time_step,episode,reward,cumulative_reward,balance,stake_a,stake_b,p_chosen,correct
1,1,-1000.00,-1000.00,0.00,1000.00,0.00,0.01,0
2,2,-842.26,-842.26,157.74,174.60,667.66,0.35,0
3,2,-1000.00,-1842.26,-842.26,82.21,35.19,0.40,0
4,3,-1000.00,-1000.00,0.00,243.48,756.52,0.10,0
5,4,-576.68,-576.68,423.32,0.00,576.68,0.16,0
6,4,-1000.00,-1576.68,-576.68,342.58,53.84,0.33,0
7,5,-1000.00,-1000.00,0.00,355.41,131.93,0.35,0
8,6,-1000.00,-1000.00,0.00,660.83,339.17,0.15,0
9,7,1000.00,1000.00,2000.00,81.77,543.17,0.33,1
10,7,-192.96,807.04,1807.04,192.96,0.00,0.22,0
11,7,1000.00,1807.04,2807.04,0.00,403.28,0.11,1
12,7,1000.00,2807.04,3807.04,1081.83,1725.22,0.33,1
13,7,1000.00,3807.04,4807.04,375.11,3431.93,0.23,1
14,7,1000.00,4807.04,5807.04,2159.52,2647.52,0.18,1
15,7,-1000.00,3807.04,4807.04,4213.99,1311.71,0.38,0
16,7,1000.00,4807.04,5807.04,0.00,1703.82,0.19,1
17,7,-1000.00,3807.04,4807.04,5807.04,0.00,0.03,0
18,7,-1000.00,2807.04,3807.04,2949.74,0.00,0.12,0
19,7,-1000.00,1807.04,2807.04,2082.71,709.52,0.38,0
20,7,-1000.00,807.04,1807.04,1513.26,1293.79,0.30,0
21,7,1000.00,1807.04,2807.04,903.52,903.52,0.19,1
22,7,-1000.00,807.04,1807.04,1571.31,1235.73,0.18,0
23,7,1000.00,1807.04,2807.04,903.52,903.52,0.03,1
24,7,-1000.00,807.04,1807.04,1750.96,1056.08,0.43,0
25,7,-1000.00,-192.96,807.04,1807.04,0.00,0.01,0
26,7,-807.04,-1000.00,0.00,445.76,361.29,0.30,0
27,8,-1000.00,-1000.00,0.00,407.68,241.20,0.39,0
28,9,1000.00,1000.00,2000.00,0.00,1000.00,0.17,1
29,9,1000.00,2000.00,3000.00,0.00,2000.00,0.02,1
30,9,-1000.00,1000.00,2000.00,2372.35,0.00,0.18,0
31,9,1000.00,2000.00,3000.00,1000.00,1000.00,0.20,1
32,9,-1000.00,1000.00,2000.00,1533.53,0.00,0.07,0
33,9,-1000.00,0.00,1000.00,1375.61,493.35,0.40,0
34,9,-1000.00,-1000.00,0.00,542.27,457.73,0.43,0
35,9,-0.00,-1000.00,0.00,0.00,0.00,0.00,0
36,10,0.00,0.00,1000.00,0.00,563.56,0.26,0
37,10,0.00,0.00,1000.00,0.00,719.45,0.20,0
38,10,0.00,0.00,1000.00,0.00,142.22,0.09,0
39,10,-807.29,-807.29,192.71,807.29,0.00,0.19,0
40,10,-112.17,-919.47,80.53,112.17,0.00,0.09,0
41,10,0.00,-919.47,80.53,26.23,54.30,0.20,0
42,10,0.00,-919.47,80.53,0.00,66.34,0.19,0
43,10,0.00,-919.47,80.53,0.00,39.47,0.19,0
44,10,0.00,-919.47,80.53,40.27,40.27,0.03,0
45,10,-64.99,-984.46,15.54,64.99,0.00,0.04,0
46,10,-7.71,-992.17,7.83,5.00,2.71,0.35,0
47,10,0.00,-992.17,7.83,1.78,4.72,0.38,0
48,10,-6.16,-998.33,1.67,3.34,2.82,0.42,0
49,10,0.00,-998.33,1.67,0.00,1.08,0.26,0
50,10,0.00,-998.33,1.67,0.56,1.11,0.19,0
51,10,0.00,-998.33,1.67,0.00,0.47,0.01,0
52,10,-1.67,-1000.00,0.00,1.15,0.52,0.09,0
53,11,-1000.00,-1000.00,0.00,336.04,663.96,0.06,0
54,12,1000.00,1000.00,2000.00,1000.00,0.00,0.05,1
55,12,-1000.00,0.00,1000.00,0.00,2000.00,0.03,0
56,12,-896.94,-896.94,103.06,279.71,617.24,0.39,0
57,12,-99.17,-996.12,3.88,15.21,83.96,0.30,0
58,12,-3.88,-1000.00,0.00,1.94,1.94,0.09,0
59,13,-1000.00,-1000.00,0.00,445.05,554.95,0.38,0
60,14,-1000.00,-1000.00,0.00,0.00,161.82,0.13,0
61,15,-1000.00,-1000.00,0.00,0.00,877.61,0.04,0
62,16,-732.14,-732.14,267.86,393.68,338.47,0.41,0
63,16,-50.03,-782.17,217.83,50.03,0.00,0.16,0
64,16,-1000.00,-1782.17,-782.17,98.24,119.58,0.08,0
65,17,1000.00,1000.00,2000.00,0.00,1000.00,0.12,1
66,17,1000.00,2000.00,3000.00,0.00,271.01,0.01,1
67,17,-1000.00,1000.00,2000.00,2980.27,19.73,0.21,0
68,17,-1000.00,0.00,1000.00,1426.62,573.38,0.34,0
69,17,-944.21,-944.21,55.79,822.34,121.87,0.33,0
70,17,-55.79,-1000.00,0.00,32.96,22.83,0.27,0
71,18,1000.00,1000.00,2000.00,431.45,568.55,0.41,1
72,18,-721.14,278.86,1278.86,721.14,0.00,0.26,0
73,18,1000.00,1278.86,2278.86,0.00,362.33,0.09,1
74,18,0.00,1278.86,2278.86,0.00,0.00,0.05,0
75,18,1000.00,2278.86,3278.86,1126.42,1152.44,0.15,1
76,18,1000.00,3278.86,4278.86,1454.02,1824.84,0.24,1
77,18,1000.00,4278.86,5278.86,1676.14,2602.71,0.15,1
78,18,-1000.00,3278.86,4278.86,4295.50,408.77,0.32,0
79,18,1000.00,4278.86,5278.86,0.00,1452.63,0.14,1
80,18,1000.00,5278.86,6278.86,0.00,934.99,0.11,1
81,18,1000.00,6278.86,7278.86,491.80,902.29,0.28,1
82,18,1000.00,7278.86,8278.86,3639.43,3639.43,0.14,1
83,18,1000.00,8278.86,9278.86,0.00,8278.86,0.07,1
84,18,-1000.00,7278.86,8278.86,9278.86,0.00,0.11,0
85,18,-1000.00,6278.86,7278.86,5829.62,2449.24,0.39,0
86,18,-1000.00,5278.86,6278.86,4042.11,3236.75,0.41,0
87,18,1000.00,6278.86,7278.86,2669.74,3609.12,0.08,1
88,18,1000.00,7278.86,8278.86,0.00,328.98,0.18,1
89,18,-1000.00,6278.86,7278.86,4258.01,0.00,0.27,0
90,18,-1000.00,5278.86,6278.86,3932.40,3346.46,0.26,0
91,18,-1000.00,4278.86,5278.86,3511.87,2766.99,0.09,0
92,18,1000.00,5278.86,6278.86,0.00,3417.70,0.07,1
93,18,1000.00,6278.86,7278.86,1166.29,5112.57,0.01,1
94,18,-1000.00,5278.86,6278.86,4240.82,3038.04,0.44,0
95,18,-1000.00,4278.86,5278.86,3378.80,2900.06,0.05,0
96,18,-1000.00,3278.86,4278.86,5259.54,19.32,0.07,0
97,18,-1000.00,2278.86,3278.86,2400.05,1878.81,0.37,0
98,18,-1000.00,1278.86,2278.86,1639.43,1639.43,0.16,0
99,18,0.00,1278.86,2278.86,0.00,0.00,0.01,0
100,18,-1000.00,278.86,1278.86,1139.43,1139.43,0.01,0
101,18,-1000.00,-721.14,278.86,0.00,758.93,0.22,0
102,18,-1000.00,-1721.14,-721.14,5.15,273.71,0.07,0
103,19,-1000.00,-1000.00,0.00,337.90,662.10,0.21,0
104,20,-86.99,-86.99,913.01,0.00,86.99,0.18,0
105,20,-913.01,-1000.00,0.00,313.16,599.85,0.30,0
106,21,1000.00,1000.00,2000.00,922.81,77.19,0.09,1
107,21,1000.00,2000.00,3000.00,1729.51,103.39,0.29,1
108,21,-1000.00,1000.00,2000.00,1500.00,1500.00,0.00,0
109,21,1000.00,2000.00,3000.00,1959.06,0.00,0.12,1
110,21,0.00,2000.00,3000.00,0.00,0.00,0.03,0
111,21,-1000.00,1000.00,2000.00,982.81,1594.12,0.41,0
112,21,1000.00,2000.00,3000.00,1270.35,729.65,0.15,1
113,21,-1000.00,1000.00,2000.00,1017.17,1982.83,0.40,0
114,21,1000.00,2000.00,3000.00,1302.34,697.66,0.07,1
115,21,1000.00,3000.00,4000.00,3000.00,0.00,0.06,1
116,21,1000.00,4000.00,5000.00,2466.84,1533.16,0.39,1
117,21,1000.00,5000.00,6000.00,207.60,0.00,0.16,1
118,21,1000.00,6000.00,7000.00,733.91,0.00,0.14,1
119,21,1000.00,7000.00,8000.00,4518.23,2481.77,0.18,1
120,21,1000.00,8000.00,9000.00,6243.62,811.36,0.33,1
121,21,1000.00,9000.00,10000.00,9000.00,0.00,0.18,1
122,21,1000.00,10000.00,11000.00,5064.75,4935.25,0.08,1
123,21,0.00,10000.00,11000.00,0.00,0.00,0.18,0
124,21,-1000.00,9000.00,10000.00,0.00,9659.81,0.03,0
125,21,-1000.00,8000.00,9000.00,5233.38,4766.62,0.43,0
126,21,-1000.00,7000.00,8000.00,4192.71,0.00,0.23,0
127,21,-1000.00,6000.00,7000.00,5701.92,396.68,0.32,0
128,21,-1000.00,5000.00,6000.00,3700.43,3299.57,0.44,0
129,21,-1000.00,4000.00,5000.00,5917.17,82.83,0.22,0
130,21,-1000.00,3000.00,4000.00,2500.00,2500.00,0.15,0
131,21,-1000.00,2000.00,3000.00,2000.00,2000.00,0.17,0
132,21,-1000.00,1000.00,2000.00,0.00,3000.00,0.06,0
133,21,-1000.00,0.00,1000.00,789.40,1210.60,0.23,0
134,21,0.00,0.00,1000.00,0.00,0.00,0.02,0
135,21,-977.59,-977.59,22.41,977.59,0.00,0.20,0
136,21,-1000.00,-1977.59,-977.59,4.47,16.16,0.35,0
137,22,-1000.00,-1000.00,0.00,479.34,520.66,0.43,0
138,23,-1000.00,-1000.00,0.00,87.57,493.57,0.33,0
139,24,-1000.00,-1000.00,0.00,194.66,805.34,0.18,0
140,25,-1000.00,-1000.00,0.00,483.71,516.29,0.20,0
141,26,-1000.00,-1000.00,0.00,413.07,586.93,0.04,0
142,27,0.00,0.00,1000.00,0.00,0.00,0.01,0
143,27,-1000.00,-1000.00,0.00,238.12,761.88,0.16,0
144,28,1000.00,1000.00,2000.00,421.56,578.44,0.41,1
145,28,-1000.00,0.00,1000.00,1084.64,915.36,0.37,0
146,28,1000.00,1000.00,2000.00,340.57,659.43,0.17,1
147,28,1000.00,2000.00,3000.00,375.45,951.55,0.37,1
148,28,-1000.00,1000.00,2000.00,2197.46,802.54,0.38,0
149,28,-369.89,630.11,1630.11,369.89,0.00,0.23,0
150,28,-1000.00,-369.89,630.11,879.36,750.75,0.13,0
151,28,-97.91,-467.80,532.20,97.91,0.00,0.13,0
152,28,1000.00,532.20,1532.20,266.10,266.10,0.14,1
153,28,-678.52,-146.32,853.68,507.49,171.04,0.33,0
154,28,1000.00,853.68,1853.68,344.69,508.99,0.26,1
155,28,1000.00,1853.68,2853.68,713.14,1140.53,0.12,1
156,28,0.00,1853.68,2853.68,0.00,0.00,0.02,0
157,28,-1000.00,853.68,1853.68,1254.69,1598.99,0.15,0
158,28,-494.25,359.43,1359.43,494.25,0.00,0.29,0
159,28,-171.65,187.78,1187.78,171.65,0.00,0.23,0
160,28,-1000.00,-812.22,187.78,556.59,631.19,0.13,0
161,28,-1000.00,-1812.22,-812.22,54.94,132.84,0.21,0
162,29,1000.00,1000.00,2000.00,412.57,141.57,0.36,1
163,29,1000.00,2000.00,3000.00,975.15,0.00,0.20,1
164,29,1000.00,3000.00,4000.00,1940.26,1059.74,0.39,1
165,29,0.00,3000.00,4000.00,0.00,0.00,0.05,0
166,29,-1000.00,2000.00,3000.00,935.27,2437.83,0.38,0
167,29,-1000.00,1000.00,2000.00,1258.23,1741.77,0.05,0
168,29,1000.00,2000.00,3000.00,1456.05,543.95,0.24,1
169,29,-1000.00,1000.00,2000.00,1215.33,1784.67,0.40,0
170,29,1000.00,2000.00,3000.00,1243.77,756.23,0.23,1
171,29,-1000.00,1000.00,2000.00,0.00,1541.36,0.23,0
172,29,0.00,1000.00,2000.00,0.00,0.00,0.17,0
173,29,-1000.00,0.00,1000.00,591.68,1408.32,0.36,0
174,29,0.00,0.00,1000.00,0.00,0.00,0.06,0
175,29,-1000.00,-1000.00,0.00,500.00,500.00,0.11,0
176,30,-1000.00,-1000.00,0.00,430.96,569.04,0.05,0
177,31,-719.04,-719.04,280.96,686.27,32.76,0.32,0
178,31,-280.96,-1000.00,0.00,141.73,139.23,0.27,0
179,32,-1000.00,-1000.00,0.00,207.48,792.52,0.31,0
180,33,1000.00,1000.00,2000.00,534.59,445.74,0.44,1
181,33,1000.00,2000.00,3000.00,1716.45,283.55,0.31,1
182,33,-1000.00,1000.00,2000.00,1248.78,1751.22,0.42,0
183,33,-997.36,2.64,1002.64,0.00,997.36,0.17,0
184,33,-42.70,-40.06,959.94,0.00,42.70,0.21,0
185,33,-959.94,-1000.00,0.00,479.97,479.97,0.20,0
186,34,0.00,0.00,1000.00,0.00,0.00,0.04,0
187,34,-1000.00,-1000.00,0.00,649.02,350.98,0.41,0
188,34,-0.00,-1000.00,0.00,0.00,0.00,0.23,0
189,35,-1000.00,-1000.00,0.00,244.29,755.71,0.28,0
190,36,-133.95,-133.95,866.05,0.00,133.95,0.13,0
191,36,-866.05,-1000.00,0.00,418.84,447.21,0.24,0
192,37,-1000.00,-1000.00,0.00,635.33,364.67,0.41,0
193,38,-1000.00,-1000.00,0.00,906.52,93.48,0.18,0
194,39,-1000.00,-1000.00,0.00,442.96,488.54,0.44,0
195,40,-1000.00,-1000.00,0.00,689.38,221.43,0.39,0
196,41,-39.17,-39.17,960.83,39.17,0.00,0.17,0
197,41,1000.00,960.83,1960.83,330.44,630.40,0.39,1
198,41,-197.13,763.71,1763.71,197.13,0.00,0.06,0
199,41,1000.00,1763.71,2763.71,494.96,1268.75,0.21,1
200,41,1000.00,2763.71,3763.71,0.00,351.79,0.01,1
201,41,-1000.00,1763.71,2763.71,2620.47,1143.24,0.30,0
202,41,1000.00,2763.71,3763.71,148.22,1660.61,0.31,1
203,41,1000.00,3763.71,4763.71,0.00,3087.98,0.22,1
204,41,1000.00,4763.71,5763.71,0.00,3762.09,0.18,1
205,41,-1000.00,3763.71,4763.71,3546.56,2217.15,0.21,0
206,41,1000.00,4763.71,5763.71,557.82,3657.73,0.31,1
207,41,-1000.00,3763.71,4763.71,3454.16,2309.54,0.35,0
208,41,1000.00,4763.71,5763.71,907.65,3856.06,0.25,1
209,41,1000.00,5763.71,6763.71,2122.81,2313.37,0.42,1
210,41,-1000.00,4763.71,5763.71,4853.68,1910.03,0.39,0
211,41,-1000.00,3763.71,4763.71,1544.31,0.00,0.03,0
212,41,0.00,3763.71,4763.71,0.00,0.00,0.06,0
213,41,-1000.00,2763.71,3763.71,3522.05,0.00,0.13,0
214,41,1000.00,3763.71,4763.71,0.00,1996.13,0.19,1
215,41,1000.00,4763.71,5763.71,0.00,4559.55,0.20,1
216,41,-1000.00,3763.71,4763.71,5398.09,365.62,0.27,0
217,41,-1000.00,2763.71,3763.71,2006.06,0.00,0.00,0
218,41,-1000.00,1763.71,2763.71,2761.92,1001.78,0.37,0
219,41,-1000.00,763.71,1763.71,1667.41,1096.30,0.36,0
220,41,-1000.00,-236.29,763.71,891.56,872.15,0.07,0
221,41,-763.71,-1000.00,0.00,473.73,289.97,0.19,0
222,42,-1000.00,-1000.00,0.00,991.70,0.00,0.21,0
223,43,-1000.00,-1000.00,0.00,307.23,692.77,0.33,0
224,44,-1000.00,-1000.00,0.00,75.30,307.53,0.31,0
225,45,-1000.00,-1000.00,0.00,426.78,573.22,0.30,0
226,46,-263.81,-263.81,736.19,0.00,263.81,0.13,0
227,46,-1000.00,-1263.81,-263.81,698.73,24.13,0.26,0
228,47,-380.26,-380.26,619.74,380.26,0.00,0.28,0
229,47,-1000.00,-1380.26,-380.26,221.43,398.31,0.16,0
230,48,-1000.00,-1000.00,0.00,131.98,868.02,0.28,0
231,49,-3.80,-3.80,996.20,3.80,0.00,0.18,0
232,49,-792.11,-795.91,204.09,582.41,209.70,0.39,0
233,49,-1000.00,-1795.91,-795.91,18.33,185.76,0.13,0
234,50,-742.41,-742.41,257.59,487.33,255.08,0.40,0
235,50,-257.59,-1000.00,0.00,257.59,0.00,0.02,0
236,51,-1000.00,-1000.00,0.00,235.23,764.77,0.37,0
237,52,-1000.00,-1000.00,0.00,323.87,676.13,0.42,0
238,53,-1000.00,-1000.00,0.00,566.82,433.18,0.29,0
239,54,-1000.00,-1000.00,0.00,218.79,781.21,0.11,0
240,55,-684.31,-684.31,315.69,542.50,141.80,0.35,0
241,55,-315.69,-1000.00,0.00,225.18,90.52,0.23,0
242,56,-855.73,-855.73,144.27,263.07,592.65,0.43,0
243,56,-144.27,-1000.00,0.00,70.28,73.99,0.22,0
244,57,-1000.00,-1000.00,0.00,0.00,753.57,0.06,0
245,58,-980.94,-980.94,19.06,338.64,642.31,0.44,0
246,58,1000.00,19.06,1019.06,11.76,7.29,0.36,1
247,58,1000.00,1019.06,2019.06,1019.06,0.00,0.23,1
248,58,-766.90,252.16,1252.16,0.00,766.90,0.12,0
249,58,-619.02,-366.86,633.14,0.00,619.02,0.31,0
250,58,1000.00,633.14,1633.14,152.42,0.00,0.06,1
251,58,-1000.00,-366.86,633.14,816.57,816.57,0.06,0
252,58,-633.14,-1000.00,0.00,276.14,357.00,0.27,0
253,59,-1000.00,-1000.00,0.00,472.49,527.51,0.42,0
254,60,-1000.00,-1000.00,0.00,679.57,261.53,0.34,0
255,61,1000.00,1000.00,2000.00,0.00,1000.00,0.05,1
256,61,1000.00,2000.00,3000.00,0.00,2000.00,0.03,1
257,61,1000.00,3000.00,4000.00,1452.85,1547.15,0.21,1
258,61,1000.00,4000.00,5000.00,0.00,1675.21,0.14,1
259,61,1000.00,5000.00,6000.00,2500.00,2500.00,0.05,1
260,61,-1000.00,4000.00,5000.00,3265.36,2734.64,0.43,0
261,61,-1000.00,3000.00,4000.00,1451.97,1026.19,0.34,0
262,61,-1000.00,2000.00,3000.00,4000.00,0.00,0.15,0
263,61,-1000.00,1000.00,2000.00,1793.23,1206.77,0.28,0
264,61,1000.00,2000.00,3000.00,459.09,1540.91,0.32,1
265,61,1000.00,3000.00,4000.00,779.81,2026.00,0.40,1
266,61,1000.00,4000.00,5000.00,2000.00,2000.00,0.04,1
267,61,1000.00,5000.00,6000.00,0.00,5000.00,0.07,1
268,61,-1000.00,4000.00,5000.00,5294.79,291.87,0.22,0
269,61,1000.00,5000.00,6000.00,0.00,5000.00,0.11,1
270,61,1000.00,6000.00,7000.00,0.00,4730.49,0.07,1
271,61,1000.00,7000.00,8000.00,2056.61,4943.39,0.28,1
272,61,1000.00,8000.00,9000.00,2619.32,5380.68,0.39,1
273,61,-1000.00,7000.00,8000.00,5773.44,3226.56,0.06,0
274,61,-1000.00,6000.00,7000.00,4115.43,3884.57,0.26,0
275,61,-1000.00,5000.00,6000.00,4626.11,2373.89,0.32,0
276,61,-1000.00,4000.00,5000.00,3489.00,2511.00,0.29,0
277,61,1000.00,5000.00,6000.00,1372.66,3627.34,0.21,1
278,61,-1000.00,4000.00,5000.00,4892.22,1107.78,0.33,0
279,61,-1000.00,3000.00,4000.00,2169.86,1198.54,0.38,0
280,61,1000.00,4000.00,5000.00,225.76,3774.24,0.26,1
281,61,1000.00,5000.00,6000.00,562.37,2076.54,0.37,1
282,61,1000.00,6000.00,7000.00,2317.93,3682.07,0.34,1
283,61,1000.00,7000.00,8000.00,0.00,2608.25,0.04,1
284,61,1000.00,8000.00,9000.00,2258.50,5741.50,0.36,1
285,61,-1000.00,7000.00,8000.00,6174.65,2825.35,0.38,0
286,61,-1000.00,6000.00,7000.00,5804.33,2195.67,0.06,0
287,61,-1000.00,5000.00,6000.00,6556.37,443.63,0.05,0
288,61,1000.00,6000.00,7000.00,2533.31,3466.69,0.43,1
289,61,-1000.00,5000.00,6000.00,5250.21,0.00,0.23,0
290,61,-1000.00,4000.00,5000.00,1125.75,415.10,0.26,0
291,61,-39.23,3960.77,4960.77,39.23,0.00,0.19,0
292,61,1000.00,4960.77,5960.77,1279.04,3039.96,0.36,1
293,61,1000.00,5960.77,6960.77,1289.12,4671.64,0.11,1
294,61,-1000.00,4960.77,5960.77,3315.21,581.90,0.32,0
295,62,1000.00,1000.00,2000.00,0.00,680.98,0.05,1
296,62,-1000.00,0.00,1000.00,1165.02,834.98,0.40,0
297,62,1000.00,1000.00,2000.00,130.66,646.91,0.32,1
298,62,1000.00,2000.00,3000.00,646.28,1353.72,0.23,1
299,62,1000.00,3000.00,4000.00,1422.60,1577.40,0.22,1
300,62,0.00,3000.00,4000.00,0.00,0.00,0.05,0
301,62,1000.00,4000.00,5000.00,184.84,2054.18,0.35,1
302,62,-1000.00,3000.00,4000.00,3135.69,1864.31,0.37,0
303,62,-1000.00,2000.00,3000.00,1985.76,0.00,0.02,0
304,62,1000.00,3000.00,4000.00,0.00,639.58,0.24,1
305,62,-1000.00,2000.00,3000.00,2245.50,1754.50,0.08,0
306,62,1000.00,3000.00,4000.00,1500.00,1500.00,0.07,1
307,62,-1000.00,2000.00,3000.00,2177.44,1188.14,0.41,0
308,62,-1000.00,1000.00,2000.00,2398.78,601.22,0.29,0
309,62,-1000.00,0.00,1000.00,99.71,1900.29,0.18,0
310,62,-1000.00,-1000.00,0.00,320.33,679.67,0.09,0
311,63,1000.00,1000.00,2000.00,716.43,283.57,0.16,1
312,63,-1000.00,0.00,1000.00,626.18,1373.82,0.33,0
313,63,1000.00,1000.00,2000.00,655.41,344.59,0.12,1
314,63,-1000.00,0.00,1000.00,787.29,1212.71,0.29,0
315,63,-1000.00,-1000.00,0.00,500.00,500.00,0.03,0
316,64,-1000.00,-1000.00,0.00,356.41,619.84,0.43,0
317,65,-1000.00,-1000.00,0.00,0.00,238.60,0.13,0
318,66,1000.00,1000.00,2000.00,910.45,0.00,0.19,1
319,66,1000.00,2000.00,3000.00,1388.97,480.68,0.36,1
320,66,-1000.00,1000.00,2000.00,0.00,3000.00,0.03,0
321,66,1000.00,2000.00,3000.00,1640.03,359.97,0.10,1
322,66,-1000.00,1000.00,2000.00,730.79,2269.21,0.23,0
323,66,-1000.00,0.00,1000.00,555.75,1444.25,0.01,0
324,66,1000.00,1000.00,2000.00,111.84,0.00,0.20,1
325,66,1000.00,2000.00,3000.00,654.52,320.33,0.31,1
326,66,-1000.00,1000.00,2000.00,1459.69,1540.31,0.24,0
327,66,1000.00,2000.00,3000.00,1656.43,343.57,0.18,1
328,66,-1000.00,1000.00,2000.00,0.00,2989.50,0.23,0
329,66,1000.00,2000.00,3000.00,1067.24,932.76,0.43,1
330,66,1000.00,3000.00,4000.00,1972.58,790.56,0.37,1
331,66,1000.00,4000.00,5000.00,4000.00,0.00,0.09,1
332,66,-1000.00,3000.00,4000.00,1449.96,3550.04,0.32,0
333,66,-1000.00,2000.00,3000.00,2000.00,2000.00,0.03,0
334,66,-1000.00,1000.00,2000.00,0.00,2981.50,0.21,0
335,66,1000.00,2000.00,3000.00,704.92,0.00,0.25,1
336,66,1000.00,3000.00,4000.00,1704.76,604.35,0.38,1
337,66,-1000.00,2000.00,3000.00,1459.76,2540.24,0.31,0
338,66,-1000.00,1000.00,2000.00,1458.67,1541.33,0.06,0
339,66,1000.00,2000.00,3000.00,1787.29,0.00,0.07,1
340,66,-1000.00,1000.00,2000.00,1694.09,1305.91,0.26,0
341,66,0.00,1000.00,2000.00,0.00,0.00,0.14,0
342,66,-1000.00,0.00,1000.00,925.72,1074.28,0.06,0
343,66,-1000.00,-1000.00,0.00,506.24,255.70,0.40,0
344,67,-1000.00,-1000.00,0.00,598.74,401.26,0.35,0
345,68,-1000.00,-1000.00,0.00,753.43,246.57,0.20,0
346,69,-864.67,-864.67,135.33,82.61,782.05,0.36,0
347,69,-1000.00,-1864.67,-864.67,112.86,22.48,0.08,0
348,70,1000.00,1000.00,2000.00,611.68,388.32,0.36,1
349,70,1000.00,2000.00,3000.00,1145.36,854.64,0.35,1
350,70,0.00,2000.00,3000.00,0.00,0.00,0.09,0
351,70,-1000.00,1000.00,2000.00,1459.92,1540.08,0.35,0
352,70,-596.93,403.07,1403.07,253.07,343.86,0.29,0
353,70,-994.45,-591.38,408.62,180.96,813.49,0.37,0
354,70,1000.00,408.62,1408.62,280.08,128.54,0.19,1
355,70,1000.00,1408.62,2408.62,721.57,687.04,0.42,1
356,70,1000.00,2408.62,3408.62,1548.86,0.00,0.26,1
357,70,-1000.00,1408.62,2408.62,1380.47,2028.15,0.33,0
358,70,-1000.00,408.62,1408.62,432.26,1976.35,0.08,0
359,70,1000.00,1408.62,2408.62,775.23,270.03,0.35,1
360,70,-1000.00,408.62,1408.62,483.57,946.28,0.35,0
361,70,-810.03,-401.42,598.58,0.00,810.03,0.30,0
362,70,-598.58,-1000.00,0.00,282.07,316.51,0.37,0
363,71,1000.00,1000.00,2000.00,546.16,202.31,0.35,1
364,71,-1000.00,0.00,1000.00,338.71,1661.29,0.10,0
365,71,-339.01,-339.01,660.99,148.87,190.14,0.30,0
366,71,-544.46,-883.47,116.53,0.00,544.46,0.27,0
367,71,-116.53,-1000.00,0.00,34.04,82.49,0.22,0
368,72,1000.00,1000.00,2000.00,257.10,395.51,0.40,1
369,72,-1000.00,0.00,1000.00,2000.00,0.00,0.08,0
370,72,1000.00,1000.00,2000.00,371.71,628.29,0.23,1
371,72,-1000.00,0.00,1000.00,1869.18,130.82,0.18,0
372,72,-735.86,-735.86,264.14,475.38,260.48,0.37,0
373,72,1000.00,264.14,1264.14,0.00,221.05,0.13,1
374,72,1000.00,1264.14,2264.14,0.00,1264.14,0.12,1
375,72,1000.00,2264.14,3264.14,67.23,2196.91,0.23,1
376,72,-1000.00,1264.14,2264.14,2847.09,417.05,0.15,0
377,72,1000.00,2264.14,3264.14,655.37,1608.77,0.38,1
378,72,-1000.00,1264.14,2264.14,1691.52,1459.72,0.43,0
379,72,1000.00,2264.14,3264.14,0.00,1773.99,0.14,1
380,72,1000.00,3264.14,4264.14,1067.38,2196.76,0.31,1
381,72,-1000.00,2264.14,3264.14,4264.14,0.00,0.12,0
382,72,-1000.00,1264.14,2264.14,3225.06,39.08,0.21,0
383,72,-49.00,1215.14,2215.14,49.00,0.00,0.00,0
384,72,-1000.00,215.14,1215.14,2074.33,41.32,0.27,0
385,72,-912.25,-697.11,302.89,912.25,0.00,0.13,0
386,72,-302.89,-1000.00,0.00,302.89,0.00,0.04,0
387,73,-966.42,-966.42,33.58,697.95,268.47,0.37,0
388,73,1000.00,33.58,1033.58,11.12,22.45,0.37,1
389,73,-837.04,-803.46,196.54,837.04,0.00,0.25,0
390,73,-146.70,-950.16,49.84,146.70,0.00,0.29,0
391,73,-34.22,-984.38,15.62,20.13,14.09,0.38,0
392,73,-15.62,-1000.00,0.00,12.93,2.68,0.26,0
393,74,1000.00,1000.00,2000.00,0.00,1000.00,0.16,1
394,74,1000.00,2000.00,3000.00,0.00,340.65,0.17,1
395,74,-1000.00,1000.00,2000.00,2977.60,0.00,0.20,0
396,74,1000.00,2000.00,3000.00,0.00,473.38,0.27,1
397,74,-1000.00,1000.00,2000.00,1941.87,1058.13,0.26,0
398,74,-1000.00,0.00,1000.00,1145.22,854.78,0.42,0
399,74,-862.41,-862.41,137.59,719.91,142.49,0.34,0
400,74,1000.00,137.59,1137.59,41.35,96.25,0.00,1
401,74,-1000.00,-862.41,137.59,653.02,484.57,0.37,0
402,74,1000.00,137.59,1137.59,68.80,68.80,0.06,1
403,74,-1000.00,-862.41,137.59,1137.59,0.00,0.04,0
404,74,1000.00,137.59,1137.59,0.00,65.27,0.17,1
405,74,1000.00,1137.59,2137.59,498.63,638.97,0.40,1
406,74,1000.00,2137.59,3137.59,924.89,1212.70,0.11,1
407,74,1000.00,3137.59,4137.59,1325.59,1812.00,0.24,1
408,74,-1000.00,2137.59,3137.59,2897.17,1240.42,0.26,0
409,74,1000.00,3137.59,4137.59,0.00,3137.59,0.03,1
410,74,0.00,3137.59,4137.59,0.00,0.00,0.04,0
411,74,-1000.00,2137.59,3137.59,2368.80,1768.79,0.08,0
412,74,-1000.00,1137.59,2137.59,2120.90,1016.70,0.37,0
413,74,1000.00,2137.59,3137.59,441.26,1696.33,0.17,1
414,74,-1000.00,1137.59,2137.59,3137.59,0.00,0.01,0
415,74,1000.00,2137.59,3137.59,1068.80,1068.80,0.01,1
416,74,-1000.00,1137.59,2137.59,1817.90,1319.69,0.43,0
417,74,-1000.00,137.59,1137.59,1534.81,491.54,0.38,0
418,74,1000.00,1137.59,2137.59,0.00,1137.59,0.00,1
419,74,1000.00,2137.59,3137.59,483.63,1653.97,0.33,1
420,74,-1000.00,1137.59,2137.59,1620.40,1269.39,0.42,0
421,74,1000.00,2137.59,3137.59,43.56,1839.27,0.29,1
422,74,-1000.00,1137.59,2137.59,2067.92,1069.67,0.32,0
423,74,-191.00,946.60,1946.60,191.00,0.00,0.11,0
424,74,-161.72,784.88,1784.88,161.72,0.00,0.05,0
425,74,1000.00,1784.88,2784.88,837.95,946.93,0.10,1
426,74,-1000.00,784.88,1784.88,2337.64,447.23,0.17,0
427,74,-1000.00,-215.12,784.88,1685.01,99.87,0.09,0
428,74,-353.21,-568.33,431.67,282.74,70.47,0.30,0
429,74,1000.00,431.67,1431.67,11.90,313.32,0.31,1
430,74,-1000.00,-568.33,431.67,1431.67,0.00,0.10,0
431,74,-294.37,-862.71,137.29,225.85,68.53,0.35,0
432,74,-137.29,-1000.00,0.00,86.30,50.99,0.41,0
433,75,-1000.00,-1000.00,0.00,487.56,512.44,0.28,0
434,76,1000.00,1000.00,2000.00,0.00,585.44,0.30,1
435,76,-1000.00,0.00,1000.00,0.00,1403.20,0.02,0
436,76,-1000.00,-1000.00,0.00,622.89,377.11,0.31,0
437,77,-1000.00,-1000.00,0.00,507.62,492.38,0.43,0
438,78,-317.84,-317.84,682.16,196.44,121.40,0.32,0
439,78,-682.16,-1000.00,0.00,538.56,143.60,0.31,0
440,79,1000.00,1000.00,2000.00,0.00,260.00,0.04,1
441,79,1000.00,2000.00,3000.00,735.23,1043.36,0.43,1
442,79,1000.00,3000.00,4000.00,1156.52,1843.48,0.44,1
443,79,-1000.00,2000.00,3000.00,2390.92,0.00,0.23,0
444,79,-1000.00,1000.00,2000.00,892.03,510.12,0.34,0
445,79,1000.00,2000.00,3000.00,841.53,1158.47,0.28,1
446,79,-1000.00,1000.00,2000.00,1678.33,1321.67,0.31,0
447,79,-986.94,13.06,1013.06,986.94,0.00,0.23,0
448,79,-1000.00,-986.94,13.06,385.13,627.93,0.19,0
449,79,-1000.00,-1986.94,-986.94,4.22,8.84,0.29,0
450,80,-1000.00,-1000.00,0.00,704.10,295.90,0.37,0
451,81,-1000.00,-1000.00,0.00,882.77,0.00,0.15,0
452,82,0.00,0.00,1000.00,0.00,0.00,0.05,0
453,82,-1000.00,-1000.00,0.00,501.43,498.57,0.16,0
454,83,-1000.00,-1000.00,0.00,608.96,391.04,0.27,0
455,84,-1000.00,-1000.00,0.00,390.13,609.87,0.06,0
456,85,-889.92,-889.92,110.08,323.47,566.45,0.43,0
457,85,-1000.00,-1889.92,-889.92,10.21,0.00,0.22,0
458,86,-742.50,-742.50,257.50,563.62,178.89,0.36,0
459,86,-1000.00,-1742.50,-742.50,0.00,253.98,0.12,0
460,87,-1000.00,-1000.00,0.00,564.25,133.10,0.32,0
461,88,1000.00,1000.00,2000.00,328.18,671.82,0.31,1
462,88,1000.00,2000.00,3000.00,841.24,1158.76,0.40,1
463,88,1000.00,3000.00,4000.00,824.71,2175.29,0.05,1
464,88,-538.45,2461.55,3461.55,452.97,85.48,0.21,0
465,88,1000.00,3461.55,4461.55,1730.78,1730.78,0.02,1
466,88,-1000.00,2461.55,3461.55,2446.62,2014.93,0.30,0
467,88,-1000.00,1461.55,2461.55,1829.41,1632.15,0.38,0
468,88,-1000.00,461.55,1461.55,1311.56,0.00,0.10,0
469,88,1000.00,1461.55,2461.55,0.00,1152.04,0.25,1
470,88,-1000.00,461.55,1461.55,1351.39,1110.17,0.17,0
471,88,1000.00,1461.55,2461.55,0.00,1461.55,0.09,1
472,88,-1000.00,461.55,1461.55,1236.88,1224.68,0.42,0
473,88,1000.00,1461.55,2461.55,200.85,1023.70,0.35,1
474,88,-1000.00,461.55,1461.55,2461.55,0.00,0.09,0
475,88,-297.97,163.58,1163.58,297.97,0.00,0.10,0
476,88,1000.00,1163.58,2163.58,581.79,581.79,0.15,1
477,88,1000.00,2163.58,3163.58,235.77,428.25,0.26,1
478,88,-1000.00,1163.58,2163.58,1941.26,0.00,0.16,0
479,88,-1000.00,163.58,1163.58,1313.27,850.31,0.42,0
480,88,-1000.00,-836.42,163.58,674.38,489.21,0.42,0
481,88,1000.00,163.58,1163.58,81.79,81.79,0.05,1
482,88,1000.00,1163.58,2163.58,224.56,939.02,0.04,1
483,88,0.00,1163.58,2163.58,0.00,0.00,0.13,0
484,88,-1000.00,163.58,1163.58,1950.21,0.00,0.12,0
485,88,-1000.00,-836.42,163.58,781.38,382.20,0.25,0
486,88,-139.62,-976.04,23.96,118.20,21.42,0.34,0
487,88,-23.96,-1000.00,0.00,14.89,9.07,0.41,0
488,89,-591.31,-591.31,408.69,591.31,0.00,0.13,0
489,89,1000.00,408.69,1408.69,164.00,244.69,0.44,1
490,89,-1000.00,-591.31,408.69,1289.86,118.83,0.15,0
491,89,-313.49,-904.80,95.20,313.49,0.00,0.16,0
492,89,1000.00,95.20,1095.20,33.75,36.14,0.42,1
493,89,-1000.00,-904.80,95.20,1095.20,0.00,0.03,0
494,89,1000.00,95.20,1095.20,4.70,82.84,0.29,1
495,89,1000.00,1095.20,2095.20,201.68,893.52,0.06,1
496,89,-1000.00,95.20,1095.20,1488.06,607.14,0.32,0
497,89,0.00,95.20,1095.20,0.00,0.00,0.14,0
498,89,1000.00,1095.20,2095.20,0.00,1095.20,0.09,1
499,89,1000.00,2095.20,3095.20,1047.60,1047.60,0.09,1
500,89,1000.00,3095.20,4095.20,543.59,2551.61,0.27,1
501,89,1000.00,4095.20,5095.20,0.82,1958.21,0.33,1
502,89,-1000.00,3095.20,4095.20,3326.70,194.49,0.27,0
503,89,-1000.00,2095.20,3095.20,2256.79,1838.41,0.40,0
504,89,1000.00,3095.20,4095.20,0.00,3095.20,0.05,1
505,89,1000.00,4095.20,5095.20,252.41,2064.86,0.34,1
506,89,-1000.00,3095.20,4095.20,5095.20,0.00,0.05,0
507,89,-1000.00,2095.20,3095.20,3070.02,0.00,0.14,0
508,89,-1000.00,1095.20,2095.20,1209.02,502.78,0.33,0
509,89,-1000.00,95.20,1095.20,1047.60,1047.60,0.05,0
510,89,-1000.00,-904.80,95.20,358.45,48.56,0.29,0
511,89,-80.80,-985.60,14.40,33.75,47.05,0.43,0
512,89,-14.40,-1000.00,0.00,2.74,11.66,0.27,0
513,90,1000.00,1000.00,2000.00,440.53,559.47,0.30,1
514,90,-1000.00,0.00,1000.00,979.12,364.33,0.34,0
515,90,-230.48,-230.48,769.52,230.48,0.00,0.14,0
516,90,-769.52,-1000.00,0.00,423.32,346.20,0.19,0
517,91,-1000.00,-1000.00,0.00,801.43,198.57,0.31,0
518,92,-1000.00,-1000.00,0.00,482.13,517.87,0.27,0
519,93,-1000.00,-1000.00,0.00,740.79,259.21,0.07,0
520,94,-1000.00,-1000.00,0.00,0.00,1000.00,0.17,0
521,95,-1000.00,-1000.00,0.00,0.00,1000.00,0.08,0
522,96,-1000.00,-1000.00,0.00,527.36,472.64,0.34,0
523,97,-1000.00,-1000.00,0.00,428.27,37.13,0.31,0
524,98,-1000.00,-1000.00,0.00,866.61,133.39,0.17,0
525,99,1000.00,1000.00,2000.00,428.08,571.92,0.42,1
526,99,-397.50,602.50,1602.50,397.50,0.00,0.19,0
527,99,-1000.00,-397.50,602.50,819.59,782.91,0.24,0
528,99,0.00,-397.50,602.50,0.00,0.00,0.04,0
529,99,1000.00,602.50,1602.50,0.00,307.77,0.17,1
530,99,1000.00,1602.50,2602.50,566.90,1035.60,0.23,1
531,99,1000.00,2602.50,3602.50,0.00,1402.17,0.16,1
532,99,1000.00,3602.50,4602.50,1801.25,1801.25,0.02,1
533,99,1000.00,4602.50,5602.50,87.82,2216.23,0.29,1
534,99,1000.00,5602.50,6602.50,2801.25,2801.25,0.07,1
535,99,-1000.00,4602.50,5602.50,6602.50,0.00,0.10,0
536,99,1000.00,5602.50,6602.50,0.00,2403.70,0.16,1
537,99,1000.00,6602.50,7602.50,2271.78,4330.72,0.41,1
538,99,1000.00,7602.50,8602.50,2308.45,3867.94,0.43,1
539,99,-1000.00,6602.50,7602.50,3687.42,206.44,0.28,0
540,99,-1000.00,5602.50,6602.50,0.00,7602.50,0.14,0
541,99,-1000.00,4602.50,5602.50,3752.97,2849.53,0.25,0
542,99,-1000.00,3602.50,4602.50,2821.14,1624.28,0.39,0
543,99,-1000.00,2602.50,3602.50,2358.24,2244.26,0.05,0
544,99,-1000.00,1602.50,2602.50,904.35,2249.78,0.37,0
545,99,-325.79,1276.70,2276.70,0.00,325.79,0.17,0
546,99,-1000.00,276.70,1276.70,1355.62,921.08,0.39,0
547,99,-1000.00,-723.30,276.70,833.39,443.32,0.02,0
548,99,-276.70,-1000.00,0.00,115.96,160.74,0.12,0
549,100,-90.98,-90.98,909.02,0.00,90.98,0.03,0
550,100,0.00,-90.98,909.02,0.00,0.00,0.05,0
551,100,-50.01,-141.00,859.00,0.00,50.01,0.03,0
552,100,-68.66,-209.66,790.34,0.00,68.66,0.09,0
553,100,-790.34,-1000.00,0.00,395.17,395.17,0.10,0
554,101,1000.00,1000.00,2000.00,496.27,503.73,0.29,1
555,101,-420.90,579.10,1579.10,420.90,0.00,0.06,0
556,101,1000.00,1579.10,2579.10,0.00,809.85,0.28,1
557,101,1000.00,2579.10,3579.10,0.00,2579.10,0.07,1
558,101,1000.00,3579.10,4579.10,648.18,2930.92,0.40,1
559,101,-1000.00,2579.10,3579.10,3460.52,0.00,0.16,0
560,101,-1000.00,1579.10,2579.10,2418.97,1160.13,0.33,0
561,101,0.00,1579.10,2579.10,0.00,0.00,0.01,0
562,101,1000.00,2579.10,3579.10,0.00,2579.10,0.11,1
563,101,1000.00,3579.10,4579.10,0.00,2666.42,0.09,1
564,101,1000.00,4579.10,5579.10,1749.15,2829.95,0.30,1
565,101,-1000.00,3579.10,4579.10,2834.11,2744.99,0.26,0
566,101,1000.00,4579.10,5579.10,1520.42,3058.68,0.04,1
567,101,1000.00,5579.10,6579.10,1714.23,3864.87,0.43,1
568,101,-1000.00,4579.10,5579.10,3176.32,997.37,0.29,0
569,101,-1000.00,3579.10,4579.10,4760.96,818.14,0.26,0
570,101,-1000.00,2579.10,3579.10,733.47,709.74,0.27,0
571,101,-1000.00,1579.10,2579.10,3579.10,0.00,0.08,0
572,101,-1000.00,579.10,1579.10,2079.40,499.70,0.25,0
573,101,-1000.00,-420.90,579.10,820.01,759.09,0.27,0
574,101,-579.10,-1000.00,0.00,276.14,302.96,0.17,0
575,102,0.00,0.00,1000.00,0.00,0.00,0.16,0
576,102,-82.49,-82.49,917.51,82.49,0.00,0.02,0
577,102,-1000.00,-1082.49,-82.49,0.00,727.77,0.24,0
578,103,-1000.00,-1000.00,0.00,888.19,111.81,0.11,0
579,104,-1000.00,-1000.00,0.00,0.00,622.06,0.07,0
580,105,-1000.00,-1000.00,0.00,288.79,711.21,0.43,0
581,106,-1000.00,-1000.00,0.00,470.04,529.96,0.34,0
582,107,-1000.00,-1000.00,0.00,368.67,631.33,0.33,0
583,107,0.00,-1000.00,0.00,0.00,0.00,0.36,1
584,107,-0.00,-1000.00,0.00,0.00,0.00,0.39,0
585,107,0.00,-1000.00,0.00,0.00,0.00,0.04,1
586,107,0.00,-1000.00,0.00,0.00,0.00,0.04,1
587,107,-0.00,-1000.00,0.00,0.00,0.00,0.22,0
588,107,-0.00,-1000.00,0.00,0.00,0.00,0.19,0
589,107,0.00,-1000.00,0.00,0.00,0.00,0.23,1
590,107,-0.00,-1000.00,0.00,0.00,0.00,0.36,0
591,108,-1000.00,-1000.00,0.00,0.00,112.23,0.23,0
592,109,-1000.00,-1000.00,0.00,784.94,215.06,0.22,0
593,110,1000.00,1000.00,2000.00,671.46,328.54,0.18,1
594,110,1000.00,2000.00,3000.00,1091.73,0.00,0.05,1
595,110,1000.00,3000.00,4000.00,1564.27,1435.73,0.41,1
596,110,-1000.00,2000.00,3000.00,1524.91,2055.80,0.41,0
597,110,1000.00,3000.00,4000.00,2278.91,337.83,0.28,1
598,110,1000.00,4000.00,5000.00,3277.26,722.74,0.30,1
599,110,-1000.00,3000.00,4000.00,1106.53,2924.32,0.41,0
600,110,-1000.00,2000.00,3000.00,1534.77,2465.23,0.00,0
601,110,1000.00,3000.00,4000.00,3000.00,0.00,0.07,1
602,110,1000.00,4000.00,5000.00,2350.83,1649.17,0.22,1
603,110,-1000.00,3000.00,4000.00,0.00,5000.00,0.03,0
604,110,1000.00,4000.00,5000.00,2419.28,1580.72,0.30,1
605,110,-1000.00,3000.00,4000.00,0.00,5000.00,0.13,0
606,110,-1000.00,2000.00,3000.00,259.65,3740.35,0.33,0
607,110,-1000.00,1000.00,2000.00,1500.00,1500.00,0.07,0
608,110,-1000.00,0.00,1000.00,0.00,1767.60,0.04,0
609,110,1000.00,1000.00,2000.00,1000.00,0.00,0.01,1
610,110,-890.14,109.86,1109.86,0.00,890.14,0.24,0
611,110,-946.91,-837.05,162.95,0.00,946.91,0.30,0
612,110,1000.00,162.95,1162.95,91.02,71.93,0.44,1
613,110,1000.00,1162.95,2162.95,581.50,0.00,0.11,1
614,110,1000.00,2162.95,3162.95,1093.98,1068.96,0.10,1
615,110,1000.00,3162.95,4162.95,1643.94,1519.00,0.22,1
616,110,1000.00,4162.95,5162.95,3245.15,0.00,0.19,1
617,110,1000.00,5162.95,6162.95,2897.89,2265.06,0.31,1
618,110,1000.00,6162.95,7162.95,4155.70,2007.24,0.38,1
619,110,-1000.00,5162.95,6162.95,0.00,6001.56,0.07,0
620,110,-1000.00,4162.95,5162.95,2398.83,3669.51,0.44,0
621,110,-1000.00,3162.95,4162.95,956.45,4206.49,0.28,0
622,110,1000.00,4162.95,5162.95,2722.85,1440.09,0.39,1
623,110,-1000.00,3162.95,4162.95,0.00,5162.95,0.06,0
624,110,-1000.00,2162.95,3162.95,1528.92,2634.03,0.08,0
625,111,1000.00,1000.00,2000.00,789.16,210.84,0.15,1
626,111,1000.00,2000.00,3000.00,957.00,0.00,0.17,1
627,111,1000.00,3000.00,4000.00,2052.73,947.27,0.11,1
628,111,1000.00,4000.00,5000.00,2628.28,1371.72,0.25,1
629,111,-1000.00,3000.00,4000.00,1844.59,3155.41,0.34,0
630,111,1000.00,4000.00,5000.00,2561.60,305.28,0.28,1
631,111,-1000.00,3000.00,4000.00,0.00,4007.11,0.26,0
632,111,1000.00,4000.00,5000.00,1554.62,0.00,0.06,1
633,111,-838.50,3161.50,4161.50,0.00,838.50,0.10,0
634,111,-1000.00,2161.50,3161.50,405.13,2403.79,0.32,0
635,111,-1000.00,1161.50,2161.50,1254.28,1907.22,0.27,0
636,111,-1000.00,161.50,1161.50,632.65,1528.85,0.16,0
637,111,-451.10,-289.60,710.40,0.00,451.10,0.22,0
638,111,1000.00,710.40,1710.40,628.73,0.00,0.02,1
639,111,-1000.00,-289.60,710.40,0.00,1492.88,0.14,0
640,111,-520.51,-810.11,189.89,0.00,520.51,0.17,0
641,111,1000.00,189.89,1189.89,115.77,74.12,0.35,1
642,111,1000.00,1189.89,2189.89,720.99,468.90,0.38,1
643,111,-1000.00,189.89,1189.89,434.32,1416.49,0.38,0
644,111,-1000.00,-810.11,189.89,306.95,882.94,0.23,0
645,111,1000.00,189.89,1189.89,104.23,85.66,0.34,1
646,111,1000.00,1189.89,2189.89,601.64,480.77,0.39,1
647,111,-1000.00,189.89,1189.89,1065.95,1123.93,0.39,0
648,111,1000.00,1189.89,2189.89,649.85,540.04,0.36,1
649,111,1000.00,2189.89,3189.89,1483.71,0.00,0.19,1
650,111,-1000.00,1189.89,2189.89,246.31,2410.51,0.42,0
651,111,1000.00,2189.89,3189.89,112.71,0.00,0.05,1
652,111,1000.00,3189.89,4189.89,1776.15,1413.73,0.08,1
653,111,1000.00,4189.89,5189.89,1055.21,660.55,0.30,1
654,111,-1000.00,3189.89,4189.89,1993.30,3196.59,0.43,0
655,111,-1000.00,2189.89,3189.89,2094.94,2094.94,0.06,0
656,111,-1000.00,1189.89,2189.89,1087.20,2102.69,0.37,0
657,111,-1000.00,189.89,1189.89,0.00,1224.75,0.29,0
658,111,-1000.00,-810.11,189.89,501.86,688.03,0.41,0
659,111,-189.89,-1000.00,0.00,92.60,97.28,0.24,0
660,112,-1000.00,-1000.00,0.00,399.89,600.11,0.39,0
661,113,-1000.00,-1000.00,0.00,91.86,908.14,0.28,0
662,114,-1000.00,-1000.00,0.00,0.00,1000.00,0.23,0
663,115,-1000.00,-1000.00,0.00,370.26,629.74,0.43,0
664,116,-980.79,-980.79,19.21,275.74,705.05,0.44,0
665,116,-19.21,-1000.00,0.00,0.00,19.21,0.26,0
666,117,-1000.00,-1000.00,0.00,603.74,396.26,0.00,0
667,118,-242.50,-242.50,757.50,0.00,242.50,0.23,0
668,118,1000.00,757.50,1757.50,747.28,0.00,0.02,1
669,118,1000.00,1757.50,2757.50,1081.41,676.08,0.31,1
670,118,1000.00,2757.50,3757.50,2047.78,709.72,0.10,1
671,118,-1000.00,1757.50,2757.50,0.00,2287.99,0.22,0
672,118,-1000.00,757.50,1757.50,0.00,2757.50,0.19,0
673,118,1000.00,1757.50,2757.50,830.91,122.56,0.27,1
674,118,-1000.00,757.50,1757.50,1055.97,1701.53,0.30,0
675,118,-1000.00,-242.50,757.50,874.02,883.48,0.43,0
676,118,0.00,-242.50,757.50,0.00,0.00,0.02,0
677,118,-668.61,-911.11,88.89,9.65,658.96,0.22,0
678,118,1000.00,88.89,1088.89,36.77,0.00,0.22,1
679,118,1000.00,1088.89,2088.89,695.18,393.71,0.31,1
680,118,-1000.00,88.89,1088.89,538.82,1550.06,0.32,0
681,118,-1000.00,-911.11,88.89,449.32,639.57,0.29,0
682,118,0.00,-911.11,88.89,0.00,0.00,0.08,0
683,118,-88.89,-1000.00,0.00,0.00,88.89,0.19,0
684,119,1000.00,1000.00,2000.00,468.05,531.95,0.17,1
685,119,1000.00,2000.00,3000.00,0.00,2000.00,0.06,1
686,119,1000.00,3000.00,4000.00,0.00,750.71,0.24,1
687,119,1000.00,4000.00,5000.00,0.00,3622.93,0.27,1
688,119,1000.00,5000.00,6000.00,1689.29,3310.71,0.30,1
689,119,1000.00,6000.00,7000.00,2698.01,3301.99,0.37,1
690,119,-1000.00,5000.00,6000.00,5449.45,1550.55,0.21,0
691,119,1000.00,6000.00,7000.00,2731.81,3268.19,0.43,1
692,119,1000.00,7000.00,8000.00,951.05,1784.14,0.26,1
693,119,-1000.00,6000.00,7000.00,4394.88,3605.12,0.34,0
694,119,1000.00,7000.00,8000.00,103.72,6896.28,0.05,1
695,119,1000.00,8000.00,9000.00,0.00,3478.86,0.18,1
696,119,-1000.00,7000.00,8000.00,5453.54,3546.46,0.32,0
697,119,-1000.00,6000.00,7000.00,4001.91,2327.18,0.36,0
698,119,1000.00,7000.00,8000.00,0.00,4949.02,0.12,1
699,119,-1000.00,6000.00,7000.00,8000.00,0.00,0.07,0
700,119,-1000.00,5000.00,6000.00,6803.52,196.48,0.16,0
701,119,-1000.00,4000.00,5000.00,3313.49,2686.51,0.43,0
702,119,1000.00,5000.00,6000.00,1601.77,3398.23,0.24,1
703,119,1000.00,6000.00,7000.00,2238.60,3262.06,0.43,1
704,119,-1000.00,5000.00,6000.00,4628.26,2371.74,0.06,0
705,119,-1000.00,4000.00,5000.00,4808.72,0.00,0.16,0
706,119,1000.00,5000.00,6000.00,83.88,1984.54,0.28,1
707,119,0.00,5000.00,6000.00,0.00,0.00,0.12,0
708,119,-1000.00,4000.00,5000.00,707.63,5292.37,0.24,0
709,119,-1000.00,3000.00,4000.00,2468.45,2294.02,0.41,0
710,119,-1000.00,2000.00,3000.00,0.00,2710.18,0.31,0
711,119,-1000.00,1000.00,2000.00,1456.62,1543.38,0.20,0
712,119,-1000.00,0.00,1000.00,1133.19,357.50,0.33,0
713,119,-1000.00,-1000.00,0.00,950.54,49.46,0.22,0
714,120,-765.78,-765.78,234.22,279.90,485.88,0.42,0
715,120,-234.22,-1000.00,0.00,0.00,234.22,0.09,0
716,121,1000.00,1000.00,2000.00,490.45,509.55,0.12,1
717,121,-1000.00,0.00,1000.00,1753.93,0.00,0.09,0
718,121,-244.07,-244.07,755.93,244.07,0.00,0.16,0
719,121,1000.00,755.93,1755.93,258.78,497.14,0.37,1
720,121,-1000.00,-244.07,755.93,1310.43,418.91,0.34,0
721,121,-658.92,-903.00,97.00,422.11,236.81,0.39,0
722,121,1000.00,97.00,1097.00,33.25,63.75,0.43,1
723,121,-727.40,-630.40,369.60,727.40,0.00,0.09,0
724,121,1000.00,369.60,1369.60,68.46,301.14,0.10,1
725,121,1000.00,1369.60,2369.60,93.34,1276.26,0.33,1
726,121,1000.00,2369.60,3369.60,0.00,2177.98,0.28,1
727,121,1000.00,3369.60,4369.60,1277.24,2092.36,0.43,1
728,121,1000.00,4369.60,5369.60,678.50,3691.10,0.15,1
729,121,1000.00,5369.60,6369.60,1853.98,3515.62,0.41,1
730,121,1000.00,6369.60,7369.60,3184.80,3184.80,0.13,1
731,121,-1000.00,5369.60,6369.60,6826.47,0.00,0.14,0
732,121,1000.00,6369.60,7369.60,2311.71,2877.12,0.41,1
733,121,-1000.00,5369.60,6369.60,4254.91,3114.69,0.16,0
734,121,1000.00,6369.60,7369.60,1712.64,4656.96,0.38,1
735,121,1000.00,7369.60,8369.60,3684.80,3684.80,0.04,1
736,121,1000.00,8369.60,9369.60,3199.08,5170.52,0.38,1
737,121,-1000.00,7369.60,8369.60,4260.12,2226.42,0.34,0
738,121,-1000.00,6369.60,7369.60,5362.33,3007.27,0.06,0
739,121,1000.00,7369.60,8369.60,3657.90,3711.70,0.39,1
740,121,-1000.00,6369.60,7369.60,6895.40,1474.20,0.14,0
741,121,1000.00,7369.60,8369.60,0.00,7369.60,0.11,1
742,121,-1000.00,6369.60,7369.60,2769.88,1739.37,0.32,0
743,121,1000.00,7369.60,8369.60,62.49,1739.92,0.26,1
744,121,1000.00,8369.60,9369.60,2714.01,4974.40,0.42,1
745,121,1000.00,9369.60,10369.60,0.00,7529.81,0.27,1
746,121,1000.00,10369.60,11369.60,3490.81,5325.29,0.42,1
747,121,1000.00,11369.60,12369.60,2079.00,8246.82,0.30,1
748,121,-1000.00,10369.60,11369.60,4866.66,1298.91,0.30,0
749,121,1000.00,11369.60,12369.60,5437.89,5931.71,0.12,1
750,121,1000.00,12369.60,13369.60,156.06,9375.25,0.31,1
751,121,1000.00,13369.60,14369.60,6498.87,6870.73,0.35,1
752,121,-1000.00,12369.60,13369.60,14369.60,0.00,0.09,0
753,122,-25.61,-25.61,974.39,0.00,25.61,0.12,0
754,122,-974.39,-1000.00,0.00,409.18,565.21,0.18,0
755,123,-1000.00,-1000.00,0.00,806.19,161.23,0.20,0
756,124,1000.00,1000.00,2000.00,741.66,226.90,0.28,1
757,124,-1000.00,0.00,1000.00,708.42,1291.58,0.41,0
758,124,-1000.00,-1000.00,0.00,500.00,500.00,0.02,0
759,125,-1000.00,-1000.00,0.00,481.87,518.13,0.11,0
760,126,-1000.00,-1000.00,0.00,406.29,593.71,0.39,0
761,127,-1000.00,-1000.00,0.00,130.93,192.13,0.30,0
762,128,-1000.00,-1000.00,0.00,479.00,521.00,0.40,0
763,129,1000.00,1000.00,2000.00,675.50,211.34,0.25,1
764,129,-1000.00,0.00,1000.00,590.78,1409.22,0.16,0
765,129,1000.00,1000.00,2000.00,660.72,339.28,0.29,1
766,129,1000.00,2000.00,3000.00,1384.69,615.31,0.09,1
767,129,-714.34,1285.66,2285.66,0.00,714.34,0.17,0
768,129,1000.00,2285.66,3285.66,259.31,0.00,0.03,1
769,129,1000.00,3285.66,4285.66,1645.97,1639.68,0.27,1
770,129,-1000.00,2285.66,3285.66,0.00,3180.45,0.26,0
771,129,1000.00,3285.66,4285.66,3285.66,0.00,0.05,1
772,129,1000.00,4285.66,5285.66,4285.66,0.00,0.02,1
773,129,-1000.00,3285.66,4285.66,374.55,4339.98,0.36,0
774,129,-1000.00,2285.66,3285.66,0.00,1426.79,0.19,0
775,129,1000.00,3285.66,4285.66,1732.05,1553.61,0.03,1
776,129,-1000.00,2285.66,3285.66,1278.75,3006.90,0.44,0
777,129,1000.00,3285.66,4285.66,1827.71,1457.94,0.41,1
778,129,-1000.00,2285.66,3285.66,0.00,4285.66,0.27,0
779,129,-1000.00,1285.66,2285.66,2056.08,870.65,0.37,0
780,129,0.00,1285.66,2285.66,0.00,0.00,0.08,0
781,129,-1000.00,285.66,1285.66,1944.47,341.19,0.04,0
782,129,-1000.00,-714.34,285.66,590.82,694.84,0.27,0
783,129,-1000.00,-1714.34,-714.34,6.14,279.52,0.08,0
784,130,1000.00,1000.00,2000.00,245.97,754.03,0.21,1
785,130,1000.00,2000.00,3000.00,905.84,1094.16,0.35,1
786,130,-429.05,1570.95,2570.95,429.05,0.00,0.12,0
787,130,1000.00,2570.95,3570.95,257.07,2313.88,0.22,1
788,130,-1000.00,1570.95,2570.95,2688.61,0.00,0.20,0
789,130,1000.00,2570.95,3570.95,0.00,2570.95,0.24,1
790,130,1000.00,3570.95,4570.95,637.68,2933.27,0.40,1
791,130,-1000.00,2570.95,3570.95,4570.95,0.00,0.11,0
792,130,1000.00,3570.95,4570.95,0.00,3054.26,0.17,1
793,130,-1000.00,2570.95,3570.95,1563.87,1523.56,0.37,0
794,130,1000.00,3570.95,4570.95,1369.64,2201.31,0.19,1
795,130,1000.00,4570.95,5570.95,1164.61,3406.35,0.34,1
796,130,-1000.00,3570.95,4570.95,2951.23,2619.73,0.26,0
797,130,-1000.00,2570.95,3570.95,2569.76,2001.20,0.39,0
798,130,1000.00,3570.95,4570.95,0.00,70.74,0.16,1
799,130,1000.00,4570.95,5570.95,0.00,546.13,0.22,1
800,130,1000.00,5570.95,6570.95,2573.84,2890.29,0.43,1
801,130,1000.00,6570.95,7570.95,2781.55,3789.40,0.43,1
802,130,1000.00,7570.95,8570.95,217.89,5974.74,0.28,1
803,130,1000.00,8570.95,9570.95,2144.55,6426.40,0.27,1
804,130,1000.00,9570.95,10570.95,3819.18,5751.77,0.43,1
805,130,-1000.00,8570.95,9570.95,2685.48,2142.62,0.28,0
806,130,1000.00,9570.95,10570.95,2511.82,7059.13,0.26,1
807,130,1000.00,10570.95,11570.95,4760.05,5810.90,0.44,1
808,130,1000.00,11570.95,12570.95,0.00,7439.60,0.12,1
809,130,1000.00,12570.95,13570.95,0.00,10658.38,0.18,1
810,130,1000.00,13570.95,14570.95,0.00,13570.95,0.18,1
811,130,-1000.00,12570.95,13570.95,3357.34,0.00,0.19,0
812,130,1000.00,13570.95,14570.95,5232.32,6159.47,0.41,1
813,130,-1000.00,12570.95,13570.95,9423.28,5147.68,0.29,0
814,130,1000.00,13570.95,14570.95,0.00,10719.97,0.20,1
815,130,1000.00,14570.95,15570.95,0.00,4766.94,0.24,1
816,130,1000.00,15570.95,16570.95,7726.67,7844.28,0.39,1
817,130,-1000.00,14570.95,15570.95,8867.88,7703.08,0.39,0
818,130,1000.00,15570.95,16570.95,6573.98,8996.97,0.10,1
819,130,-1000.00,14570.95,15570.95,8511.52,8059.44,0.35,0
820,130,-1000.00,13570.95,14570.95,15570.95,0.00,0.14,0
821,130,1000.00,14570.95,15570.95,0.00,14570.95,0.00,1
822,130,-1000.00,13570.95,14570.95,9236.68,3601.57,0.35,0
823,130,1000.00,14570.95,15570.95,2489.48,6746.23,0.36,1
824,130,-1000.00,13570.95,14570.95,7951.93,7619.03,0.44,0
825,130,-1000.00,12570.95,13570.95,6081.48,2419.12,0.32,0
826,130,-1000.00,11570.95,12570.95,3498.61,2296.44,0.28,0
827,130,-984.39,10586.56,11586.56,984.39,0.00,0.16,0
828,130,1000.00,11586.56,12586.56,0.00,11586.56,0.04,1
829,130,1000.00,12586.56,13586.56,1864.40,10722.16,0.01,1
830,130,-1000.00,11586.56,12586.56,11485.48,2101.08,0.22,0
831,130,-1000.00,10586.56,11586.56,5894.69,452.60,0.27,0
832,130,-1000.00,9586.56,10586.56,3767.27,2581.06,0.33,0
833,130,-1000.00,8586.56,9586.56,0.00,8240.90,0.22,0
834,130,-1000.00,7586.56,8586.56,4547.33,5039.23,0.38,0
835,130,-1000.00,6586.56,7586.56,4293.28,4293.28,0.15,0
836,130,-1000.00,5586.56,6586.56,1961.95,5624.61,0.36,0
837,130,-1000.00,4586.56,5586.56,3293.28,3293.28,0.01,0
838,130,-1000.00,3586.56,4586.56,3066.65,2519.91,0.31,0
839,130,-1000.00,2586.56,3586.56,1745.30,2841.26,0.43,0
840,130,-1000.00,1586.56,2586.56,0.00,3586.56,0.05,0
841,130,-1000.00,586.56,1586.56,2196.44,0.00,0.11,0
842,130,-1000.00,-413.44,586.56,339.85,1246.71,0.08,0
843,130,-586.56,-1000.00,0.00,259.79,326.78,0.39,0
844,131,-1000.00,-1000.00,0.00,487.79,512.21,0.13,0
845,132,-1000.00,-1000.00,0.00,112.14,0.00,0.05,0
846,133,-1000.00,-1000.00,0.00,500.00,500.00,0.05,0
847,134,-1000.00,-1000.00,0.00,629.24,194.16,0.29,0
848,135,-1000.00,-1000.00,0.00,394.67,605.33,0.00,0
849,136,1000.00,1000.00,2000.00,490.03,0.00,0.04,1
850,136,1000.00,2000.00,3000.00,583.36,530.80,0.35,1
851,136,0.00,2000.00,3000.00,0.00,0.00,0.00,0
852,136,-971.69,1028.31,2028.31,79.69,892.00,0.33,0
853,136,1000.00,2028.31,3028.31,1227.87,800.44,0.30,1
854,136,-1000.00,1028.31,2028.31,1514.16,1514.16,0.24,0
855,136,1000.00,2028.31,3028.31,1050.33,977.98,0.22,1
856,136,-1000.00,1028.31,2028.31,1460.74,1567.57,0.35,0
857,136,-1000.00,28.31,1028.31,700.48,1327.83,0.29,0
858,136,-1000.00,-971.69,28.31,514.16,514.16,0.07,0
859,136,1000.00,28.31,1028.31,28.31,0.00,0.13,1
860,136,-1000.00,-971.69,28.31,429.67,598.64,0.25,0
861,136,-5.61,-977.30,22.70,0.00,5.61,0.10,0
862,136,-22.70,-1000.00,0.00,10.03,12.68,0.11,0
863,137,1000.00,1000.00,2000.00,425.99,574.01,0.43,1
864,137,-752.31,247.69,1247.69,746.73,5.58,0.22,0
865,137,-1000.00,-752.31,247.69,789.44,458.25,0.32,0
866,137,-83.60,-835.91,164.09,75.96,7.64,0.25,0
867,137,-164.09,-1000.00,0.00,164.09,0.00,0.01,0
868,138,-1000.00,-1000.00,0.00,169.41,830.59,0.36,0
869,139,-643.87,-643.87,356.13,0.00,643.87,0.24,0
870,139,-321.41,-965.27,34.73,116.24,205.16,0.43,0
871,139,-1000.00,-1965.27,-965.27,34.73,0.00,0.06,0
872,140,1000.00,1000.00,2000.00,0.00,650.64,0.20,1
873,140,-1000.00,0.00,1000.00,1170.14,829.86,0.36,0
874,140,1000.00,1000.00,2000.00,0.00,393.25,0.06,1
875,140,1000.00,2000.00,3000.00,0.00,1022.78,0.20,1
876,140,1000.00,3000.00,4000.00,1500.00,1500.00,0.02,1
877,140,-1000.00,2000.00,3000.00,2159.75,1840.25,0.06,0
878,140,1000.00,3000.00,4000.00,1336.25,1663.75,0.18,1
879,140,-1000.00,2000.00,3000.00,2736.67,1263.33,0.08,0
880,140,1000.00,3000.00,4000.00,0.00,3000.00,0.07,1
881,140,1000.00,4000.00,5000.00,0.00,3494.09,0.05,1
882,140,1000.00,5000.00,6000.00,632.52,4148.99,0.32,1
883,140,1000.00,6000.00,7000.00,2485.26,3514.74,0.44,1
884,140,1000.00,7000.00,8000.00,2325.70,4674.30,0.28,1
885,140,1000.00,8000.00,9000.00,388.22,7611.78,0.07,1
886,140,1000.00,9000.00,10000.00,3910.68,5089.32,0.44,1
887,140,-1000.00,8000.00,9000.00,6135.34,3864.66,0.31,0
888,140,1000.00,9000.00,10000.00,1624.84,2052.33,0.30,1
889,140,1000.00,10000.00,11000.00,4781.25,5218.75,0.42,1
890,140,1000.00,11000.00,12000.00,0.00,3942.40,0.23,1
891,140,-1000.00,10000.00,11000.00,7016.47,4983.53,0.30,0
892,140,1000.00,11000.00,12000.00,5500.00,5500.00,0.02,1
893,140,1000.00,12000.00,13000.00,278.15,11721.85,0.19,1
894,140,0.00,12000.00,13000.00,0.00,0.00,0.07,0
895,140,1000.00,13000.00,14000.00,6500.00,6500.00,0.02,1
896,140,1000.00,14000.00,15000.00,6095.55,7904.45,0.23,1
897,140,1000.00,15000.00,16000.00,4248.17,4901.16,0.39,1
898,140,1000.00,16000.00,17000.00,0.00,8887.99,0.25,1
899,140,1000.00,17000.00,18000.00,1940.89,9216.22,0.37,1
900,140,1000.00,18000.00,19000.00,6788.33,11211.67,0.18,1
901,140,1000.00,19000.00,20000.00,0.00,5487.87,0.19,1
902,140,1000.00,20000.00,21000.00,3875.94,16124.06,0.32,1
903,140,-1000.00,19000.00,20000.00,12742.27,8257.73,0.36,0
904,140,1000.00,20000.00,21000.00,9355.88,10644.12,0.40,1
905,140,1000.00,21000.00,22000.00,9564.32,11435.68,0.22,1
906,140,1000.00,22000.00,23000.00,0.00,22000.00,0.09,1
907,140,-1000.00,21000.00,22000.00,19114.77,3885.23,0.17,0
908,140,-1000.00,20000.00,21000.00,6594.41,0.00,0.10,0
909,140,-1000.00,19000.00,20000.00,10993.67,10006.33,0.31,0
910,140,-1000.00,18000.00,19000.00,13314.44,6685.56,0.28,0
911,140,-1000.00,17000.00,18000.00,16618.59,2381.41,0.19,0
912,140,1000.00,18000.00,19000.00,3186.17,14813.83,0.11,1
913,140,1000.00,19000.00,20000.00,6936.20,12063.80,0.42,1
914,140,1000.00,20000.00,21000.00,0.00,9538.08,0.28,1
915,140,1000.00,21000.00,22000.00,10117.59,10882.41,0.36,1
916,140,1000.00,22000.00,23000.00,3390.04,15601.08,0.32,1
917,141,-1000.00,-1000.00,0.00,0.00,1000.00,0.12,0
918,142,1000.00,1000.00,2000.00,0.00,323.77,0.27,1
919,142,1000.00,2000.00,3000.00,879.29,1120.71,0.21,1
920,142,-1000.00,1000.00,2000.00,3000.00,0.00,0.04,0
921,142,1000.00,2000.00,3000.00,0.00,263.65,0.09,1
922,142,-1000.00,1000.00,2000.00,1899.99,1100.01,0.36,0
923,142,1000.00,2000.00,3000.00,611.71,1388.29,0.44,1
924,142,1000.00,3000.00,4000.00,533.39,1026.32,0.33,1
925,142,1000.00,4000.00,5000.00,1280.85,2719.15,0.41,1
926,142,1000.00,5000.00,6000.00,2182.65,2817.35,0.44,1
927,142,-1000.00,4000.00,5000.00,6000.00,0.00,0.07,0
928,142,-1000.00,3000.00,4000.00,1203.31,585.76,0.27,0
929,142,1000.00,4000.00,5000.00,1669.72,2330.28,0.37,1
930,142,-1000.00,3000.00,4000.00,2594.43,1771.30,0.37,0
931,142,-55.25,2944.75,3944.75,51.77,3.48,0.18,0
932,142,0.00,2944.75,3944.75,0.00,0.00,0.05,0
933,142,1000.00,3944.75,4944.75,1147.08,2797.67,0.29,1
934,142,1000.00,4944.75,5944.75,571.30,3141.18,0.34,1
935,142,0.00,4944.75,5944.75,0.00,0.00,0.00,0
936,142,1000.00,5944.75,6944.75,2447.92,3496.83,0.38,1
937,142,1000.00,6944.75,7944.75,1157.13,5787.62,0.19,1
938,142,1000.00,7944.75,8944.75,0.00,7944.75,0.01,1
939,142,1000.00,8944.75,9944.75,1004.68,7279.31,0.29,1
940,142,1000.00,9944.75,10944.75,4972.38,4972.38,0.13,1
941,142,1000.00,10944.75,11944.75,1470.54,9474.22,0.32,1
942,142,-1000.00,9944.75,10944.75,10399.71,0.00,0.27,0
943,142,-1000.00,8944.75,9944.75,2132.99,0.00,0.14,0
944,142,-1000.00,7944.75,8944.75,7482.22,2462.53,0.25,0
945,142,-1000.00,6944.75,7944.75,4472.38,4472.38,0.06,0
946,142,-1000.00,5944.75,6944.75,4491.92,3452.83,0.41,0
947,142,-1000.00,4944.75,5944.75,1985.86,4958.89,0.42,0
948,142,-1000.00,3944.75,4944.75,2237.28,2089.63,0.37,0
949,142,-1000.00,2944.75,3944.75,202.05,1281.74,0.21,0
950,142,-1000.00,1944.75,2944.75,1525.07,2419.69,0.42,0
951,142,-1000.00,944.75,1944.75,1062.85,1881.91,0.37,0
952,142,-123.54,821.21,1821.21,0.00,123.54,0.09,0
953,142,-1000.00,-178.79,821.21,0.00,1821.21,0.17,0
954,142,-1000.00,-1178.79,-178.79,547.63,273.58,0.38,0
955,143,1000.00,1000.00,2000.00,500.00,500.00,0.06,1
956,143,1000.00,2000.00,3000.00,523.12,1448.86,0.43,1
957,143,1000.00,3000.00,4000.00,23.13,2318.83,0.33,1
958,143,1000.00,4000.00,5000.00,0.00,3595.96,0.22,1
959,143,-1000.00,3000.00,4000.00,2780.85,2219.15,0.30,0
960,143,1000.00,4000.00,5000.00,1678.83,2321.17,0.42,1
961,143,-1000.00,3000.00,4000.00,2793.27,2206.73,0.42,0
962,143,1000.00,4000.00,5000.00,2000.00,2000.00,0.12,1
963,143,-1000.00,3000.00,4000.00,2080.38,563.50,0.30,0
964,143,1000.00,4000.00,5000.00,2000.00,2000.00,0.03,1
965,143,1000.00,5000.00,6000.00,0.00,903.34,0.18,1
966,143,-1000.00,4000.00,5000.00,4309.74,1690.26,0.12,0
967,143,1000.00,5000.00,6000.00,2500.00,2500.00,0.23,1
968,143,1000.00,6000.00,7000.00,0.00,6000.00,0.11,1
969,143,1000.00,7000.00,8000.00,891.35,6108.65,0.28,1
970,143,0.00,7000.00,8000.00,0.00,0.00,0.00,0
971,143,1000.00,8000.00,9000.00,0.00,8000.00,0.26,1
972,143,-1000.00,7000.00,8000.00,5596.79,3403.21,0.37,0
973,143,1000.00,8000.00,9000.00,0.00,5191.31,0.15,1
974,143,1000.00,9000.00,10000.00,0.00,9000.00,0.01,1
975,143,0.00,9000.00,10000.00,0.00,0.00,0.02,0
976,143,-1000.00,8000.00,9000.00,10000.00,0.00,0.04,0
977,143,1000.00,9000.00,10000.00,0.00,9000.00,0.06,1
978,143,1000.00,10000.00,11000.00,4919.66,5080.34,0.14,1
979,143,1000.00,11000.00,12000.00,3353.99,7646.01,0.26,1
980,143,-1000.00,10000.00,11000.00,12000.00,0.00,0.04,0
981,143,1000.00,11000.00,12000.00,4291.23,6708.77,0.39,1
982,143,-1000.00,10000.00,11000.00,4007.87,0.00,0.15,0
983,143,1000.00,11000.00,12000.00,4822.78,6177.22,0.36,1
984,143,1000.00,12000.00,13000.00,4973.37,7026.63,0.38,1
985,143,-1000.00,11000.00,12000.00,10195.78,0.00,0.13,0
986,143,-1000.00,10000.00,11000.00,7993.66,4006.34,0.39,0
987,143,1000.00,11000.00,12000.00,4193.24,6806.76,0.11,1
988,143,-1000.00,10000.00,11000.00,7480.63,4519.37,0.12,0
989,143,1000.00,11000.00,12000.00,4605.91,6394.09,0.08,1
990,143,1000.00,12000.00,13000.00,104.31,9982.70,0.32,1
991,143,-1000.00,11000.00,12000.00,6246.41,6005.05,0.40,0
992,143,1000.00,12000.00,13000.00,0.00,12000.00,0.17,1
993,143,1000.00,13000.00,14000.00,1275.85,4703.29,0.30,1
994,143,1000.00,14000.00,15000.00,0.00,14000.00,0.25,1
995,143,1000.00,15000.00,16000.00,6037.59,8962.41,0.40,1
996,143,1000.00,16000.00,17000.00,7920.52,8079.48,0.32,1
997,143,1000.00,17000.00,18000.00,6075.04,10924.96,0.01,1
998,143,-1000.00,16000.00,17000.00,16238.59,1761.41,0.08,0
999,143,-1000.00,15000.00,16000.00,9945.64,7054.36,0.26,0
1000,143,1000.00,16000.00,17000.00,2831.33,13168.67,0.15,1
1001,144,-654.74,-654.74,345.26,113.32,541.41,0.40,0
1002,144,-281.69,-936.43,63.57,0.00,281.69,0.28,0
1003,144,-63.57,-1000.00,0.00,30.74,32.83,0.32,0
1004,145,1000.00,1000.00,2000.00,210.43,789.57,0.33,1
1005,145,1000.00,2000.00,3000.00,867.04,1132.96,0.41,1
1006,145,1000.00,3000.00,4000.00,1500.00,1500.00,0.13,1
1007,145,-1000.00,2000.00,3000.00,1541.80,0.00,0.23,0
1008,145,-915.11,1084.89,2084.89,915.11,0.00,0.22,0
1009,145,1000.00,2084.89,3084.89,765.94,1318.95,0.38,1
1010,145,1000.00,3084.89,4084.89,105.27,1523.13,0.33,1
1011,145,1000.00,4084.89,5084.89,1456.03,2628.85,0.32,1
1012,145,1000.00,5084.89,6084.89,2461.71,2623.18,0.13,1
1013,145,-1000.00,4084.89,5084.89,3827.36,2257.52,0.28,0
1014,145,1000.00,5084.89,6084.89,0.00,5084.89,0.01,1
1015,145,1000.00,6084.89,7084.89,1134.59,4950.30,0.30,1
1016,145,1000.00,7084.89,8084.89,1778.65,5306.23,0.35,1
1017,145,1000.00,8084.89,9084.89,2192.18,5892.70,0.37,1
1018,145,0.00,8084.89,9084.89,0.00,0.00,0.09,0
1019,145,-1000.00,7084.89,8084.89,5164.36,3920.53,0.40,0
1020,145,1000.00,8084.89,9084.89,2623.45,5461.44,0.41,1
1021,145,1000.00,9084.89,10084.89,0.00,994.40,0.21,1
1022,145,-1000.00,8084.89,9084.89,5765.62,4319.27,0.36,0
1023,145,-1000.00,7084.89,8084.89,9084.89,0.00,0.15,0
1024,145,1000.00,8084.89,9084.89,4042.44,4042.44,0.04,1
1025,145,1000.00,9084.89,10084.89,1845.34,7043.47,0.40,1
1026,145,-1000.00,8084.89,9084.89,6303.24,1944.51,0.34,0
1027,145,1000.00,9084.89,10084.89,1300.12,5513.44,0.40,1
1028,145,1000.00,10084.89,11084.89,0.00,8491.51,0.28,1
1029,145,-1000.00,9084.89,10084.89,6728.32,0.00,0.20,0
1030,145,-1000.00,8084.89,9084.89,4373.61,0.00,0.02,0
1031,145,1000.00,9084.89,10084.89,0.00,1033.65,0.06,1
1032,145,-1000.00,8084.89,9084.89,5722.29,0.00,0.03,0
1033,145,-1000.00,7084.89,8084.89,9084.89,0.00,0.15,0
1034,145,1000.00,8084.89,9084.89,2019.21,6065.68,0.33,1
1035,145,-1000.00,7084.89,8084.89,3452.46,1113.11,0.29,0
1036,145,1000.00,8084.89,9084.89,0.00,6646.44,0.28,1
1037,145,1000.00,9084.89,10084.89,4542.44,4542.44,0.09,1
1038,145,-1000.00,8084.89,9084.89,7977.35,2107.53,0.23,0
1039,145,-1000.00,7084.89,8084.89,5256.24,0.00,0.27,0
1040,145,1000.00,8084.89,9084.89,3886.58,4198.30,0.44,1
1041,145,-1000.00,7084.89,8084.89,5010.49,1438.05,0.33,0
1042,145,1000.00,8084.89,9084.89,3995.17,4089.72,0.21,1
1043,146,0.00,0.00,1000.00,0.00,0.00,0.04,0
1044,146,-244.73,-244.73,755.27,0.00,244.73,0.23,0
1045,146,-1000.00,-1244.73,-244.73,525.78,229.49,0.20,0
1046,147,-637.89,-637.89,362.11,0.00,637.89,0.21,0
1047,147,-338.65,-976.54,23.46,0.00,338.65,0.11,0
1048,147,-5.19,-981.72,18.28,0.00,5.19,0.17,0
1049,147,-1000.00,-1981.72,-981.72,13.10,5.18,0.20,0
1050,148,-1000.00,-1000.00,0.00,324.60,13.52,0.24,0
1051,149,-598.81,-598.81,401.19,0.00,598.81,0.24,0
1052,149,-106.80,-705.61,294.39,0.00,106.80,0.26,0
1053,149,-294.39,-1000.00,0.00,142.18,152.20,0.19,0
1054,150,-405.73,-405.73,594.27,110.11,295.62,0.32,0
1055,150,-361.85,-767.58,232.42,0.00,361.85,0.11,0
1056,150,-1000.00,-1767.58,-767.58,67.84,38.39,0.34,0
1057,151,-1000.00,-1000.00,0.00,0.00,1000.00,0.11,0
1058,152,1000.00,1000.00,2000.00,236.98,123.66,0.24,1
1059,152,-1000.00,0.00,1000.00,775.52,1224.48,0.43,0
1060,152,1000.00,1000.00,2000.00,888.15,111.85,0.14,1
1061,152,1000.00,2000.00,3000.00,1050.38,949.62,0.20,1
1062,152,1000.00,3000.00,4000.00,1896.28,1103.72,0.19,1
1063,152,1000.00,4000.00,5000.00,2509.09,1490.91,0.15,1
1064,152,-1000.00,3000.00,4000.00,986.83,4013.17,0.42,0
1065,152,1000.00,4000.00,5000.00,1932.87,0.00,0.17,1
1066,152,-1000.00,3000.00,4000.00,2500.00,2500.00,0.12,0
1067,152,0.00,3000.00,4000.00,0.00,0.00,0.01,0
1068,152,1000.00,4000.00,5000.00,4000.00,0.00,0.11,1
1069,152,-1000.00,3000.00,4000.00,1949.05,3050.95,0.39,0
1070,152,-1000.00,2000.00,3000.00,0.00,3267.06,0.16,0
1071,152,-1000.00,1000.00,2000.00,358.48,2421.43,0.34,0
1072,152,-1000.00,0.00,1000.00,1000.00,1000.00,0.01,0
1073,152,-1000.00,-1000.00,0.00,423.80,576.20,0.36,0
1074,153,-1000.00,-1000.00,0.00,715.56,75.53,0.16,0
1075,154,-1000.00,-1000.00,0.00,326.14,673.86,0.27,0
1076,155,-245.67,-245.67,754.33,245.67,0.00,0.00,0
1077,155,-754.33,-1000.00,0.00,447.36,306.97,0.38,0
1078,156,-1000.00,-1000.00,0.00,334.01,665.99,0.38,0
1079,157,1000.00,1000.00,2000.00,0.00,298.77,0.09,1
1080,157,1000.00,2000.00,3000.00,0.00,1318.86,0.14,1
1081,157,-1000.00,1000.00,2000.00,1904.22,1095.78,0.13,0
1082,157,1000.00,2000.00,3000.00,577.37,1422.63,0.24,1
1083,157,1000.00,3000.00,4000.00,1314.88,1685.12,0.43,1
1084,157,-1000.00,2000.00,3000.00,2019.56,1980.44,0.18,0
1085,157,1000.00,3000.00,4000.00,371.97,1053.95,0.30,1
1086,157,-1000.00,2000.00,3000.00,1994.05,0.00,0.07,0
1087,157,-1000.00,1000.00,2000.00,1500.00,1500.00,0.01,0
1088,157,-986.92,13.08,1013.08,986.92,0.00,0.10,0
1089,157,-1000.00,-986.92,13.08,0.00,603.94,0.25,0
1090,157,-1000.00,-1986.92,-986.92,5.75,7.33,0.43,0
1091,158,-227.38,-227.38,772.62,0.00,227.38,0.05,0
1092,158,-225.14,-452.52,547.48,31.04,194.10,0.27,0
1093,158,-547.48,-1000.00,0.00,196.26,351.22,0.34,0
1094,159,-659.41,-659.41,340.59,105.59,553.82,0.39,0
1095,159,-340.59,-1000.00,0.00,89.43,251.16,0.43,0
1096,160,1000.00,1000.00,2000.00,500.00,500.00,0.12,1
1097,160,1000.00,2000.00,3000.00,1000.00,1000.00,0.10,1
1098,160,-1000.00,1000.00,2000.00,1842.90,1157.10,0.04,0
1099,160,1000.00,2000.00,3000.00,380.75,1619.25,0.28,1
1100,160,1000.00,3000.00,4000.00,1500.00,1500.00,0.19,1
1101,160,1000.00,4000.00,5000.00,2000.00,2000.00,0.06,1
1102,160,-1000.00,3000.00,4000.00,3398.94,1601.06,0.27,0
1103,160,1000.00,4000.00,5000.00,0.00,2712.45,0.19,1
1104,160,-1000.00,3000.00,4000.00,2306.04,1146.24,0.33,0
1105,160,1000.00,4000.00,5000.00,0.00,3077.07,0.23,1
1106,160,1000.00,5000.00,6000.00,2374.57,2625.43,0.32,1
1107,160,1000.00,6000.00,7000.00,2188.66,3811.34,0.11,1
1108,160,1000.00,7000.00,8000.00,153.54,3012.92,0.22,1
1109,160,-1000.00,6000.00,7000.00,4510.62,3489.38,0.07,0
1110,160,1000.00,7000.00,8000.00,3478.21,3521.79,0.35,1
1111,160,1000.00,8000.00,9000.00,0.00,3932.25,0.26,1
1112,160,-1000.00,7000.00,8000.00,4833.87,4166.13,0.42,0
1113,160,-1000.00,6000.00,7000.00,5268.05,2731.95,0.27,0
1114,160,-1000.00,5000.00,6000.00,4047.85,2952.15,0.03,0
1115,160,-1000.00,4000.00,5000.00,1445.32,0.00,0.18,0
1116,160,0.00,4000.00,5000.00,0.00,0.00,0.02,0
1117,160,1000.00,5000.00,6000.00,2139.04,2860.96,0.40,1
1118,160,1000.00,6000.00,7000.00,845.98,980.77,0.28,1
1119,160,1000.00,7000.00,8000.00,1900.15,5099.85,0.08,1
1120,160,1000.00,8000.00,9000.00,4000.00,4000.00,0.00,1
1121,160,1000.00,9000.00,10000.00,1525.50,7122.58,0.38,1
1122,160,-1000.00,8000.00,9000.00,4751.30,3219.82,0.35,0
1123,160,1000.00,9000.00,10000.00,976.14,8023.86,0.21,1
1124,160,1000.00,10000.00,11000.00,0.00,2251.19,0.17,1
1125,160,-1000.00,9000.00,10000.00,10151.66,0.00,0.11,0
1126,160,-1000.00,8000.00,9000.00,4589.56,644.95,0.23,0
1127,160,1000.00,9000.00,10000.00,3292.51,5707.49,0.25,1
1128,160,-1000.00,8000.00,9000.00,7520.36,2479.64,0.17,0
1129,160,1000.00,9000.00,10000.00,2995.09,6004.91,0.37,1
1130,160,1000.00,10000.00,11000.00,5000.00,5000.00,0.07,1
1131,160,-1000.00,9000.00,10000.00,11000.00,0.00,0.08,0
1132,161,-1000.00,-1000.00,0.00,864.30,135.70,0.06,0
1133,162,-857.84,-857.84,142.16,310.74,547.10,0.41,0
1134,162,-95.10,-952.94,47.06,0.00,95.10,0.30,0
1135,162,-1000.00,-1952.94,-952.94,40.10,1.16,0.22,0
1136,163,1000.00,1000.00,2000.00,384.24,595.73,0.40,1
1137,163,1000.00,2000.00,3000.00,857.00,1143.00,0.39,1
1138,163,1000.00,3000.00,4000.00,0.00,2301.25,0.36,1
1139,163,1000.00,4000.00,5000.00,0.00,3364.98,0.23,1
1140,163,1000.00,5000.00,6000.00,2500.00,2500.00,0.11,1
1141,163,1000.00,6000.00,7000.00,2551.88,3448.12,0.31,1
1142,163,1000.00,7000.00,8000.00,499.57,6500.43,0.33,1
1143,163,-1000.00,6000.00,7000.00,6042.94,1957.06,0.29,0
1144,163,1000.00,7000.00,8000.00,2478.16,4521.84,0.16,1
1145,163,-1000.00,6000.00,7000.00,4019.09,3980.91,0.42,0
1146,163,-1000.00,5000.00,6000.00,4667.41,2332.59,0.33,0
1147,163,1000.00,6000.00,7000.00,3000.00,3000.00,0.04,1
1148,163,-1000.00,5000.00,6000.00,5343.75,1656.25,0.08,0
1149,163,1000.00,6000.00,7000.00,0.00,4984.32,0.04,1
1150,163,1000.00,7000.00,8000.00,746.84,6253.16,0.34,1
1151,163,1000.00,8000.00,9000.00,3770.39,4229.61,0.14,1
1152,163,1000.00,9000.00,10000.00,0.00,7826.75,0.32,1
1153,163,-1000.00,8000.00,9000.00,4839.93,0.00,0.20,0
1154,163,-1000.00,7000.00,8000.00,4706.53,4293.47,0.33,0
1155,163,-1000.00,6000.00,7000.00,6830.80,1169.20,0.17,0
1156,163,-1000.00,5000.00,6000.00,4027.35,2972.65,0.22,0
1157,163,1000.00,6000.00,7000.00,3000.00,3000.00,0.23,1
1158,163,-1000.00,5000.00,6000.00,5424.18,0.00,0.14,0
1159,163,-1000.00,4000.00,5000.00,4435.28,1564.72,0.31,0
1160,163,-1000.00,3000.00,4000.00,2303.38,2696.62,0.42,0
1161,163,-1000.00,2000.00,3000.00,347.36,1422.49,0.30,0
1162,163,-1000.00,1000.00,2000.00,0.00,1276.20,0.22,0
1163,163,-1000.00,0.00,1000.00,938.11,1061.89,0.09,0
1164,163,-1000.00,-1000.00,0.00,281.98,718.02,0.44,0
1165,164,-1000.00,-1000.00,0.00,0.00,1000.00,0.02,0
1166,165,-1000.00,-1000.00,0.00,361.23,638.77,0.14,0
1167,166,-1000.00,-1000.00,0.00,500.00,500.00,0.11,0
1168,167,-1000.00,-1000.00,0.00,0.00,1000.00,0.08,0
1169,168,-1000.00,-1000.00,0.00,684.78,315.22,0.23,0
1170,169,-1000.00,-1000.00,0.00,109.23,890.77,0.37,0
1171,170,-1000.00,-1000.00,0.00,168.37,831.63,0.41,0
1172,171,1000.00,1000.00,2000.00,53.43,946.57,0.07,1
1173,171,-1000.00,0.00,1000.00,1071.66,302.84,0.26,0
1174,171,1000.00,1000.00,2000.00,237.60,762.40,0.35,1
1175,171,-1000.00,0.00,1000.00,1124.57,749.92,0.37,0
1176,171,1000.00,1000.00,2000.00,326.65,673.35,0.43,1
1177,171,1000.00,2000.00,3000.00,358.49,1641.51,0.37,1
1178,171,-1000.00,1000.00,2000.00,1712.93,1287.07,0.01,0
1179,171,1000.00,2000.00,3000.00,370.13,940.90,0.38,1
1180,171,1000.00,3000.00,4000.00,1206.51,1793.49,0.28,1
1181,171,-1000.00,2000.00,3000.00,2301.53,1698.47,0.41,0
1182,171,-901.75,1098.25,2098.25,901.75,0.00,0.08,0
1183,171,1000.00,2098.25,3098.25,0.00,1566.30,0.32,1
1184,171,1000.00,3098.25,4098.25,1549.12,1549.12,0.09,1
1185,171,0.00,3098.25,4098.25,0.00,0.00,0.02,0
1186,171,-1000.00,2098.25,3098.25,2419.08,1679.16,0.25,0
1187,171,1000.00,3098.25,4098.25,1549.12,1549.12,0.12,1
1188,171,-1000.00,2098.25,3098.25,1955.46,1242.71,0.34,0
1189,171,1000.00,3098.25,4098.25,1154.72,1943.52,0.31,1
1190,171,1000.00,4098.25,5098.25,1544.79,2553.45,0.38,1
1191,171,1000.00,5098.25,6098.25,0.00,2162.65,0.04,1
1192,171,-1000.00,4098.25,5098.25,4960.57,1137.68,0.16,0
1193,171,-1000.00,3098.25,4098.25,3337.17,1761.08,0.28,0
1194,171,-1000.00,2098.25,3098.25,2159.32,0.00,0.16,0
1195,171,-1000.00,1098.25,2098.25,1698.20,1400.05,0.09,0
1196,171,-1000.00,98.25,1098.25,0.00,2098.25,0.02,0
1197,171,-1000.00,-901.75,98.25,803.43,294.81,0.03,0
1198,171,-69.56,-971.31,28.69,0.00,69.56,0.13,0
1199,171,-24.12,-995.43,4.57,0.00,24.12,0.38,0
1200,171,-1000.00,-1995.43,-995.43,2.72,1.85,0.04,0
1201,172,1000.00,1000.00,2000.00,0.00,1000.00,0.16,1
1202,172,1000.00,2000.00,3000.00,0.00,892.33,0.31,1
1203,172,1000.00,3000.00,4000.00,40.69,2959.31,0.02,1
1204,172,-1000.00,2000.00,3000.00,2847.27,1152.73,0.13,0
1205,172,1000.00,3000.00,4000.00,1287.07,1712.93,0.43,1
1206,172,1000.00,4000.00,5000.00,849.88,3150.12,0.24,1
1207,172,1000.00,5000.00,6000.00,1596.86,3403.14,0.15,1
1208,172,1000.00,6000.00,7000.00,691.87,5308.13,0.12,1
1209,172,1000.00,7000.00,8000.00,790.31,4895.31,0.36,1
1210,172,1000.00,8000.00,9000.00,4000.00,4000.00,0.03,1
1211,172,1000.00,9000.00,10000.00,3223.60,5776.40,0.43,1
1212,172,1000.00,10000.00,11000.00,3834.88,6165.12,0.40,1
1213,172,1000.00,11000.00,12000.00,4664.65,6335.35,0.28,1
1214,172,-1000.00,10000.00,11000.00,2947.66,1056.20,0.24,0
1215,172,-1000.00,9000.00,10000.00,10868.67,0.00,0.04,0
1216,172,1000.00,10000.00,11000.00,0.00,6811.43,0.31,1
1217,172,1000.00,11000.00,12000.00,2852.37,8147.63,0.24,1
1218,172,1000.00,12000.00,13000.00,4723.97,7276.03,0.39,1
1219,172,1000.00,13000.00,14000.00,3395.79,6939.61,0.35,1
1220,172,1000.00,14000.00,15000.00,7000.00,7000.00,0.08,1
1221,172,-1000.00,13000.00,14000.00,8707.97,6292.03,0.43,0
1222,172,-1000.00,12000.00,13000.00,0.00,14000.00,0.06,0
1223,172,-1000.00,11000.00,12000.00,447.16,0.00,0.10,0
1224,172,-1000.00,10000.00,11000.00,0.00,7368.50,0.17,0
1225,172,-1000.00,9000.00,10000.00,5500.00,5500.00,0.25,0
1226,172,-1000.00,8000.00,9000.00,6007.91,3992.09,0.26,0
1227,172,-1000.00,7000.00,8000.00,2840.53,6159.47,0.20,0
1228,172,-1000.00,6000.00,7000.00,0.00,5670.93,0.15,0
1229,172,-1000.00,5000.00,6000.00,2779.00,0.00,0.18,0
1230,172,-1000.00,4000.00,5000.00,1616.31,4383.69,0.07,0
1231,172,-1000.00,3000.00,4000.00,2456.97,2543.03,0.07,0
1232,172,-1000.00,2000.00,3000.00,3613.34,0.00,0.06,0
1233,172,-1000.00,1000.00,2000.00,1500.00,1500.00,0.19,0
1234,172,-1000.00,0.00,1000.00,827.25,253.55,0.27,0
1235,172,-1000.00,-1000.00,0.00,225.46,774.54,0.38,0
1236,173,-1000.00,-1000.00,0.00,718.23,281.77,0.11,0
1237,173,0.00,-1000.00,0.00,0.00,0.00,0.10,1
1238,173,0.00,-1000.00,0.00,0.00,0.00,0.02,1
1239,173,0.00,-1000.00,0.00,0.00,0.00,0.13,1
1240,173,0.00,-1000.00,0.00,0.00,0.00,0.27,1
1241,173,0.00,-1000.00,0.00,0.00,0.00,0.09,1
1242,173,0.02,-999.98,0.02,0.00,0.00,0.29,1
1243,173,1.95,-998.03,1.97,0.01,0.01,0.17,1
1244,173,365.08,-632.96,367.04,0.19,1.78,0.12,1
1245,173,1000.00,367.04,1367.04,153.07,213.97,0.24,1
1246,173,1000.00,1367.04,2367.04,519.30,847.75,0.41,1
1247,173,1000.00,2367.04,3367.04,1112.98,1254.06,0.35,1
1248,173,-1000.00,1367.04,2367.04,2225.91,1141.13,0.18,0
1249,173,-757.06,609.99,1609.99,494.82,262.24,0.23,0
1250,173,1000.00,1609.99,2609.99,316.83,546.32,0.32,1
1251,173,-1000.00,609.99,1609.99,1857.38,752.61,0.33,0
1252,173,-1000.00,-390.01,609.99,1503.28,0.00,0.22,0
1253,173,-1000.00,-1390.01,-390.01,141.39,468.60,0.20,0
1254,174,-1000.00,-1000.00,0.00,387.81,612.19,0.30,0
1255,175,1000.00,1000.00,2000.00,394.56,605.44,0.11,1
1256,175,-1000.00,0.00,1000.00,1737.98,262.02,0.09,0
1257,175,1000.00,1000.00,2000.00,500.00,500.00,0.04,1
1258,175,0.00,1000.00,2000.00,0.00,0.00,0.03,0
1259,175,1000.00,2000.00,3000.00,0.00,673.43,0.18,1
1260,175,-1000.00,1000.00,2000.00,1803.29,0.00,0.03,0
1261,175,-1000.00,0.00,1000.00,1747.74,0.00,0.20,0
1262,175,1000.00,1000.00,2000.00,234.35,569.54,0.41,1
1263,175,-1000.00,0.00,1000.00,1074.44,925.56,0.42,0
1264,175,-1000.00,-1000.00,0.00,516.97,483.03,0.31,0
1265,176,-1000.00,-1000.00,0.00,1000.00,0.00,0.04,0
1266,177,-1000.00,-1000.00,0.00,344.83,655.17,0.23,0
1267,178,-1000.00,-1000.00,0.00,522.54,477.46,0.14,0
1268,178,-0.00,-1000.00,0.00,0.00,0.00,0.20,0
1269,179,-522.70,-522.70,477.30,119.82,402.88,0.35,0
1270,179,-477.30,-1000.00,0.00,164.22,313.08,0.26,0
1271,180,0.00,0.00,1000.00,0.00,0.00,0.06,0
1272,180,-1000.00,-1000.00,0.00,1000.00,0.00,0.02,0
1273,181,-1000.00,-1000.00,0.00,26.20,973.80,0.33,0
1274,182,-1000.00,-1000.00,0.00,0.00,1000.00,0.23,0
1275,183,-1000.00,-1000.00,0.00,68.28,931.72,0.05,0
1276,184,1000.00,1000.00,2000.00,187.14,0.00,0.17,1
1277,184,-1000.00,0.00,1000.00,491.45,599.93,0.31,0
1278,184,-1000.00,-1000.00,0.00,500.00,500.00,0.10,0
1279,185,-1000.00,-1000.00,0.00,755.75,0.00,0.16,0
1280,186,-1000.00,-1000.00,0.00,0.00,1000.00,0.33,0
1281,187,1000.00,1000.00,2000.00,646.26,353.74,0.28,1
1282,187,-1000.00,0.00,1000.00,0.00,2000.00,0.11,0
1283,187,1000.00,1000.00,2000.00,898.83,101.17,0.13,1
1284,187,1000.00,2000.00,3000.00,1141.57,858.43,0.29,1
1285,187,-1000.00,1000.00,2000.00,1053.56,1946.44,0.26,0
1286,187,-1000.00,0.00,1000.00,0.00,1050.53,0.16,0
1287,187,1000.00,1000.00,2000.00,757.71,242.29,0.05,1
1288,187,-1000.00,0.00,1000.00,0.00,2000.00,0.14,0
1289,187,1000.00,1000.00,2000.00,414.88,288.44,0.32,1
1290,187,-1000.00,0.00,1000.00,0.00,2000.00,0.03,0
1291,187,1000.00,1000.00,2000.00,13.97,0.00,0.01,1
1292,187,1000.00,2000.00,3000.00,1734.35,265.65,0.05,1
1293,187,-1000.00,1000.00,2000.00,0.00,2933.18,0.11,0
1294,187,-1000.00,0.00,1000.00,943.10,1056.90,0.37,0
1295,187,-1000.00,-1000.00,0.00,193.95,806.05,0.25,0
1296,188,-1000.00,-1000.00,0.00,538.24,461.76,0.25,0
1297,189,-1000.00,-1000.00,0.00,0.00,1000.00,0.08,0
1298,190,1000.00,1000.00,2000.00,492.85,0.00,0.02,1
1299,190,-1000.00,0.00,1000.00,1000.00,1000.00,0.17,0
1300,190,-1000.00,-1000.00,0.00,341.75,658.25,0.34,0
1301,191,0.00,0.00,1000.00,0.00,0.00,0.05,0
1302,191,-1000.00,-1000.00,0.00,474.25,525.75,0.31,0
1303,192,-1000.00,-1000.00,0.00,454.02,545.98,0.39,0
1304,193,1000.00,1000.00,2000.00,210.16,789.84,0.40,1
1305,193,1000.00,2000.00,3000.00,0.00,1469.18,0.10,1
1306,193,1000.00,3000.00,4000.00,1040.61,1959.39,0.36,1
1307,193,1000.00,4000.00,5000.00,0.00,1282.62,0.02,1
1308,193,-1000.00,3000.00,4000.00,3416.22,673.93,0.29,0
1309,193,-1000.00,2000.00,3000.00,3061.59,843.11,0.29,0
1310,193,-1000.00,1000.00,2000.00,1743.18,1256.82,0.26,0
1311,193,1000.00,2000.00,3000.00,979.91,1020.09,0.41,1
1312,193,-1000.00,1000.00,2000.00,2907.40,0.00,0.15,0
1313,193,1000.00,2000.00,3000.00,218.13,1456.96,0.33,1
1314,193,1000.00,3000.00,4000.00,0.00,3000.00,0.08,1
1315,193,1000.00,4000.00,5000.00,0.00,4000.00,0.03,1
1316,193,-1000.00,3000.00,4000.00,2802.64,2197.36,0.42,0
1317,193,-486.13,2513.87,3513.87,279.77,206.36,0.17,0
1318,193,1000.00,3513.87,4513.87,905.44,2100.83,0.30,1
1319,193,-1000.00,2513.87,3513.87,2295.18,2218.69,0.39,0
1320,193,1000.00,3513.87,4513.87,1756.94,1756.94,0.03,1
1321,193,1000.00,4513.87,5513.87,0.00,4513.87,0.11,1
1322,193,1000.00,5513.87,6513.87,0.00,2454.92,0.17,1
1323,193,-1000.00,4513.87,5513.87,2052.89,4460.98,0.44,0
1324,193,-1000.00,3513.87,4513.87,3135.34,2378.53,0.10,0
1325,193,-1000.00,2513.87,3513.87,1551.71,0.00,0.13,0
1326,193,-1000.00,1513.87,2513.87,0.00,2615.96,0.26,0
1327,193,-1000.00,513.87,1513.87,426.82,2087.05,0.22,0
1328,193,-1000.00,-486.13,513.87,0.00,237.60,0.05,0
1329,193,-82.84,-568.97,431.03,82.84,0.00,0.08,0
1330,193,-1000.00,-1568.97,-568.97,215.52,215.52,0.06,0
1331,194,-867.19,-867.19,132.81,423.72,443.47,0.39,0
1332,194,-132.81,-1000.00,0.00,25.38,107.43,0.42,0
1333,195,-290.63,-290.63,709.37,101.14,189.49,0.24,0
1334,195,-79.15,-369.78,630.22,0.00,79.15,0.16,0
1335,195,-630.22,-1000.00,-0.00,256.38,373.84,0.43,0
1336,196,-1000.00,-1000.00,0.00,389.98,610.02,0.22,0
1337,197,-122.10,-122.10,877.90,0.00,122.10,0.07,0
1338,197,-522.11,-644.21,355.79,0.00,522.11,0.15,0
1339,197,-355.79,-1000.00,0.00,127.97,227.82,0.44,0
1340,198,-1000.00,-1000.00,0.00,456.53,543.47,0.16,0
1341,199,-1000.00,-1000.00,0.00,199.49,800.51,0.14,0
1342,200,-827.34,-827.34,172.66,562.35,265.00,0.31,0
1343,200,0.00,-827.34,172.66,0.00,0.00,0.09,0
1344,200,1000.00,172.66,1172.66,15.34,157.32,0.16,1
1345,200,-1000.00,-827.34,172.66,665.66,506.99,0.29,0
1346,200,1000.00,172.66,1172.66,63.42,109.24,0.10,1
1347,200,1000.00,1172.66,2172.66,369.86,802.79,0.39,1
1348,200,-1000.00,172.66,1172.66,2085.69,0.00,0.08,0
1349,200,1000.00,1172.66,2172.66,238.20,934.46,0.38,1
1350,200,1000.00,2172.66,3172.66,356.32,1816.34,0.34,1
1351,200,-830.01,1342.65,2342.65,830.01,0.00,0.01,0
1352,200,-1000.00,342.65,1342.65,1250.80,1091.85,0.34,0
1353,200,-699.16,-356.51,643.49,446.76,252.41,0.26,0
1354,200,-174.27,-530.79,469.21,174.27,0.00,0.10,0
1355,200,1000.00,469.21,1469.21,223.41,245.80,0.08,1
1356,200,1000.00,1469.21,2469.21,420.02,1049.19,0.42,1
1357,200,-1000.00,469.21,1469.21,1401.19,1068.02,0.11,0
1358,200,1000.00,1469.21,2469.21,0.00,1440.27,0.16,1
1359,200,-1000.00,469.21,1469.21,1325.13,677.12,0.33,0
1360,200,1000.00,1469.21,2469.21,687.63,781.59,0.34,1
1361,200,-1000.00,469.21,1469.21,1138.47,1330.74,0.39,0
1362,200,-1000.00,-530.79,469.21,575.18,894.04,0.38,0
1363,200,-1000.00,-1530.79,-530.79,356.85,112.37,0.03,0
1364,201,-1000.00,-1000.00,0.00,0.00,1000.00,0.00,0
1365,202,-1000.00,-1000.00,0.00,47.43,952.57,0.23,0
1366,203,-882.31,-882.31,117.69,0.00,882.31,0.35,0
1367,203,-1000.00,-1882.31,-882.31,65.43,52.26,0.12,0
1368,204,-1000.00,-1000.00,0.00,506.27,493.73,0.29,0
1369,205,-690.23,-690.23,309.77,332.62,357.61,0.33,0
1370,205,-309.77,-1000.00,0.00,0.00,309.77,0.09,0
1371,206,-948.92,-948.92,51.08,357.55,591.37,0.41,0
1372,206,-51.08,-1000.00,0.00,25.54,25.54,0.08,0
1373,207,-1000.00,-1000.00,0.00,500.00,500.00,0.10,0
1374,208,-1000.00,-1000.00,0.00,717.83,282.17,0.18,0
1375,209,-1000.00,-1000.00,0.00,738.12,261.88,0.20,0
1376,210,-1000.00,-1000.00,0.00,446.28,553.72,0.36,0
1377,211,-811.06,-811.06,188.94,0.00,811.06,0.16,0
1378,211,-1000.00,-1811.06,-811.06,45.93,0.00,0.06,0
1379,212,-1000.00,-1000.00,0.00,29.20,285.34,0.29,0
1380,213,-1000.00,-1000.00,0.00,583.83,416.17,0.14,0
1381,214,-771.85,-771.85,228.15,0.00,771.85,0.23,0
1382,214,-228.15,-1000.00,0.00,80.66,147.50,0.31,0
1383,215,-1000.00,-1000.00,0.00,619.17,380.83,0.18,0
1384,216,-1000.00,-1000.00,0.00,78.59,0.00,0.04,0
1385,217,-609.56,-609.56,390.44,609.56,0.00,0.17,0
1386,217,-1000.00,-1609.56,-609.56,195.22,195.22,0.14,0
1387,218,-1000.00,-1000.00,0.00,845.98,154.02,0.14,0
1388,219,-1000.00,-1000.00,0.00,368.84,631.16,0.43,0
1389,220,-1000.00,-1000.00,0.00,205.12,794.88,0.38,0
1390,221,-1000.00,-1000.00,0.00,343.73,656.27,0.32,0
1391,222,-1000.00,-1000.00,0.00,0.00,1000.00,0.24,0
1392,223,-888.50,-888.50,111.50,490.99,397.50,0.36,0
1393,223,1000.00,111.50,1111.50,14.52,83.64,0.36,1
1394,223,-123.90,-12.40,987.60,123.90,0.00,0.11,0
1395,223,1000.00,987.60,1987.60,0.00,987.60,0.14,1
1396,223,1000.00,1987.60,2987.60,0.00,1765.09,0.11,1
1397,223,-1000.00,987.60,1987.60,1340.18,249.96,0.24,0
1398,223,-1000.00,-12.40,987.60,1387.12,231.08,0.23,0
1399,223,1000.00,987.60,1987.60,452.24,535.36,0.31,1
1400,223,1000.00,1987.60,2987.60,66.51,1921.09,0.12,1
1401,223,1000.00,2987.60,3987.60,1493.80,1493.80,0.16,1
1402,223,-1000.00,1987.60,2987.60,1271.73,0.00,0.07,0
1403,223,1000.00,2987.60,3987.60,0.00,2844.89,0.26,1
1404,223,1000.00,3987.60,4987.60,0.00,3987.60,0.01,1
1405,223,1000.00,4987.60,5987.60,0.00,3312.79,0.24,1
1406,223,1000.00,5987.60,6987.60,0.00,3615.24,0.33,1
1407,223,-1000.00,4987.60,5987.60,2957.08,2473.60,0.35,0
1408,223,1000.00,5987.60,6987.60,1421.14,4566.46,0.41,1
1409,223,-1000.00,4987.60,5987.60,4736.92,0.00,0.11,0
1410,223,-1000.00,3987.60,4987.60,2013.13,1382.71,0.31,0
1411,223,-1000.00,2987.60,3987.60,3149.38,1681.10,0.31,0
1412,223,1000.00,3987.60,4987.60,342.86,828.14,0.20,1
1413,223,-1000.00,2987.60,3987.60,3731.09,1256.51,0.20,0
1414,223,1000.00,3987.60,4987.60,1156.13,2831.47,0.43,1
1415,223,-1000.00,2987.60,3987.60,1613.65,1734.31,0.32,0
1416,223,-1000.00,1987.60,2987.60,3547.90,439.70,0.17,0
1417,223,-869.81,1117.79,2117.79,0.00,869.81,0.00,0
1418,223,-1000.00,117.79,1117.79,1812.02,104.41,0.20,0
1419,223,-1000.00,-882.21,117.79,558.90,558.90,0.01,0
1420,223,-117.79,-1000.00,0.00,39.06,78.74,0.43,0
1421,224,-1000.00,-1000.00,0.00,633.27,298.30,0.28,0
1422,225,-1000.00,-1000.00,0.00,611.36,388.64,0.26,0
1423,226,-1000.00,-1000.00,0.00,763.42,236.58,0.26,0
1424,227,-990.34,-990.34,9.66,0.00,990.34,0.31,0
1425,227,-7.07,-997.41,2.59,0.84,6.24,0.41,0
1426,227,-2.59,-1000.00,0.00,0.55,2.04,0.23,0
1427,228,-1000.00,-1000.00,0.00,0.00,1000.00,0.04,0
1428,229,-1000.00,-1000.00,0.00,540.34,248.95,0.28,0
1429,230,1000.00,1000.00,2000.00,500.00,500.00,0.07,1
1430,230,1000.00,2000.00,3000.00,987.49,1012.51,0.15,1
1431,230,1000.00,3000.00,4000.00,360.43,1724.80,0.34,1
1432,230,1000.00,4000.00,5000.00,81.37,3918.63,0.10,1
1433,230,1000.00,5000.00,6000.00,2068.75,2931.25,0.04,1
1434,230,1000.00,6000.00,7000.00,0.00,6000.00,0.22,1
1435,230,-70.24,5929.76,6929.76,70.24,0.00,0.02,0
1436,230,1000.00,6929.76,7929.76,3464.88,3464.88,0.08,1
1437,230,1000.00,7929.76,8929.76,842.10,7087.66,0.32,1
1438,230,1000.00,8929.76,9929.76,1386.03,7543.74,0.06,1
1439,230,1000.00,9929.76,10929.76,2772.15,7157.61,0.39,1
1440,230,1000.00,10929.76,11929.76,1359.09,6736.09,0.40,1
1441,230,1000.00,11929.76,12929.76,0.00,11929.76,0.14,1
1442,230,1000.00,12929.76,13929.76,4319.83,6882.23,0.40,1
1443,230,-1000.00,11929.76,12929.76,13350.70,0.00,0.01,0
1444,230,1000.00,12929.76,13929.76,1487.63,6745.97,0.30,1
1445,230,-1000.00,11929.76,12929.76,6037.12,2442.12,0.26,0
1446,230,1000.00,12929.76,13929.76,3160.02,9769.74,0.25,1
1447,230,1000.00,13929.76,14929.76,0.00,13929.76,0.26,1
1448,230,1000.00,14929.76,15929.76,0.00,14929.76,0.27,1
1449,230,1000.00,15929.76,16929.76,6258.20,9671.56,0.28,1
1450,230,1000.00,16929.76,17929.76,0.00,16929.76,0.07,1
1451,230,-1000.00,15929.76,16929.76,8964.88,8964.88,0.07,0
1452,230,-1000.00,14929.76,15929.76,5569.79,11359.97,0.43,0
1453,230,-1000.00,13929.76,14929.76,4940.25,9702.98,0.43,0
1454,230,-1000.00,12929.76,13929.76,7464.88,7464.88,0.06,0
1455,230,-1000.00,11929.76,12929.76,7806.45,0.00,0.18,0
1456,230,-1000.00,10929.76,11929.76,4640.14,8289.62,0.44,0
1457,230,-1000.00,9929.76,10929.76,5964.88,5964.88,0.03,0
1458,230,-1000.00,8929.76,9929.76,0.00,10062.56,0.28,0
1459,230,-1000.00,7929.76,8929.76,4089.27,5840.49,0.17,0
1460,230,-1000.00,6929.76,7929.76,671.87,4647.78,0.37,0
1461,230,-1000.00,5929.76,6929.76,337.63,3444.66,0.33,0
1462,230,-1000.00,4929.76,5929.76,0.00,6929.76,0.22,0
1463,230,-1000.00,3929.76,4929.76,988.97,0.00,0.11,0
1464,230,-1000.00,2929.76,3929.76,856.40,4073.36,0.25,0
1465,230,-1000.00,1929.76,2929.76,2232.76,1697.00,0.32,0
1466,230,-1000.00,929.76,1929.76,1253.08,1010.21,0.34,0
1467,230,-1000.00,-70.24,929.76,1208.77,720.99,0.05,0
1468,230,-929.76,-1000.00,0.00,244.67,685.09,0.39,0
1469,230,-0.00,-1000.00,-0.00,0.00,0.00,0.12,0
1470,231,-1000.00,-1000.00,0.00,442.90,557.10,0.40,0
1471,232,-1000.00,-1000.00,0.00,0.00,1000.00,0.06,0
1472,233,1000.00,1000.00,2000.00,483.72,516.28,0.38,1
1473,233,1000.00,2000.00,3000.00,0.00,2000.00,0.04,1
1474,233,1000.00,3000.00,4000.00,1123.00,1877.00,0.02,1
1475,233,1000.00,4000.00,5000.00,1761.93,2238.07,0.43,1
1476,233,1000.00,5000.00,6000.00,2461.36,2538.64,0.42,1
1477,233,1000.00,6000.00,7000.00,428.49,5571.51,0.03,1
1478,233,-1000.00,5000.00,6000.00,3213.61,2598.97,0.35,0
1479,233,1000.00,6000.00,7000.00,662.79,2029.61,0.26,1
1480,233,1000.00,7000.00,8000.00,0.00,215.63,0.06,1
1481,233,0.00,7000.00,8000.00,0.00,0.00,0.02,0
1482,233,-1000.00,6000.00,7000.00,6469.60,1530.40,0.18,0
1483,233,1000.00,7000.00,8000.00,1567.62,4220.72,0.34,1
1484,233,-1000.00,6000.00,7000.00,6384.85,0.00,0.15,0
1485,233,0.00,6000.00,7000.00,0.00,0.00,0.06,0
1486,233,1000.00,7000.00,8000.00,3073.25,3926.75,0.23,1
1487,233,1000.00,8000.00,9000.00,6534.01,1465.99,0.23,1
1488,233,-1000.00,7000.00,8000.00,2027.74,6905.98,0.43,0
1489,233,1000.00,8000.00,9000.00,4887.69,3112.31,0.03,1
1490,233,-1000.00,7000.00,8000.00,4500.00,4500.00,0.05,0
1491,233,-1000.00,6000.00,7000.00,2725.34,3449.89,0.39,0
1492,233,-1000.00,5000.00,6000.00,3079.97,3920.03,0.37,0
1493,233,-1000.00,4000.00,5000.00,3000.00,3000.00,0.16,0
1494,233,-1000.00,3000.00,4000.00,0.00,4908.60,0.17,0
1495,233,1000.00,4000.00,5000.00,2999.62,1000.38,0.27,1
1496,233,-1000.00,3000.00,4000.00,0.00,5000.00,0.03,0
1497,233,-1000.00,2000.00,3000.00,0.00,3662.76,0.29,0
1498,233,-1000.00,1000.00,2000.00,1500.00,1500.00,0.09,0
1499,233,1000.00,2000.00,3000.00,1720.73,279.27,0.22,1
1500,233,-1000.00,1000.00,2000.00,1500.00,1500.00,0.07,0
1501,233,-1000.00,0.00,1000.00,1000.00,1000.00,0.02,0
1502,233,1000.00,1000.00,2000.00,817.76,182.24,0.17,1
1503,233,-1000.00,0.00,1000.00,776.12,1223.88,0.26,0
1504,233,1000.00,1000.00,2000.00,543.28,456.72,0.31,1
1505,233,-1000.00,0.00,1000.00,0.00,2000.00,0.11,0
1506,233,-1000.00,-1000.00,0.00,402.49,597.51,0.28,0
1507,234,-1000.00,-1000.00,0.00,703.67,296.33,0.23,0
1508,235,-1000.00,-1000.00,0.00,19.60,980.40,0.27,0
1509,236,-1000.00,-1000.00,0.00,529.68,470.32,0.15,0
1510,237,-995.59,-995.59,4.41,2.86,992.73,0.34,0
1511,237,-3.32,-998.91,1.09,0.00,3.32,0.10,0
1512,237,-0.78,-999.69,0.31,0.22,0.56,0.40,0
1513,237,-0.16,-999.85,0.15,0.00,0.16,0.31,0
1514,237,-0.15,-1000.00,0.00,0.07,0.08,0.42,0
1515,238,1000.00,1000.00,2000.00,0.00,1000.00,0.10,1
1516,238,-1000.00,0.00,1000.00,2000.00,0.00,0.04,0
1517,238,-1000.00,-1000.00,0.00,641.83,358.17,0.24,0
1518,239,-1000.00,-1000.00,0.00,14.58,985.42,0.34,0
1519,240,-1000.00,-1000.00,0.00,0.00,1000.00,0.00,0
1520,241,1000.00,1000.00,2000.00,178.39,0.00,0.09,1
1521,241,-1000.00,0.00,1000.00,0.00,1194.28,0.06,0
1522,241,1000.00,1000.00,2000.00,553.12,446.88,0.28,1
1523,241,-1000.00,0.00,1000.00,1000.00,1000.00,0.04,0
1524,241,0.00,0.00,1000.00,0.00,0.00,0.05,0
1525,241,1000.00,1000.00,2000.00,182.19,76.06,0.24,1
1526,241,1000.00,2000.00,3000.00,1273.07,0.00,0.18,1
1527,241,-1000.00,1000.00,2000.00,0.00,3000.00,0.00,0
1528,241,1000.00,2000.00,3000.00,1073.18,926.82,0.40,1
1529,241,-1000.00,1000.00,2000.00,1249.01,1750.99,0.31,0
1530,241,-1000.00,0.00,1000.00,0.00,1481.96,0.26,0
1531,241,1000.00,1000.00,2000.00,370.86,0.00,0.04,1
1532,241,-1000.00,0.00,1000.00,562.23,1437.77,0.22,0
1533,241,1000.00,1000.00,2000.00,512.67,487.33,0.35,1
1534,241,-82.01,917.99,1917.99,0.00,82.01,0.13,0
1535,241,-278.78,639.21,1639.21,0.00,278.78,0.17,0
1536,241,-339.47,299.73,1299.73,0.00,339.47,0.07,0
1537,241,1000.00,1299.73,2299.73,278.97,0.00,0.15,1
1538,241,-5.91,1293.83,2293.83,0.00,5.91,0.12,0
1539,241,1000.00,2293.83,3293.83,1272.12,1021.71,0.42,1
1540,241,1000.00,3293.83,4293.83,1123.52,0.00,0.14,1
1541,241,-1000.00,2293.83,3293.83,0.00,1679.35,0.19,0
1542,241,1000.00,3293.83,4293.83,210.94,0.00,0.05,1
1543,241,-1000.00,2293.83,3293.83,327.43,3966.40,0.12,0
1544,241,-1000.00,1293.83,2293.83,1646.91,1646.91,0.18,0
1545,241,-1000.00,293.83,1293.83,1146.91,1146.91,0.18,0
1546,241,-1000.00,-706.17,293.83,497.55,796.27,0.35,0
1547,241,-1000.00,-1706.17,-706.17,116.53,177.29,0.42,0
1548,242,-224.80,-224.80,775.20,224.80,0.00,0.02,0
1549,242,-721.25,-946.05,53.95,721.25,0.00,0.08,0
1550,242,-53.95,-1000.00,0.00,27.41,26.54,0.31,0
1551,243,-1000.00,-1000.00,0.00,500.00,500.00,0.12,0
1552,244,-1000.00,-1000.00,0.00,572.76,427.24,0.36,0
1553,245,-1000.00,-1000.00,0.00,121.71,878.29,0.35,0
1554,245,-0.00,-1000.00,0.00,0.00,0.00,0.35,0
1555,246,-1000.00,-1000.00,0.00,466.58,533.42,0.22,0
1556,247,-1000.00,-1000.00,0.00,4.78,995.22,0.18,0
1557,248,1000.00,1000.00,2000.00,812.84,187.16,0.14,1
1558,248,-1000.00,0.00,1000.00,984.34,1015.66,0.11,0
1559,248,1000.00,1000.00,2000.00,405.66,354.02,0.35,1
1560,248,1000.00,2000.00,3000.00,2000.00,0.00,0.00,1
1561,248,1000.00,3000.00,4000.00,1758.90,315.24,0.25,1
1562,248,-1000.00,2000.00,3000.00,0.00,1371.29,0.17,0
1563,248,-1000.00,1000.00,2000.00,1376.22,1623.78,0.38,0
1564,248,1000.00,2000.00,3000.00,445.89,248.26,0.25,1
1565,248,1000.00,3000.00,4000.00,2980.28,19.72,0.07,1
1566,248,-1000.00,2000.00,3000.00,1293.13,2706.87,0.24,0
1567,248,-1000.00,1000.00,2000.00,893.95,2106.05,0.18,0
1568,248,1000.00,2000.00,3000.00,1600.03,399.97,0.16,1
1569,248,-1000.00,1000.00,2000.00,0.00,3000.00,0.13,0
1570,248,1000.00,2000.00,3000.00,323.77,0.00,0.05,1
1571,248,-1000.00,1000.00,2000.00,0.00,3000.00,0.02,0
1572,248,-1000.00,0.00,1000.00,304.38,1695.62,0.32,0
1573,248,-1000.00,-1000.00,0.00,319.22,680.78,0.41,0
1574,249,1000.00,1000.00,2000.00,500.00,500.00,0.00,1
1575,249,-1000.00,0.00,1000.00,1505.81,494.19,0.23,0
1576,249,1000.00,1000.00,2000.00,173.60,826.40,0.41,1
1577,249,1000.00,2000.00,3000.00,807.03,1192.97,0.20,1
1578,249,1000.00,3000.00,4000.00,221.84,2778.16,0.06,1
1579,249,1000.00,4000.00,5000.00,1946.52,2053.48,0.17,1
1580,249,1000.00,5000.00,6000.00,0.00,5000.00,0.21,1
1581,249,1000.00,6000.00,7000.00,0.00,5089.06,0.33,1
1582,249,1000.00,7000.00,8000.00,0.00,980.97,0.20,1
1583,249,1000.00,8000.00,9000.00,2435.02,5564.98,0.09,1
1584,249,1000.00,9000.00,10000.00,0.00,9000.00,0.19,1
1585,249,1000.00,10000.00,11000.00,917.10,9082.90,0.16,1
1586,249,1000.00,11000.00,12000.00,0.00,8137.28,0.30,1
1587,249,1000.00,12000.00,13000.00,0.00,12000.00,0.07,1
1588,249,-1000.00,11000.00,12000.00,6543.75,6456.25,0.39,0
1589,249,1000.00,12000.00,13000.00,0.00,5287.98,0.16,1
1590,249,-1000.00,11000.00,12000.00,6598.50,6401.50,0.35,0
1591,249,1000.00,12000.00,13000.00,1876.18,10123.82,0.23,1
1592,249,1000.00,13000.00,14000.00,0.00,11584.83,0.25,1
1593,249,1000.00,14000.00,15000.00,0.00,3454.86,0.19,1
1594,249,1000.00,15000.00,16000.00,40.54,13617.27,0.36,1
1595,249,1000.00,16000.00,17000.00,7436.59,8563.41,0.11,1
1596,249,-1000.00,15000.00,16000.00,11851.20,5148.80,0.09,0
1597,249,1000.00,16000.00,17000.00,8000.00,8000.00,0.07,1
1598,249,-1000.00,15000.00,16000.00,14260.78,0.00,0.06,0
1599,249,-1000.00,14000.00,15000.00,6749.42,9250.58,0.38,0
1600,249,-1000.00,13000.00,14000.00,7500.00,7500.00,0.25,0
1601,249,-1000.00,12000.00,13000.00,10104.57,3895.43,0.15,0
1602,249,-1000.00,11000.00,12000.00,0.00,7649.52,0.20,0
1603,249,-1000.00,10000.00,11000.00,0.00,12000.00,0.04,0
1604,249,-1000.00,9000.00,10000.00,1644.31,9355.69,0.30,0
1605,249,-1000.00,8000.00,9000.00,2744.33,7255.67,0.21,0
1606,249,-1000.00,7000.00,8000.00,5412.99,3587.01,0.23,0
1607,249,-1000.00,6000.00,7000.00,3757.29,4242.71,0.18,0
1608,249,-1000.00,5000.00,6000.00,1566.61,5433.39,0.36,0
1609,249,-1000.00,4000.00,5000.00,2814.33,3185.67,0.13,0
1610,249,-1000.00,3000.00,4000.00,0.00,5000.00,0.24,0
1611,249,-1000.00,2000.00,3000.00,0.00,4000.00,0.20,0
1612,249,-1000.00,1000.00,2000.00,650.37,2349.63,0.33,0
1613,249,-1000.00,0.00,1000.00,983.78,1016.22,0.17,0
1614,249,-1000.00,-1000.00,0.00,608.79,391.21,0.11,0
1615,250,1000.00,1000.00,2000.00,114.81,885.19,0.20,1
1616,250,-618.43,381.57,1381.57,618.43,0.00,0.17,0
1617,250,0.00,381.57,1381.57,0.00,0.00,0.13,0
1618,250,1000.00,1381.57,2381.57,335.72,1045.84,0.20,1
1619,250,-61.83,1319.74,2319.74,56.21,5.62,0.17,0
1620,250,-1000.00,319.74,1319.74,1159.87,1159.87,0.20,0
1621,250,-1000.00,-680.26,319.74,10.33,992.82,0.27,0
1622,250,-199.89,-880.15,119.85,199.89,0.00,0.02,0
1623,250,-119.85,-1000.00,0.00,62.41,57.44,0.35,0
1624,251,-1000.00,-1000.00,0.00,470.52,529.48,0.39,0
1625,252,-1000.00,-1000.00,0.00,432.42,567.58,0.15,0
1626,253,1000.00,1000.00,2000.00,95.47,725.56,0.34,1
1627,253,1000.00,2000.00,3000.00,0.00,2000.00,0.19,1
1628,253,-1000.00,1000.00,2000.00,1625.92,1273.98,0.40,0
1629,253,-1000.00,0.00,1000.00,649.58,390.35,0.30,0
1630,253,-350.80,-350.80,649.20,350.80,0.00,0.13,0
1631,253,-649.20,-1000.00,0.00,486.20,163.00,0.24,0
1632,254,-1000.00,-1000.00,0.00,593.14,406.86,0.39,0
1633,255,1000.00,1000.00,2000.00,104.10,895.90,0.23,1
1634,255,-1000.00,0.00,1000.00,2000.00,0.00,0.08,0
1635,255,1000.00,1000.00,2000.00,215.18,784.82,0.31,1
1636,255,1000.00,2000.00,3000.00,186.06,1695.46,0.32,1
1637,255,1000.00,3000.00,4000.00,535.14,1845.80,0.42,1
1638,255,1000.00,4000.00,5000.00,1448.40,2551.60,0.40,1
1639,255,-1000.00,3000.00,4000.00,3508.08,1491.92,0.30,0
1640,255,1000.00,4000.00,5000.00,0.00,4000.00,0.01,1
1641,255,1000.00,5000.00,6000.00,1854.20,3145.80,0.15,1
1642,255,-1000.00,4000.00,5000.00,6000.00,0.00,0.10,0
1643,255,-1000.00,3000.00,4000.00,4643.87,65.26,0.13,0
1644,255,1000.00,4000.00,5000.00,2000.00,2000.00,0.01,1
1645,255,-1000.00,3000.00,4000.00,3742.12,1257.88,0.26,0
1646,255,1000.00,4000.00,5000.00,0.00,3210.85,0.32,1
1647,255,1000.00,5000.00,6000.00,2301.10,2698.90,0.23,1
1648,255,1000.00,6000.00,7000.00,408.90,4260.21,0.32,1
1649,255,-1000.00,5000.00,6000.00,5281.19,1718.81,0.26,0
1650,255,-1000.00,4000.00,5000.00,1065.54,0.00,0.17,0
1651,255,1000.00,5000.00,6000.00,0.00,4467.29,0.23,1
1652,255,1000.00,6000.00,7000.00,1709.08,4290.92,0.39,1
1653,255,1000.00,7000.00,8000.00,1666.25,5333.75,0.33,1
1654,255,1000.00,8000.00,9000.00,1952.06,6047.94,0.15,1
1655,255,-1000.00,7000.00,8000.00,1614.03,2765.44,0.29,0
1656,255,-1000.00,6000.00,7000.00,7255.70,744.30,0.03,0
1657,255,-1000.00,5000.00,6000.00,1075.30,5924.70,0.30,0
1658,255,-1000.00,4000.00,5000.00,898.67,4034.69,0.42,0
1659,255,-1000.00,3000.00,4000.00,4024.49,975.51,0.20,0
1660,255,-1000.00,2000.00,3000.00,0.00,4000.00,0.04,0
1661,255,-1000.00,1000.00,2000.00,0.00,3000.00,0.29,0
1662,255,-1000.00,0.00,1000.00,0.00,1750.20,0.25,0
1663,255,-1000.00,-1000.00,0.00,75.45,924.55,0.20,0
1664,256,1000.00,1000.00,2000.00,465.34,534.66,0.11,1
1665,256,1000.00,2000.00,3000.00,710.13,1289.87,0.08,1
1666,256,-1000.00,1000.00,2000.00,1594.11,1405.89,0.28,0
1667,256,1000.00,2000.00,3000.00,0.00,17.60,0.10,1
1668,256,1000.00,3000.00,4000.00,1500.00,1500.00,0.07,1
1669,256,-1000.00,2000.00,3000.00,1681.09,0.00,0.08,0
1670,256,-1000.00,1000.00,2000.00,2305.22,365.77,0.21,0
1671,256,-1000.00,0.00,1000.00,1331.35,668.65,0.17,0
1672,256,1000.00,1000.00,2000.00,0.00,1000.00,0.02,1
1673,256,-1000.00,0.00,1000.00,1324.14,675.86,0.24,0
1674,256,-1000.00,-1000.00,0.00,501.95,498.05,0.22,0
1675,257,-1000.00,-1000.00,0.00,556.29,443.71,0.28,0
1676,258,-1000.00,-1000.00,0.00,302.48,697.52,0.28,0
1677,259,-1000.00,-1000.00,0.00,405.96,594.04,0.26,0
1678,260,-893.70,-893.70,106.30,893.70,0.00,0.02,0
1679,260,1000.00,106.30,1106.30,0.00,106.30,0.12,1
1680,260,1000.00,1106.30,2106.30,0.00,871.24,0.34,1
1681,260,1000.00,2106.30,3106.30,711.00,1395.29,0.38,1
1682,260,1000.00,3106.30,4106.30,1149.60,1956.70,0.43,1
1683,260,1000.00,4106.30,5106.30,0.00,3127.24,0.25,1
1684,260,1000.00,5106.30,6106.30,2553.15,2553.15,0.03,1
1685,260,0.00,5106.30,6106.30,0.00,0.00,0.06,0
1686,260,-1000.00,4106.30,5106.30,3610.69,0.00,0.15,0
1687,260,-1000.00,3106.30,4106.30,3409.30,1697.00,0.29,0
1688,260,1000.00,4106.30,5106.30,0.00,4106.30,0.09,1
1689,260,1000.00,5106.30,6106.30,0.00,1906.83,0.09,1
1690,260,1000.00,6106.30,7106.30,0.00,4721.25,0.10,1
1691,260,1000.00,7106.30,8106.30,0.00,7106.30,0.01,1
1692,260,0.00,7106.30,8106.30,0.00,0.00,0.00,0
1693,260,1000.00,8106.30,9106.30,2522.40,5583.90,0.19,1
1694,260,1000.00,9106.30,10106.30,0.00,9106.30,0.11,1
1695,260,1000.00,10106.30,11106.30,0.00,7146.29,0.19,1
1696,260,1000.00,11106.30,12106.30,0.00,9129.08,0.15,1
1697,260,-1000.00,10106.30,11106.30,7424.51,4681.79,0.40,0
1698,260,1000.00,11106.30,12106.30,302.51,10803.79,0.19,1
1699,260,-1000.00,10106.30,11106.30,7799.76,4306.54,0.26,0
1700,260,-1000.00,9106.30,10106.30,577.65,10528.65,0.37,0
1701,260,-1000.00,8106.30,9106.30,0.00,10106.30,0.10,0
1702,260,-1000.00,7106.30,8106.30,5345.83,0.00,0.15,0
1703,260,-1000.00,6106.30,7106.30,1717.01,6389.28,0.26,0
1704,260,-1000.00,5106.30,6106.30,0.00,5024.47,0.28,0
1705,260,-1000.00,4106.30,5106.30,3904.72,2201.58,0.36,0
1706,260,0.00,4106.30,5106.30,0.00,0.00,0.16,0
1707,260,-1000.00,3106.30,4106.30,911.82,4194.48,0.28,0
1708,260,-1000.00,2106.30,3106.30,288.77,3817.53,0.29,0
1709,260,-1000.00,1106.30,2106.30,1841.86,1264.44,0.21,0
1710,260,-1000.00,106.30,1106.30,171.61,1934.69,0.33,0
1711,260,-964.14,-857.84,142.16,426.41,537.73,0.39,0
1712,260,-142.16,-1000.00,0.00,64.93,77.23,0.29,0
1713,261,-1000.00,-1000.00,0.00,491.10,508.90,0.43,0
1714,262,1000.00,1000.00,2000.00,0.00,514.07,0.22,1
1715,262,-1000.00,0.00,1000.00,1202.79,206.38,0.26,0
1716,262,1000.00,1000.00,2000.00,179.82,820.18,0.04,1
1717,262,-1000.00,0.00,1000.00,2000.00,0.00,0.11,0
1718,262,1000.00,1000.00,2000.00,0.00,1000.00,0.32,1
1719,262,1000.00,2000.00,3000.00,0.00,1782.56,0.33,1
1720,262,-1000.00,1000.00,2000.00,1799.93,621.22,0.34,0
1721,262,-1000.00,0.00,1000.00,945.83,247.72,0.29,0
1722,262,1000.00,1000.00,2000.00,0.00,1000.00,0.05,1
1723,262,1000.00,2000.00,3000.00,0.00,260.60,0.12,1
1724,262,1000.00,3000.00,4000.00,513.46,2486.54,0.34,1
1725,262,1000.00,4000.00,5000.00,2000.00,2000.00,0.02,1
1726,262,1000.00,5000.00,6000.00,2264.08,2688.66,0.43,1
1727,262,1000.00,6000.00,7000.00,0.00,3633.44,0.20,1
1728,262,-1000.00,5000.00,6000.00,3777.31,2640.71,0.39,0
1729,262,1000.00,6000.00,7000.00,3000.00,3000.00,0.12,1
1730,262,1000.00,7000.00,8000.00,2787.87,4212.13,0.02,1
1731,262,-1000.00,6000.00,7000.00,5998.65,660.16,0.25,0
1732,262,0.00,6000.00,7000.00,0.00,0.00,0.05,0
1733,262,-1000.00,5000.00,6000.00,4902.95,2097.05,0.32,0
1734,262,-1000.00,4000.00,5000.00,4453.24,1546.76,0.28,0
1735,262,-1000.00,3000.00,4000.00,2108.71,2891.29,0.33,0
1736,262,-1000.00,2000.00,3000.00,0.00,4000.00,0.11,0
1737,262,-1000.00,1000.00,2000.00,1060.37,0.00,0.07,0
1738,262,-1000.00,0.00,1000.00,1458.65,0.00,0.21,0
1739,262,-1000.00,-1000.00,0.00,429.28,419.30,0.39,0
1740,263,-1000.00,-1000.00,0.00,1000.00,0.00,0.06,0
1741,264,-1000.00,-1000.00,0.00,644.27,0.00,0.16,0
1742,265,-1000.00,-1000.00,0.00,352.62,647.38,0.36,0
1743,266,-1000.00,-1000.00,0.00,776.43,223.57,0.11,0
1744,267,-1000.00,-1000.00,0.00,501.29,498.71,0.22,0
1745,268,-1000.00,-1000.00,0.00,500.00,500.00,0.17,0
1746,269,-54.22,-54.22,945.78,0.00,54.22,0.15,0
1747,269,0.00,-54.22,945.78,0.00,0.00,0.08,0
1748,269,-945.78,-1000.00,0.00,321.77,624.01,0.40,0
1749,270,-1000.00,-1000.00,0.00,0.00,1000.00,0.08,0
1750,271,-1000.00,-1000.00,0.00,165.41,834.59,0.34,0
1751,272,-266.49,-266.49,733.51,266.49,0.00,0.08,0
1752,272,1000.00,733.51,1733.51,0.00,733.51,0.16,1
1753,272,1000.00,1733.51,2733.51,0.00,1733.51,0.25,1
1754,272,1000.00,2733.51,3733.51,747.40,1986.11,0.41,1
1755,272,1000.00,3733.51,4733.51,313.23,2762.41,0.41,1
1756,272,1000.00,4733.51,5733.51,887.52,1377.80,0.27,1
1757,272,1000.00,5733.51,6733.51,1371.47,4362.04,0.09,1
1758,272,-1000.00,4733.51,5733.51,6111.73,621.78,0.23,0
1759,272,1000.00,5733.51,6733.51,2866.76,2866.76,0.14,1
1760,272,1000.00,6733.51,7733.51,1679.56,1736.14,0.28,1
1761,272,1000.00,7733.51,8733.51,283.00,7450.51,0.18,1
1762,272,-1000.00,6733.51,7733.51,5060.71,3672.81,0.34,0
1763,272,-1000.00,5733.51,6733.51,4810.79,2922.72,0.39,0
1764,272,1000.00,6733.51,7733.51,0.00,723.76,0.21,1
1765,272,1000.00,7733.51,8733.51,3728.86,4004.65,0.29,1
1766,272,1000.00,8733.51,9733.51,1298.95,7434.56,0.25,1
1767,272,-1000.00,7733.51,8733.51,5736.52,3996.99,0.38,0
1768,272,1000.00,8733.51,9733.51,0.00,8733.51,0.06,1
1769,272,-1000.00,7733.51,8733.51,8602.09,0.00,0.01,0
1770,272,1000.00,8733.51,9733.51,437.08,1399.87,0.21,1
1771,272,-1000.00,7733.51,8733.51,9733.51,0.00,0.00,0
1772,272,1000.00,8733.51,9733.51,453.21,8280.30,0.12,1
1773,272,1000.00,9733.51,10733.51,3705.81,6027.70,0.36,1
1774,272,1000.00,10733.51,11733.51,0.00,7986.88,0.25,1
1775,272,1000.00,11733.51,12733.51,0.00,8017.92,0.15,1
1776,272,-1000.00,10733.51,11733.51,7877.45,4856.06,0.07,0
1777,272,-1000.00,9733.51,10733.51,8690.79,0.00,0.05,0
1778,272,-1000.00,8733.51,9733.51,2945.58,404.59,0.22,0
1779,272,-1000.00,7733.51,8733.51,6978.78,2754.73,0.19,0
1780,272,1000.00,8733.51,9733.51,3935.75,4797.76,0.40,1
1781,272,1000.00,9733.51,10733.51,4799.65,4933.86,0.25,1
1782,272,1000.00,10733.51,11733.51,471.73,799.39,0.19,1
1783,272,-1000.00,9733.51,10733.51,8429.57,3303.94,0.29,0
1784,272,1000.00,10733.51,11733.51,3977.11,6756.40,0.19,1
1785,272,1000.00,11733.51,12733.51,734.28,10999.23,0.20,1
1786,272,1000.00,12733.51,13733.51,6366.76,6366.76,0.05,1
1787,272,-1000.00,11733.51,12733.51,11703.50,2030.01,0.13,0
1788,272,1000.00,12733.51,13733.51,0.00,12733.51,0.10,1
1789,273,-1000.00,-1000.00,0.00,1000.00,0.00,0.12,0
1790,274,1000.00,1000.00,2000.00,0.00,318.23,0.06,1
1791,274,1000.00,2000.00,3000.00,922.77,1077.23,0.09,1
1792,274,-1000.00,1000.00,2000.00,2364.16,0.00,0.06,0
1793,274,1000.00,2000.00,3000.00,274.62,1725.38,0.04,1
1794,274,1000.00,3000.00,4000.00,0.00,1110.46,0.07,1
1795,274,1000.00,4000.00,5000.00,810.75,3189.25,0.35,1
1796,274,1000.00,5000.00,6000.00,1338.89,3661.11,0.35,1
1797,274,1000.00,6000.00,7000.00,2651.19,3348.81,0.17,1
1798,274,-1000.00,5000.00,6000.00,5042.15,0.00,0.15,0
1799,274,1000.00,6000.00,7000.00,0.00,2251.18,0.27,1
1800,274,1000.00,7000.00,8000.00,2625.02,4374.98,0.13,1
1801,274,-1000.00,6000.00,7000.00,5386.09,2613.91,0.32,0
1802,274,-1000.00,5000.00,6000.00,4049.52,2950.48,0.40,0
1803,274,-1000.00,4000.00,5000.00,4963.23,0.00,0.11,0
1804,274,-1000.00,3000.00,4000.00,5000.00,0.00,0.02,0
1805,274,-1000.00,2000.00,3000.00,2309.94,1076.55,0.35,0
1806,274,1000.00,3000.00,4000.00,1321.63,1678.37,0.13,1
1807,274,1000.00,4000.00,5000.00,1240.29,2759.71,0.32,1
1808,274,-1000.00,3000.00,4000.00,3533.55,0.00,0.17,0
1809,274,1000.00,4000.00,5000.00,590.31,3377.04,0.34,1
1810,274,-1000.00,3000.00,4000.00,5000.00,0.00,0.13,0
1811,274,-1000.00,2000.00,3000.00,2844.25,0.00,0.06,0
1812,274,1000.00,3000.00,4000.00,607.47,2095.91,0.43,1
1813,274,1000.00,4000.00,5000.00,187.32,1793.32,0.36,1
1814,274,1000.00,5000.00,6000.00,1151.81,3848.19,0.34,1
1815,274,-1000.00,4000.00,5000.00,2701.37,321.70,0.26,0
1816,274,-1000.00,3000.00,4000.00,2738.73,0.00,0.10,0
1817,274,1000.00,4000.00,5000.00,536.56,3463.44,0.22,1
1818,274,-1000.00,3000.00,4000.00,3439.13,1560.87,0.07,0
1819,274,-1000.00,2000.00,3000.00,1554.70,0.00,0.19,0
1820,274,-1000.00,1000.00,2000.00,1584.37,1415.63,0.37,0
1821,274,-1000.00,0.00,1000.00,1124.24,875.76,0.10,0
1822,274,1000.00,1000.00,2000.00,429.72,570.28,0.25,1
1823,274,1000.00,2000.00,3000.00,804.42,1195.58,0.36,1
1824,274,-1000.00,1000.00,2000.00,1597.12,1402.88,0.32,0
1825,274,1000.00,2000.00,3000.00,0.00,2000.00,0.20,1
1826,274,-1000.00,1000.00,2000.00,1968.80,1031.20,0.29,0
1827,274,1000.00,2000.00,3000.00,876.31,1123.69,0.23,1
1828,274,-1000.00,1000.00,2000.00,2021.90,0.00,0.07,0
1829,274,1000.00,2000.00,3000.00,932.23,1067.77,0.22,1
1830,274,-1000.00,1000.00,2000.00,858.73,731.62,0.30,0
1831,274,1000.00,2000.00,3000.00,0.00,2000.00,0.11,1
1832,274,-1000.00,1000.00,2000.00,2148.40,0.00,0.18,0
1833,274,1000.00,2000.00,3000.00,0.00,1003.28,0.10,1
1834,274,-1000.00,1000.00,2000.00,2754.32,245.68,0.06,0
1835,274,1000.00,2000.00,3000.00,0.00,2000.00,0.15,1
1836,274,1000.00,3000.00,4000.00,0.00,2732.06,0.27,1
1837,274,1000.00,4000.00,5000.00,0.00,1180.68,0.12,1
1838,274,1000.00,5000.00,6000.00,2297.79,2702.21,0.39,1
1839,274,-1000.00,4000.00,5000.00,3003.13,2996.87,0.07,0
1840,274,1000.00,5000.00,6000.00,2349.34,2650.66,0.16,1
1841,274,-1000.00,4000.00,5000.00,3421.38,2578.62,0.19,0
1842,274,-1000.00,3000.00,4000.00,2791.95,2208.05,0.32,0
1843,274,-1000.00,2000.00,3000.00,2042.92,820.30,0.31,0
1844,274,1000.00,3000.00,4000.00,0.00,2338.34,0.02,1
1845,274,-1000.00,2000.00,3000.00,2775.21,1224.79,0.06,0
1846,274,1000.00,3000.00,4000.00,294.84,1438.17,0.32,1
1847,274,-1000.00,2000.00,3000.00,1516.30,449.97,0.25,0
1848,274,1000.00,3000.00,4000.00,0.00,3000.00,0.06,1
1849,274,-1000.00,2000.00,3000.00,2979.66,1020.34,0.22,0
1850,274,1000.00,3000.00,4000.00,1097.94,1902.06,0.23,1
1851,274,-1000.00,2000.00,3000.00,4000.00,0.00,0.06,0
1852,274,-1000.00,1000.00,2000.00,1149.12,0.00,0.08,0
1853,274,1000.00,2000.00,3000.00,198.78,1801.22,0.21,1
1854,274,1000.00,3000.00,4000.00,1500.00,1500.00,0.23,1
1855,274,-1000.00,2000.00,3000.00,3156.53,0.00,0.07,0
1856,274,-450.91,1549.09,2549.09,450.91,0.00,0.00,0
1857,274,-1000.00,549.09,1549.09,2369.92,179.16,0.08,0
1858,274,1000.00,1549.09,2549.09,423.81,1125.28,0.13,1
1859,275,1000.00,1000.00,2000.00,35.05,790.44,0.40,1
1860,275,1000.00,2000.00,3000.00,941.52,1058.48,0.38,1
1861,275,1000.00,3000.00,4000.00,1475.44,1524.56,0.40,1
1862,275,1000.00,4000.00,5000.00,1201.33,2340.55,0.43,1
1863,275,-1000.00,3000.00,4000.00,3714.59,1285.41,0.28,0
1864,275,1000.00,4000.00,5000.00,1700.69,2299.31,0.34,1
1865,275,1000.00,5000.00,6000.00,21.01,4978.99,0.10,1
1866,275,-1000.00,4000.00,5000.00,5656.67,0.00,0.02,0
1867,275,1000.00,5000.00,6000.00,2315.32,2684.68,0.33,1
1868,275,1000.00,6000.00,7000.00,2441.33,3558.67,0.09,1
1869,275,1000.00,7000.00,8000.00,1968.68,5031.32,0.01,1
1870,275,-1000.00,6000.00,7000.00,6678.30,0.00,0.08,0
1871,275,-1000.00,5000.00,6000.00,6362.19,0.00,0.15,0
1872,275,-1000.00,4000.00,5000.00,3764.72,724.64,0.23,0
1873,275,1000.00,5000.00,6000.00,0.00,5000.00,0.21,1
1874,275,1000.00,6000.00,7000.00,3000.00,3000.00,0.25,1
1875,275,1000.00,7000.00,8000.00,3042.56,3957.44,0.43,1
1876,275,-1000.00,6000.00,7000.00,6518.13,821.93,0.27,0
1877,275,1000.00,7000.00,8000.00,0.00,7000.00,0.27,1
1878,275,-1000.00,6000.00,7000.00,5225.57,2774.43,0.40,0
1879,275,-1000.00,5000.00,6000.00,2700.80,0.00,0.19,0
1880,275,-1000.00,4000.00,5000.00,3547.40,2452.60,0.06,0
1881,275,-1000.00,3000.00,4000.00,5000.00,0.00,0.07,0
1882,275,-1000.00,2000.00,3000.00,2183.85,1339.29,0.35,0
1883,275,1000.00,3000.00,4000.00,1483.09,1516.91,0.36,1
1884,275,1000.00,4000.00,5000.00,2000.00,2000.00,0.25,1
1885,275,-1000.00,3000.00,4000.00,2992.36,2007.64,0.35,0
1886,275,1000.00,4000.00,5000.00,0.00,1609.76,0.10,1
1887,275,1000.00,5000.00,6000.00,0.00,1556.94,0.07,1
1888,275,1000.00,6000.00,7000.00,2011.24,3988.76,0.40,1
1889,275,-1000.00,5000.00,6000.00,7000.00,0.00,0.14,0
1890,275,1000.00,6000.00,7000.00,2093.41,3906.59,0.32,1
1891,275,-1000.00,5000.00,6000.00,5436.79,0.00,0.13,0
1892,275,1000.00,6000.00,7000.00,2445.70,3554.30,0.33,1
1893,275,1000.00,7000.00,8000.00,0.00,7000.00,0.14,1
1894,275,1000.00,8000.00,9000.00,1009.72,6523.07,0.40,1
1895,275,1000.00,9000.00,10000.00,4100.49,4899.51,0.14,1
1896,275,1000.00,10000.00,11000.00,0.00,10000.00,0.02,1
1897,275,-1000.00,9000.00,10000.00,7486.28,0.00,0.02,0
1898,275,-1000.00,8000.00,9000.00,4276.66,0.00,0.13,0
1899,275,1000.00,9000.00,10000.00,0.00,9000.00,0.07,1
1900,275,-1000.00,8000.00,9000.00,5179.83,4820.17,0.13,0
1901,275,1000.00,9000.00,10000.00,25.66,7586.07,0.27,1
1902,275,-1000.00,8000.00,9000.00,7032.78,0.00,0.09,0
1903,275,0.00,8000.00,9000.00,0.00,0.00,0.02,0
1904,275,-1000.00,7000.00,8000.00,7019.76,1980.24,0.18,0
1905,275,-1000.00,6000.00,7000.00,6651.81,665.08,0.28,0
1906,275,-1000.00,5000.00,6000.00,12.47,1924.97,0.20,0
1907,275,-1000.00,4000.00,5000.00,513.84,152.34,0.19,0
1908,275,-1000.00,3000.00,4000.00,2500.00,2500.00,0.11,0
1909,275,-1000.00,2000.00,3000.00,0.00,3551.49,0.07,0
1910,275,-1000.00,1000.00,2000.00,2864.10,135.90,0.14,0
1911,275,-1000.00,0.00,1000.00,1541.46,458.54,0.23,0
1912,275,-1000.00,-1000.00,0.00,434.89,352.62,0.37,0
1913,276,-1000.00,-1000.00,0.00,481.45,518.55,0.29,0
1914,277,-1000.00,-1000.00,0.00,553.62,446.38,0.32,0
1915,278,-334.93,-334.93,665.07,0.00,334.93,0.28,0
1916,278,-1000.00,-1334.93,-334.93,412.97,252.11,0.21,0
1917,279,1000.00,1000.00,2000.00,775.41,224.59,0.10,1
1918,279,1000.00,2000.00,3000.00,1179.66,820.34,0.07,1
1919,279,-1000.00,1000.00,2000.00,650.23,1339.92,0.39,0
1920,279,1000.00,2000.00,3000.00,260.23,0.00,0.15,1
1921,279,-1000.00,1000.00,2000.00,276.32,2723.68,0.29,0
1922,279,1000.00,2000.00,3000.00,1302.39,697.61,0.26,1
1923,279,-1000.00,1000.00,2000.00,1239.24,1760.76,0.38,0
1924,279,-1000.00,0.00,1000.00,0.00,2000.00,0.07,0
1925,279,-1000.00,-1000.00,0.00,468.81,531.19,0.43,0
1926,280,-1000.00,-1000.00,0.00,1000.00,0.00,0.04,0
1927,281,1000.00,1000.00,2000.00,291.30,708.70,0.15,1
1928,281,-1000.00,0.00,1000.00,1080.19,919.81,0.41,0
1929,281,1000.00,1000.00,2000.00,0.00,244.16,0.15,1
1930,281,-1000.00,0.00,1000.00,1511.25,0.00,0.15,0
1931,281,1000.00,1000.00,2000.00,0.00,1000.00,0.09,1
1932,281,-870.19,129.81,1129.81,870.19,0.00,0.10,0
1933,281,1000.00,1129.81,2129.81,507.98,621.83,0.35,1
1934,281,1000.00,2129.81,3129.81,1064.90,1064.90,0.01,1
1935,281,1000.00,3129.81,4129.81,0.00,2711.91,0.19,1
1936,281,-1000.00,2129.81,3129.81,1783.86,1594.01,0.38,0
1937,281,1000.00,3129.81,4129.81,388.14,2741.67,0.21,1
1938,281,1000.00,4129.81,5129.81,2002.07,2127.74,0.25,1
1939,281,-1000.00,3129.81,4129.81,2841.67,2288.14,0.39,0
1940,281,-1000.00,2129.81,3129.81,2504.26,1625.55,0.34,0
1941,281,1000.00,3129.81,4129.81,1392.30,1737.51,0.20,1
1942,281,-1000.00,2129.81,3129.81,2413.23,762.80,0.32,0
1943,281,1000.00,3129.81,4129.81,0.00,3129.81,0.14,1
1944,281,-1000.00,2129.81,3129.81,3595.99,533.82,0.16,0
1945,281,-1000.00,1129.81,2129.81,2859.60,270.21,0.21,0
1946,281,1000.00,2129.81,3129.81,1013.72,1116.08,0.41,1
1947,281,-1000.00,1129.81,2129.81,2318.15,811.65,0.20,0
1948,281,-1000.00,129.81,1129.81,1072.98,1056.82,0.24,0
1949,281,1000.00,1129.81,2129.81,286.79,843.02,0.02,1
1950,281,-492.82,636.98,1636.98,492.82,0.00,0.12,0
1951,281,0.00,636.98,1636.98,0.00,0.00,0.00,0
1952,281,-1000.00,-363.02,636.98,730.07,0.00,0.15,0
1953,281,-636.98,-1000.00,0.00,152.26,484.73,0.22,0
1954,282,-684.88,-684.88,315.12,62.05,622.83,0.40,0
1955,282,-315.12,-1000.00,0.00,141.57,173.55,0.11,0
1956,283,-1000.00,-1000.00,0.00,450.07,549.93,0.44,0
1957,284,-1000.00,-1000.00,0.00,263.94,736.06,0.40,0
1958,285,-870.28,-870.28,129.72,501.80,368.48,0.35,0
1959,285,1000.00,129.72,1129.72,0.00,71.58,0.27,1
1960,285,1000.00,1129.72,2129.72,484.02,645.70,0.30,1
1961,285,-1000.00,129.72,1129.72,1319.39,810.33,0.10,0
1962,285,1000.00,1129.72,2129.72,258.94,870.78,0.22,1
1963,285,-1000.00,129.72,1129.72,1850.39,279.33,0.27,0
1964,285,1000.00,1129.72,2129.72,483.63,646.09,0.27,1
1965,285,-1000.00,129.72,1129.72,1795.90,333.82,0.17,0
1966,285,-727.55,-597.83,402.17,727.55,0.00,0.18,0
1967,285,1000.00,402.17,1402.17,161.89,240.28,0.40,1
1968,285,-1000.00,-597.83,402.17,1060.02,342.15,0.27,0
1969,285,-402.17,-1000.00,0.00,209.59,192.59,0.23,0
1970,286,-1000.00,-1000.00,0.00,154.00,846.00,0.13,0
1971,287,-1000.00,-1000.00,0.00,519.56,480.44,0.38,0
1972,288,-1000.00,-1000.00,0.00,422.52,577.48,0.42,0
1973,289,-1000.00,-1000.00,0.00,348.48,651.52,0.37,0
1974,290,1000.00,1000.00,2000.00,744.32,31.62,0.19,1
1975,290,-1000.00,0.00,1000.00,973.28,1026.72,0.30,0
1976,290,-800.10,-800.10,199.90,0.00,800.10,0.08,0
1977,290,1000.00,199.90,1199.90,113.00,86.90,0.39,1
1978,290,-1000.00,-800.10,199.90,0.00,1199.90,0.13,0
1979,290,-55.33,-855.43,144.57,0.00,55.33,0.17,0
1980,290,-144.57,-1000.00,0.00,1.41,143.16,0.26,0
1981,291,-1000.00,-1000.00,0.00,735.62,264.38,0.07,0
1982,292,-512.29,-512.29,487.71,512.29,0.00,0.23,0
1983,292,-1000.00,-1512.29,-512.29,221.54,266.17,0.16,0
1984,293,-1000.00,-1000.00,0.00,851.31,148.69,0.16,0
1985,294,-1000.00,-1000.00,0.00,132.18,799.33,0.42,0
1986,295,1000.00,1000.00,2000.00,0.00,1000.00,0.01,1
1987,295,1000.00,2000.00,3000.00,0.00,2000.00,0.06,1
1988,295,1000.00,3000.00,4000.00,485.94,1042.21,0.35,1
1989,295,-1000.00,2000.00,3000.00,2712.32,923.10,0.36,0
1990,295,-1000.00,1000.00,2000.00,3000.00,0.00,0.09,0
1991,295,1000.00,2000.00,3000.00,736.47,1263.53,0.17,1
1992,295,1000.00,3000.00,4000.00,1128.34,1871.66,0.12,1
1993,295,-1000.00,2000.00,3000.00,2709.73,1290.27,0.36,0
1994,295,1000.00,3000.00,4000.00,583.08,2416.92,0.25,1
1995,295,1000.00,4000.00,5000.00,1051.49,2948.51,0.19,1
1996,295,1000.00,5000.00,6000.00,0.00,944.16,0.25,1
1997,295,-786.61,4213.39,5213.39,595.86,190.75,0.17,0
1998,295,-1000.00,3213.39,4213.39,2089.47,811.46,0.30,0
1999,295,-1000.00,2213.39,3213.39,2847.95,0.00,0.00,0
2000,295,-1000.00,1213.39,2213.39,2290.49,702.98,0.32,0
2001,295,-1000.00,213.39,1213.39,1808.81,404.58,0.21,0
2002,295,-789.00,-575.62,424.38,646.99,142.02,0.26,0
2003,295,1000.00,424.38,1424.38,0.00,287.70,0.32,1
2004,295,1000.00,1424.38,2424.38,384.44,1039.94,0.34,1
2005,295,-1000.00,424.38,1424.38,2424.38,0.00,0.08,0
2006,295,-385.35,39.04,1039.04,385.35,0.00,0.03,0
2007,295,1000.00,1039.04,2039.04,0.00,362.99,0.07,1
2008,295,-1000.00,39.04,1039.04,336.16,1702.87,0.26,0
2009,295,-1000.00,-960.96,39.04,0.00,1039.04,0.07,0
2010,295,-30.78,-991.74,8.26,0.00,30.78,0.22,0
2011,295,-8.26,-1000.00,0.00,3.10,5.15,0.30,0
2012,296,-800.29,-800.29,199.71,362.75,437.55,0.39,0
2013,296,-162.99,-963.29,36.71,0.00,162.99,0.19,0
2014,296,-36.71,-1000.00,0.00,18.36,18.36,0.09,0
2015,297,-1000.00,-1000.00,0.00,406.53,593.47,0.03,0
2016,298,-1000.00,-1000.00,0.00,309.72,690.28,0.15,0
2017,299,1000.00,1000.00,2000.00,500.00,500.00,0.15,1
2018,299,-1000.00,0.00,1000.00,1071.62,609.27,0.35,0
2019,299,1000.00,1000.00,2000.00,215.94,410.57,0.35,1
2020,299,-1000.00,0.00,1000.00,1181.17,818.83,0.22,0
2021,299,-1000.00,-1000.00,0.00,911.33,88.67,0.01,0
2022,300,-1000.00,-1000.00,0.00,799.12,200.88,0.26,0
2023,301,-1000.00,-1000.00,0.00,430.01,569.99,0.43,0
2024,302,-1000.00,-1000.00,0.00,163.26,836.74,0.37,0
2025,303,-1000.00,-1000.00,0.00,620.15,379.85,0.07,0
2026,304,1000.00,1000.00,2000.00,229.98,770.02,0.31,1
2027,304,1000.00,2000.00,3000.00,943.34,1056.66,0.03,1
2028,304,0.00,2000.00,3000.00,0.00,0.00,0.02,0
2029,304,-1000.00,1000.00,2000.00,1265.57,296.86,0.27,0
2030,304,-1000.00,0.00,1000.00,1379.08,620.92,0.09,0
2031,304,1000.00,1000.00,2000.00,500.00,500.00,0.01,1
2032,304,-1000.00,0.00,1000.00,1739.52,260.48,0.15,0
2033,304,1000.00,1000.00,2000.00,282.11,678.50,0.42,1
2034,304,-1000.00,0.00,1000.00,1210.47,789.53,0.11,0
2035,304,-926.11,-926.11,73.89,465.76,460.35,0.41,0
2036,304,1000.00,73.89,1073.89,0.00,62.04,0.21,1
2037,304,1000.00,1073.89,2073.89,430.22,643.67,0.34,1
2038,304,1000.00,2073.89,3073.89,0.00,2073.89,0.01,1
2039,304,1000.00,3073.89,4073.89,1536.95,1536.95,0.12,1
2040,304,1000.00,4073.89,5073.89,0.00,2046.00,0.16,1
2041,304,-1000.00,3073.89,4073.89,4279.43,0.00,0.03,0
2042,304,1000.00,4073.89,5073.89,1532.22,2541.67,0.39,1
2043,304,-1000.00,3073.89,4073.89,1975.02,0.00,0.11,0
2044,304,1000.00,4073.89,5073.89,215.79,3858.10,0.03,1
2045,304,1000.00,5073.89,6073.89,0.00,4940.55,0.21,1
2046,304,1000.00,6073.89,7073.89,0.00,4235.49,0.29,1
2047,304,-1000.00,5073.89,6073.89,5322.87,0.00,0.19,0
2048,304,-1000.00,4073.89,5073.89,3392.04,2681.85,0.31,0
2049,304,1000.00,5073.89,6073.89,2536.95,2536.95,0.00,1
2050,304,-1000.00,4073.89,5073.89,5881.38,0.00,0.01,0
2051,304,0.00,4073.89,5073.89,0.00,0.00,0.06,0
2052,304,-1000.00,3073.89,4073.89,3893.13,1180.76,0.12,0
2053,304,-1000.00,2073.89,3073.89,2907.10,413.60,0.20,0
2054,304,1000.00,3073.89,4073.89,1240.54,1833.35,0.23,1
2055,304,1000.00,4073.89,5073.89,0.00,4073.89,0.22,1
2056,304,1000.00,5073.89,6073.89,0.00,5073.89,0.31,1
2057,304,1000.00,6073.89,7073.89,0.00,6073.89,0.01,1
2058,304,-1000.00,5073.89,6073.89,4836.95,8.44,0.22,0
2059,304,1000.00,6073.89,7073.89,3036.95,3036.95,0.00,1
2060,304,1000.00,7073.89,8073.89,0.00,4832.22,0.09,1
2061,304,-1000.00,6073.89,7073.89,1215.31,0.00,0.13,0
2062,304,1000.00,7073.89,8073.89,754.77,6319.12,0.34,1
2063,304,1000.00,8073.89,9073.89,4036.95,4036.95,0.15,1
2064,305,1000.00,1000.00,2000.00,409.27,590.73,0.32,1
2065,305,1000.00,2000.00,3000.00,832.26,1167.74,0.32,1
2066,305,1000.00,3000.00,4000.00,1271.51,1728.49,0.09,1
2067,305,1000.00,4000.00,5000.00,1070.25,2929.75,0.20,1
2068,305,-1000.00,3000.00,4000.00,2766.12,2233.88,0.24,0
2069,305,1000.00,4000.00,5000.00,980.66,3019.34,0.41,1
2070,305,-1000.00,3000.00,4000.00,3608.35,1201.76,0.32,0
2071,305,1000.00,4000.00,5000.00,1965.00,2035.00,0.23,1
2072,305,1000.00,5000.00,6000.00,2500.00,2500.00,0.09,1
2073,305,-1000.00,4000.00,5000.00,5451.53,548.47,0.21,0
2074,305,-1000.00,3000.00,4000.00,4833.07,0.00,0.16,0
2075,305,-1000.00,2000.00,3000.00,3072.62,927.38,0.23,0
2076,305,1000.00,3000.00,4000.00,0.00,1878.47,0.19,1
2077,305,-1000.00,2000.00,3000.00,2814.17,0.00,0.15,0
2078,305,1000.00,3000.00,4000.00,1018.15,1981.85,0.23,1
2079,305,-1000.00,2000.00,3000.00,2453.50,1546.50,0.04,0
2080,305,-1000.00,1000.00,2000.00,2994.56,0.00,0.12,0
2081,305,-1000.00,0.00,1000.00,944.46,1055.54,0.32,0
2082,305,0.00,0.00,1000.00,0.00,0.00,0.01,0
2083,305,-859.63,-859.63,140.37,0.00,859.63,0.27,0
2084,305,-140.37,-1000.00,0.00,61.12,79.24,0.30,0
2085,306,-1000.00,-1000.00,0.00,0.00,1000.00,0.03,0
2086,307,-1000.00,-1000.00,0.00,307.82,692.18,0.42,0
2087,308,-1000.00,-1000.00,0.00,254.60,745.40,0.34,0
2088,309,1000.00,1000.00,2000.00,425.41,185.28,0.30,1
2089,309,1000.00,2000.00,3000.00,1163.46,836.54,0.33,1
2090,309,-1000.00,1000.00,2000.00,941.60,2058.40,0.41,0
2091,309,-1000.00,0.00,1000.00,0.00,2000.00,0.08,0
2092,309,1000.00,1000.00,2000.00,512.21,0.00,0.17,1
2093,309,-1000.00,0.00,1000.00,761.30,1238.70,0.29,0
2094,309,-1000.00,-1000.00,0.00,175.68,824.32,0.40,0
2095,310,-1000.00,-1000.00,0.00,80.85,919.15,0.23,0
2096,311,1000.00,1000.00,2000.00,0.00,266.94,0.17,1
2097,311,-1000.00,0.00,1000.00,1215.79,784.21,0.18,0
2098,311,1000.00,1000.00,2000.00,0.00,1000.00,0.07,1
2099,311,1000.00,2000.00,3000.00,18.12,229.16,0.20,1
2100,311,1000.00,3000.00,4000.00,0.00,2175.46,0.26,1
2101,311,1000.00,4000.00,5000.00,0.00,682.80,0.14,1
2102,311,1000.00,5000.00,6000.00,0.00,5000.00,0.01,1
2103,311,1000.00,6000.00,7000.00,2287.16,3712.84,0.43,1
2104,311,1000.00,7000.00,8000.00,2265.78,3092.78,0.40,1
2105,311,1000.00,8000.00,9000.00,348.16,7651.84,0.19,1
2106,311,1000.00,9000.00,10000.00,1611.71,7388.29,0.08,1
2107,311,1000.00,10000.00,11000.00,5000.00,5000.00,0.08,1
2108,311,0.00,10000.00,11000.00,0.00,0.00,0.05,0
2109,311,1000.00,11000.00,12000.00,2171.35,8828.65,0.32,1
2110,311,1000.00,12000.00,13000.00,2891.19,9108.81,0.40,1
2111,311,1000.00,13000.00,14000.00,5255.63,7744.37,0.43,1
2112,311,1000.00,14000.00,15000.00,3775.13,8137.02,0.38,1
2113,311,-1000.00,13000.00,14000.00,5267.35,0.00,0.13,0
2114,311,1000.00,14000.00,15000.00,6232.78,7767.22,0.43,1
2115,311,-1000.00,13000.00,14000.00,7875.04,7124.96,0.30,0
2116,311,0.00,13000.00,14000.00,0.00,0.00,0.02,0
2117,311,-1000.00,12000.00,13000.00,7868.26,4198.84,0.34,0
2118,311,1000.00,13000.00,14000.00,0.00,11687.35,0.08,1
2119,311,1000.00,14000.00,15000.00,6846.41,7153.59,0.30,1
2120,311,1000.00,15000.00,16000.00,3235.93,3670.20,0.29,1
2121,311,0.00,15000.00,16000.00,0.00,0.00,0.01,0
2122,311,1000.00,16000.00,17000.00,414.37,15585.63,0.12,1
2123,311,1000.00,17000.00,18000.00,5563.76,9770.20,0.43,1
2124,311,1000.00,18000.00,19000.00,9000.00,9000.00,0.19,1
2125,311,1000.00,19000.00,20000.00,9500.00,9500.00,0.04,1
2126,311,1000.00,20000.00,21000.00,10000.00,10000.00,0.07,1
2127,311,1000.00,21000.00,22000.00,5809.23,15190.77,0.35,1
2128,311,1000.00,22000.00,23000.00,11000.00,11000.00,0.07,1
2129,311,1000.00,23000.00,24000.00,0.00,23000.00,0.01,1
2130,311,1000.00,24000.00,25000.00,6410.46,17589.54,0.31,1
2131,311,1000.00,25000.00,26000.00,12500.00,12500.00,0.20,1
2132,311,1000.00,26000.00,27000.00,0.00,26000.00,0.01,1
2133,311,-1000.00,25000.00,26000.00,12986.30,9078.03,0.36,0
2134,311,0.00,25000.00,26000.00,0.00,0.00,0.12,0
2135,311,1000.00,26000.00,27000.00,13000.00,13000.00,0.01,1
2136,311,0.00,26000.00,27000.00,0.00,0.00,0.03,0
2137,311,-1000.00,25000.00,26000.00,13763.11,13236.89,0.39,0
2138,311,-1000.00,24000.00,25000.00,14212.12,11787.88,0.16,0
2139,312,1000.00,1000.00,2000.00,125.60,133.42,0.25,1
2140,312,1000.00,2000.00,3000.00,0.00,472.89,0.03,1
2141,312,-1000.00,1000.00,2000.00,1825.70,0.00,0.08,0
2142,312,-1000.00,0.00,1000.00,1127.46,872.54,0.20,0
2143,312,-1000.00,-1000.00,0.00,525.25,474.75,0.42,0
2144,313,-1000.00,-1000.00,0.00,293.93,706.07,0.11,0
2145,314,1000.00,1000.00,2000.00,0.00,202.41,0.19,1
2146,314,0.00,1000.00,2000.00,0.00,0.00,0.17,0
2147,314,-1000.00,0.00,1000.00,1000.48,999.52,0.42,0
2148,314,-1000.00,-1000.00,0.00,528.47,471.53,0.27,0
2149,315,-1000.00,-1000.00,0.00,415.68,584.32,0.26,0
2150,316,-1000.00,-1000.00,0.00,644.69,355.31,0.29,0
2151,317,-1000.00,-1000.00,0.00,806.40,193.60,0.18,0
2152,318,-1000.00,-1000.00,0.00,152.05,847.95,0.12,0
2153,319,-971.43,-971.43,28.57,0.00,971.43,0.21,0
2154,319,-28.57,-1000.00,0.00,13.69,14.88,0.13,0
2155,320,-1000.00,-1000.00,0.00,507.72,492.28,0.40,0
2156,321,1000.00,1000.00,2000.00,343.03,0.00,0.18,1
2157,321,-1000.00,0.00,1000.00,0.00,2000.00,0.08,0
2158,321,-1000.00,-1000.00,0.00,424.25,575.75,0.41,0
2159,322,-1000.00,-1000.00,0.00,509.36,490.64,0.17,0
2160,323,-1000.00,-1000.00,0.00,480.63,519.37,0.41,0
2161,324,-1000.00,-1000.00,0.00,341.54,658.46,0.33,0
2162,325,-1000.00,-1000.00,0.00,0.00,948.74,0.23,0
2163,326,-1000.00,-1000.00,0.00,354.70,645.30,0.30,0
2164,327,-1000.00,-1000.00,0.00,257.53,742.47,0.35,0
2165,328,-1000.00,-1000.00,0.00,426.34,573.66,0.32,0
2166,329,-1000.00,-1000.00,0.00,328.26,671.74,0.44,0
2167,330,-1000.00,-1000.00,0.00,789.59,210.41,0.08,0
2168,331,1000.00,1000.00,2000.00,0.00,1000.00,0.00,1
2169,331,-1000.00,0.00,1000.00,1231.56,768.44,0.09,0
2170,331,1000.00,1000.00,2000.00,172.12,827.88,0.34,1
2171,331,1000.00,2000.00,3000.00,1000.00,1000.00,0.26,1
2172,331,1000.00,3000.00,4000.00,0.00,2284.70,0.28,1
2173,331,1000.00,4000.00,5000.00,0.00,1720.13,0.13,1
2174,331,1000.00,5000.00,6000.00,505.89,4494.11,0.20,1
2175,331,1000.00,6000.00,7000.00,1723.26,4276.74,0.40,1
2176,331,1000.00,7000.00,8000.00,0.00,4014.39,0.03,1
2177,331,1000.00,8000.00,9000.00,0.00,2314.79,0.24,1
2178,331,1000.00,9000.00,10000.00,0.00,9000.00,0.08,1
2179,331,-1000.00,8000.00,9000.00,6527.68,3472.32,0.37,0
2180,331,-1000.00,7000.00,8000.00,9000.00,0.00,0.12,0
2181,331,-1000.00,6000.00,7000.00,5450.66,0.00,0.10,0
2182,331,1000.00,7000.00,8000.00,0.00,7000.00,0.05,1
2183,331,1000.00,8000.00,9000.00,3659.21,4340.79,0.44,1
2184,331,-1000.00,7000.00,8000.00,5342.26,3657.74,0.22,0
2185,331,1000.00,8000.00,9000.00,0.00,7222.36,0.33,1
2186,331,-1000.00,7000.00,8000.00,4326.88,2207.02,0.29,0
2187,331,-1000.00,6000.00,7000.00,4981.29,1274.86,0.25,0
2188,331,-1000.00,5000.00,6000.00,3650.14,2758.97,0.36,0
2189,331,1000.00,6000.00,7000.00,0.00,3894.71,0.23,1
2190,331,-1000.00,5000.00,6000.00,2774.98,4225.02,0.41,0
2191,331,-1000.00,4000.00,5000.00,1576.27,4423.73,0.38,0
2192,331,-225.81,3774.19,4774.19,0.00,225.81,0.17,0
2193,331,-352.45,3421.74,4421.74,0.00,352.45,0.08,0
2194,331,-1000.00,2421.74,3421.74,1375.25,3046.49,0.43,0
2195,331,-1000.00,1421.74,2421.74,2542.27,0.00,0.08,0
2196,331,-1000.00,421.74,1421.74,1175.15,1246.59,0.40,0
2197,331,-1000.00,-578.26,421.74,147.36,1274.38,0.15,0
2198,331,-421.74,-1000.00,0.00,11.52,410.22,0.24,0
2199,332,-807.54,-807.54,192.46,727.87,79.68,0.17,0
2200,332,-183.43,-990.97,9.03,155.83,27.60,0.17,0
2201,332,-1000.00,-1990.97,-990.97,3.03,6.00,0.21,0
2202,333,-927.95,-927.95,72.05,421.01,506.94,0.41,0
2203,333,-1000.00,-1927.95,-927.95,60.20,11.84,0.19,0
2204,334,-1000.00,-1000.00,0.00,287.84,712.16,0.36,0
2205,335,-1000.00,-1000.00,0.00,226.18,773.82,0.26,0
2206,336,-1000.00,-1000.00,0.00,500.00,500.00,0.10,0
2207,337,-1000.00,-1000.00,0.00,342.04,657.96,0.43,0
2208,338,-1000.00,-1000.00,0.00,0.00,242.99,0.27,0
2209,339,-505.93,-505.93,494.07,165.67,340.27,0.34,0
2210,339,-282.37,-788.31,211.69,56.15,226.23,0.36,0
2211,339,-155.23,-943.54,56.46,72.76,82.47,0.35,0
2212,339,-1000.00,-1943.54,-943.54,34.84,21.62,0.30,0
2213,340,1000.00,1000.00,2000.00,175.30,299.91,0.31,1
2214,340,1000.00,2000.00,3000.00,1000.00,1000.00,0.05,1
2215,340,1000.00,3000.00,4000.00,1500.00,1500.00,0.12,1
2216,340,1000.00,4000.00,5000.00,1877.30,2122.70,0.25,1
2217,340,1000.00,5000.00,6000.00,0.00,2286.26,0.21,1
2218,340,1000.00,6000.00,7000.00,1146.53,4853.47,0.32,1
2219,340,1000.00,7000.00,8000.00,1388.95,5611.05,0.16,1
2220,340,1000.00,8000.00,9000.00,0.00,1594.18,0.18,1
2221,340,-1000.00,7000.00,8000.00,4813.80,4186.20,0.13,0
2222,340,-1000.00,6000.00,7000.00,7866.16,133.84,0.02,0
2223,340,-1000.00,5000.00,6000.00,3771.86,3228.14,0.38,0
2224,340,-1000.00,4000.00,5000.00,6000.00,0.00,0.13,0
2225,340,-1000.00,3000.00,4000.00,4221.99,778.01,0.14,0
2226,340,-1000.00,2000.00,3000.00,2313.09,1686.91,0.34,0
2227,340,1000.00,3000.00,4000.00,0.00,1705.78,0.27,1
2228,340,-1000.00,2000.00,3000.00,3364.27,0.00,0.18,0
2229,340,-1000.00,1000.00,2000.00,2700.44,0.00,0.20,0
2230,340,1000.00,2000.00,3000.00,0.00,1823.02,0.26,1
2231,340,-1000.00,1000.00,2000.00,2339.44,660.56,0.13,0
2232,340,1000.00,2000.00,3000.00,1000.00,1000.00,0.04,1
2233,340,0.00,2000.00,3000.00,0.00,0.00,0.03,0
2234,340,-1000.00,1000.00,2000.00,2075.55,924.45,0.09,0
2235,340,1000.00,2000.00,3000.00,0.00,1696.81,0.18,1
2236,340,1000.00,3000.00,4000.00,0.00,131.35,0.16,1
2237,340,0.00,3000.00,4000.00,0.00,0.00,0.02,0
2238,340,-1000.00,2000.00,3000.00,0.00,4000.00,0.15,0
2239,340,-33.60,1966.40,2966.40,0.00,33.60,0.06,0
2240,340,0.00,1966.40,2966.40,0.00,0.00,0.02,0
2241,340,-1000.00,966.40,1966.40,1581.64,1384.76,0.10,0
2242,340,-1000.00,-33.60,966.40,0.00,1966.40,0.09,0
2243,340,-966.40,-1000.00,0.00,361.91,604.49,0.12,0
2244,341,-1000.00,-1000.00,0.00,1000.00,0.00,0.02,0
2245,342,1000.00,1000.00,2000.00,380.69,619.31,0.19,1
2246,342,1000.00,2000.00,3000.00,0.00,1913.30,0.02,1
2247,342,1000.00,3000.00,4000.00,0.00,3000.00,0.17,1
2248,342,1000.00,4000.00,5000.00,270.98,2010.80,0.36,1
2249,342,1000.00,5000.00,6000.00,481.04,4518.96,0.14,1
2250,342,-1000.00,4000.00,5000.00,3439.60,2560.40,0.41,0
2251,342,1000.00,5000.00,6000.00,1314.16,3685.84,0.23,1
2252,342,1000.00,6000.00,7000.00,2482.48,3517.52,0.44,1
2253,342,1000.00,7000.00,8000.00,14.04,6985.96,0.11,1
2254,342,1000.00,8000.00,9000.00,4000.00,4000.00,0.10,1
2255,342,1000.00,9000.00,10000.00,903.45,7611.73,0.39,1
2256,342,-1000.00,8000.00,9000.00,5890.02,4109.98,0.14,0
2257,342,1000.00,9000.00,10000.00,3258.24,5741.76,0.38,1
2258,342,-1000.00,8000.00,9000.00,9714.86,0.00,0.09,0
2259,342,1000.00,9000.00,10000.00,945.18,4621.48,0.34,1
2260,342,-112.66,8887.34,9887.34,112.66,0.00,0.07,0
2261,342,1000.00,9887.34,10887.34,4943.67,4943.67,0.02,1
2262,342,1000.00,10887.34,11887.34,4733.78,6153.57,0.43,1
2263,342,1000.00,11887.34,12887.34,0.00,1869.52,0.18,1
2264,342,1000.00,12887.34,13887.34,17.14,5554.04,0.28,1
2265,342,-1000.00,11887.34,12887.34,8206.10,5681.24,0.13,0
2266,342,1000.00,12887.34,13887.34,6443.67,6443.67,0.03,1
2267,342,1000.00,13887.34,14887.34,6558.01,7329.34,0.44,1
2268,342,-1000.00,12887.34,13887.34,13021.08,1866.26,0.14,0
2269,342,-1000.00,11887.34,12887.34,4926.75,8960.60,0.33,0
2270,342,-1000.00,10887.34,11887.34,8500.97,4386.38,0.27,0
2271,342,-1000.00,9887.34,10887.34,0.00,8203.32,0.09,0
2272,342,-1000.00,8887.34,9887.34,1123.08,1563.09,0.25,0
2273,342,-1000.00,7887.34,8887.34,4943.67,4943.67,0.17,0
2274,342,-1000.00,6887.34,7887.34,0.00,8887.34,0.04,0
2275,342,-1000.00,5887.34,6887.34,0.00,7887.34,0.09,0
2276,342,-1000.00,4887.34,5887.34,1078.57,684.62,0.26,0
2277,342,-1000.00,3887.34,4887.34,3436.09,2451.26,0.34,0
2278,342,-1000.00,2887.34,3887.34,1835.32,3052.03,0.44,0
2279,342,-1000.00,1887.34,2887.34,1740.93,2146.41,0.28,0
2280,342,-1000.00,887.34,1887.34,413.12,1326.13,0.35,0
2281,342,-1000.00,-112.66,887.34,413.11,1474.23,0.24,0
2282,342,-1000.00,-1112.66,-112.66,255.54,0.00,0.15,0
2283,343,-604.75,-604.75,395.25,236.48,368.27,0.34,0
2284,343,-395.25,-1000.00,0.00,155.72,239.53,0.29,0
2285,344,-671.83,-671.83,328.17,0.00,671.83,0.18,0
2286,344,-1000.00,-1671.83,-671.83,237.34,90.83,0.31,0
2287,345,-1000.00,-1000.00,0.00,517.90,482.10,0.30,0
2288,346,1000.00,1000.00,2000.00,202.54,797.46,0.41,1
2289,346,1000.00,2000.00,3000.00,637.15,1362.85,0.35,1
2290,346,1000.00,3000.00,4000.00,288.50,2711.50,0.32,1
2291,346,-1000.00,2000.00,3000.00,2343.96,1656.04,0.39,0
2292,346,1000.00,3000.00,4000.00,944.42,2055.58,0.34,1
2293,346,-1000.00,2000.00,3000.00,2152.00,0.00,0.18,0
2294,346,1000.00,3000.00,4000.00,0.00,3000.00,0.17,1
2295,346,-1000.00,2000.00,3000.00,2556.87,637.67,0.28,0
2296,346,1000.00,3000.00,4000.00,0.00,3000.00,0.20,1
2297,346,1000.00,4000.00,5000.00,653.76,2653.99,0.35,1
2298,346,1000.00,5000.00,6000.00,0.00,5000.00,0.04,1
2299,346,1000.00,6000.00,7000.00,699.34,5300.66,0.38,1
2300,346,-1000.00,5000.00,6000.00,6470.64,282.52,0.14,0
2301,346,1000.00,6000.00,7000.00,0.00,2765.85,0.12,1
2302,346,-1000.00,5000.00,6000.00,4299.12,2700.88,0.38,0
2303,346,1000.00,6000.00,7000.00,0.00,6000.00,0.16,1
2304,346,1000.00,7000.00,8000.00,3500.00,3500.00,0.04,1
2305,346,1000.00,8000.00,9000.00,0.00,4881.87,0.20,1
2306,346,1000.00,9000.00,10000.00,492.37,8507.63,0.19,1
2307,346,-1000.00,8000.00,9000.00,2852.61,533.91,0.22,0
2308,346,-1000.00,7000.00,8000.00,3411.67,5588.33,0.43,0
2309,346,-1000.00,6000.00,7000.00,6047.47,1952.53,0.04,0
2310,346,-1000.00,5000.00,6000.00,3122.67,3877.33,0.28,0
2311,346,-1000.00,4000.00,5000.00,3520.21,2479.79,0.42,0
2312,346,-1000.00,3000.00,4000.00,771.65,4228.35,0.28,0
2313,346,-1000.00,2000.00,3000.00,1013.57,2986.43,0.41,0
2314,346,-1000.00,1000.00,2000.00,1137.37,1862.63,0.38,0
2315,346,-1000.00,0.00,1000.00,36.49,1519.42,0.37,0
2316,346,-68.81,-68.81,931.19,0.00,68.81,0.08,0
2317,346,-931.19,-1000.00,0.00,239.08,692.11,0.27,0
2318,347,-229.32,-229.32,770.68,202.17,27.16,0.19,0
2319,347,1000.00,770.68,1770.68,0.00,770.68,0.12,1
2320,347,-1000.00,-229.32,770.68,1050.74,0.00,0.07,0
2321,347,1000.00,770.68,1770.68,0.00,603.78,0.03,1
2322,347,1000.00,1770.68,2770.68,711.92,1058.75,0.43,1
2323,347,1000.00,2770.68,3770.68,865.65,1905.02,0.20,1
2324,347,1000.00,3770.68,4770.68,1885.34,1885.34,0.07,1
2325,347,1000.00,4770.68,5770.68,0.00,4627.65,0.20,1
2326,347,1000.00,5770.68,6770.68,2885.34,2885.34,0.20,1
2327,347,1000.00,6770.68,7770.68,0.00,4130.33,0.11,1
2328,347,1000.00,7770.68,8770.68,3290.53,4480.15,0.23,1
2329,347,-1000.00,6770.68,7770.68,5776.94,1797.01,0.31,0
2330,347,-1000.00,5770.68,6770.68,2992.52,395.41,0.24,0
2331,347,1000.00,6770.68,7770.68,27.29,148.45,0.18,1
2332,347,1000.00,7770.68,8770.68,919.43,6851.25,0.33,1
2333,347,1000.00,8770.68,9770.68,4347.22,4423.46,0.30,1
2334,347,-1000.00,7770.68,8770.68,6503.46,3267.22,0.35,0
2335,347,1000.00,8770.68,9770.68,1783.67,6987.01,0.11,1
2336,347,-1000.00,7770.68,8770.68,9770.68,0.00,0.02,0
2337,347,-1000.00,6770.68,7770.68,4475.51,4295.17,0.37,0
2338,347,1000.00,7770.68,8770.68,2514.52,5256.16,0.39,1
2339,347,1000.00,8770.68,9770.68,2455.19,4817.08,0.38,1
2340,347,-1000.00,7770.68,8770.68,7904.80,442.40,0.17,0
2341,347,-1000.00,6770.68,7770.68,6093.43,2677.25,0.03,0
2342,347,1000.00,7770.68,8770.68,1542.33,6228.35,0.13,1
2343,347,1000.00,8770.68,9770.68,1502.64,7268.04,0.40,1
2344,347,-1000.00,7770.68,8770.68,7094.71,0.00,0.09,0
2345,347,1000.00,8770.68,9770.68,1849.26,6921.41,0.31,1
2346,347,1000.00,9770.68,10770.68,0.00,9770.68,0.02,1
2347,347,1000.00,10770.68,11770.68,3134.89,7635.79,0.04,1
2348,347,1000.00,11770.68,12770.68,50.56,11720.11,0.26,1
2349,347,-1000.00,10770.68,11770.68,9929.98,0.00,0.15,0
2350,347,1000.00,11770.68,12770.68,1832.92,9937.75,0.34,1
2351,347,1000.00,12770.68,13770.68,0.00,4224.11,0.06,1
2352,347,-1000.00,11770.68,12770.68,8749.75,0.00,0.20,0
2353,347,-1000.00,10770.68,11770.68,8243.34,4527.34,0.15,0
2354,347,1000.00,11770.68,12770.68,5790.06,5980.61,0.41,1
2355,347,-1000.00,10770.68,11770.68,7811.43,4959.25,0.12,0
2356,347,-1000.00,9770.68,10770.68,8870.46,2900.22,0.01,0
2357,347,1000.00,10770.68,11770.68,0.00,5635.03,0.22,1
2358,347,1000.00,11770.68,12770.68,5885.34,5885.34,0.01,1
2359,348,1000.00,1000.00,2000.00,0.00,436.29,0.27,1
2360,348,1000.00,2000.00,3000.00,627.77,1372.23,0.44,1
2361,348,1000.00,3000.00,4000.00,615.77,2066.25,0.41,1
2362,348,-336.02,2663.98,3663.98,336.02,0.00,0.05,0
2363,348,-1000.00,1663.98,2663.98,1980.42,1683.55,0.32,0
2364,348,1000.00,2663.98,3663.98,613.56,2050.42,0.37,1
2365,348,1000.00,3663.98,4663.98,911.07,2752.91,0.37,1
2366,348,-1000.00,2663.98,3663.98,3031.54,0.00,0.02,0
2367,348,1000.00,3663.98,4663.98,1831.99,1831.99,0.16,1
2368,348,1000.00,4663.98,5663.98,2331.99,2331.99,0.11,1
2369,348,-1000.00,3663.98,4663.98,3217.02,2446.96,0.17,0
2370,348,-1000.00,2663.98,3663.98,2583.01,2080.96,0.41,0
2371,348,-1000.00,1663.98,2663.98,2025.32,1284.50,0.33,0
2372,348,1000.00,2663.98,3663.98,0.00,1785.42,0.27,1
2373,348,-1000.00,1663.98,2663.98,2956.05,707.93,0.16,0
2374,348,-1000.00,663.98,1663.98,2002.15,661.83,0.16,0
2375,348,-1000.00,-336.02,663.98,941.98,722.00,0.14,0
2376,348,-371.65,-707.67,292.33,371.65,0.00,0.14,0
2377,348,1000.00,292.33,1292.33,89.96,202.37,0.44,1
2378,348,1000.00,1292.33,2292.33,326.92,965.41,0.03,1
2379,348,-1000.00,292.33,1292.33,1976.88,0.00,0.08,0
2380,348,-1000.00,-707.67,292.33,1292.33,0.00,0.05,0
2381,348,1000.00,292.33,1292.33,0.00,172.25,0.12,1
2382,348,1000.00,1292.33,2292.33,439.61,586.99,0.39,1
2383,348,-1000.00,292.33,1292.33,1702.25,0.00,0.23,0
2384,348,1000.00,1292.33,2292.33,230.30,1062.03,0.09,1
2385,348,1000.00,2292.33,3292.33,317.61,1974.72,0.33,1
2386,348,1000.00,3292.33,4292.33,612.44,2679.89,0.17,1
2387,348,1000.00,4292.33,5292.33,1667.58,2624.75,0.44,1
2388,348,1000.00,5292.33,6292.33,2646.17,2646.17,0.10,1
2389,348,1000.00,6292.33,7292.33,3037.23,3255.10,0.32,1
2390,348,1000.00,7292.33,8292.33,1429.69,5862.64,0.12,1
2391,348,-1000.00,6292.33,7292.33,5435.99,2856.34,0.18,0
2392,348,-1000.00,5292.33,6292.33,1927.47,113.13,0.23,0
2393,348,-1000.00,4292.33,5292.33,2338.06,2022.95,0.33,0
2394,348,1000.00,5292.33,6292.33,0.00,2848.68,0.12,1
2395,348,1000.00,6292.33,7292.33,0.00,2653.45,0.05,1
2396,348,1000.00,7292.33,8292.33,3646.17,3646.17,0.01,1
2397,348,1000.00,8292.33,9292.33,0.00,8292.33,0.01,1
2398,348,1000.00,9292.33,10292.33,2530.67,6761.66,0.40,1
2399,348,1000.00,10292.33,11292.33,5146.17,5146.17,0.09,1
2400,348,1000.00,11292.33,12292.33,191.60,11100.73,0.06,1
2401,348,-1000.00,10292.33,11292.33,6617.93,5674.40,0.19,0
2402,348,1000.00,11292.33,12292.33,176.89,11115.44,0.09,1
2403,348,-1000.00,10292.33,11292.33,3693.95,2061.69,0.28,0
2404,348,1000.00,11292.33,12292.33,1249.00,10043.33,0.37,1
2405,348,1000.00,12292.33,13292.33,1808.15,10484.18,0.21,1
2406,348,-1000.00,11292.33,12292.33,5100.58,0.00,0.23,0
2407,348,-1000.00,10292.33,11292.33,337.54,11954.79,0.20,0
2408,348,-1000.00,9292.33,10292.33,1869.89,3253.59,0.30,0
2409,348,-1000.00,8292.33,9292.33,6408.50,3883.83,0.17,0
2410,348,-1000.00,7292.33,8292.33,0.00,4592.50,0.14,0
2411,348,-140.27,7152.06,8152.06,0.00,140.27,0.11,0
2412,348,-1000.00,6152.06,7152.06,59.96,0.00,0.12,0
2413,348,-1000.00,5152.06,6152.06,0.00,7152.06,0.28,0
2414,348,-1000.00,4152.06,5152.06,475.62,1671.73,0.26,0
2415,348,-1000.00,3152.06,4152.06,3413.57,1738.48,0.25,0
2416,348,-1000.00,2152.06,3152.06,0.00,1591.01,0.27,0
2417,348,-1000.00,1152.06,2152.06,2221.31,930.74,0.29,0
2418,348,-1000.00,152.06,1152.06,943.02,828.71,0.35,0
2419,348,-617.31,-465.25,534.75,0.00,617.31,0.27,0
2420,348,-1000.00,-1465.25,-465.25,295.90,238.85,0.36,0
2421,349,-1000.00,-1000.00,0.00,226.20,731.94,0.44,0
2422,350,1000.00,1000.00,2000.00,0.00,1000.00,0.08,1
2423,350,-1000.00,0.00,1000.00,1469.57,530.43,0.05,0
2424,350,1000.00,1000.00,2000.00,342.83,657.17,0.10,1
2425,350,-1000.00,0.00,1000.00,1363.68,636.32,0.34,0
2426,350,1000.00,1000.00,2000.00,0.00,534.01,0.28,1
2427,350,1000.00,2000.00,3000.00,0.00,1126.25,0.11,1
2428,350,1000.00,3000.00,4000.00,0.00,3000.00,0.05,1
2429,350,-1000.00,2000.00,3000.00,2119.16,1880.84,0.43,0
2430,350,-1000.00,1000.00,2000.00,1304.21,0.00,0.12,0
2431,350,1000.00,2000.00,3000.00,398.61,629.28,0.31,1
2432,350,-1000.00,1000.00,2000.00,1846.47,1153.53,0.40,0
2433,350,-1000.00,0.00,1000.00,1431.43,568.57,0.30,0
2434,350,-1000.00,-1000.00,0.00,809.23,190.77,0.10,0
2435,351,-1000.00,-1000.00,0.00,310.71,689.29,0.44,0
2436,352,-1000.00,-1000.00,0.00,411.34,588.66,0.01,0
2437,353,-1000.00,-1000.00,0.00,768.29,231.71,0.22,0
2438,354,-1000.00,-1000.00,0.00,173.30,826.70,0.14,0
2439,355,-1000.00,-1000.00,0.00,497.27,502.73,0.34,0
2440,356,-658.72,-658.72,341.28,0.00,658.72,0.16,0
2441,356,-252.43,-911.15,88.85,0.00,252.43,0.01,0
2442,356,-1000.00,-1911.15,-911.15,52.33,36.52,0.25,0
2443,357,-1000.00,-1000.00,0.00,210.92,789.08,0.42,0
2444,357,-0.00,-1000.00,0.00,0.00,0.00,0.27,0
2445,358,1000.00,1000.00,2000.00,106.75,204.11,0.24,1
2446,358,-1000.00,0.00,1000.00,2000.00,0.00,0.04,0
2447,358,1000.00,1000.00,2000.00,138.82,433.01,0.31,1
2448,358,1000.00,2000.00,3000.00,0.00,957.23,0.22,1
2449,358,1000.00,3000.00,4000.00,0.00,1927.30,0.18,1
2450,358,-1000.00,2000.00,3000.00,2000.84,1999.16,0.43,0
2451,358,1000.00,3000.00,4000.00,888.34,1981.49,0.40,1
2452,358,1000.00,4000.00,5000.00,0.00,4000.00,0.16,1
2453,358,1000.00,5000.00,6000.00,0.00,4387.19,0.16,1
2454,358,1000.00,6000.00,7000.00,1825.22,4174.78,0.27,1
2455,358,1000.00,7000.00,8000.00,0.00,7000.00,0.13,1
2456,358,-1000.00,6000.00,7000.00,5274.34,1693.66,0.24,0
2457,358,1000.00,7000.00,8000.00,3004.43,3995.57,0.41,1
2458,358,1000.00,8000.00,9000.00,3864.69,4135.31,0.00,1
2459,358,1000.00,9000.00,10000.00,3451.40,5548.60,0.43,1
2460,358,1000.00,10000.00,11000.00,2866.24,7133.76,0.40,1
2461,358,1000.00,11000.00,12000.00,0.00,11000.00,0.03,1
2462,358,1000.00,12000.00,13000.00,0.00,12000.00,0.02,1
2463,358,1000.00,13000.00,14000.00,6478.09,6521.91,0.35,1
2464,358,-1000.00,12000.00,13000.00,7630.96,6369.04,0.33,0
2465,358,1000.00,13000.00,14000.00,0.00,7005.98,0.27,1
2466,358,1000.00,14000.00,15000.00,5260.60,8739.40,0.39,1
2467,358,1000.00,15000.00,16000.00,1999.84,11920.80,0.34,1
2468,358,-1000.00,14000.00,15000.00,12035.85,3964.15,0.24,0
2469,358,1000.00,15000.00,16000.00,0.00,13825.41,0.31,1
2470,358,1000.00,16000.00,17000.00,4270.57,11143.05,0.40,1
2471,358,1000.00,17000.00,18000.00,815.44,16184.56,0.30,1
2472,358,-1000.00,16000.00,17000.00,9917.22,2653.98,0.28,0
2473,358,-1000.00,15000.00,16000.00,11283.03,5716.97,0.32,0
2474,358,1000.00,16000.00,17000.00,6101.82,9898.18,0.38,1
2475,358,0.00,16000.00,17000.00,0.00,0.00,0.10,0
2476,358,1000.00,17000.00,18000.00,8332.48,8667.52,0.29,1
2477,358,1000.00,18000.00,19000.00,8276.37,9723.63,0.26,1
2478,358,1000.00,19000.00,20000.00,137.79,18862.21,0.28,1
2479,358,-1000.00,18000.00,19000.00,14154.39,5845.61,0.22,0
2480,358,1000.00,19000.00,20000.00,4344.86,14655.14,0.43,1
2481,358,-1000.00,18000.00,19000.00,11307.90,0.00,0.12,0
2482,358,1000.00,19000.00,20000.00,6558.22,12441.78,0.43,1
2483,358,-1000.00,18000.00,19000.00,17980.81,581.14,0.14,0
2484,358,1000.00,19000.00,20000.00,0.00,19000.00,0.08,1
2485,358,1000.00,20000.00,21000.00,8112.40,11887.60,0.09,1
2486,358,1000.00,21000.00,22000.00,614.64,7368.61,0.23,1
2487,358,-1000.00,20000.00,21000.00,22000.00,0.00,0.11,0
2488,358,-1000.00,19000.00,20000.00,12086.55,8913.45,0.20,0
2489,358,-1000.00,18000.00,19000.00,14755.64,5244.36,0.24,0
2490,358,1000.00,19000.00,20000.00,3232.27,15767.73,0.35,1
2491,358,1000.00,20000.00,21000.00,2182.17,8775.25,0.30,1
2492,359,-1000.00,-1000.00,0.00,0.00,1000.00,0.03,0
2493,360,-1000.00,-1000.00,0.00,157.04,842.96,0.10,0
2494,361,-1000.00,-1000.00,0.00,476.34,523.66,0.11,0
2495,362,-1000.00,-1000.00,0.00,277.17,0.00,0.07,0
2496,363,-1000.00,-1000.00,0.00,389.38,610.62,0.34,0
2497,364,1000.00,1000.00,2000.00,500.00,500.00,0.14,1
2498,364,1000.00,2000.00,3000.00,0.00,2000.00,0.19,1
2499,364,1000.00,3000.00,4000.00,1369.82,1630.18,0.44,1
2500,364,1000.00,4000.00,5000.00,0.00,2920.87,0.13,1
2501,364,1000.00,5000.00,6000.00,2500.00,2500.00,0.05,1
2502,364,-1000.00,4000.00,5000.00,3352.55,2647.45,0.33,0
2503,364,1000.00,5000.00,6000.00,1921.07,3078.93,0.43,1
2504,364,1000.00,6000.00,7000.00,3000.00,3000.00,0.13,1
2505,364,1000.00,7000.00,8000.00,0.00,697.89,0.04,1
2506,364,1000.00,8000.00,9000.00,2760.96,5239.04,0.06,1
2507,364,1000.00,9000.00,10000.00,0.00,9000.00,0.11,1
2508,364,-1000.00,8000.00,9000.00,5016.41,4983.59,0.21,0
2509,364,1000.00,9000.00,10000.00,2404.77,6595.23,0.42,1
2510,364,1000.00,10000.00,11000.00,2991.46,3633.77,0.33,1
2511,364,1000.00,11000.00,12000.00,0.00,4429.03,0.24,1
2512,364,1000.00,12000.00,13000.00,5585.25,6414.75,0.35,1
2513,364,1000.00,13000.00,14000.00,2282.45,10717.55,0.16,1
2514,364,1000.00,14000.00,15000.00,0.00,13741.82,0.24,1
2515,364,-1000.00,13000.00,14000.00,4959.87,0.00,0.14,0
2516,364,-1000.00,12000.00,13000.00,8335.42,5664.58,0.39,0
2517,364,1000.00,13000.00,14000.00,793.27,1868.68,0.22,1
2518,364,-1000.00,12000.00,13000.00,7888.13,6111.87,0.31,0
2519,364,-1000.00,11000.00,12000.00,9116.95,1067.53,0.26,0
2520,364,1000.00,12000.00,13000.00,6000.00,6000.00,0.23,1
2521,364,1000.00,13000.00,14000.00,0.00,9696.83,0.17,1
2522,364,-1000.00,12000.00,13000.00,7345.18,3957.71,0.25,0
2523,364,1000.00,13000.00,14000.00,1241.78,8217.19,0.39,1
2524,364,1000.00,14000.00,15000.00,0.00,14000.00,0.17,1
2525,364,1000.00,15000.00,16000.00,2386.63,12613.37,0.18,1
2526,364,1000.00,16000.00,17000.00,0.00,8910.18,0.10,1
2527,364,-1000.00,15000.00,16000.00,4613.62,0.00,0.11,0
2528,364,1000.00,16000.00,17000.00,0.00,16000.00,0.05,1
2529,364,-1000.00,15000.00,16000.00,10416.11,6583.89,0.41,0
2530,364,1000.00,16000.00,17000.00,0.00,16000.00,0.26,1
2531,364,1000.00,17000.00,18000.00,8500.00,8500.00,0.23,1
2532,364,1000.00,18000.00,19000.00,9000.00,9000.00,0.05,1
2533,364,1000.00,19000.00,20000.00,679.09,18320.91,0.29,1
2534,364,1000.00,20000.00,21000.00,0.00,20000.00,0.04,1
2535,364,1000.00,21000.00,22000.00,2919.41,18080.59,0.31,1
2536,364,-1000.00,20000.00,21000.00,14271.60,7728.40,0.32,0
2537,364,0.00,20000.00,21000.00,0.00,0.00,0.01,0
2538,364,1000.00,21000.00,22000.00,7910.73,13089.27,0.28,1
2539,364,1000.00,22000.00,23000.00,1483.56,20516.44,0.22,1
2540,364,1000.00,23000.00,24000.00,1405.68,14325.00,0.35,1
2541,364,1000.00,24000.00,25000.00,0.00,983.68,0.02,1
2542,364,1000.00,25000.00,26000.00,12236.09,12763.91,0.14,1
2543,364,-1000.00,24000.00,25000.00,13662.14,12337.86,0.30,0
2544,364,-1000.00,23000.00,24000.00,12973.55,5123.49,0.31,0
2545,365,-519.88,-519.88,480.12,299.64,220.24,0.26,0
2546,365,1000.00,480.12,1480.12,0.00,323.87,0.26,1
2547,365,1000.00,1480.12,2480.12,730.57,749.55,0.13,1
2548,365,1000.00,2480.12,3480.12,0.00,2252.26,0.35,1
2549,365,1000.00,3480.12,4480.12,0.00,3480.12,0.14,1
2550,365,1000.00,4480.12,5480.12,1838.30,2641.81,0.43,1
2551,365,-1000.00,3480.12,4480.12,3421.23,2058.89,0.37,0
2552,365,1000.00,4480.12,5480.12,2110.09,2370.03,0.18,1
2553,365,1000.00,5480.12,6480.12,0.00,5480.12,0.00,1
2554,365,1000.00,6480.12,7480.12,2235.10,4245.02,0.41,1
2555,365,1000.00,7480.12,8480.12,2271.96,5208.15,0.19,1
2556,365,-1000.00,6480.12,7480.12,4489.22,3990.90,0.34,0
2557,365,-1000.00,5480.12,6480.12,5377.69,0.00,0.00,0
2558,365,-1000.00,4480.12,5480.12,3653.56,2826.55,0.40,0
2559,365,1000.00,5480.12,6480.12,0.00,5454.20,0.09,1
2560,365,-1000.00,4480.12,5480.12,4149.96,2330.15,0.38,0
2561,365,1000.00,5480.12,6480.12,2621.58,2858.54,0.34,1
2562,365,1000.00,6480.12,7480.12,1865.47,4614.65,0.32,1
2563,365,-1000.00,5480.12,6480.12,4581.83,2898.28,0.19,0
2564,365,1000.00,6480.12,7480.12,454.37,6025.74,0.36,1
2565,365,-1000.00,5480.12,6480.12,5173.78,2306.34,0.34,0
2566,365,1000.00,6480.12,7480.12,2762.99,3717.13,0.37,1
2567,365,-1000.00,5480.12,6480.12,5091.76,2388.36,0.23,0
2568,365,-1000.00,4480.12,5480.12,6480.12,0.00,0.05,0
2569,365,-1000.00,3480.12,4480.12,2778.02,992.73,0.28,0
2570,365,-814.07,2666.05,3666.05,0.00,814.07,0.01,0
2571,365,-1000.00,1666.05,2666.05,0.00,3666.05,0.21,0
2572,365,-1000.00,666.05,1666.05,779.00,1887.05,0.37,0
2573,365,-1000.00,-333.95,666.05,751.39,914.66,0.20,0
2574,365,-666.05,-1000.00,0.00,91.25,574.79,0.36,0
2575,365,-0.00,-1000.00,0.00,0.00,0.00,0.39,0
2576,366,-1000.00,-1000.00,0.00,464.76,535.24,0.29,0
2577,367,0.00,0.00,1000.00,0.00,0.00,0.10,0
2578,367,-1000.00,-1000.00,0.00,300.89,699.11,0.41,0
2579,368,-1000.00,-1000.00,0.00,0.00,1000.00,0.07,0
2580,369,-1000.00,-1000.00,0.00,612.68,387.32,0.22,0
2581,370,1000.00,1000.00,2000.00,4.62,537.50,0.33,1
2582,370,-1000.00,0.00,1000.00,1000.00,1000.00,0.11,0
2583,370,-1000.00,-1000.00,0.00,703.82,296.18,0.15,0
2584,371,0.00,0.00,1000.00,0.00,0.00,0.00,0
2585,371,1000.00,1000.00,2000.00,967.33,0.00,0.06,1
2586,371,-1000.00,0.00,1000.00,671.91,1328.09,0.43,0
2587,371,1000.00,1000.00,2000.00,625.97,374.03,0.25,1
2588,371,1000.00,2000.00,3000.00,1474.57,525.43,0.14,1
2589,371,-1000.00,1000.00,2000.00,1500.00,1500.00,0.05,0
2590,371,-1000.00,0.00,1000.00,49.76,1950.24,0.32,0
2591,371,-1000.00,-1000.00,0.00,0.00,1000.00,0.06,0
2592,372,-1000.00,-1000.00,0.00,403.04,596.96,0.23,0
2593,373,1000.00,1000.00,2000.00,50.45,638.25,0.38,1
2594,373,1000.00,2000.00,3000.00,851.06,1148.94,0.40,1
2595,373,1000.00,3000.00,4000.00,860.51,2139.49,0.27,1
2596,373,-1000.00,2000.00,3000.00,3298.40,557.39,0.18,0
2597,373,-1000.00,1000.00,2000.00,1591.17,1408.83,0.42,0
2598,373,1000.00,2000.00,3000.00,0.00,2000.00,0.09,1
2599,373,-1000.00,1000.00,2000.00,1297.08,0.00,0.03,0
2600,373,-136.90,863.10,1863.10,136.90,0.00,0.02,0
2601,373,1000.00,1863.10,2863.10,594.53,1268.57,0.14,1
2602,373,-1000.00,863.10,1863.10,1542.37,1320.73,0.25,0
2603,373,1000.00,1863.10,2863.10,391.14,1471.96,0.35,1
2604,373,1000.00,2863.10,3863.10,1431.55,1431.55,0.06,1
2605,373,1000.00,3863.10,4863.10,884.85,2978.26,0.35,1
2606,373,1000.00,4863.10,5863.10,0.00,4863.10,0.04,1
2607,373,1000.00,5863.10,6863.10,1931.75,3931.35,0.35,1
2608,373,-1000.00,4863.10,5863.10,6450.49,412.62,0.11,0
2609,373,1000.00,5863.10,6863.10,0.00,5863.10,0.22,1
2610,373,1000.00,6863.10,7863.10,3045.97,3817.14,0.42,1
2611,373,1000.00,7863.10,8863.10,3259.16,4603.95,0.14,1
2612,373,1000.00,8863.10,9863.10,4056.28,4806.82,0.24,1
2613,373,1000.00,9863.10,10863.10,0.00,8100.70,0.03,1
2614,373,1000.00,10863.10,11863.10,2062.16,8800.95,0.35,1
2615,373,-1000.00,9863.10,10863.10,2818.92,3315.95,0.28,0
2616,373,-1000.00,8863.10,9863.10,7472.25,0.00,0.16,0
2617,373,-723.61,8139.50,9139.50,290.49,433.11,0.16,0
2618,373,-1000.00,7139.50,8139.50,2192.25,6947.25,0.42,0
2619,373,-1000.00,6139.50,7139.50,75.84,7634.22,0.29,0
2620,373,-1000.00,5139.50,6139.50,4584.47,2555.03,0.25,0
2621,373,-1000.00,4139.50,5139.50,3069.75,3069.75,0.06,0
2622,373,-1000.00,3139.50,4139.50,0.00,3681.44,0.18,0
2623,373,-1000.00,2139.50,3139.50,0.00,4139.50,0.13,0
2624,373,-1000.00,1139.50,2139.50,2348.17,0.00,0.10,0
2625,373,-1000.00,139.50,1139.50,1069.75,1069.75,0.05,0
2626,373,-1000.00,-860.50,139.50,434.91,704.59,0.42,0
2627,373,-1000.00,-1860.50,-860.50,89.76,49.74,0.26,0
2628,374,1000.00,1000.00,2000.00,0.00,1000.00,0.18,1
2629,374,-1000.00,0.00,1000.00,1577.26,320.73,0.17,0
2630,374,1000.00,1000.00,2000.00,24.46,891.62,0.39,1
2631,374,-1000.00,0.00,1000.00,1053.09,946.91,0.18,0
2632,374,1000.00,1000.00,2000.00,0.00,1000.00,0.06,1
2633,374,1000.00,2000.00,3000.00,384.71,1050.72,0.36,1
2634,374,-1000.00,1000.00,2000.00,2029.69,970.31,0.03,0
2635,374,1000.00,2000.00,3000.00,438.99,1561.01,0.37,1
2636,374,-1000.00,1000.00,2000.00,1015.47,435.78,0.27,0
2637,374,-1000.00,0.00,1000.00,1074.24,925.76,0.38,0
2638,374,0.00,0.00,1000.00,0.00,0.00,0.05,0
2639,374,1000.00,1000.00,2000.00,228.07,771.93,0.23,1
2640,374,1000.00,2000.00,3000.00,6.93,1574.21,0.33,1
2641,374,1000.00,3000.00,4000.00,0.00,3000.00,0.17,1
2642,374,1000.00,4000.00,5000.00,248.30,2094.13,0.30,1
2643,374,-1000.00,3000.00,4000.00,3192.55,0.00,0.21,0
2644,374,1000.00,4000.00,5000.00,1055.13,2944.87,0.41,1
2645,374,1000.00,5000.00,6000.00,2500.00,2500.00,0.20,1
2646,374,-1000.00,4000.00,5000.00,6000.00,0.00,0.04,0
2647,374,1000.00,5000.00,6000.00,1419.75,2266.59,0.36,1
2648,374,1000.00,6000.00,7000.00,2768.47,3231.53,0.29,1
2649,374,-1000.00,5000.00,6000.00,3985.94,196.70,0.26,0
2650,374,-1000.00,4000.00,5000.00,1795.71,219.64,0.17,0
2651,374,-1000.00,3000.00,4000.00,2169.28,0.00,0.12,0
2652,374,1000.00,4000.00,5000.00,357.86,3149.70,0.31,1
2653,374,1000.00,5000.00,6000.00,2302.53,2697.47,0.26,1
2654,374,1000.00,6000.00,7000.00,3000.00,3000.00,0.01,1
2655,374,1000.00,7000.00,8000.00,3500.00,3500.00,0.02,1
2656,374,-1000.00,6000.00,7000.00,4170.20,3829.80,0.23,0
2657,374,1000.00,7000.00,8000.00,2319.14,4680.86,0.37,1
2658,374,-1000.00,6000.00,7000.00,4599.33,0.00,0.02,0
2659,374,0.00,6000.00,7000.00,0.00,0.00,0.00,0
2660,374,1000.00,7000.00,8000.00,3441.66,3558.34,0.16,1
2661,374,-1000.00,6000.00,7000.00,5628.73,2371.27,0.19,0
2662,374,1000.00,7000.00,8000.00,1980.52,5019.48,0.38,1
2663,374,1000.00,8000.00,9000.00,0.00,5559.87,0.29,1
2664,374,-1000.00,7000.00,8000.00,7120.65,988.47,0.24,0
2665,374,-1000.00,6000.00,7000.00,8000.00,0.00,0.03,0
2666,374,1000.00,7000.00,8000.00,1074.04,5925.96,0.12,1
2667,375,-1000.00,-1000.00,0.00,840.00,160.00,0.01,0
2668,376,1000.00,1000.00,2000.00,289.10,710.90,0.12,1
2669,376,1000.00,2000.00,3000.00,472.41,1527.59,0.44,1
2670,376,1000.00,3000.00,4000.00,1500.00,1500.00,0.00,1
2671,376,-1000.00,2000.00,3000.00,4000.00,0.00,0.03,0
2672,376,1000.00,3000.00,4000.00,603.56,2396.44,0.32,1
2673,376,1000.00,4000.00,5000.00,518.88,3481.12,0.06,1
2674,376,1000.00,5000.00,6000.00,0.00,313.08,0.12,1
2675,376,1000.00,6000.00,7000.00,2346.03,3653.97,0.42,1
2676,376,1000.00,7000.00,8000.00,1327.31,5672.69,0.35,1
2677,376,-1000.00,6000.00,7000.00,7626.96,373.04,0.08,0
2678,376,1000.00,7000.00,8000.00,0.00,3306.59,0.10,1
2679,376,-1000.00,6000.00,7000.00,4573.04,1937.16,0.32,0
2680,376,0.00,6000.00,7000.00,0.00,0.00,0.02,0
2681,376,1000.00,7000.00,8000.00,3073.83,3926.17,0.28,1
2682,376,1000.00,8000.00,9000.00,0.00,7021.72,0.22,1
2683,376,-1000.00,7000.00,8000.00,4519.03,4480.97,0.44,0
2684,376,-1000.00,6000.00,7000.00,2346.02,0.00,0.20,0
2685,376,1000.00,7000.00,8000.00,3285.20,3714.80,0.37,1
2686,376,1000.00,8000.00,9000.00,470.14,7529.86,0.11,1
2687,376,1000.00,9000.00,10000.00,0.00,2802.75,0.00,1
2688,376,1000.00,10000.00,11000.00,1391.38,8608.62,0.28,1
2689,376,1000.00,11000.00,12000.00,0.00,7152.11,0.07,1
2690,376,1000.00,12000.00,13000.00,4239.54,7760.46,0.21,1
2691,376,1000.00,13000.00,14000.00,2607.29,10392.71,0.43,1
2692,376,1000.00,14000.00,15000.00,0.00,14000.00,0.01,1
2693,376,1000.00,15000.00,16000.00,5159.48,9840.52,0.29,1
2694,376,1000.00,16000.00,17000.00,3676.18,12323.82,0.25,1
2695,376,1000.00,17000.00,18000.00,5847.87,11152.13,0.41,1
2696,376,-1000.00,16000.00,17000.00,12793.66,5206.34,0.16,0
2697,376,-1000.00,15000.00,16000.00,9649.96,0.00,0.14,0
2698,376,-1000.00,14000.00,15000.00,9181.00,0.00,0.06,0
2699,376,1000.00,15000.00,16000.00,0.00,15000.00,0.25,1
2700,376,1000.00,16000.00,17000.00,8000.00,8000.00,0.02,1
2701,376,-1000.00,15000.00,16000.00,1571.07,0.00,0.14,0
2702,376,-1000.00,14000.00,15000.00,8600.50,7399.50,0.34,0
2703,376,1000.00,15000.00,16000.00,4060.59,10939.41,0.41,1
2704,376,1000.00,16000.00,17000.00,0.00,13895.20,0.30,1
2705,376,1000.00,17000.00,18000.00,37.96,16962.04,0.26,1
2706,376,1000.00,18000.00,19000.00,8625.35,9374.65,0.38,1
2707,376,-1000.00,17000.00,18000.00,11937.02,962.55,0.23,0
2708,376,-1000.00,16000.00,17000.00,9704.17,8295.83,0.13,0
2709,377,-1000.00,-1000.00,0.00,600.49,399.51,0.33,0
2710,377,-0.00,-1000.00,-0.00,0.00,0.00,0.12,0
2711,378,1000.00,1000.00,2000.00,0.00,940.59,0.28,1
2712,378,1000.00,2000.00,3000.00,0.00,465.99,0.20,1
2713,378,1000.00,3000.00,4000.00,0.00,3000.00,0.02,1
2714,378,1000.00,4000.00,5000.00,1691.24,2308.76,0.34,1
2715,378,-1000.00,3000.00,4000.00,3282.47,1019.49,0.30,0
2716,378,-1000.00,2000.00,3000.00,2386.67,1613.33,0.24,0
2717,378,-1000.00,1000.00,2000.00,2038.18,961.82,0.33,0
2718,378,1000.00,2000.00,3000.00,1000.00,1000.00,0.02,1
2719,378,-1000.00,1000.00,2000.00,1833.29,1166.71,0.10,0
2720,378,1000.00,2000.00,3000.00,704.35,1295.65,0.06,1
2721,378,1000.00,3000.00,4000.00,0.00,2994.85,0.34,1
2722,378,-1000.00,2000.00,3000.00,2859.08,0.00,0.17,0
2723,378,1000.00,3000.00,4000.00,523.51,2476.49,0.33,1
2724,378,1000.00,4000.00,5000.00,0.00,2171.09,0.33,1
2725,378,1000.00,5000.00,6000.00,0.00,4538.21,0.36,1
2726,378,1000.00,6000.00,7000.00,2581.78,3418.22,0.19,1
2727,378,1000.00,7000.00,8000.00,3189.10,3810.90,0.35,1
2728,378,1000.00,8000.00,9000.00,2179.69,5281.63,0.40,1
2729,378,-1000.00,7000.00,8000.00,4263.85,603.71,0.26,0
2730,378,1000.00,8000.00,9000.00,0.00,2146.11,0.09,1
2731,378,-1000.00,7000.00,8000.00,3914.57,2276.69,0.33,0
2732,378,-1000.00,6000.00,7000.00,6713.38,1286.62,0.06,0
2733,378,-1000.00,5000.00,6000.00,5695.50,0.00,0.04,0
2734,378,1000.00,6000.00,7000.00,1832.24,4167.76,0.03,1
2735,378,1000.00,7000.00,8000.00,0.00,3192.19,0.17,1
2736,378,-1000.00,6000.00,7000.00,8000.00,0.00,0.02,0
2737,378,-1000.00,5000.00,6000.00,5623.44,1376.56,0.14,0
2738,378,1000.00,6000.00,7000.00,1755.84,4244.16,0.41,1
2739,378,-1000.00,5000.00,6000.00,3787.04,3212.96,0.12,0
2740,378,1000.00,6000.00,7000.00,1664.69,4335.31,0.40,1
2741,378,1000.00,7000.00,8000.00,0.00,7000.00,0.03,1
2742,378,1000.00,8000.00,9000.00,2847.32,5152.68,0.12,1
2743,378,1000.00,9000.00,10000.00,4143.67,4856.33,0.36,1
2744,378,1000.00,10000.00,11000.00,5000.00,5000.00,0.01,1
2745,378,-1000.00,9000.00,10000.00,3654.34,1705.05,0.23,0
2746,378,1000.00,10000.00,11000.00,3326.25,6673.75,0.43,1
2747,378,1000.00,11000.00,12000.00,1323.00,9677.00,0.34,1
2748,378,-1000.00,10000.00,11000.00,8203.90,3796.10,0.32,0
2749,378,-1000.00,9000.00,10000.00,7438.21,3561.79,0.34,0
2750,378,1000.00,10000.00,11000.00,0.00,3194.91,0.12,1
2751,378,-1000.00,9000.00,10000.00,9740.86,1259.14,0.17,0
2752,378,1000.00,10000.00,11000.00,3295.86,6704.14,0.27,1
2753,378,-983.89,9016.11,10016.11,983.89,0.00,0.05,0
2754,378,1000.00,10016.11,11016.11,4842.98,5173.13,0.43,1
2755,378,0.00,10016.11,11016.11,0.00,0.00,0.10,0
2756,378,1000.00,11016.11,12016.11,0.00,10235.62,0.21,1
2757,378,1000.00,12016.11,13016.11,0.00,12016.11,0.23,1
2758,378,-1000.00,11016.11,12016.11,13016.11,0.00,0.03,0
2759,378,0.00,11016.11,12016.11,0.00,0.00,0.07,0
2760,378,-1000.00,10016.11,11016.11,10129.64,1886.47,0.16,0
2761,378,-1000.00,9016.11,10016.11,2157.79,8858.32,0.10,0
2762,378,-1000.00,8016.11,9016.11,10016.11,0.00,0.03,0
2763,378,-1000.00,7016.11,8016.11,4141.94,3970.57,0.36,0
2764,378,-1000.00,6016.11,7016.11,2044.12,5971.99,0.41,0
2765,378,-1000.00,5016.11,6016.11,3428.24,3587.87,0.26,0
2766,378,-1000.00,4016.11,5016.11,3132.63,2883.48,0.38,0
2767,378,-1000.00,3016.11,4016.11,2508.06,2508.06,0.05,0
2768,378,-1000.00,2016.11,3016.11,1751.32,683.62,0.28,0
2769,378,-1000.00,1016.11,2016.11,1508.06,1508.06,0.14,0
2770,378,-1000.00,16.11,1016.11,1033.13,982.98,0.23,0
2771,378,-906.49,-890.38,109.62,0.00,906.49,0.32,0
2772,378,-109.62,-1000.00,0.00,0.00,109.62,0.17,0
2773,379,1000.00,1000.00,2000.00,0.00,1000.00,0.28,1
2774,379,1000.00,2000.00,3000.00,1000.00,1000.00,0.07,1
2775,379,1000.00,3000.00,4000.00,851.67,2148.33,0.31,1
2776,379,-1000.00,2000.00,3000.00,4000.00,0.00,0.00,0
2777,379,-1000.00,1000.00,2000.00,1102.96,0.00,0.16,0
2778,379,1000.00,2000.00,3000.00,0.00,1327.81,0.02,1
2779,379,-1000.00,1000.00,2000.00,2086.26,913.74,0.07,0
2780,379,1000.00,2000.00,3000.00,0.00,2000.00,0.16,1
2781,379,-246.10,1753.90,2753.90,246.10,0.00,0.01,0
2782,379,1000.00,2753.90,3753.90,0.00,584.39,0.15,1
2783,379,-1000.00,1753.90,2753.90,2295.05,1458.86,0.17,0
2784,379,1000.00,2753.90,3753.90,741.23,2012.67,0.44,1
2785,379,-408.34,2345.56,3345.56,408.34,0.00,0.16,0
2786,379,1000.00,3345.56,4345.56,1477.91,1867.65,0.29,1
2787,379,1000.00,4345.56,5345.56,1277.76,3067.80,0.34,1
2788,379,-1000.00,3345.56,4345.56,1761.57,713.67,0.29,0
2789,379,1000.00,4345.56,5345.56,1896.35,2449.21,0.41,1
2790,379,-1000.00,3345.56,4345.56,2957.80,2387.76,0.27,0
2791,379,-1000.00,2345.56,3345.56,2953.01,1392.55,0.25,0
2792,379,1000.00,3345.56,4345.56,0.00,3345.56,0.05,1
2793,379,1000.00,4345.56,5345.56,2083.01,2262.55,0.35,1
2794,379,-1000.00,3345.56,4345.56,3200.67,2144.89,0.30,0
2795,379,1000.00,4345.56,5345.56,2172.78,2172.78,0.10,1
2796,379,1000.00,5345.56,6345.56,1388.86,3956.70,0.37,1
2797,379,1000.00,6345.56,7345.56,0.00,2653.24,0.17,1
2798,379,1000.00,7345.56,8345.56,3424.43,3921.13,0.22,1
2799,379,1000.00,8345.56,9345.56,0.00,4727.44,0.32,1
2800,379,-1000.00,7345.56,8345.56,5475.13,3870.44,0.32,0
2801,379,-1000.00,6345.56,7345.56,4333.96,0.00,0.09,0
2802,379,1000.00,7345.56,8345.56,3211.27,4134.29,0.26,1
2803,379,1000.00,8345.56,9345.56,3825.39,4520.17,0.28,1
2804,379,1000.00,9345.56,10345.56,4455.81,4889.76,0.20,1
2805,379,1000.00,10345.56,11345.56,770.33,1522.53,0.21,1
2806,379,1000.00,11345.56,12345.56,0.00,11345.56,0.10,1
2807,379,-1000.00,10345.56,11345.56,3247.80,0.00,0.07,0
2808,379,1000.00,11345.56,12345.56,4206.35,7139.22,0.42,1
2809,379,1000.00,12345.56,13345.56,709.11,11636.45,0.09,1
2810,379,1000.00,13345.56,14345.56,3615.42,7402.67,0.40,1
2811,379,1000.00,14345.56,15345.56,2584.99,8703.51,0.38,1
2812,380,-1000.00,-1000.00,0.00,599.03,400.97,0.36,0
2813,381,-1000.00,-1000.00,0.00,602.77,397.23,0.35,0
2814,382,-1000.00,-1000.00,0.00,181.46,818.54,0.44,0
2815,383,-1000.00,-1000.00,0.00,198.68,801.32,0.00,0
2816,384,-946.11,-946.11,53.89,717.04,229.06,0.26,0
2817,384,-53.89,-1000.00,0.00,53.89,0.00,0.07,0
2818,385,-1000.00,-1000.00,0.00,0.00,1000.00,0.07,0
2819,386,-1000.00,-1000.00,0.00,506.49,493.51,0.32,0
2820,387,0.00,0.00,1000.00,0.00,0.00,0.06,0
2821,387,1000.00,1000.00,2000.00,0.00,1000.00,0.34,1
2822,387,1000.00,2000.00,3000.00,471.22,1528.78,0.37,1
2823,387,1000.00,3000.00,4000.00,0.00,3000.00,0.15,1
2824,387,1000.00,4000.00,5000.00,0.00,561.22,0.21,1
2825,387,1000.00,5000.00,6000.00,1377.12,3091.25,0.42,1
2826,387,-1000.00,4000.00,5000.00,1983.30,166.18,0.23,0
2827,387,1000.00,5000.00,6000.00,0.00,5000.00,0.01,1
2828,387,1000.00,6000.00,7000.00,1911.77,4088.23,0.27,1
2829,387,1000.00,7000.00,8000.00,0.00,7000.00,0.04,1
2830,387,-1000.00,6000.00,7000.00,5545.25,2454.75,0.16,0
2831,387,1000.00,7000.00,8000.00,0.00,5064.99,0.19,1
2832,387,1000.00,8000.00,9000.00,0.00,4256.65,0.20,1
2833,387,-1000.00,7000.00,8000.00,2538.03,551.37,0.25,0
2834,387,-1000.00,6000.00,7000.00,5195.71,0.00,0.14,0
2835,387,-1000.00,5000.00,6000.00,3835.90,3164.10,0.28,0
2836,387,1000.00,6000.00,7000.00,2193.26,3806.74,0.36,1
2837,387,1000.00,7000.00,8000.00,3083.36,3916.64,0.42,1
2838,387,0.00,7000.00,8000.00,0.00,0.00,0.12,0
2839,387,1000.00,8000.00,9000.00,0.00,6591.96,0.17,1
2840,387,-1000.00,7000.00,8000.00,5375.44,3624.56,0.18,0
2841,387,-1000.00,6000.00,7000.00,4133.11,3866.89,0.33,0
2842,387,1000.00,7000.00,8000.00,93.67,1830.15,0.26,1
2843,387,1000.00,8000.00,9000.00,0.00,8000.00,0.06,1
2844,387,1000.00,9000.00,10000.00,0.00,9000.00,0.13,1
2845,387,1000.00,10000.00,11000.00,0.00,10000.00,0.26,1
2846,387,1000.00,11000.00,12000.00,0.00,10223.36,0.02,1
2847,387,1000.00,12000.00,13000.00,4083.49,7916.51,0.39,1
2848,387,-1000.00,11000.00,12000.00,6564.92,6435.08,0.26,0
2849,387,0.00,11000.00,12000.00,0.00,0.00,0.04,0
2850,387,1000.00,12000.00,13000.00,3267.99,8732.01,0.41,1
2851,387,-1000.00,11000.00,12000.00,7877.37,5053.95,0.38,0
2852,387,-1000.00,10000.00,11000.00,12000.00,0.00,0.03,0
2853,387,1000.00,11000.00,12000.00,3228.30,7771.70,0.15,1
2854,387,1000.00,12000.00,13000.00,2380.12,9619.88,0.33,1
2855,387,1000.00,13000.00,14000.00,6372.64,6627.36,0.06,1
2856,387,-1000.00,12000.00,13000.00,10535.16,3464.84,0.23,0
2857,387,1000.00,13000.00,14000.00,6250.17,6749.83,0.33,1
2858,387,-1000.00,12000.00,13000.00,7383.31,5275.56,0.39,0
2859,387,1000.00,13000.00,14000.00,5609.43,7390.57,0.23,1
2860,387,-1000.00,12000.00,13000.00,9671.96,4328.04,0.37,0
2861,387,-1000.00,11000.00,12000.00,5480.90,0.00,0.13,0
2862,387,1000.00,12000.00,13000.00,5973.91,6026.09,0.26,1
2863,388,-73.28,-73.28,926.72,73.28,0.00,0.07,0
2864,388,-1000.00,-1073.28,-73.28,0.00,537.94,0.30,0
2865,389,-461.73,-461.73,538.27,461.73,0.00,0.14,0
2866,389,1000.00,538.27,1538.27,163.04,260.81,0.39,1
2867,389,1000.00,1538.27,2538.27,541.21,997.06,0.02,1
2868,389,1000.00,2538.27,3538.27,0.00,880.50,0.22,1
2869,389,1000.00,3538.27,4538.27,1769.13,1769.13,0.05,1
2870,389,1000.00,4538.27,5538.27,0.00,4538.27,0.23,1
2871,389,1000.00,5538.27,6538.27,2688.61,2849.66,0.40,1
2872,389,-1000.00,4538.27,5538.27,4363.42,2174.85,0.05,0
2873,389,-1000.00,3538.27,4538.27,2786.01,2752.26,0.14,0
2874,389,1000.00,4538.27,5538.27,479.14,4059.12,0.26,1
2875,389,1000.00,5538.27,6538.27,1298.59,4239.68,0.36,1
2876,389,1000.00,6538.27,7538.27,3269.13,3269.13,0.11,1
2877,389,1000.00,7538.27,8538.27,3769.13,3769.13,0.02,1
2878,389,1000.00,8538.27,9538.27,0.00,8538.27,0.01,1
2879,389,-1000.00,7538.27,8538.27,6383.74,3154.53,0.31,0
2880,389,1000.00,8538.27,9538.27,0.00,3503.53,0.20,1
2881,389,-1000.00,7538.27,8538.27,9069.47,468.80,0.13,0
2882,389,1000.00,8538.27,9538.27,3009.43,5180.06,0.39,1
2883,389,1000.00,9538.27,10538.27,4769.13,4769.13,0.12,1
2884,389,-1000.00,8538.27,9538.27,5825.26,4713.01,0.08,0
2885,389,1000.00,9538.27,10538.27,0.00,2389.54,0.19,1
2886,389,1000.00,10538.27,11538.27,0.00,9188.91,0.17,1
2887,389,-1000.00,9538.27,10538.27,2618.51,8919.76,0.15,0
2888,389,-1000.00,8538.27,9538.27,5225.71,5312.56,0.36,0
2889,389,-1000.00,7538.27,8538.27,5703.75,3834.52,0.32,0
2890,389,-1000.00,6538.27,7538.27,5985.83,1862.62,0.22,0
2891,389,-1000.00,5538.27,6538.27,7538.27,0.00,0.04,0
2892,389,0.00,5538.27,6538.27,0.00,0.00,0.03,0
2893,389,-1000.00,4538.27,5538.27,3269.13,3269.13,0.23,0
2894,389,-1000.00,3538.27,4538.27,1612.56,3925.71,0.42,0
2895,389,-1000.00,2538.27,3538.27,1471.76,0.00,0.16,0
2896,389,-1000.00,1538.27,2538.27,1769.13,1769.13,0.11,0
2897,389,-1000.00,538.27,1538.27,925.46,144.31,0.21,0
2898,389,-1000.00,-461.73,538.27,325.48,1212.79,0.12,0
2899,389,-254.77,-716.50,283.50,0.00,254.77,0.01,0
2900,389,-1000.00,-1716.50,-716.50,151.85,131.65,0.26,0
2901,390,-1000.00,-1000.00,0.00,67.44,932.56,0.05,0
2902,391,-1000.00,-1000.00,0.00,764.98,90.50,0.19,0
2903,392,-1000.00,-1000.00,0.00,500.00,500.00,0.13,0
2904,393,-580.85,-580.85,419.15,580.85,0.00,0.16,0
2905,393,-1000.00,-1580.85,-580.85,42.11,161.90,0.37,0
2906,394,-1000.00,-1000.00,0.00,341.28,658.72,0.43,0
2907,395,1000.00,1000.00,2000.00,181.04,660.63,0.42,1
2908,395,1000.00,2000.00,3000.00,0.00,2000.00,0.25,1
2909,395,1000.00,3000.00,4000.00,0.00,1725.94,0.15,1
2910,395,-1000.00,2000.00,3000.00,1105.07,0.00,0.04,0
2911,395,1000.00,3000.00,4000.00,301.53,2698.47,0.34,1
2912,395,1000.00,4000.00,5000.00,0.00,525.56,0.12,1
2913,395,-1000.00,3000.00,4000.00,2592.36,2407.64,0.36,0
2914,395,-1000.00,2000.00,3000.00,1129.89,0.00,0.04,0
2915,395,1000.00,3000.00,4000.00,804.71,2195.29,0.20,1
2916,395,1000.00,4000.00,5000.00,0.00,2410.60,0.32,1
2917,395,-1000.00,3000.00,4000.00,2403.51,0.00,0.13,0
2918,395,-1000.00,2000.00,3000.00,3504.54,495.46,0.11,0
2919,395,1000.00,3000.00,4000.00,0.00,1449.45,0.28,1
2920,395,1000.00,4000.00,5000.00,0.00,4000.00,0.16,1
2921,395,-1000.00,3000.00,4000.00,3675.14,1324.86,0.33,0
2922,395,1000.00,4000.00,5000.00,0.00,2072.21,0.13,1
2923,395,-1000.00,3000.00,4000.00,3125.68,1874.32,0.16,0
2924,395,-1000.00,2000.00,3000.00,1390.91,860.58,0.26,0
2925,395,-1000.00,1000.00,2000.00,2069.08,930.92,0.22,0
2926,395,1000.00,2000.00,3000.00,177.12,1551.17,0.41,1
2927,395,-1000.00,1000.00,2000.00,1530.68,0.00,0.19,0
2928,395,1000.00,2000.00,3000.00,0.00,2000.00,0.13,1
2929,395,1000.00,3000.00,4000.00,0.00,2638.71,0.13,1
2930,395,1000.00,4000.00,5000.00,0.00,4000.00,0.12,1
2931,395,-1000.00,3000.00,4000.00,3167.72,1832.28,0.18,0
2932,395,-1000.00,2000.00,3000.00,1377.51,2622.49,0.43,0
2933,395,-1000.00,1000.00,2000.00,1427.88,1572.12,0.42,0
2934,395,-1000.00,0.00,1000.00,731.35,1268.65,0.00,0
2935,395,-426.39,-426.39,573.61,0.00,426.39,0.12,0
2936,395,-573.61,-1000.00,0.00,199.01,374.60,0.43,0
2937,396,-1000.00,-1000.00,0.00,0.00,1000.00,0.07,0
2938,397,-1000.00,-1000.00,0.00,0.00,1000.00,0.06,0
2939,398,0.00,0.00,1000.00,0.00,0.00,0.06,0
2940,398,1000.00,1000.00,2000.00,0.00,891.87,0.23,1
2941,398,-1000.00,0.00,1000.00,1574.88,425.12,0.10,0
2942,398,-1000.00,-1000.00,0.00,890.28,109.72,0.18,0
2943,399,-460.54,-460.54,539.46,161.26,299.28,0.27,0
2944,399,-1000.00,-1460.54,-460.54,280.74,258.72,0.14,0
2945,400,-1000.00,-1000.00,0.00,1000.00,0.00,0.04,0
2946,401,-221.74,-221.74,778.26,0.00,221.74,0.19,0
2947,401,-778.26,-1000.00,-0.00,82.84,695.42,0.36,0
2948,402,-1000.00,-1000.00,0.00,0.00,1000.00,0.14,0
2949,403,-1000.00,-1000.00,0.00,454.90,545.10,0.07,0
2950,404,-533.21,-533.21,466.79,509.67,23.55,0.18,0
2951,404,-220.02,-753.23,246.77,211.56,8.46,0.18,0
2952,404,-1000.00,-1753.23,-753.23,123.39,123.39,0.15,0
2953,405,0.00,0.00,1000.00,0.00,0.00,0.03,0
2954,405,-1000.00,-1000.00,0.00,654.70,345.30,0.03,0
2955,406,-1000.00,-1000.00,0.00,0.00,1000.00,0.17,0
2956,407,-1000.00,-1000.00,0.00,500.00,500.00,0.01,0
2957,408,-1000.00,-1000.00,0.00,392.44,607.56,0.20,0
2958,409,-1000.00,-1000.00,0.00,211.70,0.00,0.11,0
2959,410,-1000.00,-1000.00,0.00,211.94,788.06,0.33,0
2960,411,-1000.00,-1000.00,0.00,107.26,892.74,0.23,0
2961,412,1000.00,1000.00,2000.00,597.95,402.05,0.18,1
2962,412,-1000.00,0.00,1000.00,449.15,1550.85,0.22,0
2963,412,-1000.00,-1000.00,0.00,398.56,601.44,0.28,0
2964,413,-1000.00,-1000.00,0.00,131.92,706.28,0.41,0
2965,414,-1000.00,-1000.00,0.00,0.00,513.27,0.28,0
2966,415,-615.77,-615.77,384.23,615.77,384.23,0.28,0
2967,415,-323.12,-938.90,61.10,0.00,323.12,0.12,0
2968,415,-34.45,-973.35,26.65,34.45,26.65,0.09,0
2969,415,-20.69,-994.04,5.96,0.00,20.69,0.25,0
2970,415,-5.96,-1000.00,0.00,2.62,3.34,0.34,0
2971,416,0.00,0.00,1000.00,0.00,0.00,0.04,0
2972,416,-1000.00,-1000.00,0.00,423.76,576.24,0.41,0
2973,417,-1000.00,-1000.00,0.00,0.00,1000.00,0.19,0
2974,418,-352.73,-352.73,647.27,0.00,352.73,0.13,0
2975,418,-1000.00,-1352.73,-352.73,293.40,0.00,0.08,0
2976,419,1000.00,1000.00,2000.00,471.42,528.58,0.23,1
2977,419,1000.00,2000.00,3000.00,796.04,1203.96,0.09,1
2978,419,1000.00,3000.00,4000.00,1500.00,1500.00,0.03,1
2979,419,1000.00,4000.00,5000.00,1683.31,2316.69,0.36,1
2980,419,1000.00,5000.00,6000.00,262.51,4737.49,0.31,1
2981,419,-1000.00,4000.00,5000.00,3848.12,2151.88,0.16,0
2982,419,1000.00,5000.00,6000.00,264.12,3160.36,0.35,1
2983,419,-1000.00,4000.00,5000.00,5073.79,0.00,0.12,0
2984,419,1000.00,5000.00,6000.00,1777.65,3222.35,0.37,1
2985,419,1000.00,6000.00,7000.00,621.11,5378.89,0.01,1
2986,419,1000.00,7000.00,8000.00,999.48,5786.52,0.41,1
2987,419,1000.00,8000.00,9000.00,2203.67,5796.33,0.38,1
2988,419,1000.00,9000.00,10000.00,448.77,1963.95,0.21,1
2989,419,1000.00,10000.00,11000.00,0.00,5462.24,0.18,1
2990,419,-1000.00,9000.00,10000.00,5631.64,5368.36,0.04,0
2991,419,1000.00,10000.00,11000.00,3013.65,5398.04,0.37,1
2992,419,-1000.00,9000.00,10000.00,7139.44,3860.56,0.38,0
2993,419,1000.00,10000.00,11000.00,2923.55,6755.37,0.41,1
2994,419,-1000.00,9000.00,10000.00,8707.26,2292.74,0.07,0
2995,419,1000.00,10000.00,11000.00,0.00,4591.05,0.29,1
2996,419,1000.00,11000.00,12000.00,5500.00,5500.00,0.11,1
2997,419,1000.00,12000.00,13000.00,5740.30,6259.70,0.31,1
2998,419,1000.00,13000.00,14000.00,6500.00,6500.00,0.25,1
2999,419,1000.00,14000.00,15000.00,4508.19,9491.81,0.21,1
3000,419,-1000.00,13000.00,14000.00,8034.45,6965.55,0.35,0
3001,419,1000.00,14000.00,15000.00,5581.05,8418.95,0.33,1
3002,419,1000.00,15000.00,16000.00,5687.08,9312.92,0.27,1
3003,419,-1000.00,14000.00,15000.00,4479.92,0.00,0.10,0
3004,419,1000.00,15000.00,16000.00,3109.69,11890.31,0.42,1
3005,419,1000.00,16000.00,17000.00,6188.27,9811.73,0.42,1
3006,419,1000.00,17000.00,18000.00,5768.71,11231.29,0.31,1
3007,419,1000.00,18000.00,19000.00,2682.26,9428.60,0.35,1
3008,419,1000.00,19000.00,20000.00,9281.50,9718.50,0.25,1
3009,419,1000.00,20000.00,21000.00,6844.30,10119.72,0.36,1
3010,419,1000.00,21000.00,22000.00,10500.00,10500.00,0.04,1
3011,419,1000.00,22000.00,23000.00,10317.32,11682.68,0.06,1
3012,419,1000.00,23000.00,24000.00,2376.19,11355.57,0.32,1
3013,419,-1000.00,22000.00,23000.00,17999.44,3666.82,0.28,0
3014,419,1000.00,23000.00,24000.00,0.00,13893.32,0.19,1
3015,419,1000.00,24000.00,25000.00,0.00,24000.00,0.05,1
3016,419,0.00,24000.00,25000.00,0.00,0.00,0.01,0
3017,420,-1000.00,-1000.00,0.00,311.44,688.56,0.43,0
3018,421,-1000.00,-1000.00,0.00,306.81,693.19,0.20,0
3019,422,-1000.00,-1000.00,0.00,168.84,142.10,0.19,0
3020,423,-1000.00,-1000.00,0.00,539.54,217.12,0.20,0
3021,424,-1000.00,-1000.00,0.00,447.79,552.21,0.33,0
3022,425,-773.67,-773.67,226.33,773.67,0.00,0.10,0
3023,425,-226.33,-1000.00,0.00,120.44,105.90,0.29,0
3024,426,-1000.00,-1000.00,0.00,313.49,686.51,0.30,0
3025,427,-1000.00,-1000.00,0.00,0.00,1000.00,0.17,0
3026,428,-1000.00,-1000.00,0.00,1000.00,0.00,0.01,0
3027,429,1000.00,1000.00,2000.00,365.37,634.63,0.35,1
3028,429,-1000.00,0.00,1000.00,1994.11,0.00,0.00,0
3029,429,1000.00,1000.00,2000.00,0.00,808.29,0.17,1
3030,429,1000.00,2000.00,3000.00,733.68,880.74,0.38,1
3031,429,1000.00,3000.00,4000.00,1055.82,1944.18,0.44,1
3032,429,1000.00,4000.00,5000.00,0.00,3351.45,0.29,1
3033,429,-1000.00,3000.00,4000.00,1787.74,0.00,0.17,0
3034,429,1000.00,4000.00,5000.00,1992.28,2007.72,0.39,1
3035,429,1000.00,5000.00,6000.00,1921.20,3078.80,0.42,1
3036,429,1000.00,6000.00,7000.00,0.00,6000.00,0.11,1
3037,429,1000.00,7000.00,8000.00,2754.97,3856.29,0.38,1
3038,429,-1000.00,6000.00,7000.00,4302.61,3697.39,0.07,0
3039,429,-1000.00,5000.00,6000.00,3720.10,3279.90,0.32,0
3040,429,1000.00,6000.00,7000.00,0.00,5859.90,0.21,1
3041,429,1000.00,7000.00,8000.00,733.95,2186.15,0.28,1
3042,429,1000.00,8000.00,9000.00,2965.46,5034.54,0.38,1
3043,429,1000.00,9000.00,10000.00,1957.75,7042.25,0.10,1
3044,429,1000.00,10000.00,11000.00,0.00,5502.07,0.22,1
3045,429,1000.00,11000.00,12000.00,4486.17,5990.43,0.40,1
3046,429,1000.00,12000.00,13000.00,5910.56,6089.44,0.23,1
3047,429,1000.00,13000.00,14000.00,6383.80,6616.20,0.06,1
3048,429,-1000.00,12000.00,13000.00,7535.07,5241.50,0.29,0
3049,429,-1000.00,11000.00,12000.00,6377.39,6622.61,0.16,0
3050,429,-1000.00,10000.00,11000.00,1828.51,10171.49,0.01,0
3051,429,-1000.00,9000.00,10000.00,0.00,11000.00,0.17,0
3052,429,-1000.00,8000.00,9000.00,4478.35,5521.65,0.35,0
3053,429,-1000.00,7000.00,8000.00,3685.88,5314.12,0.14,0
3054,429,-1000.00,6000.00,7000.00,4000.00,4000.00,0.14,0
3055,429,-1000.00,5000.00,6000.00,5749.22,1250.78,0.23,0
3056,429,-1000.00,4000.00,5000.00,3000.00,3000.00,0.08,0
3057,429,-1000.00,3000.00,4000.00,0.00,2839.08,0.32,0
3058,429,-1000.00,2000.00,3000.00,2591.03,1408.97,0.28,0
3059,429,-794.14,1205.86,2205.86,333.02,461.11,0.23,0
3060,429,-1000.00,205.86,1205.86,1433.47,772.40,0.25,0
3061,429,-1000.00,-794.14,205.86,212.42,956.85,0.43,0
3062,429,-1000.00,-1794.14,-794.14,118.50,87.37,0.37,0
3063,430,-1000.00,-1000.00,0.00,289.35,710.65,0.43,0
3064,431,-1000.00,-1000.00,0.00,826.32,173.68,0.02,0
3065,432,-1000.00,-1000.00,0.00,0.00,1000.00,0.17,0
3066,433,-1000.00,-1000.00,0.00,0.00,1000.00,0.06,0
3067,434,-1000.00,-1000.00,0.00,780.26,219.74,0.11,0
3068,435,-1000.00,-1000.00,0.00,0.00,1000.00,0.13,0
3069,436,-1000.00,-1000.00,0.00,419.60,580.40,0.36,0
3070,437,-95.62,-95.62,904.38,0.00,95.62,0.15,0
3071,437,-685.72,-781.33,218.67,0.00,685.72,0.12,0
3072,437,-218.67,-1000.00,-0.00,71.16,147.51,0.10,0
3073,438,-1000.00,-1000.00,0.00,714.73,285.27,0.18,0
3074,439,-1000.00,-1000.00,0.00,0.00,643.09,0.25,0
3075,440,1000.00,1000.00,2000.00,180.89,819.11,0.28,1
3076,440,1000.00,2000.00,3000.00,10.34,1989.66,0.08,1
3077,440,1000.00,3000.00,4000.00,0.00,1098.48,0.24,1
3078,440,1000.00,4000.00,5000.00,509.13,1087.67,0.25,1
3079,440,-1000.00,3000.00,4000.00,2673.25,1585.49,0.31,0
3080,440,1000.00,4000.00,5000.00,1840.73,2093.53,0.36,1
3081,440,1000.00,5000.00,6000.00,0.00,1533.43,0.11,1
3082,440,1000.00,6000.00,7000.00,1160.43,4839.57,0.39,1
3083,440,-1000.00,5000.00,6000.00,6569.30,430.70,0.11,0
3084,440,-1000.00,4000.00,5000.00,4409.21,1590.79,0.15,0
3085,440,1000.00,5000.00,6000.00,0.00,2518.73,0.13,1
3086,440,1000.00,6000.00,7000.00,1430.66,4569.34,0.04,1
3087,440,1000.00,7000.00,8000.00,2406.09,4593.91,0.25,1
3088,440,1000.00,8000.00,9000.00,247.51,3275.82,0.30,1
3089,440,1000.00,9000.00,10000.00,0.00,9000.00,0.16,1
3090,440,1000.00,10000.00,11000.00,0.00,6394.81,0.14,1
3091,440,1000.00,11000.00,12000.00,1682.84,9317.16,0.27,1
3092,440,1000.00,12000.00,13000.00,3485.69,8514.31,0.09,1
3093,440,1000.00,13000.00,14000.00,4123.98,8876.02,0.44,1
3094,440,-1000.00,12000.00,13000.00,0.00,5337.48,0.12,0
3095,440,-1000.00,11000.00,12000.00,4638.71,8361.29,0.41,0
3096,440,-1000.00,10000.00,11000.00,3841.79,8158.21,0.40,0
3097,440,-1000.00,9000.00,10000.00,5350.67,0.00,0.13,0
3098,440,-1000.00,8000.00,9000.00,2852.34,7147.66,0.44,0
3099,440,-1000.00,7000.00,8000.00,156.06,5046.36,0.34,0
3100,440,-1000.00,6000.00,7000.00,4000.00,4000.00,0.22,0
3101,440,-1000.00,5000.00,6000.00,0.00,7000.00,0.35,0
3102,440,-1000.00,4000.00,5000.00,4222.94,1777.06,0.15,0
3103,440,-1000.00,3000.00,4000.00,2519.79,2480.21,0.17,0
3104,440,-1000.00,2000.00,3000.00,2728.04,1271.96,0.25,0
3105,440,-1000.00,1000.00,2000.00,789.11,2210.89,0.23,0
3106,440,-1000.00,0.00,1000.00,1350.01,649.99,0.23,0
3107,440,-1000.00,-1000.00,0.00,425.29,574.71,0.16,0
3108,441,-962.54,-962.54,37.46,0.00,962.54,0.40,0
3109,441,-12.38,-974.91,25.09,2.66,9.71,0.24,0
3110,441,-22.36,-997.28,2.72,0.00,22.36,0.08,0
3111,441,-2.72,-1000.00,0.00,0.43,2.29,0.39,0
3112,442,-1000.00,-1000.00,0.00,568.81,431.19,0.33,0
3113,443,-1000.00,-1000.00,0.00,0.00,798.41,0.35,0
3114,444,-1000.00,-1000.00,0.00,514.60,124.35,0.17,0
3115,445,0.00,0.00,1000.00,466.40,533.60,0.03,0
3116,445,0.00,0.00,1000.00,187.10,812.90,0.40,0
3117,445,0.00,0.00,1000.00,160.66,839.34,0.29,0
3118,445,0.00,0.00,1000.00,0.00,484.77,0.26,0
3119,445,0.00,0.00,1000.00,111.13,611.98,0.39,0
3120,445,0.00,0.00,1000.00,474.36,525.64,0.17,0
3121,445,0.00,0.00,1000.00,287.71,596.23,0.40,0
3122,445,0.00,0.00,1000.00,476.72,523.28,0.42,0
3123,445,0.00,0.00,1000.00,433.76,566.24,0.44,0
3124,445,0.00,0.00,1000.00,0.00,1000.00,0.15,0
3125,445,-1000.00,-1000.00,0.00,1000.00,0.00,0.04,0
3126,446,-1000.00,-1000.00,0.00,97.63,902.37,0.26,0
3127,447,-958.56,-958.56,41.44,307.65,650.91,0.42,0
3128,447,1000.00,41.44,1041.44,29.99,11.45,0.22,1
3129,447,-735.71,-694.27,305.73,0.00,735.71,0.21,0
3130,447,1000.00,305.73,1305.73,268.60,0.00,0.09,1
3131,447,-1000.00,-694.27,305.73,0.00,1002.59,0.36,0
3132,447,1000.00,305.73,1305.73,80.11,0.00,0.14,1
3133,447,-1000.00,-694.27,305.73,415.44,890.28,0.44,0
3134,447,-253.11,-947.38,52.62,5.16,247.95,0.34,0
3135,447,-52.62,-1000.00,0.00,24.58,28.04,0.38,0
3136,448,1000.00,1000.00,2000.00,1000.00,0.00,0.02,1
3137,448,-1000.00,0.00,1000.00,0.00,1332.12,0.09,0
3138,448,-1000.00,-1000.00,0.00,418.91,581.09,0.07,0
3139,449,-1000.00,-1000.00,0.00,274.12,725.88,0.23,0
3140,450,-633.22,-633.22,366.78,0.00,633.22,0.19,0
3141,450,-1000.00,-1633.22,-633.22,27.28,0.00,0.12,0
3142,451,-1000.00,-1000.00,0.00,480.14,109.19,0.20,0
3143,452,1000.00,1000.00,2000.00,625.04,374.96,0.17,1
3144,452,1000.00,2000.00,3000.00,808.95,406.80,0.26,1
3145,452,-1000.00,1000.00,2000.00,297.03,2702.97,0.37,0
3146,452,0.00,1000.00,2000.00,0.00,0.00,0.01,0
3147,452,-1000.00,0.00,1000.00,0.00,2000.00,0.05,0
3148,452,0.00,0.00,1000.00,0.00,0.00,0.15,0
3149,452,-442.04,-442.04,557.96,0.00,442.04,0.37,0
3150,452,-557.96,-1000.00,0.00,198.80,359.15,0.05,0
3151,453,-1000.00,-1000.00,0.00,283.11,716.89,0.44,0
3152,454,-1000.00,-1000.00,0.00,83.30,916.70,0.20,0
3153,455,-1000.00,-1000.00,0.00,166.31,833.69,0.32,0
3154,456,-1000.00,-1000.00,0.00,704.14,295.86,0.08,0
3155,457,-1000.00,-1000.00,0.00,50.19,949.81,0.16,0
3156,457,-0.00,-1000.00,0.00,0.00,0.00,0.08,0
3157,457,0.00,-1000.00,0.00,0.00,0.00,0.01,1
3158,457,-0.00,-1000.00,0.00,0.00,0.00,0.40,0
3159,458,-426.68,-426.68,573.32,0.00,426.68,0.13,0
3160,458,-529.60,-956.29,43.71,0.00,529.60,0.14,0
3161,458,-1000.00,-1956.29,-956.29,26.88,16.83,0.09,0
3162,459,-1000.00,-1000.00,0.00,494.03,505.97,0.27,0
3163,460,-1000.00,-1000.00,0.00,236.37,763.63,0.43,0
3164,461,-1000.00,-1000.00,0.00,1000.00,0.00,0.03,0
3165,462,-1000.00,-1000.00,0.00,877.22,122.78,0.12,0
3166,463,-1000.00,-1000.00,0.00,0.00,1000.00,0.25,0
3167,464,-1000.00,-1000.00,0.00,496.64,503.36,0.32,0
3168,465,1000.00,1000.00,2000.00,0.00,1000.00,0.19,1
3169,465,-1000.00,0.00,1000.00,998.09,405.22,0.24,0
3170,465,1000.00,1000.00,2000.00,432.63,567.37,0.03,1
3171,465,-979.49,20.51,1020.51,580.26,399.23,0.31,0
3172,465,1000.00,1020.51,2020.51,195.24,332.53,0.30,1
3173,465,1000.00,2020.51,3020.51,717.06,1303.45,0.34,1
3174,465,1000.00,3020.51,4020.51,254.09,2766.34,0.35,1
3175,465,1000.00,4020.51,5020.51,158.16,3184.85,0.42,1
3176,465,1000.00,5020.51,6020.51,0.00,4026.54,0.11,1
3177,465,1000.00,6020.51,7020.51,0.00,530.33,0.16,1
3178,465,1000.00,7020.51,8020.51,1128.31,3113.46,0.34,1
3179,465,1000.00,8020.51,9020.51,0.00,8020.51,0.19,1
3180,465,1000.00,9020.51,10020.51,2713.59,4370.73,0.41,1
3181,465,1000.00,10020.51,11020.51,1615.41,8405.10,0.09,1
3182,465,1000.00,11020.51,12020.51,0.00,7832.74,0.42,1
3183,465,1000.00,12020.51,13020.51,6010.25,6010.25,0.09,1
3184,465,1000.00,13020.51,14020.51,0.00,13020.51,0.09,1
3185,465,1000.00,14020.51,15020.51,6174.77,7845.74,0.38,1
3186,465,-1000.00,13020.51,14020.51,5409.01,0.00,0.22,0
3187,465,-1000.00,12020.51,13020.51,0.00,14020.51,0.17,0
3188,465,-1000.00,11020.51,12020.51,0.00,5808.64,0.27,0
3189,465,-1000.00,10020.51,11020.51,0.00,6315.72,0.15,0
3190,465,-1000.00,9020.51,10020.51,5775.36,5245.15,0.08,0
3191,465,-1000.00,8020.51,9020.51,4891.98,2324.02,0.35,0
3192,465,-1000.00,7020.51,8020.51,1757.17,7263.34,0.17,0
3193,465,-1000.00,6020.51,7020.51,881.25,7139.26,0.09,0
3194,465,-1000.00,5020.51,6020.51,0.00,7020.51,0.01,0
3195,465,-1000.00,4020.51,5020.51,2030.89,2760.85,0.38,0
3196,465,-1000.00,3020.51,4020.51,0.00,2454.63,0.23,0
3197,465,-1000.00,2020.51,3020.51,0.00,2929.47,0.40,0
3198,465,-1000.00,1020.51,2020.51,1691.30,292.46,0.20,0
3199,465,-1000.00,20.51,1020.51,1010.25,1010.25,0.11,0
3200,465,-1000.00,-979.49,20.51,823.34,197.16,0.13,0
3201,465,-20.51,-1000.00,0.00,1.91,18.60,0.34,0
3202,466,1000.00,1000.00,2000.00,14.25,985.75,0.41,1
3203,466,1000.00,2000.00,3000.00,0.00,21.69,0.07,1
3204,466,1000.00,3000.00,4000.00,1300.92,1699.08,0.44,1
3205,466,-1000.00,2000.00,3000.00,2644.67,1249.40,0.29,0
3206,466,1000.00,3000.00,4000.00,197.20,2802.80,0.26,1
3207,466,-1000.00,2000.00,3000.00,3625.80,0.00,0.09,0
3208,466,1000.00,3000.00,4000.00,0.00,3000.00,0.37,1
3209,466,1000.00,4000.00,5000.00,1960.11,2039.89,0.21,1
3210,466,-1000.00,3000.00,4000.00,2948.67,2051.33,0.31,0
3211,466,-1000.00,2000.00,3000.00,2330.48,1669.52,0.35,0
3212,466,1000.00,3000.00,4000.00,1073.41,1926.59,0.27,1
3213,466,1000.00,4000.00,5000.00,617.27,2757.18,0.44,1
3214,466,1000.00,5000.00,6000.00,2500.00,2500.00,0.02,1
3215,466,1000.00,6000.00,7000.00,0.00,6000.00,0.05,1
3216,466,1000.00,7000.00,8000.00,1887.05,5112.95,0.36,1
3217,466,1000.00,8000.00,9000.00,0.00,7201.60,0.25,1
3218,466,-1000.00,7000.00,8000.00,4736.83,2473.38,0.29,0
3219,466,-1000.00,6000.00,7000.00,4462.59,3537.41,0.31,0
3220,466,1000.00,7000.00,8000.00,0.00,7000.00,0.21,1
3221,466,-1000.00,6000.00,7000.00,6950.00,1050.00,0.12,0
3222,466,-189.10,5810.90,6810.90,189.10,0.00,0.14,0
3223,466,1000.00,6810.90,7810.90,1990.77,2612.71,0.36,1
3224,466,1000.00,7810.90,8810.90,567.28,5853.80,0.33,1
3225,466,-1000.00,6810.90,7810.90,6096.58,2714.33,0.01,0
3226,466,1000.00,7810.90,8810.90,850.16,6960.74,0.33,1
3227,466,1000.00,8810.90,9810.90,0.00,2325.16,0.18,1
3228,466,1000.00,9810.90,10810.90,832.91,5005.93,0.36,1
3229,466,1000.00,10810.90,11810.90,0.00,10810.90,0.32,1
3230,466,1000.00,11810.90,12810.90,1155.51,10655.39,0.16,1
3231,466,1000.00,12810.90,13810.90,784.87,12026.04,0.25,1
3232,466,1000.00,13810.90,14810.90,5483.97,8326.93,0.43,1
3233,466,1000.00,14810.90,15810.90,7405.45,7405.45,0.06,1
3234,466,1000.00,15810.90,16810.90,3480.49,4295.26,0.31,1
3235,466,1000.00,16810.90,17810.90,6420.73,10390.18,0.04,1
3236,466,1000.00,17810.90,18810.90,8905.45,8905.45,0.17,1
3237,466,1000.00,18810.90,19810.90,6625.21,12185.70,0.44,1
3238,466,1000.00,19810.90,20810.90,0.00,19810.90,0.04,1
3239,466,1000.00,20810.90,21810.90,10405.45,10405.45,0.13,1
3240,466,1000.00,21810.90,22810.90,10905.45,10905.45,0.14,1
3241,466,1000.00,22810.90,23810.90,0.00,8657.85,0.06,1
3242,467,1000.00,1000.00,2000.00,587.62,412.38,0.26,1
3243,467,-1000.00,0.00,1000.00,0.00,2000.00,0.01,0
3244,467,-85.55,-85.55,914.45,0.00,85.55,0.10,0
3245,467,-914.45,-1000.00,0.00,177.61,736.84,0.26,0
3246,468,1000.00,1000.00,2000.00,288.08,711.92,0.44,1
3247,468,1000.00,2000.00,3000.00,0.00,1882.21,0.12,1
3248,468,-1000.00,1000.00,2000.00,747.12,659.23,0.24,0
3249,468,1000.00,2000.00,3000.00,750.42,1136.78,0.39,1
3250,468,-1000.00,1000.00,2000.00,1609.92,871.08,0.28,0
3251,468,1000.00,2000.00,3000.00,597.18,708.39,0.34,1
3252,468,1000.00,3000.00,4000.00,0.00,1665.67,0.24,1
3253,468,1000.00,4000.00,5000.00,952.61,3047.39,0.33,1
3254,468,-1000.00,3000.00,4000.00,2519.76,2480.24,0.40,0
3255,468,1000.00,4000.00,5000.00,613.39,3386.61,0.43,1
3256,468,-1000.00,3000.00,4000.00,3388.68,1611.32,0.21,0
3257,468,0.00,3000.00,4000.00,0.00,0.00,0.10,0
3258,468,1000.00,4000.00,5000.00,0.00,309.93,0.13,1
3259,468,1000.00,5000.00,6000.00,0.00,4527.84,0.37,1
3260,468,1000.00,6000.00,7000.00,0.00,4393.02,0.35,1
3261,468,-1000.00,5000.00,6000.00,5097.26,1798.73,0.31,0
3262,468,1000.00,6000.00,7000.00,2337.63,3662.37,0.06,1
3263,468,0.00,6000.00,7000.00,0.00,0.00,0.10,0
3264,468,-1000.00,5000.00,6000.00,5145.34,1854.66,0.24,0
3265,468,-1000.00,4000.00,5000.00,4238.63,0.00,0.25,0
3266,468,-1000.00,3000.00,4000.00,3921.68,1078.32,0.17,0
3267,468,1000.00,4000.00,5000.00,0.00,4000.00,0.25,1
3268,468,-1000.00,3000.00,4000.00,3635.62,1364.38,0.18,0
3269,468,1000.00,4000.00,5000.00,1146.50,2853.50,0.43,1
3270,468,-1000.00,3000.00,4000.00,1835.86,898.22,0.28,0
3271,468,1000.00,4000.00,5000.00,1042.32,2138.78,0.39,1
3272,468,-1000.00,3000.00,4000.00,2731.71,2268.29,0.10,0
3273,468,1000.00,4000.00,5000.00,699.73,2554.87,0.38,1
3274,468,1000.00,5000.00,6000.00,2199.82,2800.18,0.37,1
3275,468,1000.00,6000.00,7000.00,2950.71,3049.29,0.29,1
3276,468,0.00,6000.00,7000.00,0.00,0.00,0.01,0
3277,468,1000.00,7000.00,8000.00,3013.05,3986.95,0.05,1
3278,468,1000.00,8000.00,9000.00,0.00,5450.76,0.29,1
3279,468,1000.00,9000.00,10000.00,0.00,4309.27,0.27,1
3280,468,1000.00,10000.00,11000.00,5000.00,5000.00,0.05,1
3281,468,-1000.00,9000.00,10000.00,6943.13,4056.87,0.09,0
3282,468,-1000.00,8000.00,9000.00,5863.24,4136.76,0.36,0
3283,469,-1000.00,-1000.00,0.00,570.08,429.92,0.20,0
3284,470,1000.00,1000.00,2000.00,423.16,576.84,0.23,1
3285,470,-1000.00,0.00,1000.00,1037.35,962.65,0.35,0
3286,470,1000.00,1000.00,2000.00,478.73,521.27,0.16,1
3287,470,1000.00,2000.00,3000.00,0.00,1028.76,0.21,1
3288,470,1000.00,3000.00,4000.00,784.67,2215.33,0.35,1
3289,470,-1000.00,2000.00,3000.00,3032.39,967.61,0.10,0
3290,470,-1000.00,1000.00,2000.00,1618.61,1094.45,0.30,0
3291,470,-1000.00,0.00,1000.00,1275.56,724.44,0.03,0
3292,470,-382.73,-382.73,617.27,382.73,0.00,0.00,0
3293,470,1000.00,617.27,1617.27,0.00,617.27,0.23,1
3294,470,-1000.00,-382.73,617.27,890.01,727.26,0.19,0
3295,470,1000.00,617.27,1617.27,0.00,617.27,0.17,1
3296,470,-1000.00,-382.73,617.27,907.65,165.28,0.22,0
3297,470,1000.00,617.27,1617.27,0.00,352.95,0.18,1
3298,470,1000.00,1617.27,2617.27,490.73,961.05,0.41,1
3299,470,1000.00,2617.27,3617.27,903.08,1714.20,0.01,1
3300,470,1000.00,3617.27,4617.27,0.00,2308.84,0.32,1
3301,470,1000.00,4617.27,5617.27,1756.35,2860.92,0.30,1
3302,470,1000.00,5617.27,6617.27,0.00,584.78,0.04,1
3303,470,1000.00,6617.27,7617.27,0.00,1335.03,0.26,1
3304,470,-1000.00,5617.27,6617.27,4096.43,3520.85,0.43,0
3305,470,1000.00,6617.27,7617.27,0.00,3334.86,0.32,1
3306,470,1000.00,7617.27,8617.27,0.00,2921.91,0.18,1
3307,470,1000.00,8617.27,9617.27,1469.95,5338.00,0.37,1
3308,470,1000.00,9617.27,10617.27,3439.85,6177.43,0.12,1
3309,470,1000.00,10617.27,11617.27,4930.23,5687.05,0.05,1
3310,470,1000.00,11617.27,12617.27,0.00,11091.89,0.41,1
3311,470,1000.00,12617.27,13617.27,6308.64,6308.64,0.21,1
3312,470,-1000.00,11617.27,12617.27,7252.05,0.00,0.12,0
3313,470,1000.00,12617.27,13617.27,0.00,12617.27,0.02,1
3314,470,-1000.00,11617.27,12617.27,10234.26,3383.02,0.02,0
3315,470,1000.00,12617.27,13617.27,2672.37,9944.90,0.33,1
3316,470,1000.00,13617.27,14617.27,549.96,2977.75,0.20,1
3317,470,1000.00,14617.27,15617.27,0.00,6801.24,0.22,1
3318,470,1000.00,15617.27,16617.27,7677.56,7939.72,0.44,1
3319,470,-1000.00,14617.27,15617.27,1454.66,0.00,0.16,0
3320,470,1000.00,15617.27,16617.27,7394.15,8223.12,0.04,1
3321,470,1000.00,16617.27,17617.27,0.00,6566.20,0.26,1
3322,470,-1000.00,15617.27,16617.27,10985.68,6631.60,0.26,0
3323,470,1000.00,16617.27,17617.27,2427.84,14189.43,0.12,1
3324,470,1000.00,17617.27,18617.27,7702.04,9915.23,0.41,1
3325,470,1000.00,18617.27,19617.27,0.00,15606.60,0.18,1
3326,470,0.00,18617.27,19617.27,0.00,0.00,0.14,0
3327,470,-1000.00,17617.27,18617.27,19471.59,0.00,0.10,0
3328,470,1000.00,18617.27,19617.27,2735.37,15881.90,0.31,1
3329,470,1000.00,19617.27,20617.27,0.00,6443.50,0.28,1
3330,470,1000.00,20617.27,21617.27,5760.37,14856.91,0.25,1
3331,470,1000.00,21617.27,22617.27,0.00,6150.11,0.19,1
3332,471,-1000.00,-1000.00,0.00,490.45,509.55,0.38,0
3333,472,-1000.00,-1000.00,0.00,0.00,1000.00,0.29,0
3334,473,-1000.00,-1000.00,0.00,833.35,166.65,0.14,0
3335,474,1000.00,1000.00,2000.00,473.58,526.42,0.15,1
3336,474,1000.00,2000.00,3000.00,0.00,509.91,0.18,1
3337,474,1000.00,3000.00,4000.00,1500.00,1500.00,0.17,1
3338,474,-1000.00,2000.00,3000.00,2801.20,0.00,0.11,0
3339,474,-1000.00,1000.00,2000.00,1862.20,348.17,0.20,0
3340,474,-1000.00,0.00,1000.00,1120.50,0.00,0.17,0
3341,474,-1000.00,-1000.00,0.00,590.58,409.42,0.35,0
3342,475,-559.32,-559.32,440.68,0.00,559.32,0.30,0
3343,475,-440.68,-1000.00,0.00,50.91,389.76,0.44,0
3344,476,-1000.00,-1000.00,0.00,0.00,814.54,0.22,0
3345,477,-1000.00,-1000.00,0.00,0.00,1000.00,0.38,0
3346,478,-1000.00,-1000.00,0.00,404.98,595.02,0.23,0
3347,479,-1000.00,-1000.00,0.00,196.57,803.43,0.26,0
3348,480,-1000.00,-1000.00,0.00,0.00,1000.00,0.31,0
3349,481,-1000.00,-1000.00,0.00,0.00,1000.00,0.01,0
3350,482,1000.00,1000.00,2000.00,823.55,176.45,0.07,1
3351,482,-1000.00,0.00,1000.00,0.00,2000.00,0.00,0
3352,482,-1000.00,-1000.00,0.00,0.00,1000.00,0.06,0
3353,483,-528.59,-528.59,471.41,0.00,528.59,0.35,0
3354,483,-471.41,-1000.00,0.00,118.75,352.66,0.41,0
3355,484,-1000.00,-1000.00,0.00,328.29,671.71,0.18,0
3356,485,-1000.00,-1000.00,0.00,585.13,414.87,0.16,0
3357,486,-1000.00,-1000.00,0.00,0.00,794.02,0.43,0
3358,487,-840.86,-840.86,159.14,0.00,840.86,0.39,0
3359,487,-159.14,-1000.00,0.00,34.46,124.68,0.40,0
3360,488,-1000.00,-1000.00,0.00,683.84,316.16,0.14,0
3361,489,-386.00,-386.00,614.00,116.56,269.43,0.22,0
3362,489,-614.00,-1000.00,0.00,0.00,614.00,0.19,0
3363,490,-1000.00,-1000.00,0.00,0.00,710.56,0.20,0
3364,491,-1000.00,-1000.00,0.00,500.60,499.40,0.31,0
3365,492,-978.04,-978.04,21.96,0.00,978.04,0.27,0
3366,492,-1000.00,-1978.04,-978.04,14.36,7.60,0.14,0
3367,493,-658.35,-658.35,341.65,0.00,658.35,0.41,0
3368,493,1000.00,341.65,1341.65,184.62,157.02,0.19,1
3369,493,-1000.00,-658.35,341.65,0.00,1341.65,0.30,0
3370,493,1000.00,341.65,1341.65,301.75,0.00,0.14,1
3371,493,1000.00,1341.65,2341.65,583.92,0.00,0.09,1
3372,493,-1000.00,341.65,1341.65,0.00,1664.86,0.41,0
3373,493,-1000.00,-658.35,341.65,400.90,940.75,0.35,0
3374,493,1000.00,341.65,1341.65,274.61,67.04,0.28,1
3375,493,-953.07,-611.42,388.58,145.26,807.81,0.43,0
3376,493,1000.00,388.58,1388.58,168.13,0.00,0.24,1
3377,493,-1000.00,-611.42,388.58,0.00,1388.58,0.13,0
3378,493,-120.75,-732.18,267.82,0.00,120.75,0.03,0
3379,493,-267.82,-1000.00,0.00,108.89,158.93,0.17,0
3380,494,-1000.00,-1000.00,0.00,606.61,393.39,0.30,0
3381,495,-1000.00,-1000.00,0.00,500.00,500.00,0.10,0
3382,496,1000.00,1000.00,2000.00,821.33,95.67,0.15,1
3383,496,-1000.00,0.00,1000.00,974.33,1025.67,0.20,0
3384,496,1000.00,1000.00,2000.00,810.39,189.61,0.21,1
3385,496,1000.00,2000.00,3000.00,1077.01,922.99,0.07,1
3386,496,-1000.00,1000.00,2000.00,1218.33,1781.67,0.14,0
3387,496,-1000.00,0.00,1000.00,0.00,2000.00,0.03,0
3388,496,0.00,0.00,1000.00,0.00,0.00,0.06,0
3389,496,-1000.00,-1000.00,0.00,0.00,1000.00,0.34,0
3390,497,-1000.00,-1000.00,0.00,558.87,441.13,0.23,0
3391,498,-1000.00,-1000.00,0.00,500.00,500.00,0.02,0
3392,499,-1000.00,-1000.00,0.00,220.65,0.00,0.07,0
3393,500,-1000.00,-1000.00,0.00,0.00,191.03,0.16,0
3394,501,-1000.00,-1000.00,0.00,381.42,618.58,0.39,0
3395,502,-513.23,-513.23,486.77,513.23,0.00,0.12,0
3396,502,1000.00,486.77,1486.77,0.00,486.77,0.27,1
3397,502,1000.00,1486.77,2486.77,625.19,861.59,0.41,1
3398,502,1000.00,2486.77,3486.77,0.00,2486.77,0.01,1
3399,502,1000.00,3486.77,4486.77,634.93,2851.85,0.42,1
3400,502,-1000.00,2486.77,3486.77,1998.69,1560.28,0.32,0
3401,502,-1000.00,1486.77,2486.77,1788.02,1698.76,0.38,0
3402,502,-406.92,1079.86,2079.86,406.92,0.00,0.11,0
3403,502,1000.00,2079.86,3079.86,1039.93,1039.93,0.11,1
3404,502,1000.00,3079.86,4079.86,1539.93,1539.93,0.14,1
3405,502,-1000.00,2079.86,3079.86,2599.99,1479.87,0.27,0
3406,502,1000.00,3079.86,4079.86,694.87,2384.99,0.42,1
3407,502,-1000.00,2079.86,3079.86,2658.07,691.15,0.22,0
3408,502,-1000.00,1079.86,2079.86,1113.88,330.13,0.20,0
3409,502,1000.00,2079.86,3079.86,1039.93,1039.93,0.03,1
3410,502,1000.00,3079.86,4079.86,1531.37,1548.49,0.01,1
3411,502,-1000.00,2079.86,3079.86,2186.21,1893.64,0.34,0
3412,502,-1000.00,1079.86,2079.86,1153.03,0.00,0.18,0
3413,502,1000.00,2079.86,3079.86,306.46,1773.40,0.28,1
3414,502,1000.00,3079.86,4079.86,0.00,3079.86,0.13,1
3415,502,1000.00,4079.86,5079.86,2004.29,2075.56,0.44,1
3416,502,1000.00,5079.86,6079.86,2412.54,2667.32,0.19,1
3417,502,1000.00,6079.86,7079.86,0.00,6079.86,0.24,1
3418,502,1000.00,7079.86,8079.86,1207.71,5872.14,0.19,1
3419,502,1000.00,8079.86,9079.86,3621.52,4458.34,0.30,1
3420,502,1000.00,9079.86,10079.86,4539.93,4539.93,0.14,1
3421,502,1000.00,10079.86,11079.86,4261.22,5818.63,0.41,1
3422,502,1000.00,11079.86,12079.86,0.00,8495.46,0.18,1
3423,502,1000.00,12079.86,13079.86,0.00,6939.23,0.12,1
3424,502,-1000.00,11079.86,12079.86,7812.51,5267.35,0.06,0
3425,502,-1000.00,10079.86,11079.86,7382.21,4697.64,0.27,0
3426,502,1000.00,11079.86,12079.86,5539.93,5539.93,0.19,1
3427,502,1000.00,12079.86,13079.86,5721.09,6358.76,0.27,1
3428,502,1000.00,13079.86,14079.86,0.00,13079.86,0.05,1
3429,502,1000.00,14079.86,15079.86,5464.81,8615.04,0.07,1
3430,502,1000.00,15079.86,16079.86,0.00,15079.86,0.09,1
3431,502,-1000.00,14079.86,15079.86,9861.47,6218.39,0.20,0
3432,502,1000.00,15079.86,16079.86,0.00,14157.45,0.26,1
3433,502,1000.00,16079.86,17079.86,7015.46,9064.40,0.31,1
3434,502,-1000.00,15079.86,16079.86,11189.00,5890.86,0.17,0
3435,502,1000.00,16079.86,17079.86,6613.38,9466.48,0.41,1
3436,502,1000.00,17079.86,18079.86,6698.29,10381.57,0.07,1
3437,502,1000.00,18079.86,19079.86,171.77,17908.09,0.34,1
3438,502,-1000.00,17079.86,18079.86,19079.86,0.00,0.10,0
3439,503,1000.00,1000.00,2000.00,0.00,1000.00,0.02,1
3440,503,0.00,1000.00,2000.00,0.00,0.00,0.02,0
3441,503,1000.00,2000.00,3000.00,625.16,1374.84,0.32,1
3442,503,1000.00,3000.00,4000.00,1500.00,1500.00,0.14,1
3443,503,1000.00,4000.00,5000.00,1537.22,2462.78,0.11,1
3444,503,0.00,4000.00,5000.00,0.00,0.00,0.01,0
3445,503,1000.00,5000.00,6000.00,517.37,4482.63,0.17,1
3446,503,1000.00,6000.00,7000.00,2516.86,3483.14,0.32,1
3447,503,-508.97,5491.03,6491.03,508.97,0.00,0.06,0
3448,503,-1000.00,4491.03,5491.03,3792.16,2698.87,0.38,0
3449,503,-1000.00,3491.03,4491.03,1752.87,1438.62,0.31,0
3450,503,-501.36,2989.66,3989.66,501.36,0.00,0.13,0
3451,503,1000.00,3989.66,4989.66,1105.79,2883.87,0.22,1
3452,503,-1000.00,2989.66,3989.66,2988.88,1416.85,0.26,0
3453,503,1000.00,3989.66,4989.66,0.00,3989.66,0.18,1
3454,503,1000.00,4989.66,5989.66,0.00,3789.42,0.19,1
3455,503,1000.00,5989.66,6989.66,0.00,5041.28,0.40,1
3456,503,-1000.00,4989.66,5989.66,4151.03,2838.63,0.20,0
3457,503,1000.00,5989.66,6989.66,0.00,1615.30,0.13,1
3458,503,-1000.00,4989.66,5989.66,4010.53,2832.00,0.36,0
3459,503,1000.00,5989.66,6989.66,0.00,1677.89,0.22,1
3460,503,-1000.00,4989.66,5989.66,5425.69,450.05,0.18,0
3461,503,1000.00,5989.66,6989.66,0.00,5989.66,0.08,1
3462,503,1000.00,6989.66,7989.66,0.00,5771.20,0.27,1
3463,503,-1000.00,5989.66,6989.66,3994.83,3994.83,0.01,0
3464,503,-1000.00,4989.66,5989.66,0.00,6989.66,0.10,0
3465,503,-1000.00,3989.66,4989.66,1825.66,4164.01,0.04,0
3466,503,-1000.00,2989.66,3989.66,2494.83,2494.83,0.12,0
3467,503,-1000.00,1989.66,2989.66,1299.02,2690.64,0.04,0
3468,503,-1000.00,989.66,1989.66,0.00,2330.13,0.20,0
3469,503,-1000.00,-10.34,989.66,1383.21,268.65,0.17,0
3470,503,-989.66,-1000.00,0.00,105.50,884.16,0.07,0
3471,504,-1000.00,-1000.00,0.00,79.66,920.34,0.19,0
3472,504,-0.00,-1000.00,-0.00,0.00,0.00,0.04,0
3473,505,1000.00,1000.00,2000.00,0.00,1000.00,0.33,1
3474,505,1000.00,2000.00,3000.00,0.00,2000.00,0.15,1
3475,505,1000.00,3000.00,4000.00,241.36,2758.64,0.01,1
3476,505,1000.00,4000.00,5000.00,0.00,4000.00,0.19,1
3477,505,1000.00,5000.00,6000.00,0.00,3466.26,0.17,1
3478,505,1000.00,6000.00,7000.00,2693.38,3306.62,0.42,1
3479,505,1000.00,7000.00,8000.00,0.00,4875.87,0.35,1
3480,505,1000.00,8000.00,9000.00,2006.08,2631.95,0.39,1
3481,505,1000.00,9000.00,10000.00,1536.44,7463.56,0.28,1
3482,505,1000.00,10000.00,11000.00,3430.88,6569.12,0.42,1
3483,505,1000.00,11000.00,12000.00,5408.17,5591.83,0.38,1
3484,505,1000.00,12000.00,13000.00,0.00,2370.41,0.10,1
3485,505,-1000.00,11000.00,12000.00,7418.92,2589.17,0.29,0
3486,505,1000.00,12000.00,13000.00,0.00,153.17,0.14,1
3487,505,-1000.00,11000.00,12000.00,6236.68,0.00,0.14,0
3488,505,-1000.00,10000.00,11000.00,7427.10,4572.90,0.28,0
3489,505,-1000.00,9000.00,10000.00,1902.96,9097.04,0.24,0
3490,505,-1000.00,8000.00,9000.00,5238.73,4761.27,0.16,0
3491,505,-1000.00,7000.00,8000.00,0.00,3232.42,0.35,0
3492,505,-1000.00,6000.00,7000.00,8000.00,0.00,0.01,0
3493,505,-1000.00,5000.00,6000.00,0.00,3518.88,0.28,0
3494,505,-1000.00,4000.00,5000.00,1055.33,4944.67,0.37,0
3495,505,-1000.00,3000.00,4000.00,0.00,5000.00,0.22,0
3496,505,-1000.00,2000.00,3000.00,0.00,4000.00,0.05,0
3497,505,-1000.00,1000.00,2000.00,0.00,3000.00,0.12,0
3498,505,-1000.00,0.00,1000.00,0.00,210.93,0.01,0
3499,505,-1000.00,-1000.00,0.00,0.00,227.87,0.25,0
3500,506,1000.00,1000.00,2000.00,0.00,1000.00,0.26,1
3501,506,1000.00,2000.00,3000.00,0.00,21.21,0.09,1
3502,506,1000.00,3000.00,4000.00,930.06,2069.94,0.26,1
3503,506,-1000.00,2000.00,3000.00,2092.39,1907.61,0.38,0
3504,506,1000.00,3000.00,4000.00,0.00,2315.78,0.18,1
3505,506,1000.00,4000.00,5000.00,1250.54,2749.46,0.35,1
3506,506,-1000.00,3000.00,4000.00,2723.45,2276.55,0.37,0
3507,506,1000.00,4000.00,5000.00,0.00,3467.21,0.29,1
3508,506,-1000.00,3000.00,4000.00,2642.57,2357.43,0.37,0
3509,506,1000.00,4000.00,5000.00,202.52,326.78,0.16,1
3510,506,1000.00,5000.00,6000.00,0.00,1208.97,0.06,1
3511,506,1000.00,6000.00,7000.00,2118.95,3369.73,0.40,1
3512,506,1000.00,7000.00,8000.00,0.00,5774.60,0.05,1
3513,506,1000.00,8000.00,9000.00,3906.07,4093.93,0.19,1
3514,506,-1000.00,7000.00,8000.00,5041.59,0.00,0.14,0
3515,506,1000.00,8000.00,9000.00,1695.91,6304.09,0.13,1
3516,506,-1000.00,7000.00,8000.00,5808.14,0.00,0.03,0
3517,506,1000.00,8000.00,9000.00,748.58,7251.42,0.25,1
3518,506,0.00,8000.00,9000.00,0.00,0.00,0.00,0
3519,506,1000.00,9000.00,10000.00,4413.24,4586.76,0.27,1
3520,506,-1000.00,8000.00,9000.00,5118.87,4201.99,0.32,0
3521,506,-1000.00,7000.00,8000.00,6778.82,2221.18,0.25,0
3522,506,-1000.00,6000.00,7000.00,6712.24,154.90,0.14,0
3523,506,-1000.00,5000.00,6000.00,5972.62,1027.38,0.20,0
3524,506,-39.26,4960.74,5960.74,0.00,39.26,0.10,0
3525,506,-1000.00,3960.74,4960.74,0.00,2637.10,0.26,0
3526,506,-1000.00,2960.74,3960.74,2213.77,2746.98,0.41,0
3527,506,-1000.00,1960.74,2960.74,688.76,3271.98,0.03,0
3528,506,-676.39,1284.36,2284.36,0.00,676.39,0.19,0
3529,506,0.00,1284.36,2284.36,0.00,0.00,0.02,0
3530,506,-1000.00,284.36,1284.36,920.87,1363.48,0.00,0
3531,506,-1000.00,-715.64,284.36,873.19,411.17,0.22,0
3532,506,-1000.00,-1715.64,-715.64,204.63,79.73,0.26,0
3533,507,-1000.00,-1000.00,0.00,417.75,582.25,0.04,0
3534,508,1000.00,1000.00,2000.00,207.63,340.73,0.28,1
3535,508,1000.00,2000.00,3000.00,650.40,1241.12,0.38,1
3536,508,-948.02,1051.98,2051.98,948.02,0.00,0.06,0
3537,508,1000.00,2051.98,3051.98,0.00,834.44,0.05,1
3538,508,1000.00,3051.98,4051.98,747.62,2304.36,0.13,1
3539,508,1000.00,4051.98,5051.98,1483.05,2568.93,0.23,1
3540,508,-1000.00,3051.98,4051.98,2848.64,2203.34,0.12,0
3541,508,1000.00,4051.98,5051.98,0.00,4051.98,0.18,1
3542,508,1000.00,5051.98,6051.98,2400.01,2651.97,0.21,1
3543,508,1000.00,6051.98,7051.98,0.00,6051.98,0.05,1
3544,508,-1000.00,5051.98,6051.98,1781.29,0.00,0.10,0
3545,508,1000.00,6051.98,7051.98,1988.88,4063.10,0.44,1
3546,508,1000.00,7051.98,8051.98,850.82,6201.16,0.35,1
3547,508,1000.00,8051.98,9051.98,4025.99,4025.99,0.01,1
3548,508,1000.00,9051.98,10051.98,0.00,4634.21,0.28,1
3549,508,1000.00,10051.98,11051.98,0.00,10051.98,0.37,1
3550,508,1000.00,11051.98,12051.98,0.00,1934.29,0.09,1
3551,508,1000.00,12051.98,13051.98,6025.99,6025.99,0.06,1
3552,508,-1000.00,11051.98,12051.98,8010.28,5041.70,0.18,0
3553,508,1000.00,12051.98,13051.98,0.00,11477.64,0.26,1
3554,508,1000.00,13051.98,14051.98,6525.99,6525.99,0.12,1
3555,508,1000.00,14051.98,15051.98,5588.70,8463.28,0.44,1
3556,508,0.00,14051.98,15051.98,0.00,0.00,0.03,0
3557,508,-1000.00,13051.98,14051.98,11605.89,3446.09,0.16,0
3558,508,-1000.00,12051.98,13051.98,3162.76,0.00,0.12,0
3559,508,-1000.00,11051.98,12051.98,11341.49,0.00,0.11,0
3560,508,-1000.00,10051.98,11051.98,5866.46,6185.51,0.18,0
3561,508,-1000.00,9051.98,10051.98,3108.80,7943.18,0.36,0
3562,508,-1000.00,8051.98,9051.98,114.03,9937.95,0.28,0
3563,508,-1000.00,7051.98,8051.98,9051.98,0.00,0.01,0
3564,508,-1000.00,6051.98,7051.98,5900.53,2151.44,0.18,0
3565,508,-1000.00,5051.98,6051.98,7051.98,0.00,0.01,0
3566,508,-1000.00,4051.98,5051.98,3025.99,3025.99,0.27,0
3567,508,-1000.00,3051.98,4051.98,1219.30,3832.68,0.42,0
3568,508,-1000.00,2051.98,3051.98,0.00,3908.91,0.19,0
3569,508,-1000.00,1051.98,2051.98,0.00,3051.98,0.23,0
3570,508,-1000.00,51.98,1051.98,1160.89,891.09,0.01,0
3571,508,-1000.00,-948.02,51.98,525.99,525.99,0.21,0
3572,508,-1000.00,-1948.02,-948.02,26.22,25.76,0.15,0
3573,509,-1000.00,-1000.00,0.00,293.27,706.73,0.40,0
3574,510,-1000.00,-1000.00,0.00,493.65,506.35,0.24,0
3575,511,-974.35,-974.35,25.65,0.00,974.35,0.17,0
3576,511,-25.65,-1000.00,0.00,3.36,22.29,0.09,0
3577,512,-953.61,-953.61,46.39,151.27,802.35,0.44,0
3578,512,-39.13,-992.74,7.26,6.87,32.26,0.42,0
3579,512,-7.26,-1000.00,0.00,2.25,5.01,0.31,0
3580,513,-1000.00,-1000.00,0.00,147.54,852.46,0.37,0
3581,514,0.00,0.00,1000.00,0.00,0.00,0.01,0
3582,514,-1000.00,-1000.00,0.00,228.08,771.92,0.17,0
3583,515,-1000.00,-1000.00,0.00,0.00,1000.00,0.20,0
3584,516,1000.00,1000.00,2000.00,226.88,773.12,0.17,1
3585,516,-1000.00,0.00,1000.00,1410.10,589.90,0.16,0
3586,516,-1000.00,-1000.00,0.00,507.94,492.06,0.36,0
3587,517,-1000.00,-1000.00,0.00,456.97,543.03,0.30,0
3588,518,-686.87,-686.87,313.13,116.09,570.78,0.34,0
3589,518,-313.13,-1000.00,0.00,110.08,203.05,0.27,0
3590,519,0.00,0.00,1000.00,0.00,0.00,0.05,0
3591,519,-1000.00,-1000.00,0.00,395.51,604.49,0.19,0
3592,520,-47.07,-47.07,952.93,0.00,47.07,0.26,0
3593,520,-952.93,-1000.00,0.00,0.00,952.93,0.26,0
3594,521,-1000.00,-1000.00,0.00,376.50,623.50,0.39,0
3595,522,-997.87,-997.87,2.13,0.00,997.87,0.26,0
3596,522,-2.13,-1000.00,0.00,0.00,2.13,0.12,0
3597,523,1000.00,1000.00,2000.00,530.11,414.27,0.30,1
3598,523,1000.00,2000.00,3000.00,953.25,343.64,0.22,1
3599,523,-1000.00,1000.00,2000.00,987.87,2012.13,0.36,0
3600,523,-1000.00,0.00,1000.00,352.80,1009.91,0.38,0
3601,523,-344.66,-344.66,655.34,78.38,266.28,0.37,0
3602,523,0.00,-344.66,655.34,0.00,0.00,0.15,0
3603,523,-655.34,-1000.00,0.00,239.49,415.85,0.28,0
3604,524,1000.00,1000.00,2000.00,37.12,962.88,0.26,1
3605,524,-1000.00,0.00,1000.00,1224.38,775.62,0.05,0
3606,524,1000.00,1000.00,2000.00,450.18,549.82,0.30,1
3607,524,1000.00,2000.00,3000.00,1000.00,1000.00,0.02,1
3608,524,1000.00,3000.00,4000.00,1500.00,1500.00,0.20,1
3609,524,1000.00,4000.00,5000.00,0.00,1543.02,0.04,1
3610,524,1000.00,5000.00,6000.00,278.97,4721.03,0.33,1
3611,524,-1000.00,4000.00,5000.00,6000.00,0.00,0.00,0
3612,524,1000.00,5000.00,6000.00,1432.47,3567.53,0.42,1
3613,524,1000.00,6000.00,7000.00,0.00,6000.00,0.03,1
3614,524,1000.00,7000.00,8000.00,3500.00,3500.00,0.13,1
3615,524,1000.00,8000.00,9000.00,1674.08,6325.92,0.36,1
3616,524,-1000.00,7000.00,8000.00,3282.16,1239.54,0.24,0
3617,524,1000.00,8000.00,9000.00,2530.04,5469.96,0.40,1
3618,524,1000.00,9000.00,10000.00,0.00,9000.00,0.01,1
3619,524,-1000.00,8000.00,9000.00,5337.02,4662.98,0.35,0
3620,524,-1000.00,7000.00,8000.00,4074.55,2902.86,0.31,0
3621,524,-1000.00,6000.00,7000.00,4682.27,3317.73,0.33,0
3622,524,-1000.00,5000.00,6000.00,3807.03,3192.97,0.40,0
3623,524,1000.00,6000.00,7000.00,2138.24,3861.76,0.42,1
3624,524,-1000.00,5000.00,6000.00,3963.85,3036.15,0.25,0
3625,524,1000.00,6000.00,7000.00,897.06,5102.94,0.35,1
3626,524,1000.00,7000.00,8000.00,2903.85,4096.15,0.43,1
3627,524,1000.00,8000.00,9000.00,0.00,4175.30,0.29,1
3628,524,-1000.00,7000.00,8000.00,2940.14,0.00,0.13,0
3629,524,-1000.00,6000.00,7000.00,4292.71,3707.29,0.37,0
3630,524,-1000.00,5000.00,6000.00,5960.75,0.00,0.05,0
3631,524,-1000.00,4000.00,5000.00,3432.09,2567.91,0.04,0
3632,524,1000.00,5000.00,6000.00,0.00,5000.00,0.15,1
3633,524,1000.00,6000.00,7000.00,1536.06,4463.94,0.43,1
3634,524,1000.00,7000.00,8000.00,0.00,7000.00,0.02,1
3635,524,-1000.00,6000.00,7000.00,1634.87,6365.13,0.29,0
3636,524,-1000.00,5000.00,6000.00,2931.47,4068.53,0.21,0
3637,524,-1000.00,4000.00,5000.00,2053.96,1365.62,0.31,0
3638,524,-1000.00,3000.00,4000.00,2688.81,667.77,0.30,0
3639,524,-1000.00,2000.00,3000.00,1154.30,2845.70,0.42,0
3640,524,-1000.00,1000.00,2000.00,3000.00,0.00,0.06,0
3641,524,-1000.00,0.00,1000.00,752.53,1247.47,0.27,0
3642,524,-1000.00,-1000.00,0.00,0.00,1000.00,0.22,0
3643,525,-1000.00,-1000.00,0.00,0.00,927.50,0.16,0
3644,526,-640.90,-640.90,359.10,0.00,640.90,0.39,0
3645,526,-268.38,-909.28,90.72,119.58,148.81,0.32,0
3646,526,-90.72,-1000.00,0.00,0.00,90.72,0.09,0
3647,527,1000.00,1000.00,2000.00,406.83,0.00,0.01,1
3648,527,1000.00,2000.00,3000.00,1270.61,729.39,0.25,1
3649,527,-1000.00,1000.00,2000.00,0.00,2424.79,0.38,0
3650,527,-1000.00,0.00,1000.00,618.04,1381.96,0.38,0
3651,527,1000.00,1000.00,2000.00,529.59,470.41,0.14,1
3652,527,-1000.00,0.00,1000.00,1000.00,1000.00,0.02,0
3653,527,0.00,0.00,1000.00,0.00,0.00,0.18,0
3654,527,-828.28,-828.28,171.72,0.00,828.28,0.35,0
3655,527,-47.14,-875.43,124.57,0.00,47.14,0.32,0
3656,527,-124.57,-1000.00,0.00,0.00,124.57,0.12,0
3657,528,1000.00,1000.00,2000.00,0.00,1000.00,0.07,1
3658,528,-1000.00,0.00,1000.00,1995.93,0.00,0.00,0
3659,528,-1000.00,-1000.00,0.00,602.26,397.74,0.16,0
3660,529,-1000.00,-1000.00,0.00,283.11,716.89,0.43,0
3661,530,-1000.00,-1000.00,0.00,500.00,500.00,0.15,0
3662,531,1000.00,1000.00,2000.00,173.48,826.52,0.39,1
3663,531,1000.00,2000.00,3000.00,616.35,1383.65,0.42,1
3664,531,-1000.00,1000.00,2000.00,1004.79,0.00,0.07,0
3665,531,1000.00,2000.00,3000.00,0.00,281.72,0.13,1
3666,531,1000.00,3000.00,4000.00,1094.60,1905.40,0.44,1
3667,531,-1000.00,2000.00,3000.00,3492.97,0.00,0.09,0
3668,531,1000.00,3000.00,4000.00,851.85,2148.15,0.44,1
3669,531,1000.00,4000.00,5000.00,1603.85,2396.15,0.41,1
3670,531,1000.00,5000.00,6000.00,0.00,1892.97,0.08,1
3671,531,-623.42,4376.58,5376.58,623.42,0.00,0.18,0
3672,531,-1000.00,3376.58,4376.58,2992.46,2384.11,0.23,0
3673,531,-1000.00,2376.58,3376.58,2409.80,1966.78,0.06,0
3674,531,1000.00,3376.58,4376.58,131.37,3245.20,0.07,1
3675,531,1000.00,4376.58,5376.58,1729.61,2646.97,0.38,1
3676,531,1000.00,5376.58,6376.58,2343.76,3032.82,0.33,1
3677,531,-1000.00,4376.58,5376.58,3461.96,2914.61,0.26,0
3678,531,1000.00,5376.58,6376.58,579.50,4797.07,0.23,1
3679,531,1000.00,6376.58,7376.58,0.00,6376.58,0.08,1
3680,531,1000.00,7376.58,8376.58,2499.10,4877.48,0.37,1
3681,531,1000.00,8376.58,9376.58,0.00,3357.02,0.14,1
3682,531,1000.00,9376.58,10376.58,0.00,6308.71,0.09,1
3683,531,-1000.00,8376.58,9376.58,4978.23,0.00,0.17,0
3684,531,1000.00,9376.58,10376.58,3267.98,6108.60,0.15,1
3685,531,1000.00,10376.58,11376.58,5167.18,5209.40,0.33,1
3686,531,1000.00,11376.58,12376.58,4964.08,6412.49,0.28,1
3687,531,1000.00,12376.58,13376.58,4794.62,7581.96,0.42,1
3688,531,1000.00,13376.58,14376.58,3350.18,10026.40,0.40,1
3689,531,-1000.00,12376.58,13376.58,7721.77,0.00,0.01,0
3690,531,-1000.00,11376.58,12376.58,12296.08,1080.49,0.08,0
3691,531,1000.00,12376.58,13376.58,6188.29,6188.29,0.10,1
3692,531,1000.00,13376.58,14376.58,2025.53,5756.54,0.30,1
3693,531,1000.00,14376.58,15376.58,3035.60,11095.24,0.44,1
3694,531,1000.00,15376.58,16376.58,0.00,15376.58,0.11,1
3695,531,1000.00,16376.58,17376.58,0.00,9762.68,0.16,1
3696,531,0.00,16376.58,17376.58,0.00,0.00,0.06,0
3697,531,1000.00,17376.58,18376.58,7513.46,9863.11,0.06,1
3698,531,1000.00,18376.58,19376.58,5701.53,12675.05,0.10,1
3699,531,-1000.00,17376.58,18376.58,10762.94,8613.64,0.14,0
3700,531,-1000.00,16376.58,17376.58,6122.63,1771.92,0.30,0
3701,531,1000.00,17376.58,18376.58,7112.24,10264.34,0.40,1
3702,531,-1000.00,16376.58,17376.58,18376.58,0.00,0.07,0
3703,531,1000.00,17376.58,18376.58,8688.29,8688.29,0.07,1
3704,531,1000.00,18376.58,19376.58,0.00,10753.00,0.16,1
3705,531,1000.00,19376.58,20376.58,0.00,19376.58,0.04,1
3706,531,1000.00,20376.58,21376.58,5851.63,14524.95,0.12,1
3707,531,-1000.00,19376.58,20376.58,13584.54,7634.18,0.35,0
3708,531,1000.00,20376.58,21376.58,0.00,20376.58,0.12,1
3709,531,1000.00,21376.58,22376.58,9932.85,11443.73,0.35,1
3710,531,-1000.00,20376.58,21376.58,15816.42,6560.16,0.21,0
3711,531,1000.00,21376.58,22376.58,0.00,21376.58,0.25,1
3712,531,1000.00,22376.58,23376.58,0.00,11696.76,0.31,1
3713,531,1000.00,23376.58,24376.58,0.00,23376.58,0.15,1
3714,531,1000.00,24376.58,25376.58,4951.00,8797.57,0.36,1
3715,531,1000.00,25376.58,26376.58,1065.22,24311.36,0.28,1
3716,531,1000.00,26376.58,27376.58,13188.29,13188.29,0.04,1
3717,531,-1000.00,25376.58,26376.58,17148.48,0.00,0.11,0
3718,531,-1000.00,24376.58,25376.58,26179.23,197.35,0.10,0
3719,531,0.00,24376.58,25376.58,0.00,0.00,0.17,0
3720,531,1000.00,25376.58,26376.58,0.00,6291.27,0.19,1
3721,531,1000.00,26376.58,27376.58,0.00,26376.58,0.05,1
3722,531,1000.00,27376.58,28376.58,0.00,27376.58,0.12,1
3723,531,-1000.00,26376.58,27376.58,8882.75,0.00,0.11,0
3724,531,0.00,26376.58,27376.58,0.00,0.00,0.10,0
3725,531,1000.00,27376.58,28376.58,5593.14,21783.44,0.42,1
3726,531,1000.00,28376.58,29376.58,7520.66,20855.91,0.10,1
3727,531,1000.00,29376.58,30376.58,0.00,20731.98,0.13,1
3728,531,1000.00,30376.58,31376.58,133.05,18268.81,0.34,1
3729,531,1000.00,31376.58,32376.58,0.00,12692.18,0.21,1
3730,531,1000.00,32376.58,33376.58,8117.28,24259.29,0.43,1
3731,532,-1000.00,-1000.00,0.00,327.53,672.47,0.37,0
3732,533,-1000.00,-1000.00,0.00,314.50,685.50,0.03,0
3733,534,1000.00,1000.00,2000.00,85.24,914.76,0.42,1
3734,534,-1000.00,0.00,1000.00,1429.15,570.85,0.18,0
3735,534,1000.00,1000.00,2000.00,378.60,621.40,0.36,1
3736,534,1000.00,2000.00,3000.00,1000.00,1000.00,0.15,1
3737,534,1000.00,3000.00,4000.00,411.59,2588.41,0.14,1
3738,534,-1000.00,2000.00,3000.00,3042.52,957.48,0.23,0
3739,534,1000.00,3000.00,4000.00,0.00,3000.00,0.00,1
3740,534,1000.00,4000.00,5000.00,1738.60,2261.40,0.40,1
3741,534,1000.00,5000.00,6000.00,814.93,4185.07,0.24,1
3742,534,1000.00,6000.00,7000.00,2747.10,3252.90,0.40,1
3743,534,-1000.00,5000.00,6000.00,6279.47,0.00,0.09,0
3744,534,1000.00,6000.00,7000.00,3000.00,3000.00,0.11,1
3745,534,-1000.00,5000.00,6000.00,3735.61,0.00,0.16,0
3746,534,1000.00,6000.00,7000.00,1799.43,4200.57,0.15,1
3747,534,-1000.00,5000.00,6000.00,3779.21,3220.79,0.35,0
3748,534,1000.00,6000.00,7000.00,2859.06,2124.70,0.35,1
3749,534,-1000.00,5000.00,6000.00,995.51,6004.49,0.41,0
3750,534,1000.00,6000.00,7000.00,3548.68,2451.32,0.08,1
3751,534,1000.00,7000.00,8000.00,2656.83,2528.79,0.31,1
3752,534,-1000.00,6000.00,7000.00,3908.44,4091.56,0.19,0
3753,534,1000.00,7000.00,8000.00,4595.84,517.26,0.16,1
3754,534,-1000.00,6000.00,7000.00,0.00,5351.96,0.19,0
3755,534,-1000.00,5000.00,6000.00,0.00,7000.00,0.14,0
3756,534,-1000.00,4000.00,5000.00,3000.00,3000.00,0.29,0
3757,534,-1000.00,3000.00,4000.00,805.04,4194.96,0.36,0
3758,534,-1000.00,2000.00,3000.00,0.00,1925.43,0.34,0
3759,534,1000.00,3000.00,4000.00,1853.25,77.76,0.18,1
3760,534,-1000.00,2000.00,3000.00,228.38,3494.73,0.36,0
3761,534,1000.00,3000.00,4000.00,1889.43,1110.57,0.10,1
3762,534,-391.85,2608.15,3608.15,0.00,391.85,0.13,0
3763,534,-929.25,1678.90,2678.90,0.00,929.25,0.05,0
3764,534,-1000.00,678.90,1678.90,0.00,1128.69,0.19,0
3765,534,-298.54,380.37,1380.37,0.00,298.54,0.06,0
3766,534,1000.00,1380.37,2380.37,660.18,0.00,0.08,1
3767,534,1000.00,2380.37,3380.37,1538.96,772.60,0.28,1
3768,534,-1000.00,1380.37,2380.37,0.00,1642.91,0.35,0
3769,534,-1000.00,380.37,1380.37,0.00,1437.28,0.38,0
3770,534,1000.00,1380.37,2380.37,929.27,451.10,0.16,1
3771,534,-1000.00,380.37,1380.37,1266.03,29.07,0.30,0
3772,534,0.00,380.37,1380.37,0.00,0.00,0.01,0
3773,534,1000.00,1380.37,2380.37,0.00,1380.37,0.24,1
3774,534,-1000.00,380.37,1380.37,1289.71,1090.66,0.16,0
3775,534,1000.00,1380.37,2380.37,642.24,738.13,0.35,1
3776,534,-1000.00,380.37,1380.37,1746.87,411.30,0.19,0
3777,534,1000.00,1380.37,2380.37,651.60,728.77,0.43,1
3778,534,1000.00,2380.37,3380.37,768.19,1612.17,0.40,1
3779,534,1000.00,3380.37,4380.37,0.00,2710.25,0.28,1
3780,534,1000.00,4380.37,5380.37,0.00,977.76,0.15,1
3781,534,1000.00,5380.37,6380.37,330.65,1055.37,0.21,1
3782,534,1000.00,6380.37,7380.37,0.00,6380.37,0.11,1
3783,534,1000.00,7380.37,8380.37,0.00,7380.37,0.03,1
3784,534,1000.00,8380.37,9380.37,2307.70,6072.67,0.20,1
3785,534,1000.00,9380.37,10380.37,2629.33,6751.04,0.38,1
3786,534,1000.00,10380.37,11380.37,0.00,3188.78,0.18,1
3787,534,-1000.00,9380.37,10380.37,6387.31,4993.06,0.40,0
3788,534,1000.00,10380.37,11380.37,3803.95,5946.84,0.40,1
3789,535,-1000.00,-1000.00,0.00,385.75,614.25,0.38,0
3790,536,-1000.00,-1000.00,0.00,0.00,1000.00,0.30,0
3791,537,1000.00,1000.00,2000.00,603.62,396.38,0.21,1
3792,537,-1000.00,0.00,1000.00,527.79,1472.21,0.31,0
3793,537,-951.49,-951.49,48.51,186.34,765.16,0.43,0
3794,537,-48.51,-1000.00,0.00,14.15,34.36,0.43,0
3795,538,-1000.00,-1000.00,0.00,193.39,806.61,0.31,0
3796,539,-1000.00,-1000.00,0.00,173.13,826.87,0.18,0
3797,540,-1000.00,-1000.00,0.00,0.00,1000.00,0.28,0
3798,541,1000.00,1000.00,2000.00,335.47,664.53,0.41,1
3799,541,1000.00,2000.00,3000.00,0.00,2000.00,0.04,1
3800,541,1000.00,3000.00,4000.00,748.43,2251.57,0.16,1
3801,541,-1000.00,2000.00,3000.00,1594.64,0.00,0.14,0
3802,541,-1000.00,1000.00,2000.00,1554.52,1429.62,0.36,0
3803,541,1000.00,2000.00,3000.00,0.00,335.82,0.06,1
3804,541,1000.00,3000.00,4000.00,864.49,2135.51,0.44,1
3805,541,1000.00,4000.00,5000.00,0.00,1632.85,0.34,1
3806,541,0.00,4000.00,5000.00,0.00,0.00,0.06,0
3807,541,1000.00,5000.00,6000.00,1864.91,3135.09,0.42,1
3808,541,1000.00,6000.00,7000.00,0.00,4811.59,0.33,1
3809,541,1000.00,7000.00,8000.00,0.00,5190.74,0.14,1
3810,541,1000.00,8000.00,9000.00,3805.81,4194.19,0.21,1
3811,541,1000.00,9000.00,10000.00,1124.39,4147.51,0.34,1
3812,541,0.00,9000.00,10000.00,0.00,0.00,0.15,0
3813,541,1000.00,10000.00,11000.00,0.00,10000.00,0.37,1
3814,541,1000.00,11000.00,12000.00,0.00,3183.85,0.15,1
3815,541,1000.00,12000.00,13000.00,0.00,10273.64,0.28,1
3816,541,1000.00,13000.00,14000.00,2812.70,10187.30,0.40,1
3817,541,-1000.00,12000.00,13000.00,7749.24,6250.76,0.37,0
3818,541,1000.00,13000.00,14000.00,0.00,6838.71,0.20,1
3819,541,-1000.00,12000.00,13000.00,14000.00,0.00,0.01,0
3820,541,1000.00,13000.00,14000.00,0.00,11619.83,0.24,1
3821,541,-1000.00,12000.00,13000.00,624.82,4543.07,0.31,0
3822,541,-1000.00,11000.00,12000.00,334.56,12665.44,0.33,0
3823,541,-1000.00,10000.00,11000.00,2247.46,2923.93,0.33,0
3824,541,-1000.00,9000.00,10000.00,2496.95,8503.05,0.44,0
3825,541,-1000.00,8000.00,9000.00,0.00,8129.78,0.07,0
3826,541,-1000.00,7000.00,8000.00,0.00,9000.00,0.02,0
3827,541,-1000.00,6000.00,7000.00,3797.75,4202.25,0.04,0
3828,541,-1000.00,5000.00,6000.00,2726.62,4273.38,0.30,0
3829,541,-1000.00,4000.00,5000.00,1220.20,2889.60,0.42,0
3830,541,-1000.00,3000.00,4000.00,2066.67,2933.33,0.40,0
3831,541,-1000.00,2000.00,3000.00,4000.00,0.00,0.12,0
3832,541,-1000.00,1000.00,2000.00,0.00,1557.46,0.24,0
3833,541,-1000.00,0.00,1000.00,12.66,1987.34,0.28,0
3834,541,-593.19,-593.19,406.81,0.00,593.19,0.29,0
3835,541,-1000.00,-1593.19,-593.19,178.89,0.00,0.13,0
3836,542,-1000.00,-1000.00,0.00,425.21,574.79,0.20,0
3837,543,-1000.00,-1000.00,0.00,0.00,1000.00,0.35,0
3838,544,1000.00,1000.00,2000.00,496.05,503.95,0.13,1
3839,544,-1000.00,0.00,1000.00,1792.94,112.11,0.10,0
3840,544,-1000.00,-1000.00,0.00,637.44,362.56,0.21,0
3841,545,-877.19,-877.19,122.81,0.00,877.19,0.27,0
3842,545,-122.81,-1000.00,0.00,0.00,122.81,0.30,0
3843,546,-1000.00,-1000.00,0.00,0.00,220.42,0.24,0
3844,547,-1000.00,-1000.00,0.00,0.00,1000.00,0.04,0
3845,548,1000.00,1000.00,2000.00,254.26,745.74,0.44,1
3846,548,1000.00,2000.00,3000.00,0.00,2000.00,0.31,1
3847,548,-1000.00,1000.00,2000.00,1353.55,1258.37,0.32,0
3848,548,1000.00,2000.00,3000.00,863.88,1136.12,0.11,1
3849,548,1000.00,3000.00,4000.00,1500.00,1500.00,0.03,1
3850,548,1000.00,4000.00,5000.00,1041.46,2958.54,0.26,1
3851,548,1000.00,5000.00,6000.00,1768.52,3231.48,0.33,1
3852,548,-1000.00,4000.00,5000.00,3605.02,0.00,0.04,0
3853,548,1000.00,5000.00,6000.00,162.75,4837.25,0.22,1
3854,548,1000.00,6000.00,7000.00,442.28,5557.72,0.33,1
3855,548,1000.00,7000.00,8000.00,2854.27,4145.73,0.14,1
3856,548,1000.00,8000.00,9000.00,2889.87,5110.13,0.35,1
3857,548,1000.00,9000.00,10000.00,4294.35,4705.65,0.40,1
3858,548,-1000.00,8000.00,9000.00,6153.11,3846.89,0.27,0
3859,548,1000.00,9000.00,10000.00,3122.61,5877.39,0.14,1
3860,548,0.00,9000.00,10000.00,0.00,0.00,0.08,0
3861,548,-1000.00,8000.00,9000.00,6712.19,3287.81,0.25,0
3862,548,-1000.00,7000.00,8000.00,7778.45,1221.55,0.10,0
3863,548,-1000.00,6000.00,7000.00,1255.24,0.00,0.08,0
3864,548,1000.00,7000.00,8000.00,0.00,7000.00,0.31,1
3865,548,1000.00,8000.00,9000.00,230.27,4910.75,0.31,1
3866,548,1000.00,9000.00,10000.00,4119.69,4880.31,0.28,1
3867,548,1000.00,10000.00,11000.00,4082.26,5917.74,0.32,1
3868,548,-1000.00,9000.00,10000.00,11000.00,0.00,0.03,0
3869,548,-1000.00,8000.00,9000.00,5000.00,5000.00,0.05,0
3870,548,-1000.00,7000.00,8000.00,5493.78,3506.22,0.12,0
3871,548,-1000.00,6000.00,7000.00,3884.35,4115.65,0.37,0
3872,548,-1000.00,5000.00,6000.00,3500.00,3500.00,0.01,0
3873,548,-1000.00,4000.00,5000.00,769.26,1872.78,0.30,0
3874,548,-1000.00,3000.00,4000.00,0.00,5000.00,0.10,0
3875,548,-1000.00,2000.00,3000.00,2386.48,1613.52,0.29,0
3876,548,-1000.00,1000.00,2000.00,1315.94,1684.06,0.38,0
3877,548,-1000.00,0.00,1000.00,876.41,0.00,0.03,0
3878,548,-1000.00,-1000.00,0.00,451.18,548.82,0.10,0
3879,548,-0.00,-1000.00,0.00,0.00,0.00,0.31,0
3880,549,1000.00,1000.00,2000.00,0.00,1000.00,0.22,1
3881,549,-822.65,177.35,1177.35,822.65,0.00,0.08,0
3882,549,-1000.00,-822.65,177.35,1098.67,0.00,0.05,0
3883,549,-138.91,-961.55,38.45,138.22,0.68,0.12,0
3884,549,1000.00,38.45,1038.45,12.76,25.69,0.24,1
3885,549,1000.00,1038.45,2038.45,373.16,665.28,0.39,1
3886,549,1000.00,2038.45,3038.45,571.14,1467.31,0.40,1
3887,549,1000.00,3038.45,4038.45,1209.46,1828.99,0.32,1
3888,549,-1000.00,2038.45,3038.45,2345.83,1692.62,0.28,0
3889,549,-1000.00,1038.45,2038.45,2293.70,744.75,0.06,0
3890,549,1000.00,2038.45,3038.45,1019.22,1019.22,0.09,1
3891,549,-1000.00,1038.45,2038.45,1312.21,0.00,0.16,0
3892,549,-1000.00,38.45,1038.45,1615.77,422.67,0.08,0
3893,549,-1000.00,-961.55,38.45,551.77,486.68,0.04,0
3894,549,1000.00,38.45,1038.45,2.83,35.61,0.40,1
3895,549,1000.00,1038.45,2038.45,214.30,824.14,0.05,1
3896,549,1000.00,2038.45,3038.45,807.67,1230.78,0.09,1
3897,549,1000.00,3038.45,4038.45,1172.06,1866.39,0.44,1
3898,549,1000.00,4038.45,5038.45,1082.02,2956.42,0.43,1
3899,549,-1000.00,3038.45,4038.45,4165.65,872.80,0.13,0
3900,549,1000.00,4038.45,5038.45,407.52,3630.92,0.19,1
3901,549,1000.00,5038.45,6038.45,1204.80,3833.65,0.43,1
3902,549,-1000.00,4038.45,5038.45,3749.09,2289.35,0.28,0
3903,549,1000.00,5038.45,6038.45,0.00,2302.00,0.20,1
3904,549,1000.00,6038.45,7038.45,2635.33,3403.12,0.21,1
3905,549,1000.00,7038.45,8038.45,0.00,6462.39,0.39,1
3906,549,1000.00,8038.45,9038.45,2427.18,5611.26,0.33,1
3907,549,1000.00,9038.45,10038.45,3811.86,5226.59,0.36,1
3908,549,1000.00,10038.45,11038.45,1362.51,8675.94,0.27,1
3909,549,1000.00,11038.45,12038.45,0.00,2248.63,0.16,1
3910,549,1000.00,12038.45,13038.45,2339.56,7393.26,0.37,1
3911,549,1000.00,13038.45,14038.45,0.00,7134.66,0.15,1
3912,549,-1000.00,12038.45,13038.45,7535.16,6503.29,0.31,0
3913,549,1000.00,13038.45,14038.45,5697.79,7340.66,0.24,1
3914,549,1000.00,14038.45,15038.45,0.00,1200.88,0.02,1
3915,549,1000.00,15038.45,16038.45,7017.20,8021.25,0.41,1
3916,549,1000.00,16038.45,17038.45,4492.78,11545.67,0.02,1
3917,549,-1000.00,15038.45,16038.45,8720.74,8317.70,0.28,0
3918,549,-1000.00,14038.45,15038.45,8233.10,7805.35,0.41,0
3919,549,1000.00,15038.45,16038.45,5570.87,9467.58,0.40,1
3920,549,1000.00,16038.45,17038.45,0.00,16038.45,0.07,1
3921,549,1000.00,17038.45,18038.45,0.00,13341.16,0.12,1
3922,549,1000.00,18038.45,19038.45,5960.47,12077.97,0.26,1
3923,549,1000.00,19038.45,20038.45,2750.48,16287.96,0.06,1
3924,549,1000.00,20038.45,21038.45,10019.22,10019.22,0.16,1
3925,549,1000.00,21038.45,22038.45,6125.82,14912.63,0.43,1
3926,549,1000.00,22038.45,23038.45,11019.22,11019.22,0.07,1
3927,549,1000.00,23038.45,24038.45,11519.22,11519.22,0.14,1
3928,549,-1000.00,22038.45,23038.45,18913.29,5125.16,0.10,0
3929,549,-1000.00,21038.45,22038.45,10907.85,12130.60,0.33,0
3930,549,-1000.00,20038.45,21038.45,0.00,8295.32,0.20,0
3931,549,-1000.00,19038.45,20038.45,10519.22,10519.22,0.10,0
3932,549,-1000.00,18038.45,19038.45,18083.51,1954.94,0.20,0
3933,549,-1000.00,17038.45,18038.45,9816.47,9221.97,0.27,0
3934,549,-1000.00,16038.45,17038.45,4169.18,13869.27,0.43,0
3935,549,-1000.00,15038.45,16038.45,3630.95,13407.50,0.10,0
3936,549,-1000.00,14038.45,15038.45,3948.20,12090.24,0.42,0
3937,549,-1000.00,13038.45,14038.45,6989.35,6485.38,0.39,0
3938,549,-1000.00,12038.45,13038.45,0.00,14038.45,0.15,0
3939,549,-1000.00,11038.45,12038.45,5500.13,7538.31,0.19,0
3940,549,-1000.00,10038.45,11038.45,6034.08,3196.00,0.35,0
3941,549,-1000.00,9038.45,10038.45,7757.08,3281.37,0.17,0
3942,549,-1000.00,8038.45,9038.45,6056.26,3982.18,0.20,0
3943,549,-1000.00,7038.45,8038.45,0.00,9038.45,0.05,0
3944,549,-1000.00,6038.45,7038.45,4019.22,4019.22,0.08,0
3945,549,-1000.00,5038.45,6038.45,0.00,7038.45,0.26,0
3946,549,-1000.00,4038.45,5038.45,960.35,5078.10,0.38,0
3947,549,-1000.00,3038.45,4038.45,0.00,5038.45,0.02,0
3948,549,-1000.00,2038.45,3038.45,1823.10,2215.35,0.32,0
3949,549,-940.47,1097.97,2097.97,0.00,940.47,0.21,0
3950,549,-787.02,310.96,1310.96,0.00,787.02,0.31,0
3951,550,-1000.00,-1000.00,0.00,369.44,346.76,0.26,0
3952,551,-1000.00,-1000.00,0.00,15.94,246.77,0.26,0
3953,552,-1000.00,-1000.00,0.00,0.00,14.60,0.10,0
3954,553,-1000.00,-1000.00,0.00,465.62,534.38,0.21,0
3955,554,-1000.00,-1000.00,0.00,584.91,415.09,0.16,0
3956,555,0.00,0.00,1000.00,0.00,0.00,0.13,0
3957,555,-734.14,-734.14,265.86,734.14,0.00,0.09,0
3958,555,-1000.00,-1734.14,-734.14,51.36,214.50,0.30,0
3959,556,-850.03,-850.03,149.97,0.00,850.03,0.26,0
3960,556,-149.97,-1000.00,0.00,61.37,88.60,0.26,0
3961,557,-1000.00,-1000.00,0.00,209.48,790.52,0.09,0
3962,558,-1000.00,-1000.00,0.00,0.00,1000.00,0.25,0
3963,559,-1000.00,-1000.00,0.00,270.05,729.95,0.44,0
3964,560,1000.00,1000.00,2000.00,406.71,593.29,0.34,1
3965,560,1000.00,2000.00,3000.00,858.17,1141.83,0.21,1
3966,560,1000.00,3000.00,4000.00,1207.48,1792.52,0.41,1
3967,560,1000.00,4000.00,5000.00,0.00,2380.83,0.29,1
3968,560,1000.00,5000.00,6000.00,1572.77,3427.23,0.42,1
3969,560,-1000.00,4000.00,5000.00,4627.29,1372.71,0.06,0
3970,560,1000.00,5000.00,6000.00,0.00,3045.54,0.33,1
3971,560,-1000.00,4000.00,5000.00,2428.16,2314.77,0.33,0
3972,560,1000.00,5000.00,6000.00,1830.49,3169.51,0.35,1
3973,560,1000.00,6000.00,7000.00,0.00,2704.03,0.11,1
3974,560,1000.00,7000.00,8000.00,0.00,2465.27,0.31,1
3975,560,1000.00,8000.00,9000.00,0.00,6144.38,0.34,1
3976,560,-1000.00,7000.00,8000.00,2078.42,184.13,0.20,0
3977,560,-1000.00,6000.00,7000.00,3933.67,2198.42,0.41,0
3978,560,1000.00,7000.00,8000.00,3500.00,3500.00,0.00,1
3979,560,1000.00,8000.00,9000.00,753.48,7246.52,0.43,1
3980,560,-1000.00,7000.00,8000.00,1194.24,1174.08,0.21,0
3981,560,1000.00,8000.00,9000.00,0.00,8000.00,0.04,1
3982,560,1000.00,9000.00,10000.00,2933.36,6066.64,0.32,1
3983,560,1000.00,10000.00,11000.00,2334.34,7665.66,0.17,1
3984,560,-1000.00,9000.00,10000.00,6989.77,738.47,0.18,0
3985,561,-1000.00,-1000.00,0.00,0.00,745.71,0.42,0
3986,562,-1000.00,-1000.00,0.00,378.07,621.93,0.23,0
3987,563,-535.68,-535.68,464.32,0.00,535.68,0.26,0
3988,563,-389.58,-925.26,74.74,0.00,389.58,0.39,0
3989,563,1000.00,74.74,1074.74,40.19,34.55,0.24,1
3990,563,-1000.00,-925.26,74.74,437.55,637.19,0.25,0
3991,563,-15.29,-940.56,59.44,0.00,15.29,0.12,0
3992,563,-59.44,-1000.00,0.00,0.00,59.44,0.26,0
3993,564,1000.00,1000.00,2000.00,0.00,1000.00,0.13,1
3994,564,1000.00,2000.00,3000.00,623.98,1376.02,0.04,1
3995,564,1000.00,3000.00,4000.00,1334.67,1665.33,0.38,1
3996,564,1000.00,4000.00,5000.00,0.00,3635.42,0.30,1
3997,564,1000.00,5000.00,6000.00,1084.76,3539.71,0.41,1
3998,564,1000.00,6000.00,7000.00,0.00,3772.47,0.09,1
3999,564,1000.00,7000.00,8000.00,3008.48,3991.52,0.41,1
4000,564,1000.00,8000.00,9000.00,3823.65,4176.35,0.29,1
4001,564,1000.00,9000.00,10000.00,0.00,9000.00,0.28,1
4002,564,1000.00,10000.00,11000.00,0.00,6140.42,0.06,1
4003,564,1000.00,11000.00,12000.00,0.00,11000.00,0.02,1
4004,564,-1000.00,10000.00,11000.00,5413.74,0.00,0.14,0
4005,564,1000.00,11000.00,12000.00,5120.77,5879.23,0.39,1
4006,564,1000.00,12000.00,13000.00,6000.00,6000.00,0.01,1
4007,564,1000.00,13000.00,14000.00,3353.61,9646.39,0.44,1
4008,564,-1000.00,12000.00,13000.00,8840.54,5159.46,0.25,0
4009,564,-1000.00,11000.00,12000.00,8780.72,4219.28,0.21,0
4010,564,1000.00,12000.00,13000.00,6000.00,6000.00,0.01,1
4011,564,1000.00,13000.00,14000.00,2036.86,8135.69,0.41,1
4012,564,1000.00,14000.00,15000.00,3587.57,5575.58,0.40,1
4013,564,1000.00,15000.00,16000.00,0.00,12562.23,0.25,1
4014,564,-1000.00,14000.00,15000.00,9222.32,6777.68,0.06,0
4015,564,1000.00,15000.00,16000.00,6396.06,8603.94,0.32,1
4016,564,-1000.00,14000.00,15000.00,11368.36,4631.64,0.04,0
4017,564,-1000.00,13000.00,14000.00,0.00,8032.69,0.12,0
4018,564,-1000.00,12000.00,13000.00,14000.00,0.00,0.01,0
4019,564,-1000.00,11000.00,12000.00,1869.20,11130.80,0.27,0
4020,564,0.00,11000.00,12000.00,0.00,0.00,0.01,0
4021,564,-1000.00,10000.00,11000.00,0.00,3439.43,0.22,0
4022,564,-1000.00,9000.00,10000.00,3716.58,7283.42,0.10,0
4023,564,-1000.00,8000.00,9000.00,5000.00,5000.00,0.14,0
4024,564,-1000.00,7000.00,8000.00,3626.93,5373.07,0.12,0
4025,564,-1000.00,6000.00,7000.00,6496.98,1255.48,0.18,0
4026,564,-1000.00,5000.00,6000.00,0.00,4802.56,0.07,0
4027,564,-1000.00,4000.00,5000.00,1182.91,4817.09,0.33,0
4028,564,-1000.00,3000.00,4000.00,0.00,4629.09,0.07,0
4029,564,-1000.00,2000.00,3000.00,1686.41,2313.59,0.32,0
4030,564,-1000.00,1000.00,2000.00,1127.29,325.10,0.28,0
4031,564,-1000.00,0.00,1000.00,697.97,1302.03,0.11,0
4032,564,-1000.00,-1000.00,0.00,0.00,886.93,0.37,0
4033,565,-1000.00,-1000.00,0.00,292.68,707.32,0.35,0
4034,566,1000.00,1000.00,2000.00,0.00,1000.00,0.35,1
4035,566,1000.00,2000.00,3000.00,168.31,1051.42,0.33,1
4036,566,1000.00,3000.00,4000.00,1394.70,1605.30,0.22,1
4037,566,1000.00,4000.00,5000.00,0.00,2898.01,0.18,1
4038,566,1000.00,5000.00,6000.00,1415.81,2785.07,0.40,1
4039,566,1000.00,6000.00,7000.00,2131.83,3868.17,0.29,1
4040,566,1000.00,7000.00,8000.00,253.06,1766.44,0.24,1
4041,566,1000.00,8000.00,9000.00,4000.00,4000.00,0.06,1
4042,566,-1000.00,7000.00,8000.00,5123.76,3876.24,0.03,0
4043,566,-1000.00,6000.00,7000.00,4629.99,3370.01,0.30,0
4044,566,1000.00,7000.00,8000.00,832.80,6167.20,0.36,1
4045,566,1000.00,8000.00,9000.00,1949.32,5014.50,0.40,1
4046,566,-1000.00,7000.00,8000.00,5008.90,2447.41,0.28,0
4047,566,1000.00,8000.00,9000.00,3051.72,4948.28,0.41,1
4048,566,-1000.00,7000.00,8000.00,4972.69,4027.31,0.33,0
4049,566,1000.00,8000.00,9000.00,0.00,6751.54,0.17,1
4050,566,1000.00,9000.00,10000.00,4500.00,4500.00,0.07,1
4051,566,-1000.00,8000.00,9000.00,3855.75,0.00,0.24,0
4052,566,1000.00,9000.00,10000.00,0.00,9000.00,0.28,1
4053,566,-1000.00,8000.00,9000.00,6031.21,3968.79,0.20,0
4054,566,-1000.00,7000.00,8000.00,6074.08,2925.92,0.15,0
4055,566,1000.00,8000.00,9000.00,3085.23,4914.77,0.41,1
4056,566,1000.00,9000.00,10000.00,4474.99,4525.01,0.17,1
4057,566,1000.00,10000.00,11000.00,43.16,9956.84,0.31,1
4058,566,-503.85,9496.15,10496.15,503.85,0.00,0.12,0
4059,566,1000.00,10496.15,11496.15,4797.37,5698.79,0.27,1
4060,566,-1000.00,9496.15,10496.15,4031.68,3830.96,0.31,0
4061,566,1000.00,10496.15,11496.15,1716.17,4973.92,0.39,1
4062,566,-1000.00,9496.15,10496.15,5096.62,4403.14,0.32,0
4063,566,-1000.00,8496.15,9496.15,5280.92,5215.23,0.35,0
4064,566,1000.00,9496.15,10496.15,3865.88,5630.28,0.41,1
4065,566,1000.00,10496.15,11496.15,80.28,7512.87,0.40,1
4066,566,1000.00,11496.15,12496.15,5748.08,5748.08,0.07,1
4067,566,1000.00,12496.15,13496.15,6248.08,6248.08,0.06,1
4068,566,1000.00,13496.15,14496.15,3542.72,9953.44,0.09,1
4069,566,1000.00,14496.15,15496.15,7223.66,7272.49,0.37,1
4070,566,1000.00,15496.15,16496.15,3128.37,8146.95,0.41,1
4071,566,-1000.00,14496.15,15496.15,13163.90,3332.26,0.16,0
4072,566,0.00,14496.15,15496.15,0.00,0.00,0.01,0
4073,566,-1000.00,13496.15,14496.15,10617.28,4878.87,0.16,0
4074,566,-1000.00,12496.15,13496.15,7421.39,0.00,0.16,0
4075,566,1000.00,13496.15,14496.15,6475.63,7020.52,0.09,1
4076,566,1000.00,14496.15,15496.15,0.00,1504.90,0.13,1
4077,566,1000.00,15496.15,16496.15,0.00,15496.15,0.04,1
4078,566,1000.00,16496.15,17496.15,7162.69,9333.46,0.25,1
4079,566,-1000.00,15496.15,16496.15,8905.02,8591.13,0.03,0
4080,566,-1000.00,14496.15,15496.15,16496.15,0.00,0.01,0
4081,566,-1000.00,13496.15,14496.15,5591.38,9904.78,0.40,0
4082,566,-1000.00,12496.15,13496.15,992.41,13503.75,0.19,0
4083,566,-1000.00,11496.15,12496.15,2659.91,10343.27,0.40,0
4084,566,-1000.00,10496.15,11496.15,6400.90,6095.25,0.00,0
4085,566,-1000.00,9496.15,10496.15,0.00,5785.22,0.27,0
4086,566,-1000.00,8496.15,9496.15,486.61,10009.54,0.22,0
4087,566,-1000.00,7496.15,8496.15,3846.98,5649.17,0.28,0
4088,566,-1000.00,6496.15,7496.15,8399.97,0.00,0.04,0
4089,566,-1000.00,5496.15,6496.15,1957.52,0.00,0.16,0
4090,566,-1000.00,4496.15,5496.15,3223.88,1320.70,0.24,0
4091,566,-1000.00,3496.15,4496.15,2550.73,2945.42,0.35,0
4092,566,-1000.00,2496.15,3496.15,0.00,4496.15,0.06,0
4093,566,-489.60,2006.56,3006.56,0.00,489.60,0.11,0
4094,566,-1000.00,1006.56,2006.56,1503.28,1503.28,0.12,0
4095,566,-1000.00,6.56,1006.56,2006.56,0.00,0.04,0
4096,566,-522.46,-515.90,484.10,0.00,522.46,0.30,0
4097,566,-484.10,-1000.00,0.00,0.00,484.10,0.29,0
4098,567,1000.00,1000.00,2000.00,492.83,507.17,0.20,1
4099,567,1000.00,2000.00,3000.00,0.00,2000.00,0.13,1
4100,567,1000.00,3000.00,4000.00,0.00,3000.00,0.10,1
4101,567,-769.68,2230.32,3230.32,769.68,0.00,0.07,0
4102,567,1000.00,3230.32,4230.32,400.87,2829.46,0.34,1
4103,567,-1000.00,2230.32,3230.32,3379.80,0.00,0.14,0
4104,567,1000.00,3230.32,4230.32,0.00,3230.32,0.16,1
4105,567,1000.00,4230.32,5230.32,0.00,4230.32,0.28,1
4106,567,-1000.00,3230.32,4230.32,1840.62,0.00,0.07,0
4107,567,1000.00,4230.32,5230.32,0.00,3662.92,0.12,1
4108,567,1000.00,5230.32,6230.32,0.00,5230.32,0.11,1
4109,567,1000.00,6230.32,7230.32,0.00,3149.84,0.20,1
4110,567,-1000.00,5230.32,6230.32,5660.74,0.00,0.11,0
4111,567,1000.00,6230.32,7230.32,0.00,5929.65,0.08,1
4112,567,1000.00,7230.32,8230.32,0.00,4871.26,0.35,1
4113,567,1000.00,8230.32,9230.32,1437.39,6792.94,0.22,1
4114,567,1000.00,9230.32,10230.32,2987.70,6242.63,0.44,1
4115,567,1000.00,10230.32,11230.32,0.00,10230.32,0.03,1
4116,567,-1000.00,9230.32,10230.32,6785.79,0.00,0.14,0
4117,567,-1000.00,8230.32,9230.32,5810.18,1619.33,0.26,0
4118,567,-1000.00,7230.32,8230.32,5946.65,1059.91,0.22,0
4119,567,1000.00,8230.32,9230.32,3449.09,4781.23,0.43,1
4120,567,0.00,8230.32,9230.32,0.00,0.00,0.07,0
4121,567,1000.00,9230.32,10230.32,0.00,4025.37,0.17,1
4122,567,-1000.00,8230.32,9230.32,5432.33,4797.99,0.26,0
4123,567,-1000.00,7230.32,8230.32,0.00,7660.22,0.33,0
4124,567,-1000.00,6230.32,7230.32,4303.58,0.00,0.10,0
4125,567,-1000.00,5230.32,6230.32,4430.89,2799.44,0.19,0
4126,567,-1000.00,4230.32,5230.32,4034.12,0.00,0.23,0
4127,567,-1000.00,3230.32,4230.32,0.00,5230.32,0.10,0
4128,567,-1000.00,2230.32,3230.32,958.96,0.00,0.24,0
4129,567,0.00,2230.32,3230.32,0.00,0.00,0.00,0
4130,567,-1000.00,1230.32,2230.32,2788.03,442.29,0.16,0
4131,567,-1000.00,230.32,1230.32,1609.30,621.03,0.04,0
4132,567,-564.47,-334.15,665.85,38.07,526.41,0.35,0
4133,567,-1000.00,-1334.15,-334.15,665.85,0.00,0.03,0
4134,568,-1000.00,-1000.00,0.00,374.96,625.04,0.08,0
4135,569,-664.66,-664.66,335.34,493.41,171.25,0.19,0
4136,569,-238.39,-903.05,96.95,224.41,13.98,0.12,0
4137,569,1000.00,96.95,1096.95,48.47,48.47,0.05,1
4138,569,-1000.00,-903.05,96.95,721.12,375.83,0.19,0
4139,569,1000.00,96.95,1096.95,0.00,92.88,0.32,1
4140,569,-183.98,-87.03,912.97,183.98,0.00,0.14,0
4141,569,-912.97,-1000.00,0.00,484.85,428.12,0.11,0
4142,570,-1000.00,-1000.00,0.00,0.00,1000.00,0.02,0
4143,571,-1000.00,-1000.00,0.00,501.88,498.12,0.26,0
4144,572,-1000.00,-1000.00,0.00,0.00,123.48,0.21,0
4145,573,-959.06,-959.06,40.94,0.00,959.06,0.40,0
4146,573,-40.94,-1000.00,0.00,16.35,24.59,0.19,0
4147,574,-445.35,-445.35,554.65,0.00,445.35,0.32,0
4148,574,-1000.00,-1445.35,-445.35,404.59,0.00,0.10,0
4149,575,-1000.00,-1000.00,0.00,625.43,374.57,0.22,0
4150,576,1000.00,1000.00,2000.00,83.87,916.13,0.38,1
4151,576,1000.00,2000.00,3000.00,1000.00,1000.00,0.13,1
4152,576,1000.00,3000.00,4000.00,1421.16,1578.84,0.33,1
4153,576,1000.00,4000.00,5000.00,1532.87,2467.13,0.11,1
4154,576,-1000.00,3000.00,4000.00,2902.48,0.00,0.12,0
4155,576,-1000.00,2000.00,3000.00,2018.38,1981.62,0.29,0
4156,576,1000.00,3000.00,4000.00,668.91,2331.09,0.33,1
4157,576,1000.00,4000.00,5000.00,2000.00,2000.00,0.04,1
4158,576,1000.00,5000.00,6000.00,1762.83,3237.17,0.29,1
4159,576,1000.00,6000.00,7000.00,1822.53,4177.47,0.41,1
4160,576,1000.00,7000.00,8000.00,2446.82,4553.18,0.43,1
4161,576,1000.00,8000.00,9000.00,0.00,8000.00,0.13,1
4162,576,-1000.00,7000.00,8000.00,5850.89,3149.11,0.15,0
4163,576,1000.00,8000.00,9000.00,0.00,8000.00,0.09,1
4164,576,-1000.00,7000.00,8000.00,1990.36,0.00,0.12,0
4165,576,1000.00,8000.00,9000.00,2621.00,2772.07,0.28,1
4166,576,1000.00,9000.00,10000.00,3044.65,5955.35,0.26,1
4167,576,1000.00,10000.00,11000.00,5000.00,5000.00,0.14,1
4168,576,1000.00,11000.00,12000.00,5314.33,5685.67,0.25,1
4169,576,1000.00,12000.00,13000.00,0.00,9567.59,0.13,1
4170,576,-1000.00,11000.00,12000.00,3293.19,320.84,0.19,0
4171,576,1000.00,12000.00,13000.00,3662.90,8337.10,0.42,1
4172,576,-1000.00,11000.00,12000.00,5711.85,7288.15,0.34,0
4173,576,-1000.00,10000.00,11000.00,2030.16,9969.84,0.29,0
4174,576,-1000.00,9000.00,10000.00,11000.00,0.00,0.00,0
4175,576,-1000.00,8000.00,9000.00,3976.08,6023.92,0.35,0
4176,576,-1000.00,7000.00,8000.00,2359.23,6640.77,0.44,0
4177,576,-1000.00,6000.00,7000.00,1098.00,0.00,0.16,0
4178,576,-1000.00,5000.00,6000.00,2213.96,4786.04,0.17,0
4179,576,-1000.00,4000.00,5000.00,0.00,6000.00,0.05,0
4180,576,-1000.00,3000.00,4000.00,4699.86,300.14,0.09,0
4181,576,-1000.00,2000.00,3000.00,0.00,4000.00,0.14,0
4182,576,-1000.00,1000.00,2000.00,527.17,2448.86,0.40,0
4183,576,-1000.00,0.00,1000.00,0.00,1402.31,0.26,0
4184,576,-524.52,-524.52,475.48,0.00,524.52,0.19,0
4185,576,-108.61,-633.13,366.87,0.00,108.61,0.17,0
4186,576,-366.87,-1000.00,0.00,101.54,265.33,0.42,0
4187,577,-1000.00,-1000.00,0.00,185.89,814.11,0.42,0
4188,578,1000.00,1000.00,2000.00,680.23,0.00,0.07,1
4189,578,-1000.00,0.00,1000.00,97.27,1902.73,0.37,0
4190,578,-703.10,-703.10,296.90,0.00,703.10,0.23,0
4191,578,-238.88,-941.99,58.01,0.00,238.88,0.33,0
4192,578,-58.01,-1000.00,0.00,0.00,58.01,0.17,0
4193,579,-1000.00,-1000.00,0.00,549.23,450.77,0.26,0
4194,580,-752.22,-752.22,247.78,46.22,706.00,0.35,0
4195,580,-247.78,-1000.00,0.00,123.89,123.89,0.10,0
4196,581,-738.45,-738.45,261.55,313.88,424.57,0.29,0
4197,581,-1000.00,-1738.45,-738.45,72.60,0.00,0.09,0
4198,582,-1000.00,-1000.00,0.00,275.39,724.61,0.30,0
4199,583,-1000.00,-1000.00,0.00,0.00,1000.00,0.12,0
4200,584,-292.55,-292.55,707.45,0.00,292.55,0.19,0
4201,584,-707.45,-1000.00,0.00,0.00,707.45,0.21,0
4202,585,-1000.00,-1000.00,0.00,798.29,201.71,0.11,0
4203,586,-867.22,-867.22,132.78,0.00,867.22,0.38,0
4204,586,-132.78,-1000.00,0.00,16.32,116.46,0.41,0
4205,587,-1000.00,-1000.00,0.00,310.87,689.13,0.06,0
4206,588,1000.00,1000.00,2000.00,0.00,1000.00,0.29,1
4207,588,1000.00,2000.00,3000.00,452.35,1547.65,0.44,1
4208,588,-1000.00,1000.00,2000.00,1620.18,1379.82,0.27,0
4209,588,1000.00,2000.00,3000.00,884.26,1115.74,0.29,1
4210,588,1000.00,3000.00,4000.00,1164.03,1835.97,0.39,1
4211,588,1000.00,4000.00,5000.00,0.00,2276.89,0.04,1
4212,588,1000.00,5000.00,6000.00,0.00,3204.59,0.35,1
4213,588,1000.00,6000.00,7000.00,2226.63,3773.37,0.16,1
4214,588,1000.00,7000.00,8000.00,0.00,7000.00,0.16,1
4215,588,1000.00,8000.00,9000.00,3198.14,4801.86,0.25,1
4216,588,-1000.00,7000.00,8000.00,7181.85,1365.21,0.21,0
4217,588,-1000.00,6000.00,7000.00,5638.74,0.00,0.11,0
4218,588,-1000.00,5000.00,6000.00,4882.15,2117.85,0.04,0
4219,588,1000.00,6000.00,7000.00,0.00,6000.00,0.24,1
4220,588,1000.00,7000.00,8000.00,0.00,6212.99,0.29,1
4221,588,1000.00,8000.00,9000.00,3359.40,4640.60,0.03,1
4222,588,1000.00,9000.00,10000.00,1279.43,7720.57,0.31,1
4223,588,1000.00,10000.00,11000.00,2669.33,7330.67,0.27,1
4224,588,-1000.00,9000.00,10000.00,0.00,8632.60,0.28,0
4225,588,-1000.00,8000.00,9000.00,4205.04,5794.96,0.21,0
4226,588,-1000.00,7000.00,8000.00,2093.12,6906.88,0.06,0
4227,588,-1000.00,6000.00,7000.00,4655.96,3344.04,0.11,0
4228,588,-1000.00,5000.00,6000.00,2139.62,4860.38,0.42,0
4229,588,-1000.00,4000.00,5000.00,0.00,6000.00,0.18,0
4230,588,-1000.00,3000.00,4000.00,429.33,4570.67,0.21,0
4231,588,-1000.00,2000.00,3000.00,1880.26,2119.74,0.28,0
4232,588,-1000.00,1000.00,2000.00,563.45,2436.55,0.44,0
4233,588,-292.00,708.00,1708.00,0.00,292.00,0.21,0
4234,588,-1000.00,-292.00,708.00,0.00,1708.00,0.29,0
4235,588,-516.42,-808.43,191.57,0.00,516.42,0.38,0
4236,588,-191.57,-1000.00,0.00,95.79,95.79,0.11,0
4237,589,1000.00,1000.00,2000.00,0.00,1000.00,0.07,1
4238,589,1000.00,2000.00,3000.00,326.64,1673.36,0.40,1
4239,589,1000.00,3000.00,4000.00,1178.92,1775.69,0.39,1
4240,589,1000.00,4000.00,5000.00,926.79,3073.21,0.41,1
4241,589,-1000.00,3000.00,4000.00,4900.62,0.00,0.10,0
4242,589,-1000.00,2000.00,3000.00,1522.69,898.83,0.24,0
4243,589,-1000.00,1000.00,2000.00,2864.23,0.00,0.08,0
4244,589,-1000.00,0.00,1000.00,1082.89,917.11,0.27,0
4245,589,1000.00,1000.00,2000.00,317.43,682.57,0.34,1
4246,589,1000.00,2000.00,3000.00,0.00,1070.66,0.15,1
4247,589,1000.00,3000.00,4000.00,733.23,2266.77,0.43,1
4248,589,1000.00,4000.00,5000.00,365.99,3634.01,0.39,1
4249,589,1000.00,5000.00,6000.00,0.00,2119.88,0.14,1
4250,589,1000.00,6000.00,7000.00,931.10,5068.90,0.42,1
4251,589,1000.00,7000.00,8000.00,970.98,1733.93,0.25,1
4252,589,1000.00,8000.00,9000.00,0.00,8000.00,0.14,1
4253,589,1000.00,9000.00,10000.00,0.00,9000.00,0.25,1
4254,589,1000.00,10000.00,11000.00,304.45,9695.55,0.31,1
4255,589,-1000.00,9000.00,10000.00,5589.30,5410.70,0.29,0
4256,589,-1000.00,8000.00,9000.00,6043.60,3956.40,0.19,0
4257,589,1000.00,9000.00,10000.00,2356.01,6643.99,0.20,1
4258,589,-1000.00,8000.00,9000.00,7542.34,2457.66,0.31,0
4259,589,-1000.00,7000.00,8000.00,0.00,7096.78,0.22,0
4260,589,-1000.00,6000.00,7000.00,3877.62,3797.58,0.34,0
4261,589,-1000.00,5000.00,6000.00,3795.50,3204.50,0.04,0
4262,589,-1000.00,4000.00,5000.00,0.00,1617.83,0.12,0
4263,589,-1000.00,3000.00,4000.00,2141.30,2858.70,0.40,0
4264,589,-1000.00,2000.00,3000.00,1996.06,0.00,0.02,0
4265,589,-1000.00,1000.00,2000.00,2345.20,654.80,0.13,0
4266,589,-457.13,542.87,1542.87,0.00,457.13,0.22,0
4267,589,-1000.00,-457.13,542.87,858.75,684.12,0.16,0
4268,589,-176.53,-633.66,366.34,0.00,176.53,0.29,0
4269,589,-366.34,-1000.00,0.00,117.57,248.77,0.40,0
4270,590,-1000.00,-1000.00,0.00,696.88,303.12,0.20,0
4271,591,-1000.00,-1000.00,0.00,348.10,651.90,0.39,0
4272,592,-1000.00,-1000.00,0.00,0.00,1000.00,0.05,0
4273,593,-1000.00,-1000.00,0.00,500.00,500.00,0.07,0
4274,594,1000.00,1000.00,2000.00,0.00,1000.00,0.23,1
4275,594,1000.00,2000.00,3000.00,0.00,1354.15,0.12,1
4276,594,-1000.00,1000.00,2000.00,2207.59,792.41,0.07,0
4277,594,1000.00,2000.00,3000.00,392.57,1607.43,0.09,1
4278,594,1000.00,3000.00,4000.00,601.19,2398.81,0.14,1
4279,594,1000.00,4000.00,5000.00,667.25,3332.75,0.28,1
4280,594,1000.00,5000.00,6000.00,0.00,3915.01,0.15,1
4281,594,1000.00,6000.00,7000.00,1805.33,4194.67,0.43,1
4282,594,1000.00,7000.00,8000.00,0.00,7000.00,0.23,1
4283,594,1000.00,8000.00,9000.00,1449.00,6551.00,0.11,1
4284,594,1000.00,9000.00,10000.00,0.00,9000.00,0.10,1
4285,594,1000.00,10000.00,11000.00,973.21,9026.79,0.27,1
4286,594,1000.00,11000.00,12000.00,0.00,4842.83,0.02,1
4287,594,-1000.00,10000.00,11000.00,3696.44,3591.45,0.26,0
4288,594,1000.00,11000.00,12000.00,3687.49,7312.51,0.41,1
4289,594,-1000.00,10000.00,11000.00,8839.45,3160.55,0.16,0
4290,594,-1000.00,9000.00,10000.00,6980.95,3507.33,0.26,0
4291,594,-1000.00,8000.00,9000.00,2121.77,578.50,0.14,0
4292,594,1000.00,9000.00,10000.00,1032.88,7967.12,0.06,1
4293,594,1000.00,10000.00,11000.00,5000.00,5000.00,0.02,1
4294,594,1000.00,11000.00,12000.00,5024.79,5975.21,0.00,1
4295,594,1000.00,12000.00,13000.00,4447.85,7185.96,0.40,1
4296,594,-1000.00,11000.00,12000.00,8644.04,4355.96,0.33,0
4297,594,-1000.00,10000.00,11000.00,0.00,12000.00,0.05,0
4298,594,-1000.00,9000.00,10000.00,5500.00,5500.00,0.19,0
4299,594,-1000.00,8000.00,9000.00,4484.36,5515.64,0.09,0
4300,594,-1000.00,7000.00,8000.00,3586.08,5413.92,0.34,0
4301,594,-1000.00,6000.00,7000.00,4000.00,4000.00,0.02,0
4302,594,-1000.00,5000.00,6000.00,2726.25,2680.07,0.30,0
4303,594,-1000.00,4000.00,5000.00,2495.90,0.00,0.07,0
4304,594,-1000.00,3000.00,4000.00,2707.59,2292.41,0.27,0
4305,594,-1000.00,2000.00,3000.00,1786.05,2213.95,0.27,0
4306,594,-1000.00,1000.00,2000.00,0.00,3000.00,0.09,0
4307,594,-1000.00,0.00,1000.00,1302.35,697.65,0.27,0
4308,594,-1000.00,-1000.00,0.00,322.81,677.19,0.35,0
4309,595,1000.00,1000.00,2000.00,0.00,256.70,0.07,1
4310,595,1000.00,2000.00,3000.00,0.00,2000.00,0.20,1
4311,595,0.00,2000.00,3000.00,0.00,0.00,0.02,0
4312,595,1000.00,3000.00,4000.00,1345.94,1654.06,0.20,1
4313,595,1000.00,4000.00,5000.00,0.00,4000.00,0.19,1
4314,595,1000.00,5000.00,6000.00,2276.16,2723.84,0.03,1
4315,595,1000.00,6000.00,7000.00,0.00,896.10,0.20,1
4316,595,1000.00,7000.00,8000.00,2106.03,4893.97,0.28,1
4317,595,1000.00,8000.00,9000.00,0.00,7979.29,0.34,1
4318,595,1000.00,9000.00,10000.00,4140.97,4859.03,0.37,1
4319,595,1000.00,10000.00,11000.00,4825.75,5174.25,0.43,1
4320,595,-1000.00,9000.00,10000.00,7536.35,3463.65,0.30,0
4321,595,1000.00,10000.00,11000.00,3470.46,6529.54,0.42,1
4322,595,-1000.00,9000.00,10000.00,7319.66,3680.34,0.21,0
4323,595,1000.00,10000.00,11000.00,0.00,10000.00,0.16,1
4324,595,1000.00,11000.00,12000.00,0.00,10691.28,0.35,1
4325,595,1000.00,12000.00,13000.00,0.00,12000.00,0.04,1
4326,595,1000.00,13000.00,14000.00,1042.28,11529.18,0.40,1
4327,595,1000.00,14000.00,15000.00,225.52,13774.48,0.28,1
4328,595,-1000.00,13000.00,14000.00,9449.28,5550.72,0.01,0
4329,595,-1000.00,12000.00,13000.00,6086.89,6034.90,0.30,0
4330,595,-1000.00,11000.00,12000.00,2002.33,1832.71,0.18,0
4331,595,1000.00,12000.00,13000.00,6000.00,6000.00,0.00,1
4332,595,-1000.00,11000.00,12000.00,6504.42,6495.58,0.07,0
4333,595,1000.00,12000.00,13000.00,0.00,5229.69,0.19,1
4334,595,1000.00,13000.00,14000.00,2672.23,10327.77,0.27,1
4335,595,1000.00,14000.00,15000.00,0.00,10366.03,0.25,1
4336,595,1000.00,15000.00,16000.00,0.00,15000.00,0.07,1
4337,595,1000.00,16000.00,17000.00,6464.55,9535.45,0.41,1
4338,595,1000.00,17000.00,18000.00,8328.01,8671.99,0.11,1
4339,595,1000.00,18000.00,19000.00,5358.27,12641.73,0.44,1
4340,595,1000.00,19000.00,20000.00,8290.25,10709.75,0.15,1
4341,595,-1000.00,18000.00,19000.00,13660.00,6340.00,0.11,0
4342,595,-1000.00,17000.00,18000.00,9807.43,9192.57,0.15,0
4343,595,-1000.00,16000.00,17000.00,9656.49,8343.51,0.38,0
4344,595,1000.00,17000.00,18000.00,6978.27,10021.73,0.31,1
4345,595,1000.00,18000.00,19000.00,1902.64,16097.36,0.23,1
4346,595,1000.00,19000.00,20000.00,6388.16,8322.24,0.40,1
4347,595,1000.00,20000.00,21000.00,9649.34,10350.66,0.02,1
4348,595,-1000.00,19000.00,20000.00,14143.68,6856.32,0.33,0
4349,595,1000.00,20000.00,21000.00,0.00,14696.24,0.35,1
4350,596,-1000.00,-1000.00,0.00,53.98,946.02,0.06,0
4351,597,-580.74,-580.74,419.26,523.00,57.74,0.15,0
4352,597,-419.26,-1000.00,0.00,419.26,0.00,0.01,0
4353,598,-469.76,-469.76,530.24,0.00,469.76,0.21,0
4354,598,-530.24,-1000.00,0.00,226.61,303.64,0.37,0
4355,599,1000.00,1000.00,2000.00,425.03,574.97,0.18,1
4356,599,1000.00,2000.00,3000.00,0.00,1972.74,0.37,1
4357,599,1000.00,3000.00,4000.00,0.00,3000.00,0.17,1
4358,599,0.00,3000.00,4000.00,0.00,0.00,0.00,0
4359,599,-1000.00,2000.00,3000.00,4000.00,0.00,0.04,0
4360,599,1000.00,3000.00,4000.00,0.00,3000.00,0.05,1
4361,599,-1000.00,2000.00,3000.00,1365.94,330.68,0.19,0
4362,599,1000.00,3000.00,4000.00,0.00,2264.23,0.25,1
4363,599,-1000.00,2000.00,3000.00,1829.01,0.00,0.07,0
4364,599,1000.00,3000.00,4000.00,188.60,1041.22,0.30,1
4365,599,1000.00,4000.00,5000.00,0.00,4000.00,0.18,1
4366,599,1000.00,5000.00,6000.00,2110.96,2889.04,0.15,1
4367,599,1000.00,6000.00,7000.00,1748.68,4251.32,0.38,1
4368,599,1000.00,7000.00,8000.00,3261.94,3738.06,0.29,1
4369,599,1000.00,8000.00,9000.00,0.00,8000.00,0.33,1
4370,599,1000.00,9000.00,10000.00,1947.99,7052.01,0.38,1
4371,599,1000.00,10000.00,11000.00,0.00,6566.09,0.32,1
4372,599,-1000.00,9000.00,10000.00,6199.84,4800.16,0.25,0
4373,599,1000.00,10000.00,11000.00,4612.85,5387.15,0.09,1
4374,599,1000.00,11000.00,12000.00,4468.19,6531.81,0.19,1
4375,599,1000.00,12000.00,13000.00,0.00,5682.50,0.01,1
4376,599,-1000.00,11000.00,12000.00,13000.00,0.00,0.03,0
4377,599,-1000.00,10000.00,11000.00,6123.67,5876.33,0.25,0
4378,599,-1000.00,9000.00,10000.00,8566.77,1444.37,0.19,0
4379,599,-1000.00,8000.00,9000.00,5000.00,5000.00,0.02,0
4380,599,-1000.00,7000.00,8000.00,0.00,9000.00,0.09,0
4381,599,-1000.00,6000.00,7000.00,2132.29,5313.41,0.43,0
4382,599,-1000.00,5000.00,6000.00,5460.73,1407.60,0.28,0
4383,599,-1000.00,4000.00,5000.00,3396.98,1530.76,0.24,0
4384,599,-1000.00,3000.00,4000.00,2690.16,0.00,0.18,0
4385,599,-1000.00,2000.00,3000.00,203.35,3796.65,0.31,0
4386,599,-1000.00,1000.00,2000.00,553.85,2446.15,0.42,0
4387,599,-782.11,217.89,1217.89,215.76,566.35,0.31,0
4388,599,-143.04,74.85,1074.85,0.00,143.04,0.08,0
4389,599,-1000.00,-925.15,74.85,603.04,471.81,0.01,0
4390,599,-1000.00,-1925.15,-925.15,58.49,16.36,0.29,0
4391,600,-1000.00,-1000.00,0.00,0.00,1000.00,0.32,0
4392,601,-1000.00,-1000.00,0.00,81.70,918.30,0.30,0
4393,602,0.00,0.00,1000.00,0.00,0.00,0.01,0
4394,602,-1000.00,-1000.00,0.00,170.05,829.95,0.33,0
4395,603,-757.91,-757.91,242.09,0.00,757.91,0.30,0
4396,603,-242.09,-1000.00,0.00,0.00,242.09,0.28,0
4397,604,-1000.00,-1000.00,0.00,435.97,564.03,0.24,0
4398,605,-1000.00,-1000.00,0.00,0.00,381.31,0.17,0
4399,606,1000.00,1000.00,2000.00,255.81,458.01,0.34,1
4400,606,1000.00,2000.00,3000.00,385.66,1375.89,0.42,1
4401,606,-1000.00,1000.00,2000.00,1161.90,1011.13,0.28,0
4402,606,1000.00,2000.00,3000.00,0.00,1792.87,0.23,1
4403,606,1000.00,3000.00,4000.00,0.00,3000.00,0.07,1
4404,606,1000.00,4000.00,5000.00,0.00,4000.00,0.37,1
4405,606,-1000.00,3000.00,4000.00,2986.63,2013.37,0.27,0
4406,606,1000.00,4000.00,5000.00,0.00,3904.33,0.15,1
4407,606,-1000.00,3000.00,4000.00,1137.36,0.00,0.02,0
4408,606,0.00,3000.00,4000.00,0.00,0.00,0.02,0
4409,606,-950.12,2049.88,3049.88,769.83,180.29,0.19,0
4410,606,1000.00,3049.88,4049.88,0.00,3049.88,0.25,1
4411,606,1000.00,4049.88,5049.88,96.12,3427.73,0.41,1
4412,606,1000.00,5049.88,6049.88,0.00,5049.88,0.22,1
4413,606,1000.00,6049.88,7049.88,2718.96,3330.92,0.37,1
4414,606,1000.00,7049.88,8049.88,0.00,7049.88,0.32,1
4415,606,-1000.00,6049.88,7049.88,4541.28,3199.68,0.32,0
4416,606,0.00,6049.88,7049.88,0.00,0.00,0.08,0
4417,606,1000.00,7049.88,8049.88,150.54,6563.20,0.38,1
4418,606,1000.00,8049.88,9049.88,3793.30,4256.58,0.34,1
4419,606,1000.00,9049.88,10049.88,4118.69,4931.19,0.08,1
4420,606,1000.00,10049.88,11049.88,0.00,5928.65,0.38,1
4421,606,1000.00,11049.88,12049.88,0.00,11049.88,0.10,1
4422,606,1000.00,12049.88,13049.88,0.00,8895.18,0.33,1
4423,606,1000.00,13049.88,14049.88,5480.35,6897.57,0.40,1
4424,606,-1000.00,12049.88,13049.88,9968.76,196.94,0.10,0
4425,606,1000.00,13049.88,14049.88,0.00,13049.88,0.14,1
4426,606,1000.00,14049.88,15049.88,3985.65,7173.14,0.34,1
4427,606,1000.00,15049.88,16049.88,5712.91,9336.97,0.32,1
4428,606,1000.00,16049.88,17049.88,5950.87,9052.31,0.36,1
4429,606,1000.00,17049.88,18049.88,8437.34,8612.54,0.34,1
4430,606,-1000.00,16049.88,17049.88,9630.86,8419.02,0.02,0
4431,606,1000.00,17049.88,18049.88,6224.20,10825.68,0.44,1
4432,606,1000.00,18049.88,19049.88,0.00,7748.93,0.30,1
4433,606,-1000.00,17049.88,18049.88,5516.67,0.00,0.06,0
4434,606,1000.00,18049.88,19049.88,6806.43,11243.45,0.22,1
4435,606,1000.00,19049.88,20049.88,4053.13,7293.76,0.37,1
4436,606,-1000.00,18049.88,19049.88,12530.25,284.38,0.11,0
4437,606,1000.00,19049.88,20049.88,0.00,6284.60,0.01,1
4438,606,1000.00,20049.88,21049.88,8118.12,10435.29,0.36,1
4439,606,1000.00,21049.88,22049.88,0.00,21049.88,0.07,1
4440,606,1000.00,22049.88,23049.88,9791.06,12258.82,0.35,1
4441,606,-1000.00,21049.88,22049.88,20454.30,2595.58,0.03,0
4442,606,1000.00,22049.88,23049.88,0.00,11415.27,0.12,1
4443,606,1000.00,23049.88,24049.88,0.00,21013.31,0.30,1
4444,606,-1000.00,22049.88,23049.88,21760.72,2289.16,0.09,0
4445,606,1000.00,23049.88,24049.88,37.11,13561.90,0.40,1
4446,606,-1000.00,22049.88,23049.88,14857.37,9192.51,0.02,0
4447,606,-1000.00,21049.88,22049.88,7403.56,15646.32,0.28,0
4448,606,-1000.00,20049.88,21049.88,17575.46,402.63,0.13,0
4449,606,-1000.00,19049.88,20049.88,5075.32,15974.56,0.27,0
4450,606,-1000.00,18049.88,19049.88,0.00,20049.88,0.14,0
4451,606,-1000.00,17049.88,18049.88,0.00,10979.21,0.04,0
4452,606,-1000.00,16049.88,17049.88,0.00,9707.90,0.21,0
4453,606,-1000.00,15049.88,16049.88,2547.88,14502.00,0.10,0
4454,606,-1000.00,14049.88,15049.88,7146.47,8903.41,0.23,0
4455,606,-1000.00,13049.88,14049.88,0.00,15049.88,0.10,0
4456,606,-1000.00,12049.88,13049.88,0.00,14049.88,0.32,0
4457,606,-1000.00,11049.88,12049.88,3061.58,9988.30,0.43,0
4458,606,-1000.00,10049.88,11049.88,2937.07,9112.81,0.08,0
4459,606,-1000.00,9049.88,10049.88,6230.67,2857.44,0.21,0
4460,606,-1000.00,8049.88,9049.88,2885.69,2348.52,0.31,0
4461,606,-1000.00,7049.88,8049.88,0.00,2597.24,0.11,0
4462,606,-1000.00,6049.88,7049.88,1869.96,6179.92,0.04,0
4463,606,-1000.00,5049.88,6049.88,0.00,7049.88,0.30,0
4464,606,-1000.00,4049.88,5049.88,0.00,6049.88,0.04,0
4465,606,-1000.00,3049.88,4049.88,1907.20,1769.14,0.32,0
4466,606,-1000.00,2049.88,3049.88,1519.19,2339.86,0.42,0
4467,606,-1000.00,1049.88,2049.88,1344.83,1705.05,0.33,0
4468,606,-1000.00,49.88,1049.88,1327.03,587.81,0.22,0
4469,607,-1000.00,-1000.00,0.00,320.11,679.89,0.26,0
4470,608,0.00,0.00,1000.00,0.00,0.00,0.07,0
4471,608,-885.55,-885.55,114.45,0.00,885.55,0.28,0
4472,608,-114.45,-1000.00,0.00,21.42,93.03,0.34,0
4473,609,-508.50,-508.50,491.50,0.00,508.50,0.32,0
4474,609,-491.50,-1000.00,0.00,127.73,363.78,0.39,0
4475,610,-1000.00,-1000.00,0.00,0.00,1000.00,0.10,0
4476,611,-1000.00,-1000.00,0.00,669.49,330.51,0.10,0
4477,612,-659.50,-659.50,340.50,0.00,659.50,0.43,0
4478,612,1000.00,340.50,1340.50,104.42,45.41,0.27,1
4479,612,-584.38,-243.88,756.12,0.00,584.38,0.36,0
4480,612,1000.00,756.12,1756.12,473.97,0.00,0.01,1
4481,612,1000.00,1756.12,2756.12,793.09,609.83,0.40,1
4482,612,-1000.00,756.12,1756.12,906.81,1849.31,0.25,0
4483,612,1000.00,1756.12,2756.12,403.22,56.77,0.27,1
4484,612,-896.72,859.39,1859.39,0.00,896.72,0.08,0
4485,612,1000.00,1859.39,2859.39,1014.50,593.89,0.37,1
4486,612,1000.00,2859.39,3859.39,2400.78,458.61,0.02,1
4487,612,-1000.00,1859.39,2859.39,159.47,1062.83,0.38,0
4488,612,1000.00,2859.39,3859.39,2255.99,491.07,0.18,1
4489,612,-1000.00,1859.39,2859.39,663.06,3196.34,0.40,0
4490,612,-1000.00,859.39,1859.39,1026.91,1832.48,0.38,0
4491,612,-1000.00,-140.61,859.39,900.32,959.07,0.22,0
4492,612,-859.39,-1000.00,0.00,0.00,859.39,0.27,0
4493,613,-80.05,-80.05,919.95,0.00,80.05,0.21,0
4494,613,-919.95,-1000.00,0.00,0.00,919.95,0.15,0
4495,614,-306.05,-306.05,693.95,306.05,0.00,0.05,0
4496,614,1000.00,693.95,1693.95,33.90,660.05,0.30,1
4497,614,1000.00,1693.95,2693.95,100.15,1593.80,0.10,1
4498,614,-1000.00,693.95,1693.95,1495.43,1198.52,0.10,0
4499,614,1000.00,1693.95,2693.95,0.00,357.82,0.17,1
4500,614,1000.00,2693.95,3693.95,417.08,2276.86,0.36,1
4501,614,1000.00,3693.95,4693.95,0.00,3052.00,0.30,1
4502,614,1000.00,4693.95,5693.95,0.00,2438.71,0.01,1
4503,614,1000.00,5693.95,6693.95,0.00,5693.95,0.01,1
4504,614,1000.00,6693.95,7693.95,0.00,5051.30,0.22,1
4505,614,-1000.00,5693.95,6693.95,4026.23,3667.72,0.33,0
4506,614,1000.00,6693.95,7693.95,2601.67,4092.27,0.21,1
4507,614,1000.00,7693.95,8693.95,0.00,7693.95,0.17,1
4508,614,1000.00,8693.95,9693.95,3498.86,5195.08,0.05,1
4509,614,1000.00,9693.95,10693.95,3334.11,6359.84,0.43,1
4510,614,1000.00,10693.95,11693.95,5231.79,5462.16,0.04,1
4511,614,1000.00,11693.95,12693.95,0.00,3504.42,0.12,1
4512,614,1000.00,12693.95,13693.95,3086.20,9607.75,0.42,1
4513,614,1000.00,13693.95,14693.95,6846.97,6846.97,0.15,1
4514,614,1000.00,14693.95,15693.95,2021.18,5832.08,0.30,1
4515,614,1000.00,15693.95,16693.95,7846.97,7846.97,0.00,1
4516,614,1000.00,16693.95,17693.95,0.00,16693.95,0.23,1
4517,614,-1000.00,15693.95,16693.95,2367.82,0.00,0.10,0
4518,614,1000.00,16693.95,17693.95,4917.06,11776.89,0.37,1
4519,614,-1000.00,15693.95,16693.95,7130.89,10563.06,0.34,0
4520,614,-1000.00,14693.95,15693.95,7301.49,9392.46,0.35,0
4521,614,-1000.00,13693.95,14693.95,7846.97,7846.97,0.18,0
4522,614,-1000.00,12693.95,13693.95,3605.57,0.00,0.06,0
4523,614,-1000.00,11693.95,12693.95,2588.38,8813.34,0.40,0
4524,614,-1000.00,10693.95,11693.95,5541.11,1319.62,0.17,0
4525,614,-1000.00,9693.95,10693.95,7303.22,4390.73,0.04,0
4526,614,-1000.00,8693.95,9693.95,0.00,1942.18,0.12,0
4527,614,-1000.00,7693.95,8693.95,6705.84,2224.18,0.23,0
4528,614,-1000.00,6693.95,7693.95,0.00,8693.95,0.33,0
4529,614,-1000.00,5693.95,6693.95,4979.71,2714.24,0.18,0
4530,614,-1000.00,4693.95,5693.95,0.00,6693.95,0.36,0
4531,614,-1000.00,3693.95,4693.95,3233.31,2460.64,0.31,0
4532,614,-1000.00,2693.95,3693.95,1647.79,0.00,0.10,0
4533,614,-1000.00,1693.95,2693.95,13.46,3680.49,0.09,0
4534,614,0.00,1693.95,2693.95,0.00,0.00,0.07,0
4535,614,-1000.00,693.95,1693.95,691.89,1577.16,0.37,0
4536,614,-1000.00,-306.05,693.95,755.94,938.01,0.24,0
4537,614,-693.95,-1000.00,0.00,346.97,346.97,0.18,0
4538,615,-1000.00,-1000.00,0.00,0.00,1000.00,0.25,0
4539,616,-961.64,-961.64,38.36,270.85,690.79,0.40,0
4540,616,-38.36,-1000.00,0.00,9.74,28.63,0.15,0
4541,617,-1000.00,-1000.00,0.00,0.00,1000.00,0.38,0
4542,618,-1000.00,-1000.00,0.00,437.80,562.20,0.34,0
4543,619,-1000.00,-1000.00,0.00,0.00,1000.00,0.40,0
4544,620,1000.00,1000.00,2000.00,159.61,840.39,0.41,1
4545,620,1000.00,2000.00,3000.00,0.00,531.05,0.21,1
4546,620,1000.00,3000.00,4000.00,1500.00,1500.00,0.13,1
4547,620,1000.00,4000.00,5000.00,2000.00,2000.00,0.02,1
4548,620,-1000.00,3000.00,4000.00,2743.88,2256.12,0.14,0
4549,620,-1000.00,2000.00,3000.00,2730.24,692.01,0.17,0
4550,620,1000.00,3000.00,4000.00,981.67,2018.33,0.24,1
4551,620,1000.00,4000.00,5000.00,821.87,3178.13,0.29,1
4552,620,1000.00,5000.00,6000.00,1317.52,3682.48,0.04,1
4553,620,1000.00,6000.00,7000.00,0.00,6000.00,0.23,1
4554,620,1000.00,7000.00,8000.00,0.00,4134.42,0.21,1
4555,620,1000.00,8000.00,9000.00,3344.62,4655.38,0.33,1
4556,620,-1000.00,7000.00,8000.00,5028.13,3971.87,0.19,0
4557,620,-1000.00,6000.00,7000.00,5248.46,2751.54,0.08,0
4558,620,-1000.00,5000.00,6000.00,4902.52,2097.48,0.02,0
4559,620,1000.00,6000.00,7000.00,0.00,2598.72,0.27,1
4560,620,1000.00,7000.00,8000.00,3072.68,3927.32,0.42,1
4561,620,-1000.00,6000.00,7000.00,4025.14,3974.86,0.24,0
4562,620,1000.00,7000.00,8000.00,0.00,5999.91,0.04,1
4563,620,1000.00,8000.00,9000.00,3818.27,4181.73,0.36,1
4564,620,0.00,8000.00,9000.00,0.00,0.00,0.05,0
4565,620,1000.00,9000.00,10000.00,2178.05,6821.95,0.05,1
4566,620,1000.00,10000.00,11000.00,3505.65,6494.35,0.26,1
4567,620,1000.00,11000.00,12000.00,4421.60,6244.13,0.35,1
4568,620,1000.00,12000.00,13000.00,3148.07,5712.08,0.33,1
4569,620,1000.00,13000.00,14000.00,0.00,515.26,0.08,1
4570,620,1000.00,14000.00,15000.00,6190.19,7809.81,0.35,1
4571,620,1000.00,15000.00,16000.00,5771.24,9228.76,0.44,1
4572,620,-1000.00,14000.00,15000.00,8962.87,7037.13,0.28,0
4573,620,1000.00,15000.00,16000.00,782.53,14217.47,0.23,1
4574,620,1000.00,16000.00,17000.00,6070.42,9929.58,0.39,1
4575,620,1000.00,17000.00,18000.00,0.00,17000.00,0.05,1
4576,620,1000.00,18000.00,19000.00,918.57,11938.88,0.40,1
4577,620,1000.00,19000.00,20000.00,418.70,1195.10,0.18,1
4578,620,1000.00,20000.00,21000.00,9808.28,10191.72,0.39,1
4579,620,1000.00,21000.00,22000.00,155.23,20844.77,0.35,1
4580,620,1000.00,22000.00,23000.00,6892.85,9888.77,0.34,1
4581,620,1000.00,23000.00,24000.00,0.00,23000.00,0.06,1
4582,620,-1000.00,22000.00,23000.00,24000.00,0.00,0.10,0
4583,620,1000.00,23000.00,24000.00,0.00,16162.69,0.39,1
4584,620,1000.00,24000.00,25000.00,0.00,24000.00,0.04,1
4585,620,1000.00,25000.00,26000.00,4436.10,20563.90,0.41,1
4586,620,-7.19,24992.81,25992.81,7.19,0.00,0.15,0
4587,620,1000.00,25992.81,26992.81,9317.07,16675.74,0.30,1
4588,620,1000.00,26992.81,27992.81,1205.36,25787.44,0.29,1
4589,620,1000.00,27992.81,28992.81,3445.53,15426.31,0.39,1
4590,621,-1000.00,-1000.00,0.00,545.72,454.28,0.22,0
4591,622,-662.42,-662.42,337.58,0.00,662.42,0.29,0
4592,622,-337.58,-1000.00,0.00,136.66,200.92,0.37,0
4593,623,-795.72,-795.72,204.28,0.00,795.72,0.39,0
4594,623,0.00,-795.72,204.28,0.00,0.00,0.01,0
4595,623,-204.28,-1000.00,0.00,0.00,204.28,0.11,0
4596,624,1000.00,1000.00,2000.00,0.00,581.60,0.11,1
4597,624,1000.00,2000.00,3000.00,588.73,1411.27,0.35,1
4598,624,1000.00,3000.00,4000.00,1092.84,1907.16,0.20,1
4599,624,1000.00,4000.00,5000.00,57.16,1395.58,0.26,1
4600,624,1000.00,5000.00,6000.00,1209.13,3790.87,0.44,1
4601,624,-1000.00,4000.00,5000.00,1520.39,0.00,0.07,0
4602,624,-1000.00,3000.00,4000.00,2855.89,283.39,0.18,0
4603,624,1000.00,4000.00,5000.00,1362.17,2637.83,0.38,1
4604,624,1000.00,5000.00,6000.00,0.00,3452.07,0.32,1
4605,624,1000.00,6000.00,7000.00,0.00,6000.00,0.19,1
4606,624,1000.00,7000.00,8000.00,2035.32,4964.68,0.35,1
4607,624,1000.00,8000.00,9000.00,4000.00,4000.00,0.04,1
4608,624,-1000.00,7000.00,8000.00,2613.62,0.00,0.28,0
4609,624,1000.00,8000.00,9000.00,0.00,5072.72,0.18,1
4610,624,-1000.00,7000.00,8000.00,6457.89,2542.11,0.16,0
4611,624,1000.00,8000.00,9000.00,0.00,8000.00,0.30,1
4612,624,1000.00,9000.00,10000.00,3675.68,5324.32,0.06,1
4613,624,-1000.00,8000.00,9000.00,10000.00,0.00,0.02,0
4614,624,-1000.00,7000.00,8000.00,6462.42,470.03,0.18,0
4615,624,0.00,7000.00,8000.00,0.00,0.00,0.01,0
4616,624,1000.00,8000.00,9000.00,0.00,2227.22,0.14,1
4617,624,1000.00,9000.00,10000.00,3528.54,4273.57,0.39,1
4618,624,1000.00,10000.00,11000.00,3665.64,6334.36,0.28,1
4619,624,1000.00,11000.00,12000.00,2698.35,5342.37,0.38,1
4620,624,-1000.00,10000.00,11000.00,7041.78,4958.22,0.31,0
4621,624,-1000.00,9000.00,10000.00,5500.00,5500.00,0.04,0
4622,624,-1000.00,8000.00,9000.00,3358.30,6641.70,0.41,0
4623,624,-1000.00,7000.00,8000.00,1434.10,7565.90,0.40,0
4624,624,-1000.00,6000.00,7000.00,204.66,0.00,0.15,0
4625,624,-1000.00,5000.00,6000.00,1548.94,5451.06,0.34,0
4626,624,-370.21,4629.79,5629.79,0.00,370.21,0.16,0
4627,624,-1000.00,3629.79,4629.79,0.00,1696.17,0.24,0
4628,624,-1000.00,2629.79,3629.79,1218.38,0.00,0.07,0
4629,624,-1000.00,1629.79,2629.79,297.02,0.00,0.00,0
4630,624,-1000.00,629.79,1629.79,0.00,2629.79,0.04,0
4631,624,-1000.00,-370.21,629.79,519.25,1110.54,0.30,0
4632,624,-1000.00,-1370.21,-370.21,60.05,0.00,0.14,0
4633,625,-1000.00,-1000.00,0.00,0.00,1000.00,0.12,0
4634,626,-942.37,-942.37,57.63,942.37,0.00,0.04,0
4635,626,-1000.00,-1942.37,-942.37,0.00,57.63,0.06,0
4636,627,-1000.00,-1000.00,0.00,0.00,897.47,0.43,0
4637,628,0.00,0.00,1000.00,0.00,0.00,0.08,0
4638,628,-1000.00,-1000.00,0.00,0.00,1000.00,0.15,0
4639,629,-833.45,-833.45,166.55,135.75,697.70,0.42,0
4640,629,-166.55,-1000.00,0.00,82.56,83.98,0.09,0
4641,630,1000.00,1000.00,2000.00,0.00,1000.00,0.23,1
4642,630,1000.00,2000.00,3000.00,1000.00,1000.00,0.17,1
4643,630,-1000.00,1000.00,2000.00,1871.61,1128.39,0.05,0
4644,630,1000.00,2000.00,3000.00,1000.00,1000.00,0.03,1
4645,630,1000.00,3000.00,4000.00,982.26,2017.74,0.17,1
4646,630,-1000.00,2000.00,3000.00,2136.63,1863.37,0.21,0
4647,630,-1000.00,1000.00,2000.00,3000.00,0.00,0.04,0
4648,630,1000.00,2000.00,3000.00,550.49,1449.51,0.41,1
4649,630,0.00,2000.00,3000.00,0.00,0.00,0.02,0
4650,630,-1000.00,1000.00,2000.00,2861.96,138.04,0.05,0
4651,630,1000.00,2000.00,3000.00,924.27,1075.73,0.39,1
4652,630,1000.00,3000.00,4000.00,766.30,2233.70,0.39,1
4653,630,1000.00,4000.00,5000.00,204.64,3456.87,0.41,1
4654,630,1000.00,5000.00,6000.00,2500.00,2500.00,0.07,1
4655,630,1000.00,6000.00,7000.00,2272.65,3727.35,0.27,1
4656,630,-1000.00,5000.00,6000.00,7000.00,0.00,0.01,0
4657,630,-1000.00,4000.00,5000.00,3053.37,1683.82,0.39,0
4658,630,1000.00,5000.00,6000.00,1142.59,1527.72,0.31,1
4659,630,1000.00,6000.00,7000.00,2047.79,3952.21,0.42,1
4660,630,1000.00,7000.00,8000.00,215.24,3694.65,0.37,1
4661,630,1000.00,8000.00,9000.00,84.27,213.05,0.20,1
4662,630,-1000.00,7000.00,8000.00,5245.67,3754.33,0.10,0
4663,630,-1000.00,6000.00,7000.00,1072.33,6927.67,0.41,0
4664,630,-1000.00,5000.00,6000.00,3443.85,3556.15,0.29,0
4665,630,0.00,5000.00,6000.00,0.00,0.00,0.04,0
4666,630,-1000.00,4000.00,5000.00,2957.86,3042.14,0.32,0
4667,630,-1000.00,3000.00,4000.00,1269.61,3730.39,0.41,0
4668,630,-1000.00,2000.00,3000.00,766.47,1920.01,0.41,0
4669,630,-1000.00,1000.00,2000.00,0.00,2290.90,0.32,0
4670,630,-1000.00,0.00,1000.00,501.25,1498.75,0.17,0
4671,630,0.00,0.00,1000.00,0.00,0.00,0.05,0
4672,630,-1000.00,-1000.00,0.00,720.81,279.19,0.03,0
4673,631,-1000.00,-1000.00,0.00,126.81,873.19,0.41,0
4674,632,1000.00,1000.00,2000.00,0.00,541.48,0.30,1
4675,632,-1000.00,0.00,1000.00,936.70,764.86,0.28,0
4676,632,1000.00,1000.00,2000.00,0.00,1000.00,0.24,1
4677,632,1000.00,2000.00,3000.00,0.00,158.28,0.17,1
4678,632,-1000.00,1000.00,2000.00,1851.31,1148.69,0.27,0
4679,632,1000.00,2000.00,3000.00,46.19,1953.81,0.09,1
4680,632,-1000.00,1000.00,2000.00,1840.96,1159.04,0.23,0
4681,632,-1000.00,0.00,1000.00,1685.86,314.14,0.05,0
4682,632,1000.00,1000.00,2000.00,252.90,747.10,0.14,1
4683,632,1000.00,2000.00,3000.00,0.00,498.74,0.16,1
4684,632,1000.00,3000.00,4000.00,256.16,2743.84,0.39,1
4685,632,-1000.00,2000.00,3000.00,2664.31,787.41,0.18,0
4686,632,1000.00,3000.00,4000.00,0.00,3000.00,0.07,1
4687,632,1000.00,4000.00,5000.00,0.00,3128.00,0.11,1
4688,632,1000.00,5000.00,6000.00,2500.00,2500.00,0.13,1
4689,632,-865.92,4134.08,5134.08,865.92,0.00,0.10,0
4690,632,1000.00,5134.08,6134.08,0.00,5134.08,0.15,1
4691,632,1000.00,6134.08,7134.08,0.00,5174.31,0.07,1
4692,632,-1000.00,5134.08,6134.08,6634.90,0.00,0.18,0
4693,632,1000.00,6134.08,7134.08,2912.39,3079.50,0.30,1
4694,632,1000.00,7134.08,8134.08,0.00,7134.08,0.15,1
4695,632,1000.00,8134.08,9134.08,0.00,8134.08,0.17,1
4696,632,1000.00,9134.08,10134.08,3205.16,5928.92,0.39,1
4697,632,1000.00,10134.08,11134.08,2886.52,7247.56,0.44,1
4698,632,-1000.00,9134.08,10134.08,7446.08,3688.00,0.29,0
4699,632,0.00,9134.08,10134.08,0.00,0.00,0.03,0
4700,632,1000.00,10134.08,11134.08,5067.04,5067.04,0.08,1
4701,632,1000.00,11134.08,12134.08,1339.37,9794.71,0.43,1
4702,632,-1000.00,10134.08,11134.08,12134.08,0.00,0.00,0
4703,632,-1000.00,9134.08,10134.08,10467.51,0.00,0.04,0
4704,632,1000.00,10134.08,11134.08,4794.24,5339.84,0.37,1
4705,632,-1000.00,9134.08,10134.08,5602.81,0.00,0.10,0
4706,633,-1000.00,-1000.00,0.00,175.35,824.65,0.16,0
4707,634,-1000.00,-1000.00,0.00,0.00,1000.00,0.09,0
4708,635,-1000.00,-1000.00,0.00,0.00,1000.00,0.12,0
4709,636,-1000.00,-1000.00,0.00,0.00,1000.00,0.05,0
4710,637,1000.00,1000.00,2000.00,476.24,523.76,0.25,1
4711,637,-1000.00,0.00,1000.00,1314.90,685.10,0.15,0
4712,637,1000.00,1000.00,2000.00,156.68,843.32,0.35,1
4713,637,1000.00,2000.00,3000.00,973.03,1026.97,0.23,1
4714,637,1000.00,3000.00,4000.00,0.00,3000.00,0.09,1
4715,637,-1000.00,2000.00,3000.00,4000.00,0.00,0.00,0
4716,637,-689.64,1310.36,2310.36,689.64,0.00,0.08,0
4717,637,1000.00,2310.36,3310.36,892.39,1417.97,0.27,1
4718,637,0.00,2310.36,3310.36,0.00,0.00,0.00,0
4719,637,1000.00,3310.36,4310.36,1655.18,1655.18,0.20,1
4720,637,-1000.00,2310.36,3310.36,3540.59,0.00,0.09,0
4721,637,-960.68,1349.68,2349.68,960.68,0.00,0.13,0
4722,637,1000.00,2349.68,3349.68,0.00,1037.33,0.25,1
4723,637,0.00,2349.68,3349.68,0.00,0.00,0.04,0
4724,637,1000.00,3349.68,4349.68,1674.84,1674.84,0.03,1
4725,637,1000.00,4349.68,5349.68,133.43,4216.24,0.33,1
4726,637,1000.00,5349.68,6349.68,0.00,5349.68,0.27,1
4727,637,-1000.00,4349.68,5349.68,3238.93,0.00,0.08,0
4728,637,-1000.00,3349.68,4349.68,1927.92,3421.75,0.41,0
4729,637,-1000.00,2349.68,3349.68,2099.33,2250.35,0.31,0
4730,637,-1000.00,1349.68,2349.68,1279.73,2069.95,0.42,0
4731,637,-1000.00,349.68,1349.68,237.62,25.35,0.16,0
4732,637,-680.65,-330.97,669.03,0.00,680.65,0.04,0
4733,637,-669.03,-1000.00,0.00,0.00,669.03,0.06,0
4734,638,-1000.00,-1000.00,0.00,0.00,1000.00,0.33,0
4735,639,-1000.00,-1000.00,0.00,36.29,963.71,0.26,0
4736,640,-1000.00,-1000.00,0.00,0.00,1000.00,0.21,0
4737,641,-1000.00,-1000.00,0.00,0.00,1000.00,0.34,0
4738,642,0.00,0.00,1000.00,0.00,0.00,0.04,0
4739,642,-606.58,-606.58,393.42,0.00,606.58,0.16,0
4740,642,0.00,-606.58,393.42,0.00,0.00,0.09,0
4741,642,-393.42,-1000.00,0.00,194.29,199.14,0.09,0
4742,643,-1000.00,-1000.00,0.00,0.00,1000.00,0.38,0
4743,644,-1000.00,-1000.00,0.00,0.00,276.72,0.20,0
4744,645,1000.00,1000.00,2000.00,0.00,731.35,0.28,1
4745,645,1000.00,2000.00,3000.00,286.24,1713.76,0.29,1
4746,645,1000.00,3000.00,4000.00,0.00,2009.57,0.17,1
4747,645,1000.00,4000.00,5000.00,0.00,4000.00,0.07,1
4748,645,0.00,4000.00,5000.00,0.00,0.00,0.01,0
4749,645,1000.00,5000.00,6000.00,782.57,3379.58,0.39,1
4750,645,1000.00,6000.00,7000.00,1797.27,3194.43,0.35,1
4751,645,1000.00,7000.00,8000.00,0.00,7000.00,0.07,1
4752,645,1000.00,8000.00,9000.00,3729.36,4270.64,0.38,1
4753,645,1000.00,9000.00,10000.00,0.00,6375.26,0.31,1
4754,645,1000.00,10000.00,11000.00,2616.98,6423.12,0.39,1
4755,645,-1000.00,9000.00,10000.00,7653.76,2520.34,0.18,0
4756,645,1000.00,10000.00,11000.00,1599.68,8400.32,0.09,1
4757,645,1000.00,11000.00,12000.00,4747.34,6252.66,0.26,1
4758,645,1000.00,12000.00,13000.00,0.00,8770.56,0.34,1
4759,645,1000.00,13000.00,14000.00,4673.49,8326.51,0.42,1
4760,645,1000.00,14000.00,15000.00,4666.86,9333.14,0.19,1
4761,645,1000.00,15000.00,16000.00,1058.31,13941.69,0.19,1
4762,645,1000.00,16000.00,17000.00,7720.70,8279.30,0.19,1
4763,645,1000.00,17000.00,18000.00,0.00,17000.00,0.10,1
4764,645,1000.00,18000.00,19000.00,5294.51,12705.49,0.39,1
4765,645,-1000.00,17000.00,18000.00,10474.68,8525.32,0.05,0
4766,645,0.00,17000.00,18000.00,0.00,0.00,0.01,0
4767,645,1000.00,18000.00,19000.00,8585.09,9414.91,0.30,1
4768,645,1000.00,19000.00,20000.00,7726.99,11273.01,0.29,1
4769,645,1000.00,20000.00,21000.00,8755.70,11244.30,0.43,1
4770,645,-1000.00,19000.00,20000.00,12483.85,8516.15,0.16,0
4771,645,1000.00,20000.00,21000.00,7159.64,12840.36,0.43,1
4772,645,-1000.00,19000.00,20000.00,5013.18,2063.65,0.16,0
4773,645,-1000.00,18000.00,19000.00,11944.36,8055.64,0.28,0
4774,645,1000.00,19000.00,20000.00,6753.05,12246.95,0.34,1
4775,645,1000.00,20000.00,21000.00,472.47,14216.99,0.34,1
4776,645,-1000.00,19000.00,20000.00,11320.71,9679.29,0.32,0
4777,645,1000.00,20000.00,21000.00,4944.24,15055.76,0.18,1
4778,645,1000.00,21000.00,22000.00,10500.00,10500.00,0.15,1
4779,645,-1000.00,20000.00,21000.00,11963.94,10036.06,0.03,0
4780,645,1000.00,21000.00,22000.00,8859.99,12140.01,0.30,1
4781,645,-1000.00,20000.00,21000.00,17511.10,4488.90,0.05,0
4782,645,1000.00,21000.00,22000.00,0.00,1633.75,0.16,1
4783,645,1000.00,22000.00,23000.00,8520.30,13479.70,0.28,1
4784,645,-1000.00,21000.00,22000.00,11798.63,11201.37,0.07,0
4785,645,1000.00,22000.00,23000.00,0.00,22000.00,0.21,1
4786,645,1000.00,23000.00,24000.00,0.00,6079.53,0.07,1
4787,646,1000.00,1000.00,2000.00,383.64,616.36,0.36,1
4788,646,1000.00,2000.00,3000.00,754.17,1245.83,0.06,1
4789,646,-1000.00,1000.00,2000.00,1809.30,1190.70,0.19,0
4790,646,1000.00,2000.00,3000.00,294.45,1705.55,0.33,1
4791,646,1000.00,3000.00,4000.00,1441.49,1558.51,0.18,1
4792,646,1000.00,4000.00,5000.00,610.48,3389.52,0.40,1
4793,646,1000.00,5000.00,6000.00,2010.10,2989.90,0.35,1
4794,646,1000.00,6000.00,7000.00,3000.00,3000.00,0.16,1
4795,646,1000.00,7000.00,8000.00,2565.00,4435.00,0.31,1
4796,646,1000.00,8000.00,9000.00,0.00,8000.00,0.05,1
4797,646,-1000.00,7000.00,8000.00,6485.31,2514.69,0.14,0
4798,646,1000.00,8000.00,9000.00,0.00,8000.00,0.25,1
4799,646,1000.00,9000.00,10000.00,0.00,1241.22,0.21,1
4800,646,0.00,9000.00,10000.00,0.00,0.00,0.07,0
4801,646,-1000.00,8000.00,9000.00,8416.40,1583.60,0.07,0
4802,646,0.00,8000.00,9000.00,0.00,0.00,0.12,0
4803,646,1000.00,9000.00,10000.00,3889.09,5110.91,0.14,1
4804,646,0.00,9000.00,10000.00,0.00,0.00,0.02,0
4805,646,1000.00,10000.00,11000.00,3951.44,6048.56,0.22,1
4806,646,1000.00,11000.00,12000.00,1779.98,9220.02,0.40,1
4807,646,-1000.00,10000.00,11000.00,3842.01,8157.99,0.39,0
4808,646,-1000.00,9000.00,10000.00,1940.10,1817.37,0.23,0
4809,646,-1000.00,8000.00,9000.00,8095.58,1275.30,0.13,0
4810,646,-1000.00,7000.00,8000.00,5066.19,2773.55,0.23,0
4811,646,-1000.00,6000.00,7000.00,2021.77,5978.23,0.34,0
4812,646,-1000.00,5000.00,6000.00,3274.99,3725.01,0.21,0
4813,646,-1000.00,4000.00,5000.00,0.00,6000.00,0.19,0
4814,646,-1000.00,3000.00,4000.00,2285.07,2714.93,0.16,0
4815,646,-1000.00,2000.00,3000.00,2587.54,1412.46,0.12,0
4816,646,-1000.00,1000.00,2000.00,1383.98,1616.02,0.32,0
4817,646,-430.63,569.37,1569.37,0.00,430.63,0.28,0
4818,646,0.00,569.37,1569.37,0.00,0.00,0.10,0
4819,646,-628.13,-58.76,941.24,0.00,628.13,0.37,0
4820,646,-941.24,-1000.00,0.00,0.00,941.24,0.10,0
4821,647,-1000.00,-1000.00,0.00,685.65,314.35,0.02,0
4822,648,-1000.00,-1000.00,0.00,0.00,1000.00,0.15,0
4823,649,-1000.00,-1000.00,0.00,0.00,1000.00,0.08,0
4824,650,1000.00,1000.00,2000.00,0.00,711.06,0.36,1
4825,650,1000.00,2000.00,3000.00,235.25,1764.75,0.34,1
4826,650,1000.00,3000.00,4000.00,920.82,2079.18,0.27,1
4827,650,1000.00,4000.00,5000.00,1826.26,2173.74,0.27,1
4828,650,1000.00,5000.00,6000.00,0.00,3857.54,0.26,1
4829,650,1000.00,6000.00,7000.00,0.00,3247.34,0.30,1
4830,650,1000.00,7000.00,8000.00,718.22,6281.78,0.22,1
4831,650,1000.00,8000.00,9000.00,0.00,3541.25,0.09,1
4832,650,1000.00,9000.00,10000.00,0.00,9000.00,0.18,1
4833,650,1000.00,10000.00,11000.00,0.00,10000.00,0.31,1
4834,650,1000.00,11000.00,12000.00,5500.00,5500.00,0.12,1
4835,650,1000.00,12000.00,13000.00,1135.80,10864.20,0.42,1
4836,650,1000.00,13000.00,14000.00,3555.82,9444.18,0.40,1
4837,650,1000.00,14000.00,15000.00,4304.97,9695.03,0.42,1
4838,650,1000.00,15000.00,16000.00,7500.00,7500.00,0.04,1
4839,650,-1000.00,14000.00,15000.00,3612.99,0.00,0.18,0
4840,650,1000.00,15000.00,16000.00,1063.65,8046.66,0.36,1
4841,650,1000.00,16000.00,17000.00,7962.06,8037.94,0.34,1
4842,650,1000.00,17000.00,18000.00,0.00,6474.58,0.04,1
4843,650,-1000.00,16000.00,17000.00,0.00,18000.00,0.02,0
4844,650,-1000.00,15000.00,16000.00,0.00,17000.00,0.12,0
4845,650,-1000.00,14000.00,15000.00,8000.00,8000.00,0.10,0
4846,650,-1000.00,13000.00,14000.00,9637.22,5362.78,0.22,0
4847,650,-1000.00,12000.00,13000.00,0.00,9563.00,0.24,0
4848,650,-1000.00,11000.00,12000.00,0.00,13000.00,0.15,0
4849,650,-1000.00,10000.00,11000.00,1362.49,9730.80,0.40,0
4850,650,-1000.00,9000.00,10000.00,1474.40,3736.60,0.33,0
4851,650,-1000.00,8000.00,9000.00,6133.98,3866.02,0.25,0
4852,650,-1000.00,7000.00,8000.00,2406.63,6593.37,0.34,0
4853,650,-1000.00,6000.00,7000.00,0.00,1311.72,0.22,0
4854,650,-1000.00,5000.00,6000.00,0.00,2936.14,0.15,0
4855,650,-1000.00,4000.00,5000.00,5758.23,0.00,0.13,0
4856,650,0.00,4000.00,5000.00,0.00,0.00,0.01,0
4857,650,-1000.00,3000.00,4000.00,1394.09,3605.91,0.42,0
4858,650,-1000.00,2000.00,3000.00,3739.15,0.00,0.03,0
4859,650,-1000.00,1000.00,2000.00,0.00,2423.08,0.12,0
4860,650,-1000.00,0.00,1000.00,0.00,2000.00,0.31,0
4861,650,-1000.00,-1000.00,0.00,897.73,102.27,0.10,0
4862,651,-845.87,-845.87,154.13,178.40,667.47,0.39,0
4863,651,-154.13,-1000.00,0.00,29.47,124.66,0.37,0
4864,652,1000.00,1000.00,2000.00,0.00,916.09,0.33,1
4865,652,1000.00,2000.00,3000.00,0.00,1389.12,0.26,1
4866,652,1000.00,3000.00,4000.00,0.00,3000.00,0.31,1
4867,652,1000.00,4000.00,5000.00,0.00,3888.27,0.14,1
4868,652,1000.00,5000.00,6000.00,907.91,4092.09,0.22,1
4869,652,-1000.00,4000.00,5000.00,3563.37,2436.63,0.22,0
4870,652,1000.00,5000.00,6000.00,0.00,5000.00,0.01,1
4871,652,1000.00,6000.00,7000.00,0.00,3685.95,0.18,1
4872,652,1000.00,7000.00,8000.00,2238.02,4761.98,0.12,1
4873,652,1000.00,8000.00,9000.00,1750.14,6249.86,0.18,1
4874,652,-1000.00,7000.00,8000.00,5990.31,3009.69,0.21,0
4875,652,1000.00,8000.00,9000.00,2904.35,5095.65,0.40,1
4876,652,1000.00,9000.00,10000.00,0.00,9000.00,0.39,1
4877,652,1000.00,10000.00,11000.00,3572.26,6427.74,0.01,1
4878,652,1000.00,11000.00,12000.00,1420.91,9579.09,0.19,1
4879,652,-1000.00,10000.00,11000.00,7539.47,0.00,0.08,0
4880,652,1000.00,11000.00,12000.00,3359.68,7640.32,0.38,1
4881,652,1000.00,12000.00,13000.00,0.00,9582.99,0.11,1
4882,652,1000.00,13000.00,14000.00,0.00,5742.88,0.26,1
4883,652,1000.00,14000.00,15000.00,0.00,14000.00,0.17,1
4884,652,1000.00,15000.00,16000.00,2622.12,12377.88,0.37,1
4885,652,1000.00,16000.00,17000.00,0.00,10273.83,0.11,1
4886,652,-1000.00,15000.00,16000.00,9490.36,7509.64,0.04,0
4887,652,1000.00,16000.00,17000.00,0.00,16000.00,0.11,1
4888,652,-1000.00,15000.00,16000.00,9654.70,7345.30,0.08,0
4889,652,1000.00,16000.00,17000.00,0.00,10416.74,0.28,1
4890,652,-1000.00,15000.00,16000.00,8527.60,8472.40,0.30,0
4891,652,-1000.00,14000.00,15000.00,8180.06,7819.94,0.08,0
4892,652,1000.00,15000.00,16000.00,3423.09,6550.87,0.33,1
4893,652,1000.00,16000.00,17000.00,2421.67,8880.60,0.36,1
4894,652,0.00,16000.00,17000.00,0.00,0.00,0.12,0
4895,652,1000.00,17000.00,18000.00,2624.20,14375.80,0.35,1
4896,652,0.00,17000.00,18000.00,0.00,0.00,0.02,0
4897,652,1000.00,18000.00,19000.00,8571.80,9428.20,0.32,1
4898,652,1000.00,19000.00,20000.00,0.00,10182.67,0.08,1
4899,652,1000.00,20000.00,21000.00,7367.78,12632.22,0.39,1
4900,652,-1000.00,19000.00,20000.00,15515.39,0.00,0.11,0
4901,652,1000.00,20000.00,21000.00,0.00,20000.00,0.28,1
4902,652,1000.00,21000.00,22000.00,7465.32,13534.68,0.18,1
4903,652,1000.00,22000.00,23000.00,9156.74,12843.26,0.36,1
4904,652,1000.00,23000.00,24000.00,0.00,23000.00,0.06,1
4905,652,-1000.00,22000.00,23000.00,12999.90,11000.10,0.38,0
4906,652,1000.00,23000.00,24000.00,9259.07,13740.93,0.27,1
4907,652,1000.00,24000.00,25000.00,0.00,24000.00,0.22,1
4908,652,1000.00,25000.00,26000.00,0.00,25000.00,0.30,1
4909,652,-1000.00,24000.00,25000.00,26000.00,0.00,0.06,0
4910,652,1000.00,25000.00,26000.00,0.00,25000.00,0.18,1
4911,652,-1000.00,24000.00,25000.00,13558.73,12441.27,0.18,0
4912,652,-981.34,23018.66,24018.66,0.00,981.34,0.13,0
4913,652,-1000.00,22018.66,23018.66,8243.03,15775.62,0.38,0
4914,652,-1000.00,21018.66,22018.66,0.00,23018.66,0.03,0
4915,652,-1000.00,20018.66,21018.66,5563.43,16455.23,0.36,0
4916,652,-1000.00,19018.66,20018.66,0.00,21018.66,0.04,0
4917,652,-1000.00,18018.66,19018.66,3797.04,16221.62,0.44,0
4918,652,-1000.00,17018.66,18018.66,13783.86,0.00,0.04,0
4919,652,-1000.00,16018.66,17018.66,0.00,18018.66,0.19,0
4920,652,-1000.00,15018.66,16018.66,0.00,17018.66,0.25,0
4921,652,-1000.00,14018.66,15018.66,603.30,9638.72,0.32,0
4922,652,0.00,14018.66,15018.66,0.00,0.00,0.07,0
4923,652,-1000.00,13018.66,14018.66,4704.23,534.78,0.18,0
4924,652,-1000.00,12018.66,13018.66,6332.84,7685.82,0.24,0
4925,652,-1000.00,11018.66,12018.66,4897.51,8121.14,0.38,0
4926,652,-1000.00,10018.66,11018.66,10903.24,0.00,0.07,0
4927,652,-1000.00,9018.66,10018.66,4491.15,6527.51,0.17,0
4928,652,-1000.00,8018.66,9018.66,2598.39,7420.26,0.41,0
4929,652,-1000.00,7018.66,8018.66,5489.89,3528.76,0.13,0
4930,652,-1000.00,6018.66,7018.66,831.05,7187.60,0.16,0
4931,652,-1000.00,5018.66,6018.66,3509.33,3509.33,0.05,0
4932,653,-1000.00,-1000.00,0.00,392.92,607.08,0.27,0
4933,653,-0.00,-1000.00,0.00,0.00,0.00,0.41,0
4934,654,1000.00,1000.00,2000.00,0.00,951.73,0.05,1
4935,654,1000.00,2000.00,3000.00,321.88,1595.53,0.43,1
4936,654,1000.00,3000.00,4000.00,0.00,3000.00,0.05,1
4937,654,1000.00,4000.00,5000.00,476.23,3523.77,0.38,1
4938,654,0.00,4000.00,5000.00,0.00,0.00,0.06,0
4939,654,1000.00,5000.00,6000.00,1150.92,3849.08,0.41,1
4940,654,1000.00,6000.00,7000.00,0.00,6000.00,0.19,1
4941,654,1000.00,7000.00,8000.00,3318.76,3681.24,0.21,1
4942,654,1000.00,8000.00,9000.00,0.00,6508.52,0.16,1
4943,654,-1000.00,7000.00,8000.00,6796.79,90.12,0.12,0
4944,654,1000.00,8000.00,9000.00,2580.09,5419.91,0.40,1
4945,654,1000.00,9000.00,10000.00,1663.30,2759.81,0.21,1
4946,654,0.00,9000.00,10000.00,0.00,0.00,0.06,0
4947,654,0.00,9000.00,10000.00,0.00,0.00,0.00,0
4948,654,1000.00,10000.00,11000.00,0.00,5705.07,0.15,1
4949,654,0.00,10000.00,11000.00,0.00,0.00,0.06,0
4950,654,1000.00,11000.00,12000.00,0.00,11000.00,0.08,1
4951,654,1000.00,12000.00,13000.00,1139.16,10860.84,0.13,1
4952,654,-1000.00,11000.00,12000.00,9633.43,3366.57,0.12,0
4953,654,1000.00,12000.00,13000.00,1365.72,6524.71,0.26,1
4954,654,1000.00,13000.00,14000.00,5651.13,7348.87,0.23,1
4955,654,-1000.00,12000.00,13000.00,1273.43,0.00,0.01,0
4956,654,1000.00,13000.00,14000.00,4282.72,8717.28,0.40,1
4957,654,1000.00,14000.00,15000.00,0.00,9397.97,0.17,1
4958,654,1000.00,15000.00,16000.00,5674.54,9325.46,0.43,1
4959,654,1000.00,16000.00,17000.00,0.00,5810.06,0.06,1
4960,654,1000.00,17000.00,18000.00,0.00,92.27,0.11,1
4961,654,1000.00,18000.00,19000.00,0.00,12750.88,0.16,1
4962,654,1000.00,19000.00,20000.00,5577.77,13422.23,0.35,1
4963,654,-1000.00,18000.00,19000.00,12601.41,7398.59,0.13,0
4964,654,1000.00,19000.00,20000.00,1895.63,14410.40,0.41,1
4965,654,-1000.00,18000.00,19000.00,10008.43,9991.57,0.29,0
4966,654,1000.00,19000.00,20000.00,127.72,17334.21,0.42,1
4967,654,1000.00,20000.00,21000.00,0.00,20000.00,0.15,1
4968,654,-1000.00,19000.00,20000.00,13833.50,7166.50,0.23,0
4969,654,1000.00,20000.00,21000.00,9458.08,10541.92,0.24,1
4970,654,-1000.00,19000.00,20000.00,21000.00,0.00,0.02,0
4971,654,1000.00,20000.00,21000.00,7308.76,12691.24,0.35,1
4972,655,-1000.00,-1000.00,0.00,347.22,652.78,0.33,0
4973,656,-1000.00,-1000.00,0.00,0.00,1000.00,0.15,0
4974,657,-671.88,-671.88,328.12,671.88,0.00,0.01,0
4975,657,1000.00,328.12,1328.12,0.00,177.04,0.20,1
4976,657,1000.00,1328.12,2328.12,446.74,650.35,0.33,1
4977,657,1000.00,2328.12,3328.12,1058.30,1269.83,0.16,1
4978,657,1000.00,3328.12,4328.12,0.00,1716.00,0.30,1
4979,657,1000.00,4328.12,5328.12,558.40,781.74,0.24,1
4980,657,1000.00,5328.12,6328.12,1139.51,4188.61,0.31,1
4981,657,1000.00,6328.12,7328.12,1551.79,1939.12,0.25,1
4982,657,-1000.00,5328.12,6328.12,6859.52,0.00,0.03,0
4983,657,1000.00,6328.12,7328.12,1094.75,5233.37,0.44,1
4984,657,1000.00,7328.12,8328.12,0.00,5158.27,0.18,1
4985,657,1000.00,8328.12,9328.12,0.00,7410.04,0.38,1
4986,657,-1000.00,7328.12,8328.12,8650.61,677.52,0.00,0
4987,657,-1000.00,6328.12,7328.12,4204.77,4123.35,0.10,0
4988,657,1000.00,7328.12,8328.12,0.00,5667.40,0.25,1
4989,657,1000.00,8328.12,9328.12,4022.12,4306.01,0.31,1
4990,657,1000.00,9328.12,10328.12,2145.42,7182.70,0.44,1
4991,657,1000.00,10328.12,11328.12,0.00,3139.28,0.07,1
4992,657,1000.00,11328.12,12328.12,4271.65,7056.47,0.14,1
4993,657,1000.00,12328.12,13328.12,0.00,12328.12,0.26,1
4994,657,-1000.00,11328.12,12328.12,4288.72,0.00,0.03,0
4995,657,1000.00,12328.12,13328.12,4020.70,8307.42,0.33,1
4996,657,1000.00,13328.12,14328.12,6067.67,7260.45,0.30,1
4997,657,1000.00,14328.12,15328.12,0.00,14328.12,0.12,1
4998,657,1000.00,15328.12,16328.12,5789.35,9538.77,0.39,1
4999,657,1000.00,16328.12,17328.12,0.00,3626.80,0.15,1
5000,657,1000.00,17328.12,18328.12,2117.93,15210.19,0.08,1
5001,657,1000.00,18328.12,19328.12,1305.95,17022.18,0.36,1
5002,657,1000.00,19328.12,20328.12,0.00,19328.12,0.21,1
5003,657,1000.00,20328.12,21328.12,7025.43,13302.70,0.25,1
5004,657,-1000.00,19328.12,20328.12,21328.12,0.00,0.02,0
5005,657,1000.00,20328.12,21328.12,0.00,20328.12,0.02,1
5006,657,-1000.00,19328.12,20328.12,10908.76,10419.36,0.14,0
5007,657,1000.00,20328.12,21328.12,0.00,2916.34,0.12,1
5008,657,1000.00,21328.12,22328.12,28.59,13820.99,0.29,1
5009,657,1000.00,22328.12,23328.12,6740.77,15587.35,0.22,1
5010,657,-1000.00,21328.12,22328.12,0.00,11961.89,0.30,0
5011,657,-1000.00,20328.12,21328.12,0.00,4423.78,0.04,0
5012,657,-1000.00,19328.12,20328.12,13216.16,8111.96,0.30,0
5013,657,-1000.00,18328.12,19328.12,1841.48,16376.88,0.43,0
5014,657,-1000.00,17328.12,18328.12,10748.14,8579.99,0.16,0
5015,657,-1000.00,16328.12,17328.12,10211.23,3524.89,0.32,0
5016,657,-1000.00,15328.12,16328.12,4960.12,12368.01,0.34,0
5017,657,-1000.00,14328.12,15328.12,0.00,8398.08,0.31,0
5018,657,-1000.00,13328.12,14328.12,4036.93,11291.19,0.38,0
5019,657,-1000.00,12328.12,13328.12,0.00,13061.15,0.01,0
5020,657,1000.00,13328.12,14328.12,9218.16,0.00,0.21,1
5021,657,-742.59,12585.53,13585.53,0.00,742.59,0.12,0
5022,657,0.00,12585.53,13585.53,0.00,0.00,0.01,0
5023,657,-1000.00,11585.53,12585.53,0.00,13585.53,0.39,0
5024,657,-1000.00,10585.53,11585.53,4685.34,1004.91,0.17,0
5025,657,-1000.00,9585.53,10585.53,2236.12,9349.41,0.40,0
5026,657,-1000.00,8585.53,9585.53,2530.26,2103.55,0.21,0
5027,657,-1000.00,7585.53,8585.53,0.00,2026.17,0.05,0
5028,657,-1000.00,6585.53,7585.53,0.00,5790.05,0.35,0
5029,657,-1000.00,5585.53,6585.53,0.00,7585.53,0.13,0
5030,657,-1000.00,4585.53,5585.53,0.00,6585.53,0.10,0
5031,657,-1000.00,3585.53,4585.53,0.00,5585.53,0.30,0
5032,657,-1000.00,2585.53,3585.53,3121.28,1464.25,0.18,0
5033,657,-1000.00,1585.53,2585.53,503.20,3082.33,0.28,0
5034,657,-1000.00,585.53,1585.53,794.30,1791.23,0.03,0
5035,657,-1000.00,-414.47,585.53,913.36,672.16,0.15,0
5036,657,-238.73,-653.20,346.80,0.00,238.73,0.06,0
5037,657,-346.80,-1000.00,0.00,0.00,346.80,0.19,0
5038,658,-1000.00,-1000.00,0.00,653.13,346.87,0.16,0
5039,659,-1000.00,-1000.00,0.00,219.28,452.73,0.41,0
5040,660,1000.00,1000.00,2000.00,158.94,295.70,0.25,1
5041,660,1000.00,2000.00,3000.00,219.17,1477.33,0.42,1
5042,660,-1000.00,1000.00,2000.00,1175.36,831.35,0.39,0
5043,660,-1000.00,0.00,1000.00,1005.44,994.56,0.17,0
5044,660,-1000.00,-1000.00,0.00,609.66,390.34,0.33,0
5045,661,-992.88,-992.88,7.12,176.47,816.41,0.43,0
5046,661,-7.12,-1000.00,0.00,3.41,3.71,0.07,0
5047,662,-1000.00,-1000.00,0.00,477.91,522.09,0.10,0
5048,663,-1000.00,-1000.00,0.00,112.30,162.59,0.24,0
5049,664,-1000.00,-1000.00,0.00,657.12,342.88,0.12,0
5050,665,-613.55,-613.55,386.45,0.00,613.55,0.34,0
5051,665,-1000.00,-1613.55,-613.55,175.72,0.00,0.08,0
5052,666,-572.49,-572.49,427.51,70.00,502.49,0.32,0
5053,666,-385.93,-958.42,41.58,102.62,283.31,0.38,0
5054,666,-41.58,-1000.00,0.00,16.40,25.17,0.25,0
5055,667,-1000.00,-1000.00,0.00,106.63,893.37,0.38,0
5056,668,-645.44,-645.44,354.56,0.00,645.44,0.20,0
5057,668,-289.82,-935.26,64.74,0.00,289.82,0.42,0
5058,668,-64.74,-1000.00,0.00,27.48,37.27,0.43,0
5059,669,1000.00,1000.00,2000.00,423.33,576.67,0.27,1
5060,669,1000.00,2000.00,3000.00,0.00,513.99,0.17,1
5061,669,1000.00,3000.00,4000.00,303.98,666.56,0.21,1
5062,669,193.14,3193.14,4193.14,0.00,1.74,0.10,1
5063,669,1000.00,4193.14,5193.14,1964.51,2228.63,0.35,1
5064,669,1000.00,5193.14,6193.14,0.00,5193.14,0.29,1
5065,669,1000.00,6193.14,7193.14,0.00,6193.14,0.22,1
5066,669,-1000.00,5193.14,6193.14,2224.53,4968.60,0.26,0
5067,669,-1000.00,4193.14,5193.14,1887.13,4306.01,0.07,0
5068,669,-1000.00,3193.14,4193.14,0.00,772.60,0.38,0
5069,669,-1000.00,2193.14,3193.14,607.02,3586.11,0.31,0
5070,669,-1000.00,1193.14,2193.14,135.05,3058.08,0.15,0
5071,669,-1000.00,193.14,1193.14,0.00,113.70,0.17,0
5072,669,-1000.00,-806.86,193.14,0.00,1047.46,0.15,0
5073,669,-22.42,-829.29,170.71,22.42,0.00,0.25,0
5074,669,-111.11,-940.39,59.61,106.68,4.43,0.20,0
5075,669,-15.30,-955.69,44.31,15.30,0.00,0.32,0
5076,669,-1000.00,-1955.69,-955.69,0.00,3.00,0.30,0
5077,670,-1000.00,-1000.00,0.00,409.63,590.37,0.30,0
5078,671,-478.78,-478.78,521.22,423.11,55.67,0.19,0
5079,671,-1000.00,-1478.78,-478.78,135.53,385.68,0.21,0
5080,672,1000.00,1000.00,2000.00,239.77,760.23,0.20,1
5081,672,0.00,1000.00,2000.00,0.00,0.00,0.02,0
5082,672,1000.00,2000.00,3000.00,0.00,2000.00,0.07,1
5083,672,1000.00,3000.00,4000.00,1413.42,1586.58,0.24,1
5084,672,0.00,3000.00,4000.00,0.00,0.00,0.05,0
5085,672,1000.00,4000.00,5000.00,1953.94,2046.06,0.31,1
5086,672,1000.00,5000.00,6000.00,2390.49,2609.51,0.05,1
5087,672,1000.00,6000.00,7000.00,0.00,3976.56,0.12,1
5088,672,1000.00,7000.00,8000.00,982.75,6017.25,0.36,1
5089,672,-1000.00,6000.00,7000.00,3678.51,51.65,0.14,0
5090,672,1000.00,7000.00,8000.00,2825.37,3313.64,0.31,1
5091,672,1000.00,8000.00,9000.00,173.74,7826.26,0.39,1
5092,672,1000.00,9000.00,10000.00,3166.46,5833.54,0.44,1
5093,672,1000.00,10000.00,11000.00,0.00,5723.21,0.14,1
5094,672,1000.00,11000.00,12000.00,0.00,7100.50,0.25,1
5095,672,-1000.00,10000.00,11000.00,7946.30,4053.70,0.29,0
5096,672,1000.00,11000.00,12000.00,0.00,6505.05,0.24,1
5097,672,-1000.00,10000.00,11000.00,3273.66,2828.14,0.25,0
5098,672,1000.00,11000.00,12000.00,544.31,10114.25,0.40,1
5099,672,-1000.00,10000.00,11000.00,9024.94,2975.06,0.18,0
5100,672,1000.00,11000.00,12000.00,3280.94,7719.06,0.32,1
5101,672,1000.00,12000.00,13000.00,2591.12,9408.88,0.40,1
5102,672,1000.00,13000.00,14000.00,0.00,13000.00,0.33,1
5103,672,-1000.00,12000.00,13000.00,7160.82,6839.18,0.21,0
5104,672,1000.00,13000.00,14000.00,5916.52,7083.48,0.27,1
5105,672,-1000.00,12000.00,13000.00,7148.98,6851.02,0.01,0
5106,672,1000.00,13000.00,14000.00,3389.94,9610.06,0.43,1
5107,672,1000.00,14000.00,15000.00,0.00,7952.16,0.25,1
5108,672,-1000.00,13000.00,14000.00,10652.91,4347.09,0.10,0
5109,672,1000.00,14000.00,15000.00,5953.44,8046.56,0.28,1
5110,672,1000.00,15000.00,16000.00,1798.05,13201.95,0.35,1
5111,672,1000.00,16000.00,17000.00,0.00,16000.00,0.03,1
5112,672,1000.00,17000.00,18000.00,0.00,17000.00,0.12,1
5113,672,1000.00,18000.00,19000.00,5910.18,6462.53,0.30,1
5114,672,-1000.00,17000.00,18000.00,12241.94,6758.06,0.29,0
5115,672,-1000.00,16000.00,17000.00,11893.31,6106.69,0.04,0
5116,672,0.00,16000.00,17000.00,0.00,0.00,0.02,0
5117,672,-1000.00,15000.00,16000.00,9244.42,7755.58,0.22,0
5118,672,1000.00,16000.00,17000.00,0.00,12620.73,0.42,1
5119,672,1000.00,17000.00,18000.00,7456.26,9543.74,0.13,1
5120,672,1000.00,18000.00,19000.00,8882.57,9117.43,0.20,1
5121,672,0.00,18000.00,19000.00,0.00,0.00,0.02,0
5122,672,1000.00,19000.00,20000.00,8641.31,10358.69,0.25,1
5123,673,1000.00,1000.00,2000.00,0.00,1000.00,0.24,1
5124,673,-1000.00,0.00,1000.00,1397.08,602.92,0.13,0
5125,673,1000.00,1000.00,2000.00,500.00,500.00,0.09,1
5126,673,1000.00,2000.00,3000.00,1000.00,1000.00,0.03,1
5127,673,-1000.00,1000.00,2000.00,3000.00,0.00,0.02,0
5128,673,1000.00,2000.00,3000.00,1000.00,1000.00,0.15,1
5129,673,1000.00,3000.00,4000.00,0.00,837.38,0.19,1
5130,673,1000.00,4000.00,5000.00,0.00,3999.96,0.26,1
5131,673,1000.00,5000.00,6000.00,2360.95,2639.05,0.24,1
5132,673,-1000.00,4000.00,5000.00,3333.71,2666.29,0.29,0
5133,673,1000.00,5000.00,6000.00,0.00,4455.64,0.19,1
5134,673,1000.00,6000.00,7000.00,3000.00,3000.00,0.08,1
5135,673,-1000.00,5000.00,6000.00,3710.09,3289.91,0.33,0
5136,673,-1000.00,4000.00,5000.00,2657.32,0.00,0.10,0
5137,673,1000.00,5000.00,6000.00,0.00,5000.00,0.01,1
5138,673,1000.00,6000.00,7000.00,2985.15,3014.85,0.38,1
5139,673,1000.00,7000.00,8000.00,0.00,7000.00,0.16,1
5140,673,-1000.00,6000.00,7000.00,2070.85,0.00,0.10,0
5141,673,1000.00,7000.00,8000.00,0.00,6133.38,0.23,1
5142,673,-1000.00,6000.00,7000.00,2731.45,0.00,0.12,0
5143,673,-1000.00,5000.00,6000.00,2591.19,839.97,0.19,0
5144,673,-1000.00,4000.00,5000.00,29.98,5970.02,0.11,0
5145,673,-1000.00,3000.00,4000.00,0.00,5000.00,0.23,0
5146,673,-1000.00,2000.00,3000.00,749.93,3250.07,0.40,0
5147,673,-1000.00,1000.00,2000.00,1248.43,1751.57,0.33,0
5148,673,-1000.00,0.00,1000.00,1044.66,955.34,0.32,0
5149,673,-1000.00,-1000.00,0.00,491.14,508.86,0.08,0
5150,674,-1000.00,-1000.00,0.00,339.01,660.99,0.32,0
5151,675,1000.00,1000.00,2000.00,444.95,555.05,0.04,1
5152,675,1000.00,2000.00,3000.00,0.00,2000.00,0.13,1
5153,675,1000.00,3000.00,4000.00,1306.41,1693.59,0.35,1
5154,675,1000.00,4000.00,5000.00,0.00,2876.36,0.24,1
5155,675,1000.00,5000.00,6000.00,874.60,4125.40,0.26,1
5156,675,1000.00,6000.00,7000.00,1229.85,4770.15,0.37,1
5157,675,1000.00,7000.00,8000.00,0.00,7000.00,0.28,1
5158,675,1000.00,8000.00,9000.00,1495.49,6504.51,0.42,1
5159,675,1000.00,9000.00,10000.00,0.00,5461.69,0.30,1
5160,675,1000.00,10000.00,11000.00,1263.16,8736.84,0.39,1
5161,675,1000.00,11000.00,12000.00,2851.95,8148.05,0.39,1
5162,675,1000.00,12000.00,13000.00,359.62,6461.05,0.30,1
5163,675,1000.00,13000.00,14000.00,0.00,9798.70,0.06,1
5164,675,1000.00,14000.00,15000.00,5293.57,8706.43,0.15,1
5165,675,1000.00,15000.00,16000.00,3457.88,11542.12,0.41,1
5166,675,1000.00,16000.00,17000.00,2637.06,13362.94,0.26,1
5167,675,-1000.00,15000.00,16000.00,2302.67,270.50,0.11,0
5168,675,1000.00,16000.00,17000.00,4440.71,11559.29,0.40,1
5169,675,-1000.00,15000.00,16000.00,9689.55,7310.45,0.32,0
5170,675,-1000.00,14000.00,15000.00,5112.80,10887.20,0.44,0
5171,675,-1000.00,13000.00,14000.00,0.00,15000.00,0.14,0
5172,675,-1000.00,12000.00,13000.00,5242.04,8757.96,0.34,0
5173,675,-1000.00,11000.00,12000.00,7193.80,5806.20,0.03,0
5174,675,-1000.00,10000.00,11000.00,1962.80,10037.20,0.40,0
5175,675,-1000.00,9000.00,10000.00,2308.09,8691.91,0.04,0
5176,675,-1000.00,8000.00,9000.00,76.29,9531.38,0.43,0
5177,675,-1000.00,7000.00,8000.00,759.86,0.00,0.11,0
5178,675,-1000.00,6000.00,7000.00,1141.34,6858.66,0.36,0
5179,675,-1000.00,5000.00,6000.00,679.13,6320.87,0.03,0
5180,675,-1000.00,4000.00,5000.00,3871.32,2128.68,0.17,0
5181,675,-1000.00,3000.00,4000.00,1549.30,3450.70,0.12,0
5182,675,-1000.00,2000.00,3000.00,2325.27,1375.17,0.33,0
5183,675,-1000.00,1000.00,2000.00,274.80,1165.68,0.28,0
5184,675,-1000.00,0.00,1000.00,0.00,2000.00,0.29,0
5185,675,0.00,0.00,1000.00,0.00,0.00,0.04,0
5186,675,-1000.00,-1000.00,0.00,0.00,1000.00,0.17,0
5187,676,-1000.00,-1000.00,0.00,74.08,925.92,0.42,0
5188,677,-1000.00,-1000.00,0.00,355.62,644.38,0.36,0
5189,678,-1000.00,-1000.00,0.00,460.99,539.01,0.23,0
5190,679,-1000.00,-1000.00,0.00,438.16,561.84,0.26,0
5191,680,-1000.00,-1000.00,0.00,0.00,1000.00,0.07,0
5192,681,-1000.00,-1000.00,0.00,0.00,673.77,0.38,0
5193,682,1000.00,1000.00,2000.00,599.66,400.34,0.20,1
5194,682,1000.00,2000.00,3000.00,267.81,131.58,0.16,1
5195,682,-1000.00,1000.00,2000.00,669.76,1900.02,0.43,0
5196,682,-1000.00,0.00,1000.00,850.08,1149.92,0.22,0
5197,682,-165.20,-165.20,834.80,0.00,165.20,0.27,0
5198,682,-834.80,-1000.00,0.00,0.00,834.80,0.11,0
5199,683,-491.07,-491.07,508.93,0.00,491.07,0.16,0
5200,683,-1000.00,-1491.07,-491.07,278.36,230.56,0.03,0
5201,684,-1000.00,-1000.00,0.00,0.00,1000.00,0.05,0
5202,685,-1000.00,-1000.00,0.00,0.00,1000.00,0.04,0
5203,686,-1000.00,-1000.00,0.00,0.00,1000.00,0.10,0
5204,687,-1000.00,-1000.00,0.00,500.00,500.00,0.09,0
5205,688,-1000.00,-1000.00,0.00,13.62,986.38,0.38,0
5206,689,-1000.00,-1000.00,0.00,0.00,771.49,0.08,0
5207,690,-1000.00,-1000.00,0.00,281.00,719.00,0.40,0
5208,691,-1000.00,-1000.00,0.00,0.00,1000.00,0.11,0
5209,692,1000.00,1000.00,2000.00,311.93,372.78,0.26,1
5210,692,-1000.00,0.00,1000.00,1234.43,765.57,0.17,0
5211,692,1000.00,1000.00,2000.00,348.44,651.56,0.17,1
5212,692,1000.00,2000.00,3000.00,0.00,38.80,0.07,1
5213,692,1000.00,3000.00,4000.00,1457.40,1542.60,0.30,1
5214,692,1000.00,4000.00,5000.00,2000.00,2000.00,0.12,1
5215,692,-1000.00,3000.00,4000.00,2370.88,2629.12,0.31,0
5216,692,-1000.00,2000.00,3000.00,3906.93,0.00,0.06,0
5217,692,-1000.00,1000.00,2000.00,452.56,2547.44,0.31,0
5218,692,-1000.00,0.00,1000.00,0.00,2000.00,0.24,0
5219,692,-1000.00,-1000.00,0.00,0.00,493.65,0.30,0
5220,693,-1000.00,-1000.00,0.00,358.65,641.35,0.24,0
5221,694,0.00,0.00,1000.00,0.00,0.00,0.11,0
5222,694,-1000.00,-1000.00,0.00,91.22,908.78,0.44,0
5223,695,-1000.00,-1000.00,0.00,258.76,741.24,0.43,0
5224,696,-1000.00,-1000.00,0.00,0.00,1000.00,0.37,0
5225,697,-722.37,-722.37,277.63,0.00,722.37,0.38,0
5226,697,-277.63,-1000.00,0.00,104.98,172.64,0.18,0
5227,698,-1000.00,-1000.00,0.00,0.00,577.45,0.05,0
5228,699,-1000.00,-1000.00,0.00,522.64,477.36,0.03,0
5229,700,-1000.00,-1000.00,0.00,0.00,276.83,0.04,0
5230,701,1000.00,1000.00,2000.00,309.67,690.33,0.44,1
5231,701,-1000.00,0.00,1000.00,1294.06,705.94,0.24,0
5232,701,1000.00,1000.00,2000.00,445.59,554.41,0.35,1
5233,701,1000.00,2000.00,3000.00,34.61,1965.39,0.22,1
5234,701,1000.00,3000.00,4000.00,436.28,2563.72,0.16,1
5235,701,1000.00,4000.00,5000.00,1509.10,2490.90,0.23,1
5236,701,1000.00,5000.00,6000.00,1527.11,3472.89,0.19,1
5237,701,1000.00,6000.00,7000.00,3000.00,3000.00,0.11,1
5238,701,1000.00,7000.00,8000.00,2071.72,4928.28,0.37,1
5239,701,1000.00,8000.00,9000.00,2252.68,5747.32,0.38,1
5240,701,1000.00,9000.00,10000.00,4500.00,4500.00,0.22,1
5241,701,1000.00,10000.00,11000.00,2483.79,7516.21,0.42,1
5242,701,-1000.00,9000.00,10000.00,2784.46,0.00,0.07,0
5243,701,1000.00,10000.00,11000.00,3738.16,6261.84,0.33,1
5244,701,1000.00,11000.00,12000.00,3507.30,7492.70,0.37,1
5245,701,1000.00,12000.00,13000.00,0.00,12000.00,0.09,1
5246,701,1000.00,13000.00,14000.00,3852.08,9147.92,0.36,1
5247,701,1000.00,14000.00,15000.00,0.00,5412.95,0.03,1
5248,701,1000.00,15000.00,16000.00,0.00,5141.29,0.18,1
5249,701,1000.00,16000.00,17000.00,0.00,13343.00,0.32,1
5250,701,-1000.00,15000.00,16000.00,17000.00,0.00,0.04,0
5251,701,1000.00,16000.00,17000.00,8000.00,8000.00,0.27,1
5252,701,1000.00,17000.00,18000.00,0.00,17000.00,0.29,1
5253,701,-1000.00,16000.00,17000.00,11554.68,6445.32,0.03,0
5254,701,1000.00,17000.00,18000.00,4095.63,12904.37,0.39,1
5255,701,1000.00,18000.00,19000.00,9000.00,9000.00,0.08,1
5256,701,1000.00,19000.00,20000.00,5937.08,13062.92,0.26,1
5257,701,-1000.00,18000.00,19000.00,11370.07,8629.93,0.13,0
5258,701,1000.00,19000.00,20000.00,6632.90,12367.10,0.38,1
5259,701,1000.00,20000.00,21000.00,0.00,20000.00,0.00,1
5260,701,1000.00,21000.00,22000.00,6248.64,14751.36,0.13,1
5261,701,1000.00,22000.00,23000.00,11000.00,11000.00,0.18,1
5262,701,1000.00,23000.00,24000.00,11500.00,11500.00,0.06,1
5263,701,1000.00,24000.00,25000.00,0.00,11285.46,0.17,1
5264,701,1000.00,25000.00,26000.00,7965.16,8983.32,0.25,1
5265,701,1000.00,26000.00,27000.00,13000.00,13000.00,0.15,1
5266,701,1000.00,27000.00,28000.00,13500.00,13500.00,0.21,1
5267,701,1000.00,28000.00,29000.00,7550.85,20449.15,0.22,1
5268,701,1000.00,29000.00,30000.00,0.00,11021.91,0.20,1
5269,701,1000.00,30000.00,31000.00,5952.46,24047.54,0.25,1
5270,701,1000.00,31000.00,32000.00,2419.13,4914.82,0.12,1
5271,701,1000.00,32000.00,33000.00,0.00,32000.00,0.10,1
5272,701,1000.00,33000.00,34000.00,0.00,33000.00,0.02,1
5273,701,1000.00,34000.00,35000.00,2049.85,13304.07,0.28,1
5274,701,1000.00,35000.00,36000.00,0.00,35000.00,0.03,1
5275,702,-1000.00,-1000.00,0.00,482.11,517.89,0.06,0
5276,703,-1000.00,-1000.00,0.00,610.84,389.16,0.12,0
5277,704,1000.00,1000.00,2000.00,208.93,543.65,0.33,1
5278,704,-1000.00,0.00,1000.00,1090.70,909.30,0.08,0
5279,704,1000.00,1000.00,2000.00,474.57,525.43,0.11,1
5280,704,1000.00,2000.00,3000.00,910.69,1089.31,0.19,1
5281,704,1000.00,3000.00,4000.00,1234.80,1765.20,0.41,1
5282,704,1000.00,4000.00,5000.00,0.00,4000.00,0.15,1
5283,704,1000.00,5000.00,6000.00,2500.00,2500.00,0.02,1
5284,704,1000.00,6000.00,7000.00,0.00,3355.11,0.04,1
5285,704,1000.00,7000.00,8000.00,3500.00,3500.00,0.01,1
5286,704,1000.00,8000.00,9000.00,3338.43,4661.57,0.29,1
5287,704,-1000.00,7000.00,8000.00,5956.60,3043.40,0.24,0
5288,704,1000.00,8000.00,9000.00,4000.00,4000.00,0.05,1
5289,704,1000.00,9000.00,10000.00,3760.61,5239.39,0.36,1
5290,704,1000.00,10000.00,11000.00,0.00,1589.28,0.07,1
5291,704,-1000.00,9000.00,10000.00,7278.90,2946.20,0.18,0
5292,704,1000.00,10000.00,11000.00,2271.46,6997.03,0.35,1
5293,704,1000.00,11000.00,12000.00,0.00,11000.00,0.09,1
5294,704,1000.00,12000.00,13000.00,5335.22,6664.78,0.39,1
5295,704,1000.00,13000.00,14000.00,0.00,12104.21,0.32,1
5296,704,-1000.00,12000.00,13000.00,8634.01,5365.99,0.09,0
5297,704,-1000.00,11000.00,12000.00,10330.76,2669.24,0.17,0
5298,704,1000.00,12000.00,13000.00,5072.75,6927.25,0.31,1
5299,704,1000.00,13000.00,14000.00,0.00,543.43,0.00,1
5300,704,-1000.00,12000.00,13000.00,2913.02,473.88,0.12,0
5301,704,-1000.00,11000.00,12000.00,0.00,10472.10,0.34,0
5302,704,-1000.00,10000.00,11000.00,5459.63,6540.37,0.02,0
5303,704,-1000.00,9000.00,10000.00,2248.22,8751.78,0.44,0
5304,704,-1000.00,8000.00,9000.00,0.00,8887.76,0.29,0
5305,704,-1000.00,7000.00,8000.00,5835.52,3164.48,0.05,0
5306,704,-1000.00,6000.00,7000.00,3955.75,4044.25,0.14,0
5307,704,-1000.00,5000.00,6000.00,2857.78,4142.22,0.15,0
5308,704,-1000.00,4000.00,5000.00,2328.27,3671.73,0.28,0
5309,704,-1000.00,3000.00,4000.00,0.00,5000.00,0.20,0
5310,704,-1000.00,2000.00,3000.00,2000.00,2000.00,0.13,0
5311,704,-1000.00,1000.00,2000.00,1227.76,1772.24,0.28,0
5312,704,-1000.00,0.00,1000.00,739.69,1109.92,0.35,0
5313,704,-1000.00,-1000.00,0.00,0.00,1000.00,0.06,0
5314,705,-814.91,-814.91,185.09,0.00,814.91,0.12,0
5315,705,-185.09,-1000.00,0.00,0.00,185.09,0.02,0
5316,706,0.00,0.00,1000.00,0.00,0.00,0.07,0
5317,706,1000.00,1000.00,2000.00,461.50,538.50,0.29,1
5318,706,1000.00,2000.00,3000.00,285.45,1714.55,0.32,1
5319,706,1000.00,3000.00,4000.00,16.42,2983.58,0.05,1
5320,706,1000.00,4000.00,5000.00,1427.37,2572.63,0.24,1
5321,706,1000.00,5000.00,6000.00,0.00,5000.00,0.15,1
5322,706,1000.00,6000.00,7000.00,2583.71,2659.94,0.29,1
5323,706,1000.00,7000.00,8000.00,0.00,7000.00,0.02,1
5324,706,-1000.00,6000.00,7000.00,4411.54,2654.96,0.25,0
5325,706,1000.00,7000.00,8000.00,0.00,6424.66,0.29,1
5326,706,1000.00,8000.00,9000.00,0.00,8000.00,0.06,1
5327,706,1000.00,9000.00,10000.00,0.00,9000.00,0.13,1
5328,706,1000.00,10000.00,11000.00,556.46,9443.54,0.29,1
5329,706,1000.00,11000.00,12000.00,0.00,10643.93,0.42,1
5330,706,1000.00,12000.00,13000.00,3929.66,8070.34,0.25,1
5331,706,-1000.00,11000.00,12000.00,9908.45,3091.55,0.05,0
5332,706,-1000.00,10000.00,11000.00,0.00,8580.57,0.38,0
5333,706,-1000.00,9000.00,10000.00,2637.25,0.00,0.09,0
5334,706,-1000.00,8000.00,9000.00,0.00,3239.64,0.26,0
5335,706,-1000.00,7000.00,8000.00,7944.56,1055.44,0.06,0
5336,706,-1000.00,6000.00,7000.00,0.00,8000.00,0.10,0
5337,706,-1000.00,5000.00,6000.00,3934.86,3065.14,0.26,0
5338,706,-1000.00,4000.00,5000.00,0.00,6000.00,0.07,0
5339,706,-1000.00,3000.00,4000.00,2500.00,2500.00,0.13,0
5340,706,-1000.00,2000.00,3000.00,0.00,3251.72,0.13,0
5341,706,-1000.00,1000.00,2000.00,1526.88,1323.51,0.31,0
5342,706,0.00,1000.00,2000.00,0.00,0.00,0.12,0
5343,706,-1000.00,0.00,1000.00,0.00,1049.41,0.35,0
5344,706,-1000.00,-1000.00,0.00,500.00,500.00,0.07,0
5345,707,-1000.00,-1000.00,0.00,0.00,1000.00,0.19,0
5346,708,-1000.00,-1000.00,0.00,149.15,101.23,0.19,0
5347,709,-1000.00,-1000.00,0.00,500.00,500.00,0.06,0
5348,710,1000.00,1000.00,2000.00,0.00,1000.00,0.03,1
5349,710,1000.00,2000.00,3000.00,689.06,1310.94,0.11,1
5350,710,1000.00,3000.00,4000.00,1342.57,1657.43,0.25,1
5351,710,1000.00,4000.00,5000.00,1538.73,2461.27,0.36,1
5352,710,1000.00,5000.00,6000.00,0.00,3535.40,0.06,1
5353,710,1000.00,6000.00,7000.00,1973.91,4026.09,0.42,1
5354,710,1000.00,7000.00,8000.00,2795.25,4204.75,0.20,1
5355,710,1000.00,8000.00,9000.00,0.00,8000.00,0.19,1
5356,710,1000.00,9000.00,10000.00,0.00,9000.00,0.18,1
5357,710,1000.00,10000.00,11000.00,4765.64,5234.36,0.36,1
5358,710,1000.00,11000.00,12000.00,0.00,11000.00,0.05,1
5359,710,1000.00,12000.00,13000.00,0.00,10885.77,0.28,1
5360,710,-1000.00,11000.00,12000.00,6519.27,6480.73,0.18,0
5361,710,1000.00,12000.00,13000.00,2731.53,9268.47,0.40,1
5362,710,1000.00,13000.00,14000.00,3141.45,9858.55,0.44,1
5363,710,-936.40,12063.60,13063.60,936.40,0.00,0.09,0
5364,710,1000.00,13063.60,14063.60,0.00,8712.51,0.29,1
5365,710,-1000.00,12063.60,13063.60,9157.65,4905.95,0.23,0
5366,710,-1000.00,11063.60,12063.60,6144.48,2078.68,0.18,0
5367,710,-1000.00,10063.60,11063.60,0.00,831.22,0.26,0
5368,710,-1000.00,9063.60,10063.60,0.00,11063.60,0.07,0
5369,710,-1000.00,8063.60,9063.60,8994.53,0.00,0.11,0
5370,710,-1000.00,7063.60,8063.60,0.00,9063.60,0.24,0
5371,710,-1000.00,6063.60,7063.60,2291.63,792.56,0.41,0
5372,710,1000.00,7063.60,8063.60,2167.42,3265.65,0.29,1
5373,710,1000.00,8063.60,9063.60,169.91,7893.69,0.28,1
5374,710,1000.00,9063.60,10063.60,3671.42,5392.18,0.39,1
5375,710,1000.00,10063.60,11063.60,4777.32,5286.28,0.41,1
5376,710,-1000.00,9063.60,10063.60,4166.11,2577.36,0.21,0
5377,710,1000.00,10063.60,11063.60,0.00,10063.60,0.01,1
5378,710,-1000.00,9063.60,10063.60,6700.14,4363.46,0.26,0
5379,710,-1000.00,8063.60,9063.60,7067.06,2996.54,0.18,0
5380,710,-1000.00,7063.60,8063.60,1871.28,103.28,0.11,0
5381,710,-1000.00,6063.60,7063.60,4856.62,2020.66,0.21,0
5382,710,1000.00,7063.60,8063.60,0.00,7063.60,0.13,1
5383,710,-1000.00,6063.60,7063.60,5658.79,2404.81,0.08,0
5384,710,1000.00,7063.60,8063.60,1867.62,5195.98,0.26,1
5385,710,-1000.00,6063.60,7063.60,4036.23,4027.37,0.33,0
5386,710,-1000.00,5063.60,6063.60,4727.25,2336.35,0.20,0
5387,710,1000.00,6063.60,7063.60,2657.25,3406.35,0.17,1
5388,710,-1000.00,5063.60,6063.60,2410.05,373.83,0.16,0
5389,710,1000.00,6063.60,7063.60,0.00,6063.60,0.05,1
5390,710,1000.00,7063.60,8063.60,2304.61,4758.98,0.42,1
5391,710,1000.00,8063.60,9063.60,1281.66,6781.94,0.02,1
5392,710,-1000.00,7063.60,8063.60,5460.55,3603.05,0.30,0
5393,710,1000.00,8063.60,9063.60,0.00,2545.13,0.16,1
5394,710,-1000.00,7063.60,8063.60,6438.60,2624.99,0.16,0
5395,711,1000.00,1000.00,2000.00,0.00,44.76,0.11,1
5396,711,1000.00,2000.00,3000.00,307.10,1692.90,0.18,1
5397,711,1000.00,3000.00,4000.00,709.50,2290.50,0.43,1
5398,711,1000.00,4000.00,5000.00,2000.00,2000.00,0.04,1
5399,711,1000.00,5000.00,6000.00,0.00,1902.43,0.11,1
5400,711,1000.00,6000.00,7000.00,0.00,1469.47,0.09,1
5401,711,1000.00,7000.00,8000.00,0.00,2136.12,0.12,1
5402,711,1000.00,8000.00,9000.00,2217.28,4272.25,0.34,1
5403,711,1000.00,9000.00,10000.00,4500.00,4500.00,0.18,1
5404,711,1000.00,10000.00,11000.00,2580.87,7283.62,0.42,1
5405,711,1000.00,11000.00,12000.00,2489.94,7883.52,0.42,1
5406,711,1000.00,12000.00,13000.00,5993.24,6006.76,0.24,1
5407,711,1000.00,13000.00,14000.00,83.97,12408.09,0.42,1
5408,711,1000.00,14000.00,15000.00,0.00,3443.75,0.22,1
5409,711,1000.00,15000.00,16000.00,0.00,15000.00,0.21,1
5410,711,1000.00,16000.00,17000.00,8000.00,8000.00,0.18,1
5411,711,-1000.00,15000.00,16000.00,12142.42,4857.58,0.18,0
5412,711,1000.00,16000.00,17000.00,3438.99,9918.01,0.32,1
5413,711,1000.00,17000.00,18000.00,0.00,17000.00,0.09,1
5414,711,1000.00,18000.00,19000.00,9000.00,9000.00,0.11,1
5415,711,1000.00,19000.00,20000.00,1033.45,17966.55,0.07,1
5416,711,1000.00,20000.00,21000.00,0.00,20000.00,0.00,1
5417,711,-1000.00,19000.00,20000.00,3837.88,17162.12,0.22,0
5418,711,-1000.00,18000.00,19000.00,10467.50,9532.50,0.24,0
5419,711,-1000.00,17000.00,18000.00,13513.52,5486.48,0.19,0
5420,711,-1000.00,16000.00,17000.00,0.00,18000.00,0.26,0
5421,711,0.00,16000.00,17000.00,0.00,0.00,0.05,0
5422,711,-1000.00,15000.00,16000.00,8541.45,8458.55,0.36,0
5423,711,-1000.00,14000.00,15000.00,0.00,16000.00,0.13,0
5424,711,-1000.00,13000.00,14000.00,3980.32,0.00,0.07,0
5425,711,-1000.00,12000.00,13000.00,0.00,8864.96,0.34,0
5426,711,-1000.00,11000.00,12000.00,958.71,12041.29,0.43,0
5427,711,-1000.00,10000.00,11000.00,7837.93,4162.07,0.07,0
5428,711,-1000.00,9000.00,10000.00,4638.43,6361.57,0.26,0
5429,711,-1000.00,8000.00,9000.00,0.00,10000.00,0.22,0
5430,711,-1000.00,7000.00,8000.00,0.00,5572.31,0.01,0
5431,711,-1000.00,6000.00,7000.00,3927.59,4072.41,0.34,0
5432,711,-1000.00,5000.00,6000.00,0.00,6007.43,0.26,0
5433,711,-1000.00,4000.00,5000.00,3000.00,3000.00,0.01,0
5434,711,-1000.00,3000.00,4000.00,0.00,4878.01,0.22,0
5435,711,-1000.00,2000.00,3000.00,385.97,3084.88,0.42,0
5436,711,-1000.00,1000.00,2000.00,1152.87,1847.13,0.27,0
5437,711,-1000.00,0.00,1000.00,725.71,1274.29,0.39,0
5438,711,-1000.00,-1000.00,0.00,500.00,500.00,0.18,0
5439,712,-401.25,-401.25,598.75,248.19,153.06,0.23,0
5440,712,-1000.00,-1401.25,-401.25,222.56,376.18,0.31,0
5441,713,-1000.00,-1000.00,0.00,0.00,1000.00,0.20,0
5442,714,-1000.00,-1000.00,0.00,500.00,500.00,0.08,0
5443,715,-771.01,-771.01,228.99,0.00,771.01,0.36,0
5444,715,-21.39,-792.40,207.60,0.00,21.39,0.07,0
5445,715,1000.00,207.60,1207.60,112.03,16.55,0.19,1
5446,715,-1000.00,-792.40,207.60,603.80,603.80,0.05,0
5447,715,-111.35,-903.76,96.24,22.40,88.95,0.32,0
5448,715,-96.24,-1000.00,0.00,0.00,96.24,0.06,0
5449,716,-355.91,-355.91,644.09,355.91,0.00,0.08,0
5450,716,1000.00,644.09,1644.09,34.99,271.21,0.30,1
5451,716,1000.00,1644.09,2644.09,0.00,1644.09,0.20,1
5452,716,1000.00,2644.09,3644.09,385.66,2258.43,0.05,1
5453,716,1000.00,3644.09,4644.09,1735.36,1908.73,0.29,1
5454,716,1000.00,4644.09,5644.09,967.24,1777.34,0.41,1
5455,716,-1000.00,3644.09,4644.09,3879.38,1764.71,0.12,0
5456,716,-1000.00,2644.09,3644.09,2062.29,310.49,0.25,0
5457,716,1000.00,3644.09,4644.09,1251.51,2392.58,0.13,1
5458,716,1000.00,4644.09,5644.09,1386.76,3257.33,0.09,1
5459,716,1000.00,5644.09,6644.09,1081.48,4562.62,0.41,1
5460,716,-1000.00,4644.09,5644.09,3460.06,3184.03,0.01,0
5461,716,-1000.00,3644.09,4644.09,4337.33,0.00,0.14,0
5462,716,1000.00,4644.09,5644.09,547.12,4096.97,0.24,1
5463,716,-1000.00,3644.09,4644.09,5644.09,0.00,0.09,0
5464,716,1000.00,4644.09,5644.09,1357.30,3286.79,0.26,1
5465,716,1000.00,5644.09,6644.09,737.22,2099.81,0.37,1
5466,716,1000.00,6644.09,7644.09,556.95,4756.46,0.43,1
5467,716,1000.00,7644.09,8644.09,3616.09,4028.00,0.32,1
5468,716,-1000.00,6644.09,7644.09,0.00,4371.96,0.02,0
5469,716,-1000.00,5644.09,6644.09,0.00,7644.09,0.11,0
5470,716,-1000.00,4644.09,5644.09,2605.59,4038.50,0.34,0
5471,716,-1000.00,3644.09,4644.09,0.00,1166.34,0.33,0
5472,716,-1000.00,2644.09,3644.09,1875.17,2768.92,0.16,0
5473,716,-1000.00,1644.09,2644.09,709.47,2934.62,0.36,0
5474,716,-576.84,1067.25,2067.25,576.84,0.00,0.16,0
5475,716,-1000.00,67.25,1067.25,0.00,1748.36,0.29,0
5476,716,-1000.00,-932.75,67.25,654.88,412.38,0.12,0
5477,716,-1000.00,-1932.75,-932.75,0.00,60.75,0.41,0
5478,717,-921.92,-921.92,78.08,0.00,921.92,0.37,0
5479,717,-1000.00,-1921.92,-921.92,43.77,34.32,0.21,0
5480,718,-657.21,-657.21,342.79,0.00,657.21,0.37,0
5481,718,-197.05,-854.26,145.74,60.18,136.86,0.31,0
5482,718,-145.74,-1000.00,0.00,0.00,145.74,0.22,0
5483,719,-996.93,-996.93,3.07,97.22,899.71,0.41,0
5484,719,-3.07,-1000.00,0.00,1.36,1.71,0.36,0
5485,720,-1000.00,-1000.00,0.00,27.19,637.85,0.40,0
5486,721,-1000.00,-1000.00,0.00,1000.00,0.00,0.03,0
5487,722,-716.88,-716.88,283.12,0.00,716.88,0.39,0
5488,722,-169.98,-886.86,113.14,0.00,169.98,0.37,0
5489,722,-1000.00,-1886.86,-886.86,76.83,36.31,0.03,0
5490,723,-1000.00,-1000.00,0.00,0.00,553.83,0.40,0
5491,724,-757.19,-757.19,242.81,36.66,720.53,0.44,0
5492,724,-124.60,-881.78,118.22,0.00,124.60,0.36,0
5493,724,-118.22,-1000.00,-0.00,29.56,88.66,0.15,0
5494,725,-1000.00,-1000.00,0.00,0.00,1000.00,0.05,0
5495,726,-1000.00,-1000.00,0.00,85.09,914.91,0.27,0
5496,727,1000.00,1000.00,2000.00,0.00,1000.00,0.21,1
5497,727,1000.00,2000.00,3000.00,0.00,2000.00,0.00,1
5498,727,1000.00,3000.00,4000.00,1476.74,1523.26,0.30,1
5499,727,-1000.00,2000.00,3000.00,4000.00,0.00,0.02,0
5500,727,1000.00,3000.00,4000.00,0.00,192.26,0.19,1
5501,727,1000.00,4000.00,5000.00,1905.54,2094.46,0.27,1
5502,727,1000.00,5000.00,6000.00,0.00,3936.94,0.35,1
5503,727,-1000.00,4000.00,5000.00,5730.04,269.96,0.07,0
5504,727,1000.00,5000.00,6000.00,0.00,2021.42,0.03,1
5505,727,1000.00,6000.00,7000.00,2274.96,3725.04,0.36,1
5506,727,1000.00,7000.00,8000.00,0.00,3481.11,0.21,1
5507,727,1000.00,8000.00,9000.00,3460.33,4539.67,0.14,1
5508,727,-1000.00,7000.00,8000.00,3784.08,5215.92,0.36,0
5509,727,-1000.00,6000.00,7000.00,4330.95,1305.82,0.21,0
5510,727,-1000.00,5000.00,6000.00,5406.01,0.00,0.13,0
5511,727,-1000.00,4000.00,5000.00,0.00,3209.66,0.28,0
5512,727,-1000.00,3000.00,4000.00,0.00,3511.41,0.35,0
5513,727,-1000.00,2000.00,3000.00,1300.44,2699.56,0.33,0
5514,727,-1000.00,1000.00,2000.00,3000.00,0.00,0.02,0
5515,727,-1000.00,0.00,1000.00,1000.00,1000.00,0.03,0
5516,727,-1000.00,-1000.00,0.00,93.63,439.85,0.43,0
5517,728,-1000.00,-1000.00,0.00,0.00,1000.00,0.19,0
5518,729,-1000.00,-1000.00,0.00,0.00,840.16,0.40,0
5519,730,-614.61,-614.61,385.39,72.45,542.16,0.34,0
5520,730,-385.39,-1000.00,0.00,59.30,326.08,0.16,0
5521,731,1000.00,1000.00,2000.00,199.52,0.00,0.12,1
5522,731,-610.47,389.53,1389.53,0.00,610.47,0.30,0
5523,731,1000.00,1389.53,2389.53,48.48,0.00,0.20,1
5524,731,-1000.00,389.53,1389.53,450.90,941.34,0.40,0
5525,731,1000.00,1389.53,2389.53,743.59,645.93,0.25,1
5526,731,-1000.00,389.53,1389.53,728.19,1661.34,0.40,0
5527,731,-1000.00,-610.47,389.53,615.93,773.59,0.07,0
5528,731,-51.41,-661.88,338.12,0.00,51.41,0.05,0
5529,731,-92.25,-754.13,245.87,0.00,92.25,0.40,0
5530,731,-245.87,-1000.00,0.00,0.00,245.87,0.35,0
5531,732,-1000.00,-1000.00,0.00,500.00,500.00,0.02,0
5532,733,-1000.00,-1000.00,0.00,376.88,623.12,0.35,0
5533,733,-0.00,-1000.00,0.00,0.00,0.00,0.17,0
5534,734,-1000.00,-1000.00,0.00,0.00,1000.00,0.28,0
5535,735,1000.00,1000.00,2000.00,0.00,761.55,0.10,1
5536,735,1000.00,2000.00,3000.00,1000.00,1000.00,0.06,1
5537,735,1000.00,3000.00,4000.00,1465.45,1534.55,0.14,1
5538,735,1000.00,4000.00,5000.00,1661.09,2338.91,0.14,1
5539,735,1000.00,5000.00,6000.00,0.00,4536.91,0.32,1
5540,735,1000.00,6000.00,7000.00,591.05,5408.95,0.15,1
5541,735,1000.00,7000.00,8000.00,0.00,2064.25,0.17,1
5542,735,1000.00,8000.00,9000.00,0.00,8000.00,0.15,1
5543,735,1000.00,9000.00,10000.00,755.99,8244.01,0.33,1
5544,735,-1000.00,8000.00,9000.00,5181.83,4818.17,0.34,0
5545,735,1000.00,9000.00,10000.00,0.00,7467.81,0.35,1
5546,735,-1000.00,8000.00,9000.00,7479.17,2520.83,0.11,0
5547,735,-1000.00,7000.00,8000.00,0.00,9000.00,0.06,0
5548,735,-1000.00,6000.00,7000.00,0.00,6920.61,0.14,0
5549,735,-1000.00,5000.00,6000.00,728.12,6271.88,0.31,0
5550,735,-1000.00,4000.00,5000.00,3449.90,2550.10,0.31,0
5551,735,-1000.00,3000.00,4000.00,4579.10,333.26,0.08,0
5552,735,-1000.00,2000.00,3000.00,2550.60,0.00,0.06,0
5553,735,-1000.00,1000.00,2000.00,1468.85,1347.78,0.33,0
5554,735,-1000.00,0.00,1000.00,0.00,1178.31,0.35,0
5555,735,-1000.00,-1000.00,0.00,14.17,985.83,0.26,0
5556,736,-554.88,-554.88,445.12,0.00,554.88,0.26,0
5557,736,-445.12,-1000.00,0.00,0.00,445.12,0.25,0
5558,737,1000.00,1000.00,2000.00,87.72,912.28,0.18,1
5559,737,1000.00,2000.00,3000.00,0.00,1740.77,0.39,1
5560,737,1000.00,3000.00,4000.00,1009.00,1522.82,0.33,1
5561,737,1000.00,4000.00,5000.00,0.00,3669.90,0.00,1
5562,737,-1000.00,3000.00,4000.00,2733.97,1894.20,0.26,0
5563,737,-1000.00,2000.00,3000.00,2011.97,1988.03,0.12,0
5564,737,1000.00,3000.00,4000.00,0.00,3000.00,0.01,1
5565,737,1000.00,4000.00,5000.00,1595.11,2404.89,0.37,1
5566,737,1000.00,5000.00,6000.00,0.00,3197.80,0.26,1
5567,737,1000.00,6000.00,7000.00,780.06,5219.94,0.39,1
5568,737,-1000.00,5000.00,6000.00,4414.92,2585.08,0.06,0
5569,737,1000.00,6000.00,7000.00,0.00,6000.00,0.08,1
5570,737,1000.00,7000.00,8000.00,0.00,7000.00,0.01,1
5571,737,-1000.00,6000.00,7000.00,4150.25,3849.75,0.09,0
5572,737,1000.00,7000.00,8000.00,0.00,7000.00,0.01,1
5573,737,1000.00,8000.00,9000.00,1919.58,6080.42,0.43,1
5574,737,1000.00,9000.00,10000.00,0.00,710.48,0.17,1
5575,737,1000.00,10000.00,11000.00,0.00,8818.43,0.42,1
5576,737,-1000.00,9000.00,10000.00,5808.13,5191.87,0.03,0
5577,737,1000.00,10000.00,11000.00,709.41,9290.59,0.37,1
5578,737,1000.00,11000.00,12000.00,148.13,10851.87,0.13,1
5579,737,1000.00,12000.00,13000.00,123.41,11876.59,0.13,1
5580,737,-1000.00,11000.00,12000.00,6500.00,6500.00,0.09,0
5581,737,-1000.00,10000.00,11000.00,0.00,12000.00,0.20,0
5582,737,-1000.00,9000.00,10000.00,2509.83,8490.17,0.03,0
5583,737,-1000.00,8000.00,9000.00,3368.14,6631.86,0.29,0
5584,737,-1000.00,7000.00,8000.00,4058.89,4011.89,0.30,0
5585,737,-1000.00,6000.00,7000.00,0.00,8000.00,0.10,0
5586,737,-1000.00,5000.00,6000.00,0.00,7000.00,0.01,0
5587,737,-1000.00,4000.00,5000.00,0.00,6000.00,0.27,0
5588,737,-1000.00,3000.00,4000.00,0.00,3842.92,0.26,0
5589,737,-855.04,2144.96,3144.96,0.00,855.04,0.08,0
5590,737,-1000.00,1144.96,2144.96,0.00,3129.78,0.10,0
5591,737,-1000.00,144.96,1144.96,0.00,2042.80,0.32,0
5592,737,-1000.00,-855.04,144.96,544.70,600.26,0.23,0
5593,737,-144.96,-1000.00,0.00,32.73,112.23,0.40,0
5594,738,-1000.00,-1000.00,0.00,329.91,670.09,0.37,0
5595,739,1000.00,1000.00,2000.00,243.81,756.19,0.41,1
5596,739,-1000.00,0.00,1000.00,1224.97,775.03,0.06,0
5597,739,1000.00,1000.00,2000.00,0.00,1000.00,0.05,1
5598,739,1000.00,2000.00,3000.00,514.97,1485.03,0.37,1
5599,739,-1000.00,1000.00,2000.00,1544.46,1455.54,0.25,0
5600,739,1000.00,2000.00,3000.00,183.50,808.79,0.28,1
5601,739,1000.00,3000.00,4000.00,0.00,107.02,0.12,1
5602,739,1000.00,4000.00,5000.00,0.00,4000.00,0.10,1
5603,739,-1000.00,3000.00,4000.00,1948.69,0.00,0.16,0
5604,739,1000.00,4000.00,5000.00,1881.22,2118.78,0.24,1
5605,739,1000.00,5000.00,6000.00,1074.68,3925.32,0.28,1
5606,739,1000.00,6000.00,7000.00,0.00,6000.00,0.20,1
5607,739,1000.00,7000.00,8000.00,0.00,7000.00,0.17,1
5608,739,1000.00,8000.00,9000.00,0.00,8000.00,0.30,1
5609,739,1000.00,9000.00,10000.00,565.84,8434.16,0.40,1
5610,739,1000.00,10000.00,11000.00,0.00,10000.00,0.39,1
5611,739,1000.00,11000.00,12000.00,2154.40,6048.74,0.37,1
5612,739,-1000.00,10000.00,11000.00,9469.84,2530.16,0.12,0
5613,739,1000.00,11000.00,12000.00,1391.94,9608.06,0.33,1
5614,739,-1000.00,10000.00,11000.00,0.00,2332.87,0.22,0
5615,739,-1000.00,9000.00,10000.00,4869.73,6130.27,0.22,0
5616,739,-1000.00,8000.00,9000.00,0.00,10000.00,0.07,0
5617,739,-1000.00,7000.00,8000.00,3342.12,5657.88,0.36,0
5618,739,-1000.00,6000.00,7000.00,0.00,7229.58,0.28,0
5619,739,-1000.00,5000.00,6000.00,0.00,5795.64,0.31,0
5620,739,-1000.00,4000.00,5000.00,3838.69,2161.31,0.17,0
5621,739,-1000.00,3000.00,4000.00,0.00,5000.00,0.22,0
5622,739,-1000.00,2000.00,3000.00,0.00,4000.00,0.14,0
5623,739,-1000.00,1000.00,2000.00,1162.72,1837.28,0.13,0
5624,739,-1000.00,0.00,1000.00,10.98,0.00,0.09,0
5625,739,-1000.00,-1000.00,0.00,441.00,559.00,0.19,0
5626,740,-771.25,-771.25,228.75,0.00,771.25,0.37,0
5627,740,-228.75,-1000.00,0.00,10.64,218.11,0.44,0
5628,741,-1000.00,-1000.00,0.00,137.01,862.99,0.27,0
5629,741,-0.00,-1000.00,0.00,0.00,0.00,0.33,0
5630,742,-1000.00,-1000.00,0.00,0.00,1000.00,0.19,0
5631,743,-617.93,-617.93,382.07,252.47,365.46,0.27,0
5632,743,-382.07,-1000.00,0.00,99.26,282.81,0.41,0
5633,744,-776.35,-776.35,223.65,776.35,0.00,0.04,0
5634,744,-1000.00,-1776.35,-776.35,0.00,95.27,0.30,0
5635,745,1000.00,1000.00,2000.00,180.28,755.27,0.42,1
5636,745,1000.00,2000.00,3000.00,0.00,926.35,0.03,1
5637,745,1000.00,3000.00,4000.00,764.43,2235.57,0.37,1
5638,745,1000.00,4000.00,5000.00,1432.00,2568.00,0.20,1
5639,745,1000.00,5000.00,6000.00,204.28,3278.94,0.40,1
5640,745,-1000.00,4000.00,5000.00,1922.64,1884.74,0.27,0
5641,745,1000.00,5000.00,6000.00,2471.37,2528.63,0.22,1
5642,745,1000.00,6000.00,7000.00,1763.89,4236.11,0.43,1
5643,745,0.00,6000.00,7000.00,0.00,0.00,0.09,0
5644,745,-1000.00,5000.00,6000.00,3787.56,3212.44,0.15,0
5645,745,1000.00,6000.00,7000.00,0.00,6000.00,0.14,1
5646,745,1000.00,7000.00,8000.00,2492.64,4507.36,0.15,1
5647,745,-1000.00,6000.00,7000.00,4558.29,3441.71,0.12,0
5648,745,1000.00,7000.00,8000.00,0.00,7000.00,0.01,1
5649,745,1000.00,8000.00,9000.00,2617.80,5382.20,0.41,1
5650,745,1000.00,9000.00,10000.00,2883.07,6116.93,0.40,1
5651,745,1000.00,10000.00,11000.00,2582.40,7417.60,0.30,1
5652,745,1000.00,11000.00,12000.00,1455.82,9544.18,0.32,1
5653,745,-1000.00,10000.00,11000.00,8288.52,3711.48,0.10,0
5654,745,-1000.00,9000.00,10000.00,7731.57,3268.43,0.22,0
5655,745,1000.00,10000.00,11000.00,0.00,10000.00,0.23,1
5656,745,1000.00,11000.00,12000.00,3837.80,7162.20,0.26,1
5657,745,-1000.00,10000.00,11000.00,6546.47,5453.53,0.10,0
5658,745,1000.00,11000.00,12000.00,3526.80,7473.20,0.33,1
5659,745,1000.00,12000.00,13000.00,2969.59,9030.41,0.35,1
5660,745,1000.00,13000.00,14000.00,0.00,3989.78,0.20,1
5661,745,1000.00,14000.00,15000.00,1567.72,11598.46,0.40,1
5662,745,1000.00,15000.00,16000.00,0.00,5973.83,0.13,1
5663,745,1000.00,16000.00,17000.00,5993.27,7509.68,0.33,1
5664,745,1000.00,17000.00,18000.00,0.00,15800.45,0.24,1
5665,745,1000.00,18000.00,19000.00,0.00,18000.00,0.26,1
5666,745,1000.00,19000.00,20000.00,0.00,12233.99,0.23,1
5667,745,1000.00,20000.00,21000.00,0.00,20000.00,0.02,1
5668,745,1000.00,21000.00,22000.00,2514.43,18485.57,0.09,1
5669,745,1000.00,22000.00,23000.00,0.00,14708.54,0.09,1
5670,745,1000.00,23000.00,24000.00,11500.00,11500.00,0.12,1
5671,745,-1000.00,22000.00,23000.00,3302.93,2936.94,0.23,0
5672,745,1000.00,23000.00,24000.00,7444.61,15555.39,0.25,1
5673,746,1000.00,1000.00,2000.00,0.00,715.01,0.31,1
5674,746,-1000.00,0.00,1000.00,1237.05,762.95,0.17,0
5675,746,1000.00,1000.00,2000.00,0.00,1000.00,0.35,1
5676,746,1000.00,2000.00,3000.00,0.00,1224.59,0.13,1
5677,746,1000.00,3000.00,4000.00,0.00,2184.25,0.36,1
5678,746,1000.00,4000.00,5000.00,0.00,4000.00,0.28,1
5679,746,1000.00,5000.00,6000.00,1616.24,3383.76,0.43,1
5680,746,1000.00,6000.00,7000.00,0.00,1867.60,0.18,1
5681,746,-1000.00,5000.00,6000.00,3618.02,3381.98,0.34,0
5682,746,1000.00,6000.00,7000.00,0.00,6000.00,0.29,1
5683,746,1000.00,7000.00,8000.00,0.00,7000.00,0.08,1
5684,746,1000.00,8000.00,9000.00,0.00,8000.00,0.35,1
5685,746,1000.00,9000.00,10000.00,2581.31,2826.33,0.40,1
5686,746,1000.00,10000.00,11000.00,5000.00,5000.00,0.06,1
5687,746,1000.00,11000.00,12000.00,0.00,8389.36,0.26,1
5688,746,1000.00,12000.00,13000.00,0.00,1526.28,0.13,1
5689,746,1000.00,13000.00,14000.00,6428.09,6571.91,0.25,1
5690,746,1000.00,14000.00,15000.00,1506.40,9088.58,0.39,1
5691,746,-1000.00,13000.00,14000.00,740.53,9494.17,0.38,0
5692,746,-1000.00,12000.00,13000.00,4224.20,9775.80,0.29,0
5693,746,0.00,12000.00,13000.00,0.00,0.00,0.16,0
5694,746,-1000.00,11000.00,12000.00,0.00,10708.60,0.42,0
5695,746,-1000.00,10000.00,11000.00,1644.56,10355.44,0.37,0
5696,746,-1000.00,9000.00,10000.00,3454.71,7545.29,0.43,0
5697,746,-1000.00,8000.00,9000.00,642.30,5033.58,0.32,0
5698,746,-1000.00,7000.00,8000.00,60.63,7759.15,0.42,0
5699,746,-1000.00,6000.00,7000.00,0.00,7884.80,0.32,0
5700,746,-1000.00,5000.00,6000.00,1839.53,5160.47,0.32,0
5701,746,-1000.00,4000.00,5000.00,0.00,5065.61,0.17,0
5702,746,-1000.00,3000.00,4000.00,764.42,4235.58,0.05,0
5703,746,-1000.00,2000.00,3000.00,0.00,4000.00,0.04,0
5704,746,-1000.00,1000.00,2000.00,906.65,1585.16,0.34,0
5705,746,-1000.00,0.00,1000.00,0.00,1910.99,0.30,0
5706,746,-1000.00,-1000.00,0.00,392.99,607.01,0.23,0
5707,747,1000.00,1000.00,2000.00,0.00,372.30,0.02,1
5708,747,1000.00,2000.00,3000.00,0.00,2000.00,0.32,1
5709,747,-1000.00,1000.00,2000.00,2198.04,801.96,0.12,0
5710,747,1000.00,2000.00,3000.00,0.00,1548.21,0.27,1
5711,747,1000.00,3000.00,4000.00,0.00,3000.00,0.21,1
5712,747,-1000.00,2000.00,3000.00,994.78,256.65,0.14,0
5713,747,1000.00,3000.00,4000.00,1201.73,1798.27,0.36,1
5714,747,-1000.00,2000.00,3000.00,1579.78,0.00,0.08,0
5715,747,1000.00,3000.00,4000.00,973.75,2026.25,0.42,1
5716,747,-685.16,2314.84,3314.84,685.16,0.00,0.09,0
5717,747,-1000.00,1314.84,2314.84,2375.07,939.77,0.19,0
5718,747,1000.00,2314.84,3314.84,0.00,2314.84,0.22,1
5719,747,1000.00,3314.84,4314.84,1260.21,2054.63,0.40,1
5720,747,1000.00,4314.84,5314.84,0.00,4314.84,0.33,1
5721,747,1000.00,5314.84,6314.84,0.00,5314.84,0.11,1
5722,747,1000.00,6314.84,7314.84,3157.42,3157.42,0.10,1
5723,747,1000.00,7314.84,8314.84,0.00,7314.84,0.05,1
5724,747,1000.00,8314.84,9314.84,4157.42,4157.42,0.08,1
5725,747,1000.00,9314.84,10314.84,4479.02,4835.82,0.28,1
5726,747,1000.00,10314.84,11314.84,3474.81,6840.03,0.20,1
5727,747,1000.00,11314.84,12314.84,5657.42,5657.42,0.02,1
5728,747,1000.00,12314.84,13314.84,6157.42,6157.42,0.02,1
5729,747,-1000.00,11314.84,12314.84,6690.12,6624.72,0.25,0
5730,747,1000.00,12314.84,13314.84,6157.42,6157.42,0.11,1
5731,747,-1000.00,11314.84,12314.84,1744.93,0.00,0.03,0
5732,747,0.00,11314.84,12314.84,0.00,0.00,0.04,0
5733,747,1000.00,12314.84,13314.84,4936.85,7377.99,0.35,1
5734,747,1000.00,13314.84,14314.84,5181.58,8133.26,0.30,1
5735,747,1000.00,14314.84,15314.84,4406.75,9908.10,0.43,1
5736,747,1000.00,15314.84,16314.84,5058.35,10256.49,0.41,1
5737,747,1000.00,16314.84,17314.84,3042.72,13272.12,0.35,1
5738,747,1000.00,17314.84,18314.84,0.00,17314.84,0.27,1
5739,747,1000.00,18314.84,19314.84,7427.93,10886.91,0.25,1
5740,747,-1000.00,17314.84,18314.84,10490.94,8823.91,0.21,0
5741,747,-1000.00,16314.84,17314.84,9238.27,9076.58,0.37,0
5742,747,1000.00,17314.84,18314.84,977.17,7844.18,0.38,1
5743,747,0.00,17314.84,18314.84,0.00,0.00,0.11,0
5744,747,1000.00,18314.84,19314.84,0.00,8491.53,0.36,1
5745,747,1000.00,19314.84,20314.84,8369.19,10945.65,0.35,1
5746,747,1000.00,20314.84,21314.84,9554.68,10760.16,0.38,1
5747,747,1000.00,21314.84,22314.84,7596.68,12184.50,0.39,1
5748,747,1000.00,22314.84,23314.84,2687.02,19627.82,0.44,1
5749,747,-1000.00,21314.84,22314.84,17182.88,6131.96,0.19,0
5750,748,-1000.00,-1000.00,0.00,500.00,500.00,0.10,0
5751,749,-1000.00,-1000.00,0.00,465.18,534.82,0.15,0
5752,750,-1000.00,-1000.00,0.00,500.00,500.00,0.04,0
5753,751,-1000.00,-1000.00,0.00,359.62,640.38,0.10,0
5754,752,-1000.00,-1000.00,0.00,0.00,775.84,0.40,0
5755,753,-1000.00,-1000.00,0.00,0.00,1000.00,0.32,0
5756,754,-885.27,-885.27,114.73,0.00,885.27,0.42,0
5757,754,-1000.00,-1885.27,-885.27,65.34,49.39,0.17,0
5758,755,-1000.00,-1000.00,0.00,0.00,1000.00,0.29,0
5759,756,-1000.00,-1000.00,0.00,0.00,1000.00,0.12,0
5760,757,-715.61,-715.61,284.39,0.00,715.61,0.38,0
5761,757,-284.39,-1000.00,0.00,0.00,284.39,0.17,0
5762,758,-277.47,-277.47,722.53,277.47,0.00,0.11,0
5763,758,-1000.00,-1277.47,-277.47,156.42,566.11,0.02,0
5764,759,-884.96,-884.96,115.04,91.71,793.26,0.37,0
5765,759,-1000.00,-1884.96,-884.96,58.79,56.25,0.31,0
5766,760,-1000.00,-1000.00,0.00,836.54,0.00,0.03,0
5767,761,-1000.00,-1000.00,0.00,385.81,614.19,0.17,0
5768,762,1000.00,1000.00,2000.00,71.99,928.01,0.10,1
5769,762,1000.00,2000.00,3000.00,0.00,1613.77,0.37,1
5770,762,1000.00,3000.00,4000.00,1451.58,1548.42,0.18,1
5771,762,1000.00,4000.00,5000.00,1513.29,2486.71,0.44,1
5772,762,1000.00,5000.00,6000.00,1664.57,3335.43,0.19,1
5773,762,-1000.00,4000.00,5000.00,1456.37,0.00,0.08,0
5774,762,1000.00,5000.00,6000.00,132.71,4867.29,0.08,1
5775,762,1000.00,6000.00,7000.00,2416.85,3583.15,0.38,1
5776,762,-1000.00,5000.00,6000.00,3588.72,0.00,0.04,0
5777,762,1000.00,6000.00,7000.00,2885.78,3114.22,0.34,1
5778,762,-1000.00,5000.00,6000.00,5555.58,0.00,0.02,0
5779,762,-1000.00,4000.00,5000.00,4774.94,1225.06,0.00,0
5780,762,1000.00,5000.00,6000.00,2033.57,2966.43,0.21,1
5781,762,1000.00,6000.00,7000.00,0.00,6000.00,0.05,1
5782,762,1000.00,7000.00,8000.00,3500.00,3500.00,0.01,1
5783,762,1000.00,8000.00,9000.00,4000.00,4000.00,0.34,1
5784,762,1000.00,9000.00,10000.00,1156.05,7843.95,0.12,1
5785,762,1000.00,10000.00,11000.00,3339.37,6660.63,0.42,1
5786,762,-1000.00,9000.00,10000.00,4042.63,0.00,0.03,0
5787,762,1000.00,10000.00,11000.00,5000.00,5000.00,0.11,1
5788,762,1000.00,11000.00,12000.00,2765.71,7821.85,0.40,1
5789,762,1000.00,12000.00,13000.00,2711.12,9288.88,0.30,1
5790,762,-1000.00,11000.00,12000.00,6500.00,6500.00,0.18,0
5791,762,-1000.00,10000.00,11000.00,7260.65,4739.35,0.19,0
5792,762,-1000.00,9000.00,10000.00,0.00,8012.60,0.14,0
5793,762,-1000.00,8000.00,9000.00,4782.75,5217.25,0.18,0
5794,762,-1000.00,7000.00,8000.00,3960.34,5039.66,0.37,0
5795,762,-1000.00,6000.00,7000.00,0.00,7230.30,0.24,0
5796,762,-1000.00,5000.00,6000.00,0.00,7000.00,0.21,0
5797,762,-1000.00,4000.00,5000.00,3244.00,2756.00,0.28,0
5798,762,-1000.00,3000.00,4000.00,1333.92,3666.08,0.41,0
5799,762,-1000.00,2000.00,3000.00,99.21,3192.85,0.38,0
5800,762,-1000.00,1000.00,2000.00,1195.44,1804.56,0.13,0
5801,762,-1000.00,0.00,1000.00,322.52,1057.07,0.33,0
5802,762,-548.33,-548.33,451.67,0.00,548.33,0.24,0
5803,762,-451.67,-1000.00,0.00,0.00,451.67,0.37,0
5804,763,-1000.00,-1000.00,0.00,0.00,300.29,0.28,0
5805,764,-684.91,-684.91,315.09,181.02,503.89,0.32,0
5806,764,-315.09,-1000.00,0.00,0.00,315.09,0.16,0
5807,765,-1000.00,-1000.00,0.00,500.00,500.00,0.03,0
5808,766,1000.00,1000.00,2000.00,131.38,476.86,0.32,1
5809,766,1000.00,2000.00,3000.00,914.04,1085.96,0.15,1
5810,766,-1000.00,1000.00,2000.00,1638.19,1361.81,0.00,0
5811,766,1000.00,2000.00,3000.00,0.00,1265.67,0.08,1
5812,766,1000.00,3000.00,4000.00,0.00,3000.00,0.15,1
5813,766,1000.00,4000.00,5000.00,0.00,1950.57,0.16,1
5814,766,1000.00,5000.00,6000.00,950.92,4049.08,0.44,1
5815,766,-1000.00,4000.00,5000.00,3988.08,2011.92,0.22,0
5816,766,-1000.00,3000.00,4000.00,2569.02,2430.98,0.30,0
5817,766,1000.00,4000.00,5000.00,0.00,763.18,0.14,1
5818,766,1000.00,5000.00,6000.00,0.00,5000.00,0.16,1
5819,766,1000.00,6000.00,7000.00,0.00,6000.00,0.12,1
5820,766,-1000.00,5000.00,6000.00,5102.86,1897.14,0.19,0
5821,766,1000.00,6000.00,7000.00,2343.41,3656.59,0.36,1
5822,766,1000.00,7000.00,8000.00,0.00,6764.77,0.25,1
5823,766,1000.00,8000.00,9000.00,0.00,7116.91,0.31,1
5824,766,-1000.00,7000.00,8000.00,2683.55,6316.45,0.26,0
5825,766,-1000.00,6000.00,7000.00,6009.12,1990.88,0.14,0
5826,766,-1000.00,5000.00,6000.00,3500.00,3500.00,0.04,0
5827,766,-1000.00,4000.00,5000.00,2215.65,3784.35,0.04,0
5828,766,-1000.00,3000.00,4000.00,0.00,1696.82,0.16,0
5829,766,-1000.00,2000.00,3000.00,2000.00,2000.00,0.19,0
5830,766,-1000.00,1000.00,2000.00,0.00,1959.24,0.34,0
5831,766,-696.86,303.14,1303.14,487.72,209.14,0.23,0
5832,766,-1000.00,-696.86,303.14,174.22,323.26,0.34,0
5833,766,-1000.00,-1696.86,-696.86,0.00,110.20,0.26,0
5834,767,-1000.00,-1000.00,0.00,0.00,101.07,0.19,0
5835,768,1000.00,1000.00,2000.00,0.00,343.49,0.25,1
5836,768,1000.00,2000.00,3000.00,0.00,978.12,0.29,1
5837,768,1000.00,3000.00,4000.00,368.53,2015.09,0.37,1
5838,768,1000.00,4000.00,5000.00,850.59,3149.41,0.39,1
5839,768,-1000.00,3000.00,4000.00,4787.36,212.64,0.01,0
5840,768,-1000.00,2000.00,3000.00,2178.92,1821.08,0.18,0
5841,768,1000.00,3000.00,4000.00,0.00,3000.00,0.17,1
5842,768,1000.00,4000.00,5000.00,0.00,4000.00,0.35,1
5843,768,1000.00,5000.00,6000.00,0.00,5000.00,0.16,1
5844,768,-1000.00,4000.00,5000.00,5836.37,0.00,0.09,0
5845,768,1000.00,5000.00,6000.00,115.45,4884.55,0.09,1
5846,768,-1000.00,4000.00,5000.00,3351.91,2648.09,0.14,0
5847,768,1000.00,5000.00,6000.00,845.81,4154.19,0.22,1
5848,768,1000.00,6000.00,7000.00,2215.46,3784.54,0.26,1
5849,768,-1000.00,5000.00,6000.00,4375.70,623.06,0.13,0
5850,768,1000.00,6000.00,7000.00,0.00,6000.00,0.16,1
5851,768,1000.00,7000.00,8000.00,0.00,6764.77,0.31,1
5852,768,1000.00,8000.00,9000.00,0.00,1780.42,0.08,1
5853,768,1000.00,9000.00,10000.00,0.00,9000.00,0.18,1
5854,768,-1000.00,8000.00,9000.00,5884.79,4115.21,0.32,0
5855,768,-1000.00,7000.00,8000.00,0.00,5342.10,0.18,0
5856,768,-1000.00,6000.00,7000.00,3822.33,4177.67,0.20,0
5857,768,-1000.00,5000.00,6000.00,0.00,7000.00,0.07,0
5858,768,-1000.00,4000.00,5000.00,2784.12,3215.88,0.29,0
5859,768,-1000.00,3000.00,4000.00,2529.51,2470.49,0.14,0
5860,768,-1000.00,2000.00,3000.00,0.00,4000.00,0.37,0
5861,768,-1000.00,1000.00,2000.00,0.00,3000.00,0.08,0
5862,768,-1000.00,0.00,1000.00,0.00,2000.00,0.17,0
5863,768,-1000.00,-1000.00,0.00,322.89,262.13,0.25,0
5864,769,1000.00,1000.00,2000.00,386.66,405.26,0.26,1
5865,769,1000.00,2000.00,3000.00,0.00,2000.00,0.09,1
5866,769,1000.00,3000.00,4000.00,1166.40,1833.60,0.14,1
5867,769,1000.00,4000.00,5000.00,2000.00,2000.00,0.00,1
5868,769,1000.00,5000.00,6000.00,0.00,5000.00,0.10,1
5869,769,1000.00,6000.00,7000.00,0.00,4788.11,0.27,1
5870,769,-1000.00,5000.00,6000.00,3966.95,3033.05,0.11,0
5871,769,1000.00,6000.00,7000.00,0.00,5623.36,0.35,1
5872,769,1000.00,7000.00,8000.00,1394.04,3213.57,0.33,1
5873,769,1000.00,8000.00,9000.00,0.00,8000.00,0.19,1
5874,769,0.00,8000.00,9000.00,0.00,0.00,0.08,0
5875,769,1000.00,9000.00,10000.00,4291.79,4708.21,0.26,1
5876,769,1000.00,10000.00,11000.00,1434.18,8565.82,0.30,1
5877,769,1000.00,11000.00,12000.00,0.00,7867.62,0.11,1
5878,769,1000.00,12000.00,13000.00,0.00,6057.81,0.02,1
5879,769,1000.00,13000.00,14000.00,6500.00,6500.00,0.24,1
5880,769,1000.00,14000.00,15000.00,4403.75,9596.25,0.28,1
5881,769,1000.00,15000.00,16000.00,2001.39,10884.03,0.41,1
5882,769,-1000.00,14000.00,15000.00,12451.44,3548.56,0.11,0
5883,769,0.00,14000.00,15000.00,0.00,0.00,0.02,0
5884,769,1000.00,15000.00,16000.00,0.00,15000.00,0.32,1
5885,769,1000.00,16000.00,17000.00,3422.33,9091.22,0.39,1
5886,769,-1000.00,15000.00,16000.00,9011.90,7988.10,0.21,0
5887,769,1000.00,16000.00,17000.00,0.00,16000.00,0.08,1
5888,769,1000.00,17000.00,18000.00,6731.49,10268.51,0.31,1
5889,769,-1000.00,16000.00,17000.00,12036.99,5517.32,0.22,0
5890,769,1000.00,17000.00,18000.00,6735.66,10264.34,0.40,1
5891,769,1000.00,18000.00,19000.00,4225.83,13774.17,0.41,1
5892,769,1000.00,19000.00,20000.00,3191.94,15808.06,0.37,1
5893,769,1000.00,20000.00,21000.00,10000.00,10000.00,0.28,1
5894,769,1000.00,21000.00,22000.00,8995.25,12004.75,0.37,1
5895,769,1000.00,22000.00,23000.00,3980.45,18019.55,0.35,1
5896,769,-1000.00,21000.00,22000.00,14003.53,6939.05,0.22,0
5897,769,1000.00,22000.00,23000.00,1422.24,20577.76,0.22,1
5898,769,1000.00,23000.00,24000.00,0.00,23000.00,0.13,1
5899,769,1000.00,24000.00,25000.00,9108.59,14891.41,0.33,1
5900,769,-1000.00,23000.00,24000.00,13268.40,11731.60,0.31,0
5901,769,1000.00,24000.00,25000.00,0.00,16192.01,0.09,1
5902,769,-1000.00,23000.00,24000.00,13103.57,11896.43,0.31,0
5903,769,1000.00,24000.00,25000.00,1408.58,19657.22,0.41,1
5904,769,1000.00,25000.00,26000.00,9050.02,15949.98,0.42,1
5905,770,-1000.00,-1000.00,0.00,0.00,1000.00,0.29,0
5906,771,-1000.00,-1000.00,0.00,6.35,876.85,0.44,0
5907,772,-1000.00,-1000.00,0.00,390.14,609.86,0.11,0
5908,773,-1000.00,-1000.00,0.00,229.08,770.92,0.35,0
5909,774,-1000.00,-1000.00,0.00,367.62,632.38,0.35,0
5910,775,-1000.00,-1000.00,0.00,193.33,806.67,0.43,0
5911,776,1000.00,1000.00,2000.00,142.61,857.39,0.24,1
5912,776,-1000.00,0.00,1000.00,1133.02,866.98,0.21,0
5913,776,1000.00,1000.00,2000.00,0.00,616.14,0.16,1
5914,776,1000.00,2000.00,3000.00,695.56,1304.44,0.21,1
5915,776,-1000.00,1000.00,2000.00,1751.91,1248.09,0.16,0
5916,776,1000.00,2000.00,3000.00,0.00,2000.00,0.06,1
5917,776,1000.00,3000.00,4000.00,68.91,1033.84,0.27,1
5918,776,1000.00,4000.00,5000.00,0.00,4000.00,0.26,1
5919,776,1000.00,5000.00,6000.00,1515.10,3484.90,0.31,1
5920,776,-1000.00,4000.00,5000.00,1812.23,0.00,0.06,0
5921,776,1000.00,5000.00,6000.00,2324.71,2415.69,0.35,1
5922,776,1000.00,6000.00,7000.00,1248.71,3656.10,0.40,1
5923,776,1000.00,7000.00,8000.00,0.00,7000.00,0.15,1
5924,776,1000.00,8000.00,9000.00,2788.56,5211.44,0.36,1
5925,776,-1000.00,7000.00,8000.00,8373.72,0.00,0.00,0
5926,776,1000.00,8000.00,9000.00,2302.44,5697.56,0.41,1
5927,776,1000.00,9000.00,10000.00,0.00,7792.93,0.29,1
5928,776,1000.00,10000.00,11000.00,0.00,10000.00,0.25,1
5929,776,1000.00,11000.00,12000.00,0.00,8907.89,0.30,1
5930,776,1000.00,12000.00,13000.00,0.00,12000.00,0.15,1
5931,776,1000.00,13000.00,14000.00,0.00,4580.26,0.19,1
5932,776,1000.00,14000.00,15000.00,7000.00,7000.00,0.08,1
5933,776,-1000.00,13000.00,14000.00,2677.47,1901.48,0.17,0
5934,776,0.00,13000.00,14000.00,0.00,0.00,0.03,0
5935,776,-1000.00,12000.00,13000.00,6738.75,7261.25,0.22,0
5936,776,-1000.00,11000.00,12000.00,6342.09,6657.91,0.11,0
5937,776,-1000.00,10000.00,11000.00,4704.52,0.00,0.10,0
5938,776,-1000.00,9000.00,10000.00,9.09,10990.91,0.04,0
5939,776,-1000.00,8000.00,9000.00,0.00,9055.49,0.32,0
5940,776,-1000.00,7000.00,8000.00,6824.12,1836.43,0.12,0
5941,776,-1000.00,6000.00,7000.00,0.00,4390.29,0.32,0
5942,776,-1000.00,5000.00,6000.00,1595.11,5404.89,0.30,0
5943,776,-1000.00,4000.00,5000.00,2460.86,3539.14,0.24,0
5944,776,-1000.00,3000.00,4000.00,2500.00,2500.00,0.06,0
5945,776,-1000.00,2000.00,3000.00,0.00,1634.01,0.30,0
5946,776,-1000.00,1000.00,2000.00,1522.61,1304.06,0.31,0
5947,776,-1000.00,0.00,1000.00,0.00,1066.01,0.17,0
5948,776,-1000.00,-1000.00,0.00,353.82,646.18,0.22,0
5949,777,1000.00,1000.00,2000.00,412.42,587.58,0.32,1
5950,777,1000.00,2000.00,3000.00,0.00,66.15,0.09,1
5951,777,1000.00,3000.00,4000.00,1166.58,1833.42,0.35,1
5952,777,-1000.00,2000.00,3000.00,2206.82,1793.18,0.18,0
5953,777,1000.00,3000.00,4000.00,0.00,1630.09,0.19,1
5954,777,1000.00,4000.00,5000.00,1541.50,2458.50,0.39,1
5955,777,-1000.00,3000.00,4000.00,0.00,344.99,0.06,0
5956,777,-1000.00,2000.00,3000.00,0.00,2469.58,0.19,0
5957,777,-1000.00,1000.00,2000.00,456.46,2543.54,0.38,0
5958,777,-1000.00,0.00,1000.00,670.86,1329.14,0.39,0
5959,777,-1000.00,-1000.00,0.00,313.95,686.05,0.41,0
5960,778,0.00,0.00,1000.00,0.00,0.00,0.01,0
5961,778,1000.00,1000.00,2000.00,400.04,599.96,0.26,1
5962,778,1000.00,2000.00,3000.00,0.00,2000.00,0.12,1
5963,778,1000.00,3000.00,4000.00,0.00,1736.82,0.08,1
5964,778,-1000.00,2000.00,3000.00,3274.41,725.59,0.16,0
5965,778,1000.00,3000.00,4000.00,0.00,1385.45,0.20,1
5966,778,1000.00,4000.00,5000.00,0.00,4000.00,0.16,1
5967,778,1000.00,5000.00,6000.00,0.00,5000.00,0.01,1
5968,778,1000.00,6000.00,7000.00,0.00,6000.00,0.20,1
5969,778,1000.00,7000.00,8000.00,1545.67,5454.33,0.19,1
5970,778,1000.00,8000.00,9000.00,2178.22,5821.78,0.10,1
5971,778,1000.00,9000.00,10000.00,0.00,1616.95,0.04,1
5972,778,1000.00,10000.00,11000.00,0.00,10000.00,0.16,1
5973,778,1000.00,11000.00,12000.00,0.00,7767.92,0.22,1
5974,778,-1000.00,10000.00,11000.00,6474.29,5525.71,0.26,0
5975,778,1000.00,11000.00,12000.00,2224.80,8775.20,0.34,1
5976,778,1000.00,12000.00,13000.00,0.00,7352.06,0.09,1
5977,778,-1000.00,11000.00,12000.00,6842.02,6157.98,0.23,0
5978,778,1000.00,12000.00,13000.00,0.00,4129.73,0.16,1
5979,778,1000.00,13000.00,14000.00,2256.83,6789.69,0.30,1
5980,778,1000.00,14000.00,15000.00,7000.00,7000.00,0.25,1
5981,778,0.00,14000.00,15000.00,0.00,0.00,0.02,0
5982,778,-1000.00,13000.00,14000.00,6111.83,0.00,0.10,0
5983,778,-1000.00,12000.00,13000.00,9333.50,4666.50,0.07,0
5984,778,1000.00,13000.00,14000.00,5502.45,7497.55,0.40,1
5985,778,1000.00,14000.00,15000.00,0.00,14000.00,0.03,1
5986,778,1000.00,15000.00,16000.00,0.00,14319.62,0.40,1
5987,778,1000.00,16000.00,17000.00,8000.00,8000.00,0.09,1
5988,778,1000.00,17000.00,18000.00,0.00,14505.27,0.40,1
5989,778,1000.00,18000.00,19000.00,2986.37,15013.63,0.29,1
5990,778,1000.00,19000.00,20000.00,0.00,19000.00,0.21,1
5991,778,-1000.00,18000.00,19000.00,16445.43,22.13,0.08,0
5992,778,1000.00,19000.00,20000.00,5838.81,13161.19,0.42,1
5993,778,1000.00,20000.00,21000.00,0.00,12066.75,0.24,1
5994,778,1000.00,21000.00,22000.00,10500.00,10500.00,0.13,1
5995,778,1000.00,22000.00,23000.00,0.00,18451.39,0.41,1
5996,778,1000.00,23000.00,24000.00,0.00,23000.00,0.05,1
5997,778,-1000.00,22000.00,23000.00,14887.50,9112.50,0.11,0
5998,778,1000.00,23000.00,24000.00,5980.03,17019.97,0.42,1
5999,778,-1000.00,22000.00,23000.00,13885.82,10114.18,0.28,0
6000,778,1000.00,23000.00,24000.00,1982.44,16199.33,0.39,1
6001,778,1000.00,24000.00,25000.00,0.00,24000.00,0.29,1
6002,778,1000.00,25000.00,26000.00,9316.11,15683.89,0.29,1
6003,778,1000.00,26000.00,27000.00,12728.60,13271.40,0.25,1
6004,778,-1000.00,25000.00,26000.00,0.00,20559.61,0.02,0
6005,778,-1000.00,24000.00,25000.00,0.00,26000.00,0.23,0
6006,778,-1000.00,23000.00,24000.00,0.00,25000.00,0.14,0
6007,778,-1000.00,22000.00,23000.00,0.00,24000.00,0.11,0
6008,778,-1000.00,21000.00,22000.00,0.00,9806.17,0.20,0
6009,778,-1000.00,20000.00,21000.00,0.00,22000.00,0.11,0
6010,778,-1000.00,19000.00,20000.00,7932.15,0.00,0.08,0
6011,778,-1000.00,18000.00,19000.00,6834.53,13165.47,0.43,0
6012,778,-1000.00,17000.00,18000.00,15193.70,3606.16,0.12,0
6013,778,-1000.00,16000.00,17000.00,6990.57,11009.43,0.39,0
6014,778,-1000.00,15000.00,16000.00,0.00,17000.00,0.27,0
6015,778,-1000.00,14000.00,15000.00,13519.56,2480.44,0.05,0
6016,778,-1000.00,13000.00,14000.00,6836.51,8163.49,0.22,0
6017,778,-1000.00,12000.00,13000.00,7401.35,6598.65,0.29,0
6018,778,-1000.00,11000.00,12000.00,6500.00,6500.00,0.26,0
6019,778,-1000.00,10000.00,11000.00,5171.93,6828.07,0.40,0
6020,778,-1000.00,9000.00,10000.00,4284.17,6715.83,0.13,0
6021,778,-1000.00,8000.00,9000.00,3922.95,6077.05,0.38,0
6022,778,-1000.00,7000.00,8000.00,0.00,7555.02,0.39,0
6023,778,-1000.00,6000.00,7000.00,1235.07,0.00,0.12,0
6024,778,-1000.00,5000.00,6000.00,1927.27,5072.73,0.27,0
6025,778,-1000.00,4000.00,5000.00,1826.41,2948.80,0.38,0
6026,778,-1000.00,3000.00,4000.00,506.55,756.60,0.20,0
6027,778,-1000.00,2000.00,3000.00,369.51,2964.49,0.43,0
6028,779,-1000.00,-1000.00,0.00,403.48,596.52,0.14,0
6029,780,-1000.00,-1000.00,0.00,301.34,698.66,0.39,0
6030,781,-784.04,-784.04,215.96,0.00,784.04,0.30,0
6031,781,-43.50,-827.54,172.46,2.45,41.05,0.27,0
6032,781,0.00,-827.54,172.46,0.00,0.00,0.09,0
6033,781,0.00,-827.54,172.46,0.00,0.00,0.09,0
6034,781,-35.34,-862.88,137.12,0.00,35.34,0.11,0
6035,781,-113.69,-976.56,23.44,0.00,113.69,0.37,0
6036,781,-23.44,-1000.00,0.00,3.33,20.11,0.26,0
6037,782,-960.67,-960.67,39.33,700.05,260.62,0.14,0
6038,782,-1000.00,-1960.67,-960.67,4.35,34.98,0.26,0
6039,783,1000.00,1000.00,2000.00,0.00,1000.00,0.22,1
6040,783,1000.00,2000.00,3000.00,0.00,2000.00,0.35,1
6041,783,-1000.00,1000.00,2000.00,1356.38,0.00,0.08,0
6042,783,1000.00,2000.00,3000.00,0.00,1911.72,0.20,1
6043,783,1000.00,3000.00,4000.00,323.18,2676.82,0.43,1
6044,783,-1000.00,2000.00,3000.00,3836.77,163.23,0.08,0
6045,783,1000.00,3000.00,4000.00,0.00,670.94,0.17,1
6046,783,1000.00,4000.00,5000.00,2000.00,2000.00,0.16,1
6047,783,1000.00,5000.00,6000.00,0.00,4164.16,0.37,1
6048,783,1000.00,6000.00,7000.00,428.15,1418.47,0.19,1
6049,783,1000.00,7000.00,8000.00,0.00,7000.00,0.31,1
6050,783,-1000.00,6000.00,7000.00,6163.09,1836.91,0.16,0
6051,783,-1000.00,5000.00,6000.00,3866.44,3133.56,0.27,0
6052,783,1000.00,6000.00,7000.00,0.00,6000.00,0.06,1
6053,783,0.00,6000.00,7000.00,0.00,0.00,0.11,0
6054,783,-1000.00,5000.00,6000.00,379.78,1227.80,0.11,0
6055,783,-1000.00,4000.00,5000.00,1159.49,3455.84,0.36,0
6056,783,-1000.00,3000.00,4000.00,2417.68,1033.12,0.18,0
6057,783,-1000.00,2000.00,3000.00,0.00,4000.00,0.14,0
6058,783,-1000.00,1000.00,2000.00,0.00,3000.00,0.14,0
6059,783,-1000.00,0.00,1000.00,0.00,2000.00,0.07,0
6060,783,-982.53,-982.53,17.47,0.00,982.53,0.31,0
6061,783,-17.47,-1000.00,0.00,8.66,8.81,0.28,0
6062,784,-1000.00,-1000.00,0.00,0.00,531.77,0.35,0
6063,785,-414.09,-414.09,585.91,0.00,414.09,0.27,0
6064,785,-585.91,-1000.00,0.00,121.51,464.40,0.20,0
6065,786,-1000.00,-1000.00,0.00,209.52,790.48,0.42,0
6066,787,-1000.00,-1000.00,0.00,412.82,587.18,0.36,0
6067,788,-1000.00,-1000.00,0.00,0.00,1000.00,0.03,0
6068,789,-1000.00,-1000.00,0.00,273.97,726.03,0.35,0
6069,790,-1000.00,-1000.00,0.00,273.60,232.03,0.20,0
6070,791,-1000.00,-1000.00,0.00,101.10,898.90,0.10,0
6071,792,-1000.00,-1000.00,0.00,0.00,994.01,0.41,0
6072,793,1000.00,1000.00,2000.00,355.48,644.52,0.42,1
6073,793,1000.00,2000.00,3000.00,444.63,1555.37,0.43,1
6074,793,1000.00,3000.00,4000.00,0.00,2171.92,0.27,1
6075,793,1000.00,4000.00,5000.00,1120.27,2879.73,0.35,1
6076,793,1000.00,5000.00,6000.00,1208.71,3791.29,0.07,1
6077,793,1000.00,6000.00,7000.00,0.00,2923.37,0.23,1
6078,793,1000.00,7000.00,8000.00,1040.45,5959.55,0.37,1
6079,793,1000.00,8000.00,9000.00,0.00,4207.74,0.22,1
6080,793,-1000.00,7000.00,8000.00,5291.14,3708.86,0.31,0
6081,793,0.00,7000.00,8000.00,0.00,0.00,0.08,0
6082,793,1000.00,8000.00,9000.00,0.00,6317.34,0.23,1
6083,793,1000.00,9000.00,10000.00,3063.67,5936.33,0.37,1
6084,793,-1000.00,8000.00,9000.00,6232.64,0.00,0.10,0
6085,793,1000.00,9000.00,10000.00,3311.79,5688.21,0.38,1
6086,793,1000.00,10000.00,11000.00,1664.13,8335.87,0.09,1
6087,793,1000.00,11000.00,12000.00,5362.41,5637.59,0.17,1
6088,793,-1000.00,10000.00,11000.00,9819.79,2180.21,0.15,0
6089,793,1000.00,11000.00,12000.00,5189.60,5409.13,0.32,1
6090,793,-1000.00,10000.00,11000.00,5428.20,5112.54,0.27,0
6091,793,1000.00,11000.00,12000.00,0.00,8619.92,0.40,1
6092,793,1000.00,12000.00,13000.00,0.00,12000.00,0.06,1
6093,793,-1000.00,11000.00,12000.00,7211.18,5788.82,0.34,0
6094,793,1000.00,12000.00,13000.00,2523.95,8855.62,0.38,1
6095,793,1000.00,13000.00,14000.00,5365.43,7634.57,0.39,1
6096,793,1000.00,14000.00,15000.00,3431.62,10568.38,0.28,1
6097,793,1000.00,15000.00,16000.00,0.00,15000.00,0.23,1
6098,793,1000.00,16000.00,17000.00,0.00,16000.00,0.07,1
6099,793,1000.00,17000.00,18000.00,0.00,16333.27,0.42,1
6100,793,1000.00,18000.00,19000.00,0.00,18000.00,0.40,1
6101,793,1000.00,19000.00,20000.00,5408.61,13591.39,0.41,1
6102,793,1000.00,20000.00,21000.00,7217.18,12782.82,0.15,1
6103,793,1000.00,21000.00,22000.00,9531.75,11468.25,0.26,1
6104,793,1000.00,22000.00,23000.00,0.00,22000.00,0.08,1
6105,793,1000.00,23000.00,24000.00,0.00,23000.00,0.28,1
6106,793,-1000.00,22000.00,23000.00,23509.51,0.00,0.09,0
6107,793,1000.00,23000.00,24000.00,11500.00,11500.00,0.06,1
6108,793,1000.00,24000.00,25000.00,6992.17,17007.83,0.43,1
6109,793,-1000.00,23000.00,24000.00,13725.30,11274.70,0.09,0
6110,793,1000.00,24000.00,25000.00,0.00,11650.57,0.26,1
6111,793,1000.00,25000.00,26000.00,0.00,25000.00,0.26,1
6112,793,1000.00,26000.00,27000.00,7101.16,18898.84,0.43,1
6113,794,-273.25,-273.25,726.75,0.00,273.25,0.13,0
6114,794,0.00,-273.25,726.75,0.00,0.00,0.09,0
6115,794,-1000.00,-1273.25,-273.25,389.47,0.00,0.03,0
6116,795,-1000.00,-1000.00,0.00,287.79,712.21,0.25,0
6117,796,-1000.00,-1000.00,0.00,0.00,1000.00,0.12,0
6118,797,-1000.00,-1000.00,0.00,0.00,1000.00,0.32,0
6119,798,1000.00,1000.00,2000.00,395.95,604.05,0.25,1
6120,798,1000.00,2000.00,3000.00,913.16,1086.84,0.22,1
6121,798,1000.00,3000.00,4000.00,0.00,2826.24,0.43,1
6122,798,1000.00,4000.00,5000.00,0.00,4000.00,0.21,1
6123,798,1000.00,5000.00,6000.00,1102.64,3897.36,0.15,1
6124,798,1000.00,6000.00,7000.00,1999.66,3997.62,0.37,1
6125,798,0.00,6000.00,7000.00,0.00,0.00,0.05,0
6126,798,1000.00,7000.00,8000.00,1852.80,5147.20,0.11,1
6127,798,1000.00,8000.00,9000.00,2173.38,5826.62,0.42,1
6128,798,1000.00,9000.00,10000.00,0.00,535.90,0.12,1
6129,798,-1000.00,8000.00,9000.00,9276.97,723.03,0.01,0
6130,798,1000.00,9000.00,10000.00,4500.00,4500.00,0.01,1
6131,798,1000.00,10000.00,11000.00,0.00,10000.00,0.03,1
6132,798,1000.00,11000.00,12000.00,4892.27,6107.73,0.31,1
6133,798,1000.00,12000.00,13000.00,6000.00,6000.00,0.01,1
6134,798,1000.00,13000.00,14000.00,0.00,8034.33,0.08,1
6135,798,-1000.00,12000.00,13000.00,7784.92,6215.08,0.35,0
6136,798,-1000.00,11000.00,12000.00,8156.62,4843.38,0.19,0
6137,798,1000.00,12000.00,13000.00,0.00,12000.00,0.07,1
6138,798,1000.00,13000.00,14000.00,6500.00,6500.00,0.07,1
6139,798,1000.00,14000.00,15000.00,5257.81,8742.19,0.37,1
6140,798,1000.00,15000.00,16000.00,0.00,15000.00,0.07,1
6141,798,1000.00,16000.00,17000.00,4861.00,11139.00,0.25,1
6142,798,1000.00,17000.00,18000.00,5411.26,11588.74,0.32,1
6143,798,-1000.00,16000.00,17000.00,4984.12,1077.38,0.16,0
6144,798,1000.00,17000.00,18000.00,1413.05,15428.40,0.44,1
6145,798,-1000.00,16000.00,17000.00,10607.68,7392.32,0.09,0
6146,798,1000.00,17000.00,18000.00,5401.44,11598.56,0.31,1
6147,798,1000.00,18000.00,19000.00,7486.30,10513.70,0.32,1
6148,798,1000.00,19000.00,20000.00,4559.72,14312.41,0.38,1
6149,798,1000.00,20000.00,21000.00,0.00,5208.28,0.09,1
6150,798,1000.00,21000.00,22000.00,5551.19,15448.81,0.43,1
6151,798,1000.00,22000.00,23000.00,9409.16,12590.84,0.20,1
6152,798,-1000.00,21000.00,22000.00,15502.64,0.00,0.09,0
6153,798,1000.00,22000.00,23000.00,7392.95,14607.05,0.23,1
6154,798,1000.00,23000.00,24000.00,0.00,12658.84,0.18,1
6155,798,-1000.00,22000.00,23000.00,12174.13,11825.87,0.06,0
6156,798,1000.00,23000.00,24000.00,2984.72,20015.28,0.40,1
6157,798,1000.00,24000.00,25000.00,8554.27,15445.73,0.40,1
6158,798,1000.00,25000.00,26000.00,8395.64,16604.36,0.43,1
6159,798,1000.00,26000.00,27000.00,6998.50,19001.50,0.44,1
6160,798,-1000.00,25000.00,26000.00,20101.48,5092.93,0.15,0
6161,798,1000.00,26000.00,27000.00,0.00,5552.13,0.23,1
6162,798,1000.00,27000.00,28000.00,0.00,27000.00,0.26,1
6163,798,1000.00,28000.00,29000.00,6259.07,21740.93,0.37,1
6164,798,1000.00,29000.00,30000.00,3557.57,25442.43,0.40,1
6165,798,1000.00,30000.00,31000.00,13404.59,16595.41,0.09,1
6166,798,-1000.00,29000.00,30000.00,14191.31,16808.69,0.40,0
6167,798,-1000.00,28000.00,29000.00,10793.10,19206.90,0.38,0
6168,798,-1000.00,27000.00,28000.00,0.00,19622.93,0.05,0
6169,798,-1000.00,26000.00,27000.00,4201.42,23798.58,0.43,0
6170,798,-1000.00,25000.00,26000.00,19134.39,7097.19,0.21,0
6171,798,0.00,25000.00,26000.00,0.00,0.00,0.04,0
6172,798,-1000.00,24000.00,25000.00,5138.51,20861.49,0.44,0
6173,798,-1000.00,23000.00,24000.00,16426.87,8573.13,0.03,0
6174,798,-1000.00,22000.00,23000.00,6634.78,17365.22,0.25,0
6175,798,-1000.00,21000.00,22000.00,0.00,23000.00,0.26,0
6176,798,-1000.00,20000.00,21000.00,0.00,13699.63,0.07,0
6177,798,-1000.00,19000.00,20000.00,10500.00,10500.00,0.08,0
6178,798,-1000.00,18000.00,19000.00,0.00,6586.39,0.09,0
6179,798,-1000.00,17000.00,18000.00,9500.00,9500.00,0.11,0
6180,798,-1000.00,16000.00,17000.00,0.00,18000.00,0.02,0
6181,798,-1000.00,15000.00,16000.00,1498.07,5939.43,0.33,0
6182,798,-1000.00,14000.00,15000.00,0.00,16000.00,0.17,0
6183,798,-1000.00,13000.00,14000.00,0.00,8770.39,0.37,0
6184,798,-1000.00,12000.00,13000.00,8158.93,5841.07,0.35,0
6185,798,-1000.00,11000.00,12000.00,5668.05,7331.95,0.32,0
6186,798,-1000.00,10000.00,11000.00,2700.78,7956.64,0.38,0
6187,798,-1000.00,9000.00,10000.00,5105.17,5894.83,0.14,0
6188,798,-1000.00,8000.00,9000.00,2751.97,5806.34,0.37,0
6189,799,1000.00,1000.00,2000.00,1000.00,0.00,0.02,1
6190,799,-1000.00,0.00,1000.00,0.00,1247.46,0.39,0
6191,799,1000.00,1000.00,2000.00,865.32,134.68,0.09,1
6192,799,-1000.00,0.00,1000.00,0.00,1445.71,0.17,0
6193,799,0.00,0.00,1000.00,0.00,0.00,0.17,0
6194,799,1000.00,1000.00,2000.00,502.06,497.94,0.02,1
6195,799,-1000.00,0.00,1000.00,0.00,1540.18,0.27,0
6196,799,-180.66,-180.66,819.34,0.00,180.66,0.24,0
6197,799,1000.00,819.34,1819.34,432.08,387.26,0.15,1
6198,799,0.00,819.34,1819.34,0.00,0.00,0.24,0
6199,799,-630.38,188.96,1188.96,185.72,444.66,0.42,0
6200,799,-625.35,-436.39,563.61,69.71,555.63,0.43,0
6201,799,-414.49,-850.88,149.12,0.00,414.49,0.08,0
6202,799,0.00,-850.88,149.12,0.00,0.00,0.17,0
6203,799,215.13,-635.75,364.25,0.92,0.00,0.00,1
6204,799,-322.64,-958.39,41.61,0.00,322.64,0.16,0
6205,799,1000.00,41.61,1041.61,9.61,0.00,0.13,1
6206,799,-440.54,-398.92,601.08,0.00,440.54,0.32,0
6207,799,-601.08,-1000.00,0.00,176.61,424.47,0.08,0
6208,800,-701.47,-701.47,298.53,0.00,701.47,0.34,0
6209,800,-298.53,-1000.00,0.00,115.93,182.60,0.34,0
6210,801,-205.82,-205.82,794.18,0.00,205.82,0.19,0
6211,801,-752.25,-958.07,41.93,10.44,741.81,0.44,0
6212,801,-1000.00,-1958.07,-958.07,27.83,14.10,0.11,0
6213,802,-1000.00,-1000.00,0.00,92.62,282.01,0.30,0
6214,803,-1000.00,-1000.00,0.00,0.00,234.04,0.16,0
6215,804,0.00,0.00,1000.00,0.00,0.00,0.09,0
6216,804,1000.00,1000.00,2000.00,0.00,1000.00,0.11,1
6217,804,1000.00,2000.00,3000.00,0.00,2000.00,0.01,1
6218,804,1000.00,3000.00,4000.00,1481.64,1518.36,0.13,1
6219,804,1000.00,4000.00,5000.00,1474.05,1883.68,0.34,1
6220,804,-1000.00,3000.00,4000.00,5000.00,0.00,0.00,0
6221,804,1000.00,4000.00,5000.00,0.00,3891.25,0.36,1
6222,804,-1000.00,3000.00,4000.00,2619.70,2380.30,0.26,0
6223,804,1000.00,4000.00,5000.00,947.30,3052.70,0.32,1
6224,804,1000.00,5000.00,6000.00,0.00,797.81,0.10,1
6225,804,1000.00,6000.00,7000.00,0.00,4342.32,0.35,1
6226,804,1000.00,7000.00,8000.00,1213.81,2711.97,0.23,1
6227,804,-1000.00,6000.00,7000.00,3057.91,2214.38,0.22,0
6228,804,-1000.00,5000.00,6000.00,3858.23,3141.77,0.04,0
6229,804,1000.00,6000.00,7000.00,0.00,4800.68,0.14,1
6230,804,1000.00,7000.00,8000.00,3244.11,3755.89,0.32,1
6231,804,0.00,7000.00,8000.00,0.00,0.00,0.03,0
6232,804,1000.00,8000.00,9000.00,0.00,8000.00,0.23,1
6233,804,-1000.00,7000.00,8000.00,5921.22,131.03,0.11,0
6234,804,1000.00,8000.00,9000.00,0.00,8000.00,0.03,1
6235,804,1000.00,9000.00,10000.00,0.00,9000.00,0.07,1
6236,804,0.00,9000.00,10000.00,0.00,0.00,0.06,0
6237,804,1000.00,10000.00,11000.00,1318.34,8057.80,0.44,1
6238,804,1000.00,11000.00,12000.00,0.00,11000.00,0.11,1
6239,804,-1000.00,10000.00,11000.00,7473.01,0.00,0.10,0
6240,804,-1000.00,9000.00,10000.00,0.00,11000.00,0.12,0
6241,804,-1000.00,8000.00,9000.00,4672.08,5327.92,0.20,0
6242,804,-1000.00,7000.00,8000.00,2613.59,5992.15,0.38,0
6243,804,-1000.00,6000.00,7000.00,1886.71,6113.29,0.40,0
6244,804,-1000.00,5000.00,6000.00,1724.94,5275.06,0.43,0
6245,804,-1000.00,4000.00,5000.00,1962.08,4037.92,0.30,0
6246,804,-1000.00,3000.00,4000.00,2402.01,2597.99,0.10,0
6247,804,-1000.00,2000.00,3000.00,205.31,1701.74,0.29,0
6248,804,-1000.00,1000.00,2000.00,0.00,3000.00,0.04,0
6249,804,-1000.00,0.00,1000.00,0.00,1683.96,0.33,0
6250,804,-688.18,-688.18,311.82,0.00,688.18,0.04,0
6251,804,-311.82,-1000.00,0.00,154.38,157.45,0.20,0
6252,805,-628.70,-628.70,371.30,0.00,628.70,0.40,0
6253,805,-371.30,-1000.00,0.00,185.65,185.65,0.06,0
6254,806,-1000.00,-1000.00,0.00,210.02,789.98,0.38,0
6255,807,-724.05,-724.05,275.95,2.14,721.90,0.40,0
6256,807,-275.95,-1000.00,0.00,0.00,275.95,0.04,0
6257,808,-1000.00,-1000.00,0.00,425.67,574.33,0.30,0
6258,809,-93.82,-93.82,906.18,93.82,0.00,0.06,0
6259,809,1000.00,906.18,1906.18,0.00,392.38,0.25,1
6260,809,-1000.00,-93.82,906.18,996.80,909.38,0.24,0
6261,809,-148.75,-242.58,757.42,148.75,0.00,0.01,0
6262,809,1000.00,757.42,1757.42,195.68,561.74,0.44,1
6263,809,1000.00,1757.42,2757.42,0.00,1757.42,0.18,1
6264,809,1000.00,2757.42,3757.42,1236.41,1521.01,0.19,1
6265,809,1000.00,3757.42,4757.42,0.00,284.82,0.13,1
6266,809,1000.00,4757.42,5757.42,2378.71,2378.71,0.00,1
6267,809,1000.00,5757.42,6757.42,0.00,1644.02,0.15,1
6268,809,-1000.00,4757.42,5757.42,4113.44,2643.98,0.25,0
6269,809,1000.00,5757.42,6757.42,346.70,1972.38,0.23,1
6270,809,1000.00,6757.42,7757.42,1472.25,5285.17,0.17,1
6271,809,0.00,6757.42,7757.42,0.00,0.00,0.04,0
6272,809,1000.00,7757.42,8757.42,1411.42,6346.00,0.21,1
6273,809,-1000.00,6757.42,7757.42,7099.76,1312.57,0.18,0
6274,809,1000.00,7757.42,8757.42,3401.00,4356.43,0.19,1
6275,809,1000.00,8757.42,9757.42,2150.28,6607.14,0.39,1
6276,809,1000.00,9757.42,10757.42,0.00,9757.42,0.03,1
6277,809,1000.00,10757.42,11757.42,816.72,9940.70,0.37,1
6278,809,1000.00,11757.42,12757.42,3645.42,8112.00,0.38,1
6279,809,-1000.00,10757.42,11757.42,6743.58,6013.84,0.07,0
6280,809,1000.00,11757.42,12757.42,3220.44,8536.98,0.43,1
6281,809,1000.00,12757.42,13757.42,3549.05,9208.38,0.23,1
6282,809,1000.00,13757.42,14757.42,0.00,10991.44,0.19,1
6283,809,1000.00,14757.42,15757.42,2716.70,12040.73,0.14,1
6284,809,-1000.00,13757.42,14757.42,7961.65,7795.78,0.24,0
6285,809,-1000.00,12757.42,13757.42,10411.13,4346.29,0.24,0
6286,809,1000.00,13757.42,14757.42,5840.95,7916.48,0.40,1
6287,809,1000.00,14757.42,15757.42,0.00,14757.42,0.00,1
6288,809,-1000.00,13757.42,14757.42,9067.49,2166.45,0.13,0
6289,809,1000.00,14757.42,15757.42,7222.40,7535.02,0.17,1
6290,809,1000.00,15757.42,16757.42,7878.71,7878.71,0.24,1
6291,809,-1000.00,14757.42,15757.42,13553.27,0.00,0.03,0
6292,809,1000.00,15757.42,16757.42,1346.38,14411.04,0.39,1
6293,809,1000.00,16757.42,17757.42,0.00,16757.42,0.35,1
6294,809,1000.00,17757.42,18757.42,5467.34,12290.08,0.36,1
6295,809,1000.00,18757.42,19757.42,0.00,249.60,0.11,1
6296,809,-1000.00,17757.42,18757.42,12022.59,7734.83,0.26,0
6297,809,1000.00,18757.42,19757.42,0.00,16821.71,0.02,1
6298,809,-1000.00,17757.42,18757.42,11703.83,8053.59,0.29,0
6299,809,1000.00,18757.42,19757.42,5348.06,13409.37,0.37,1
6300,809,1000.00,19757.42,20757.42,0.00,3395.31,0.13,1
6301,809,1000.00,20757.42,21757.42,5516.04,15241.39,0.38,1
6302,809,1000.00,21757.42,22757.42,0.00,10733.00,0.28,1
6303,809,1000.00,22757.42,23757.42,5221.75,17535.68,0.03,1
6304,809,1000.00,23757.42,24757.42,10963.44,12793.98,0.33,1
6305,809,-1000.00,22757.42,23757.42,14253.91,10503.51,0.15,0
6306,809,-1000.00,21757.42,22757.42,11878.71,11878.71,0.02,0
6307,809,-1000.00,20757.42,21757.42,1083.67,21673.76,0.33,0
6308,809,-1000.00,19757.42,20757.42,0.00,21757.42,0.23,0
6309,809,-1000.00,18757.42,19757.42,12202.57,8554.85,0.36,0
6310,809,-1000.00,17757.42,18757.42,10792.44,8964.99,0.28,0
6311,809,-1000.00,16757.42,17757.42,3322.52,15434.91,0.21,0
6312,809,-1000.00,15757.42,16757.42,0.00,2656.04,0.07,0
6313,809,-1000.00,14757.42,15757.42,0.00,7919.46,0.02,0
6314,809,-1000.00,13757.42,14757.42,3005.78,12751.64,0.42,0
6315,809,-1000.00,12757.42,13757.42,5731.81,9025.61,0.33,0
6316,809,-1000.00,11757.42,12757.42,12116.87,1640.55,0.03,0
6317,809,-1000.00,10757.42,11757.42,0.00,10075.83,0.22,0
6318,809,-1000.00,9757.42,10757.42,1677.87,10079.55,0.13,0
6319,809,-1000.00,8757.42,9757.42,604.60,10152.83,0.36,0
6320,809,-1000.00,7757.42,8757.42,0.00,7148.89,0.21,0
6321,809,-1000.00,6757.42,7757.42,2720.79,6036.64,0.06,0
6322,809,-1000.00,5757.42,6757.42,1047.78,4766.73,0.41,0
6323,809,-1000.00,4757.42,5757.42,2991.03,3766.39,0.05,0
6324,809,-1000.00,3757.42,4757.42,2878.71,2878.71,0.06,0
6325,809,-1000.00,2757.42,3757.42,0.00,4757.42,0.09,0
6326,810,1000.00,1000.00,2000.00,364.71,635.29,0.35,1
6327,810,1000.00,2000.00,3000.00,0.00,2000.00,0.33,1
6328,810,1000.00,3000.00,4000.00,428.72,2571.28,0.19,1
6329,810,1000.00,4000.00,5000.00,1646.73,2353.27,0.29,1
6330,810,1000.00,5000.00,6000.00,0.00,5000.00,0.14,1
6331,810,1000.00,6000.00,7000.00,1616.99,4383.01,0.36,1
6332,810,1000.00,7000.00,8000.00,0.00,7000.00,0.06,1
6333,810,1000.00,8000.00,9000.00,3342.63,4657.37,0.41,1
6334,810,1000.00,9000.00,10000.00,3802.83,5197.17,0.26,1
6335,810,1000.00,10000.00,11000.00,3154.86,6845.14,0.42,1
6336,810,1000.00,11000.00,12000.00,4992.96,6007.04,0.10,1
6337,810,1000.00,12000.00,13000.00,624.04,11375.96,0.34,1
6338,810,1000.00,13000.00,14000.00,6269.80,6730.20,0.32,1
6339,810,-1000.00,12000.00,13000.00,8292.00,5708.00,0.16,0
6340,810,1000.00,13000.00,14000.00,0.00,6085.84,0.04,1
6341,810,1000.00,14000.00,15000.00,0.00,14000.00,0.24,1
6342,810,-1000.00,13000.00,14000.00,10225.00,4775.00,0.28,0
6343,810,1000.00,14000.00,15000.00,0.00,12496.67,0.27,1
6344,810,1000.00,15000.00,16000.00,0.00,15000.00,0.39,1
6345,810,1000.00,16000.00,17000.00,0.00,6753.30,0.30,1
6346,810,1000.00,17000.00,18000.00,8500.00,8500.00,0.00,1
6347,810,1000.00,18000.00,19000.00,2503.16,15496.84,0.15,1
6348,810,1000.00,19000.00,20000.00,8603.34,10396.66,0.17,1
6349,810,1000.00,20000.00,21000.00,0.00,20000.00,0.39,1
6350,810,-1000.00,19000.00,20000.00,11317.57,9682.43,0.10,0
6351,810,1000.00,20000.00,21000.00,10000.00,10000.00,0.07,1
6352,810,0.00,20000.00,21000.00,0.00,0.00,0.02,0
6353,810,1000.00,21000.00,22000.00,5927.15,15072.85,0.37,1
6354,810,-1000.00,20000.00,21000.00,11970.13,10029.87,0.28,0
6355,810,0.00,20000.00,21000.00,0.00,0.00,0.08,0
6356,810,1000.00,21000.00,22000.00,1645.42,19354.58,0.29,1
6357,810,-1000.00,20000.00,21000.00,6026.22,4917.56,0.22,0
6358,810,1000.00,21000.00,22000.00,0.00,21000.00,0.34,1
6359,810,-1000.00,20000.00,21000.00,17821.92,4178.08,0.20,0
6360,810,1000.00,21000.00,22000.00,6255.59,14744.41,0.04,1
6361,810,1000.00,22000.00,23000.00,0.00,11685.75,0.38,1
6362,810,1000.00,23000.00,24000.00,9855.43,13144.57,0.25,1
6363,810,1000.00,24000.00,25000.00,3733.54,4434.53,0.22,1
6364,810,1000.00,25000.00,26000.00,2641.51,22358.49,0.08,1
6365,810,1000.00,26000.00,27000.00,0.00,15775.35,0.33,1
6366,810,1000.00,27000.00,28000.00,13500.00,13500.00,0.05,1
6367,810,1000.00,28000.00,29000.00,5685.88,22314.12,0.42,1
6368,810,-1000.00,27000.00,28000.00,18378.36,10621.64,0.01,0
6369,810,1000.00,28000.00,29000.00,0.00,28000.00,0.04,1
6370,810,1000.00,29000.00,30000.00,13761.46,15238.54,0.21,1
6371,810,-1000.00,28000.00,29000.00,14007.36,15992.64,0.29,0
6372,810,-1000.00,27000.00,28000.00,11872.24,17127.76,0.08,0
6373,810,-1000.00,26000.00,27000.00,11037.95,16962.05,0.25,0
6374,810,-1000.00,25000.00,26000.00,0.00,27000.00,0.23,0
6375,810,-1000.00,24000.00,25000.00,0.00,18638.16,0.33,0
6376,810,-1000.00,23000.00,24000.00,0.00,25000.00,0.15,0
6377,810,-1000.00,22000.00,23000.00,0.00,24000.00,0.26,0
6378,810,-1000.00,21000.00,22000.00,9718.01,13281.99,0.36,0
6379,810,-1000.00,20000.00,21000.00,11657.78,10342.22,0.09,0
6380,810,-1000.00,19000.00,20000.00,0.00,21000.00,0.10,0
6381,810,-1000.00,18000.00,19000.00,7614.90,9092.31,0.31,0
6382,810,-1000.00,17000.00,18000.00,12885.25,6114.75,0.04,0
6383,810,-1000.00,16000.00,17000.00,2779.20,15220.80,0.28,0
6384,810,-1000.00,15000.00,16000.00,1689.47,15310.53,0.37,0
6385,810,-1000.00,14000.00,15000.00,0.00,12417.66,0.41,0
6386,810,-1000.00,13000.00,14000.00,0.00,15000.00,0.39,0
6387,810,-1000.00,12000.00,13000.00,321.60,13678.40,0.40,0
6388,810,-1000.00,11000.00,12000.00,6500.00,6500.00,0.22,0
6389,810,-1000.00,10000.00,11000.00,1329.01,10670.99,0.23,0
6390,811,-1000.00,-1000.00,0.00,0.00,244.34,0.28,0
6391,812,-1000.00,-1000.00,0.00,41.67,958.33,0.38,0
6392,813,-539.23,-539.23,460.77,0.00,539.23,0.36,0
6393,813,-201.79,-741.03,258.97,0.00,201.79,0.31,0
6394,813,-53.36,-794.39,205.61,0.00,53.36,0.26,0
6395,813,-156.87,-951.26,48.74,0.00,156.87,0.37,0
6396,813,-48.74,-1000.00,0.00,15.68,33.06,0.21,0
6397,814,-145.87,-145.87,854.13,0.00,145.87,0.18,0
6398,814,-211.21,-357.07,642.93,0.00,211.21,0.19,0
6399,814,1000.00,642.93,1642.93,53.50,0.00,0.29,1
6400,814,-1000.00,-357.07,642.93,216.63,1426.30,0.33,0
6401,814,-518.05,-875.12,124.88,0.00,518.05,0.01,0
6402,814,-124.88,-1000.00,0.00,0.00,124.88,0.04,0
6403,815,-1000.00,-1000.00,0.00,0.00,1000.00,0.34,0
6404,816,-1000.00,-1000.00,0.00,392.30,607.70,0.15,0
6405,817,-762.90,-762.90,237.10,339.90,423.00,0.27,0
6406,817,-237.10,-1000.00,0.00,114.53,122.57,0.19,0
6407,818,-477.36,-477.36,522.64,0.00,477.36,0.31,0
6408,818,-264.51,-741.87,258.13,0.00,264.51,0.09,0
6409,818,-1000.00,-1741.87,-741.87,40.30,25.11,0.16,0
6410,819,-1000.00,-1000.00,0.00,0.00,1000.00,0.02,0
6411,820,-1000.00,-1000.00,0.00,165.40,834.60,0.11,0
6412,821,-1000.00,-1000.00,0.00,0.00,1000.00,0.24,0
6413,822,0.00,0.00,1000.00,0.00,0.00,0.06,0
6414,822,-1000.00,-1000.00,0.00,552.91,447.09,0.23,0
6415,823,-561.76,-561.76,438.24,150.68,411.08,0.30,0
6416,823,-438.24,-1000.00,0.00,219.12,219.12,0.07,0
6417,824,-1000.00,-1000.00,0.00,500.00,500.00,0.13,0
6418,825,-1000.00,-1000.00,0.00,154.82,845.18,0.22,0
6419,826,-1000.00,-1000.00,0.00,79.48,920.52,0.24,0
6420,827,-963.25,-963.25,36.75,344.97,618.28,0.33,0
6421,827,-8.81,-972.05,27.95,0.00,8.81,0.16,0
6422,827,-95.49,-1067.54,-67.54,0.42,0.00,0.06,0
6423,828,1000.00,1000.00,2000.00,19.38,400.34,0.30,1
6424,828,1000.00,2000.00,3000.00,1000.00,1000.00,0.04,1
6425,828,1000.00,3000.00,4000.00,0.00,3000.00,0.07,1
6426,828,1000.00,4000.00,5000.00,0.00,3324.81,0.42,1
6427,828,1000.00,5000.00,6000.00,0.00,4092.32,0.29,1
6428,828,1000.00,6000.00,7000.00,3000.00,3000.00,0.06,1
6429,828,1000.00,7000.00,8000.00,0.00,2749.05,0.02,1
6430,828,1000.00,8000.00,9000.00,1031.31,6968.69,0.41,1
6431,828,1000.00,9000.00,10000.00,0.00,4512.73,0.22,1
6432,828,1000.00,10000.00,11000.00,0.00,10000.00,0.15,1
6433,828,1000.00,11000.00,12000.00,4399.75,6600.25,0.33,1
6434,828,-1000.00,10000.00,11000.00,2759.68,0.00,0.05,0
6435,828,1000.00,11000.00,12000.00,688.13,8797.14,0.40,1
6436,828,1000.00,12000.00,13000.00,1357.43,10642.57,0.37,1
6437,828,1000.00,13000.00,14000.00,3690.83,5402.96,0.29,1
6438,828,1000.00,14000.00,15000.00,7000.00,7000.00,0.11,1
6439,828,-1000.00,13000.00,14000.00,9486.36,0.00,0.09,0
6440,828,1000.00,14000.00,15000.00,0.00,14000.00,0.03,1
6441,828,1000.00,15000.00,16000.00,5614.31,9385.69,0.38,1
6442,828,1000.00,16000.00,17000.00,0.00,5764.84,0.21,1
6443,828,1000.00,17000.00,18000.00,0.00,13262.65,0.19,1
6444,828,1000.00,18000.00,19000.00,7895.20,10104.80,0.23,1
6445,828,0.00,18000.00,19000.00,0.00,0.00,0.03,0
6446,828,-1000.00,17000.00,18000.00,12942.83,6057.17,0.09,0
6447,828,1000.00,18000.00,19000.00,1836.74,16163.26,0.02,1
6448,828,-1000.00,17000.00,18000.00,9825.75,9174.25,0.18,0
6449,828,1000.00,18000.00,19000.00,5247.82,12752.18,0.36,1
6450,828,1000.00,19000.00,20000.00,5459.22,13540.78,0.40,1
6451,828,1000.00,20000.00,21000.00,10000.00,10000.00,0.17,1
6452,828,1000.00,21000.00,22000.00,0.00,10168.88,0.21,1
6453,828,1000.00,22000.00,23000.00,10068.39,11931.61,0.39,1
6454,828,1000.00,23000.00,24000.00,8496.32,14503.68,0.37,1
6455,828,1000.00,24000.00,25000.00,8854.34,15145.66,0.36,1
6456,828,1000.00,25000.00,26000.00,635.68,8402.75,0.29,1
6457,828,1000.00,26000.00,27000.00,10507.32,15492.68,0.15,1
6458,828,1000.00,27000.00,28000.00,7631.00,19369.00,0.33,1
6459,828,1000.00,28000.00,29000.00,5315.29,22684.71,0.22,1
6460,828,1000.00,29000.00,30000.00,8839.48,20160.52,0.38,1
6461,828,1000.00,30000.00,31000.00,12687.07,17312.93,0.06,1
6462,829,-1000.00,-1000.00,0.00,0.00,1000.00,0.05,0
6463,830,-1000.00,-1000.00,0.00,107.28,892.72,0.43,0
6464,831,1000.00,1000.00,2000.00,0.00,165.35,0.07,1
6465,831,1000.00,2000.00,3000.00,0.00,717.43,0.13,1
6466,831,1000.00,3000.00,4000.00,391.32,2608.68,0.41,1
6467,831,1000.00,4000.00,5000.00,1090.32,2903.65,0.40,1
6468,831,-1000.00,3000.00,4000.00,5000.00,0.00,0.02,0
6469,831,1000.00,4000.00,5000.00,1844.00,2156.00,0.38,1
6470,831,1000.00,5000.00,6000.00,0.00,5000.00,0.03,1
6471,831,1000.00,6000.00,7000.00,1880.19,2794.57,0.30,1
6472,831,1000.00,7000.00,8000.00,198.87,2468.00,0.25,1
6473,831,1000.00,8000.00,9000.00,0.00,7808.07,0.23,1
6474,831,1000.00,9000.00,10000.00,0.00,9000.00,0.15,1
6475,831,1000.00,10000.00,11000.00,0.00,9019.92,0.31,1
6476,831,1000.00,11000.00,12000.00,466.15,10533.85,0.28,1
6477,831,1000.00,12000.00,13000.00,0.00,8790.80,0.34,1
6478,831,1000.00,13000.00,14000.00,0.00,3905.49,0.11,1
6479,831,-1000.00,12000.00,13000.00,12170.19,1829.81,0.14,0
6480,831,-1000.00,11000.00,12000.00,12053.97,946.03,0.09,0
6481,831,1000.00,12000.00,13000.00,0.00,12000.00,0.20,1
6482,831,1000.00,13000.00,14000.00,0.00,13000.00,0.28,1
6483,831,-1000.00,12000.00,13000.00,7484.73,6515.27,0.31,0
6484,831,-1000.00,11000.00,12000.00,7340.65,5659.35,0.13,0
6485,831,-1000.00,10000.00,11000.00,0.00,12000.00,0.16,0
6486,831,-1000.00,9000.00,10000.00,3391.85,7608.15,0.38,0
6487,831,-1000.00,8000.00,9000.00,5675.49,4324.51,0.29,0
6488,831,-1000.00,7000.00,8000.00,0.00,3658.85,0.24,0
6489,831,-1000.00,6000.00,7000.00,1484.32,2099.56,0.28,0
6490,831,-1000.00,5000.00,6000.00,3489.66,3510.34,0.23,0
6491,831,-1000.00,4000.00,5000.00,1024.20,2339.03,0.35,0
6492,831,-1000.00,3000.00,4000.00,850.84,4149.16,0.40,0
6493,831,-991.18,2008.82,3008.82,0.00,991.18,0.00,0
6494,831,-1000.00,1008.82,2008.82,0.00,2847.32,0.20,0
6495,831,-1000.00,8.82,1008.82,483.00,0.00,0.11,0
6496,831,-506.43,-497.61,502.39,0.00,506.43,0.27,0
6497,831,-502.39,-1000.00,0.00,112.70,389.69,0.32,0
6498,832,-1000.00,-1000.00,0.00,557.25,442.75,0.25,0
6499,833,-1000.00,-1000.00,0.00,448.97,551.03,0.01,0
6500,834,-726.64,-726.64,273.36,245.73,480.91,0.39,0
6501,834,-235.47,-962.11,37.89,0.00,235.47,0.09,0
6502,834,-10.89,-973.00,27.00,0.00,10.89,0.26,0
6503,834,1000.00,27.00,1027.00,14.07,0.00,0.27,1
6504,834,1000.00,1027.00,2027.00,983.17,34.22,0.09,1
6505,834,-1000.00,27.00,1027.00,455.18,1571.82,0.20,0
6506,834,-1000.00,-973.00,27.00,409.08,617.91,0.09,0
6507,834,-15.39,-988.39,11.61,0.00,15.39,0.15,0
6508,834,-7.41,-995.80,4.20,0.00,7.41,0.42,0
6509,834,335.62,-660.19,339.81,1.45,0.00,0.25,1
6510,834,-339.81,-1000.00,0.00,0.00,339.81,0.25,0
6511,835,1000.00,1000.00,2000.00,463.64,536.36,0.09,1
6512,835,1000.00,2000.00,3000.00,0.00,1563.86,0.06,1
6513,835,1000.00,3000.00,4000.00,638.31,2361.69,0.24,1
6514,835,1000.00,4000.00,5000.00,0.00,2626.66,0.39,1
6515,835,1000.00,5000.00,6000.00,0.00,3953.71,0.36,1
6516,835,1000.00,6000.00,7000.00,0.00,5896.06,0.30,1
6517,835,1000.00,7000.00,8000.00,3178.65,3821.35,0.35,1
6518,835,1000.00,8000.00,9000.00,725.10,3045.72,0.23,1
6519,835,1000.00,9000.00,10000.00,0.00,2266.63,0.18,1
6520,835,-1000.00,8000.00,9000.00,5205.93,4794.07,0.35,0
6521,835,1000.00,9000.00,10000.00,0.00,9000.00,0.14,1
6522,835,1000.00,10000.00,11000.00,0.00,2651.00,0.18,1
6523,835,-1000.00,9000.00,10000.00,5670.01,5329.99,0.38,0
6524,835,1000.00,10000.00,11000.00,0.00,10000.00,0.29,1
6525,835,1000.00,11000.00,12000.00,2359.42,8640.58,0.44,1
6526,835,1000.00,12000.00,13000.00,2571.58,9428.42,0.42,1
6527,835,1000.00,13000.00,14000.00,6489.15,6510.85,0.26,1
6528,835,1000.00,14000.00,15000.00,5250.00,8750.00,0.37,1
6529,835,-1000.00,13000.00,14000.00,6109.48,8890.52,0.26,0
6530,835,-1000.00,12000.00,13000.00,0.00,14000.00,0.35,0
6531,835,-1000.00,11000.00,12000.00,0.00,3878.63,0.04,0
6532,835,-1000.00,10000.00,11000.00,5006.85,6993.15,0.27,0
6533,835,-1000.00,9000.00,10000.00,0.00,123.89,0.29,0
6534,835,-1000.00,8000.00,9000.00,10000.00,0.00,0.02,0
6535,835,1000.00,9000.00,10000.00,0.00,9000.00,0.16,1
6536,835,-1000.00,8000.00,9000.00,10000.00,0.00,0.04,0
6537,835,1000.00,9000.00,10000.00,0.00,9000.00,0.21,1
6538,835,1000.00,10000.00,11000.00,0.00,4935.17,0.07,1
6539,835,1000.00,11000.00,12000.00,1427.15,9572.85,0.37,1
6540,835,-1000.00,10000.00,11000.00,3111.97,2120.62,0.19,0
6541,835,1000.00,11000.00,12000.00,0.00,2597.40,0.18,1
6542,835,-1000.00,10000.00,11000.00,6623.18,5376.82,0.06,0
6543,835,-1000.00,9000.00,10000.00,5697.74,5302.26,0.21,0
6544,835,1000.00,10000.00,11000.00,4954.61,5045.39,0.05,1
6545,835,1000.00,11000.00,12000.00,0.00,11000.00,0.34,1
6546,835,1000.00,12000.00,13000.00,1813.20,10186.80,0.36,1
6547,835,1000.00,13000.00,14000.00,0.00,13000.00,0.24,1
6548,835,-1000.00,12000.00,13000.00,9894.91,1533.26,0.11,0
6549,835,1000.00,13000.00,14000.00,0.00,13000.00,0.19,1
6550,835,1000.00,14000.00,15000.00,5735.14,8264.86,0.40,1
6551,835,1000.00,15000.00,16000.00,7305.15,7694.85,0.01,1
6552,835,1000.00,16000.00,17000.00,0.00,16000.00,0.22,1
6553,835,1000.00,17000.00,18000.00,0.00,15365.68,0.02,1
6554,835,1000.00,18000.00,19000.00,0.00,18000.00,0.42,1
6555,835,1000.00,19000.00,20000.00,2866.29,16133.71,0.15,1
6556,835,1000.00,20000.00,21000.00,7189.21,12810.79,0.39,1
6557,835,1000.00,21000.00,22000.00,1611.54,19388.46,0.37,1
6558,836,1000.00,1000.00,2000.00,500.00,500.00,0.08,1
6559,836,1000.00,2000.00,3000.00,0.00,998.42,0.12,1
6560,836,1000.00,3000.00,4000.00,1444.10,1555.90,0.05,1
6561,836,1000.00,4000.00,5000.00,0.00,4000.00,0.35,1
6562,836,1000.00,5000.00,6000.00,2500.00,2500.00,0.01,1
6563,836,1000.00,6000.00,7000.00,2520.63,3479.37,0.36,1
6564,836,1000.00,7000.00,8000.00,0.00,4027.65,0.24,1
6565,836,1000.00,8000.00,9000.00,0.00,5600.09,0.40,1
6566,836,1000.00,9000.00,10000.00,4500.00,4500.00,0.09,1
6567,836,1000.00,10000.00,11000.00,0.00,10000.00,0.14,1
6568,836,1000.00,11000.00,12000.00,2543.85,8456.15,0.39,1
6569,836,1000.00,12000.00,13000.00,4162.57,7837.43,0.37,1
6570,836,1000.00,13000.00,14000.00,3302.73,9697.27,0.35,1
6571,836,1000.00,14000.00,15000.00,3967.19,10032.81,0.35,1
6572,836,-1000.00,13000.00,14000.00,11600.15,3399.85,0.00,0
6573,836,1000.00,14000.00,15000.00,3444.65,9791.60,0.40,1
6574,836,1000.00,15000.00,16000.00,5644.45,8011.28,0.34,1
6575,836,1000.00,16000.00,17000.00,2655.75,13344.25,0.31,1
6576,836,-1000.00,15000.00,16000.00,4540.24,0.00,0.05,0
6577,836,-1000.00,14000.00,15000.00,8735.91,7264.09,0.27,0
6578,836,-1000.00,13000.00,14000.00,13205.35,1794.65,0.02,0
6579,836,1000.00,14000.00,15000.00,0.00,10368.79,0.18,1
6580,836,1000.00,15000.00,16000.00,7450.91,7549.09,0.25,1
6581,836,-1000.00,14000.00,15000.00,11034.33,4965.67,0.07,0
6582,836,-1000.00,13000.00,14000.00,7966.24,7033.76,0.31,0
6583,836,1000.00,14000.00,15000.00,0.00,5600.88,0.29,1
6584,836,1000.00,15000.00,16000.00,0.00,15000.00,0.27,1
6585,836,1000.00,16000.00,17000.00,0.00,16000.00,0.40,1
6586,836,1000.00,17000.00,18000.00,0.00,15794.13,0.25,1
6587,836,1000.00,18000.00,19000.00,5119.09,12880.91,0.32,1
6588,836,1000.00,19000.00,20000.00,6398.20,12601.80,0.31,1
6589,836,1000.00,20000.00,21000.00,141.69,19858.31,0.35,1
6590,836,1000.00,21000.00,22000.00,0.00,12971.95,0.28,1
6591,836,-1000.00,20000.00,21000.00,13767.69,8232.31,0.25,0
6592,836,1000.00,21000.00,22000.00,2315.44,9737.90,0.30,1
6593,836,-1000.00,20000.00,21000.00,14576.20,0.00,0.09,0
6594,836,-1000.00,19000.00,20000.00,11694.06,9305.94,0.37,0
6595,836,1000.00,20000.00,21000.00,5049.29,14950.71,0.23,1
6596,836,1000.00,21000.00,22000.00,8750.61,12249.39,0.14,1
6597,836,1000.00,22000.00,23000.00,11000.00,11000.00,0.07,1
6598,836,1000.00,23000.00,24000.00,0.00,16214.02,0.28,1
6599,836,1000.00,24000.00,25000.00,11097.05,12902.95,0.30,1
6600,836,1000.00,25000.00,26000.00,12500.00,12500.00,0.22,1
6601,836,1000.00,26000.00,27000.00,2081.08,23918.92,0.21,1
6602,836,1000.00,27000.00,28000.00,13500.00,13500.00,0.21,1
6603,836,1000.00,28000.00,29000.00,0.00,28000.00,0.16,1
6604,836,-1000.00,27000.00,28000.00,11800.36,10239.23,0.23,0
6605,836,1000.00,28000.00,29000.00,13831.51,14168.49,0.14,1
6606,836,-1000.00,27000.00,28000.00,14848.62,0.00,0.07,0
6607,836,-1000.00,26000.00,27000.00,13599.33,14400.67,0.13,0
6608,836,-1000.00,25000.00,26000.00,2665.95,13419.23,0.35,0
6609,836,-1000.00,24000.00,25000.00,7262.18,0.00,0.07,0
6610,836,-1000.00,23000.00,24000.00,0.00,25000.00,0.17,0
6611,836,-1000.00,22000.00,23000.00,12000.00,12000.00,0.02,0
6612,836,-1000.00,21000.00,22000.00,6627.55,16372.45,0.43,0
6613,836,-1000.00,20000.00,21000.00,0.00,18686.21,0.43,0
6614,836,-1000.00,19000.00,20000.00,0.00,21000.00,0.04,0
6615,836,-1000.00,18000.00,19000.00,0.00,4076.79,0.20,0
6616,836,-1000.00,17000.00,18000.00,3.70,17098.00,0.42,0
6617,836,-1000.00,16000.00,17000.00,380.54,13646.76,0.44,0
6618,836,-1000.00,15000.00,16000.00,6023.21,10976.79,0.12,0
6619,836,-1000.00,14000.00,15000.00,1041.99,14958.01,0.25,0
6620,836,-1000.00,13000.00,14000.00,2276.87,9267.41,0.39,0
6621,836,-1000.00,12000.00,13000.00,3003.71,10996.29,0.44,0
6622,836,-1000.00,11000.00,12000.00,4800.41,0.00,0.16,0
6623,836,-1000.00,10000.00,11000.00,12000.00,0.00,0.02,0
6624,836,-1000.00,9000.00,10000.00,4987.34,6012.66,0.32,0
6625,836,-1000.00,8000.00,9000.00,3972.32,0.00,0.14,0
6626,836,-1000.00,7000.00,8000.00,0.00,8596.36,0.30,0
6627,836,0.00,7000.00,8000.00,0.00,0.00,0.00,0
6628,836,-1000.00,6000.00,7000.00,1797.49,3918.51,0.37,0
6629,837,1000.00,1000.00,2000.00,396.57,603.43,0.09,1
6630,837,1000.00,2000.00,3000.00,0.00,611.33,0.15,1
6631,837,1000.00,3000.00,4000.00,1500.00,1500.00,0.02,1
6632,837,1000.00,4000.00,5000.00,0.00,4000.00,0.25,1
6633,837,-1000.00,3000.00,4000.00,2865.78,1713.45,0.21,0
6634,837,-1000.00,2000.00,3000.00,2160.83,1839.17,0.27,0
6635,837,1000.00,3000.00,4000.00,0.00,68.75,0.01,1
6636,837,1000.00,4000.00,5000.00,0.00,974.98,0.14,1
6637,837,1000.00,5000.00,6000.00,0.00,5000.00,0.10,1
6638,837,-1000.00,4000.00,5000.00,2856.22,2426.60,0.26,0
6639,837,1000.00,5000.00,6000.00,2117.94,2882.06,0.37,1
6640,837,1000.00,6000.00,7000.00,0.00,5559.15,0.24,1
6641,837,1000.00,7000.00,8000.00,181.51,6194.21,0.42,1
6642,837,-1000.00,6000.00,7000.00,4153.96,3846.04,0.21,0
6643,837,1000.00,7000.00,8000.00,875.72,6124.28,0.36,1
6644,837,1000.00,8000.00,9000.00,4833.20,3166.80,0.37,1
6645,837,-1000.00,7000.00,8000.00,0.00,9000.00,0.29,0
6646,837,-1000.00,6000.00,7000.00,2417.32,5582.68,0.31,0
6647,837,0.00,6000.00,7000.00,0.00,0.00,0.06,0
6648,837,1000.00,7000.00,8000.00,3652.76,3347.24,0.09,1
6649,837,-1000.00,6000.00,7000.00,4000.00,4000.00,0.09,0
6650,837,-1000.00,5000.00,6000.00,0.00,5915.13,0.10,0
6651,837,-1000.00,4000.00,5000.00,163.86,4975.68,0.40,0
6652,837,1000.00,5000.00,6000.00,3069.01,1930.99,0.26,1
6653,837,-1000.00,4000.00,5000.00,1101.32,4898.68,0.34,0
6654,837,-1000.00,3000.00,4000.00,0.00,4610.31,0.44,0
6655,837,-1000.00,2000.00,3000.00,0.00,3356.85,0.40,0
6656,837,-78.28,1921.72,2921.72,0.00,78.28,0.07,0
6657,837,-1000.00,921.72,1921.72,0.00,2921.72,0.30,0
6658,837,-1000.00,-78.28,921.72,64.89,1856.83,0.42,0
6659,837,-921.72,-1000.00,0.00,434.00,487.72,0.20,0
6660,838,-1000.00,-1000.00,0.00,451.13,548.87,0.23,0
6661,839,-1000.00,-1000.00,0.00,0.00,1000.00,0.18,0
6662,840,-1000.00,-1000.00,0.00,258.23,741.77,0.20,0
6663,840,0.00,-1000.00,0.00,0.00,0.00,0.14,0
6664,840,0.00,-1000.00,0.00,0.00,0.00,0.25,1
6665,840,-0.00,-1000.00,0.00,0.00,0.00,0.25,0
6666,840,0.00,-1000.00,0.00,0.00,0.00,0.17,1
6667,840,0.00,-1000.00,0.00,0.00,0.00,0.14,1
6668,840,-0.00,-1000.00,0.00,0.00,0.00,0.31,0
6669,840,-0.00,-1000.00,0.00,0.00,0.00,0.38,0
6670,840,-0.00,-1000.00,0.00,0.00,0.00,0.39,0
6671,840,0.00,-1000.00,0.00,0.00,0.00,0.23,1
6672,840,0.00,-1000.00,0.00,0.00,0.00,0.24,0
6673,840,0.00,-1000.00,0.00,0.00,0.00,0.20,1
6674,840,-0.00,-1000.00,0.00,0.00,0.00,0.31,0
6675,840,0.00,-1000.00,0.00,0.00,0.00,0.02,0
6676,840,-0.00,-1000.00,0.00,0.00,0.00,0.24,0
6677,840,-0.00,-1000.00,0.00,0.00,0.00,0.31,0
6678,841,-1000.00,-1000.00,0.00,245.10,754.90,0.40,0
6679,842,-1000.00,-1000.00,0.00,598.24,401.76,0.23,0
6680,843,-301.88,-301.88,698.12,0.00,301.88,0.09,0
6681,843,-698.12,-1000.00,0.00,75.16,622.96,0.33,0
6682,844,-647.54,-647.54,352.46,195.37,452.17,0.33,0
6683,844,-1000.00,-1647.54,-647.54,233.26,114.16,0.16,0
6684,845,-1000.00,-1000.00,0.00,55.15,648.08,0.42,0
6685,846,-1000.00,-1000.00,0.00,375.65,624.35,0.00,0
6686,847,1000.00,1000.00,2000.00,0.00,100.83,0.00,1
6687,847,1000.00,2000.00,3000.00,1000.00,1000.00,0.02,1
6688,847,1000.00,3000.00,4000.00,0.00,3000.00,0.25,1
6689,847,1000.00,4000.00,5000.00,0.00,4000.00,0.26,1
6690,847,1000.00,5000.00,6000.00,0.00,5000.00,0.04,1
6691,847,1000.00,6000.00,7000.00,1483.49,3566.08,0.37,1
6692,847,1000.00,7000.00,8000.00,0.00,7000.00,0.39,1
6693,847,-1000.00,6000.00,7000.00,4406.32,3593.68,0.21,0
6694,847,1000.00,7000.00,8000.00,0.00,7000.00,0.00,1
6695,847,1000.00,8000.00,9000.00,0.00,293.04,0.12,1
6696,847,1000.00,9000.00,10000.00,0.00,7013.49,0.17,1
6697,847,1000.00,10000.00,11000.00,4759.24,5240.76,0.16,1
6698,847,1000.00,11000.00,12000.00,0.00,11000.00,0.01,1
6699,847,1000.00,12000.00,13000.00,0.00,12000.00,0.17,1
6700,847,1000.00,13000.00,14000.00,0.00,13000.00,0.17,1
6701,847,1000.00,14000.00,15000.00,0.00,9594.73,0.27,1
6702,847,1000.00,15000.00,16000.00,4015.59,10984.41,0.38,1
6703,847,1000.00,16000.00,17000.00,5173.36,10826.64,0.30,1
6704,847,1000.00,17000.00,18000.00,4930.17,11693.36,0.41,1
6705,847,1000.00,18000.00,19000.00,0.00,45.64,0.07,1
6706,847,1000.00,19000.00,20000.00,9500.00,9500.00,0.04,1
6707,847,1000.00,20000.00,21000.00,3784.20,10117.69,0.42,1
6708,847,1000.00,21000.00,22000.00,7700.49,13299.51,0.36,1
6709,847,-1000.00,20000.00,21000.00,11417.50,10582.50,0.06,0
6710,847,1000.00,21000.00,22000.00,6028.72,14971.28,0.43,1
6711,847,1000.00,22000.00,23000.00,0.00,1472.43,0.17,1
6712,847,1000.00,23000.00,24000.00,10473.57,12526.43,0.28,1
6713,847,-1000.00,22000.00,23000.00,14560.86,9439.14,0.03,0
6714,847,1000.00,23000.00,24000.00,986.86,20446.02,0.27,1
6715,847,1000.00,24000.00,25000.00,0.00,18722.75,0.25,1
6716,847,1000.00,25000.00,26000.00,0.00,25000.00,0.04,1
6717,847,1000.00,26000.00,27000.00,0.00,26000.00,0.18,1
6718,847,-1000.00,25000.00,26000.00,24381.27,2618.73,0.15,0
6719,847,1000.00,26000.00,27000.00,6038.04,19961.96,0.31,1
6720,847,0.00,26000.00,27000.00,0.00,0.00,0.07,0
6721,847,1000.00,27000.00,28000.00,0.00,27000.00,0.34,1
6722,847,-1000.00,26000.00,27000.00,7214.11,0.00,0.10,0
6723,847,1000.00,27000.00,28000.00,1240.24,21703.82,0.43,1
6724,847,1000.00,28000.00,29000.00,0.00,28000.00,0.15,1
6725,847,1000.00,29000.00,30000.00,2814.24,19770.83,0.30,1
6726,847,1000.00,30000.00,31000.00,5123.62,5732.07,0.19,1
6727,847,1000.00,31000.00,32000.00,0.00,31000.00,0.16,1
6728,847,1000.00,32000.00,33000.00,9611.95,22388.05,0.20,1
6729,847,1000.00,33000.00,34000.00,0.00,26553.70,0.38,1
6730,847,1000.00,34000.00,35000.00,0.00,34000.00,0.08,1
6731,847,-1000.00,33000.00,34000.00,35000.00,0.00,0.00,0
6732,847,1000.00,34000.00,35000.00,0.00,34000.00,0.14,1
6733,847,1000.00,35000.00,36000.00,16147.36,18852.64,0.22,1
6734,848,-1000.00,-1000.00,0.00,155.97,844.03,0.07,0
6735,849,-636.36,-636.36,363.64,0.00,636.36,0.30,0
6736,849,-179.23,-815.60,184.40,0.00,179.23,0.29,0
6737,849,-184.40,-1000.00,0.00,0.00,184.40,0.20,0
6738,850,-1000.00,-1000.00,0.00,4.82,824.07,0.44,0
6739,851,-1000.00,-1000.00,0.00,0.00,1000.00,0.09,0
6740,852,-1000.00,-1000.00,0.00,0.00,1000.00,0.05,0
6741,853,-1000.00,-1000.00,0.00,190.40,689.62,0.42,0
6742,854,-695.69,-695.69,304.31,0.00,695.69,0.03,0
6743,854,-92.44,-788.13,211.87,0.00,92.44,0.32,0
6744,854,1000.00,211.87,1211.87,68.59,0.00,0.20,1
6745,854,1000.00,1211.87,2211.87,795.43,150.53,0.18,1
6746,854,-1000.00,211.87,1211.87,744.79,1467.09,0.12,0
6747,854,-605.78,-393.90,606.10,0.00,605.78,0.35,0
6748,854,-388.90,-782.81,217.19,0.00,388.90,0.27,0
6749,854,-217.19,-1000.00,0.00,68.70,148.49,0.20,0
6750,854,-0.00,-1000.00,0.00,0.00,0.00,0.34,0
6751,855,-916.19,-916.19,83.81,0.00,916.19,0.40,0
6752,855,1000.00,83.81,1083.81,19.30,3.38,0.19,1
6753,855,-1000.00,-916.19,83.81,238.13,845.68,0.25,0
6754,855,1000.00,83.81,1083.81,32.64,12.53,0.22,1
6755,855,1000.00,1083.81,2083.81,1083.81,0.00,0.02,1
6756,855,-1000.00,83.81,1083.81,727.77,1356.04,0.29,0
6757,855,-1000.00,-916.19,83.81,514.39,569.41,0.22,0
6758,855,1000.00,83.81,1083.81,61.31,0.00,0.01,1
6759,855,-356.97,-273.17,726.83,0.00,356.97,0.31,0
6760,855,-663.67,-936.83,63.17,0.00,663.67,0.18,0
6761,855,-63.17,-1000.00,0.00,31.58,31.58,0.03,0
6762,856,1000.00,1000.00,2000.00,0.00,783.14,0.42,1
6763,856,1000.00,2000.00,3000.00,0.00,712.35,0.14,1
6764,856,0.00,2000.00,3000.00,0.00,0.00,0.10,0
6765,856,1000.00,3000.00,4000.00,233.73,2766.27,0.25,1
6766,856,1000.00,4000.00,5000.00,0.00,668.64,0.17,1
6767,856,-1000.00,3000.00,4000.00,1078.47,576.91,0.16,0
6768,856,1000.00,4000.00,5000.00,0.00,4000.00,0.34,1
6769,856,1000.00,5000.00,6000.00,417.26,4582.74,0.43,1
6770,856,-1000.00,4000.00,5000.00,2298.81,479.77,0.14,0
6771,856,1000.00,5000.00,6000.00,1709.86,3290.14,0.29,1
6772,856,-1000.00,4000.00,5000.00,3933.99,2066.01,0.06,0
6773,856,1000.00,5000.00,6000.00,0.00,1458.75,0.07,1
6774,856,1000.00,6000.00,7000.00,1982.13,4017.87,0.23,1
6775,856,1000.00,7000.00,8000.00,0.00,7000.00,0.29,1
6776,856,-1000.00,6000.00,7000.00,5006.00,0.00,0.09,0
6777,856,1000.00,7000.00,8000.00,0.00,2590.34,0.22,1
6778,856,-1000.00,6000.00,7000.00,6166.27,1833.73,0.13,0
6779,856,1000.00,7000.00,8000.00,0.00,6301.23,0.40,1
6780,856,1000.00,8000.00,9000.00,1268.40,6724.91,0.44,1
6781,856,1000.00,9000.00,10000.00,0.00,9000.00,0.06,1
6782,856,1000.00,10000.00,11000.00,4342.10,5657.90,0.03,1
6783,856,1000.00,11000.00,12000.00,0.00,8569.57,0.37,1
6784,856,-1000.00,10000.00,11000.00,10403.44,1596.56,0.09,0
6785,856,-1000.00,9000.00,10000.00,0.00,10905.57,0.35,0
6786,856,-1000.00,8000.00,9000.00,5671.74,4328.26,0.11,0
6787,856,-1000.00,7000.00,8000.00,3488.65,1026.32,0.15,0
6788,856,-1000.00,6000.00,7000.00,0.00,6202.35,0.39,0
6789,856,-1000.00,5000.00,6000.00,3145.28,77.76,0.13,0
6790,856,-1000.00,4000.00,5000.00,0.00,6000.00,0.22,0
6791,856,-1000.00,3000.00,4000.00,2500.00,2500.00,0.25,0
6792,856,-1000.00,2000.00,3000.00,0.00,4000.00,0.25,0
6793,856,-1000.00,1000.00,2000.00,1024.74,1975.26,0.42,0
6794,856,-1000.00,0.00,1000.00,981.53,1018.47,0.29,0
6795,856,-1000.00,-1000.00,0.00,526.46,0.00,0.04,0
6796,857,1000.00,1000.00,2000.00,0.00,667.56,0.33,1
6797,857,1000.00,2000.00,3000.00,343.39,1656.61,0.35,1
6798,857,1000.00,3000.00,4000.00,1261.83,1738.17,0.33,1
6799,857,1000.00,4000.00,5000.00,1778.97,2221.03,0.22,1
6800,857,1000.00,5000.00,6000.00,0.00,4017.52,0.18,1
6801,857,1000.00,6000.00,7000.00,0.00,1820.47,0.07,1
6802,857,1000.00,7000.00,8000.00,1456.52,2680.92,0.27,1
6803,857,1000.00,8000.00,9000.00,753.62,5401.80,0.39,1
6804,857,1000.00,9000.00,10000.00,0.00,9000.00,0.37,1
6805,857,1000.00,10000.00,11000.00,4212.21,4964.42,0.28,1
6806,857,1000.00,11000.00,12000.00,1761.91,5878.07,0.36,1
6807,857,1000.00,12000.00,13000.00,0.00,11219.62,0.42,1
6808,857,-1000.00,11000.00,12000.00,7856.10,5143.90,0.12,0
6809,857,1000.00,12000.00,13000.00,0.00,9817.71,0.42,1
6810,857,1000.00,13000.00,14000.00,0.00,10020.00,0.09,1
6811,857,1000.00,14000.00,15000.00,1505.34,12494.66,0.37,1
6812,857,1000.00,15000.00,16000.00,7500.00,7500.00,0.08,1
6813,857,1000.00,16000.00,17000.00,4823.66,11176.34,0.11,1
6814,857,1000.00,17000.00,18000.00,8500.00,8500.00,0.17,1
6815,857,1000.00,18000.00,19000.00,5626.10,12373.90,0.38,1
6816,857,1000.00,19000.00,20000.00,4147.89,14852.11,0.42,1
6817,857,-1000.00,18000.00,19000.00,12015.62,7984.38,0.02,0
6818,857,1000.00,19000.00,20000.00,5367.13,13632.87,0.42,1
6819,857,1000.00,20000.00,21000.00,2021.93,17978.07,0.36,1
6820,857,1000.00,21000.00,22000.00,10500.00,10500.00,0.10,1
6821,857,1000.00,22000.00,23000.00,0.00,11498.21,0.34,1
6822,857,1000.00,23000.00,24000.00,9194.39,13805.61,0.13,1
6823,857,-1000.00,22000.00,23000.00,14924.81,9075.19,0.21,0
6824,857,1000.00,23000.00,24000.00,0.00,23000.00,0.20,1
6825,857,1000.00,24000.00,25000.00,3235.52,20764.48,0.43,1
6826,857,1000.00,25000.00,26000.00,2928.08,22071.92,0.18,1
6827,857,1000.00,26000.00,27000.00,870.30,13819.90,0.24,1
6828,857,1000.00,27000.00,28000.00,13500.00,13500.00,0.06,1
6829,857,1000.00,28000.00,29000.00,0.00,9410.48,0.26,1
6830,857,1000.00,29000.00,30000.00,12701.84,16298.16,0.33,1
6831,857,1000.00,30000.00,31000.00,0.00,796.56,0.11,1
6832,857,-1000.00,29000.00,30000.00,12781.48,18218.52,0.43,0
6833,858,-1000.00,-1000.00,0.00,865.57,134.43,0.03,0
6834,859,-1000.00,-1000.00,0.00,304.38,695.62,0.33,0
6835,860,-936.78,-936.78,63.22,0.00,936.78,0.39,0
6836,860,-63.22,-1000.00,0.00,0.00,63.22,0.15,0
6837,861,1000.00,1000.00,2000.00,0.00,118.03,0.04,1
6838,861,-1000.00,0.00,1000.00,1061.11,938.89,0.18,0
6839,861,1000.00,1000.00,2000.00,320.69,679.31,0.43,1
6840,861,-1000.00,0.00,1000.00,1103.05,896.95,0.04,0
6841,861,1000.00,1000.00,2000.00,0.00,1000.00,0.37,1
6842,861,1000.00,2000.00,3000.00,134.03,1865.97,0.26,1
6843,861,1000.00,3000.00,4000.00,772.03,2227.97,0.13,1
6844,861,1000.00,4000.00,5000.00,999.23,3000.77,0.39,1
6845,861,-1000.00,3000.00,4000.00,2405.43,989.68,0.19,0
6846,861,0.00,3000.00,4000.00,0.00,0.00,0.03,0
6847,861,1000.00,4000.00,5000.00,0.00,4000.00,0.15,1
6848,861,-1000.00,3000.00,4000.00,4729.38,270.62,0.06,0
6849,861,1000.00,4000.00,5000.00,0.00,2304.03,0.17,1
6850,861,1000.00,5000.00,6000.00,2500.00,2500.00,0.00,1
6851,861,-1000.00,4000.00,5000.00,1445.15,990.43,0.16,0
6852,861,1000.00,5000.00,6000.00,0.00,5000.00,0.00,1
6853,861,1000.00,6000.00,7000.00,3000.00,3000.00,0.20,1
6854,861,1000.00,7000.00,8000.00,3024.97,3975.03,0.36,1
6855,861,-1000.00,6000.00,7000.00,4470.77,3529.23,0.07,0
6856,861,1000.00,7000.00,8000.00,850.42,6149.58,0.23,1
6857,861,1000.00,8000.00,9000.00,0.00,6270.93,0.28,1
6858,861,1000.00,9000.00,10000.00,2424.45,4111.15,0.30,1
6859,861,-1000.00,8000.00,9000.00,1566.67,8433.33,0.21,0
6860,861,-1000.00,7000.00,8000.00,4908.35,450.12,0.09,0
6861,861,0.00,7000.00,8000.00,0.00,0.00,0.05,0
6862,861,-1000.00,6000.00,7000.00,2769.84,5230.16,0.23,0
6863,861,-1000.00,5000.00,6000.00,3500.00,3500.00,0.21,0
6864,861,-1000.00,4000.00,5000.00,3000.00,3000.00,0.04,0
6865,861,-1000.00,3000.00,4000.00,2919.38,2080.62,0.23,0
6866,861,-1000.00,2000.00,3000.00,0.00,3419.61,0.05,0
6867,861,-1000.00,1000.00,2000.00,1607.63,1392.37,0.13,0
6868,861,-1000.00,0.00,1000.00,574.79,1425.21,0.37,0
6869,861,-1000.00,-1000.00,0.00,138.18,861.82,0.11,0
6870,861,-0.00,-1000.00,0.00,0.00,0.00,0.38,0
6871,862,-1000.00,-1000.00,0.00,423.57,383.81,0.24,0
6872,863,-1000.00,-1000.00,0.00,538.21,461.79,0.22,0
6873,864,-348.04,-348.04,651.96,158.02,190.02,0.41,0
6874,864,0.00,-348.04,651.96,0.00,0.00,0.03,0
6875,864,-186.06,-534.10,465.90,0.00,186.06,0.35,0
6876,864,1000.00,465.90,1465.90,43.49,0.00,0.32,1
6877,864,-1000.00,-534.10,465.90,15.64,1450.26,0.12,0
6878,864,-465.90,-1000.00,0.00,0.00,465.90,0.12,0
6879,865,1000.00,1000.00,2000.00,0.00,586.72,0.02,1
6880,865,-1000.00,0.00,1000.00,1033.95,966.05,0.02,0
6881,865,1000.00,1000.00,2000.00,266.73,715.59,0.40,1
6882,865,1000.00,2000.00,3000.00,285.21,1714.79,0.44,1
6883,865,1000.00,3000.00,4000.00,1368.92,1631.08,0.37,1
6884,865,-1000.00,2000.00,3000.00,2293.69,1706.31,0.25,0
6885,865,-1000.00,1000.00,2000.00,1515.37,1370.36,0.28,0
6886,865,1000.00,2000.00,3000.00,0.00,701.18,0.22,1
6887,865,1000.00,3000.00,4000.00,0.00,3000.00,0.32,1
6888,865,1000.00,4000.00,5000.00,0.00,4000.00,0.05,1
6889,865,1000.00,5000.00,6000.00,692.42,4079.25,0.42,1
6890,865,1000.00,6000.00,7000.00,2301.45,3698.55,0.30,1
6891,865,1000.00,7000.00,8000.00,2745.70,4254.30,0.27,1
6892,865,1000.00,8000.00,9000.00,2985.67,3342.42,0.27,1
6893,865,-1000.00,7000.00,8000.00,4769.45,4230.55,0.38,0
6894,865,1000.00,8000.00,9000.00,0.00,7903.70,0.41,1
6895,865,-1000.00,7000.00,8000.00,5293.78,2806.97,0.18,0
6896,865,1000.00,8000.00,9000.00,0.00,5880.31,0.38,1
6897,865,1000.00,9000.00,10000.00,0.00,3546.61,0.21,1
6898,865,-1000.00,8000.00,9000.00,7678.79,2321.21,0.16,0
6899,865,1000.00,9000.00,10000.00,400.44,8599.56,0.34,1
6900,865,-1000.00,8000.00,9000.00,5453.24,4546.76,0.33,0
6901,865,1000.00,9000.00,10000.00,0.00,9000.00,0.42,1
6902,865,1000.00,10000.00,11000.00,5000.00,5000.00,0.14,1
6903,865,-1000.00,9000.00,10000.00,7169.54,0.00,0.01,0
6904,865,1000.00,10000.00,11000.00,0.00,3217.69,0.27,1
6905,865,-1000.00,9000.00,10000.00,0.00,11000.00,0.42,0
6906,865,-185.25,8814.75,9814.75,185.25,0.00,0.35,0
6907,865,-1000.00,7814.75,8814.75,0.00,636.06,0.31,0
6908,865,-1000.00,6814.75,7814.75,429.91,3462.37,0.44,0
6909,865,-1000.00,5814.75,6814.75,0.00,2618.56,0.44,0
6910,865,-1000.00,4814.75,5814.75,1992.04,762.91,0.42,0
6911,865,-1000.00,3814.75,4814.75,1056.64,2549.85,0.40,0
6912,865,-1000.00,2814.75,3814.75,0.00,1725.94,0.36,0
6913,865,-1000.00,1814.75,2814.75,0.00,247.08,0.08,0
6914,865,-1000.00,814.75,1814.75,458.00,2356.75,0.40,0
6915,865,0.00,814.75,1814.75,0.00,0.00,0.11,0
6916,865,-1000.00,-185.25,814.75,436.27,1378.48,0.23,0
6917,865,0.00,-185.25,814.75,0.00,0.00,0.05,0
6918,865,-1000.00,-1185.25,-185.25,0.00,705.77,0.34,0
6919,866,1000.00,1000.00,2000.00,0.00,860.42,0.22,1
6920,866,-1000.00,0.00,1000.00,1121.58,878.42,0.14,0
6921,866,1000.00,1000.00,2000.00,0.00,305.94,0.12,1
6922,866,0.00,1000.00,2000.00,0.00,0.00,0.03,0
6923,866,1000.00,2000.00,3000.00,680.44,1319.56,0.33,1
6924,866,1000.00,3000.00,4000.00,0.00,2187.16,0.28,1
6925,866,1000.00,4000.00,5000.00,0.00,1181.56,0.22,1
6926,866,1000.00,5000.00,6000.00,1438.11,3561.89,0.41,1
6927,866,1000.00,6000.00,7000.00,2597.65,3402.35,0.06,1
6928,866,1000.00,7000.00,8000.00,781.93,2848.79,0.29,1
6929,866,1000.00,8000.00,9000.00,3753.76,4246.24,0.34,1
6930,866,1000.00,9000.00,10000.00,1369.30,2675.92,0.24,1
6931,866,-1000.00,8000.00,9000.00,7603.86,2396.14,0.10,0
6932,866,1000.00,9000.00,10000.00,2523.74,6476.26,0.39,1
6933,866,0.00,9000.00,10000.00,0.00,0.00,0.00,0
6934,866,1000.00,10000.00,11000.00,4258.90,5741.10,0.28,1
6935,866,1000.00,11000.00,12000.00,0.00,11000.00,0.12,1
6936,866,1000.00,12000.00,13000.00,3456.79,3660.04,0.24,1
6937,866,1000.00,13000.00,14000.00,0.00,13000.00,0.24,1
6938,866,1000.00,14000.00,15000.00,6233.72,7766.28,0.05,1
6939,866,1000.00,15000.00,16000.00,2330.74,5643.03,0.33,1
6940,866,-1000.00,14000.00,15000.00,0.00,16000.00,0.01,0
6941,866,-1000.00,13000.00,14000.00,999.09,0.00,0.03,0
6942,866,-1000.00,12000.00,13000.00,4763.60,9236.40,0.26,0
6943,866,-1000.00,11000.00,12000.00,0.00,1513.65,0.17,0
6944,866,-1000.00,10000.00,11000.00,1015.42,560.99,0.14,0
6945,866,-1000.00,9000.00,10000.00,0.00,9490.76,0.34,0
6946,866,-1000.00,8000.00,9000.00,1020.08,8979.92,0.43,0
6947,866,-1000.00,7000.00,8000.00,0.00,6286.61,0.40,0
6948,866,-1000.00,6000.00,7000.00,2592.80,5407.20,0.42,0
6949,866,-1000.00,5000.00,6000.00,5023.33,231.93,0.11,0
6950,866,-1000.00,4000.00,5000.00,1808.36,2786.92,0.32,0
6951,866,-1000.00,3000.00,4000.00,0.00,1173.59,0.20,0
6952,866,-1000.00,2000.00,3000.00,405.71,379.89,0.21,0
6953,866,-1000.00,1000.00,2000.00,0.00,3000.00,0.09,0
6954,866,-1000.00,0.00,1000.00,537.31,1462.69,0.06,0
6955,866,-1000.00,-1000.00,0.00,0.00,1000.00,0.03,0
6956,867,-1000.00,-1000.00,0.00,0.00,108.08,0.05,0
6957,868,-1000.00,-1000.00,0.00,390.14,609.86,0.26,0
6958,869,-1000.00,-1000.00,0.00,0.00,1000.00,0.01,0
6959,870,0.00,0.00,1000.00,0.00,272.06,0.06,0
6960,870,-1000.00,-1000.00,0.00,759.18,240.82,0.07,0
6961,871,1000.00,1000.00,2000.00,333.95,666.05,0.40,1
6962,871,1000.00,2000.00,3000.00,893.83,1106.17,0.11,1
6963,871,1000.00,3000.00,4000.00,1160.32,1839.68,0.03,1
6964,871,1000.00,4000.00,5000.00,0.00,3817.14,0.28,1
6965,871,1000.00,5000.00,6000.00,2500.00,2500.00,0.02,1
6966,871,1000.00,6000.00,7000.00,0.00,4246.12,0.33,1
6967,871,-1000.00,5000.00,6000.00,3615.88,3384.12,0.13,0
6968,871,1000.00,6000.00,7000.00,0.00,2953.15,0.23,1
6969,871,1000.00,7000.00,8000.00,2411.71,4588.29,0.32,1
6970,871,1000.00,8000.00,9000.00,4000.00,4000.00,0.02,1
6971,871,-1000.00,7000.00,8000.00,5671.33,3328.67,0.12,0
6972,871,1000.00,8000.00,9000.00,2346.09,5653.91,0.44,1
6973,871,-1000.00,7000.00,8000.00,4828.31,4171.69,0.10,0
6974,871,1000.00,8000.00,9000.00,4000.00,4000.00,0.15,1
6975,871,1000.00,9000.00,10000.00,0.00,5379.72,0.08,1
6976,871,1000.00,10000.00,11000.00,0.00,2716.45,0.16,1
6977,871,1000.00,11000.00,12000.00,4076.21,6923.79,0.37,1
6978,871,-1000.00,10000.00,11000.00,10246.97,1753.03,0.12,0
6979,871,1000.00,11000.00,12000.00,0.00,11000.00,0.01,1
6980,871,1000.00,12000.00,13000.00,0.00,11514.12,0.28,1
6981,871,1000.00,13000.00,14000.00,1646.72,11353.28,0.34,1
6982,871,1000.00,14000.00,15000.00,7000.00,7000.00,0.04,1
6983,871,1000.00,15000.00,16000.00,6966.06,7501.73,0.27,1
6984,871,1000.00,16000.00,17000.00,4667.77,11332.23,0.34,1
6985,871,-1000.00,15000.00,16000.00,0.00,8300.91,0.25,0
6986,871,0.00,15000.00,16000.00,0.00,0.00,0.07,0
6987,871,-1000.00,14000.00,15000.00,4395.84,11604.16,0.39,0
6988,871,-1000.00,13000.00,14000.00,0.00,15000.00,0.38,0
6989,871,-1000.00,12000.00,13000.00,2569.56,11430.44,0.25,0
6990,871,-1000.00,11000.00,12000.00,0.00,13000.00,0.37,0
6991,871,-1000.00,10000.00,11000.00,2206.82,9793.18,0.42,0
6992,871,-1000.00,9000.00,10000.00,1042.48,9957.52,0.30,0
6993,871,-1000.00,8000.00,9000.00,5000.00,5000.00,0.00,0
6994,871,-1000.00,7000.00,8000.00,334.28,8665.72,0.36,0
6995,871,-1000.00,6000.00,7000.00,88.56,2169.11,0.17,0
6996,871,-1000.00,5000.00,6000.00,2005.84,4994.16,0.43,0
6997,871,-1000.00,4000.00,5000.00,2564.43,3435.57,0.24,0
6998,871,-1000.00,3000.00,4000.00,2765.99,2234.01,0.04,0
6999,871,-1000.00,2000.00,3000.00,0.00,3863.58,0.35,0
7000,871,-1000.00,1000.00,2000.00,276.45,2723.55,0.18,0
7001,871,-1000.00,0.00,1000.00,551.70,1448.30,0.35,0
7002,871,-1000.00,-1000.00,0.00,324.11,675.89,0.44,0
7003,872,-1000.00,-1000.00,0.00,153.54,435.01,0.31,0
7004,873,-867.12,-867.12,132.88,0.00,867.12,0.35,0
7005,873,-119.07,-986.19,13.81,30.18,88.89,0.40,0
7006,873,1000.00,13.81,1013.81,9.84,3.96,0.19,1
7007,873,-1000.00,-986.19,13.81,0.00,1013.81,0.06,0
7008,873,1000.00,13.81,1013.81,8.28,5.53,0.01,1
7009,873,-1000.00,-986.19,13.81,0.00,1013.81,0.28,0
7010,873,-2.13,-988.32,11.68,0.00,2.13,0.07,0
7011,873,-11.68,-1000.00,0.00,5.84,5.84,0.06,0
7012,874,-1000.00,-1000.00,0.00,320.54,297.26,0.21,0
7013,875,-1000.00,-1000.00,0.00,829.38,170.62,0.05,0
7014,876,-1000.00,-1000.00,0.00,0.00,1000.00,0.13,0
7015,877,-856.72,-856.72,143.28,851.07,5.65,0.06,0
7016,877,-143.28,-1000.00,0.00,78.93,64.34,0.15,0
7017,878,-716.78,-716.78,283.22,186.07,530.71,0.33,0
7018,878,-283.22,-1000.00,0.00,0.00,283.22,0.15,0
7019,879,1000.00,1000.00,2000.00,351.94,580.67,0.34,1
7020,879,1000.00,2000.00,3000.00,0.00,2000.00,0.24,1
7021,879,1000.00,3000.00,4000.00,0.00,3000.00,0.35,1
7022,879,1000.00,4000.00,5000.00,0.00,1491.23,0.33,1
7023,879,1000.00,5000.00,6000.00,0.00,5000.00,0.17,1
7024,879,-1000.00,4000.00,5000.00,5213.58,45.02,0.09,0
7025,879,1000.00,5000.00,6000.00,2062.75,2937.25,0.02,1
7026,879,1000.00,6000.00,7000.00,0.00,4839.64,0.42,1
7027,879,-1000.00,5000.00,6000.00,2430.42,0.00,0.09,0
7028,879,-1000.00,4000.00,5000.00,5440.71,559.29,0.10,0
7029,879,1000.00,5000.00,6000.00,0.00,3664.63,0.22,1
7030,879,1000.00,6000.00,7000.00,0.00,6000.00,0.07,1
7031,879,1000.00,7000.00,8000.00,2445.86,3572.48,0.44,1
7032,879,-1000.00,6000.00,7000.00,2984.62,2626.72,0.27,0
7033,879,0.00,6000.00,7000.00,0.00,0.00,0.05,0
7034,879,1000.00,7000.00,8000.00,0.00,6260.27,0.30,1
7035,879,0.00,7000.00,8000.00,0.00,0.00,0.16,0
7036,879,1000.00,8000.00,9000.00,0.00,8000.00,0.05,1
7037,879,1000.00,9000.00,10000.00,0.00,9000.00,0.29,1
7038,879,1000.00,10000.00,11000.00,2459.47,7540.53,0.31,1
7039,879,1000.00,11000.00,12000.00,1575.83,9424.17,0.39,1
7040,879,-1000.00,10000.00,11000.00,6642.25,5357.75,0.27,0
7041,879,0.00,10000.00,11000.00,0.00,0.00,0.24,0
7042,879,1000.00,11000.00,12000.00,2977.25,8022.75,0.07,1
7043,879,-1000.00,10000.00,11000.00,11806.74,0.00,0.12,0
7044,879,1000.00,11000.00,12000.00,0.00,11000.00,0.42,1
7045,879,-1000.00,10000.00,11000.00,3648.88,1201.32,0.16,0
7046,879,1000.00,11000.00,12000.00,1994.30,6586.84,0.36,1
7047,879,1000.00,12000.00,13000.00,4156.43,7843.57,0.38,1
7048,879,-1000.00,11000.00,12000.00,7716.33,5283.67,0.15,0
7049,879,1000.00,12000.00,13000.00,4731.81,7268.19,0.14,1
7050,879,-1000.00,11000.00,12000.00,5852.37,4603.33,0.23,0
7051,879,-1000.00,10000.00,11000.00,8444.73,3555.27,0.19,0
7052,879,1000.00,11000.00,12000.00,0.00,11000.00,0.15,1
7053,879,-1000.00,10000.00,11000.00,9012.33,2987.67,0.07,0
7054,879,-1000.00,9000.00,10000.00,10155.59,844.41,0.02,0
7055,879,1000.00,10000.00,11000.00,0.00,10000.00,0.23,1
7056,879,1000.00,11000.00,12000.00,2230.13,8769.87,0.34,1
7057,879,-1000.00,10000.00,11000.00,2078.73,1438.86,0.12,0
7058,879,1000.00,11000.00,12000.00,0.00,4557.92,0.20,1
7059,879,1000.00,12000.00,13000.00,2101.85,4554.63,0.17,1
7060,879,1000.00,13000.00,14000.00,3006.89,9993.11,0.30,1
7061,879,1000.00,14000.00,15000.00,4665.05,9334.95,0.42,1
7062,880,-1000.00,-1000.00,0.00,423.72,576.28,0.24,0
7063,881,1000.00,1000.00,2000.00,0.00,520.07,0.30,1
7064,881,1000.00,2000.00,3000.00,0.00,2000.00,0.08,1
7065,881,1000.00,3000.00,4000.00,121.30,2878.70,0.28,1
7066,881,1000.00,4000.00,5000.00,0.00,4000.00,0.11,1
7067,881,1000.00,5000.00,6000.00,0.00,5000.00,0.29,1
7068,881,1000.00,6000.00,7000.00,270.10,5729.90,0.25,1
7069,881,1000.00,7000.00,8000.00,3137.54,3862.46,0.32,1
7070,881,1000.00,8000.00,9000.00,1582.52,6417.48,0.38,1
7071,881,1000.00,9000.00,10000.00,0.00,7993.27,0.20,1
7072,881,-1000.00,8000.00,9000.00,5131.44,4868.56,0.00,0
7073,881,1000.00,9000.00,10000.00,4500.00,4500.00,0.07,1
7074,881,-1000.00,8000.00,9000.00,5584.40,3399.45,0.24,0
7075,881,1000.00,9000.00,10000.00,0.00,1067.50,0.06,1
7076,881,1000.00,10000.00,11000.00,2851.87,5855.07,0.35,1
7077,881,1000.00,11000.00,12000.00,1558.35,9441.65,0.30,1
7078,881,1000.00,12000.00,13000.00,5180.40,6819.60,0.40,1
7079,881,1000.00,13000.00,14000.00,0.00,7787.48,0.22,1
7080,881,1000.00,14000.00,15000.00,0.00,4268.35,0.19,1
7081,881,1000.00,15000.00,16000.00,6380.21,8619.79,0.42,1
7082,881,1000.00,16000.00,17000.00,0.00,15188.73,0.40,1
7083,881,1000.00,17000.00,18000.00,8500.00,8500.00,0.02,1
7084,881,-1000.00,16000.00,17000.00,5847.35,4623.38,0.21,0
7085,881,1000.00,17000.00,18000.00,7075.24,9924.76,0.31,1
7086,881,1000.00,18000.00,19000.00,7284.15,10715.85,0.31,1
7087,881,-1000.00,17000.00,18000.00,9795.73,9204.27,0.34,0
7088,881,-1000.00,16000.00,17000.00,0.00,11256.14,0.21,0
7089,881,-1000.00,15000.00,16000.00,4684.76,12315.24,0.42,0
7090,881,-1000.00,14000.00,15000.00,2668.89,13331.11,0.38,0
7091,881,-1000.00,13000.00,14000.00,5614.08,9385.92,0.10,0
7092,881,-1000.00,12000.00,13000.00,7797.08,6202.92,0.23,0
7093,881,-1000.00,11000.00,12000.00,5994.80,7005.20,0.28,0
7094,881,-1000.00,10000.00,11000.00,2854.19,9145.81,0.42,0
7095,881,-1000.00,9000.00,10000.00,483.44,10516.56,0.39,0
7096,881,-1000.00,8000.00,9000.00,0.00,5759.14,0.25,0
7097,881,-1000.00,7000.00,8000.00,4213.73,4786.27,0.42,0
7098,881,-1000.00,6000.00,7000.00,4233.95,3766.05,0.36,0
7099,881,-1000.00,5000.00,6000.00,3381.70,3618.30,0.33,0
7100,881,-1000.00,4000.00,5000.00,4153.28,1846.72,0.14,0
7101,881,-1000.00,3000.00,4000.00,0.00,3600.92,0.11,0
7102,881,-1000.00,2000.00,3000.00,1712.35,2287.65,0.05,0
7103,881,-1000.00,1000.00,2000.00,1089.33,1338.65,0.27,0
7104,881,-1000.00,0.00,1000.00,267.47,1732.53,0.34,0
7105,881,-1000.00,-1000.00,0.00,500.00,500.00,0.16,0
7106,882,-1000.00,-1000.00,0.00,0.00,1000.00,0.41,0
7107,883,-1000.00,-1000.00,0.00,0.00,1000.00,0.10,0
7108,884,-187.07,-187.07,812.93,126.59,60.48,0.15,0
7109,884,-107.82,-294.89,705.11,84.24,23.58,0.13,0
7110,884,1000.00,705.11,1705.11,188.80,516.31,0.23,1
7111,884,-1000.00,-294.89,705.11,1042.16,0.00,0.03,0
7112,884,1000.00,705.11,1705.11,352.56,352.56,0.10,1
7113,884,-139.77,565.35,1565.35,139.77,0.00,0.07,0
7114,884,1000.00,1565.35,2565.35,0.00,1565.35,0.37,1
7115,884,1000.00,2565.35,3565.35,1064.83,1500.52,0.38,1
7116,884,1000.00,3565.35,4565.35,1351.43,2213.91,0.38,1
7117,884,1000.00,4565.35,5565.35,0.00,2504.00,0.14,1
7118,884,-1000.00,3565.35,4565.35,3626.31,1939.04,0.06,0
7119,884,1000.00,4565.35,5565.35,2282.67,2282.67,0.09,1
7120,884,1000.00,5565.35,6565.35,0.00,133.26,0.15,1
7121,884,1000.00,6565.35,7565.35,0.00,3098.16,0.28,1
7122,884,1000.00,7565.35,8565.35,544.01,6800.52,0.43,1
7123,884,-1000.00,6565.35,7565.35,5169.88,3395.47,0.18,0
7124,884,1000.00,7565.35,8565.35,0.00,7565.35,0.14,1
7125,884,1000.00,8565.35,9565.35,0.00,7382.13,0.43,1
7126,884,1000.00,9565.35,10565.35,0.00,5710.16,0.09,1
7127,884,1000.00,10565.35,11565.35,0.00,3672.85,0.30,1
7128,884,1000.00,11565.35,12565.35,1400.29,10165.05,0.18,1
7129,884,-1000.00,10565.35,11565.35,10096.48,0.00,0.05,0
7130,884,-1000.00,9565.35,10565.35,5782.67,5782.67,0.17,0
7131,884,-1000.00,8565.35,9565.35,5282.67,5282.67,0.07,0
7132,884,-1000.00,7565.35,8565.35,0.00,8596.83,0.13,0
7133,884,-1000.00,6565.35,7565.35,0.00,7586.73,0.38,0
7134,884,-1000.00,5565.35,6565.35,2719.34,4846.01,0.34,0
7135,884,-1000.00,4565.35,5565.35,0.00,5068.76,0.24,0
7136,884,-1000.00,3565.35,4565.35,0.00,5565.35,0.14,0
7137,884,-1000.00,2565.35,3565.35,0.00,1860.23,0.20,0
7138,884,-1000.00,1565.35,2565.35,0.00,3565.35,0.26,0
7139,884,-1000.00,565.35,1565.35,1282.67,1282.67,0.06,0
7140,884,-1000.00,-434.65,565.35,400.03,1165.31,0.40,0
7141,884,-489.33,-923.98,76.02,0.00,489.33,0.29,0
7142,884,-41.17,-965.15,34.85,0.00,41.17,0.22,0
7143,884,-13.29,-978.44,21.56,0.00,13.29,0.25,0
7144,884,-21.56,-1000.00,0.00,0.00,21.56,0.09,0
7145,885,1000.00,1000.00,2000.00,366.70,633.30,0.20,1
7146,885,1000.00,2000.00,3000.00,0.00,1330.34,0.37,1
7147,885,1000.00,3000.00,4000.00,880.80,2119.20,0.41,1
7148,885,1000.00,4000.00,5000.00,0.00,4000.00,0.11,1
7149,885,-1000.00,3000.00,4000.00,2215.71,0.00,0.02,0
7150,885,1000.00,4000.00,5000.00,0.00,3594.75,0.13,1
7151,885,1000.00,5000.00,6000.00,0.00,5000.00,0.09,1
7152,885,1000.00,6000.00,7000.00,2150.05,3849.95,0.42,1
7153,885,-1000.00,5000.00,6000.00,4491.45,2508.55,0.21,0
7154,885,1000.00,6000.00,7000.00,1118.75,4881.25,0.37,1
7155,885,1000.00,7000.00,8000.00,0.00,562.43,0.14,1
7156,885,-1000.00,6000.00,7000.00,5824.78,146.62,0.08,0
7157,885,1000.00,7000.00,8000.00,2587.31,4412.69,0.11,1
7158,885,1000.00,8000.00,9000.00,1347.52,5883.83,0.41,1
7159,885,1000.00,9000.00,10000.00,0.00,9000.00,0.04,1
7160,885,0.00,9000.00,10000.00,0.00,0.00,0.02,0
7161,885,1000.00,10000.00,11000.00,0.00,8930.75,0.36,1
7162,885,1000.00,11000.00,12000.00,1025.13,9974.87,0.31,1
7163,885,-1000.00,10000.00,11000.00,1701.93,1239.91,0.18,0
7164,885,-1000.00,9000.00,10000.00,3227.39,3180.38,0.27,0
7165,885,1000.00,10000.00,11000.00,0.00,10000.00,0.16,1
7166,885,-1000.00,9000.00,10000.00,6174.97,4825.03,0.41,0
7167,885,1000.00,10000.00,11000.00,0.00,10000.00,0.22,1
7168,885,1000.00,11000.00,12000.00,3687.60,7312.40,0.19,1
7169,885,-1000.00,10000.00,11000.00,3666.31,8333.69,0.36,0
7170,885,-1000.00,9000.00,10000.00,1995.47,8031.75,0.43,0
7171,885,-1000.00,8000.00,9000.00,573.94,7251.11,0.44,0
7172,885,-1000.00,7000.00,8000.00,2396.30,6603.70,0.29,0
7173,885,-1000.00,6000.00,7000.00,0.00,7979.02,0.19,0
7174,885,0.00,6000.00,7000.00,0.00,0.00,0.00,0
7175,885,-1000.00,5000.00,6000.00,1718.04,5082.58,0.42,0
7176,885,-1000.00,4000.00,5000.00,0.00,1015.74,0.14,0
7177,885,0.00,4000.00,5000.00,0.00,0.00,0.02,0
7178,885,-1000.00,3000.00,4000.00,0.00,5000.00,0.20,0
7179,885,-1000.00,2000.00,3000.00,0.00,852.81,0.24,0
7180,885,-773.74,1226.26,2226.26,773.74,0.00,0.13,0
7181,885,-1000.00,226.26,1226.26,0.00,621.07,0.21,0
7182,885,-1000.00,-773.74,226.26,36.60,1116.84,0.40,0
7183,885,-27.61,-801.36,198.64,27.61,0.00,0.06,0
7184,885,-181.17,-982.52,17.48,153.95,27.22,0.13,0
7185,885,0.00,-982.52,17.48,0.00,0.00,0.28,0
7186,885,-291.16,-1273.68,-273.68,0.00,2.02,0.30,0
7187,886,-1000.00,-1000.00,0.00,0.00,1000.00,0.40,0
7188,887,-1000.00,-1000.00,0.00,0.00,1000.00,0.36,0
7189,888,-1000.00,-1000.00,0.00,212.39,787.61,0.36,0
7190,889,-1000.00,-1000.00,0.00,465.98,534.02,0.32,0
7191,890,-1000.00,-1000.00,0.00,491.64,107.85,0.13,0
7192,891,-1000.00,-1000.00,0.00,52.54,947.46,0.42,0
7193,892,-943.79,-943.79,56.21,0.00,943.79,0.17,0
7194,892,-56.21,-1000.00,0.00,13.23,42.98,0.29,0
7195,893,-1000.00,-1000.00,0.00,535.28,464.72,0.18,0
7196,894,-1000.00,-1000.00,0.00,225.87,774.13,0.01,0
7197,895,-1000.00,-1000.00,0.00,0.00,1000.00,0.28,0
7198,896,-1000.00,-1000.00,0.00,0.00,1000.00,0.01,0
7199,897,-1000.00,-1000.00,0.00,727.93,0.00,0.02,0
7200,898,-1000.00,-1000.00,0.00,497.81,502.19,0.14,0
7201,899,-310.13,-310.13,689.87,0.00,310.13,0.04,0
7202,899,-689.87,-1000.00,0.00,0.00,689.87,0.13,0
7203,900,1000.00,1000.00,2000.00,383.58,616.42,0.33,1
7204,900,1000.00,2000.00,3000.00,756.53,1243.47,0.33,1
7205,900,1000.00,3000.00,4000.00,906.97,2093.03,0.13,1
7206,900,-1000.00,2000.00,3000.00,3753.53,246.47,0.10,0
7207,900,1000.00,3000.00,4000.00,919.26,1633.28,0.32,1
7208,900,1000.00,4000.00,5000.00,363.52,3636.48,0.18,1
7209,900,-1000.00,3000.00,4000.00,1568.79,660.59,0.13,0
7210,900,1000.00,4000.00,5000.00,1232.33,2767.67,0.32,1
7211,900,1000.00,5000.00,6000.00,688.73,4311.27,0.43,1
7212,900,1000.00,6000.00,7000.00,2221.42,3778.58,0.42,1
7213,900,1000.00,7000.00,8000.00,0.00,7000.00,0.14,1
7214,900,-1000.00,6000.00,7000.00,1238.96,725.14,0.15,0
7215,900,-1000.00,5000.00,6000.00,3710.92,3289.08,0.41,0
7216,900,1000.00,6000.00,7000.00,0.00,6000.00,0.11,1
7217,900,1000.00,7000.00,8000.00,0.00,7000.00,0.15,1
7218,900,1000.00,8000.00,9000.00,2120.66,5879.34,0.17,1
7219,900,1000.00,9000.00,10000.00,0.00,9000.00,0.10,1
7220,900,1000.00,10000.00,11000.00,1678.54,8267.78,0.42,1
7221,900,1000.00,11000.00,12000.00,5500.00,5500.00,0.17,1
7222,900,1000.00,12000.00,13000.00,0.00,12000.00,0.17,1
7223,900,1000.00,13000.00,14000.00,0.00,5847.19,0.21,1
7224,900,1000.00,14000.00,15000.00,7000.00,7000.00,0.17,1
7225,900,1000.00,15000.00,16000.00,0.00,6554.71,0.24,1
7226,900,0.00,15000.00,16000.00,0.00,0.00,0.05,0
7227,900,1000.00,16000.00,17000.00,0.00,15342.18,0.22,1
7228,900,-1000.00,15000.00,16000.00,1779.76,0.00,0.09,0
7229,900,-1000.00,14000.00,15000.00,9679.72,6320.28,0.09,0
7230,900,1000.00,15000.00,16000.00,0.00,15000.00,0.11,1
7231,900,1000.00,16000.00,17000.00,2656.89,13343.11,0.09,1
7232,900,1000.00,17000.00,18000.00,0.00,16920.19,0.19,1
7233,900,-1000.00,16000.00,17000.00,9693.37,8306.63,0.14,0
7234,900,1000.00,17000.00,18000.00,0.00,17000.00,0.32,1
7235,900,1000.00,18000.00,19000.00,0.00,18000.00,0.14,1
7236,900,-1000.00,17000.00,18000.00,10186.61,8813.39,0.04,0
7237,900,-1000.00,16000.00,17000.00,10491.08,0.00,0.06,0
7238,900,1000.00,17000.00,18000.00,0.00,11253.66,0.28,1
7239,900,1000.00,18000.00,19000.00,6120.90,11879.10,0.02,1
7240,900,1000.00,19000.00,20000.00,0.00,19000.00,0.28,1
7241,900,1000.00,20000.00,21000.00,6663.20,13336.80,0.41,1
7242,900,-1000.00,19000.00,20000.00,17462.77,3537.23,0.08,0
7243,900,1000.00,20000.00,21000.00,5078.13,14921.87,0.43,1
7244,901,-1000.00,-1000.00,0.00,382.14,617.86,0.09,0
7245,902,-803.99,-803.99,196.01,380.20,423.78,0.24,0
7246,902,-63.16,-867.15,132.85,0.00,63.16,0.21,0
7247,902,-132.85,-1000.00,0.00,0.00,132.85,0.02,0
7248,903,-1000.00,-1000.00,0.00,320.25,679.75,0.10,0
7249,904,-1000.00,-1000.00,0.00,368.08,352.20,0.22,0
7250,905,1000.00,1000.00,2000.00,0.00,56.83,0.12,1
7251,905,1000.00,2000.00,3000.00,0.00,2000.00,0.38,1
7252,905,-1000.00,1000.00,2000.00,1298.67,0.00,0.09,0
7253,905,1000.00,2000.00,3000.00,0.00,755.91,0.13,1
7254,905,1000.00,3000.00,4000.00,571.00,2128.17,0.39,1
7255,905,1000.00,4000.00,5000.00,2000.00,2000.00,0.13,1
7256,905,-541.78,3458.22,4458.22,541.78,0.00,0.08,0
7257,905,1000.00,4458.22,5458.22,0.00,4250.98,0.10,1
7258,905,-1000.00,3458.22,4458.22,4586.60,871.62,0.06,0
7259,905,1000.00,4458.22,5458.22,0.00,2104.30,0.26,1
7260,905,1000.00,5458.22,6458.22,0.00,5458.22,0.18,1
7261,905,1000.00,6458.22,7458.22,2734.93,3723.29,0.32,1
7262,905,1000.00,7458.22,8458.22,2356.07,5102.15,0.43,1
7263,905,1000.00,8458.22,9458.22,0.00,5186.08,0.30,1
7264,905,1000.00,9458.22,10458.22,3379.98,6078.24,0.35,1
7265,905,1000.00,10458.22,11458.22,4535.53,4579.04,0.26,1
7266,905,1000.00,11458.22,12458.22,2268.16,9190.06,0.36,1
7267,905,1000.00,12458.22,13458.22,6229.11,6229.11,0.14,1
7268,905,-1000.00,11458.22,12458.22,6729.11,6729.11,0.01,0
7269,905,-1000.00,10458.22,11458.22,7563.56,4894.66,0.04,0
7270,905,-1000.00,9458.22,10458.22,6184.24,5273.98,0.16,0
7271,905,-1000.00,8458.22,9458.22,0.00,10458.22,0.03,0
7272,905,-1000.00,7458.22,8458.22,6327.15,3131.07,0.28,0
7273,905,-1000.00,6458.22,7458.22,0.00,5953.63,0.40,0
7274,905,-1000.00,5458.22,6458.22,0.00,7458.22,0.37,0
7275,905,-1000.00,4458.22,5458.22,0.00,6458.22,0.04,0
7276,905,-1000.00,3458.22,4458.22,0.00,5458.22,0.22,0
7277,905,-1000.00,2458.22,3458.22,1822.59,717.10,0.15,0
7278,905,-1000.00,1458.22,2458.22,714.88,2743.34,0.41,0
7279,905,-1000.00,458.22,1458.22,939.34,1518.88,0.26,0
7280,905,-1000.00,-541.78,458.22,729.11,729.11,0.21,0
7281,905,-410.15,-951.94,48.06,0.00,410.15,0.39,0
7282,905,-48.06,-1000.00,0.00,0.00,48.06,0.28,0
7283,906,-1000.00,-1000.00,0.00,0.00,1000.00,0.15,0
7284,907,-1000.00,-1000.00,0.00,155.54,844.46,0.02,0
7285,907,-0.00,-1000.00,0.00,0.00,0.00,0.10,0
7286,908,-1000.00,-1000.00,0.00,162.01,837.99,0.30,0
7287,909,-1000.00,-1000.00,0.00,0.00,1000.00,0.18,0
7288,910,-1000.00,-1000.00,0.00,0.00,1000.00,0.43,0
7289,911,1000.00,1000.00,2000.00,135.62,578.21,0.35,1
7290,911,-1000.00,0.00,1000.00,1231.90,768.10,0.09,0
7291,911,-451.29,-451.29,548.71,419.23,32.06,0.13,0
7292,911,1000.00,548.71,1548.71,87.43,461.27,0.43,1
7293,911,1000.00,1548.71,2548.71,445.29,1103.41,0.33,1
7294,911,1000.00,2548.71,3548.71,418.49,2130.22,0.28,1
7295,911,1000.00,3548.71,4548.71,1397.71,2151.00,0.31,1
7296,911,1000.00,4548.71,5548.71,0.00,4548.71,0.16,1
7297,911,0.00,4548.71,5548.71,0.00,0.00,0.11,0
7298,911,1000.00,5548.71,6548.71,2112.34,3436.36,0.27,1
7299,911,1000.00,6548.71,7548.71,0.00,6548.71,0.35,1
7300,911,1000.00,7548.71,8548.71,0.00,1250.00,0.07,1
7301,911,1000.00,8548.71,9548.71,0.00,5574.79,0.40,1
7302,911,1000.00,9548.71,10548.71,3970.05,5578.65,0.11,1
7303,911,1000.00,10548.71,11548.71,5274.35,5274.35,0.26,1
7304,911,1000.00,11548.71,12548.71,0.00,11548.71,0.25,1
7305,911,1000.00,12548.71,13548.71,0.00,12548.71,0.31,1
7306,911,0.00,12548.71,13548.71,0.00,0.00,0.00,0
7307,911,1000.00,13548.71,14548.71,3661.99,9886.72,0.23,1
7308,911,-1000.00,12548.71,13548.71,8296.38,0.00,0.09,0
7309,911,-1000.00,11548.71,12548.71,0.00,6072.56,0.05,0
7310,911,-1000.00,10548.71,11548.71,2466.68,10082.03,0.44,0
7311,911,-1000.00,9548.71,10548.71,4518.53,7030.18,0.26,0
7312,911,-1000.00,8548.71,9548.71,7608.50,0.00,0.29,0
7313,911,-1000.00,7548.71,8548.71,4291.45,5257.26,0.17,0
7314,911,-1000.00,6548.71,7548.71,0.00,8548.71,0.11,0
7315,911,-1000.00,5548.71,6548.71,1451.51,6097.20,0.43,0
7316,911,-1000.00,4548.71,5548.71,1970.04,2099.33,0.30,0
7317,911,-1000.00,3548.71,4548.71,2008.72,3539.99,0.02,0
7318,911,-1000.00,2548.71,3548.71,2152.54,2396.17,0.13,0
7319,911,-1000.00,1548.71,2548.71,0.00,3548.71,0.07,0
7320,911,-1000.00,548.71,1548.71,0.00,854.52,0.27,0
7321,911,-1000.00,-451.29,548.71,0.00,667.61,0.16,0
7322,911,-1000.00,-1451.29,-451.29,0.00,548.71,0.26,0
7323,912,-948.69,-948.69,51.31,0.00,948.69,0.44,0
7324,912,-51.31,-1000.00,0.00,0.00,51.31,0.23,0
7325,913,-952.88,-952.88,47.12,264.79,688.09,0.36,0
7326,913,-47.12,-1000.00,0.00,0.00,47.12,0.43,0
7327,914,-1000.00,-1000.00,0.00,373.80,0.00,0.05,0
7328,915,-93.21,-93.21,906.79,0.00,93.21,0.13,0
7329,915,-906.79,-1000.00,0.00,0.00,906.79,0.01,0
7330,916,1000.00,1000.00,2000.00,159.27,840.73,0.07,1
7331,916,1000.00,2000.00,3000.00,0.00,891.23,0.27,1
7332,916,1000.00,3000.00,4000.00,1105.61,1894.39,0.24,1
7333,916,1000.00,4000.00,5000.00,0.00,4000.00,0.09,1
7334,916,1000.00,5000.00,6000.00,0.00,5000.00,0.15,1
7335,916,1000.00,6000.00,7000.00,1627.68,4372.32,0.35,1
7336,916,1000.00,7000.00,8000.00,3068.84,3931.16,0.25,1
7337,916,1000.00,8000.00,9000.00,0.00,8000.00,0.05,1
7338,916,1000.00,9000.00,10000.00,0.00,6483.37,0.31,1
7339,916,-1000.00,8000.00,9000.00,6773.56,2460.20,0.19,0
7340,916,1000.00,9000.00,10000.00,3375.09,5582.62,0.36,1
7341,916,1000.00,10000.00,11000.00,0.00,10000.00,0.17,1
7342,916,1000.00,11000.00,12000.00,3994.92,7005.08,0.37,1
7343,916,1000.00,12000.00,13000.00,0.00,12000.00,0.06,1
7344,916,1000.00,13000.00,14000.00,0.00,13000.00,0.04,1
7345,916,1000.00,14000.00,15000.00,0.00,2991.85,0.20,1
7346,916,1000.00,15000.00,16000.00,5894.53,9105.47,0.31,1
7347,916,-1000.00,14000.00,15000.00,8571.47,7428.53,0.26,0
7348,916,1000.00,15000.00,16000.00,4741.24,10258.76,0.31,1
7349,916,1000.00,16000.00,17000.00,927.96,15072.04,0.44,1
7350,916,1000.00,17000.00,18000.00,8500.00,8500.00,0.10,1
7351,916,1000.00,18000.00,19000.00,2773.25,15226.75,0.06,1
7352,916,-1000.00,17000.00,18000.00,13335.93,4845.91,0.16,0
7353,916,-1000.00,16000.00,17000.00,0.00,18000.00,0.06,0
7354,916,-1000.00,15000.00,16000.00,0.00,17000.00,0.33,0
7355,916,-1000.00,14000.00,15000.00,3286.71,12713.29,0.22,0
7356,916,-1000.00,13000.00,14000.00,0.00,12859.86,0.32,0
7357,916,-1000.00,12000.00,13000.00,0.00,14000.00,0.00,0
7358,916,-1000.00,11000.00,12000.00,0.00,1340.04,0.07,0
7359,916,-1000.00,10000.00,11000.00,0.00,12000.00,0.29,0
7360,916,-1000.00,9000.00,10000.00,8109.19,2291.89,0.11,0
7361,916,-1000.00,8000.00,9000.00,10000.00,0.00,0.02,0
7362,916,-1000.00,7000.00,8000.00,7428.80,0.00,0.00,0
7363,916,-1000.00,6000.00,7000.00,0.00,4651.86,0.35,0
7364,916,-1000.00,5000.00,6000.00,526.96,6473.04,0.17,0
7365,916,-1000.00,4000.00,5000.00,2207.33,3061.49,0.29,0
7366,916,-1000.00,3000.00,4000.00,0.00,2619.63,0.11,0
7367,916,-1000.00,2000.00,3000.00,0.00,4000.00,0.32,0
7368,916,-1000.00,1000.00,2000.00,0.00,3000.00,0.21,0
7369,916,-1000.00,0.00,1000.00,0.00,2000.00,0.24,0
7370,916,-1000.00,-1000.00,0.00,358.36,641.64,0.36,0
7371,917,1000.00,1000.00,2000.00,0.00,493.20,0.09,1
7372,917,1000.00,2000.00,3000.00,865.71,1134.29,0.28,1
7373,917,1000.00,3000.00,4000.00,1500.00,1500.00,0.03,1
7374,917,1000.00,4000.00,5000.00,406.30,3593.70,0.43,1
7375,917,1000.00,5000.00,6000.00,0.00,3938.96,0.30,1
7376,917,1000.00,6000.00,7000.00,0.00,3297.84,0.29,1
7377,917,1000.00,7000.00,8000.00,0.00,6531.46,0.23,1
7378,917,1000.00,8000.00,9000.00,2181.93,5818.07,0.43,1
7379,917,1000.00,9000.00,10000.00,0.00,9000.00,0.26,1
7380,917,1000.00,10000.00,11000.00,3249.92,6750.08,0.26,1
7381,917,-1000.00,9000.00,10000.00,3668.75,3000.41,0.22,0
7382,917,-1000.00,8000.00,9000.00,4250.62,0.00,0.03,0
7383,917,1000.00,9000.00,10000.00,4500.00,4500.00,0.07,1
7384,917,1000.00,10000.00,11000.00,0.00,8542.84,0.42,1
7385,917,0.00,10000.00,11000.00,0.00,0.00,0.03,0
7386,917,1000.00,11000.00,12000.00,0.00,6673.58,0.03,1
7387,917,1000.00,12000.00,13000.00,6000.00,6000.00,0.01,1
7388,917,1000.00,13000.00,14000.00,0.00,4598.99,0.09,1
7389,917,1000.00,14000.00,15000.00,4008.61,9991.39,0.28,1
7390,917,1000.00,15000.00,16000.00,0.00,15000.00,0.14,1
7391,917,-1000.00,14000.00,15000.00,11000.82,1620.62,0.16,0
7392,917,-1000.00,13000.00,14000.00,3052.32,9183.50,0.35,0
7393,917,-1000.00,12000.00,13000.00,5157.52,8842.48,0.33,0
7394,917,-1000.00,11000.00,12000.00,1449.94,0.00,0.02,0
7395,917,-1000.00,10000.00,11000.00,5013.73,6986.27,0.02,0
7396,917,-1000.00,9000.00,10000.00,0.00,9873.27,0.08,0
7397,917,-1000.00,8000.00,9000.00,2253.69,7746.31,0.41,0
7398,917,-1000.00,7000.00,8000.00,0.00,9000.00,0.34,0
7399,917,-1000.00,6000.00,7000.00,0.00,8000.00,0.25,0
7400,917,-1000.00,5000.00,6000.00,0.00,3152.52,0.19,0
7401,917,-1000.00,4000.00,5000.00,3797.91,2202.09,0.26,0
7402,917,-1000.00,3000.00,4000.00,3121.96,1878.04,0.16,0
7403,917,-1000.00,2000.00,3000.00,0.00,2984.79,0.35,0
7404,917,-1000.00,1000.00,2000.00,1286.76,1713.24,0.12,0
7405,917,-1000.00,0.00,1000.00,1180.13,819.87,0.12,0
7406,917,-1000.00,-1000.00,0.00,131.59,65.03,0.14,0
7407,918,-1000.00,-1000.00,0.00,0.00,1000.00,0.23,0
7408,919,-721.15,-721.15,278.85,0.00,721.15,0.37,0
7409,919,-278.85,-1000.00,0.00,0.00,278.85,0.25,0
7410,920,-1000.00,-1000.00,0.00,531.52,468.48,0.21,0
7411,921,-1000.00,-1000.00,0.00,500.00,500.00,0.01,0
7412,922,-1000.00,-1000.00,0.00,0.00,1000.00,0.40,0
7413,923,1000.00,1000.00,2000.00,21.10,900.18,0.44,1
7414,923,1000.00,2000.00,3000.00,950.73,1049.27,0.22,1
7415,923,1000.00,3000.00,4000.00,476.73,2523.27,0.35,1
7416,923,1000.00,4000.00,5000.00,0.00,2948.94,0.12,1
7417,923,1000.00,5000.00,6000.00,1342.06,3009.19,0.35,1
7418,923,1000.00,6000.00,7000.00,1.31,4930.55,0.43,1
7419,923,1000.00,7000.00,8000.00,2065.48,4256.85,0.36,1
7420,923,1000.00,8000.00,9000.00,3311.96,4405.56,0.33,1
7421,923,1000.00,9000.00,10000.00,0.00,3526.81,0.09,1
7422,923,1000.00,10000.00,11000.00,0.00,7636.55,0.08,1
7423,923,1000.00,11000.00,12000.00,5500.00,5500.00,0.07,1
7424,923,1000.00,12000.00,13000.00,0.00,10113.86,0.20,1
7425,923,-1000.00,11000.00,12000.00,7892.47,5107.53,0.26,0
7426,923,1000.00,12000.00,13000.00,3726.21,8273.79,0.41,1
7427,923,1000.00,13000.00,14000.00,0.00,13000.00,0.08,1
7428,923,-1000.00,12000.00,13000.00,7582.94,6417.06,0.08,0
7429,923,1000.00,13000.00,14000.00,6500.00,6500.00,0.05,1
7430,923,1000.00,14000.00,15000.00,0.00,14000.00,0.07,1
7431,923,1000.00,15000.00,16000.00,202.62,14797.38,0.24,1
7432,923,1000.00,16000.00,17000.00,0.00,16000.00,0.30,1
7433,923,-1000.00,15000.00,16000.00,17000.00,0.00,0.08,0
7434,923,1000.00,16000.00,17000.00,5297.18,10702.82,0.08,1
7435,923,1000.00,17000.00,18000.00,6555.10,10444.90,0.11,1
7436,923,1000.00,18000.00,19000.00,3089.33,14910.67,0.34,1
7437,923,1000.00,19000.00,20000.00,0.00,18516.08,0.24,1
7438,923,1000.00,20000.00,21000.00,0.00,14217.76,0.20,1
7439,923,1000.00,21000.00,22000.00,10500.00,10500.00,0.09,1
7440,923,1000.00,22000.00,23000.00,0.00,22000.00,0.41,1
7441,923,-1000.00,21000.00,22000.00,3625.16,0.00,0.04,0
7442,923,1000.00,22000.00,23000.00,3998.43,18001.57,0.40,1
7443,923,1000.00,23000.00,24000.00,0.00,22716.67,0.39,1
7444,923,1000.00,24000.00,25000.00,0.00,12940.23,0.27,1
7445,923,-1000.00,23000.00,24000.00,22615.22,0.00,0.02,0
7446,923,1000.00,24000.00,25000.00,0.00,23309.56,0.31,1
7447,923,1000.00,25000.00,26000.00,0.00,25000.00,0.14,1
7448,923,-1000.00,24000.00,25000.00,17120.49,8879.51,0.12,0
7449,923,1000.00,25000.00,26000.00,6902.90,18097.10,0.39,1
7450,923,1000.00,26000.00,27000.00,13000.00,13000.00,0.14,1
7451,923,1000.00,27000.00,28000.00,0.00,27000.00,0.16,1
7452,923,1000.00,28000.00,29000.00,6263.45,21736.55,0.44,1
7453,923,1000.00,29000.00,30000.00,0.00,29000.00,0.16,1
7454,923,1000.00,30000.00,31000.00,2512.75,22999.23,0.40,1
7455,923,1000.00,31000.00,32000.00,0.00,30049.63,0.40,1
7456,923,-1000.00,30000.00,31000.00,15896.89,3632.89,0.16,0
7457,924,1000.00,1000.00,2000.00,0.00,860.83,0.16,1
7458,924,1000.00,2000.00,3000.00,673.77,1158.22,0.33,1
7459,924,1000.00,3000.00,4000.00,1177.64,1822.36,0.37,1
7460,924,1000.00,4000.00,5000.00,1292.39,2707.61,0.34,1
7461,924,1000.00,5000.00,6000.00,0.00,5000.00,0.22,1
7462,924,1000.00,6000.00,7000.00,0.00,1669.82,0.22,1
7463,924,1000.00,7000.00,8000.00,2129.73,4870.27,0.39,1
7464,924,0.00,7000.00,8000.00,0.00,0.00,0.03,0
7465,924,1000.00,8000.00,9000.00,3990.67,4009.33,0.28,1
7466,924,-1000.00,7000.00,8000.00,4644.00,4356.00,0.20,0
7467,924,-1000.00,6000.00,7000.00,5096.26,2903.74,0.03,0
7468,924,-1000.00,5000.00,6000.00,2734.61,0.00,0.12,0
7469,924,1000.00,6000.00,7000.00,1938.74,4061.26,0.16,1
7470,924,1000.00,7000.00,8000.00,0.00,7000.00,0.22,1
7471,924,1000.00,8000.00,9000.00,2099.73,5900.27,0.40,1
7472,924,-1000.00,7000.00,8000.00,6918.83,2081.17,0.05,0
7473,924,1000.00,8000.00,9000.00,4000.00,4000.00,0.06,1
7474,924,-1000.00,7000.00,8000.00,5600.31,3399.69,0.26,0
7475,924,1000.00,8000.00,9000.00,3089.01,4910.99,0.29,1
7476,924,1000.00,9000.00,10000.00,0.00,9000.00,0.04,1
7477,924,-1000.00,8000.00,9000.00,6324.60,3675.40,0.21,0
7478,924,1000.00,9000.00,10000.00,0.00,9000.00,0.29,1
7479,924,1000.00,10000.00,11000.00,0.00,10000.00,0.00,1
7480,924,-1000.00,9000.00,10000.00,2794.99,8205.01,0.36,0
7481,924,-1000.00,8000.00,9000.00,0.00,8582.31,0.09,0
7482,924,-1000.00,7000.00,8000.00,0.00,4721.53,0.36,0
7483,924,-1000.00,6000.00,7000.00,3613.30,4386.70,0.21,0
7484,924,-1000.00,5000.00,6000.00,0.00,7000.00,0.26,0
7485,924,-1000.00,4000.00,5000.00,3000.00,3000.00,0.29,0
7486,924,-1000.00,3000.00,4000.00,0.00,4509.03,0.33,0
7487,924,-1000.00,2000.00,3000.00,0.00,2941.54,0.41,0
7488,924,-1000.00,1000.00,2000.00,0.00,3000.00,0.09,0
7489,924,-1000.00,0.00,1000.00,0.00,2000.00,0.38,0
7490,924,-1000.00,-1000.00,0.00,0.00,1000.00,0.01,0
7491,925,1000.00,1000.00,2000.00,244.05,755.95,0.39,1
7492,925,1000.00,2000.00,3000.00,105.97,1525.73,0.41,1
7493,925,1000.00,3000.00,4000.00,1500.00,1500.00,0.10,1
7494,925,1000.00,4000.00,5000.00,0.00,3379.90,0.40,1
7495,925,1000.00,5000.00,6000.00,1192.04,3807.96,0.44,1
7496,925,1000.00,6000.00,7000.00,2801.29,3198.71,0.18,1
7497,925,1000.00,7000.00,8000.00,0.00,7000.00,0.08,1
7498,925,1000.00,8000.00,9000.00,0.00,8000.00,0.19,1
7499,925,1000.00,9000.00,10000.00,0.00,8180.99,0.29,1
7500,925,1000.00,10000.00,11000.00,0.00,10000.00,0.23,1
7501,925,1000.00,11000.00,12000.00,4363.78,6636.22,0.30,1
7502,925,1000.00,12000.00,13000.00,0.00,12000.00,0.11,1
7503,925,-1000.00,11000.00,12000.00,8001.55,4998.45,0.17,0
7504,925,1000.00,12000.00,13000.00,0.00,12000.00,0.20,1
7505,925,1000.00,13000.00,14000.00,2225.21,10774.79,0.35,1
7506,925,1000.00,14000.00,15000.00,0.00,9089.32,0.10,1
7507,925,1000.00,15000.00,16000.00,3399.48,8885.25,0.35,1
7508,925,1000.00,16000.00,17000.00,0.00,7142.00,0.15,1
7509,925,1000.00,17000.00,18000.00,0.00,17000.00,0.08,1
7510,925,1000.00,18000.00,19000.00,7485.58,9757.14,0.32,1
7511,925,1000.00,19000.00,20000.00,0.00,19000.00,0.28,1
7512,925,1000.00,20000.00,21000.00,6236.13,13763.87,0.42,1
7513,925,1000.00,21000.00,22000.00,5462.28,15537.72,0.43,1
7514,925,-1000.00,20000.00,21000.00,5013.14,0.00,0.06,0
7515,925,1000.00,21000.00,22000.00,7053.32,13946.68,0.28,1
7516,925,1000.00,22000.00,23000.00,0.00,7264.35,0.21,1
7517,925,1000.00,23000.00,24000.00,0.00,23000.00,0.37,1
7518,925,1000.00,24000.00,25000.00,10074.49,13925.51,0.12,1
7519,925,1000.00,25000.00,26000.00,0.00,19810.33,0.26,1
7520,925,1000.00,26000.00,27000.00,0.00,18233.12,0.05,1
7521,925,1000.00,27000.00,28000.00,12397.08,14602.92,0.10,1
7522,925,1000.00,28000.00,29000.00,0.00,28000.00,0.13,1
7523,925,1000.00,29000.00,30000.00,4679.09,24320.91,0.01,1
7524,925,1000.00,30000.00,31000.00,14985.73,15014.27,0.21,1
7525,925,1000.00,31000.00,32000.00,14983.88,16016.12,0.31,1
7526,925,1000.00,32000.00,33000.00,0.00,32000.00,0.26,1
7527,925,1000.00,33000.00,34000.00,14705.94,18294.06,0.10,1
7528,925,1000.00,34000.00,35000.00,4958.56,28082.63,0.38,1
7529,925,1000.00,35000.00,36000.00,4764.40,23123.00,0.37,1
7530,925,1000.00,36000.00,37000.00,0.00,34907.12,0.30,1
7531,926,1000.00,1000.00,2000.00,0.00,1000.00,0.31,1
7532,926,1000.00,2000.00,3000.00,0.00,2000.00,0.31,1
7533,926,1000.00,3000.00,4000.00,358.18,2641.82,0.38,1
7534,926,1000.00,4000.00,5000.00,646.37,1775.42,0.29,1
7535,926,1000.00,5000.00,6000.00,2388.28,2611.72,0.15,1
7536,926,1000.00,6000.00,7000.00,0.00,6000.00,0.14,1
7537,926,1000.00,7000.00,8000.00,1772.52,5227.48,0.39,1
7538,926,1000.00,8000.00,9000.00,3536.47,4463.53,0.31,1
7539,926,1000.00,9000.00,10000.00,4007.68,4992.32,0.16,1
7540,926,1000.00,10000.00,11000.00,2109.84,4817.18,0.32,1
7541,926,1000.00,11000.00,12000.00,1551.81,9448.19,0.18,1
7542,926,-1000.00,10000.00,11000.00,10181.10,1395.95,0.08,0
7543,926,1000.00,11000.00,12000.00,0.00,4663.15,0.18,1
7544,926,1000.00,12000.00,13000.00,4905.40,7094.60,0.23,1
7545,926,1000.00,13000.00,14000.00,2776.88,10223.12,0.31,1
7546,926,1000.00,14000.00,15000.00,0.00,11076.82,0.15,1
7547,926,1000.00,15000.00,16000.00,5314.60,9685.40,0.04,1
7548,926,1000.00,16000.00,17000.00,0.00,16000.00,0.37,1
7549,926,1000.00,17000.00,18000.00,8500.00,8500.00,0.09,1
7550,926,1000.00,18000.00,19000.00,4588.58,13411.42,0.05,1
7551,926,-1000.00,17000.00,18000.00,9541.90,9458.10,0.24,0
7552,926,1000.00,18000.00,19000.00,1804.43,16195.57,0.31,1
7553,926,1000.00,19000.00,20000.00,0.00,19000.00,0.12,1
7554,926,1000.00,20000.00,21000.00,0.00,15260.35,0.39,1
7555,926,-1000.00,19000.00,20000.00,10500.00,10500.00,0.06,0
7556,926,-1000.00,18000.00,19000.00,0.00,20000.00,0.25,0
7557,926,-1000.00,17000.00,18000.00,0.00,19000.00,0.25,0
7558,926,-1000.00,16000.00,17000.00,6763.14,11236.86,0.24,0
7559,926,-1000.00,15000.00,16000.00,6558.21,10441.79,0.19,0
7560,926,-1000.00,14000.00,15000.00,10293.76,5706.24,0.10,0
7561,926,-1000.00,13000.00,14000.00,0.00,11454.04,0.30,0
7562,926,-1000.00,12000.00,13000.00,3864.81,10135.19,0.42,0
7563,926,-1000.00,11000.00,12000.00,4131.17,8702.03,0.35,0
7564,926,-1000.00,10000.00,11000.00,0.00,12000.00,0.37,0
7565,926,-1000.00,9000.00,10000.00,1225.10,4639.79,0.29,0
7566,926,-1000.00,8000.00,9000.00,1357.50,8642.50,0.20,0
7567,926,-1000.00,7000.00,8000.00,0.00,6699.53,0.38,0
7568,926,-1000.00,6000.00,7000.00,0.00,8000.00,0.31,0
7569,926,-1000.00,5000.00,6000.00,4317.18,2682.82,0.10,0
7570,926,-1000.00,4000.00,5000.00,96.56,1628.30,0.21,0
7571,926,-1000.00,3000.00,4000.00,0.00,5000.00,0.22,0
7572,926,-1000.00,2000.00,3000.00,2176.34,1766.58,0.30,0
7573,926,-1000.00,1000.00,2000.00,0.00,2470.12,0.43,0
7574,926,-1000.00,0.00,1000.00,0.00,1042.08,0.40,0
7575,926,0.00,0.00,1000.00,0.00,0.00,0.12,0
7576,926,-715.51,-715.51,284.49,0.00,715.51,0.27,0
7577,926,-151.81,-867.32,132.68,0.00,151.81,0.29,0
7578,926,-132.68,-1000.00,0.00,12.43,120.25,0.12,0
7579,927,1000.00,1000.00,2000.00,0.00,500.46,0.20,1
7580,927,1000.00,2000.00,3000.00,44.48,1955.52,0.07,1
7581,927,1000.00,3000.00,4000.00,0.00,3000.00,0.34,1
7582,927,1000.00,4000.00,5000.00,0.00,3083.60,0.20,1
7583,927,1000.00,5000.00,6000.00,0.00,5000.00,0.29,1
7584,927,1000.00,6000.00,7000.00,2626.00,3374.00,0.03,1
7585,927,1000.00,7000.00,8000.00,0.00,2220.62,0.09,1
7586,927,1000.00,8000.00,9000.00,2720.10,5279.90,0.23,1
7587,927,1000.00,9000.00,10000.00,2653.68,6346.32,0.42,1
7588,927,1000.00,10000.00,11000.00,0.00,5270.06,0.10,1
7589,927,1000.00,11000.00,12000.00,0.00,11000.00,0.08,1
7590,927,1000.00,12000.00,13000.00,0.00,12000.00,0.34,1
7591,927,1000.00,13000.00,14000.00,6192.52,6807.48,0.12,1
7592,927,1000.00,14000.00,15000.00,1779.29,12220.71,0.43,1
7593,927,1000.00,15000.00,16000.00,3963.30,11036.70,0.36,1
7594,927,1000.00,16000.00,17000.00,3435.09,12507.76,0.41,1
7595,927,1000.00,17000.00,18000.00,0.00,8087.49,0.15,1
7596,927,1000.00,18000.00,19000.00,2164.32,15835.68,0.40,1
7597,927,1000.00,19000.00,20000.00,7829.52,11170.48,0.10,1
7598,927,1000.00,20000.00,21000.00,0.00,20000.00,0.38,1
7599,927,1000.00,21000.00,22000.00,5293.95,15706.05,0.08,1
7600,927,1000.00,22000.00,23000.00,10663.33,11336.67,0.02,1
7601,927,1000.00,23000.00,24000.00,0.00,17089.18,0.02,1
7602,927,1000.00,24000.00,25000.00,0.00,11045.56,0.28,1
7603,927,-1000.00,23000.00,24000.00,13874.20,11125.80,0.33,0
7604,927,-1000.00,22000.00,23000.00,6817.50,17182.50,0.36,0
7605,927,-1000.00,21000.00,22000.00,0.00,20981.41,0.40,0
7606,927,-1000.00,20000.00,21000.00,0.00,22000.00,0.42,0
7607,927,-1000.00,19000.00,20000.00,0.00,4856.07,0.06,0
7608,927,-1000.00,18000.00,19000.00,6730.95,13269.05,0.06,0
7609,927,-1000.00,17000.00,18000.00,3327.11,15672.89,0.42,0
7610,927,-1000.00,16000.00,17000.00,0.00,13947.28,0.36,0
7611,927,-1000.00,15000.00,16000.00,6526.45,10473.55,0.02,0
7612,927,-1000.00,14000.00,15000.00,0.00,16000.00,0.09,0
7613,927,-1000.00,13000.00,14000.00,12223.86,2776.14,0.04,0
7614,927,-1000.00,12000.00,13000.00,5747.82,8252.18,0.31,0
7615,927,-1000.00,11000.00,12000.00,0.00,5790.65,0.26,0
7616,927,-1000.00,10000.00,11000.00,0.00,11749.23,0.42,0
7617,927,-1000.00,9000.00,10000.00,5453.33,2435.23,0.17,0
7618,927,-1000.00,8000.00,9000.00,0.00,8495.44,0.42,0
7619,927,-1000.00,7000.00,8000.00,0.00,5583.85,0.34,0
7620,927,-1000.00,6000.00,7000.00,999.15,7000.85,0.34,0
7621,927,-1000.00,5000.00,6000.00,0.00,7000.00,0.07,0
7622,927,-1000.00,4000.00,5000.00,0.00,1368.10,0.27,0
7623,927,-1000.00,3000.00,4000.00,1363.97,3636.03,0.36,0
7624,927,-1000.00,2000.00,3000.00,0.00,1695.28,0.29,0
7625,927,-1000.00,1000.00,2000.00,831.60,2168.40,0.31,0
7626,927,-1000.00,0.00,1000.00,875.38,1124.62,0.22,0
7627,927,-713.70,-713.70,286.30,0.00,713.70,0.38,0
7628,927,-286.30,-1000.00,0.00,111.37,174.94,0.27,0
7629,928,1000.00,1000.00,2000.00,404.03,595.97,0.18,1
7630,928,1000.00,2000.00,3000.00,255.37,1744.63,0.43,1
7631,928,1000.00,3000.00,4000.00,0.00,3000.00,0.02,1
7632,928,1000.00,4000.00,5000.00,0.00,4000.00,0.29,1
7633,928,-1000.00,3000.00,4000.00,2540.13,2459.87,0.15,0
7634,928,1000.00,4000.00,5000.00,832.06,3167.94,0.41,1
7635,928,1000.00,5000.00,6000.00,0.00,5000.00,0.41,1
7636,928,1000.00,6000.00,7000.00,0.00,6000.00,0.14,1
7637,928,1000.00,7000.00,8000.00,0.00,4894.03,0.35,1
7638,928,1000.00,8000.00,9000.00,0.00,4983.43,0.15,1
7639,928,-1000.00,7000.00,8000.00,3805.03,3466.91,0.23,0
7640,928,1000.00,8000.00,9000.00,1847.99,6152.01,0.11,1
7641,928,1000.00,9000.00,10000.00,3084.26,5915.74,0.43,1
7642,928,1000.00,10000.00,11000.00,1789.59,8210.41,0.11,1
7643,928,1000.00,11000.00,12000.00,5297.23,5702.77,0.25,1
7644,928,1000.00,12000.00,13000.00,1937.66,10062.34,0.38,1
7645,928,1000.00,13000.00,14000.00,4914.38,8085.62,0.41,1
7646,928,-1000.00,12000.00,13000.00,6188.92,1632.58,0.14,0
7647,928,-1000.00,11000.00,12000.00,7521.37,5478.63,0.19,0
7648,928,1000.00,12000.00,13000.00,4273.48,7726.52,0.13,1
7649,928,1000.00,13000.00,14000.00,784.01,9257.45,0.43,1
7650,928,1000.00,14000.00,15000.00,394.59,6197.56,0.30,1
7651,928,-1000.00,13000.00,14000.00,7246.29,7753.71,0.44,0
7652,928,-1000.00,12000.00,13000.00,3591.66,10408.34,0.08,0
7653,928,-1000.00,11000.00,12000.00,5519.01,7480.99,0.32,0
7654,928,-1000.00,10000.00,11000.00,0.00,9455.00,0.03,0
7655,928,-1000.00,9000.00,10000.00,0.00,11000.00,0.36,0
7656,928,-1000.00,8000.00,9000.00,4430.25,5569.75,0.27,0
7657,928,-1000.00,7000.00,8000.00,0.00,8828.36,0.32,0
7658,928,-1000.00,6000.00,7000.00,4000.00,4000.00,0.07,0
7659,928,-1000.00,5000.00,6000.00,0.00,7000.00,0.18,0
7660,928,-1000.00,4000.00,5000.00,3889.10,2110.90,0.08,0
7661,928,-1000.00,3000.00,4000.00,0.00,3623.10,0.28,0
7662,928,-1000.00,2000.00,3000.00,0.00,2275.58,0.24,0
7663,928,-1000.00,1000.00,2000.00,1972.34,1027.66,0.17,0
7664,928,-1000.00,0.00,1000.00,0.00,1930.73,0.34,0
7665,928,-1000.00,-1000.00,0.00,82.85,917.15,0.22,0
7666,928,-0.00,-1000.00,0.00,0.00,0.00,0.41,0
7667,929,1000.00,1000.00,2000.00,138.29,189.37,0.18,1
7668,929,1000.00,2000.00,3000.00,0.00,2000.00,0.41,1
7669,929,1000.00,3000.00,4000.00,1172.02,1827.98,0.29,1
7670,929,1000.00,4000.00,5000.00,823.99,3176.01,0.41,1
7671,929,1000.00,5000.00,6000.00,2500.00,2500.00,0.23,1
7672,929,1000.00,6000.00,7000.00,1448.52,4551.48,0.02,1
7673,929,1000.00,7000.00,8000.00,0.00,7000.00,0.36,1
7674,929,1000.00,8000.00,9000.00,0.00,8000.00,0.02,1
7675,929,1000.00,9000.00,10000.00,4500.00,4500.00,0.05,1
7676,929,1000.00,10000.00,11000.00,5000.00,5000.00,0.26,1
7677,929,1000.00,11000.00,12000.00,0.00,6942.81,0.28,1
7678,929,1000.00,12000.00,13000.00,4596.51,7403.49,0.33,1
7679,929,-1000.00,11000.00,12000.00,10869.57,0.00,0.02,0
7680,929,1000.00,12000.00,13000.00,881.04,11118.96,0.41,1
7681,929,-1000.00,11000.00,12000.00,8113.56,4886.44,0.18,0
7682,929,1000.00,12000.00,13000.00,2916.73,9083.27,0.37,1
7683,929,1000.00,13000.00,14000.00,490.59,12509.41,0.39,1
7684,929,1000.00,14000.00,15000.00,0.00,5673.89,0.16,1
7685,929,1000.00,15000.00,16000.00,2646.87,12353.13,0.39,1
7686,929,1000.00,16000.00,17000.00,8000.00,8000.00,0.17,1
7687,929,1000.00,17000.00,18000.00,0.00,17000.00,0.07,1
7688,929,1000.00,18000.00,19000.00,0.00,18000.00,0.02,1
7689,929,1000.00,19000.00,20000.00,9436.43,9563.57,0.24,1
7690,929,-1000.00,18000.00,19000.00,10370.50,9629.50,0.44,0
7691,929,1000.00,19000.00,20000.00,0.00,19000.00,0.12,1
7692,929,1000.00,20000.00,21000.00,10000.00,10000.00,0.02,1
7693,929,1000.00,21000.00,22000.00,0.00,20383.13,0.33,1
7694,929,1000.00,22000.00,23000.00,11000.00,11000.00,0.10,1
7695,929,1000.00,23000.00,24000.00,11049.51,11950.49,0.27,1
7696,929,1000.00,24000.00,25000.00,0.00,18643.59,0.27,1
7697,929,1000.00,25000.00,26000.00,0.00,25000.00,0.06,1
7698,929,1000.00,26000.00,27000.00,0.00,10884.18,0.22,1
7699,929,1000.00,27000.00,28000.00,2536.78,24463.22,0.41,1
7700,929,-1000.00,26000.00,27000.00,15164.12,12835.88,0.14,0
7701,929,1000.00,27000.00,28000.00,0.00,3283.80,0.16,1
7702,929,1000.00,28000.00,29000.00,4116.44,23883.56,0.42,1
7703,929,1000.00,29000.00,30000.00,0.00,29000.00,0.37,1
7704,929,1000.00,30000.00,31000.00,6539.54,23460.46,0.40,1
7705,929,1000.00,31000.00,32000.00,15500.00,15500.00,0.01,1
7706,929,1000.00,32000.00,33000.00,0.00,26546.13,0.06,1
7707,929,1000.00,33000.00,34000.00,13458.00,19542.00,0.27,1
7708,929,1000.00,34000.00,35000.00,16938.77,17061.23,0.37,1
7709,929,1000.00,35000.00,36000.00,7599.26,27400.74,0.35,1
7710,929,1000.00,36000.00,37000.00,2098.66,26462.24,0.36,1
7711,929,1000.00,37000.00,38000.00,0.00,37000.00,0.24,1
7712,929,1000.00,38000.00,39000.00,4866.69,33133.31,0.32,1
7713,929,1000.00,39000.00,40000.00,10907.04,28092.96,0.27,1
7714,930,-1000.00,-1000.00,0.00,133.62,866.38,0.43,0
7715,931,1000.00,1000.00,2000.00,0.00,849.23,0.41,1
7716,931,1000.00,2000.00,3000.00,926.24,1073.76,0.22,1
7717,931,1000.00,3000.00,4000.00,993.40,2006.60,0.43,1
7718,931,1000.00,4000.00,5000.00,298.87,3701.13,0.22,1
7719,931,0.00,4000.00,5000.00,0.00,0.00,0.05,0
7720,931,1000.00,5000.00,6000.00,0.00,5000.00,0.18,1
7721,931,1000.00,6000.00,7000.00,2558.99,3441.01,0.13,1
7722,931,-1000.00,5000.00,6000.00,3519.15,3480.85,0.37,0
7723,931,1000.00,6000.00,7000.00,3000.00,3000.00,0.13,1
7724,931,-1000.00,5000.00,6000.00,4070.06,2929.94,0.13,0
7725,931,1000.00,6000.00,7000.00,2920.02,3079.98,0.36,1
7726,931,1000.00,7000.00,8000.00,0.00,7000.00,0.19,1
7727,931,1000.00,8000.00,9000.00,0.00,8000.00,0.03,1
7728,931,1000.00,9000.00,10000.00,3728.51,5271.49,0.16,1
7729,931,1000.00,10000.00,11000.00,2821.87,7178.13,0.30,1
7730,931,-1000.00,9000.00,10000.00,6346.70,3237.54,0.18,0
7731,931,1000.00,10000.00,11000.00,0.00,7892.52,0.30,1
7732,931,-1000.00,9000.00,10000.00,2519.63,51.17,0.11,0
7733,931,1000.00,10000.00,11000.00,0.00,7945.74,0.25,1
7734,931,1000.00,11000.00,12000.00,0.00,11000.00,0.16,1
7735,931,1000.00,12000.00,13000.00,0.00,12000.00,0.08,1
7736,931,-1000.00,11000.00,12000.00,12958.16,0.00,0.06,0
7737,931,1000.00,12000.00,13000.00,5906.13,6093.87,0.41,1
7738,931,1000.00,13000.00,14000.00,2593.58,10406.42,0.43,1
7739,931,-1000.00,12000.00,13000.00,11942.42,2057.58,0.08,0
7740,931,-1000.00,11000.00,12000.00,6827.14,6172.86,0.30,0
7741,931,1000.00,12000.00,13000.00,3831.88,8168.12,0.38,1
7742,931,1000.00,13000.00,14000.00,6469.64,6530.36,0.37,1
7743,931,-1000.00,12000.00,13000.00,1545.06,1472.01,0.13,0
7744,931,-1000.00,11000.00,12000.00,11110.85,1889.15,0.11,0
7745,931,1000.00,12000.00,13000.00,5708.49,6291.51,0.30,1
7746,931,1000.00,13000.00,14000.00,0.00,13000.00,0.12,1
7747,931,1000.00,14000.00,15000.00,0.00,14000.00,0.31,1
7748,931,1000.00,15000.00,16000.00,0.00,15000.00,0.09,1
7749,931,1000.00,16000.00,17000.00,2347.66,13652.34,0.15,1
7750,931,1000.00,17000.00,18000.00,4789.39,12210.61,0.34,1
7751,931,1000.00,18000.00,19000.00,4127.85,13872.15,0.30,1
7752,931,1000.00,19000.00,20000.00,0.00,2251.84,0.14,1
7753,931,1000.00,20000.00,21000.00,9323.60,10676.40,0.32,1
7754,931,1000.00,21000.00,22000.00,0.00,12849.98,0.14,1
7755,931,1000.00,22000.00,23000.00,7464.12,14535.88,0.39,1
7756,931,1000.00,23000.00,24000.00,0.00,23000.00,0.07,1
7757,931,1000.00,24000.00,25000.00,0.00,24000.00,0.23,1
7758,931,1000.00,25000.00,26000.00,3210.89,21789.11,0.16,1
7759,931,1000.00,26000.00,27000.00,0.00,26000.00,0.03,1
7760,931,1000.00,27000.00,28000.00,7960.65,19039.35,0.44,1
7761,932,1000.00,1000.00,2000.00,605.66,374.51,0.18,1
7762,932,-1000.00,0.00,1000.00,493.36,1506.64,0.14,0
7763,932,-1000.00,-1000.00,0.00,318.03,681.97,0.31,0
7764,932,0.00,-1000.00,0.00,0.00,0.00,0.11,1
7765,932,-0.00,-1000.00,0.00,0.00,0.00,0.32,0
7766,932,-0.00,-1000.00,0.00,0.00,0.00,0.40,0
7767,933,1000.00,1000.00,2000.00,0.00,1000.00,0.35,1
7768,933,-1000.00,0.00,1000.00,1035.28,964.72,0.00,0
7769,933,1000.00,1000.00,2000.00,308.96,691.04,0.26,1
7770,933,1000.00,2000.00,3000.00,781.00,1219.00,0.30,1
7771,933,-1000.00,1000.00,2000.00,1763.13,155.34,0.13,0
7772,933,1000.00,2000.00,3000.00,608.29,1391.71,0.43,1
7773,933,1000.00,3000.00,4000.00,1500.00,1500.00,0.17,1
7774,933,1000.00,4000.00,5000.00,0.00,4000.00,0.23,1
7775,933,1000.00,5000.00,6000.00,478.40,4521.60,0.37,1
7776,933,1000.00,6000.00,7000.00,1973.97,4026.03,0.33,1
7777,933,1000.00,7000.00,8000.00,0.00,930.16,0.11,1
7778,933,1000.00,8000.00,9000.00,1809.71,6190.29,0.41,1
7779,933,-1000.00,7000.00,8000.00,6458.48,2541.52,0.10,0
7780,933,1000.00,8000.00,9000.00,2644.26,5355.74,0.29,1
7781,933,1000.00,9000.00,10000.00,4216.36,4783.64,0.17,1
7782,933,1000.00,10000.00,11000.00,4246.45,5753.55,0.21,1
7783,933,-1000.00,9000.00,10000.00,2969.03,1356.46,0.16,0
7784,933,1000.00,10000.00,11000.00,2885.22,7114.78,0.44,1
7785,933,1000.00,11000.00,12000.00,2489.11,8510.89,0.23,1
7786,933,1000.00,12000.00,13000.00,3564.72,8435.28,0.43,1
7787,933,-1000.00,11000.00,12000.00,7985.53,5014.47,0.23,0
7788,933,-1000.00,10000.00,11000.00,3189.82,8810.18,0.36,0
7789,933,-1000.00,9000.00,10000.00,0.00,9376.32,0.43,0
7790,933,-1000.00,8000.00,9000.00,3425.91,6574.09,0.23,0
7791,933,-1000.00,7000.00,8000.00,3597.75,5402.25,0.44,0
7792,933,-1000.00,6000.00,7000.00,3391.72,4608.28,0.42,0
7793,933,-1000.00,5000.00,6000.00,1905.69,5094.31,0.43,0
7794,933,-1000.00,4000.00,5000.00,1805.40,4194.60,0.43,0
7795,933,-1000.00,3000.00,4000.00,0.00,5000.00,0.11,0
7796,933,-1000.00,2000.00,3000.00,1970.04,2029.96,0.15,0
7797,933,-1000.00,1000.00,2000.00,106.07,2176.97,0.41,0
7798,933,-1000.00,0.00,1000.00,699.34,1300.66,0.30,0
7799,933,-740.63,-740.63,259.37,263.40,477.23,0.29,0
7800,933,-118.05,-858.68,141.32,0.00,118.05,0.10,0
7801,933,-132.75,-991.43,8.57,0.00,132.75,0.10,0
7802,933,-8.57,-1000.00,0.00,1.38,7.20,0.42,0
7803,934,-1000.00,-1000.00,0.00,0.00,1000.00,0.32,0
7804,935,-1000.00,-1000.00,0.00,500.00,500.00,0.00,0
7805,936,-1000.00,-1000.00,0.00,150.31,849.69,0.40,0
7806,937,-900.54,-900.54,99.46,882.26,18.28,0.05,0
7807,937,-1000.00,-1900.54,-900.54,35.65,63.81,0.31,0
7808,938,1000.00,1000.00,2000.00,124.03,572.37,0.35,1
7809,938,1000.00,2000.00,3000.00,0.00,2000.00,0.37,1
7810,938,1000.00,3000.00,4000.00,0.00,831.92,0.15,1
7811,938,1000.00,4000.00,5000.00,2000.00,2000.00,0.08,1
7812,938,1000.00,5000.00,6000.00,0.00,5000.00,0.33,1
7813,938,1000.00,6000.00,7000.00,2390.40,3609.60,0.23,1
7814,938,1000.00,7000.00,8000.00,0.00,1547.26,0.17,1
7815,938,1000.00,8000.00,9000.00,0.00,8000.00,0.32,1
7816,938,1000.00,9000.00,10000.00,0.00,9000.00,0.13,1
7817,938,-1000.00,8000.00,9000.00,7351.05,2648.95,0.12,0
7818,938,-1000.00,7000.00,8000.00,9000.00,0.00,0.02,0
7819,938,-1000.00,6000.00,7000.00,5260.91,2739.09,0.07,0
7820,938,1000.00,7000.00,8000.00,3197.98,3802.02,0.13,1
7821,938,1000.00,8000.00,9000.00,2467.23,3121.98,0.25,1
7822,938,1000.00,9000.00,10000.00,0.00,2582.86,0.21,1
7823,938,1000.00,10000.00,11000.00,4133.29,5866.71,0.16,1
7824,938,1000.00,11000.00,12000.00,2898.27,8101.73,0.41,1
7825,938,1000.00,12000.00,13000.00,0.00,12000.00,0.21,1
7826,938,1000.00,13000.00,14000.00,0.00,12181.63,0.38,1
7827,938,-1000.00,12000.00,13000.00,14000.00,0.00,0.01,0
7828,938,-1000.00,11000.00,12000.00,7658.83,5341.17,0.07,0
7829,938,-1000.00,10000.00,11000.00,6368.27,5631.73,0.23,0
7830,938,0.00,10000.00,11000.00,0.00,0.00,0.01,0
7831,938,1000.00,11000.00,12000.00,2691.92,8308.08,0.37,1
7832,938,-1000.00,10000.00,11000.00,12000.00,0.00,0.14,0
7833,938,1000.00,11000.00,12000.00,0.00,11000.00,0.18,1
7834,938,1000.00,12000.00,13000.00,4365.42,7634.58,0.07,1
7835,938,1000.00,13000.00,14000.00,4313.71,7972.21,0.36,1
7836,938,0.00,13000.00,14000.00,0.00,0.00,0.10,0
7837,938,-1000.00,12000.00,13000.00,1621.65,0.00,0.09,0
7838,938,1000.00,13000.00,14000.00,4904.49,6041.55,0.29,1
7839,938,1000.00,14000.00,15000.00,3904.49,10095.51,0.41,1
7840,938,-1000.00,13000.00,14000.00,9641.99,5358.01,0.21,0
7841,938,1000.00,14000.00,15000.00,0.00,10792.31,0.14,1
7842,938,-1000.00,13000.00,14000.00,7193.97,4736.92,0.23,0
7843,938,1000.00,14000.00,15000.00,3601.56,8219.16,0.35,1
7844,938,1000.00,15000.00,16000.00,0.00,15000.00,0.39,1
7845,938,1000.00,16000.00,17000.00,0.00,9289.61,0.21,1
7846,938,-1000.00,15000.00,16000.00,11781.83,5218.17,0.07,0
7847,938,1000.00,16000.00,17000.00,0.00,16000.00,0.02,1
7848,938,1000.00,17000.00,18000.00,0.00,17000.00,0.04,1
7849,939,1000.00,1000.00,2000.00,0.00,96.94,0.16,1
7850,939,1000.00,2000.00,3000.00,193.38,1806.62,0.37,1
7851,939,1000.00,3000.00,4000.00,965.46,1604.82,0.32,1
7852,939,1000.00,4000.00,5000.00,0.00,4000.00,0.20,1
7853,939,1000.00,5000.00,6000.00,0.00,5000.00,0.21,1
7854,939,1000.00,6000.00,7000.00,350.78,4218.66,0.42,1
7855,939,1000.00,7000.00,8000.00,1361.36,3329.02,0.32,1
7856,939,1000.00,8000.00,9000.00,2164.25,5835.75,0.38,1
7857,939,-1000.00,7000.00,8000.00,6848.42,1410.03,0.16,0
7858,939,1000.00,8000.00,9000.00,0.00,757.34,0.04,1
7859,939,1000.00,9000.00,10000.00,3486.07,4188.45,0.33,1
7860,939,-1000.00,8000.00,9000.00,8041.18,1478.72,0.09,0
7861,939,1000.00,9000.00,10000.00,2948.77,5062.51,0.35,1
7862,939,1000.00,10000.00,11000.00,0.00,8483.22,0.40,1
7863,939,-1000.00,9000.00,10000.00,7587.64,3412.36,0.14,0
7864,939,1000.00,10000.00,11000.00,493.11,9506.89,0.39,1
7865,939,1000.00,11000.00,12000.00,603.36,9769.71,0.42,1
7866,939,1000.00,12000.00,13000.00,0.00,12000.00,0.01,1
7867,939,1000.00,13000.00,14000.00,0.00,4076.70,0.23,1
7868,939,1000.00,14000.00,15000.00,0.00,11289.35,0.15,1
7869,939,1000.00,15000.00,16000.00,5425.73,9574.27,0.38,1
7870,939,1000.00,16000.00,17000.00,0.00,16000.00,0.20,1
7871,939,1000.00,17000.00,18000.00,0.00,17000.00,0.29,1
7872,939,1000.00,18000.00,19000.00,7421.79,10578.21,0.17,1
7873,939,-1000.00,17000.00,18000.00,14336.93,4186.56,0.20,0
7874,939,-1000.00,16000.00,17000.00,18000.00,0.00,0.02,0
7875,939,-1000.00,15000.00,16000.00,1866.17,14751.91,0.43,0
7876,939,-1000.00,14000.00,15000.00,599.36,11975.72,0.42,0
7877,939,-1000.00,13000.00,14000.00,10925.49,4074.51,0.07,0
7878,939,-1000.00,12000.00,13000.00,0.00,14000.00,0.27,0
7879,939,-1000.00,11000.00,12000.00,0.00,5760.28,0.27,0
7880,939,-1000.00,10000.00,11000.00,0.00,6669.52,0.35,0
7881,939,-1000.00,9000.00,10000.00,0.00,11000.00,0.11,0
7882,939,-1000.00,8000.00,9000.00,0.00,3452.17,0.18,0
7883,939,-1000.00,7000.00,8000.00,171.77,8828.23,0.32,0
7884,939,-1000.00,6000.00,7000.00,6284.44,1715.56,0.00,0
7885,939,-1000.00,5000.00,6000.00,0.00,6791.45,0.19,0
7886,939,-1000.00,4000.00,5000.00,0.00,3094.75,0.33,0
7887,939,-594.17,3405.83,4405.83,0.00,594.17,0.28,0
7888,939,-1000.00,2405.83,3405.83,0.00,3111.11,0.41,0
7889,939,0.00,2405.83,3405.83,0.00,0.00,0.02,0
7890,939,-1000.00,1405.83,2405.83,0.00,3234.13,0.23,0
7891,939,-1000.00,405.83,1405.83,0.00,1039.39,0.28,0
7892,940,-918.82,-918.82,81.18,0.19,918.63,0.43,0
7893,940,-69.75,-988.57,11.43,0.00,69.75,0.42,0
7894,940,-11.43,-1000.00,0.00,1.92,9.51,0.43,0
7895,941,-1000.00,-1000.00,0.00,0.00,1000.00,0.37,0
7896,942,-1000.00,-1000.00,0.00,469.84,530.16,0.06,0
7897,943,-1000.00,-1000.00,0.00,0.00,1000.00,0.31,0
7898,944,-1000.00,-1000.00,0.00,0.00,1000.00,0.16,0
7899,945,-805.26,-805.26,194.74,162.04,643.22,0.37,0
7900,945,-194.74,-1000.00,0.00,50.03,144.72,0.38,0
7901,946,-1000.00,-1000.00,0.00,500.00,500.00,0.07,0
7902,947,-1000.00,-1000.00,0.00,626.76,373.24,0.00,0
7903,948,-1000.00,-1000.00,0.00,0.00,1000.00,0.30,0
7904,949,-1000.00,-1000.00,0.00,0.00,1000.00,0.17,0
7905,950,-1000.00,-1000.00,0.00,452.10,547.90,0.20,0
7906,951,1000.00,1000.00,2000.00,0.00,1000.00,0.13,1
7907,951,1000.00,2000.00,3000.00,0.00,2000.00,0.23,1
7908,951,1000.00,3000.00,4000.00,859.49,2140.51,0.42,1
7909,951,1000.00,4000.00,5000.00,1521.69,2228.75,0.34,1
7910,951,1000.00,5000.00,6000.00,113.54,204.03,0.14,1
7911,951,1000.00,6000.00,7000.00,0.00,835.91,0.04,1
7912,951,-1000.00,5000.00,6000.00,3567.09,3432.91,0.31,0
7913,951,-1000.00,4000.00,5000.00,3788.66,2211.34,0.09,0
7914,951,-1000.00,3000.00,4000.00,1075.20,498.21,0.17,0
7915,951,1000.00,4000.00,5000.00,1102.19,2897.81,0.25,1
7916,951,1000.00,5000.00,6000.00,2013.26,2986.74,0.42,1
7917,951,1000.00,6000.00,7000.00,0.00,6000.00,0.21,1
7918,951,-1000.00,5000.00,6000.00,1187.06,0.00,0.05,0
7919,951,-1000.00,4000.00,5000.00,0.00,3055.14,0.38,0
7920,951,-1000.00,3000.00,4000.00,0.00,5000.00,0.12,0
7921,951,-1000.00,2000.00,3000.00,1226.55,2773.45,0.37,0
7922,951,-1000.00,1000.00,2000.00,1209.32,1790.68,0.12,0
7923,951,-1000.00,0.00,1000.00,1466.39,0.00,0.18,0
7924,951,-1000.00,-1000.00,0.00,0.00,1000.00,0.01,0
7925,952,-1000.00,-1000.00,0.00,262.60,737.40,0.38,0
7926,953,-440.37,-440.37,559.63,0.00,440.37,0.28,0
7927,953,-559.63,-1000.00,0.00,218.35,341.28,0.20,0
7928,954,-831.34,-831.34,168.66,0.00,831.34,0.36,0
7929,954,-168.66,-1000.00,0.00,52.77,115.88,0.38,0
7930,955,1000.00,1000.00,2000.00,0.00,1000.00,0.27,1
7931,955,-1000.00,0.00,1000.00,1500.01,499.99,0.02,0
7932,955,1000.00,1000.00,2000.00,0.00,432.77,0.06,1
7933,955,-1000.00,0.00,1000.00,1028.16,971.84,0.20,0
7934,955,-1000.00,-1000.00,0.00,534.71,465.29,0.30,0
7935,955,0.00,-1000.00,0.00,0.00,0.00,0.20,1
7936,955,0.00,-1000.00,0.00,0.00,0.00,0.10,1
7937,955,0.00,-1000.00,0.00,0.00,0.00,0.06,1
7938,955,0.00,-1000.00,0.00,0.00,0.00,0.20,1
7939,955,0.00,-1000.00,0.00,0.00,0.00,0.28,1
7940,955,0.05,-999.95,0.05,0.00,0.00,0.31,1
7941,955,5.49,-994.46,5.54,0.01,0.04,0.39,1
7942,955,460.42,-534.04,465.96,2.20,3.34,0.33,1
7943,955,1000.00,465.96,1465.96,154.80,311.16,0.32,1
7944,955,1000.00,1465.96,2465.96,718.57,747.38,0.27,1
7945,955,1000.00,2465.96,3465.96,993.46,1045.93,0.25,1
7946,955,1000.00,3465.96,4465.96,0.00,3465.96,0.08,1
7947,955,1000.00,4465.96,5465.96,1558.55,2907.40,0.34,1
7948,955,1000.00,5465.96,6465.96,0.00,3144.38,0.25,1
7949,955,-1000.00,4465.96,5465.96,1905.24,4560.72,0.12,0
7950,955,-1000.00,3465.96,4465.96,3446.50,2019.45,0.05,0
7951,955,-1000.00,2465.96,3465.96,2216.09,2249.86,0.04,0
7952,955,-1000.00,1465.96,2465.96,0.00,3465.96,0.01,0
7953,955,-1000.00,465.96,1465.96,664.48,1801.47,0.05,0
7954,955,-543.40,-77.45,922.55,0.00,543.40,0.19,0
7955,955,-922.55,-1000.00,0.00,288.25,634.31,0.43,0
7956,956,-1000.00,-1000.00,0.00,0.00,1000.00,0.21,0
7957,957,-751.01,-751.01,248.99,0.00,751.01,0.29,0
7958,957,-248.99,-1000.00,0.00,41.04,207.95,0.37,0
7959,957,-0.00,-1000.00,-0.00,0.00,0.00,0.12,0
7960,958,-1000.00,-1000.00,0.00,534.69,465.31,0.08,0
7961,959,-1000.00,-1000.00,0.00,0.00,1000.00,0.38,0
7962,960,-1000.00,-1000.00,0.00,474.49,525.51,0.25,0
7963,961,-1000.00,-1000.00,0.00,272.96,727.04,0.37,0
7964,962,1000.00,1000.00,2000.00,0.00,1000.00,0.44,1
7965,962,1000.00,2000.00,3000.00,342.60,1657.40,0.13,1
7966,962,1000.00,3000.00,4000.00,634.96,2365.04,0.25,1
7967,962,1000.00,4000.00,5000.00,1693.69,2306.31,0.03,1
7968,962,1000.00,5000.00,6000.00,2500.00,2500.00,0.08,1
7969,962,1000.00,6000.00,7000.00,1612.73,4387.27,0.43,1
7970,962,1000.00,7000.00,8000.00,0.00,7000.00,0.01,1
7971,962,1000.00,8000.00,9000.00,2168.95,5630.49,0.39,1
7972,962,1000.00,9000.00,10000.00,0.00,9000.00,0.03,1
7973,962,1000.00,10000.00,11000.00,4237.39,5762.61,0.06,1
7974,962,1000.00,11000.00,12000.00,59.93,4708.22,0.30,1
7975,962,1000.00,12000.00,13000.00,4745.37,7254.63,0.27,1
7976,962,1000.00,13000.00,14000.00,1862.98,11137.02,0.44,1
7977,962,1000.00,14000.00,15000.00,4413.24,9586.76,0.37,1
7978,962,1000.00,15000.00,16000.00,0.00,4725.62,0.16,1
7979,962,1000.00,16000.00,17000.00,0.00,2843.85,0.02,1
7980,962,-1000.00,15000.00,16000.00,16659.73,0.00,0.06,0
7981,962,1000.00,16000.00,17000.00,0.00,11913.43,0.29,1
7982,962,-1000.00,15000.00,16000.00,3562.28,485.08,0.13,0
7983,962,1000.00,16000.00,17000.00,0.00,11833.32,0.22,1
7984,962,1000.00,17000.00,18000.00,3035.07,6790.29,0.28,1
7985,962,-1000.00,16000.00,17000.00,14508.32,3491.68,0.34,0
7986,962,-1000.00,15000.00,16000.00,17000.00,0.00,0.02,0
7987,962,1000.00,16000.00,17000.00,0.00,16000.00,0.21,1
7988,962,1000.00,17000.00,18000.00,0.00,5356.27,0.09,1
7989,962,1000.00,18000.00,19000.00,4081.49,13918.51,0.26,1
7990,962,1000.00,19000.00,20000.00,0.00,19000.00,0.07,1
7991,962,1000.00,20000.00,21000.00,0.00,11339.45,0.23,1
7992,962,1000.00,21000.00,22000.00,0.00,16799.68,0.11,1
7993,962,1000.00,22000.00,23000.00,9671.41,12328.59,0.29,1
7994,962,1000.00,23000.00,24000.00,5539.54,17460.46,0.33,1
7995,962,1000.00,24000.00,25000.00,0.00,24000.00,0.14,1
7996,962,1000.00,25000.00,26000.00,7232.93,17767.07,0.21,1
7997,962,-1000.00,24000.00,25000.00,10410.03,6325.21,0.33,0
7998,962,1000.00,25000.00,26000.00,2367.37,17941.44,0.40,1
7999,962,1000.00,26000.00,27000.00,0.00,24083.14,0.40,1
8000,962,-1000.00,25000.00,26000.00,18435.08,8564.92,0.04,0
8001,962,1000.00,26000.00,27000.00,0.00,26000.00,0.14,1
8002,962,1000.00,27000.00,28000.00,0.00,14457.55,0.32,1
8003,962,1000.00,28000.00,29000.00,9330.62,18669.38,0.36,1
8004,962,-1000.00,27000.00,28000.00,22045.46,6954.54,0.20,0
8005,962,1000.00,28000.00,29000.00,13495.62,14504.38,0.29,1
8006,962,1000.00,29000.00,30000.00,6413.89,22586.11,0.05,1
8007,962,1000.00,30000.00,31000.00,15000.00,15000.00,0.04,1
8008,962,-1000.00,29000.00,30000.00,31000.00,0.00,0.00,0
8009,962,1000.00,30000.00,31000.00,15000.00,15000.00,0.10,1
8010,962,-1000.00,29000.00,30000.00,18030.01,12969.99,0.12,0
8011,962,1000.00,30000.00,31000.00,5056.91,24943.09,0.39,1
8012,962,-1000.00,29000.00,30000.00,31000.00,0.00,0.01,0
8013,962,1000.00,30000.00,31000.00,0.00,30000.00,0.04,1
8014,962,1000.00,31000.00,32000.00,15286.40,15713.60,0.18,1
8015,962,-1000.00,30000.00,31000.00,16614.22,15385.78,0.19,0
8016,962,1000.00,31000.00,32000.00,0.00,31000.00,0.21,1
8017,962,1000.00,32000.00,33000.00,10299.02,21700.98,0.31,1
8018,962,1000.00,33000.00,34000.00,0.00,25944.28,0.22,1
8019,962,1000.00,34000.00,35000.00,17000.00,17000.00,0.12,1
8020,962,1000.00,35000.00,36000.00,3124.95,31875.05,0.37,1
8021,962,-1000.00,34000.00,35000.00,33975.33,2024.67,0.04,0
8022,962,1000.00,35000.00,36000.00,0.00,32817.41,0.44,1
8023,962,1000.00,36000.00,37000.00,0.00,36000.00,0.19,1
8024,962,1000.00,37000.00,38000.00,0.00,37000.00,0.33,1
8025,962,1000.00,38000.00,39000.00,11998.75,26001.25,0.42,1
8026,962,1000.00,39000.00,40000.00,1171.80,37828.20,0.18,1
8027,962,1000.00,40000.00,41000.00,0.00,40000.00,0.05,1
8028,962,1000.00,41000.00,42000.00,7739.40,33260.60,0.03,1
8029,962,-1000.00,40000.00,41000.00,31234.31,10765.69,0.04,0
8030,962,1000.00,41000.00,42000.00,7584.58,33415.42,0.22,1
8031,962,1000.00,42000.00,43000.00,0.00,42000.00,0.11,1
8032,962,1000.00,43000.00,44000.00,8609.27,34390.73,0.28,1
8033,963,-1000.00,-1000.00,0.00,736.12,263.88,0.06,0
8034,964,1000.00,1000.00,2000.00,0.00,1000.00,0.35,1
8035,964,1000.00,2000.00,3000.00,795.42,1204.58,0.22,1
8036,964,1000.00,3000.00,4000.00,1500.00,1500.00,0.02,1
8037,964,1000.00,4000.00,5000.00,780.91,3219.09,0.44,1
8038,964,1000.00,5000.00,6000.00,0.00,3453.67,0.09,1
8039,964,1000.00,6000.00,7000.00,0.00,4205.98,0.33,1
8040,964,1000.00,7000.00,8000.00,639.76,6360.24,0.23,1
8041,964,1000.00,8000.00,9000.00,2999.01,5000.99,0.32,1
8042,964,-1000.00,7000.00,8000.00,5817.88,3182.12,0.05,0
8043,964,1000.00,8000.00,9000.00,2373.91,5626.09,0.43,1
8044,964,1000.00,9000.00,10000.00,3467.13,5532.87,0.33,1
8045,964,1000.00,10000.00,11000.00,0.00,101.30,0.01,1
8046,964,1000.00,11000.00,12000.00,0.00,11000.00,0.02,1
8047,964,1000.00,12000.00,13000.00,0.00,12000.00,0.12,1
8048,964,1000.00,13000.00,14000.00,2728.71,10271.29,0.25,1
8049,964,1000.00,14000.00,15000.00,0.00,6512.63,0.23,1
8050,964,1000.00,15000.00,16000.00,3537.46,11462.54,0.43,1
8051,964,-1000.00,14000.00,15000.00,8000.00,8000.00,0.02,0
8052,964,-1000.00,13000.00,14000.00,2879.55,12120.45,0.13,0
8053,964,-1000.00,12000.00,13000.00,8414.94,2246.36,0.11,0
8054,964,-1000.00,11000.00,12000.00,0.00,5177.03,0.18,0
8055,964,-1000.00,10000.00,11000.00,0.00,12000.00,0.06,0
8056,964,-1000.00,9000.00,10000.00,0.00,11000.00,0.31,0
8057,964,-1000.00,8000.00,9000.00,0.00,10000.00,0.30,0
8058,964,-1000.00,7000.00,8000.00,0.00,4613.18,0.22,0
8059,964,-1000.00,6000.00,7000.00,5345.44,2654.56,0.02,0
8060,964,-1000.00,5000.00,6000.00,0.00,7000.00,0.37,0
8061,964,-1000.00,4000.00,5000.00,829.00,5171.00,0.38,0
8062,964,-1000.00,3000.00,4000.00,5000.00,0.00,0.01,0
8063,964,-1000.00,2000.00,3000.00,0.00,3295.22,0.34,0
8064,964,-1000.00,1000.00,2000.00,0.00,3000.00,0.33,0
8065,964,-1000.00,0.00,1000.00,634.12,1365.88,0.36,0
8066,964,-1000.00,-1000.00,0.00,974.00,0.00,0.10,0
8067,965,-1000.00,-1000.00,0.00,166.36,833.64,0.14,0
8068,966,-1000.00,-1000.00,0.00,0.00,1000.00,0.04,0
8069,967,-858.69,-858.69,141.31,0.00,858.69,0.35,0
8070,967,-141.31,-1000.00,0.00,0.00,141.31,0.10,0
8071,968,-1000.00,-1000.00,0.00,305.72,694.28,0.14,0
8072,969,-729.37,-729.37,270.63,0.00,729.37,0.15,0
8073,969,-270.63,-1000.00,0.00,0.00,270.63,0.15,0
8074,970,-642.81,-642.81,357.19,642.81,0.00,0.07,0
8075,970,1000.00,357.19,1357.19,106.20,163.62,0.28,1
8076,970,1000.00,1357.19,2357.19,0.00,1357.19,0.19,1
8077,970,-1000.00,357.19,1357.19,1378.94,978.25,0.22,0
8078,970,1000.00,1357.19,2357.19,0.00,566.54,0.21,1
8079,970,1000.00,2357.19,3357.19,0.00,1111.79,0.19,1
8080,970,-1000.00,1357.19,2357.19,2429.77,927.42,0.26,0
8081,970,1000.00,2357.19,3357.19,1178.59,1178.59,0.07,1
8082,970,1000.00,3357.19,4357.19,1678.59,1678.59,0.15,1
8083,970,-1000.00,2357.19,3357.19,2242.02,2115.17,0.33,0
8084,970,1000.00,3357.19,4357.19,1292.96,2064.23,0.40,1
8085,970,1000.00,4357.19,5357.19,0.00,2240.55,0.30,1
8086,970,-1000.00,3357.19,4357.19,2835.17,2522.01,0.30,0
8087,970,-1000.00,2357.19,3357.19,2690.69,1666.50,0.04,0
8088,970,1000.00,3357.19,4357.19,897.66,2459.53,0.44,1
8089,970,1000.00,4357.19,5357.19,1680.43,2676.76,0.34,1
8090,970,1000.00,5357.19,6357.19,2678.59,2678.59,0.22,1
8091,970,1000.00,6357.19,7357.19,2909.14,3448.05,0.27,1
8092,970,-1000.00,5357.19,6357.19,3392.81,3754.31,0.32,0
8093,970,-1000.00,4357.19,5357.19,1864.15,4493.04,0.37,0
8094,970,-1000.00,3357.19,4357.19,1856.64,1908.86,0.28,0
8095,970,-1000.00,2357.19,3357.19,1581.20,2775.99,0.16,0
8096,970,-926.01,1431.18,2431.18,0.00,926.01,0.22,0
8097,970,-1000.00,431.18,1431.18,0.00,2431.18,0.26,0
8098,970,-1000.00,-568.82,431.18,321.53,159.03,0.15,0
8099,970,-431.18,-1000.00,0.00,215.59,215.59,0.01,0
8100,971,-1000.00,-1000.00,0.00,114.18,0.00,0.09,0
8101,972,-1000.00,-1000.00,0.00,0.00,1000.00,0.09,0
8102,973,-1000.00,-1000.00,0.00,565.31,434.69,0.06,0
8103,973,0.00,-1000.00,0.00,0.00,0.00,0.29,1
8104,973,0.00,-1000.00,0.00,0.00,0.00,0.19,1
8105,973,-0.00,-1000.00,0.00,0.00,0.00,0.14,0
8106,973,0.00,-1000.00,0.00,0.00,0.00,0.15,1
8107,973,0.00,-1000.00,0.00,0.00,0.00,0.40,1
8108,973,0.00,-1000.00,0.00,0.00,0.00,0.25,1
8109,973,0.00,-1000.00,0.00,0.00,0.00,0.01,1
8110,973,0.23,-999.76,0.24,0.00,0.00,0.44,1
8111,973,-0.24,-1000.00,0.00,0.14,0.10,0.30,0
8112,974,-1000.00,-1000.00,0.00,594.70,405.30,0.17,0
8113,975,-990.83,-990.83,9.17,0.00,990.83,0.41,0
8114,975,-3.03,-993.86,6.14,0.00,3.03,0.18,0
8115,975,-6.14,-1000.00,0.00,0.00,6.14,0.23,0
8116,976,-1000.00,-1000.00,0.00,0.00,708.32,0.39,0
8117,977,-1000.00,-1000.00,0.00,559.48,440.52,0.18,0
8118,978,-1000.00,-1000.00,0.00,468.31,531.69,0.15,0
8119,979,-1000.00,-1000.00,0.00,0.00,1000.00,0.33,0
8120,980,-850.49,-850.49,149.51,850.49,0.00,0.04,0
8121,980,1000.00,149.51,1149.51,0.00,149.51,0.33,1
8122,980,-1000.00,-850.49,149.51,751.65,397.85,0.19,0
8123,980,1000.00,149.51,1149.51,0.00,63.93,0.20,1
8124,980,1000.00,1149.51,2149.51,574.75,574.75,0.08,1
8125,980,-1000.00,149.51,1149.51,1181.27,968.24,0.13,0
8126,980,1000.00,1149.51,2149.51,468.52,680.99,0.38,1
8127,980,-1000.00,149.51,1149.51,1453.64,695.87,0.05,0
8128,980,1000.00,1149.51,2149.51,442.00,707.51,0.28,1
8129,980,1000.00,2149.51,3149.51,0.00,1885.05,0.32,1
8130,980,1000.00,3149.51,4149.51,1574.75,1574.75,0.08,1
8131,980,1000.00,4149.51,5149.51,0.00,1138.68,0.14,1
8132,980,1000.00,5149.51,6149.51,0.00,3727.07,0.23,1
8133,980,1000.00,6149.51,7149.51,2057.25,4092.26,0.40,1
8134,980,1000.00,7149.51,8149.51,2719.53,4429.98,0.14,1
8135,980,1000.00,8149.51,9149.51,4074.75,4074.75,0.27,1
8136,980,-278.58,7870.93,8870.93,278.58,0.00,0.03,0
8137,980,1000.00,8870.93,9870.93,0.00,3453.98,0.07,1
8138,980,1000.00,9870.93,10870.93,2130.61,7740.32,0.31,1
8139,980,1000.00,10870.93,11870.93,2914.13,7007.12,0.38,1
8140,980,1000.00,11870.93,12870.93,0.00,11870.93,0.09,1
8141,980,-1000.00,10870.93,11870.93,6889.87,5981.06,0.21,0
8142,980,1000.00,11870.93,12870.93,4537.40,7333.52,0.30,1
8143,980,1000.00,12870.93,13870.93,1895.02,10975.91,0.36,1
8144,980,1000.00,13870.93,14870.93,0.00,13870.93,0.09,1
8145,980,-1000.00,12870.93,13870.93,14870.93,0.00,0.03,0
8146,980,1000.00,13870.93,14870.93,1006.86,10013.71,0.35,1
8147,980,1000.00,14870.93,15870.93,7435.46,7435.46,0.06,1
8148,980,1000.00,15870.93,16870.93,1775.19,10743.51,0.32,1
8149,980,1000.00,16870.93,17870.93,6445.86,10425.06,0.29,1
8150,980,1000.00,17870.93,18870.93,8718.03,9152.90,0.24,1
8151,980,-1000.00,16870.93,17870.93,14573.91,4297.02,0.07,0
8152,980,1000.00,17870.93,18870.93,8935.46,8935.46,0.06,1
8153,980,1000.00,18870.93,19870.93,0.00,18870.93,0.31,1
8154,980,-1000.00,17870.93,18870.93,11768.86,8102.07,0.06,0
8155,980,1000.00,18870.93,19870.93,7780.10,11090.83,0.43,1
8156,980,-1000.00,17870.93,18870.93,10210.98,7319.71,0.20,0
8157,980,1000.00,18870.93,19870.93,84.59,18786.34,0.35,1
8158,980,-1000.00,17870.93,18870.93,10533.38,0.00,0.05,0
8159,980,1000.00,18870.93,19870.93,0.00,11805.08,0.21,1
8160,980,1000.00,19870.93,20870.93,9935.46,9935.46,0.01,1
8161,980,1000.00,20870.93,21870.93,0.00,20870.93,0.04,1
8162,980,1000.00,21870.93,22870.93,6438.60,15432.33,0.36,1
8163,981,1000.00,1000.00,2000.00,301.29,97.22,0.14,1
8164,981,-1000.00,0.00,1000.00,0.00,2000.00,0.13,0
8165,981,-1000.00,-1000.00,0.00,206.54,793.46,0.14,0
8166,982,-1000.00,-1000.00,0.00,270.98,729.02,0.04,0
8167,983,1000.00,1000.00,2000.00,0.00,547.90,0.14,1
8168,983,1000.00,2000.00,3000.00,672.01,1327.99,0.24,1
8169,983,1000.00,3000.00,4000.00,0.00,3000.00,0.01,1
8170,983,1000.00,4000.00,5000.00,0.00,4000.00,0.31,1
8171,983,1000.00,5000.00,6000.00,79.11,4920.89,0.29,1
8172,983,-1000.00,4000.00,5000.00,4586.11,1413.89,0.09,0
8173,983,1000.00,5000.00,6000.00,2084.79,2915.21,0.34,1
8174,983,1000.00,6000.00,7000.00,0.00,3802.27,0.34,1
8175,983,1000.00,7000.00,8000.00,2857.43,4142.57,0.40,1
8176,983,1000.00,8000.00,9000.00,0.00,8000.00,0.11,1
8177,983,1000.00,9000.00,10000.00,0.00,9000.00,0.01,1
8178,983,1000.00,10000.00,11000.00,0.00,6677.20,0.17,1
8179,983,1000.00,11000.00,12000.00,0.00,11000.00,0.02,1
8180,983,1000.00,12000.00,13000.00,2486.93,9513.07,0.40,1
8181,983,1000.00,13000.00,14000.00,1873.79,11126.21,0.40,1
8182,983,1000.00,14000.00,15000.00,0.00,9275.21,0.19,1
8183,983,-1000.00,13000.00,14000.00,8701.81,1369.92,0.10,0
8184,983,1000.00,14000.00,15000.00,0.00,3305.69,0.16,1
8185,983,1000.00,15000.00,16000.00,0.00,11358.39,0.41,1
8186,983,1000.00,16000.00,17000.00,0.00,15325.92,0.40,1
8187,983,1000.00,17000.00,18000.00,5990.14,11009.86,0.41,1
8188,983,-1000.00,16000.00,17000.00,0.00,10741.80,0.04,0
8189,983,-1000.00,15000.00,16000.00,0.00,3499.39,0.11,0
8190,983,-1000.00,14000.00,15000.00,7280.15,8719.85,0.14,0
8191,983,-1000.00,13000.00,14000.00,7500.00,7500.00,0.01,0
8192,983,-1000.00,12000.00,13000.00,0.00,1746.05,0.13,0
8193,983,-1000.00,11000.00,12000.00,0.00,13000.00,0.25,0
8194,983,-1000.00,10000.00,11000.00,2617.55,6078.02,0.31,0
8195,983,-1000.00,9000.00,10000.00,2813.79,0.00,0.10,0
8196,983,-1000.00,8000.00,9000.00,4057.27,5942.73,0.08,0
8197,983,-1000.00,7000.00,8000.00,3079.69,5920.31,0.32,0
8198,983,-1000.00,6000.00,7000.00,4000.88,3999.12,0.15,0
8199,983,-1000.00,5000.00,6000.00,3860.06,3139.94,0.10,0
8200,983,-1000.00,4000.00,5000.00,0.00,5561.29,0.43,0
8201,983,-1000.00,3000.00,4000.00,1290.25,3709.75,0.37,0
8202,983,-1000.00,2000.00,3000.00,1431.41,0.00,0.09,0
8203,983,-1000.00,1000.00,2000.00,3000.00,0.00,0.01,0
8204,983,-1000.00,0.00,1000.00,0.00,2000.00,0.13,0
8205,983,-586.74,-586.74,413.26,79.31,507.42,0.33,0
8206,983,1000.00,413.26,1413.26,124.97,288.29,0.25,1
8207,983,1000.00,1413.26,2413.26,567.49,845.78,0.35,1
8208,983,1000.00,2413.26,3413.26,750.16,1663.11,0.27,1
8209,983,1000.00,3413.26,4413.26,1706.63,1706.63,0.11,1
8210,983,-1000.00,2413.26,3413.26,2254.01,2159.25,0.17,0
8211,983,-1000.00,1413.26,2413.26,3257.75,75.63,0.08,0
8212,983,-1000.00,413.26,1413.26,1561.44,851.82,0.11,0
8213,983,1000.00,1413.26,2413.26,0.00,1413.26,0.16,1
8214,983,1000.00,2413.26,3413.26,1068.66,1344.60,0.34,1
8215,983,1000.00,3413.26,4413.26,0.00,2747.45,0.23,1
8216,983,-1000.00,2413.26,3413.26,2675.76,1737.51,0.19,0
8217,983,1000.00,3413.26,4413.26,1637.47,1775.79,0.14,1
8218,983,1000.00,4413.26,5413.26,2206.63,2206.63,0.04,1
8219,983,1000.00,5413.26,6413.26,0.00,5331.93,0.34,1
8220,983,-1000.00,4413.26,5413.26,5251.17,0.00,0.05,0
8221,983,1000.00,5413.26,6413.26,1930.44,3482.83,0.25,1
8222,983,1000.00,6413.26,7413.26,1738.35,4674.91,0.36,1
8223,983,1000.00,7413.26,8413.26,0.00,5782.38,0.34,1
8224,983,1000.00,8413.26,9413.26,0.00,8413.26,0.06,1
8225,983,-1000.00,7413.26,8413.26,5263.29,4149.98,0.18,0
8226,983,1000.00,8413.26,9413.26,3024.00,5389.26,0.09,1
8227,983,-1000.00,7413.26,8413.26,6339.54,3073.72,0.21,0
8228,984,-1000.00,-1000.00,0.00,325.94,674.06,0.42,0
8229,985,-220.79,-220.79,779.21,0.00,220.79,0.26,0
8230,985,1000.00,779.21,1779.21,483.17,296.04,0.13,1
8231,985,-1000.00,-220.79,779.21,0.00,1779.21,0.10,0
8232,985,1000.00,779.21,1779.21,671.43,107.77,0.09,1
8233,985,1000.00,1779.21,2779.21,1130.82,0.00,0.01,1
8234,985,-1000.00,779.21,1779.21,804.46,1974.75,0.23,0
8235,985,-426.18,353.03,1353.03,0.00,426.18,0.03,0
8236,985,1000.00,1353.03,2353.03,727.96,625.07,0.22,1
8237,985,-1000.00,353.03,1353.03,967.70,1385.33,0.26,0
8238,985,-1000.00,-646.97,353.03,93.34,1259.68,0.25,0
8239,985,-194.67,-841.65,158.35,0.00,194.67,0.36,0
8240,985,0.00,-841.65,158.35,0.00,0.00,0.07,0
8241,985,1000.00,158.35,1158.35,79.79,13.64,0.23,1
8242,985,-1000.00,-841.65,158.35,67.03,1091.32,0.21,0
8243,985,1000.00,158.35,1158.35,49.16,4.65,0.22,1
8244,985,-723.65,-565.30,434.70,105.23,618.42,0.39,0
8245,985,0.00,-565.30,434.70,0.00,0.00,0.38,0
8246,985,-434.70,-1000.00,0.00,192.34,242.36,0.03,0
8247,986,-1000.00,-1000.00,0.00,401.11,598.89,0.31,0
8248,987,-1000.00,-1000.00,0.00,500.00,500.00,0.05,0
8249,988,-1000.00,-1000.00,0.00,809.41,190.59,0.00,0
8250,989,-1000.00,-1000.00,0.00,302.92,697.08,0.37,0
8251,990,-1000.00,-1000.00,0.00,667.93,332.07,0.13,0
8252,991,-900.91,-900.91,99.09,395.73,505.18,0.26,0
8253,991,-92.47,-993.38,6.62,35.81,56.66,0.29,0
8254,991,-6.62,-1000.00,-0.00,0.89,5.73,0.25,0
8255,992,-702.47,-702.47,297.53,262.00,440.46,0.39,0
8256,992,-297.53,-1000.00,0.00,128.12,169.41,0.19,0
8257,993,-604.04,-604.04,395.96,90.84,513.21,0.31,0
8258,993,-395.96,-1000.00,0.00,153.19,242.77,0.21,0
8259,994,-1000.00,-1000.00,0.00,0.00,1000.00,0.07,0
8260,995,-1000.00,-1000.00,0.00,500.00,500.00,0.09,0
8261,996,-550.16,-550.16,449.84,0.00,550.16,0.32,0
8262,996,-449.84,-1000.00,0.00,0.00,449.84,0.17,0
8263,997,-1000.00,-1000.00,0.00,500.00,500.00,0.01,0
8264,998,1000.00,1000.00,2000.00,0.00,1000.00,0.27,1
8265,998,1000.00,2000.00,3000.00,638.61,1361.39,0.30,1
8266,998,1000.00,3000.00,4000.00,0.00,3000.00,0.07,1
8267,998,1000.00,4000.00,5000.00,0.00,4000.00,0.43,1
8268,998,1000.00,5000.00,6000.00,0.00,5000.00,0.30,1
8269,998,1000.00,6000.00,7000.00,2696.29,3303.71,0.38,1
8270,998,1000.00,7000.00,8000.00,0.00,256.64,0.08,1
8271,998,1000.00,8000.00,9000.00,3652.79,4347.21,0.03,1
8272,998,0.00,8000.00,9000.00,0.00,0.00,0.03,0
8273,998,1000.00,9000.00,10000.00,1972.95,7027.05,0.27,1
8274,998,1000.00,10000.00,11000.00,0.00,3124.10,0.09,1
8275,998,0.00,10000.00,11000.00,0.00,0.00,0.06,0
8276,998,1000.00,11000.00,12000.00,0.00,6780.64,0.35,1
8277,998,-1000.00,10000.00,11000.00,2891.32,0.00,0.14,0
8278,998,1000.00,11000.00,12000.00,0.00,5762.89,0.17,1
8279,998,1000.00,12000.00,13000.00,4152.91,7847.09,0.23,1
8280,998,1000.00,13000.00,14000.00,0.00,13000.00,0.16,1
8281,998,1000.00,14000.00,15000.00,0.00,14000.00,0.24,1
8282,998,1000.00,15000.00,16000.00,7317.25,7682.75,0.28,1
8283,998,-1000.00,14000.00,15000.00,9823.01,6176.99,0.23,0
8284,998,1000.00,15000.00,16000.00,4873.60,10126.40,0.41,1
8285,999,-1000.00,-1000.00,0.00,388.59,611.41,0.22,0
8286,1000,-577.32,-577.32,422.68,0.00,577.32,0.35,0
8287,1000,1000.00,422.68,1422.68,301.33,121.34,0.00,1
8288,1000,-1000.00,-577.32,422.68,388.64,1034.03,0.38,0
8289,1000,1000.00,422.68,1422.68,359.87,0.00,0.00,1
8290,1000,-1000.00,-577.32,422.68,0.00,1199.79,0.01,0
8291,1000,-422.68,-1000.00,0.00,0.00,422.68,0.15,0
8292,1001,-1000.00,-1000.00,0.00,317.91,682.09,0.21,0
8293,1002,-1000.00,-1000.00,0.00,0.00,462.57,0.38,0
8294,1003,-1000.00,-1000.00,0.00,0.00,1000.00,0.21,0
8295,1004,1000.00,1000.00,2000.00,0.00,1000.00,0.41,1
8296,1004,1000.00,2000.00,3000.00,1000.00,1000.00,0.03,1
8297,1004,-1000.00,1000.00,2000.00,1416.75,0.00,0.04,0
8298,1004,1000.00,2000.00,3000.00,1000.00,1000.00,0.02,1
8299,1004,1000.00,3000.00,4000.00,213.19,1722.59,0.37,1
8300,1004,1000.00,4000.00,5000.00,1397.66,2602.34,0.30,1
8301,1004,1000.00,5000.00,6000.00,194.41,4805.59,0.11,1
8302,1004,1000.00,6000.00,7000.00,69.22,5930.78,0.29,1
8303,1004,1000.00,7000.00,8000.00,0.00,7000.00,0.16,1
8304,1004,1000.00,8000.00,9000.00,0.00,6559.94,0.38,1
8305,1004,1000.00,9000.00,10000.00,1632.34,7367.66,0.23,1
8306,1004,-1000.00,8000.00,9000.00,5501.82,4498.18,0.25,0
8307,1004,1000.00,9000.00,10000.00,4500.00,4500.00,0.09,1
8308,1004,1000.00,10000.00,11000.00,0.00,10000.00,0.17,1
8309,1004,1000.00,11000.00,12000.00,0.00,6797.11,0.34,1
8310,1004,1000.00,12000.00,13000.00,0.00,12000.00,0.10,1
8311,1004,-1000.00,11000.00,12000.00,8608.34,4391.66,0.22,0
8312,1004,1000.00,12000.00,13000.00,3953.74,8046.26,0.40,1
8313,1004,-1000.00,11000.00,12000.00,7234.63,5765.37,0.24,0
8314,1004,1000.00,12000.00,13000.00,3219.75,5863.48,0.31,1
8315,1004,1000.00,13000.00,14000.00,1995.43,11004.57,0.41,1
8316,1004,1000.00,14000.00,15000.00,6651.26,7348.74,0.36,1
8317,1004,-1000.00,13000.00,14000.00,4789.25,0.00,0.20,0
8318,1004,1000.00,14000.00,15000.00,7000.00,7000.00,0.18,1
8319,1004,-1000.00,13000.00,14000.00,6591.67,8408.33,0.36,0
8320,1004,-1000.00,12000.00,13000.00,638.20,13361.80,0.27,0
8321,1004,-1000.00,11000.00,12000.00,8631.50,4368.50,0.07,0
8322,1004,-1000.00,10000.00,11000.00,7137.44,4862.56,0.27,0
8323,1004,-1000.00,9000.00,10000.00,3622.86,33.95,0.11,0
8324,1004,-1000.00,8000.00,9000.00,0.00,10000.00,0.09,0
8325,1004,-1000.00,7000.00,8000.00,0.00,9000.00,0.04,0
8326,1004,-1000.00,6000.00,7000.00,4519.52,2874.46,0.23,0
8327,1004,-1000.00,5000.00,6000.00,3899.70,3100.30,0.19,0
8328,1004,-1000.00,4000.00,5000.00,0.00,6000.00,0.01,0
8329,1004,-1000.00,3000.00,4000.00,0.00,5000.00,0.11,0
8330,1004,-1000.00,2000.00,3000.00,0.00,1504.72,0.02,0
8331,1004,-1000.00,1000.00,2000.00,1513.69,1486.31,0.23,0
8332,1004,-274.32,725.68,1725.68,0.00,274.32,0.15,0
8333,1004,-1000.00,-274.32,725.68,0.00,1248.23,0.30,0
8334,1004,-725.68,-1000.00,0.00,0.00,725.68,0.29,0
8335,1005,-1000.00,-1000.00,0.00,0.00,1000.00,0.23,0
8336,1006,-1000.00,-1000.00,0.00,0.00,1000.00,0.14,0
8337,1007,-1000.00,-1000.00,0.00,226.26,773.74,0.39,0
8338,1008,-1000.00,-1000.00,0.00,0.00,1000.00,0.31,0
8339,1009,-1000.00,-1000.00,0.00,302.98,697.02,0.31,0
8340,1010,-1000.00,-1000.00,0.00,0.00,1000.00,0.14,0
8341,1011,-1000.00,-1000.00,0.00,0.00,1000.00,0.20,0
8342,1012,-1000.00,-1000.00,0.00,0.00,1000.00,0.20,0
8343,1013,-222.27,-222.27,777.73,0.00,222.27,0.02,0
8344,1013,-660.92,-883.19,116.81,243.95,416.97,0.30,0
8345,1013,-73.07,-956.26,43.74,0.00,73.07,0.33,0
8346,1013,-1000.00,-1956.26,-956.26,9.00,0.00,0.16,0
8347,1014,-1000.00,-1000.00,0.00,311.47,688.53,0.34,0
8348,1015,-59.27,-59.27,940.73,0.00,59.27,0.09,0
8349,1015,-940.73,-1000.00,0.00,0.00,940.73,0.09,0
8350,1016,-180.27,-180.27,819.73,0.00,180.27,0.17,0
8351,1016,-392.12,-572.39,427.61,0.00,392.12,0.20,0
8352,1016,1000.00,427.61,1427.61,108.68,0.00,0.03,1
8353,1016,1000.00,1427.61,2427.61,1427.61,0.00,0.07,1
8354,1016,-1000.00,427.61,1427.61,0.00,1303.28,0.23,0
8355,1016,1000.00,1427.61,2427.61,914.83,512.78,0.17,1
8356,1016,-1000.00,427.61,1427.61,0.00,1809.68,0.43,0
8357,1016,1000.00,1427.61,2427.61,244.74,220.78,0.39,1
8358,1016,-1000.00,427.61,1427.61,131.92,2295.69,0.43,0
8359,1016,-929.63,-502.02,497.98,254.54,675.09,0.40,0
8360,1016,-497.98,-1000.00,0.00,236.44,261.54,0.19,0
8361,1017,1000.00,1000.00,2000.00,133.95,866.05,0.07,1
8362,1017,1000.00,2000.00,3000.00,0.00,2000.00,0.36,1
8363,1017,1000.00,3000.00,4000.00,795.20,2204.80,0.34,1
8364,1017,1000.00,4000.00,5000.00,1515.96,2484.04,0.10,1
8365,1017,1000.00,5000.00,6000.00,772.59,2731.81,0.25,1
8366,1017,1000.00,6000.00,7000.00,2767.65,3232.35,0.19,1
8367,1017,1000.00,7000.00,8000.00,3425.39,3574.61,0.40,1
8368,1017,1000.00,8000.00,9000.00,1336.71,6663.29,0.43,1
8369,1017,0.00,8000.00,9000.00,0.00,0.00,0.02,0
8370,1017,1000.00,9000.00,10000.00,2961.60,6038.40,0.29,1
8371,1017,1000.00,10000.00,11000.00,0.00,10000.00,0.41,1
8372,1017,1000.00,11000.00,12000.00,1556.89,9443.11,0.39,1
8373,1017,-1000.00,10000.00,11000.00,3661.76,3286.48,0.22,0
8374,1017,1000.00,11000.00,12000.00,3272.54,7727.46,0.28,1
8375,1017,-1000.00,10000.00,11000.00,8232.41,3767.59,0.11,0
8376,1017,1000.00,11000.00,12000.00,263.53,10736.47,0.34,1
8377,1017,1000.00,12000.00,13000.00,5839.69,6160.31,0.32,1
8378,1017,1000.00,13000.00,14000.00,377.11,9794.88,0.38,1
8379,1017,1000.00,14000.00,15000.00,6843.96,7156.04,0.27,1
8380,1017,-1000.00,13000.00,14000.00,5023.82,3390.04,0.21,0
8381,1017,1000.00,14000.00,15000.00,857.27,13142.73,0.10,1
8382,1017,-1000.00,13000.00,14000.00,6865.32,3394.60,0.16,0
8383,1017,-1000.00,12000.00,13000.00,8275.44,5724.56,0.36,0
8384,1017,-1000.00,11000.00,12000.00,8578.43,4421.57,0.02,0
8385,1017,1000.00,12000.00,13000.00,6000.00,6000.00,0.21,1
8386,1017,1000.00,13000.00,14000.00,0.00,9293.20,0.39,1
8387,1017,0.00,13000.00,14000.00,0.00,0.00,0.06,0
8388,1017,1000.00,14000.00,15000.00,0.00,7702.70,0.24,1
8389,1017,-1000.00,13000.00,14000.00,9617.58,5382.42,0.31,0
8390,1017,-1000.00,12000.00,13000.00,7216.24,6783.76,0.15,0
8391,1017,1000.00,13000.00,14000.00,3793.05,8644.38,0.38,1
8392,1017,1000.00,14000.00,15000.00,113.87,13886.13,0.26,1
8393,1017,1000.00,15000.00,16000.00,1488.57,9212.67,0.36,1
8394,1017,1000.00,16000.00,17000.00,3101.69,12898.31,0.43,1
8395,1017,1000.00,17000.00,18000.00,6794.50,10205.50,0.16,1
8396,1017,1000.00,18000.00,19000.00,7922.35,10077.65,0.22,1
8397,1017,1000.00,19000.00,20000.00,7989.07,11010.93,0.20,1
8398,1017,1000.00,20000.00,21000.00,3220.74,13010.05,0.37,1
8399,1017,1000.00,21000.00,22000.00,6222.50,14777.50,0.40,1
8400,1017,1000.00,22000.00,23000.00,0.00,10000.51,0.03,1
8401,1017,1000.00,23000.00,24000.00,10989.59,12010.41,0.28,1
8402,1017,-1000.00,22000.00,23000.00,13687.34,10312.66,0.16,0
8403,1017,1000.00,23000.00,24000.00,0.00,23000.00,0.24,1
8404,1017,1000.00,24000.00,25000.00,12000.00,12000.00,0.01,1
8405,1017,-1000.00,23000.00,24000.00,13680.71,11319.29,0.14,0
8406,1017,-1000.00,22000.00,23000.00,17959.64,6040.36,0.28,0
8407,1017,1000.00,23000.00,24000.00,2087.33,20912.67,0.44,1
8408,1017,-1000.00,22000.00,23000.00,24000.00,0.00,0.08,0
8409,1017,-1000.00,21000.00,22000.00,11500.00,11500.00,0.10,0
8410,1017,-1000.00,20000.00,21000.00,0.00,22000.00,0.14,0
8411,1017,-1000.00,19000.00,20000.00,0.00,5758.70,0.13,0
8412,1017,-1000.00,18000.00,19000.00,1816.24,17118.69,0.43,0
8413,1017,-1000.00,17000.00,18000.00,10333.14,8666.86,0.13,0
8414,1017,-1000.00,16000.00,17000.00,0.00,11262.72,0.16,0
8415,1017,-1000.00,15000.00,16000.00,5059.33,11940.67,0.22,0
8416,1017,-1000.00,14000.00,15000.00,7542.32,8457.68,0.15,0
8417,1017,-1000.00,13000.00,14000.00,0.00,12864.40,0.39,0
8418,1017,-1000.00,12000.00,13000.00,3756.00,0.00,0.04,0
8419,1017,-1000.00,11000.00,12000.00,5174.72,7825.28,0.29,0
8420,1017,-1000.00,10000.00,11000.00,586.18,11413.82,0.40,0
8421,1017,-1000.00,9000.00,10000.00,0.00,1916.75,0.17,0
8422,1017,-1000.00,8000.00,9000.00,5000.00,5000.00,0.11,0
8423,1017,-1000.00,7000.00,8000.00,0.00,8768.34,0.39,0
8424,1017,-1000.00,6000.00,7000.00,951.04,7048.96,0.33,0
8425,1017,-1000.00,5000.00,6000.00,2469.90,4530.10,0.33,0
8426,1017,-1000.00,4000.00,5000.00,1133.46,4866.54,0.37,0
8427,1017,-1000.00,3000.00,4000.00,446.10,4553.90,0.03,0
8428,1018,-1000.00,-1000.00,0.00,0.00,1000.00,0.31,0
8429,1019,1000.00,1000.00,2000.00,0.00,262.28,0.14,1
8430,1019,1000.00,2000.00,3000.00,219.84,1547.23,0.41,1
8431,1019,1000.00,3000.00,4000.00,1239.46,1267.43,0.28,1
8432,1019,1000.00,4000.00,5000.00,138.89,2609.41,0.38,1
8433,1019,1000.00,5000.00,6000.00,2500.00,2500.00,0.01,1
8434,1019,1000.00,6000.00,7000.00,2042.79,3957.21,0.32,1
8435,1019,1000.00,7000.00,8000.00,473.22,6526.78,0.38,1
8436,1019,1000.00,8000.00,9000.00,2922.59,5077.41,0.31,1
8437,1019,1000.00,9000.00,10000.00,4500.00,4500.00,0.17,1
8438,1019,1000.00,10000.00,11000.00,4992.61,5007.39,0.20,1
8439,1019,1000.00,11000.00,12000.00,0.00,11000.00,0.07,1
8440,1019,1000.00,12000.00,13000.00,5862.08,6137.92,0.17,1
8441,1019,1000.00,13000.00,14000.00,0.00,2650.97,0.16,1
8442,1019,1000.00,14000.00,15000.00,6768.01,7231.99,0.10,1
8443,1019,1000.00,15000.00,16000.00,1994.60,13005.40,0.08,1
8444,1019,1000.00,16000.00,17000.00,3797.27,12202.73,0.36,1
8445,1019,-1000.00,15000.00,16000.00,1650.75,0.00,0.03,0
8446,1019,1000.00,16000.00,17000.00,0.00,14445.97,0.04,1
8447,1019,-1000.00,15000.00,16000.00,9147.94,7852.06,0.21,0
8448,1019,-1000.00,14000.00,15000.00,16000.00,0.00,0.09,0
8449,1019,-1000.00,13000.00,14000.00,6083.47,8916.53,0.06,0
8450,1019,-1000.00,12000.00,13000.00,0.00,10367.51,0.37,0
8451,1019,-1000.00,11000.00,12000.00,13000.00,0.00,0.01,0
8452,1019,-1000.00,10000.00,11000.00,6000.00,6000.00,0.03,0
8453,1019,-1000.00,9000.00,10000.00,7015.62,3984.38,0.06,0
8454,1019,-1000.00,8000.00,9000.00,0.00,6404.54,0.19,0
8455,1019,-1000.00,7000.00,8000.00,0.00,9000.00,0.10,0
8456,1019,-1000.00,6000.00,7000.00,0.00,1951.07,0.20,0
8457,1019,-1000.00,5000.00,6000.00,0.00,7000.00,0.03,0
8458,1019,-1000.00,4000.00,5000.00,0.00,3287.51,0.24,0
8459,1019,-1000.00,3000.00,4000.00,0.00,5000.00,0.28,0
8460,1019,-1000.00,2000.00,3000.00,0.00,3423.29,0.19,0
8461,1019,-1000.00,1000.00,2000.00,0.00,2589.64,0.38,0
8462,1019,-1000.00,0.00,1000.00,797.60,1202.40,0.21,0
8463,1019,-1000.00,-1000.00,0.00,405.41,594.59,0.31,0
8464,1020,-1000.00,-1000.00,0.00,108.64,891.36,0.29,0
8465,1021,-1000.00,-1000.00,0.00,254.87,745.13,0.40,0
8466,1022,-897.91,-897.91,102.09,62.15,835.75,0.42,0
8467,1022,-102.09,-1000.00,0.00,10.96,91.13,0.31,0
8468,1023,1000.00,1000.00,2000.00,319.84,680.16,0.38,1
8469,1023,1000.00,2000.00,3000.00,276.94,1723.06,0.15,1
8470,1023,1000.00,3000.00,4000.00,0.00,3000.00,0.22,1
8471,1023,1000.00,4000.00,5000.00,2000.00,2000.00,0.01,1
8472,1023,1000.00,5000.00,6000.00,1785.32,3214.68,0.27,1
8473,1023,-1000.00,4000.00,5000.00,718.01,716.29,0.15,0
8474,1023,1000.00,5000.00,6000.00,0.00,1426.38,0.22,1
8475,1023,0.00,5000.00,6000.00,0.00,0.00,0.08,0
8476,1023,1000.00,6000.00,7000.00,1100.60,1231.63,0.18,1
8477,1023,1000.00,7000.00,8000.00,0.00,7000.00,0.20,1
8478,1023,1000.00,8000.00,9000.00,2678.82,5321.18,0.19,1
8479,1023,1000.00,9000.00,10000.00,4258.12,4741.88,0.20,1
8480,1023,1000.00,10000.00,11000.00,0.00,10000.00,0.30,1
8481,1023,1000.00,11000.00,12000.00,0.00,10594.75,0.37,1
8482,1023,1000.00,12000.00,13000.00,2699.87,9300.13,0.39,1
8483,1023,1000.00,13000.00,14000.00,4982.70,8017.30,0.07,1
8484,1023,1000.00,14000.00,15000.00,5721.36,8278.64,0.42,1
8485,1023,1000.00,15000.00,16000.00,7271.85,7728.15,0.23,1
8486,1023,1000.00,16000.00,17000.00,5854.96,10145.04,0.19,1
8487,1023,1000.00,17000.00,18000.00,2650.08,14349.92,0.43,1
8488,1023,1000.00,18000.00,19000.00,3861.22,14138.78,0.44,1
8489,1023,1000.00,19000.00,20000.00,9315.92,9684.08,0.25,1
8490,1023,-1000.00,18000.00,19000.00,11686.83,8313.17,0.19,0
8491,1023,1000.00,19000.00,20000.00,0.00,11831.95,0.25,1
8492,1023,-1000.00,18000.00,19000.00,4094.72,14565.27,0.38,0
8493,1023,-1000.00,17000.00,18000.00,2048.64,16951.36,0.34,0
8494,1023,-1000.00,16000.00,17000.00,0.00,18000.00,0.33,0
8495,1023,-1000.00,15000.00,16000.00,0.00,17000.00,0.42,0
8496,1023,-1000.00,14000.00,15000.00,16000.00,0.00,0.04,0
8497,1023,-1000.00,13000.00,14000.00,0.00,15000.00,0.33,0
8498,1023,-1000.00,12000.00,13000.00,7000.00,7000.00,0.11,0
8499,1023,-1000.00,11000.00,12000.00,2945.42,10054.58,0.28,0
8500,1023,-1000.00,10000.00,11000.00,0.00,12000.00,0.29,0
8501,1023,-1000.00,9000.00,10000.00,0.00,11000.00,0.12,0
8502,1023,-1000.00,8000.00,9000.00,0.00,5026.54,0.10,0
8503,1023,-1000.00,7000.00,8000.00,4500.00,4500.00,0.19,0
8504,1023,-1000.00,6000.00,7000.00,0.00,6638.27,0.33,0
8505,1023,-1000.00,5000.00,6000.00,2987.60,4012.40,0.13,0
8506,1023,-1000.00,4000.00,5000.00,2016.96,3983.04,0.33,0
8507,1023,-1000.00,3000.00,4000.00,1321.97,3678.03,0.08,0
8508,1023,-1000.00,2000.00,3000.00,0.00,4000.00,0.09,0
8509,1023,-1000.00,1000.00,2000.00,0.00,1267.19,0.23,0
8510,1023,-1000.00,0.00,1000.00,807.83,1192.17,0.44,0
8511,1023,-949.13,-949.13,50.87,63.01,886.11,0.43,0
8512,1023,-1000.00,-1949.13,-949.13,37.69,13.18,0.09,0
8513,1024,-1000.00,-1000.00,0.00,369.79,630.21,0.31,0
8514,1025,-1000.00,-1000.00,0.00,373.49,11.53,0.10,0
8515,1026,-37.87,-37.87,962.13,0.00,37.87,0.08,0
8516,1026,-463.93,-501.80,498.20,0.00,463.93,0.23,0
8517,1026,0.00,-501.80,498.20,0.00,0.00,0.05,0
8518,1026,-498.20,-1000.00,0.00,107.70,390.50,0.41,0
8519,1027,1000.00,1000.00,2000.00,455.20,544.80,0.16,1
8520,1027,1000.00,2000.00,3000.00,388.27,1611.73,0.33,1
8521,1027,1000.00,3000.00,4000.00,0.00,155.82,0.13,1
8522,1027,-1000.00,2000.00,3000.00,2853.05,1146.95,0.17,0
8523,1027,1000.00,3000.00,4000.00,0.00,1057.56,0.21,1
8524,1027,1000.00,4000.00,5000.00,1428.09,2571.91,0.39,1
8525,1027,-1000.00,3000.00,4000.00,2526.33,2473.67,0.14,0
8526,1027,1000.00,4000.00,5000.00,1643.78,2356.22,0.33,1
8527,1027,1000.00,5000.00,6000.00,0.00,3938.65,0.34,1
8528,1027,-1000.00,4000.00,5000.00,5261.91,738.09,0.04,0
8529,1027,1000.00,5000.00,6000.00,2425.99,2574.01,0.37,1
8530,1027,1000.00,6000.00,7000.00,0.00,5605.89,0.20,1
8531,1027,1000.00,7000.00,8000.00,0.00,5997.88,0.18,1
8532,1027,1000.00,8000.00,9000.00,0.00,6192.35,0.10,1
8533,1027,1000.00,9000.00,10000.00,3908.28,5091.72,0.32,1
8534,1027,1000.00,10000.00,11000.00,0.00,5904.75,0.39,1
8535,1027,1000.00,11000.00,12000.00,2081.91,8918.09,0.00,1
8536,1027,1000.00,12000.00,13000.00,1894.68,10105.32,0.09,1
8537,1027,-1000.00,11000.00,12000.00,13000.00,0.00,0.34,0
8538,1027,1000.00,12000.00,13000.00,0.00,10840.25,0.43,1
8539,1027,-1000.00,11000.00,12000.00,11290.55,0.00,0.04,0
8540,1027,1000.00,12000.00,13000.00,683.62,2177.93,0.17,1
8541,1027,1000.00,13000.00,14000.00,3722.74,5660.10,0.30,1
8542,1027,1000.00,14000.00,15000.00,2469.09,11530.91,0.27,1
8543,1027,1000.00,15000.00,16000.00,4977.93,10022.07,0.19,1
8544,1027,1000.00,16000.00,17000.00,8000.00,8000.00,0.26,1
8545,1027,1000.00,17000.00,18000.00,4641.12,12358.88,0.39,1
8546,1027,1000.00,18000.00,19000.00,6610.93,11389.07,0.37,1
8547,1027,-1000.00,17000.00,18000.00,14257.28,4742.72,0.07,0
8548,1027,1000.00,18000.00,19000.00,2349.04,15650.96,0.22,1
8549,1027,-1000.00,17000.00,18000.00,19000.00,0.00,0.03,0
8550,1027,1000.00,18000.00,19000.00,0.00,18000.00,0.05,1
8551,1028,-1000.00,-1000.00,0.00,216.01,498.69,0.30,0
8552,1029,-1000.00,-1000.00,0.00,507.35,492.65,0.01,0
8553,1030,-876.00,-876.00,124.00,0.00,876.00,0.40,0
8554,1030,-1000.00,-1876.00,-876.00,73.79,0.00,0.04,0
8555,1031,-1000.00,-1000.00,0.00,266.12,733.88,0.10,0
8556,1032,-986.80,-986.80,13.20,0.00,986.80,0.41,0
8557,1032,-13.20,-1000.00,0.00,0.00,13.20,0.02,0
8558,1033,1000.00,1000.00,2000.00,0.00,742.24,0.14,1
8559,1033,1000.00,2000.00,3000.00,377.05,1622.95,0.42,1
8560,1033,1000.00,3000.00,4000.00,628.27,2371.73,0.44,1
8561,1033,1000.00,4000.00,5000.00,1737.00,2263.00,0.14,1
8562,1033,1000.00,5000.00,6000.00,1304.21,3695.79,0.21,1
8563,1033,1000.00,6000.00,7000.00,0.00,2505.18,0.19,1
8564,1033,1000.00,7000.00,8000.00,0.00,7000.00,0.21,1
8565,1033,1000.00,8000.00,9000.00,0.00,8000.00,0.36,1
8566,1033,1000.00,9000.00,10000.00,4161.46,4838.54,0.16,1
8567,1033,1000.00,10000.00,11000.00,0.00,7207.75,0.09,1
8568,1033,1000.00,11000.00,12000.00,3773.63,7226.37,0.05,1
8569,1033,-1000.00,10000.00,11000.00,7436.83,4563.17,0.11,0
8570,1033,-1000.00,9000.00,10000.00,6344.27,4655.73,0.02,0
8571,1033,1000.00,10000.00,11000.00,0.00,8942.69,0.22,1
8572,1033,1000.00,11000.00,12000.00,2525.33,8474.67,0.31,1
8573,1033,1000.00,12000.00,13000.00,5527.99,6472.01,0.39,1
8574,1033,1000.00,13000.00,14000.00,3734.35,5736.91,0.29,1
8575,1033,-1000.00,12000.00,13000.00,2983.62,0.00,0.13,0
8576,1033,-1000.00,11000.00,12000.00,10851.10,2148.90,0.10,0
8577,1033,1000.00,12000.00,13000.00,5237.01,6762.99,0.23,1
8578,1033,1000.00,13000.00,14000.00,0.00,8446.85,0.37,1
8579,1033,1000.00,14000.00,15000.00,3640.13,10359.87,0.43,1
8580,1033,1000.00,15000.00,16000.00,3273.72,11726.28,0.27,1
8581,1033,1000.00,16000.00,17000.00,1306.80,12168.29,0.41,1
8582,1033,1000.00,17000.00,18000.00,3649.81,13350.19,0.37,1
8583,1033,-1000.00,16000.00,17000.00,11685.22,6314.78,0.18,0
8584,1033,1000.00,17000.00,18000.00,0.00,17000.00,0.17,1
8585,1033,1000.00,18000.00,19000.00,0.00,18000.00,0.12,1
8586,1033,1000.00,19000.00,20000.00,8211.20,10788.80,0.34,1
8587,1033,1000.00,20000.00,21000.00,0.00,20000.00,0.17,1
8588,1033,1000.00,21000.00,22000.00,0.00,8262.55,0.18,1
8589,1033,-1000.00,20000.00,21000.00,12057.28,9942.72,0.25,0
8590,1033,1000.00,21000.00,22000.00,9905.20,11094.80,0.13,1
8591,1033,1000.00,22000.00,23000.00,0.00,22000.00,0.09,1
8592,1033,1000.00,23000.00,24000.00,10752.29,12247.71,0.20,1
8593,1033,1000.00,24000.00,25000.00,0.00,7604.04,0.13,1
8594,1033,1000.00,25000.00,26000.00,0.00,25000.00,0.23,1
8595,1033,-1000.00,24000.00,25000.00,5566.66,0.00,0.10,0
8596,1033,1000.00,25000.00,26000.00,0.00,25000.00,0.04,1
8597,1034,-242.42,-242.42,757.58,0.00,242.42,0.14,0
8598,1034,-757.58,-1000.00,0.00,0.00,757.58,0.43,0
8599,1035,-791.90,-791.90,208.10,0.00,791.90,0.39,0
8600,1035,-208.10,-1000.00,0.00,37.28,170.82,0.35,0
8601,1036,-1000.00,-1000.00,0.00,202.00,798.00,0.38,0
8602,1037,-1000.00,-1000.00,0.00,0.00,1000.00,0.37,0
8603,1038,-1000.00,-1000.00,0.00,56.56,943.44,0.11,0
8604,1039,1000.00,1000.00,2000.00,196.02,803.98,0.33,1
8605,1039,1000.00,2000.00,3000.00,239.22,1515.89,0.40,1
8606,1039,1000.00,3000.00,4000.00,1500.00,1500.00,0.15,1
8607,1039,-1000.00,2000.00,3000.00,2571.05,1428.95,0.11,0
8608,1039,1000.00,3000.00,4000.00,1500.00,1500.00,0.01,1
8609,1039,1000.00,4000.00,5000.00,1860.95,2139.05,0.35,1
8610,1039,1000.00,5000.00,6000.00,0.00,4253.69,0.41,1
8611,1039,1000.00,6000.00,7000.00,957.05,5042.95,0.17,1
8612,1039,1000.00,7000.00,8000.00,918.82,6039.62,0.29,1
8613,1039,1000.00,8000.00,9000.00,0.00,5821.13,0.37,1
8614,1039,1000.00,9000.00,10000.00,1289.62,7710.38,0.36,1
8615,1039,1000.00,10000.00,11000.00,2164.46,7835.54,0.41,1
8616,1039,1000.00,11000.00,12000.00,0.00,11000.00,0.11,1
8617,1039,1000.00,12000.00,13000.00,0.00,8886.15,0.37,1
8618,1039,-1000.00,11000.00,12000.00,12077.01,922.99,0.01,0
8619,1039,-1000.00,10000.00,11000.00,8313.52,3686.48,0.23,0
8620,1039,1000.00,11000.00,12000.00,556.42,8318.21,0.40,1
8621,1039,1000.00,12000.00,13000.00,4841.24,7158.76,0.36,1
8622,1039,-1000.00,11000.00,12000.00,5284.89,0.00,0.04,0
8623,1039,-1000.00,10000.00,11000.00,11894.00,106.00,0.03,0
8624,1039,1000.00,11000.00,12000.00,5500.00,5500.00,0.13,1
8625,1039,1000.00,12000.00,13000.00,6000.00,6000.00,0.14,1
8626,1039,1000.00,13000.00,14000.00,4015.29,8984.71,0.34,1
8627,1039,-1000.00,12000.00,13000.00,8085.76,5914.24,0.29,0
8628,1039,-1000.00,11000.00,12000.00,7788.22,5211.78,0.28,0
8629,1039,1000.00,12000.00,13000.00,3430.90,8569.10,0.31,1
8630,1039,1000.00,13000.00,14000.00,5670.31,7329.69,0.36,1
8631,1039,1000.00,14000.00,15000.00,5361.72,8638.28,0.41,1
8632,1039,1000.00,15000.00,16000.00,5877.07,9122.93,0.14,1
8633,1039,1000.00,16000.00,17000.00,6615.73,9384.27,0.08,1
8634,1039,1000.00,17000.00,18000.00,4108.75,12891.25,0.39,1
8635,1039,1000.00,18000.00,19000.00,0.00,13957.61,0.39,1
8636,1039,1000.00,19000.00,20000.00,0.00,10494.47,0.25,1
8637,1039,1000.00,20000.00,21000.00,0.00,20000.00,0.14,1
8638,1039,1000.00,21000.00,22000.00,4721.30,16278.70,0.33,1
8639,1039,1000.00,22000.00,23000.00,11000.00,11000.00,0.35,1
8640,1039,1000.00,23000.00,24000.00,6932.99,16067.01,0.40,1
8641,1039,1000.00,24000.00,25000.00,12000.00,12000.00,0.29,1
8642,1039,1000.00,25000.00,26000.00,0.00,25000.00,0.20,1
8643,1039,-1000.00,24000.00,25000.00,21817.78,0.00,0.01,0
8644,1039,1000.00,25000.00,26000.00,0.00,25000.00,0.11,1
8645,1039,1000.00,26000.00,27000.00,0.00,20365.67,0.37,1
8646,1039,-1000.00,25000.00,26000.00,20591.07,6408.93,0.01,0
8647,1039,-1000.00,24000.00,25000.00,22599.09,3400.91,0.09,0
8648,1039,1000.00,25000.00,26000.00,0.00,25000.00,0.19,1
8649,1040,-1000.00,-1000.00,0.00,44.16,955.84,0.39,0
8650,1040,-0.00,-1000.00,0.00,0.00,0.00,0.17,0
8651,1040,-0.00,-1000.00,0.00,0.00,0.00,0.29,0
8652,1040,-0.00,-1000.00,0.00,0.00,0.00,0.44,0
8653,1041,-1000.00,-1000.00,0.00,383.52,616.48,0.12,0
8654,1042,-1000.00,-1000.00,0.00,235.82,764.18,0.40,0
8655,1043,-1000.00,-1000.00,0.00,70.09,929.91,0.22,0
8656,1044,-1000.00,-1000.00,0.00,0.00,1000.00,0.17,0
8657,1045,-639.84,-639.84,360.16,0.00,639.84,0.37,0
8658,1045,-360.16,-1000.00,0.00,0.00,360.16,0.18,0
8659,1046,1000.00,1000.00,2000.00,387.80,480.76,0.25,1
8660,1046,1000.00,2000.00,3000.00,1000.00,1000.00,0.02,1
8661,1046,1000.00,3000.00,4000.00,0.00,2275.07,0.19,1
8662,1046,1000.00,4000.00,5000.00,0.00,3393.39,0.29,1
8663,1046,-1000.00,3000.00,4000.00,5000.00,0.00,0.01,0
8664,1046,1000.00,4000.00,5000.00,0.00,2731.91,0.24,1
8665,1046,1000.00,5000.00,6000.00,1592.16,3407.84,0.32,1
8666,1046,1000.00,6000.00,7000.00,1976.63,4023.37,0.35,1
8667,1046,1000.00,7000.00,8000.00,0.00,6823.73,0.44,1
8668,1046,1000.00,8000.00,9000.00,0.00,7167.25,0.44,1
8669,1046,1000.00,9000.00,10000.00,4500.00,4500.00,0.24,1
8670,1046,1000.00,10000.00,11000.00,4017.57,5982.43,0.15,1
8671,1046,1000.00,11000.00,12000.00,2497.91,8502.09,0.31,1
8672,1046,-1000.00,10000.00,11000.00,6862.21,5137.79,0.08,0
8673,1046,1000.00,11000.00,12000.00,390.72,9046.14,0.43,1
8674,1046,1000.00,12000.00,13000.00,843.25,8018.25,0.21,1
8675,1046,1000.00,13000.00,14000.00,1576.91,11423.09,0.39,1
8676,1046,1000.00,14000.00,15000.00,0.00,14000.00,0.16,1
8677,1046,1000.00,15000.00,16000.00,4730.32,10269.68,0.33,1
8678,1046,-1000.00,14000.00,15000.00,10288.10,0.00,0.09,0
8679,1046,1000.00,15000.00,16000.00,7500.00,7500.00,0.13,1
8680,1046,-1000.00,14000.00,15000.00,9336.93,6663.07,0.08,0
8681,1046,-1000.00,13000.00,14000.00,10945.06,4054.94,0.16,0
8682,1046,1000.00,14000.00,15000.00,0.00,13955.56,0.35,1
8683,1046,-1000.00,13000.00,14000.00,10134.45,4865.55,0.26,0
8684,1046,1000.00,14000.00,15000.00,7000.00,7000.00,0.09,1
8685,1046,1000.00,15000.00,16000.00,6504.01,8073.66,0.33,1
8686,1046,1000.00,16000.00,17000.00,0.00,16000.00,0.35,1
8687,1046,1000.00,17000.00,18000.00,7505.89,9494.11,0.20,1
8688,1046,1000.00,18000.00,19000.00,0.00,18000.00,0.15,1
8689,1046,1000.00,19000.00,20000.00,8547.55,10452.45,0.19,1
8690,1046,1000.00,20000.00,21000.00,7615.60,12384.40,0.37,1
8691,1046,1000.00,21000.00,22000.00,1559.87,19366.13,0.44,1
8692,1046,1000.00,22000.00,23000.00,899.48,6645.71,0.23,1
8693,1046,1000.00,23000.00,24000.00,0.00,17420.39,0.26,1
8694,1046,1000.00,24000.00,25000.00,8839.84,15160.16,0.24,1
8695,1046,1000.00,25000.00,26000.00,0.00,25000.00,0.31,1
8696,1046,1000.00,26000.00,27000.00,746.89,25253.11,0.34,1
8697,1046,1000.00,27000.00,28000.00,0.00,23092.94,0.42,1
8698,1046,-1000.00,26000.00,27000.00,13416.62,5760.85,0.18,0
8699,1046,1000.00,27000.00,28000.00,0.00,6513.92,0.24,1
8700,1046,1000.00,28000.00,29000.00,10920.36,17079.64,0.35,1
8701,1046,1000.00,29000.00,30000.00,14341.13,14658.87,0.42,1
8702,1046,1000.00,30000.00,31000.00,6356.97,23643.03,0.35,1
8703,1046,1000.00,31000.00,32000.00,0.00,27161.67,0.03,1
8704,1046,1000.00,32000.00,33000.00,8177.35,23822.65,0.19,1
8705,1046,-1000.00,31000.00,32000.00,1866.22,0.00,0.04,0
8706,1046,-1000.00,30000.00,31000.00,27113.57,0.00,0.01,0
8707,1046,-1000.00,29000.00,30000.00,0.00,25985.67,0.15,0
8708,1046,-1000.00,28000.00,29000.00,0.00,20553.73,0.19,0
8709,1046,-1000.00,27000.00,28000.00,0.00,29000.00,0.10,0
8710,1046,-1000.00,26000.00,27000.00,10981.22,17018.78,0.22,0
8711,1046,-1000.00,25000.00,26000.00,0.00,1365.13,0.13,0
8712,1046,-1000.00,24000.00,25000.00,0.00,13610.17,0.26,0
8713,1046,-1000.00,23000.00,24000.00,9642.21,15357.79,0.37,0
8714,1046,-1000.00,22000.00,23000.00,0.00,2311.04,0.13,0
8715,1046,-1000.00,21000.00,22000.00,5829.38,17170.62,0.42,0
8716,1046,-1000.00,20000.00,21000.00,9351.00,12649.00,0.18,0
8717,1046,-1000.00,19000.00,20000.00,0.00,21000.00,0.20,0
8718,1046,-1000.00,18000.00,19000.00,0.00,20000.00,0.00,0
8719,1046,-1000.00,17000.00,18000.00,7587.24,11412.76,0.27,0
8720,1046,-1000.00,16000.00,17000.00,0.00,18000.00,0.21,0
8721,1046,-1000.00,15000.00,16000.00,9819.24,7180.76,0.40,0
8722,1046,-1000.00,14000.00,15000.00,7335.74,8664.26,0.38,0
8723,1046,-1000.00,13000.00,14000.00,0.00,15000.00,0.11,0
8724,1046,-1000.00,12000.00,13000.00,0.00,14000.00,0.01,0
8725,1046,-1000.00,11000.00,12000.00,0.00,11778.06,0.37,0
8726,1046,-1000.00,10000.00,11000.00,0.00,12000.00,0.21,0
8727,1046,-1000.00,9000.00,10000.00,0.00,10977.21,0.13,0
8728,1046,-1000.00,8000.00,9000.00,0.00,8985.42,0.13,0
8729,1046,-1000.00,7000.00,8000.00,0.00,8429.12,0.42,0
8730,1046,-1000.00,6000.00,7000.00,0.00,8000.00,0.05,0
8731,1046,-1000.00,5000.00,6000.00,0.00,5510.74,0.04,0
8732,1046,-1000.00,4000.00,5000.00,11.58,5988.42,0.35,0
8733,1046,-1000.00,3000.00,4000.00,0.00,1181.24,0.21,0
8734,1046,-1000.00,2000.00,3000.00,0.00,4000.00,0.15,0
8735,1046,-1000.00,1000.00,2000.00,1183.33,875.88,0.21,0
8736,1046,-1000.00,0.00,1000.00,705.72,1239.83,0.34,0
8737,1046,-1000.00,-1000.00,0.00,41.27,958.73,0.34,0
8738,1047,-687.78,-687.78,312.22,0.00,687.78,0.37,0
8739,1047,-312.22,-1000.00,0.00,11.63,300.59,0.07,0
8740,1048,-1000.00,-1000.00,0.00,261.99,738.01,0.40,0
8741,1049,-1000.00,-1000.00,0.00,0.00,1000.00,0.29,0
8742,1050,-1000.00,-1000.00,0.00,72.22,566.37,0.35,0
8743,1051,-1000.00,-1000.00,0.00,216.56,783.44,0.21,0
8744,1052,-1000.00,-1000.00,0.00,0.00,1000.00,0.10,0
8745,1053,-1000.00,-1000.00,0.00,0.00,1000.00,0.06,0
8746,1054,-1000.00,-1000.00,0.00,278.19,721.81,0.12,0
8747,1055,-1000.00,-1000.00,0.00,379.13,620.87,0.31,0
8748,1056,-1000.00,-1000.00,0.00,0.00,598.88,0.31,0
8749,1057,1000.00,1000.00,2000.00,0.00,1000.00,0.35,1
8750,1057,1000.00,2000.00,3000.00,655.02,908.28,0.26,1
8751,1057,1000.00,3000.00,4000.00,1274.67,1725.33,0.20,1
8752,1057,1000.00,4000.00,5000.00,0.00,3244.97,0.16,1
8753,1057,1000.00,5000.00,6000.00,0.00,5000.00,0.05,1
8754,1057,1000.00,6000.00,7000.00,0.00,5499.29,0.41,1
8755,1057,-1000.00,5000.00,6000.00,5266.76,756.35,0.14,0
8756,1057,1000.00,6000.00,7000.00,2582.52,3417.48,0.31,1
8757,1057,1000.00,7000.00,8000.00,1993.61,5006.39,0.43,1
8758,1057,1000.00,8000.00,9000.00,3266.02,4733.98,0.23,1
8759,1057,1000.00,9000.00,10000.00,2506.29,6493.71,0.41,1
8760,1057,1000.00,10000.00,11000.00,2063.77,7936.23,0.41,1
8761,1057,-1000.00,9000.00,10000.00,7576.13,2121.51,0.21,0
8762,1057,1000.00,10000.00,11000.00,0.00,7100.70,0.32,1
8763,1057,1000.00,11000.00,12000.00,0.00,6673.31,0.33,1
8764,1057,1000.00,12000.00,13000.00,0.00,12000.00,0.10,1
8765,1057,-1000.00,11000.00,12000.00,7623.24,5376.76,0.10,0
8766,1057,1000.00,12000.00,13000.00,0.00,12000.00,0.17,1
8767,1057,-1000.00,11000.00,12000.00,7174.01,5825.99,0.01,0
8768,1057,-1000.00,10000.00,11000.00,9960.04,2039.96,0.02,0
8769,1057,1000.00,11000.00,12000.00,0.00,11000.00,0.13,1
8770,1057,1000.00,12000.00,13000.00,3015.64,8984.36,0.44,1
8771,1057,-1000.00,11000.00,12000.00,4089.13,7482.03,0.32,0
8772,1057,-1000.00,10000.00,11000.00,3238.70,8761.30,0.35,0
8773,1057,-1000.00,9000.00,10000.00,7588.76,3411.24,0.06,0
8774,1057,-1000.00,8000.00,9000.00,0.00,10000.00,0.14,0
8775,1057,-1000.00,7000.00,8000.00,0.00,3178.91,0.21,0
8776,1057,-1000.00,6000.00,7000.00,0.00,7758.04,0.44,0
8777,1057,-1000.00,5000.00,6000.00,0.00,4545.08,0.24,0
8778,1057,-1000.00,4000.00,5000.00,589.01,5410.99,0.43,0
8779,1057,-1000.00,3000.00,4000.00,1392.21,3607.79,0.42,0
8780,1057,-1000.00,2000.00,3000.00,961.15,0.00,0.05,0
8781,1057,-1000.00,1000.00,2000.00,1424.00,1576.00,0.31,0
8782,1057,0.00,1000.00,2000.00,0.00,0.00,0.03,0
8783,1057,-1000.00,0.00,1000.00,867.19,1132.81,0.31,0
8784,1057,-482.72,-482.72,517.28,0.00,482.72,0.23,0
8785,1057,-517.28,-1000.00,0.00,0.00,517.28,0.42,0
8786,1058,-1000.00,-1000.00,0.00,383.88,616.12,0.27,0
8787,1059,1000.00,1000.00,2000.00,0.00,512.23,0.22,1
8788,1059,1000.00,2000.00,3000.00,0.00,2000.00,0.20,1
8789,1059,-1000.00,1000.00,2000.00,1520.58,1222.43,0.23,0
8790,1059,-1000.00,0.00,1000.00,1398.70,601.30,0.16,0
8791,1059,-621.86,-621.86,378.14,504.36,117.50,0.17,0
8792,1059,1000.00,378.14,1378.14,0.00,378.14,0.20,1
8793,1059,1000.00,1378.14,2378.14,150.51,1227.63,0.14,1
8794,1059,-1000.00,378.14,1378.14,775.41,1602.73,0.11,0
8795,1059,-1000.00,-621.86,378.14,1378.14,0.00,0.03,0
8796,1059,-2.91,-624.77,375.23,2.91,0.00,0.31,0
8797,1059,-323.98,-948.75,51.25,288.30,35.68,0.21,0
8798,1059,-1000.00,-1948.75,-948.75,23.22,28.03,0.19,0
8799,1060,-546.02,-546.02,453.98,0.00,546.02,0.30,0
8800,1060,-453.98,-1000.00,0.00,0.00,453.98,0.25,0
8801,1061,-611.38,-611.38,388.62,0.00,611.38,0.39,0
8802,1061,-388.62,-1000.00,0.00,104.58,284.03,0.26,0
8803,1062,-1000.00,-1000.00,0.00,0.00,733.58,0.35,0
8804,1063,-1000.00,-1000.00,0.00,249.81,750.19,0.17,0
8805,1064,1000.00,1000.00,2000.00,0.00,510.17,0.27,1
8806,1064,1000.00,2000.00,3000.00,0.00,515.66,0.11,1
8807,1064,1000.00,3000.00,4000.00,1236.53,1763.47,0.20,1
8808,1064,1000.00,4000.00,5000.00,0.00,4000.00,0.44,1
8809,1064,1000.00,5000.00,6000.00,1433.61,3566.39,0.04,1
8810,1064,1000.00,6000.00,7000.00,2023.55,3976.45,0.43,1
8811,1064,1000.00,7000.00,8000.00,2516.32,4483.68,0.31,1
8812,1064,1000.00,8000.00,9000.00,2719.02,5280.98,0.43,1
8813,1064,1000.00,9000.00,10000.00,1803.55,7196.45,0.17,1
8814,1064,1000.00,10000.00,11000.00,3241.96,6517.57,0.35,1
8815,1064,1000.00,11000.00,12000.00,0.00,11000.00,0.02,1
8816,1064,1000.00,12000.00,13000.00,0.00,9902.38,0.38,1
8817,1064,1000.00,13000.00,14000.00,5679.10,7320.90,0.15,1
8818,1064,1000.00,14000.00,15000.00,0.00,4712.78,0.16,1
8819,1064,1000.00,15000.00,16000.00,5677.93,9322.07,0.36,1
8820,1064,1000.00,16000.00,17000.00,7955.20,8044.80,0.29,1
8821,1064,1000.00,17000.00,18000.00,0.00,8645.31,0.14,1
8822,1064,-1000.00,16000.00,17000.00,11331.96,6668.04,0.12,0
8823,1064,1000.00,17000.00,18000.00,2157.65,3089.46,0.20,1
8824,1064,1000.00,18000.00,19000.00,7616.30,10383.70,0.37,1
8825,1064,-1000.00,17000.00,18000.00,11933.62,7066.38,0.16,0
8826,1064,1000.00,18000.00,19000.00,0.00,11531.15,0.11,1
8827,1064,-1000.00,17000.00,18000.00,10556.99,8443.01,0.15,0
8828,1064,1000.00,18000.00,19000.00,2837.10,15162.90,0.20,1
8829,1064,-1000.00,17000.00,18000.00,8598.81,10401.19,0.39,0
8830,1064,-1000.00,16000.00,17000.00,9948.05,8051.95,0.08,0
8831,1064,-1000.00,15000.00,16000.00,8500.00,8500.00,0.15,0
8832,1064,-1000.00,14000.00,15000.00,5778.06,8234.09,0.27,0
8833,1064,-1000.00,13000.00,14000.00,10677.17,79.53,0.17,0
8834,1064,-1000.00,12000.00,13000.00,0.00,14000.00,0.27,0
8835,1064,-1000.00,11000.00,12000.00,0.00,13000.00,0.06,0
8836,1064,-1000.00,10000.00,11000.00,0.00,12000.00,0.24,0
8837,1064,-1000.00,9000.00,10000.00,0.00,9769.88,0.23,0
8838,1064,-1000.00,8000.00,9000.00,151.25,9848.75,0.39,0
8839,1064,-1000.00,7000.00,8000.00,0.00,4265.92,0.29,0
8840,1064,-1000.00,6000.00,7000.00,0.00,7600.28,0.25,0
8841,1064,-1000.00,5000.00,6000.00,2600.11,4399.89,0.32,0
8842,1064,-1000.00,4000.00,5000.00,2094.31,3905.69,0.33,0
8843,1064,-1000.00,3000.00,4000.00,0.00,2153.14,0.22,0
8844,1064,-1000.00,2000.00,3000.00,2583.55,1416.45,0.06,0
8845,1064,-1000.00,1000.00,2000.00,373.68,2626.32,0.35,0
8846,1065,-1000.00,-1000.00,0.00,253.95,746.05,0.39,0
8847,1066,-233.04,-233.04,766.96,0.00,233.04,0.27,0
8848,1066,-766.96,-1000.00,0.00,324.65,442.31,0.01,0
8849,1067,-1000.00,-1000.00,0.00,652.32,347.68,0.02,0
8850,1068,-1000.00,-1000.00,0.00,360.10,639.90,0.31,0
8851,1069,-1000.00,-1000.00,0.00,736.15,263.85,0.07,0
8852,1070,-1000.00,-1000.00,0.00,275.59,724.41,0.04,0
8853,1071,-1000.00,-1000.00,0.00,0.00,984.29,0.31,0
8854,1072,1000.00,1000.00,2000.00,462.56,537.44,0.22,1
8855,1072,1000.00,2000.00,3000.00,0.00,2000.00,0.03,1
8856,1072,1000.00,3000.00,4000.00,0.00,2811.18,0.35,1
8857,1072,1000.00,4000.00,5000.00,432.00,3568.00,0.43,1
8858,1072,0.00,4000.00,5000.00,0.00,0.00,0.04,0
8859,1072,1000.00,5000.00,6000.00,1010.06,3989.94,0.42,1
8860,1072,1000.00,6000.00,7000.00,0.00,6000.00,0.19,1
8861,1072,1000.00,7000.00,8000.00,3500.00,3500.00,0.35,1
8862,1072,1000.00,8000.00,9000.00,0.00,8000.00,0.16,1
8863,1072,1000.00,9000.00,10000.00,1981.04,5430.03,0.34,1
8864,1072,-1000.00,8000.00,9000.00,5603.46,4396.54,0.14,0
8865,1072,1000.00,9000.00,10000.00,4188.20,4811.80,0.35,1
8866,1072,1000.00,10000.00,11000.00,0.00,5595.74,0.31,1
8867,1072,0.00,10000.00,11000.00,0.00,0.00,0.05,0
8868,1072,1000.00,11000.00,12000.00,5500.00,5500.00,0.01,1
8869,1072,1000.00,12000.00,13000.00,6000.00,6000.00,0.18,1
8870,1072,1000.00,13000.00,14000.00,1653.95,6157.00,0.30,1
8871,1072,1000.00,14000.00,15000.00,1015.61,8292.67,0.34,1
8872,1072,1000.00,15000.00,16000.00,7500.00,7500.00,0.02,1
8873,1072,1000.00,16000.00,17000.00,0.00,16000.00,0.01,1
8874,1072,-1000.00,15000.00,16000.00,9071.56,7928.44,0.33,0
8875,1072,1000.00,16000.00,17000.00,7007.95,8992.05,0.41,1
8876,1072,1000.00,17000.00,18000.00,0.00,10505.38,0.14,1
8877,1072,1000.00,18000.00,19000.00,0.00,18000.00,0.11,1
8878,1072,1000.00,19000.00,20000.00,6791.62,12208.38,0.38,1
8879,1072,1000.00,20000.00,21000.00,4436.29,15563.71,0.39,1
8880,1072,1000.00,21000.00,22000.00,10500.00,10500.00,0.23,1
8881,1072,1000.00,22000.00,23000.00,10120.19,11879.81,0.22,1
8882,1072,1000.00,23000.00,24000.00,3159.54,19840.46,0.25,1
8883,1072,1000.00,24000.00,25000.00,11105.11,12894.89,0.19,1
8884,1072,1000.00,25000.00,26000.00,0.00,20899.17,0.20,1
8885,1072,-1000.00,24000.00,25000.00,3354.28,22645.72,0.13,0
8886,1072,-1000.00,23000.00,24000.00,0.00,13629.74,0.44,0
8887,1072,-1000.00,22000.00,23000.00,0.00,10887.24,0.16,0
8888,1072,-1000.00,21000.00,22000.00,7329.68,15670.32,0.20,0
8889,1072,-1000.00,20000.00,21000.00,7818.55,14181.45,0.29,0
8890,1072,-1000.00,19000.00,20000.00,0.00,17161.81,0.27,0
8891,1072,-1000.00,18000.00,19000.00,4692.44,15307.56,0.10,0
8892,1072,-1000.00,17000.00,18000.00,1854.01,17145.99,0.30,0
8893,1072,-1000.00,16000.00,17000.00,15295.26,2704.74,0.07,0
8894,1072,0.00,16000.00,17000.00,0.00,0.00,0.37,0
8895,1073,-1000.00,-1000.00,0.00,0.00,1000.00,0.39,0
8896,1074,0.00,0.00,1000.00,0.00,0.00,0.01,0
8897,1074,-1000.00,-1000.00,0.00,155.02,505.47,0.31,0
8898,1075,-1000.00,-1000.00,0.00,357.43,227.99,0.17,0
8899,1076,-1000.00,-1000.00,0.00,0.00,865.10,0.39,0
8900,1077,-1000.00,-1000.00,0.00,352.22,647.78,0.08,0
8901,1078,1000.00,1000.00,2000.00,958.50,41.50,0.03,1
8902,1078,-1000.00,0.00,1000.00,334.05,1665.95,0.31,0
8903,1078,-1000.00,-1000.00,0.00,198.60,801.40,0.36,0
8904,1079,1000.00,1000.00,2000.00,188.11,811.89,0.35,1
8905,1079,1000.00,2000.00,3000.00,505.67,1494.33,0.29,1
8906,1079,-1000.00,1000.00,2000.00,1262.02,877.80,0.18,0
8907,1079,1000.00,2000.00,3000.00,0.00,1996.05,0.22,1
8908,1079,1000.00,3000.00,4000.00,0.00,2808.82,0.37,1
8909,1079,1000.00,4000.00,5000.00,1378.92,2621.08,0.38,1
8910,1079,1000.00,5000.00,6000.00,2500.00,2500.00,0.15,1
8911,1079,1000.00,6000.00,7000.00,0.00,4973.29,0.30,1
8912,1079,1000.00,7000.00,8000.00,1924.76,4938.56,0.38,1
8913,1079,1000.00,8000.00,9000.00,0.00,6444.11,0.31,1
8914,1079,1000.00,9000.00,10000.00,0.00,9000.00,0.06,1
8915,1079,1000.00,10000.00,11000.00,878.59,3691.11,0.26,1
8916,1079,1000.00,11000.00,12000.00,0.00,7698.60,0.23,1
8917,1079,1000.00,12000.00,13000.00,0.00,5796.78,0.30,1
8918,1079,1000.00,13000.00,14000.00,0.00,10338.03,0.32,1
8919,1079,1000.00,14000.00,15000.00,5637.53,8362.47,0.36,1
8920,1079,1000.00,15000.00,16000.00,4651.50,10348.50,0.28,1
8921,1079,1000.00,16000.00,17000.00,1675.94,14324.06,0.38,1
8922,1079,1000.00,17000.00,18000.00,0.00,7998.75,0.32,1
8923,1079,1000.00,18000.00,19000.00,0.00,12195.03,0.28,1
8924,1079,-1000.00,17000.00,18000.00,13524.43,5475.57,0.05,0
8925,1079,-1000.00,16000.00,17000.00,10631.81,7368.19,0.09,0
8926,1079,1000.00,17000.00,18000.00,0.00,7362.14,0.22,1
8927,1079,1000.00,18000.00,19000.00,0.00,18000.00,0.32,1
8928,1079,-1000.00,17000.00,18000.00,12138.35,6861.65,0.31,0
8929,1079,-1000.00,16000.00,17000.00,950.97,17049.03,0.41,0
8930,1079,-1000.00,15000.00,16000.00,0.00,7785.41,0.25,0
8931,1079,-1000.00,14000.00,15000.00,6497.56,0.00,0.05,0
8932,1079,-1000.00,13000.00,14000.00,0.00,15000.00,0.14,0
8933,1079,-1000.00,12000.00,13000.00,0.00,14000.00,0.22,0
8934,1079,-1000.00,11000.00,12000.00,6500.00,6500.00,0.07,0
8935,1079,-1000.00,10000.00,11000.00,0.00,12000.00,0.33,0
8936,1079,-1000.00,9000.00,10000.00,1744.03,9255.97,0.43,0
8937,1079,-1000.00,8000.00,9000.00,3071.57,6928.43,0.25,0
8938,1079,-1000.00,7000.00,8000.00,0.00,9000.00,0.13,0
8939,1079,-1000.00,6000.00,7000.00,4000.00,4000.00,0.07,0
8940,1079,-1000.00,5000.00,6000.00,6386.27,613.73,0.02,0
8941,1079,-1000.00,4000.00,5000.00,1713.83,4286.17,0.31,0
8942,1079,-1000.00,3000.00,4000.00,1661.65,3338.35,0.26,0
8943,1079,-1000.00,2000.00,3000.00,932.94,3067.06,0.17,0
8944,1079,-1000.00,1000.00,2000.00,0.00,3000.00,0.00,0
8945,1079,-1000.00,0.00,1000.00,2000.00,0.00,0.14,0
8946,1079,-1000.00,-1000.00,0.00,227.09,0.00,0.08,0
8947,1080,-216.93,-216.93,783.07,126.90,90.03,0.16,0
8948,1080,-1000.00,-1216.93,-216.93,275.17,507.90,0.14,0
8949,1081,0.00,0.00,1000.00,0.00,0.00,0.06,0
8950,1081,-1000.00,-1000.00,0.00,443.23,556.77,0.10,0
8951,1082,1000.00,1000.00,2000.00,0.00,1000.00,0.06,1
8952,1082,-1000.00,0.00,1000.00,1558.14,441.86,0.06,0
8953,1082,1000.00,1000.00,2000.00,0.00,1000.00,0.10,1
8954,1082,-1000.00,0.00,1000.00,1175.46,0.00,0.02,0
8955,1082,1000.00,1000.00,2000.00,0.00,1000.00,0.22,1
8956,1082,1000.00,2000.00,3000.00,0.00,378.27,0.13,1
8957,1082,1000.00,3000.00,4000.00,890.68,2109.32,0.41,1
8958,1082,1000.00,4000.00,5000.00,1079.52,2920.48,0.43,1
8959,1082,-1000.00,3000.00,4000.00,3719.75,1280.25,0.13,0
8960,1082,-1000.00,2000.00,3000.00,2063.35,1936.65,0.34,0
8961,1082,1000.00,3000.00,4000.00,0.00,2445.46,0.02,1
8962,1082,1000.00,4000.00,5000.00,1723.32,2276.68,0.22,1
8963,1082,1000.00,5000.00,6000.00,898.10,4101.90,0.38,1
8964,1082,1000.00,6000.00,7000.00,0.00,6000.00,0.27,1
8965,1082,1000.00,7000.00,8000.00,3357.64,3642.36,0.13,1
8966,1082,1000.00,8000.00,9000.00,2096.94,5903.06,0.35,1
8967,1082,1000.00,9000.00,10000.00,3862.23,5137.77,0.21,1
8968,1082,-1000.00,8000.00,9000.00,5177.94,4822.06,0.35,0
8969,1082,-1000.00,7000.00,8000.00,4459.43,0.00,0.10,0
8970,1082,1000.00,8000.00,9000.00,457.17,7542.83,0.39,1
8971,1082,1000.00,9000.00,10000.00,0.00,9000.00,0.40,1
8972,1082,1000.00,10000.00,11000.00,0.00,10000.00,0.03,1
8973,1082,1000.00,11000.00,12000.00,5114.21,5885.79,0.41,1
8974,1082,1000.00,12000.00,13000.00,0.00,12000.00,0.00,1
8975,1082,1000.00,13000.00,14000.00,5490.50,7509.50,0.35,1
8976,1082,1000.00,14000.00,15000.00,0.00,10620.60,0.40,1
8977,1082,1000.00,15000.00,16000.00,7500.00,7500.00,0.17,1
8978,1082,1000.00,16000.00,17000.00,0.00,4766.99,0.12,1
8979,1082,1000.00,17000.00,18000.00,1671.85,12265.21,0.39,1
8980,1082,1000.00,18000.00,19000.00,6048.61,11951.39,0.39,1
8981,1082,1000.00,19000.00,20000.00,7299.09,11700.91,0.34,1
8982,1082,-1000.00,18000.00,19000.00,12016.97,7983.03,0.18,0
8983,1082,1000.00,19000.00,20000.00,0.00,2731.81,0.15,1
8984,1082,1000.00,20000.00,21000.00,6285.05,13714.95,0.43,1
8985,1082,1000.00,21000.00,22000.00,10369.78,10630.22,0.18,1
8986,1082,1000.00,22000.00,23000.00,0.00,6658.41,0.09,1
8987,1082,1000.00,23000.00,24000.00,0.00,11295.86,0.08,1
8988,1082,1000.00,24000.00,25000.00,4909.61,18978.61,0.40,1
8989,1082,1000.00,25000.00,26000.00,8516.76,10822.11,0.26,1
8990,1082,1000.00,26000.00,27000.00,1510.14,24489.86,0.44,1
8991,1082,1000.00,27000.00,28000.00,8070.34,12325.31,0.26,1
8992,1082,1000.00,28000.00,29000.00,0.00,28000.00,0.04,1
8993,1082,-1000.00,27000.00,28000.00,20280.78,3029.57,0.14,0
8994,1082,1000.00,28000.00,29000.00,0.00,5158.08,0.14,1
8995,1082,1000.00,29000.00,30000.00,0.00,14552.97,0.11,1
8996,1082,1000.00,30000.00,31000.00,0.00,19464.53,0.41,1
8997,1083,-1000.00,-1000.00,0.00,388.38,611.62,0.28,0
8998,1084,-901.00,-901.00,99.00,0.00,901.00,0.06,0
8999,1084,-87.19,-988.18,11.82,33.87,53.31,0.33,0
9000,1084,1000.00,11.82,1011.82,3.50,0.00,0.14,1
9001,1084,1000.00,1011.82,2011.82,167.61,0.00,0.31,1
9002,1084,1000.00,2011.82,3011.82,147.33,0.00,0.41,1
9003,1084,-716.91,1294.91,2294.91,0.00,716.91,0.38,0
9004,1084,1000.00,2294.91,3294.91,1317.39,977.52,0.16,1
9005,1084,1000.00,3294.91,4294.91,1238.31,922.29,0.36,1
9006,1084,1000.00,4294.91,5294.91,3566.60,0.00,0.05,1
9007,1084,1000.00,5294.91,6294.91,1259.10,0.00,0.26,1
9008,1084,1000.00,6294.91,7294.91,4331.27,0.00,0.28,1
9009,1084,0.00,6294.91,7294.91,0.00,0.00,0.24,0
9010,1084,-1000.00,5294.91,6294.91,0.00,2078.13,0.40,0
9011,1084,-1000.00,4294.91,5294.91,1242.32,1668.35,0.40,0
9012,1084,1000.00,5294.91,6294.91,2691.44,0.00,0.27,1
9013,1084,-1000.00,4294.91,5294.91,1799.39,4495.52,0.12,0
9014,1084,0.00,4294.91,5294.91,0.00,0.00,0.11,0
9015,1084,1000.00,5294.91,6294.91,3125.77,0.00,0.28,1
9016,1084,1000.00,6294.91,7294.91,5226.62,1068.29,0.11,1
9017,1084,-1000.00,5294.91,6294.91,0.00,2913.72,0.27,0
9018,1084,1000.00,6294.91,7294.91,1276.08,0.00,0.23,1
9019,1084,0.00,6294.91,7294.91,0.00,0.00,0.39,0
9020,1084,0.00,6294.91,7294.91,0.00,0.00,0.40,0
9021,1084,-1000.00,5294.91,6294.91,0.00,2991.32,0.35,0
9022,1084,-1000.00,4294.91,5294.91,3275.98,0.00,0.23,0
9023,1084,-1000.00,3294.91,4294.91,0.00,1046.73,0.03,0
9024,1084,-1000.00,2294.91,3294.91,3332.65,0.00,0.09,0
9025,1084,-1000.00,1294.91,2294.91,0.00,404.68,0.44,0
9026,1084,-314.19,980.72,1980.72,314.19,0.00,0.35,0
9027,1084,0.00,980.72,1980.72,0.00,0.00,0.23,0
9028,1084,0.00,980.72,1980.72,0.00,0.00,0.15,0
9029,1084,-1000.00,-19.28,980.72,0.00,1980.72,0.01,0
9030,1084,-1000.00,-1019.28,-19.28,444.26,536.46,0.05,0
9031,1085,-1000.00,-1000.00,0.00,0.00,590.54,0.17,0
9032,1086,-714.76,-714.76,285.24,0.00,714.76,0.16,0
9033,1086,-285.24,-1000.00,0.00,0.00,285.24,0.33,0
9034,1087,-729.73,-729.73,270.27,21.50,708.23,0.39,0
9035,1087,-270.27,-1000.00,0.00,89.26,181.01,0.26,0
9036,1088,1000.00,1000.00,2000.00,0.00,1000.00,0.36,1
9037,1088,1000.00,2000.00,3000.00,269.22,783.99,0.26,1
9038,1088,1000.00,3000.00,4000.00,0.00,2707.39,0.36,1
9039,1088,1000.00,4000.00,5000.00,2000.00,2000.00,0.01,1
9040,1088,1000.00,5000.00,6000.00,1541.61,1674.03,0.24,1
9041,1088,-1000.00,4000.00,5000.00,3553.49,2446.51,0.20,0
9042,1088,-1000.00,3000.00,4000.00,2827.66,2172.34,0.32,0
9043,1088,-1000.00,2000.00,3000.00,2014.22,1985.78,0.17,0
9044,1088,1000.00,3000.00,4000.00,401.59,2598.41,0.26,1
9045,1088,1000.00,4000.00,5000.00,0.00,4000.00,0.10,1
9046,1088,1000.00,5000.00,6000.00,1886.58,3113.42,0.14,1
9047,1088,1000.00,6000.00,7000.00,2099.50,3900.50,0.36,1
9048,1088,-1000.00,5000.00,6000.00,6064.17,935.83,0.01,0
9049,1088,1000.00,6000.00,7000.00,0.00,5441.63,0.41,1
9050,1088,1000.00,7000.00,8000.00,0.00,7000.00,0.23,1
9051,1088,1000.00,8000.00,9000.00,0.00,5439.10,0.06,1
9052,1088,1000.00,9000.00,10000.00,0.00,6498.86,0.34,1
9053,1088,1000.00,10000.00,11000.00,0.00,7008.90,0.32,1
9054,1088,1000.00,11000.00,12000.00,4843.47,6156.53,0.35,1
9055,1088,1000.00,12000.00,13000.00,5633.66,6366.34,0.16,1
9056,1088,1000.00,13000.00,14000.00,0.00,13000.00,0.01,1
9057,1088,1000.00,14000.00,15000.00,3990.27,10009.73,0.29,1
9058,1088,1000.00,15000.00,16000.00,1601.60,13398.40,0.08,1
9059,1088,-1000.00,14000.00,15000.00,9238.89,6761.11,0.17,0
9060,1088,-1000.00,13000.00,14000.00,1416.89,13583.11,0.27,0
9061,1088,-1000.00,12000.00,13000.00,0.00,4324.89,0.19,0
9062,1088,-1000.00,11000.00,12000.00,0.00,13000.00,0.18,0
9063,1088,-1000.00,10000.00,11000.00,5687.90,6312.10,0.09,0
9064,1088,-1000.00,9000.00,10000.00,1735.15,3822.43,0.25,0
9065,1088,-1000.00,8000.00,9000.00,362.02,3536.71,0.25,0
9066,1088,-1000.00,7000.00,8000.00,4500.00,4500.00,0.28,0
9067,1088,-1000.00,6000.00,7000.00,2438.97,5561.03,0.35,0
9068,1088,-1000.00,5000.00,6000.00,0.00,5529.52,0.00,0
9069,1088,-221.42,4778.58,5778.58,0.00,221.42,0.05,0
9070,1088,-1000.00,3778.58,4778.58,0.00,5778.58,0.28,0
9071,1088,-1000.00,2778.58,3778.58,0.00,3877.98,0.25,0
9072,1088,-1000.00,1778.58,2778.58,451.65,3326.93,0.44,0
9073,1088,-1000.00,778.58,1778.58,1357.16,84.29,0.12,0
9074,1088,-318.12,460.46,1460.46,0.00,318.12,0.16,0
9075,1088,-1000.00,-539.54,460.46,0.00,1106.84,0.36,0
9076,1088,-229.16,-768.70,231.30,98.31,130.85,0.22,0
9077,1088,-227.15,-995.85,4.15,0.00,227.15,0.23,0
9078,1088,-2.28,-998.13,1.87,0.00,2.28,0.24,0
9079,1088,-477.45,-1475.58,-475.58,1.05,0.00,0.06,0
9080,1089,-1000.00,-1000.00,0.00,367.26,632.74,0.28,0
9081,1089,-0.00,-1000.00,0.00,0.00,0.00,0.09,0
9082,1089,-0.00,-1000.00,0.00,0.00,0.00,0.07,0
9083,1089,-0.00,-1000.00,0.00,0.00,0.00,0.35,0
9084,1090,-1000.00,-1000.00,0.00,246.40,753.60,0.20,0
9085,1091,-1000.00,-1000.00,0.00,394.32,605.68,0.29,0
9086,1092,-1000.00,-1000.00,0.00,0.00,1000.00,0.12,0
9087,1093,1000.00,1000.00,2000.00,0.00,1000.00,0.27,1
9088,1093,1000.00,2000.00,3000.00,1000.00,1000.00,0.06,1
9089,1093,1000.00,3000.00,4000.00,0.00,3000.00,0.03,1
9090,1093,1000.00,4000.00,5000.00,1918.99,1935.75,0.31,1
9091,1093,1000.00,5000.00,6000.00,973.79,4026.21,0.29,1
9092,1093,1000.00,6000.00,7000.00,3000.00,3000.00,0.13,1
9093,1093,1000.00,7000.00,8000.00,1161.71,5838.29,0.42,1
9094,1093,-1000.00,6000.00,7000.00,4687.03,3312.97,0.16,0
9095,1093,1000.00,7000.00,8000.00,0.00,4361.73,0.21,1
9096,1093,1000.00,8000.00,9000.00,4000.00,4000.00,0.11,1
9097,1093,1000.00,9000.00,10000.00,3520.96,5479.04,0.33,1
9098,1093,-1000.00,8000.00,9000.00,6557.32,3442.68,0.35,0
9099,1093,-1000.00,7000.00,8000.00,4568.23,4431.77,0.09,0
9100,1093,1000.00,8000.00,9000.00,0.00,8000.00,0.15,1
9101,1093,1000.00,9000.00,10000.00,482.69,6636.92,0.26,1
9102,1093,1000.00,10000.00,11000.00,0.00,2371.30,0.18,1
9103,1093,1000.00,11000.00,12000.00,0.00,2116.83,0.18,1
9104,1093,1000.00,12000.00,13000.00,3822.89,8177.11,0.35,1
9105,1093,1000.00,13000.00,14000.00,0.00,13000.00,0.15,1
9106,1093,-1000.00,12000.00,13000.00,9239.34,4760.66,0.37,0
9107,1093,-1000.00,11000.00,12000.00,6994.51,464.55,0.09,0
9108,1093,1000.00,12000.00,13000.00,0.00,12000.00,0.05,1
9109,1093,1000.00,13000.00,14000.00,0.00,13000.00,0.14,1
9110,1093,1000.00,14000.00,15000.00,3225.20,10774.80,0.18,1
9111,1093,1000.00,15000.00,16000.00,0.00,5821.63,0.11,1
9112,1093,1000.00,16000.00,17000.00,0.00,14905.77,0.37,1
9113,1093,1000.00,17000.00,18000.00,7386.43,9613.57,0.30,1
9114,1093,1000.00,18000.00,19000.00,4758.77,13241.23,0.28,1
9115,1093,-1000.00,17000.00,18000.00,13009.91,5990.09,0.20,0
9116,1093,1000.00,18000.00,19000.00,9000.00,9000.00,0.24,1
9117,1093,1000.00,19000.00,20000.00,4861.63,14138.37,0.43,1
9118,1093,1000.00,20000.00,21000.00,4892.73,15107.27,0.24,1
9119,1093,1000.00,21000.00,22000.00,3417.23,17582.77,0.13,1
9120,1093,1000.00,22000.00,23000.00,0.00,22000.00,0.15,1
9121,1093,1000.00,23000.00,24000.00,0.00,23000.00,0.04,1
9122,1093,1000.00,24000.00,25000.00,0.00,24000.00,0.27,1
9123,1093,1000.00,25000.00,26000.00,0.00,25000.00,0.27,1
9124,1093,1000.00,26000.00,27000.00,4045.12,13214.34,0.33,1
9125,1093,0.00,26000.00,27000.00,0.00,0.00,0.01,0
9126,1093,1000.00,27000.00,28000.00,10827.29,16172.71,0.25,1
9127,1093,1000.00,28000.00,29000.00,0.00,28000.00,0.40,1
9128,1094,-527.55,-527.55,472.45,0.00,527.55,0.25,0
9129,1094,-472.45,-1000.00,0.00,0.00,472.45,0.41,0
9130,1095,-924.21,-924.21,75.79,0.00,924.21,0.43,0
9131,1095,-70.00,-994.21,5.79,0.00,70.00,0.40,0
9132,1095,-5.79,-1000.00,0.00,2.86,2.93,0.13,0
9133,1096,-1000.00,-1000.00,0.00,0.00,1000.00,0.34,0
9134,1097,-1000.00,-1000.00,0.00,564.55,435.45,0.05,0
9135,1098,0.00,0.00,1000.00,0.00,0.00,0.03,0
9136,1098,-1000.00,-1000.00,0.00,370.53,524.26,0.29,0
9137,1099,-84.33,-84.33,915.67,0.00,84.33,0.15,0
9138,1099,-17.33,-101.65,898.35,0.00,17.33,0.03,0
9139,1099,-337.29,-438.94,561.06,0.00,337.29,0.41,0
9140,1099,1000.00,561.06,1561.06,164.57,1.98,0.21,1
9141,1099,1000.00,1561.06,2561.06,1296.02,0.00,0.05,1
9142,1099,-1000.00,561.06,1561.06,0.00,2057.29,0.30,0
9143,1099,-1000.00,-438.94,561.06,0.00,1561.06,0.10,0
9144,1099,-561.06,-1000.00,0.00,183.67,377.39,0.30,0
9145,1100,-773.30,-773.30,226.70,0.00,773.30,0.19,0
9146,1100,-117.43,-890.73,109.27,0.00,117.43,0.31,0
9147,1100,-109.27,-1000.00,0.00,0.00,109.27,0.24,0
9148,1101,-1000.00,-1000.00,0.00,0.00,1000.00,0.35,0
9149,1102,-1000.00,-1000.00,0.00,693.02,306.98,0.11,0
9150,1103,-1000.00,-1000.00,0.00,0.00,1000.00,0.02,0
9151,1104,-1000.00,-1000.00,0.00,0.00,1000.00,0.18,0
9152,1105,-1000.00,-1000.00,0.00,444.50,555.50,0.14,0
9153,1106,-1000.00,-1000.00,0.00,449.77,550.23,0.03,0
9154,1107,-1000.00,-1000.00,0.00,169.89,830.11,0.40,0
9155,1108,-1000.00,-1000.00,0.00,544.82,455.18,0.15,0
9156,1109,-1000.00,-1000.00,0.00,0.00,603.74,0.38,0
9157,1110,-1000.00,-1000.00,0.00,0.00,1000.00,0.06,0
9158,1111,-1000.00,-1000.00,0.00,180.20,819.80,0.39,0
9159,1112,-1000.00,-1000.00,0.00,461.86,538.14,0.01,0
9160,1113,1000.00,1000.00,2000.00,296.61,703.39,0.36,1
9161,1113,1000.00,2000.00,3000.00,452.64,1547.36,0.37,1
9162,1113,1000.00,3000.00,4000.00,1500.00,1500.00,0.13,1
9163,1113,1000.00,4000.00,5000.00,0.00,4000.00,0.11,1
9164,1113,-1000.00,3000.00,4000.00,1688.33,1445.99,0.34,0
9165,1113,1000.00,4000.00,5000.00,0.00,4000.00,0.16,1
9166,1113,1000.00,5000.00,6000.00,0.00,2945.55,0.29,1
9167,1113,1000.00,6000.00,7000.00,2295.72,3704.28,0.07,1
9168,1113,0.00,6000.00,7000.00,0.00,0.00,0.02,0
9169,1113,1000.00,7000.00,8000.00,0.00,7000.00,0.36,1
9170,1113,1000.00,8000.00,9000.00,3256.30,4743.70,0.28,1
9171,1113,1000.00,9000.00,10000.00,0.00,8769.68,0.29,1
9172,1113,1000.00,10000.00,11000.00,4061.03,5938.97,0.29,1
9173,1113,1000.00,11000.00,12000.00,1752.96,9123.36,0.43,1
9174,1113,1000.00,12000.00,13000.00,3100.08,8899.92,0.02,1
9175,1113,1000.00,13000.00,14000.00,6475.81,6524.19,0.26,1
9176,1113,-1000.00,12000.00,13000.00,7000.00,7000.00,0.01,0
9177,1113,-1000.00,11000.00,12000.00,0.00,8760.53,0.17,0
9178,1113,-1000.00,10000.00,11000.00,3655.62,8344.38,0.31,0
9179,1113,-1000.00,9000.00,10000.00,5500.00,5500.00,0.17,0
9180,1113,-1000.00,8000.00,9000.00,3396.31,6603.69,0.35,0
9181,1113,-1000.00,7000.00,8000.00,2138.10,6861.90,0.44,0
9182,1113,-1000.00,6000.00,7000.00,0.00,8000.00,0.27,0
9183,1113,-1000.00,5000.00,6000.00,0.00,7000.00,0.04,0
9184,1113,-1000.00,4000.00,5000.00,0.00,3455.64,0.43,0
9185,1113,-1000.00,3000.00,4000.00,1559.70,3109.52,0.39,0
9186,1113,-1000.00,2000.00,3000.00,80.46,3919.54,0.44,0
9187,1113,-1000.00,1000.00,2000.00,1128.61,1871.39,0.36,0
9188,1113,-1000.00,0.00,1000.00,1716.81,0.00,0.21,0
9189,1113,-1000.00,-1000.00,0.00,0.00,391.51,0.24,0
9190,1114,-1000.00,-1000.00,0.00,500.00,500.00,0.07,0
9191,1115,-94.40,-94.40,905.60,0.00,94.40,0.11,0
9192,1115,-905.60,-1000.00,-0.00,349.30,556.30,0.26,0
9193,1116,-1000.00,-1000.00,0.00,43.92,254.32,0.22,0
9194,1117,-1000.00,-1000.00,0.00,0.00,1000.00,0.09,0
9195,1118,1000.00,1000.00,2000.00,95.86,170.79,0.17,1
9196,1118,1000.00,2000.00,3000.00,803.05,1196.95,0.19,1
9197,1118,1000.00,3000.00,4000.00,307.99,2614.74,0.43,1
9198,1118,1000.00,4000.00,5000.00,0.00,913.43,0.02,1
9199,1118,1000.00,5000.00,6000.00,0.00,4561.47,0.36,1
9200,1118,1000.00,6000.00,7000.00,0.00,2567.17,0.14,1
9201,1118,-1000.00,5000.00,6000.00,1405.63,0.00,0.03,0
9202,1118,-1000.00,4000.00,5000.00,2789.38,569.76,0.11,0
9203,1118,1000.00,5000.00,6000.00,1288.96,3711.04,0.44,1
9204,1118,1000.00,6000.00,7000.00,1674.74,4325.26,0.36,1
9205,1118,1000.00,7000.00,8000.00,0.00,7000.00,0.11,1
9206,1118,-1000.00,6000.00,7000.00,1683.18,0.00,0.06,0
9207,1118,-1000.00,5000.00,6000.00,4701.90,2298.10,0.13,0
9208,1118,1000.00,6000.00,7000.00,0.00,3853.73,0.29,1
9209,1118,1000.00,7000.00,8000.00,3365.97,3634.03,0.15,1
9210,1118,-1000.00,6000.00,7000.00,1891.84,0.00,0.19,0
9211,1118,1000.00,7000.00,8000.00,0.00,7000.00,0.03,1
9212,1118,1000.00,8000.00,9000.00,2024.96,5975.04,0.39,1
9213,1118,1000.00,9000.00,10000.00,0.00,9000.00,0.28,1
9214,1118,-1000.00,8000.00,9000.00,6004.03,3995.97,0.21,0
9215,1118,1000.00,9000.00,10000.00,0.00,5038.87,0.35,1
9216,1118,-1000.00,8000.00,9000.00,0.00,9604.12,0.03,0
9217,1118,-1000.00,7000.00,8000.00,2488.61,6511.39,0.32,0
9218,1118,-1000.00,6000.00,7000.00,4462.79,3537.21,0.11,0
9219,1118,-1000.00,5000.00,6000.00,0.00,7000.00,0.16,0
9220,1118,-1000.00,4000.00,5000.00,0.00,6000.00,0.12,0
9221,1118,-1000.00,3000.00,4000.00,2500.00,2500.00,0.06,0
9222,1118,-1000.00,2000.00,3000.00,2053.07,1946.93,0.16,0
9223,1118,-827.24,1172.76,2172.76,0.00,827.24,0.13,0
9224,1118,-1000.00,172.76,1172.76,0.00,1495.15,0.18,0
9225,1118,-1000.00,-827.24,172.76,0.00,1172.76,0.25,0
9226,1118,-44.48,-871.72,128.28,0.00,44.48,0.03,0
9227,1118,-128.28,-1000.00,0.00,64.14,64.14,0.12,0
9228,1119,-773.25,-773.25,226.75,298.44,474.81,0.27,0
9229,1119,-222.30,-995.55,4.45,0.00,222.30,0.42,0
9230,1119,-4.45,-1000.00,0.00,1.57,2.88,0.32,0
9231,1120,-1000.00,-1000.00,0.00,265.37,734.63,0.38,0
9232,1121,-1000.00,-1000.00,0.00,0.00,1000.00,0.25,0
9233,1122,-1000.00,-1000.00,0.00,395.70,604.30,0.09,0
9234,1123,1000.00,1000.00,2000.00,0.00,966.45,0.22,1
9235,1123,1000.00,2000.00,3000.00,44.68,1045.17,0.32,1
9236,1123,1000.00,3000.00,4000.00,0.00,3000.00,0.12,1
9237,1123,1000.00,4000.00,5000.00,0.00,3195.69,0.22,1
9238,1123,1000.00,5000.00,6000.00,1146.66,3853.34,0.11,1
9239,1123,1000.00,6000.00,7000.00,2651.96,3348.04,0.32,1
9240,1123,1000.00,7000.00,8000.00,938.04,6061.96,0.40,1
9241,1123,1000.00,8000.00,9000.00,0.00,8000.00,0.15,1
9242,1123,1000.00,9000.00,10000.00,0.00,9000.00,0.09,1
9243,1123,1000.00,10000.00,11000.00,2969.89,7030.11,0.28,1
9244,1123,1000.00,11000.00,12000.00,4243.00,6757.00,0.37,1
9245,1123,-1000.00,10000.00,11000.00,5890.83,3956.24,0.19,0
9246,1123,-1000.00,9000.00,10000.00,0.00,6833.46,0.34,0
9247,1123,-1000.00,8000.00,9000.00,1743.24,8256.76,0.40,0
9248,1123,-1000.00,7000.00,8000.00,2367.89,0.00,0.32,0
9249,1123,-1000.00,6000.00,7000.00,2910.04,5089.96,0.16,0
9250,1123,-1000.00,5000.00,6000.00,0.00,1500.81,0.36,0
9251,1123,0.00,5000.00,6000.00,0.00,0.00,0.11,0
9252,1123,-1000.00,4000.00,5000.00,1219.31,449.18,0.20,0
9253,1123,0.00,4000.00,5000.00,0.00,0.00,0.23,0
9254,1123,-1000.00,3000.00,4000.00,5000.00,0.00,0.11,0
9255,1123,1000.00,4000.00,5000.00,4000.00,0.00,0.33,1
9256,1123,-1000.00,3000.00,4000.00,2500.00,2500.00,0.01,0
9257,1123,-1000.00,2000.00,3000.00,2000.00,2000.00,0.02,0
9258,1123,-933.15,1066.85,2066.85,0.00,933.15,0.02,0
9259,1123,-983.55,83.30,1083.30,135.98,847.57,0.29,0
9260,1123,-1000.00,-916.70,83.30,0.00,1083.30,0.24,0
9261,1123,-83.30,-1000.00,0.00,0.00,83.30,0.04,0
9262,1124,-41.68,-41.68,958.32,0.00,41.68,0.11,0
9263,1124,-1000.00,-1041.68,-41.68,311.04,0.00,0.06,0
9264,1125,-817.69,-817.69,182.31,100.53,717.16,0.39,0
9265,1125,-182.31,-1000.00,0.00,0.00,182.31,0.23,0
9266,1126,-736.28,-736.28,263.72,0.00,736.28,0.38,0
9267,1126,-263.72,-1000.00,0.00,84.79,178.92,0.02,0
9268,1127,-1000.00,-1000.00,0.00,500.00,500.00,0.09,0
9269,1128,-1000.00,-1000.00,0.00,428.33,571.67,0.04,0
9270,1129,1000.00,1000.00,2000.00,666.01,172.61,0.10,1
9271,1129,1000.00,2000.00,3000.00,1002.76,997.24,0.23,1
9272,1129,-1000.00,1000.00,2000.00,0.00,3000.00,0.06,0
9273,1129,-1000.00,0.00,1000.00,0.00,1033.00,0.36,0
9274,1129,-278.41,-278.41,721.59,0.00,278.41,0.30,0
9275,1129,-721.59,-1000.00,0.00,0.00,721.59,0.06,0
9276,1130,-1000.00,-1000.00,0.00,0.00,1000.00,0.39,0
9277,1131,1000.00,1000.00,2000.00,0.00,581.77,0.34,1
9278,1131,1000.00,2000.00,3000.00,582.23,1417.77,0.19,1
9279,1131,1000.00,3000.00,4000.00,0.00,3000.00,0.24,1
9280,1131,1000.00,4000.00,5000.00,178.53,3821.47,0.38,1
9281,1131,1000.00,5000.00,6000.00,0.00,4363.33,0.20,1
9282,1131,1000.00,6000.00,7000.00,1630.03,4369.97,0.21,1
9283,1131,1000.00,7000.00,8000.00,671.22,1706.80,0.19,1
9284,1131,-1000.00,6000.00,7000.00,0.00,2708.44,0.16,0
9285,1131,-1000.00,5000.00,6000.00,2867.24,0.00,0.18,0
9286,1131,0.00,5000.00,6000.00,0.00,0.00,0.11,0
9287,1131,-1000.00,4000.00,5000.00,1557.18,0.00,0.23,0
9288,1131,-1000.00,3000.00,4000.00,700.89,463.82,0.42,0
9289,1131,-1000.00,2000.00,3000.00,2264.14,1735.86,0.27,0
9290,1131,-1000.00,1000.00,2000.00,0.00,3000.00,0.06,0
9291,1131,-1000.00,0.00,1000.00,1103.14,0.00,0.33,0
9292,1131,0.00,0.00,1000.00,0.00,0.00,0.04,0
9293,1131,0.00,0.00,1000.00,0.00,0.00,0.26,0
9294,1131,0.00,0.00,1000.00,0.00,0.00,0.07,0
9295,1131,-637.51,-637.51,362.49,637.51,0.00,0.08,0
9296,1131,-1000.00,-1637.51,-637.51,0.00,319.68,0.14,0
9297,1132,1000.00,1000.00,2000.00,379.32,332.56,0.21,1
9298,1132,-1000.00,0.00,1000.00,0.00,1539.41,0.42,0
9299,1132,-1000.00,-1000.00,0.00,0.00,1000.00,0.22,0
9300,1133,-1000.00,-1000.00,0.00,129.84,870.16,0.11,0
9301,1134,-1000.00,-1000.00,0.00,0.00,1000.00,0.35,0
9302,1135,-1000.00,-1000.00,0.00,434.78,565.22,0.19,0
9303,1136,1000.00,1000.00,2000.00,428.75,571.25,0.20,1
9304,1136,1000.00,2000.00,3000.00,812.60,1187.40,0.29,1
9305,1136,1000.00,3000.00,4000.00,84.95,2915.05,0.07,1
9306,1136,1000.00,4000.00,5000.00,1485.91,2514.09,0.23,1
9307,1136,1000.00,5000.00,6000.00,1683.24,3316.76,0.16,1
9308,1136,1000.00,6000.00,7000.00,1128.94,4871.06,0.41,1
9309,1136,1000.00,7000.00,8000.00,0.00,7000.00,0.06,1
9310,1136,1000.00,8000.00,9000.00,0.00,2844.05,0.12,1
9311,1136,1000.00,9000.00,10000.00,489.78,4037.69,0.30,1
9312,1136,1000.00,10000.00,11000.00,4702.86,5297.14,0.11,1
9313,1136,1000.00,11000.00,12000.00,4152.11,6847.89,0.27,1
9314,1136,1000.00,12000.00,13000.00,5181.19,6818.81,0.17,1
9315,1136,1000.00,13000.00,14000.00,0.00,8462.73,0.12,1
9316,1136,1000.00,14000.00,15000.00,0.00,2354.12,0.19,1
9317,1136,1000.00,15000.00,16000.00,0.00,13314.64,0.43,1
9318,1136,-1000.00,14000.00,15000.00,11932.91,4067.09,0.08,0
9319,1136,1000.00,15000.00,16000.00,311.91,14688.09,0.23,1
9320,1136,1000.00,16000.00,17000.00,1769.42,13750.24,0.42,1
9321,1136,1000.00,17000.00,18000.00,8500.00,8500.00,0.10,1
9322,1136,1000.00,18000.00,19000.00,0.00,18000.00,0.16,1
9323,1136,1000.00,19000.00,20000.00,9500.00,9500.00,0.15,1
9324,1136,1000.00,20000.00,21000.00,7633.53,12366.47,0.22,1
9325,1136,1000.00,21000.00,22000.00,3956.42,17043.58,0.42,1
9326,1136,1000.00,22000.00,23000.00,0.00,3496.91,0.08,1
9327,1136,1000.00,23000.00,24000.00,11500.00,11500.00,0.12,1
9328,1136,1000.00,24000.00,25000.00,0.00,24000.00,0.39,1
9329,1136,1000.00,25000.00,26000.00,6376.83,16940.83,0.36,1
9330,1136,1000.00,26000.00,27000.00,1968.35,24031.65,0.24,1
9331,1136,1000.00,27000.00,28000.00,11783.56,15216.44,0.38,1
9332,1136,1000.00,28000.00,29000.00,6919.77,21080.23,0.39,1
9333,1136,1000.00,29000.00,30000.00,0.00,27012.47,0.28,1
9334,1136,1000.00,30000.00,31000.00,15000.00,15000.00,0.04,1
9335,1136,1000.00,31000.00,32000.00,449.22,26829.01,0.39,1
9336,1136,-1000.00,30000.00,31000.00,22186.87,9813.13,0.28,0
9337,1136,1000.00,31000.00,32000.00,7578.65,23421.35,0.39,1
9338,1136,1000.00,32000.00,33000.00,12564.73,19435.27,0.34,1
9339,1136,1000.00,33000.00,34000.00,13129.04,19870.96,0.34,1
9340,1136,1000.00,34000.00,35000.00,0.00,15998.31,0.20,1
9341,1136,-1000.00,33000.00,34000.00,21193.41,13806.59,0.21,0
9342,1136,1000.00,34000.00,35000.00,0.00,22367.40,0.24,1
9343,1136,1000.00,35000.00,36000.00,6787.11,28212.89,0.40,1
9344,1136,1000.00,36000.00,37000.00,0.00,36000.00,0.22,1
9345,1136,1000.00,37000.00,38000.00,18500.00,18500.00,0.06,1
9346,1136,-1000.00,36000.00,37000.00,21778.30,16221.70,0.32,0
9347,1136,1000.00,37000.00,38000.00,18500.00,18500.00,0.19,1
9348,1136,-1000.00,36000.00,37000.00,38000.00,0.00,0.04,0
9349,1136,1000.00,37000.00,38000.00,16701.18,20298.82,0.39,1
9350,1136,-1000.00,36000.00,37000.00,7926.02,0.00,0.00,0
9351,1136,-1000.00,35000.00,36000.00,4684.68,32315.32,0.35,0
9352,1136,-1000.00,34000.00,35000.00,0.00,36000.00,0.23,0
9353,1136,-1000.00,33000.00,34000.00,0.00,33333.10,0.44,0
9354,1136,-1000.00,32000.00,33000.00,14069.78,19930.22,0.26,0
9355,1136,-1000.00,31000.00,32000.00,14823.80,18176.20,0.35,0
9356,1136,-1000.00,30000.00,31000.00,16000.00,16000.00,0.18,0
9357,1136,-1000.00,29000.00,30000.00,0.00,31000.00,0.07,0
9358,1136,-1000.00,28000.00,29000.00,13283.50,16716.50,0.11,0
9359,1136,-1000.00,27000.00,28000.00,14620.12,14379.88,0.23,0
9360,1136,-1000.00,26000.00,27000.00,8725.41,15477.35,0.34,0
9361,1136,-1000.00,25000.00,26000.00,15228.46,8125.05,0.23,0
9362,1136,-1000.00,24000.00,25000.00,0.00,20252.21,0.19,0
9363,1136,-1000.00,23000.00,24000.00,5140.72,15913.06,0.20,0
9364,1136,-1000.00,22000.00,23000.00,12295.12,11704.88,0.21,0
9365,1136,-1000.00,21000.00,22000.00,65.70,22934.30,0.41,0
9366,1136,-1000.00,20000.00,21000.00,9933.72,12066.28,0.23,0
9367,1136,0.00,20000.00,21000.00,0.00,0.00,0.15,0
9368,1136,-1000.00,19000.00,20000.00,0.00,1954.72,0.10,0
9369,1136,-1000.00,18000.00,19000.00,0.00,20000.00,0.14,0
9370,1136,-1000.00,17000.00,18000.00,6235.39,0.00,0.08,0
9371,1136,-1000.00,16000.00,17000.00,0.00,12174.41,0.28,0
9372,1136,-1000.00,15000.00,16000.00,0.00,17000.00,0.02,0
9373,1136,-1000.00,14000.00,15000.00,2984.96,13015.04,0.05,0
9374,1137,0.00,0.00,1000.00,0.00,0.00,0.07,0
9375,1137,-1000.00,-1000.00,0.00,0.00,1000.00,0.20,0
9376,1138,-968.44,-968.44,31.56,0.00,968.44,0.17,0
9377,1138,-1000.00,-1968.44,-968.44,4.67,4.48,0.16,0
9378,1139,-849.18,-849.18,150.82,0.00,849.18,0.35,0
9379,1139,-150.82,-1000.00,0.00,32.08,118.74,0.06,0
9380,1140,1000.00,1000.00,2000.00,0.00,1000.00,0.23,1
9381,1140,1000.00,2000.00,3000.00,0.00,2000.00,0.19,1
9382,1140,1000.00,3000.00,4000.00,0.00,569.68,0.15,1
9383,1140,1000.00,4000.00,5000.00,903.82,3096.18,0.08,1
9384,1140,1000.00,5000.00,6000.00,2025.63,2974.37,0.29,1
9385,1140,-1000.00,4000.00,5000.00,4032.69,1967.31,0.33,0
9386,1140,1000.00,5000.00,6000.00,2376.00,2624.00,0.12,1
9387,1140,1000.00,6000.00,7000.00,0.00,1769.60,0.13,1
9388,1140,1000.00,7000.00,8000.00,2721.70,4278.30,0.38,1
9389,1140,1000.00,8000.00,9000.00,45.42,3484.46,0.28,1
9390,1140,1000.00,9000.00,10000.00,2900.21,6099.79,0.31,1
9391,1140,0.00,9000.00,10000.00,0.00,0.00,0.01,0
9392,1140,1000.00,10000.00,11000.00,0.00,9385.90,0.42,1
9393,1140,-1000.00,9000.00,10000.00,6097.17,4902.83,0.10,0
9394,1140,1000.00,10000.00,11000.00,0.00,10000.00,0.09,1
9395,1140,1000.00,11000.00,12000.00,0.00,2161.28,0.17,1
9396,1140,1000.00,12000.00,13000.00,3093.63,4535.27,0.28,1
9397,1140,1000.00,13000.00,14000.00,0.00,13000.00,0.26,1
9398,1140,1000.00,14000.00,15000.00,141.37,9255.01,0.37,1
9399,1140,1000.00,15000.00,16000.00,7500.00,7500.00,0.04,1
9400,1140,1000.00,16000.00,17000.00,0.00,4263.69,0.20,1
9401,1140,1000.00,17000.00,18000.00,2486.75,10504.64,0.36,1
9402,1140,1000.00,18000.00,19000.00,0.00,2923.56,0.03,1
9403,1140,1000.00,19000.00,20000.00,9500.00,9500.00,0.10,1
9404,1140,-1000.00,18000.00,19000.00,19641.65,358.35,0.01,0
9405,1140,-1000.00,17000.00,18000.00,14223.20,4776.80,0.05,0
9406,1140,1000.00,18000.00,19000.00,4016.05,13983.95,0.29,1
9407,1140,1000.00,19000.00,20000.00,0.00,7405.72,0.25,1
9408,1140,1000.00,20000.00,21000.00,7868.70,12131.30,0.35,1
9409,1140,1000.00,21000.00,22000.00,8313.69,12686.31,0.36,1
9410,1140,1000.00,22000.00,23000.00,11000.00,11000.00,0.09,1
9411,1140,-1000.00,21000.00,22000.00,12038.49,10961.51,0.41,0
9412,1140,1000.00,22000.00,23000.00,2067.67,11074.94,0.32,1
9413,1140,1000.00,23000.00,24000.00,0.00,23000.00,0.36,1
9414,1140,-1000.00,22000.00,23000.00,8173.65,5766.39,0.31,0
9415,1140,1000.00,23000.00,24000.00,0.00,18920.99,0.36,1
9416,1140,1000.00,24000.00,25000.00,5171.85,18828.15,0.41,1
9417,1140,1000.00,25000.00,26000.00,10579.99,14420.01,0.19,1
9418,1140,1000.00,26000.00,27000.00,0.00,26000.00,0.34,1
9419,1140,1000.00,27000.00,28000.00,9909.44,17090.56,0.39,1
9420,1140,-1000.00,26000.00,27000.00,14948.76,13051.24,0.21,0
9421,1141,-232.41,-232.41,767.59,232.41,0.00,0.09,0
9422,1141,-1000.00,-1232.41,-232.41,0.00,767.59,0.35,0
9423,1142,-1000.00,-1000.00,0.00,492.63,507.37,0.17,0
9424,1143,1000.00,1000.00,2000.00,0.00,836.98,0.35,1
9425,1143,1000.00,2000.00,3000.00,374.37,1625.63,0.06,1
9426,1143,1000.00,3000.00,4000.00,1275.49,1724.51,0.23,1
9427,1143,1000.00,4000.00,5000.00,0.00,23.20,0.08,1
9428,1143,1000.00,5000.00,6000.00,470.23,4529.77,0.24,1
9429,1143,-1000.00,4000.00,5000.00,2379.65,0.00,0.05,0
9430,1143,1000.00,5000.00,6000.00,0.00,5000.00,0.28,1
9431,1143,1000.00,6000.00,7000.00,2088.09,3911.91,0.44,1
9432,1143,1000.00,7000.00,8000.00,0.00,7000.00,0.01,1
9433,1143,1000.00,8000.00,9000.00,3919.15,4080.85,0.30,1
9434,1143,1000.00,9000.00,10000.00,0.00,1399.84,0.16,1
9435,1143,-1000.00,8000.00,9000.00,5405.90,4594.10,0.01,0
9436,1143,1000.00,9000.00,10000.00,4500.00,4500.00,0.07,1
9437,1143,1000.00,10000.00,11000.00,2952.00,7048.00,0.36,1
9438,1143,1000.00,11000.00,12000.00,2698.33,8301.67,0.19,1
9439,1143,1000.00,12000.00,13000.00,3596.33,7452.51,0.32,1
9440,1143,-189.87,11810.13,12810.13,189.87,0.00,0.10,0
9441,1143,-1000.00,10810.13,11810.13,6501.42,6308.72,0.34,0
9442,1143,1000.00,11810.13,12810.13,3564.31,8245.82,0.39,1
9443,1143,-1000.00,10810.13,11810.13,7237.63,5572.50,0.15,0
9444,1143,1000.00,11810.13,12810.13,1644.19,10165.94,0.43,1
9445,1143,1000.00,12810.13,13810.13,5719.26,7090.87,0.09,1
9446,1143,1000.00,13810.13,14810.13,6905.07,6905.07,0.08,1
9447,1143,-1000.00,12810.13,13810.13,0.00,14810.13,0.14,0
9448,1143,-1000.00,11810.13,12810.13,0.00,13810.13,0.31,0
9449,1143,-1000.00,10810.13,11810.13,9595.14,1430.62,0.13,0
9450,1143,-1000.00,9810.13,10810.13,273.44,11536.69,0.41,0
9451,1143,-1000.00,8810.13,9810.13,0.00,10810.13,0.33,0
9452,1143,-1000.00,7810.13,8810.13,0.00,6107.36,0.27,0
9453,1143,-1000.00,6810.13,7810.13,0.00,1990.64,0.19,0
9454,1143,-1000.00,5810.13,6810.13,1988.85,5821.28,0.34,0
9455,1143,-1000.00,4810.13,5810.13,0.00,6810.13,0.43,0
9456,1143,-1000.00,3810.13,4810.13,2157.12,3653.01,0.04,0
9457,1143,-1000.00,2810.13,3810.13,0.00,4810.13,0.02,0
9458,1143,-1000.00,1810.13,2810.13,1230.94,2579.19,0.34,0
9459,1143,-1000.00,810.13,1810.13,1405.07,1405.07,0.01,0
9460,1143,-1000.00,-189.87,810.13,0.00,1254.04,0.35,0
9461,1143,-810.13,-1000.00,0.00,0.00,810.13,0.27,0
9462,1144,-787.20,-787.20,212.80,0.00,787.20,0.42,0
9463,1144,-212.80,-1000.00,0.00,69.99,142.81,0.02,0
9464,1145,-1000.00,-1000.00,0.00,500.00,500.00,0.01,0
9465,1146,-1000.00,-1000.00,0.00,289.07,710.93,0.35,0
9466,1147,-1000.00,-1000.00,0.00,23.08,976.92,0.22,0
9467,1148,-1000.00,-1000.00,0.00,583.25,416.75,0.07,0
9468,1149,0.00,0.00,1000.00,0.00,0.00,0.08,0
9469,1149,-1000.00,-1000.00,0.00,0.00,825.64,0.37,0
9470,1150,1000.00,1000.00,2000.00,0.00,1000.00,0.03,1
9471,1150,-133.20,866.80,1866.80,133.20,0.00,0.08,0
9472,1150,1000.00,1866.80,2866.80,0.00,1422.41,0.33,1
9473,1150,1000.00,2866.80,3866.80,0.00,2661.18,0.40,1
9474,1150,-1000.00,1866.80,2866.80,2739.22,1127.59,0.25,0
9475,1150,1000.00,2866.80,3866.80,334.22,2532.58,0.05,1
9476,1150,1000.00,3866.80,4866.80,0.00,3866.80,0.33,1
9477,1150,1000.00,4866.80,5866.80,507.30,1929.13,0.27,1
9478,1150,1000.00,5866.80,6866.80,0.00,5866.80,0.08,1
9479,1150,1000.00,6866.80,7866.80,0.00,6866.80,0.04,1
9480,1150,1000.00,7866.80,8866.80,0.00,3394.66,0.08,1
9481,1150,-1000.00,6866.80,7866.80,3412.83,3201.41,0.23,0
9482,1150,1000.00,7866.80,8866.80,0.00,3471.85,0.02,1
9483,1150,1000.00,8866.80,9866.80,0.00,8767.67,0.38,1
9484,1150,1000.00,9866.80,10866.80,3980.90,5885.91,0.24,1
9485,1150,1000.00,10866.80,11866.80,0.00,10866.80,0.04,1
9486,1150,1000.00,11866.80,12866.80,3293.78,8573.02,0.40,1
9487,1150,1000.00,12866.80,13866.80,3466.74,9400.06,0.32,1
9488,1150,1000.00,13866.80,14866.80,6380.68,7486.12,0.01,1
9489,1150,1000.00,14866.80,15866.80,0.00,14866.80,0.09,1
9490,1150,1000.00,15866.80,16866.80,6011.11,9855.69,0.05,1
9491,1150,-1000.00,14866.80,15866.80,9119.06,7747.74,0.40,0
9492,1150,1000.00,15866.80,16866.80,7877.69,7989.11,0.22,1
9493,1150,1000.00,16866.80,17866.80,5581.98,11284.82,0.11,1
9494,1150,-1000.00,15866.80,16866.80,10252.00,7614.81,0.05,0
9495,1150,-1000.00,14866.80,15866.80,8714.27,8152.53,0.03,0
9496,1150,-1000.00,13866.80,14866.80,8035.76,7831.05,0.17,0
9497,1150,-1000.00,12866.80,13866.80,893.16,8961.31,0.31,0
9498,1150,-1000.00,11866.80,12866.80,8719.41,1853.68,0.34,0
9499,1150,0.00,11866.80,12866.80,0.00,0.00,0.29,0
9500,1150,-1000.00,10866.80,11866.80,0.00,8078.39,0.12,0
9501,1150,-1000.00,9866.80,10866.80,0.00,4730.07,0.12,0
9502,1150,-1000.00,8866.80,9866.80,2139.85,2402.64,0.42,0
9503,1150,-1000.00,7866.80,8866.80,0.00,7669.48,0.36,0
9504,1150,-1000.00,6866.80,7866.80,3650.19,5216.61,0.26,0
9505,1150,-1000.00,5866.80,6866.80,3383.85,4482.95,0.24,0
9506,1150,-1000.00,4866.80,5866.80,0.00,6866.80,0.04,0
9507,1150,-1000.00,3866.80,4866.80,4112.09,0.00,0.04,0
9508,1150,-1000.00,2866.80,3866.80,2122.87,2743.93,0.09,0
9509,1150,-1000.00,1866.80,2866.80,0.00,984.52,0.13,0
9510,1150,-1000.00,866.80,1866.80,0.00,997.92,0.14,0
9511,1150,-538.83,327.97,1327.97,538.83,0.00,0.10,0
9512,1150,-1000.00,-672.03,327.97,217.17,683.51,0.42,0
9513,1150,-161.29,-833.31,166.69,93.65,67.63,0.34,0
9514,1150,-1000.00,-1833.31,-833.31,0.00,151.86,0.29,0
9515,1151,-1000.00,-1000.00,0.00,120.04,879.96,0.13,0
9516,1152,-556.08,-556.08,443.92,89.91,466.17,0.30,0
9517,1152,-443.92,-1000.00,0.00,0.00,443.92,0.02,0
9518,1153,-1000.00,-1000.00,0.00,0.00,1000.00,0.07,0
9519,1154,-1000.00,-1000.00,0.00,413.87,586.13,0.00,0
9520,1155,-1000.00,-1000.00,0.00,417.24,582.76,0.06,0
9521,1156,1000.00,1000.00,2000.00,109.26,890.74,0.43,1
9522,1156,-737.15,262.85,1262.85,737.15,0.00,0.03,0
9523,1156,1000.00,1262.85,2262.85,368.87,893.98,0.25,1
9524,1156,0.00,1262.85,2262.85,0.00,0.00,0.01,0
9525,1156,1000.00,2262.85,3262.85,529.58,1249.23,0.33,1
9526,1156,1000.00,3262.85,4262.85,1381.46,1881.39,0.33,1
9527,1156,1000.00,4262.85,5262.85,0.00,2785.42,0.24,1
9528,1156,1000.00,5262.85,6262.85,1032.16,4230.69,0.08,1
9529,1156,1000.00,6262.85,7262.85,2641.23,2797.49,0.29,1
9530,1156,1000.00,7262.85,8262.85,0.00,7262.85,0.04,1
9531,1156,1000.00,8262.85,9262.85,0.00,8262.85,0.08,1
9532,1156,-1000.00,7262.85,8262.85,1198.36,1013.68,0.15,0
9533,1156,1000.00,8262.85,9262.85,0.00,6981.14,0.40,1
9534,1156,1000.00,9262.85,10262.85,0.00,9262.85,0.14,1
9535,1156,1000.00,10262.85,11262.85,4179.95,6082.91,0.25,1
9536,1156,1000.00,11262.85,12262.85,0.00,11262.85,0.04,1
9537,1156,1000.00,12262.85,13262.85,4367.98,7894.87,0.35,1
9538,1156,1000.00,13262.85,14262.85,0.00,13262.85,0.08,1
9539,1156,1000.00,14262.85,15262.85,3168.75,11094.10,0.29,1
9540,1156,1000.00,15262.85,16262.85,2941.31,11710.53,0.34,1
9541,1156,1000.00,16262.85,17262.85,7044.32,9218.53,0.34,1
9542,1156,-1000.00,15262.85,16262.85,0.00,17262.85,0.05,0
9543,1156,-1000.00,14262.85,15262.85,9296.75,6966.11,0.07,0
9544,1156,-1000.00,13262.85,14262.85,6881.63,8381.23,0.15,0
9545,1156,-1000.00,12262.85,13262.85,6981.04,7281.82,0.42,0
9546,1156,-1000.00,11262.85,12262.85,11200.22,0.00,0.02,0
9547,1156,-1000.00,10262.85,11262.85,1518.23,10744.63,0.31,0
9548,1156,-1000.00,9262.85,10262.85,0.00,11262.85,0.24,0
9549,1156,-1000.00,8262.85,9262.85,0.00,6601.92,0.22,0
9550,1156,-1000.00,7262.85,8262.85,0.00,4386.79,0.14,0
9551,1156,-1000.00,6262.85,7262.85,0.00,4674.78,0.24,0
9552,1156,-1000.00,5262.85,6262.85,0.00,7262.85,0.06,0
9553,1156,-1000.00,4262.85,5262.85,1409.85,4853.00,0.37,0
9554,1156,-1000.00,3262.85,4262.85,2195.61,3067.24,0.34,0
9555,1156,-1000.00,2262.85,3262.85,0.00,4262.85,0.37,0
9556,1156,-1000.00,1262.85,2262.85,0.00,3262.85,0.05,0
9557,1156,-1000.00,262.85,1262.85,2166.20,0.00,0.03,0
9558,1156,-754.07,-491.21,508.79,76.93,677.14,0.34,0
9559,1156,-347.19,-838.40,161.60,81.58,265.60,0.33,0
9560,1156,-99.80,-938.20,61.80,0.00,99.80,0.31,0
9561,1156,-61.80,-1000.00,0.00,0.00,61.80,0.20,0
9562,1157,-1000.00,-1000.00,0.00,0.00,663.56,0.18,0
9563,1158,0.00,0.00,1000.00,0.00,0.00,0.03,0
9564,1158,-1000.00,-1000.00,0.00,404.07,595.93,0.10,0
9565,1159,-1000.00,-1000.00,0.00,0.00,1000.00,0.28,0
9566,1160,-1000.00,-1000.00,0.00,76.33,923.67,0.44,0
9567,1161,-1000.00,-1000.00,0.00,0.00,804.48,0.42,0
9568,1162,-1000.00,-1000.00,0.00,19.69,980.31,0.33,0
9569,1163,1000.00,1000.00,2000.00,0.00,515.72,0.23,1
9570,1163,1000.00,2000.00,3000.00,0.00,2000.00,0.09,1
9571,1163,1000.00,3000.00,4000.00,0.00,3000.00,0.29,1
9572,1163,1000.00,4000.00,5000.00,982.27,1862.95,0.30,1
9573,1163,1000.00,5000.00,6000.00,0.00,5000.00,0.33,1
9574,1163,1000.00,6000.00,7000.00,3000.00,3000.00,0.02,1
9575,1163,1000.00,7000.00,8000.00,2932.70,4067.30,0.26,1
9576,1163,1000.00,8000.00,9000.00,0.00,8000.00,0.35,1
9577,1163,1000.00,9000.00,10000.00,0.00,4535.89,0.21,1
9578,1163,-1000.00,8000.00,9000.00,5031.93,4442.11,0.27,0
9579,1163,1000.00,9000.00,10000.00,1018.15,7981.85,0.36,1
9580,1163,1000.00,10000.00,11000.00,0.00,10000.00,0.04,1
9581,1163,1000.00,11000.00,12000.00,2682.09,7998.31,0.34,1
9582,1163,1000.00,12000.00,13000.00,6000.00,6000.00,0.09,1
9583,1163,1000.00,13000.00,14000.00,5639.88,7360.12,0.21,1
9584,1163,-1000.00,12000.00,13000.00,9199.10,4800.90,0.29,0
9585,1163,1000.00,13000.00,14000.00,4629.62,8370.38,0.12,1
9586,1163,1000.00,14000.00,15000.00,6647.10,7352.90,0.41,1
9587,1163,1000.00,15000.00,16000.00,7500.00,7500.00,0.01,1
9588,1163,-1000.00,14000.00,15000.00,8203.36,7796.64,0.26,0
9589,1163,1000.00,15000.00,16000.00,5424.25,9575.75,0.32,1
9590,1163,1000.00,16000.00,17000.00,0.00,16000.00,0.03,1
9591,1163,1000.00,17000.00,18000.00,0.00,11823.75,0.33,1
9592,1163,1000.00,18000.00,19000.00,2961.76,15038.24,0.34,1
9593,1163,1000.00,19000.00,20000.00,0.00,19000.00,0.06,1
9594,1163,1000.00,20000.00,21000.00,8855.52,11144.48,0.33,1
9595,1163,1000.00,21000.00,22000.00,0.00,21000.00,0.25,1
9596,1163,1000.00,22000.00,23000.00,0.00,22000.00,0.03,1
9597,1163,1000.00,23000.00,24000.00,7402.51,15597.49,0.34,1
9598,1163,1000.00,24000.00,25000.00,0.00,8657.29,0.21,1
9599,1163,1000.00,25000.00,26000.00,12500.00,12500.00,0.02,1
9600,1163,1000.00,26000.00,27000.00,2125.06,23874.94,0.40,1
9601,1163,1000.00,27000.00,28000.00,0.00,27000.00,0.13,1
9602,1163,1000.00,28000.00,29000.00,9700.22,18299.78,0.35,1
9603,1163,1000.00,29000.00,30000.00,14500.00,14500.00,0.22,1
9604,1163,1000.00,30000.00,31000.00,9363.84,20636.16,0.18,1
9605,1163,-1000.00,29000.00,30000.00,4328.24,0.00,0.07,0
9606,1163,1000.00,30000.00,31000.00,1901.46,28098.54,0.10,1
9607,1163,-1000.00,29000.00,30000.00,21506.07,9493.93,0.10,0
9608,1164,-1000.00,-1000.00,0.00,0.00,1000.00,0.33,0
9609,1165,-1000.00,-1000.00,0.00,499.32,500.68,0.03,0
9610,1166,-1000.00,-1000.00,0.00,0.00,1000.00,0.42,0
9611,1167,-1000.00,-1000.00,0.00,197.79,802.21,0.01,0
9612,1168,-1000.00,-1000.00,0.00,588.55,411.45,0.01,0
9613,1169,-859.51,-859.51,140.49,0.00,859.51,0.33,0
9614,1169,-140.49,-1000.00,0.00,0.00,140.49,0.02,0
9615,1170,-1000.00,-1000.00,0.00,137.91,862.09,0.34,0
9616,1171,-181.81,-181.81,818.19,0.00,181.81,0.18,0
9617,1171,-818.19,-1000.00,0.00,0.00,818.19,0.25,0
9618,1172,1000.00,1000.00,2000.00,443.96,556.04,0.12,1
9619,1172,-1000.00,0.00,1000.00,1372.18,627.82,0.09,0
9620,1172,1000.00,1000.00,2000.00,0.00,884.08,0.33,1
9621,1172,1000.00,2000.00,3000.00,847.95,1152.05,0.20,1
9622,1172,1000.00,3000.00,4000.00,0.00,3000.00,0.32,1
9623,1172,-1000.00,2000.00,3000.00,2134.60,1865.40,0.22,0
9624,1172,1000.00,3000.00,4000.00,0.00,2507.59,0.35,1
9625,1172,1000.00,4000.00,5000.00,0.00,2629.33,0.36,1
9626,1172,-42.85,3957.15,4957.15,42.85,0.00,0.10,0
9627,1172,1000.00,4957.15,5957.15,0.00,4957.15,0.00,1
9628,1172,1000.00,5957.15,6957.15,0.00,731.83,0.10,1
9629,1172,1000.00,6957.15,7957.15,1473.92,5483.24,0.37,1
9630,1172,1000.00,7957.15,8957.15,707.72,7249.44,0.22,1
9631,1172,1000.00,8957.15,9957.15,0.00,3502.56,0.16,1
9632,1172,1000.00,9957.15,10957.15,2200.39,7756.77,0.35,1
9633,1172,-1000.00,8957.15,9957.15,7820.29,3136.87,0.40,0
9634,1172,-1000.00,7957.15,8957.15,0.00,7767.34,0.41,0
9635,1172,-1000.00,6957.15,7957.15,0.00,8957.15,0.03,0
9636,1172,-1000.00,5957.15,6957.15,2395.12,5562.03,0.03,0
9637,1172,-1000.00,4957.15,5957.15,3011.73,816.26,0.20,0
9638,1172,-1000.00,3957.15,4957.15,0.00,4365.60,0.20,0
9639,1172,-1000.00,2957.15,3957.15,3713.72,947.77,0.19,0
9640,1172,-1000.00,1957.15,2957.15,1662.72,2294.43,0.20,0
9641,1172,-1000.00,957.15,1957.15,1153.30,1803.85,0.13,0
9642,1172,-1000.00,-42.85,957.15,331.99,1625.17,0.17,0
9643,1172,-1000.00,-1042.85,-42.85,482.67,474.48,0.03,0
9644,1173,1000.00,1000.00,2000.00,0.00,1000.00,0.12,1
9645,1173,-1000.00,0.00,1000.00,0.00,1151.12,0.15,0
9646,1173,-1000.00,-1000.00,0.00,472.91,478.93,0.25,0
9647,1174,-1000.00,-1000.00,0.00,0.00,1000.00,0.42,0
9648,1175,1000.00,1000.00,2000.00,0.00,126.50,0.15,1
9649,1175,-1000.00,0.00,1000.00,1200.52,799.48,0.13,0
9650,1175,1000.00,1000.00,2000.00,0.00,1000.00,0.08,1
9651,1175,0.00,1000.00,2000.00,0.00,0.00,0.04,0
9652,1175,1000.00,2000.00,3000.00,778.06,1221.94,0.36,1
9653,1175,1000.00,3000.00,4000.00,0.00,3000.00,0.10,1
9654,1175,-1000.00,2000.00,3000.00,4000.00,0.00,0.01,0
9655,1175,1000.00,3000.00,4000.00,1267.56,1732.44,0.18,1
9656,1175,1000.00,4000.00,5000.00,0.00,3342.00,0.24,1
9657,1175,1000.00,5000.00,6000.00,1958.55,3041.45,0.40,1
9658,1175,1000.00,6000.00,7000.00,873.45,5126.55,0.44,1
9659,1175,1000.00,7000.00,8000.00,1652.84,3177.74,0.28,1
9660,1175,-1000.00,6000.00,7000.00,0.00,8000.00,0.25,0
9661,1175,-1000.00,5000.00,6000.00,0.00,7000.00,0.23,0
9662,1175,-1000.00,4000.00,5000.00,2441.38,3558.62,0.04,0
9663,1175,-1000.00,3000.00,4000.00,4515.49,484.51,0.29,0
9664,1175,-1000.00,2000.00,3000.00,1126.13,2327.30,0.33,0
9665,1175,-1000.00,1000.00,2000.00,1131.30,1736.73,0.36,0
9666,1175,-1000.00,0.00,1000.00,0.00,1545.51,0.43,0
9667,1175,0.00,0.00,1000.00,0.00,0.00,0.03,0
9668,1175,-1000.00,-1000.00,0.00,0.00,416.74,0.31,0
9669,1176,-745.62,-745.62,254.38,745.62,0.00,0.01,0
9670,1176,-1000.00,-1745.62,-745.62,0.00,254.38,0.06,0
9671,1177,-185.71,-185.71,814.29,0.00,185.71,0.16,0
9672,1177,-814.29,-1000.00,0.00,407.15,407.15,0.07,0
9673,1178,-1000.00,-1000.00,0.00,173.37,0.00,0.07,0
9674,1179,1000.00,1000.00,2000.00,0.00,1000.00,0.11,1
9675,1179,1000.00,2000.00,3000.00,420.47,1579.53,0.40,1
9676,1179,1000.00,3000.00,4000.00,0.00,2256.99,0.40,1
9677,1179,1000.00,4000.00,5000.00,926.91,2954.67,0.40,1
9678,1179,1000.00,5000.00,6000.00,0.00,3935.95,0.38,1
9679,1179,-1000.00,4000.00,5000.00,3153.08,2846.92,0.25,0
9680,1179,1000.00,5000.00,6000.00,0.00,2506.54,0.26,1
9681,1179,1000.00,6000.00,7000.00,2512.66,3487.34,0.33,1
9682,1179,-1000.00,5000.00,6000.00,4537.20,2462.80,0.13,0
9683,1179,-980.63,4019.37,5019.37,980.63,0.00,0.05,0
9684,1179,1000.00,5019.37,6019.37,0.00,5019.37,0.06,1
9685,1179,1000.00,6019.37,7019.37,2164.31,3855.06,0.07,1
9686,1179,1000.00,7019.37,8019.37,668.81,6350.56,0.44,1
9687,1179,1000.00,8019.37,9019.37,2341.46,5677.92,0.35,1
9688,1179,1000.00,9019.37,10019.37,0.00,5451.84,0.32,1
9689,1179,-1000.00,8019.37,9019.37,6939.85,3079.53,0.12,0
9690,1179,1000.00,9019.37,10019.37,1480.49,3261.16,0.25,1
9691,1179,1000.00,10019.37,11019.37,5009.69,5009.69,0.12,1
9692,1179,1000.00,11019.37,12019.37,3217.12,7034.17,0.32,1
9693,1179,-1000.00,10019.37,11019.37,2584.69,0.00,0.08,0
9694,1179,1000.00,11019.37,12019.37,4090.74,6928.63,0.41,1
9695,1179,1000.00,12019.37,13019.37,0.00,12019.37,0.23,1
9696,1179,1000.00,13019.37,14019.37,6509.69,6509.69,0.12,1
9697,1179,-1000.00,12019.37,13019.37,11924.86,2094.52,0.02,0
9698,1179,1000.00,13019.37,14019.37,0.00,7311.73,0.16,1
9699,1179,1000.00,14019.37,15019.37,6848.80,7170.57,0.29,1
9700,1179,-1000.00,13019.37,14019.37,8118.19,6901.18,0.28,0
9701,1179,1000.00,14019.37,15019.37,6305.39,7713.98,0.35,1
9702,1179,1000.00,15019.37,16019.37,0.00,15019.37,0.06,1
9703,1179,-1000.00,14019.37,15019.37,11959.83,4059.54,0.14,0
9704,1179,-1000.00,13019.37,14019.37,7520.48,7498.89,0.24,0
9705,1179,-1000.00,12019.37,13019.37,5503.12,8516.26,0.13,0
9706,1179,-1000.00,11019.37,12019.37,6650.31,6369.06,0.11,0
9707,1179,-1000.00,10019.37,11019.37,6009.69,6009.69,0.15,0
9708,1179,-1000.00,9019.37,10019.37,8090.15,2929.22,0.20,0
9709,1179,-1000.00,8019.37,9019.37,0.00,2448.93,0.14,0
9710,1179,-1000.00,7019.37,8019.37,3333.99,3862.50,0.38,0
9711,1179,-1000.00,6019.37,7019.37,0.00,8019.37,0.03,0
9712,1179,-1000.00,5019.37,6019.37,1391.13,2130.27,0.41,0
9713,1179,-1000.00,4019.37,5019.37,2222.35,0.00,0.02,0
9714,1179,-1000.00,3019.37,4019.37,4204.71,814.66,0.11,0
9715,1180,1000.00,1000.00,2000.00,214.39,785.61,0.32,1
9716,1180,1000.00,2000.00,3000.00,212.05,1597.02,0.42,1
9717,1180,1000.00,3000.00,4000.00,1500.00,1500.00,0.01,1
9718,1180,1000.00,4000.00,5000.00,0.00,1827.86,0.05,1
9719,1180,1000.00,5000.00,6000.00,0.00,5000.00,0.15,1
9720,1180,1000.00,6000.00,7000.00,360.53,3817.14,0.37,1
9721,1180,1000.00,7000.00,8000.00,0.00,6258.12,0.25,1
9722,1180,1000.00,8000.00,9000.00,0.00,7335.84,0.37,1
9723,1180,1000.00,9000.00,10000.00,0.00,2854.01,0.01,1
9724,1180,1000.00,10000.00,11000.00,3414.94,6585.06,0.06,1
9725,1180,1000.00,11000.00,12000.00,192.30,10807.70,0.44,1
9726,1180,1000.00,12000.00,13000.00,1263.63,4177.12,0.20,1
9727,1180,1000.00,13000.00,14000.00,0.00,13000.00,0.21,1
9728,1180,1000.00,14000.00,15000.00,12.59,13496.06,0.44,1
9729,1180,1000.00,15000.00,16000.00,6400.64,8599.36,0.28,1
9730,1180,-1000.00,14000.00,15000.00,10106.40,5893.60,0.01,0
9731,1180,1000.00,15000.00,16000.00,7500.00,7500.00,0.04,1
9732,1180,1000.00,16000.00,17000.00,0.00,5767.10,0.20,1
9733,1180,-1000.00,15000.00,16000.00,9093.65,0.00,0.02,0
9734,1180,1000.00,16000.00,17000.00,2431.65,13568.35,0.41,1
9735,1180,1000.00,17000.00,18000.00,0.00,17000.00,0.42,1
9736,1180,1000.00,18000.00,19000.00,8796.69,9203.31,0.09,1
9737,1180,1000.00,19000.00,20000.00,1217.58,17782.42,0.44,1
9738,1180,1000.00,20000.00,21000.00,6187.29,13317.50,0.37,1
9739,1180,-1000.00,19000.00,20000.00,0.00,10806.60,0.32,0
9740,1180,0.00,19000.00,20000.00,0.00,0.00,0.01,0
9741,1180,-1000.00,18000.00,19000.00,2425.99,17574.01,0.01,0
9742,1180,-1000.00,17000.00,18000.00,0.00,19000.00,0.04,0
9743,1180,-1000.00,16000.00,17000.00,0.00,6189.46,0.15,0
9744,1180,-1000.00,15000.00,16000.00,0.00,14998.98,0.18,0
9745,1180,-1000.00,14000.00,15000.00,0.00,16000.00,0.25,0
9746,1180,-1000.00,13000.00,14000.00,7500.00,7500.00,0.02,0
9747,1180,-1000.00,12000.00,13000.00,0.00,14000.00,0.04,0
9748,1180,-1000.00,11000.00,12000.00,0.00,2291.14,0.11,0
9749,1180,-1000.00,10000.00,11000.00,0.00,12000.00,0.18,0
9750,1180,-1000.00,9000.00,10000.00,2160.62,8839.38,0.16,0
9751,1180,-1000.00,8000.00,9000.00,1664.64,8335.36,0.20,0
9752,1180,-1000.00,7000.00,8000.00,0.00,9000.00,0.32,0
9753,1180,-1000.00,6000.00,7000.00,0.00,8000.00,0.02,0
9754,1180,-1000.00,5000.00,6000.00,0.00,7000.00,0.43,0
9755,1180,-1000.00,4000.00,5000.00,6000.00,0.00,0.00,0
9756,1180,-1000.00,3000.00,4000.00,0.00,2539.17,0.21,0
9757,1180,-1000.00,2000.00,3000.00,0.00,4000.00,0.08,0
9758,1180,-1000.00,1000.00,2000.00,1419.59,1580.41,0.12,0
9759,1180,-1000.00,0.00,1000.00,158.68,1603.67,0.42,0
9760,1181,-1000.00,-1000.00,0.00,0.00,538.55,0.31,0
9761,1182,1000.00,1000.00,2000.00,0.00,1000.00,0.18,1
9762,1182,1000.00,2000.00,3000.00,0.00,2000.00,0.06,1
9763,1182,1000.00,3000.00,4000.00,817.00,1988.00,0.38,1
9764,1182,1000.00,4000.00,5000.00,221.31,818.13,0.18,1
9765,1182,1000.00,5000.00,6000.00,0.00,4442.87,0.05,1
9766,1182,1000.00,6000.00,7000.00,0.00,2872.10,0.22,1
9767,1182,1000.00,7000.00,8000.00,2973.46,3427.08,0.25,1
9768,1182,1000.00,8000.00,9000.00,1457.79,6542.21,0.09,1
9769,1182,1000.00,9000.00,10000.00,0.00,9000.00,0.23,1
9770,1182,-1000.00,8000.00,9000.00,7194.76,2805.24,0.03,0
9771,1182,1000.00,9000.00,10000.00,4500.00,4500.00,0.05,1
9772,1182,1000.00,10000.00,11000.00,0.00,10000.00,0.12,1
9773,1182,1000.00,11000.00,12000.00,1637.98,9362.02,0.20,1
9774,1182,1000.00,12000.00,13000.00,4059.76,7940.24,0.23,1
9775,1182,-1000.00,11000.00,12000.00,1766.05,0.00,0.02,0
9776,1182,1000.00,12000.00,13000.00,3228.63,6990.46,0.32,1
9777,1182,1000.00,13000.00,14000.00,0.00,5274.96,0.14,1
9778,1182,1000.00,14000.00,15000.00,0.00,14000.00,0.23,1
9779,1182,-1000.00,13000.00,14000.00,7778.92,7221.08,0.26,0
9780,1182,1000.00,14000.00,15000.00,0.00,14000.00,0.41,1
9781,1182,-1000.00,13000.00,14000.00,7961.45,7038.55,0.36,0
9782,1182,1000.00,14000.00,15000.00,7000.00,7000.00,0.19,1
9783,1182,1000.00,15000.00,16000.00,0.00,15000.00,0.03,1
9784,1182,1000.00,16000.00,17000.00,8000.00,8000.00,0.25,1
9785,1182,1000.00,17000.00,18000.00,3713.46,12034.63,0.37,1
9786,1182,1000.00,18000.00,19000.00,0.00,8056.14,0.26,1
9787,1182,1000.00,19000.00,20000.00,1313.24,17686.76,0.44,1
9788,1182,-1000.00,18000.00,19000.00,10591.81,9408.19,0.22,0
9789,1182,1000.00,19000.00,20000.00,9244.05,9755.95,0.21,1
9790,1182,1000.00,20000.00,21000.00,0.00,17920.31,0.40,1
9791,1182,-1000.00,19000.00,20000.00,10937.15,10062.85,0.06,0
9792,1182,1000.00,20000.00,21000.00,10000.00,10000.00,0.03,1
9793,1182,1000.00,21000.00,22000.00,8042.89,12957.11,0.43,1
9794,1182,-1000.00,20000.00,21000.00,8858.13,8852.16,0.26,0
9795,1182,1000.00,21000.00,22000.00,0.00,21000.00,0.23,1
9796,1182,1000.00,22000.00,23000.00,0.00,2764.02,0.15,1
9797,1182,0.00,22000.00,23000.00,0.00,0.00,0.09,0
9798,1182,1000.00,23000.00,24000.00,9770.38,10828.96,0.24,1
9799,1182,1000.00,24000.00,25000.00,2037.64,21962.36,0.30,1
9800,1182,1000.00,25000.00,26000.00,6652.96,18347.04,0.36,1
9801,1182,-1000.00,24000.00,25000.00,16337.04,9662.96,0.17,0
9802,1182,1000.00,25000.00,26000.00,0.00,25000.00,0.05,1
9803,1182,1000.00,26000.00,27000.00,0.00,26000.00,0.44,1
9804,1182,-1000.00,25000.00,26000.00,4781.56,0.00,0.03,0
9805,1182,-1000.00,24000.00,25000.00,18527.95,7472.05,0.04,0
9806,1183,-1000.00,-1000.00,0.00,0.00,1000.00,0.28,0
9807,1184,-1000.00,-1000.00,0.00,558.71,441.29,0.16,0
9808,1185,-1000.00,-1000.00,0.00,0.00,1000.00,0.29,0
9809,1186,1000.00,1000.00,2000.00,415.54,584.46,0.08,1
9810,1186,1000.00,2000.00,3000.00,0.00,2000.00,0.30,1
9811,1186,1000.00,3000.00,4000.00,0.00,3000.00,0.02,1
9812,1186,1000.00,4000.00,5000.00,0.00,3975.66,0.26,1
9813,1186,1000.00,5000.00,6000.00,6.35,4993.65,0.24,1
9814,1186,1000.00,6000.00,7000.00,0.00,4486.37,0.17,1
9815,1186,1000.00,7000.00,8000.00,0.00,465.57,0.11,1
9816,1186,1000.00,8000.00,9000.00,4000.00,4000.00,0.12,1
9817,1186,1000.00,9000.00,10000.00,2831.49,6168.51,0.43,1
9818,1186,1000.00,10000.00,11000.00,0.00,10000.00,0.06,1
9819,1186,-1000.00,9000.00,10000.00,6941.87,4058.13,0.27,0
9820,1186,1000.00,10000.00,11000.00,0.00,5782.60,0.16,1
9821,1186,-1000.00,9000.00,10000.00,5896.64,5103.36,0.04,0
9822,1186,-1000.00,8000.00,9000.00,7282.26,2717.74,0.10,0
9823,1186,1000.00,9000.00,10000.00,2656.38,6343.62,0.20,1
9824,1186,-1000.00,8000.00,9000.00,3053.21,802.11,0.18,0
9825,1186,1000.00,9000.00,10000.00,0.00,9000.00,0.29,1
9826,1186,1000.00,10000.00,11000.00,5000.00,5000.00,0.04,1
9827,1186,1000.00,11000.00,12000.00,0.00,11000.00,0.21,1
9828,1186,-1000.00,10000.00,11000.00,8798.91,3201.09,0.40,0
9829,1186,1000.00,11000.00,12000.00,0.00,5226.50,0.18,1
9830,1186,1000.00,12000.00,13000.00,6000.00,6000.00,0.28,1
9831,1186,1000.00,13000.00,14000.00,0.00,7699.04,0.22,1
9832,1186,1000.00,14000.00,15000.00,150.24,5843.09,0.28,1
9833,1186,1000.00,15000.00,16000.00,5236.29,9763.71,0.18,1
9834,1186,1000.00,16000.00,17000.00,422.31,15577.69,0.42,1
9835,1186,1000.00,17000.00,18000.00,0.00,9443.81,0.28,1
9836,1186,1000.00,18000.00,19000.00,9000.00,9000.00,0.08,1
9837,1186,1000.00,19000.00,20000.00,0.00,19000.00,0.40,1
9838,1186,1000.00,20000.00,21000.00,0.00,20000.00,0.39,1
9839,1186,1000.00,21000.00,22000.00,5899.77,15100.23,0.19,1
9840,1186,1000.00,22000.00,23000.00,3868.89,18131.11,0.38,1
9841,1186,1000.00,23000.00,24000.00,0.00,11730.39,0.27,1
9842,1186,1000.00,24000.00,25000.00,4414.27,19585.73,0.41,1
9843,1186,-1000.00,23000.00,24000.00,13758.48,11241.52,0.36,0
9844,1186,-1000.00,22000.00,23000.00,14781.80,9218.20,0.14,0
9845,1186,1000.00,23000.00,24000.00,0.00,23000.00,0.15,1
9846,1186,1000.00,24000.00,25000.00,4157.87,15802.77,0.37,1
9847,1186,-1000.00,23000.00,24000.00,14316.57,10683.43,0.17,0
9848,1186,-1000.00,22000.00,23000.00,19348.85,4651.15,0.15,0
9849,1186,1000.00,23000.00,24000.00,0.00,10491.35,0.20,1
9850,1186,1000.00,24000.00,25000.00,0.00,24000.00,0.30,1
9851,1186,1000.00,25000.00,26000.00,12500.00,12500.00,0.09,1
9852,1187,-1000.00,-1000.00,0.00,499.75,500.25,0.09,0
9853,1188,1000.00,1000.00,2000.00,144.18,387.42,0.26,1
9854,1188,1000.00,2000.00,3000.00,740.07,1259.93,0.32,1
9855,1188,1000.00,3000.00,4000.00,0.00,3000.00,0.04,1
9856,1188,1000.00,4000.00,5000.00,520.24,3479.76,0.43,1
9857,1188,1000.00,5000.00,6000.00,1995.08,3004.92,0.24,1
9858,1188,1000.00,6000.00,7000.00,0.00,5555.56,0.31,1
9859,1188,1000.00,7000.00,8000.00,0.00,7000.00,0.09,1
9860,1188,1000.00,8000.00,9000.00,0.00,8000.00,0.21,1
9861,1188,1000.00,9000.00,10000.00,651.48,8348.52,0.40,1
9862,1188,1000.00,10000.00,11000.00,4284.05,5715.95,0.39,1
9863,1188,1000.00,11000.00,12000.00,2655.40,8344.60,0.26,1
9864,1188,-1000.00,10000.00,11000.00,10324.53,1675.47,0.08,0
9865,1188,1000.00,11000.00,12000.00,4512.46,6487.54,0.43,1
9866,1188,1000.00,12000.00,13000.00,0.00,12000.00,0.02,1
9867,1188,0.00,12000.00,13000.00,0.00,0.00,0.01,0
9868,1188,1000.00,13000.00,14000.00,5015.66,7984.34,0.30,1
9869,1188,1000.00,14000.00,15000.00,0.00,14000.00,0.12,1
9870,1188,-1000.00,13000.00,14000.00,7961.50,7038.50,0.07,0
9871,1188,1000.00,14000.00,15000.00,0.00,6185.28,0.28,1
9872,1188,1000.00,15000.00,16000.00,0.00,3157.15,0.10,1
9873,1188,-1000.00,14000.00,15000.00,11544.83,0.00,0.03,0
9874,1188,1000.00,15000.00,16000.00,0.00,15000.00,0.17,1
9875,1188,-1000.00,14000.00,15000.00,11982.42,4017.58,0.24,0
9876,1188,-1000.00,13000.00,14000.00,7500.00,7500.00,0.01,0
9877,1188,-1000.00,12000.00,13000.00,1143.41,12856.59,0.42,0
9878,1188,-1000.00,11000.00,12000.00,0.00,13000.00,0.25,0
9879,1188,-1000.00,10000.00,11000.00,0.00,6716.19,0.05,0
9880,1188,-1000.00,9000.00,10000.00,0.00,5869.33,0.24,0
9881,1188,-1000.00,8000.00,9000.00,5998.63,1875.17,0.14,0
9882,1188,0.00,8000.00,9000.00,0.00,0.00,0.00,0
9883,1188,0.00,8000.00,9000.00,0.00,0.00,0.05,0
9884,1188,-1000.00,7000.00,8000.00,1259.45,7740.55,0.43,0
9885,1188,-1000.00,6000.00,7000.00,3621.11,4378.89,0.32,0
9886,1188,-1000.00,5000.00,6000.00,0.00,3634.92,0.11,0
9887,1188,-1000.00,4000.00,5000.00,103.87,5896.13,0.34,0
9888,1188,-1000.00,3000.00,4000.00,0.00,5000.00,0.37,0
9889,1188,-1000.00,2000.00,3000.00,1550.70,2279.01,0.42,0
9890,1188,-1000.00,1000.00,2000.00,0.00,1935.14,0.36,0
9891,1188,-1000.00,0.00,1000.00,0.00,2000.00,0.10,0
9892,1188,-738.82,-738.82,261.18,0.00,738.82,0.40,0
9893,1188,-261.18,-1000.00,0.00,91.70,169.48,0.33,0
9894,1189,-1000.00,-1000.00,0.00,0.00,1000.00,0.25,0
9895,1190,-835.97,-835.97,164.03,771.71,64.26,0.06,0
9896,1190,1000.00,164.03,1164.03,0.00,43.60,0.17,1
9897,1190,-1000.00,-835.97,164.03,1118.92,0.00,0.04,0
9898,1190,1000.00,164.03,1164.03,13.66,114.82,0.33,1
9899,1190,1000.00,1164.03,2164.03,179.32,984.70,0.39,1
9900,1190,-1000.00,164.03,1164.03,1658.41,505.62,0.09,0
9901,1190,1000.00,1164.03,2164.03,0.00,746.52,0.28,1
9902,1190,-273.08,890.95,1890.95,273.08,0.00,0.11,0
9903,1190,1000.00,1890.95,2890.95,598.82,1292.13,0.41,1
9904,1190,-1000.00,890.95,1890.95,1590.14,1300.81,0.17,0
9905,1190,1000.00,1890.95,2890.95,869.45,1021.50,0.15,1
9906,1190,1000.00,2890.95,3890.95,4.67,2886.28,0.44,1
9907,1190,1000.00,3890.95,4890.95,1555.32,2335.63,0.09,1
9908,1190,1000.00,4890.95,5890.95,2296.70,2594.25,0.02,1
9909,1190,1000.00,5890.95,6890.95,2945.47,2945.47,0.05,1
9910,1190,1000.00,6890.95,7890.95,0.00,4945.44,0.13,1
9911,1190,1000.00,7890.95,8890.95,0.00,1770.56,0.19,1
9912,1190,0.00,7890.95,8890.95,0.00,0.00,0.04,0
9913,1190,1000.00,8890.95,9890.95,0.00,7638.03,0.43,1
9914,1190,1000.00,9890.95,10890.95,3576.87,6314.07,0.41,1
9915,1190,1000.00,10890.95,11890.95,3260.10,7630.85,0.36,1
9916,1190,1000.00,11890.95,12890.95,2991.01,8899.94,0.39,1
9917,1190,1000.00,12890.95,13890.95,2375.27,10515.68,0.27,1
9918,1190,1000.00,13890.95,14890.95,6945.47,6945.47,0.06,1
9919,1190,1000.00,14890.95,15890.95,0.00,14305.39,0.37,1
9920,1190,1000.00,15890.95,16890.95,6531.97,9358.98,0.28,1
9921,1190,1000.00,16890.95,17890.95,0.00,16890.95,0.03,1
9922,1190,1000.00,17890.95,18890.95,8945.47,8945.47,0.26,1
9923,1190,-1000.00,16890.95,17890.95,12238.62,6652.33,0.08,0
9924,1190,1000.00,17890.95,18890.95,1075.88,13218.92,0.39,1
9925,1190,1000.00,18890.95,19890.95,0.00,18890.95,0.07,1
9926,1190,1000.00,19890.95,20890.95,263.11,19627.83,0.41,1
9927,1190,1000.00,20890.95,21890.95,0.00,9601.85,0.11,1
9928,1190,1000.00,21890.95,22890.95,4287.74,16424.33,0.40,1
9929,1190,1000.00,22890.95,23890.95,0.00,22890.95,0.42,1
9930,1190,1000.00,23890.95,24890.95,0.00,23890.95,0.03,1
9931,1190,-1000.00,22890.95,23890.95,14917.27,9973.68,0.04,0
9932,1190,1000.00,23890.95,24890.95,9094.03,14796.92,0.10,1
9933,1190,-1000.00,22890.95,23890.95,15223.78,9667.16,0.22,0
9934,1190,1000.00,23890.95,24890.95,0.00,20385.10,0.42,1
9935,1190,1000.00,24890.95,25890.95,211.62,3620.09,0.20,1
9936,1190,1000.00,25890.95,26890.95,12719.45,13171.50,0.35,1
9937,1190,1000.00,26890.95,27890.95,0.00,26890.95,0.32,1
9938,1190,1000.00,27890.95,28890.95,10306.66,17584.29,0.35,1
9939,1190,0.00,27890.95,28890.95,0.00,0.00,0.03,0
9940,1190,1000.00,28890.95,29890.95,2185.19,21378.32,0.41,1
9941,1190,-1000.00,27890.95,28890.95,27994.18,1896.77,0.07,0
9942,1191,0.00,0.00,1000.00,0.00,0.00,0.02,0
9943,1191,-1000.00,-1000.00,0.00,0.00,1000.00,0.16,0
9944,1192,-1000.00,-1000.00,0.00,0.00,1000.00,0.04,0
9945,1193,-1000.00,-1000.00,0.00,448.80,551.20,0.21,0
9946,1194,-1000.00,-1000.00,0.00,943.43,56.57,0.01,0
9947,1195,-865.09,-865.09,134.91,0.00,865.09,0.08,0
9948,1195,-134.91,-1000.00,0.00,57.46,77.45,0.27,0
9949,1196,-1000.00,-1000.00,0.00,535.68,464.32,0.03,0
9950,1197,1000.00,1000.00,2000.00,0.00,893.37,0.25,1
9951,1197,1000.00,2000.00,3000.00,931.62,1068.38,0.16,1
9952,1197,-1000.00,1000.00,2000.00,1865.82,1134.18,0.26,0
9953,1197,1000.00,2000.00,3000.00,926.69,1073.31,0.26,1
9954,1197,1000.00,3000.00,4000.00,0.00,3000.00,0.18,1
9955,1197,1000.00,4000.00,5000.00,0.00,4000.00,0.06,1
9956,1197,1000.00,5000.00,6000.00,2500.00,2500.00,0.14,1
9957,1197,1000.00,6000.00,7000.00,2380.68,3619.32,0.42,1
9958,1197,1000.00,7000.00,8000.00,1234.12,5765.88,0.43,1
9959,1197,1000.00,8000.00,9000.00,0.00,4166.72,0.11,1
9960,1197,1000.00,9000.00,10000.00,0.00,1185.49,0.04,1
9961,1197,1000.00,10000.00,11000.00,0.00,6264.55,0.33,1
9962,1197,1000.00,11000.00,12000.00,0.00,11000.00,0.37,1
9963,1197,1000.00,12000.00,13000.00,5600.36,6399.64,0.01,1
9964,1197,1000.00,13000.00,14000.00,4284.64,8715.36,0.44,1
9965,1197,1000.00,14000.00,15000.00,3514.85,10485.15,0.29,1
9966,1197,1000.00,15000.00,16000.00,0.00,6924.79,0.16,1
9967,1197,1000.00,16000.00,17000.00,8000.00,8000.00,0.08,1
9968,1197,1000.00,17000.00,18000.00,6574.22,10425.78,0.38,1
9969,1197,-1000.00,16000.00,17000.00,9000.00,9000.00,0.14,0
9970,1197,-1000.00,15000.00,16000.00,0.00,17000.00,0.11,0
9971,1197,-1000.00,14000.00,15000.00,0.00,16000.00,0.27,0
9972,1197,-1000.00,13000.00,14000.00,3529.04,11470.96,0.26,0
9973,1197,-1000.00,12000.00,13000.00,7209.47,6790.53,0.44,0
9974,1197,-1000.00,11000.00,12000.00,0.00,11313.88,0.42,0
9975,1197,-1000.00,10000.00,11000.00,5125.04,6874.96,0.15,0
9976,1197,-1000.00,9000.00,10000.00,496.29,2068.34,0.17,0
9977,1197,-1000.00,8000.00,9000.00,0.00,10000.00,0.04,0
9978,1197,-519.43,7480.57,8480.57,0.00,519.43,0.09,0
9979,1197,-1000.00,6480.57,7480.57,2078.89,3227.76,0.27,0
9980,1197,-1000.00,5480.57,6480.57,802.01,4221.09,0.34,0
9981,1197,-1000.00,4480.57,5480.57,2860.88,3619.69,0.17,0
9982,1197,-1000.00,3480.57,4480.57,0.00,5480.57,0.19,0
9983,1197,-1000.00,2480.57,3480.57,2551.80,1928.77,0.16,0
9984,1197,-1000.00,1480.57,2480.57,1418.18,2062.40,0.30,0
9985,1197,-1000.00,480.57,1480.57,0.00,1675.20,0.25,0
9986,1197,-1000.00,-519.43,480.57,0.00,1480.57,0.34,0
9987,1197,-480.57,-1000.00,0.00,212.34,268.23,0.20,0
9988,1198,-1000.00,-1000.00,0.00,210.14,789.86,0.36,0
9989,1199,-1000.00,-1000.00,0.00,112.18,887.82,0.26,0
9990,1200,-764.30,-764.30,235.70,341.42,422.88,0.24,0
9991,1200,-235.70,-1000.00,0.00,0.00,235.70,0.40,0
9992,1201,-1000.00,-1000.00,0.00,0.00,1000.00,0.35,0
9993,1202,-317.15,-317.15,682.85,317.15,0.00,0.10,0
9994,1202,-1000.00,-1317.15,-317.15,0.00,682.85,0.11,0
9995,1203,-1000.00,-1000.00,0.00,0.00,1000.00,0.27,0
9996,1204,-1000.00,-1000.00,0.00,280.67,719.33,0.21,0
9997,1204,-0.00,-1000.00,0.00,0.00,0.00,0.38,0
9998,1204,-0.00,-1000.00,0.00,0.00,0.00,0.16,0
9999,1204,0.00,-1000.00,0.00,0.00,0.00,0.30,1
10000,1204,0.00,-1000.00,0.00,0.00,0.00,0.35,0
10001,1204,0.00,-1000.00,0.00,0.00,0.00,0.08,0
10002,1204,-0.00,-1000.00,0.00,0.00,0.00,0.01,0
10003,1204,0.00,-1000.00,0.00,0.00,0.00,0.05,0
10004,1204,0.00,-1000.00,0.00,0.00,0.00,0.02,0
10005,1204,-0.00,-1000.00,0.00,0.00,0.00,0.34,0
10006,1204,0.00,-1000.00,0.00,0.00,0.00,0.19,1
10007,1204,-0.00,-1000.00,0.00,0.00,0.00,0.30,0
10008,1204,0.00,-1000.00,0.00,0.00,0.00,0.01,1
10009,1204,-0.00,-1000.00,0.00,0.00,0.00,0.39,0
10010,1205,-378.44,-378.44,621.56,378.44,0.00,0.04,0
10011,1205,1000.00,621.56,1621.56,0.00,586.57,0.34,1
10012,1205,1000.00,1621.56,2621.56,0.00,1621.56,0.35,1
10013,1205,-1000.00,621.56,1621.56,1521.43,1100.13,0.19,0
10014,1205,1000.00,1621.56,2621.56,0.00,1621.56,0.29,1
10015,1205,1000.00,2621.56,3621.56,49.11,1832.17,0.29,1
10016,1205,1000.00,3621.56,4621.56,758.09,2356.69,0.33,1
10017,1205,1000.00,4621.56,5621.56,1838.18,2783.38,0.14,1
10018,1205,1000.00,5621.56,6621.56,42.84,5578.71,0.41,1
10019,1205,1000.00,6621.56,7621.56,1221.36,5400.20,0.38,1
10020,1205,1000.00,7621.56,8621.56,0.00,7621.56,0.25,1
10021,1205,1000.00,8621.56,9621.56,976.72,7644.84,0.40,1
10022,1205,1000.00,9621.56,10621.56,914.94,8706.61,0.37,1
10023,1205,1000.00,10621.56,11621.56,0.00,7193.86,0.11,1
10024,1205,0.00,10621.56,11621.56,0.00,0.00,0.02,0
10025,1205,-1000.00,9621.56,10621.56,10815.17,806.38,0.11,0
10026,1205,1000.00,10621.56,11621.56,3205.13,7416.43,0.41,1
10027,1205,-1000.00,9621.56,10621.56,8133.02,3488.53,0.19,0
10028,1205,1000.00,10621.56,11621.56,0.00,7186.60,0.10,1
10029,1205,1000.00,11621.56,12621.56,582.86,6757.46,0.38,1
10030,1205,1000.00,12621.56,13621.56,6094.58,6526.97,0.31,1
10031,1205,1000.00,13621.56,14621.56,0.00,3662.44,0.02,1
10032,1205,1000.00,14621.56,15621.56,5601.92,9019.63,0.25,1
10033,1205,1000.00,15621.56,16621.56,1477.82,14143.73,0.30,1
10034,1205,0.00,15621.56,16621.56,0.00,0.00,0.03,0
10035,1205,-1000.00,14621.56,15621.56,4542.88,0.00,0.33,0
10036,1205,-1000.00,13621.56,14621.56,0.00,15621.56,0.08,0
10037,1205,-1000.00,12621.56,13621.56,0.00,14621.56,0.24,0
10038,1205,-1000.00,11621.56,12621.56,1390.30,12231.26,0.14,0
10039,1205,-1000.00,10621.56,11621.56,0.00,4062.94,0.05,0
10040,1205,-1000.00,9621.56,10621.56,0.00,4338.80,0.31,0
10041,1205,-1000.00,8621.56,9621.56,3214.87,7406.69,0.08,0
10042,1205,-1000.00,7621.56,8621.56,5399.34,0.00,0.06,0
10043,1205,-1000.00,6621.56,7621.56,2270.11,3553.85,0.36,0
10044,1205,-1000.00,5621.56,6621.56,0.00,7621.56,0.19,0
10045,1205,-1000.00,4621.56,5621.56,4578.37,0.00,0.12,0
10046,1205,-1000.00,3621.56,4621.56,2205.59,2901.96,0.29,0
10047,1205,-1000.00,2621.56,3621.56,0.00,4621.56,0.11,0
10048,1205,-1000.00,1621.56,2621.56,1058.92,1128.95,0.39,0
10049,1205,-1000.00,621.56,1621.56,1310.78,1310.78,0.00,0
10050,1205,-1000.00,-378.44,621.56,0.00,1621.56,0.15,0
10051,1205,-1000.00,-1378.44,-378.44,0.00,37.58,0.15,0
10052,1206,-1000.00,-1000.00,0.00,639.68,360.32,0.10,0
10053,1207,-425.43,-425.43,574.57,0.00,425.43,0.16,0
10054,1207,-483.32,-908.75,91.25,158.46,324.85,0.31,0
10055,1207,-1000.00,-1908.75,-908.75,47.77,43.48,0.32,0
10056,1208,-80.48,-80.48,919.52,0.00,80.48,0.20,0
10057,1208,-5.51,-85.99,914.01,0.00,5.51,0.03,0
10058,1208,-135.43,-221.41,778.59,19.04,116.39,0.42,0
10059,1208,1000.00,778.59,1778.59,34.49,0.00,0.37,1
10060,1208,1000.00,1778.59,2778.59,1778.59,0.00,0.21,1
10061,1208,1000.00,2778.59,3778.59,1121.49,0.00,0.23,1
10062,1208,-1000.00,1778.59,2778.59,0.00,1026.43,0.43,0
10063,1208,-245.75,1532.83,2532.83,0.00,245.75,0.43,0
10064,1208,-1000.00,532.83,1532.83,0.00,2532.83,0.01,0
10065,1208,-622.56,-89.73,910.27,95.80,526.76,0.41,0
10066,1208,1000.00,910.27,1910.27,264.06,0.00,0.28,1
10067,1208,-1000.00,-89.73,910.27,0.00,1297.24,0.19,0
10068,1208,-229.85,-319.58,680.42,0.00,229.85,0.22,0
10069,1208,-149.66,-469.24,530.76,0.00,149.66,0.32,0
10070,1208,1000.00,530.76,1530.76,331.99,198.77,0.12,1
10071,1208,1000.00,1530.76,2530.76,252.61,0.00,0.23,1
10072,1208,0.00,1530.76,2530.76,0.00,0.00,0.39,0
10073,1208,1000.00,2530.76,3530.76,642.84,0.00,0.02,1
10074,1208,-1000.00,1530.76,2530.76,0.00,1457.09,0.33,0
10075,1208,-1000.00,530.76,1530.76,0.00,1452.20,0.16,0
10076,1208,-744.15,-213.40,786.60,744.15,0.00,0.28,0
10077,1208,-410.97,-624.36,375.64,410.97,0.00,0.14,0
10078,1208,-375.64,-1000.00,-0.00,340.25,35.39,0.03,0
10079,1209,-1000.00,-1000.00,0.00,135.66,864.34,0.42,0
10080,1210,-1000.00,-1000.00,0.00,0.00,1000.00,0.11,0
10081,1211,-564.33,-564.33,435.67,0.00,564.33,0.22,0
10082,1211,-435.67,-1000.00,0.00,0.00,435.67,0.32,0
10083,1212,1000.00,1000.00,2000.00,0.00,799.29,0.42,1
10084,1212,1000.00,2000.00,3000.00,142.84,366.82,0.17,1
10085,1212,1000.00,3000.00,4000.00,1366.26,1633.74,0.25,1
10086,1212,1000.00,4000.00,5000.00,1759.97,2240.03,0.23,1
10087,1212,1000.00,5000.00,6000.00,1764.14,3235.86,0.12,1
10088,1212,-1000.00,4000.00,5000.00,1217.12,0.00,0.09,0
10089,1212,1000.00,5000.00,6000.00,2500.00,2500.00,0.05,1
10090,1212,1000.00,6000.00,7000.00,482.90,5517.10,0.30,1
10091,1212,-1000.00,5000.00,6000.00,3563.81,3436.19,0.30,0
10092,1212,1000.00,6000.00,7000.00,0.00,6000.00,0.10,1
10093,1212,1000.00,7000.00,8000.00,0.00,7000.00,0.15,1
10094,1212,1000.00,8000.00,9000.00,3369.66,4630.34,0.34,1
10095,1212,1000.00,9000.00,10000.00,0.00,6650.36,0.40,1
10096,1212,1000.00,10000.00,11000.00,942.89,9057.11,0.04,1
10097,1212,-1000.00,9000.00,10000.00,7156.95,3843.05,0.06,0
10098,1212,-1000.00,8000.00,9000.00,4921.27,2199.23,0.19,0
10099,1212,1000.00,9000.00,10000.00,2347.63,6652.37,0.42,1
10100,1212,1000.00,10000.00,11000.00,0.00,4092.93,0.16,1
10101,1212,1000.00,11000.00,12000.00,3817.60,7182.40,0.27,1
10102,1212,1000.00,12000.00,13000.00,0.00,12000.00,0.06,1
10103,1212,1000.00,13000.00,14000.00,0.00,13000.00,0.02,1
10104,1212,-1000.00,12000.00,13000.00,3529.05,0.00,0.04,0
10105,1212,-1000.00,11000.00,12000.00,6549.80,6450.20,0.43,0
10106,1212,-1000.00,10000.00,11000.00,0.00,12000.00,0.38,0
10107,1212,-1000.00,9000.00,10000.00,487.73,10512.27,0.36,0
10108,1212,-1000.00,8000.00,9000.00,7193.06,1741.31,0.16,0
10109,1212,-1000.00,7000.00,8000.00,0.00,9000.00,0.36,0
10110,1212,-1000.00,6000.00,7000.00,4750.33,3249.67,0.17,0
10111,1212,-1000.00,5000.00,6000.00,0.00,7000.00,0.05,0
10112,1212,-1000.00,4000.00,5000.00,3000.00,3000.00,0.06,0
10113,1212,-1000.00,3000.00,4000.00,486.25,4513.75,0.43,0
10114,1212,-1000.00,2000.00,3000.00,0.00,3262.43,0.22,0
10115,1212,-1000.00,1000.00,2000.00,1046.88,1953.12,0.27,0
10116,1212,-1000.00,0.00,1000.00,0.00,1896.13,0.22,0
10117,1212,-764.87,-764.87,235.13,0.00,764.87,0.37,0
10118,1212,-1000.00,-1764.87,-764.87,201.53,33.60,0.05,0
10119,1213,-1000.00,-1000.00,0.00,177.44,822.56,0.40,0
10120,1213,-0.00,-1000.00,0.00,0.00,0.00,0.04,0
10121,1213,-0.00,-1000.00,0.00,0.00,0.00,0.26,0
10122,1214,-26.84,-26.84,973.16,0.00,26.84,0.10,0
10123,1214,-973.16,-1000.00,0.00,0.00,973.16,0.22,0
10124,1215,1000.00,1000.00,2000.00,83.74,916.26,0.42,1
10125,1215,1000.00,2000.00,3000.00,0.00,1483.45,0.38,1
10126,1215,1000.00,3000.00,4000.00,899.49,2100.51,0.36,1
10127,1215,-588.10,2411.90,3411.90,588.10,0.00,0.05,0
10128,1215,1000.00,3411.90,4411.90,0.00,3411.90,0.04,1
10129,1215,1000.00,4411.90,5411.90,0.00,4411.90,0.03,1
10130,1215,1000.00,5411.90,6411.90,0.00,5411.90,0.37,1
10131,1215,1000.00,6411.90,7411.90,2035.91,3279.77,0.31,1
10132,1215,-1000.00,5411.90,6411.90,6646.69,0.00,0.02,0
10133,1215,1000.00,6411.90,7411.90,2882.19,3529.71,0.30,1
10134,1215,-1000.00,5411.90,6411.90,3878.67,3533.23,0.26,0
10135,1215,1000.00,6411.90,7411.90,0.00,6411.90,0.13,1
10136,1215,1000.00,7411.90,8411.90,2886.53,4525.37,0.42,1
10137,1215,1000.00,8411.90,9411.90,0.00,8411.90,0.11,1
10138,1215,1000.00,9411.90,10411.90,2733.27,6678.64,0.39,1
10139,1215,1000.00,10411.90,11411.90,0.00,10411.90,0.06,1
10140,1215,1000.00,11411.90,12411.90,0.00,11411.90,0.11,1
10141,1215,-1000.00,10411.90,11411.90,6771.17,5640.73,0.37,0
10142,1215,-1000.00,9411.90,10411.90,11411.90,0.00,0.02,0
10143,1215,-1000.00,8411.90,9411.90,1373.75,6144.11,0.35,0
10144,1215,-1000.00,7411.90,8411.90,0.00,9411.90,0.02,0
10145,1215,-1000.00,6411.90,7411.90,0.00,1066.49,0.42,0
10146,1215,-1000.00,5411.90,6411.90,4847.02,0.00,0.09,0
10147,1215,-1000.00,4411.90,5411.90,2562.97,0.00,0.18,0
10148,1215,1000.00,5411.90,6411.90,0.00,5411.90,0.04,1
10149,1215,1000.00,6411.90,7411.90,90.40,6321.50,0.32,1
10150,1215,1000.00,7411.90,8411.90,0.00,4706.33,0.30,1
10151,1215,1000.00,8411.90,9411.90,1425.10,6986.80,0.30,1
10152,1215,1000.00,9411.90,10411.90,0.00,3756.36,0.26,1
10153,1215,1000.00,10411.90,11411.90,232.77,5795.90,0.24,1
10154,1215,1000.00,11411.90,12411.90,5240.18,6171.72,0.31,1
10155,1215,-1000.00,10411.90,11411.90,9232.48,2044.09,0.13,0
10156,1215,1000.00,11411.90,12411.90,0.00,11411.90,0.10,1
10157,1215,-1000.00,10411.90,11411.90,6241.74,6170.16,0.08,0
10158,1215,1000.00,11411.90,12411.90,2429.48,8982.42,0.36,1
10159,1215,1000.00,12411.90,13411.90,0.00,12411.90,0.08,1
10160,1215,1000.00,13411.90,14411.90,4912.20,8499.70,0.25,1
10161,1215,1000.00,14411.90,15411.90,7205.95,7205.95,0.09,1
10162,1215,1000.00,15411.90,16411.90,0.00,15411.90,0.25,1
10163,1215,1000.00,16411.90,17411.90,8205.95,8205.95,0.07,1
10164,1215,1000.00,17411.90,18411.90,1507.81,15904.09,0.34,1
10165,1215,1000.00,18411.90,19411.90,2525.60,15886.30,0.37,1
10166,1215,1000.00,19411.90,20411.90,9705.95,9705.95,0.07,1
10167,1215,1000.00,20411.90,21411.90,0.00,20411.90,0.28,1
10168,1215,1000.00,21411.90,22411.90,10705.95,10705.95,0.35,1
10169,1215,1000.00,22411.90,23411.90,0.00,13098.83,0.02,1
10170,1215,1000.00,23411.90,24411.90,8439.66,14972.24,0.41,1
10171,1216,-1000.00,-1000.00,0.00,156.06,843.94,0.34,0
10172,1217,-1000.00,-1000.00,0.00,345.46,654.54,0.08,0
10173,1218,-1000.00,-1000.00,0.00,0.00,1000.00,0.11,0
10174,1219,1000.00,1000.00,2000.00,276.68,723.32,0.36,1
10175,1219,1000.00,2000.00,3000.00,0.00,417.56,0.13,1
10176,1219,1000.00,3000.00,4000.00,538.07,2461.93,0.20,1
10177,1219,1000.00,4000.00,5000.00,572.40,3427.60,0.30,1
10178,1219,1000.00,5000.00,6000.00,190.64,2506.45,0.21,1
10179,1219,-1000.00,4000.00,5000.00,4062.88,1937.12,0.11,0
10180,1219,1000.00,5000.00,6000.00,0.00,3581.37,0.39,1
10181,1219,1000.00,6000.00,7000.00,0.00,6000.00,0.16,1
10182,1219,1000.00,7000.00,8000.00,1517.19,5482.81,0.40,1
10183,1219,1000.00,8000.00,9000.00,4000.00,4000.00,0.02,1
10184,1219,-1000.00,7000.00,8000.00,2785.70,2566.86,0.19,0
10185,1219,1000.00,8000.00,9000.00,0.00,10.79,0.21,1
10186,1219,1000.00,9000.00,10000.00,3491.50,5508.50,0.19,1
10187,1219,-1000.00,8000.00,9000.00,5611.20,3302.05,0.16,0
10188,1219,1000.00,9000.00,10000.00,2534.75,6465.25,0.14,1
10189,1219,1000.00,10000.00,11000.00,0.00,10000.00,0.40,1
10190,1219,1000.00,11000.00,12000.00,5500.00,5500.00,0.26,1
10191,1219,1000.00,12000.00,13000.00,4871.43,7128.57,0.30,1
10192,1219,1000.00,13000.00,14000.00,6500.00,6500.00,0.01,1
10193,1219,1000.00,14000.00,15000.00,0.00,12312.55,0.43,1
10194,1219,-1000.00,13000.00,14000.00,7416.41,6489.54,0.29,0
10195,1219,1000.00,14000.00,15000.00,0.00,12590.68,0.40,1
10196,1219,1000.00,15000.00,16000.00,0.00,9501.52,0.07,1
10197,1219,1000.00,16000.00,17000.00,6925.96,9074.04,0.02,1
10198,1219,1000.00,17000.00,18000.00,8500.00,8500.00,0.00,1
10199,1219,1000.00,18000.00,19000.00,0.00,14866.98,0.33,1
10200,1219,1000.00,19000.00,20000.00,0.00,16182.95,0.36,1
10201,1219,-1000.00,18000.00,19000.00,2427.11,0.00,0.04,0
10202,1219,-1000.00,17000.00,18000.00,5052.09,4551.99,0.19,0
10203,1219,1000.00,18000.00,19000.00,0.00,18000.00,0.07,1
10204,1219,1000.00,19000.00,20000.00,0.00,19000.00,0.17,1
10205,1219,-1000.00,18000.00,19000.00,13444.71,6555.29,0.06,0
10206,1219,0.00,18000.00,19000.00,0.00,0.00,0.01,0
10207,1219,1000.00,19000.00,20000.00,4923.28,14076.72,0.38,1
10208,1219,-1000.00,18000.00,19000.00,10976.09,3848.41,0.15,0
10209,1219,1000.00,19000.00,20000.00,0.00,19000.00,0.23,1
10210,1219,1000.00,20000.00,21000.00,8124.12,11875.88,0.23,1
10211,1219,1000.00,21000.00,22000.00,8141.61,12858.39,0.25,1
10212,1219,1000.00,22000.00,23000.00,0.00,22000.00,0.00,1
10213,1219,1000.00,23000.00,24000.00,6027.00,10819.74,0.30,1
10214,1219,1000.00,24000.00,25000.00,4708.61,19291.39,0.01,1
10215,1219,1000.00,25000.00,26000.00,12500.00,12500.00,0.10,1
10216,1219,1000.00,26000.00,27000.00,2790.88,6081.43,0.20,1
10217,1219,1000.00,27000.00,28000.00,0.00,16508.93,0.21,1
10218,1219,1000.00,28000.00,29000.00,0.00,28000.00,0.30,1
10219,1219,1000.00,29000.00,30000.00,3847.35,25152.65,0.43,1
10220,1219,1000.00,30000.00,31000.00,0.00,28079.48,0.44,1
10221,1219,-1000.00,29000.00,30000.00,31000.00,0.00,0.18,0
10222,1219,-1000.00,28000.00,29000.00,0.00,30000.00,0.35,0
10223,1219,-1000.00,27000.00,28000.00,10703.08,18296.92,0.35,0
10224,1219,-1000.00,26000.00,27000.00,14479.75,13520.25,0.19,0
10225,1219,-1000.00,25000.00,26000.00,27000.00,0.00,0.04,0
10226,1219,-1000.00,24000.00,25000.00,9826.04,16173.96,0.43,0
10227,1219,-1000.00,23000.00,24000.00,0.00,22044.74,0.08,0
10228,1219,-1000.00,22000.00,23000.00,4296.35,19703.65,0.44,0
10229,1219,-1000.00,21000.00,22000.00,0.00,10448.83,0.25,0
10230,1219,-1000.00,20000.00,21000.00,4543.80,17456.20,0.23,0
10231,1219,-1000.00,19000.00,20000.00,0.00,11815.54,0.01,0
10232,1219,-1000.00,18000.00,19000.00,0.00,6394.62,0.23,0
10233,1219,-1000.00,17000.00,18000.00,15979.51,3020.49,0.03,0
10234,1219,-1000.00,16000.00,17000.00,0.00,18000.00,0.38,0
10235,1219,-1000.00,15000.00,16000.00,0.00,15098.74,0.22,0
10236,1219,-1000.00,14000.00,15000.00,4158.16,11841.84,0.16,0
10237,1219,-1000.00,13000.00,14000.00,0.00,12934.27,0.08,0
10238,1219,-1000.00,12000.00,13000.00,0.00,14000.00,0.27,0
10239,1219,-1000.00,11000.00,12000.00,4848.11,8151.89,0.32,0
10240,1219,-1000.00,10000.00,11000.00,7199.03,4800.97,0.04,0
10241,1219,-1000.00,9000.00,10000.00,5500.00,5500.00,0.35,0
10242,1219,-1000.00,8000.00,9000.00,0.00,10000.00,0.00,0
10243,1219,-1000.00,7000.00,8000.00,0.00,6109.89,0.34,0
10244,1220,-1000.00,-1000.00,0.00,417.41,582.59,0.26,0
10245,1221,-181.66,-181.66,818.34,0.00,181.66,0.17,0
10246,1221,-818.34,-1000.00,0.00,188.89,629.45,0.12,0
10247,1222,-799.11,-799.11,200.89,187.44,611.67,0.34,0
10248,1222,0.00,-799.11,200.89,0.00,0.00,0.06,0
10249,1222,0.00,-799.11,200.89,0.00,0.00,0.05,0
10250,1222,-148.93,-948.03,51.97,70.63,78.30,0.25,0
10251,1222,-48.72,-996.75,3.25,3.25,45.47,0.43,0
10252,1222,-3.25,-1000.00,0.00,0.00,3.25,0.11,0
10253,1223,1000.00,1000.00,2000.00,0.00,1000.00,0.18,1
10254,1223,-1000.00,0.00,1000.00,1401.12,598.88,0.07,0
10255,1223,1000.00,1000.00,2000.00,408.40,591.60,0.25,1
10256,1223,0.00,1000.00,2000.00,0.00,0.00,0.04,0
10257,1223,1000.00,2000.00,3000.00,0.00,1429.36,0.02,1
10258,1223,1000.00,3000.00,4000.00,710.45,2289.55,0.24,1
10259,1223,1000.00,4000.00,5000.00,296.82,3660.85,0.44,1
10260,1223,-1000.00,3000.00,4000.00,3044.83,1955.17,0.25,0
10261,1223,1000.00,4000.00,5000.00,0.00,4000.00,0.03,1
10262,1223,1000.00,5000.00,6000.00,73.45,4926.55,0.38,1
10263,1223,1000.00,6000.00,7000.00,0.00,2418.04,0.04,1
10264,1223,1000.00,7000.00,8000.00,213.56,6786.44,0.28,1
10265,1223,1000.00,8000.00,9000.00,1873.15,6126.85,0.26,1
10266,1223,1000.00,9000.00,10000.00,0.00,2428.65,0.21,1
10267,1223,1000.00,10000.00,11000.00,951.31,7349.39,0.38,1
10268,1223,1000.00,11000.00,12000.00,0.00,6273.89,0.03,1
10269,1223,1000.00,12000.00,13000.00,4641.78,7358.22,0.15,1
10270,1223,1000.00,13000.00,14000.00,4063.79,8936.21,0.19,1
10271,1223,1000.00,14000.00,15000.00,1087.02,7019.09,0.32,1
10272,1223,-1000.00,13000.00,14000.00,6119.89,8880.11,0.18,0
10273,1223,-1000.00,12000.00,13000.00,0.00,14000.00,0.31,0
10274,1223,-1000.00,11000.00,12000.00,0.00,12980.92,0.44,0
10275,1223,-1000.00,10000.00,11000.00,6000.00,6000.00,0.22,0
10276,1223,-1000.00,9000.00,10000.00,0.00,7747.67,0.35,0
10277,1223,-1000.00,8000.00,9000.00,0.00,4994.51,0.32,0
10278,1223,0.00,8000.00,9000.00,0.00,0.00,0.02,0
10279,1223,-1000.00,7000.00,8000.00,0.00,5732.73,0.07,0
10280,1223,-1000.00,6000.00,7000.00,2176.30,5823.70,0.20,0
10281,1223,-1000.00,5000.00,6000.00,928.69,4768.35,0.38,0
10282,1223,-1000.00,4000.00,5000.00,1454.96,4545.04,0.35,0
10283,1223,-1000.00,3000.00,4000.00,0.00,5000.00,0.08,0
10284,1223,-1000.00,2000.00,3000.00,0.00,4000.00,0.12,0
10285,1223,-1000.00,1000.00,2000.00,1667.94,1332.06,0.06,0
10286,1223,-1000.00,0.00,1000.00,0.00,1636.06,0.38,0
10287,1223,-1000.00,-1000.00,0.00,0.00,1000.00,0.14,0
10288,1224,-65.69,-65.69,934.31,0.00,65.69,0.08,0
10289,1224,-934.31,-1000.00,0.00,0.00,934.31,0.37,0
10290,1225,-1000.00,-1000.00,0.00,500.00,500.00,0.02,0
10291,1226,-1000.00,-1000.00,0.00,416.05,583.95,0.17,0
10292,1227,-435.55,-435.55,564.45,224.37,211.17,0.18,0
10293,1227,1000.00,564.45,1564.45,0.00,350.64,0.31,1
10294,1227,1000.00,1564.45,2564.45,782.23,782.23,0.07,1
10295,1227,1000.00,2564.45,3564.45,711.18,1853.28,0.05,1
10296,1227,1000.00,3564.45,4564.45,0.00,958.97,0.11,1
10297,1227,-1000.00,2564.45,3564.45,3364.83,52.67,0.12,0
10298,1227,1000.00,3564.45,4564.45,0.00,2519.02,0.04,1
10299,1227,1000.00,4564.45,5564.45,0.00,2946.86,0.29,1
10300,1227,1000.00,5564.45,6564.45,838.81,1963.17,0.25,1
10301,1227,0.00,5564.45,6564.45,0.00,0.00,0.04,0
10302,1227,1000.00,6564.45,7564.45,1539.92,5024.53,0.40,1
10303,1227,1000.00,7564.45,8564.45,0.00,7564.45,0.03,1
10304,1227,1000.00,8564.45,9564.45,3199.49,5364.96,0.04,1
10305,1227,1000.00,9564.45,10564.45,3292.86,6271.59,0.27,1
10306,1227,1000.00,10564.45,11564.45,0.00,9944.90,0.38,1
10307,1227,1000.00,11564.45,12564.45,281.98,8180.71,0.40,1
10308,1227,-1000.00,10564.45,11564.45,6257.60,0.00,0.08,0
10309,1227,1000.00,11564.45,12564.45,0.00,11564.45,0.09,1
10310,1227,1000.00,12564.45,13564.45,5262.22,7302.24,0.42,1
10311,1227,-1000.00,11564.45,12564.45,4655.72,8908.73,0.26,0
10312,1227,-1000.00,10564.45,11564.45,0.00,11950.86,0.34,0
10313,1227,-1000.00,9564.45,10564.45,0.00,11564.45,0.19,0
10314,1227,-1000.00,8564.45,9564.45,0.00,8539.63,0.41,0
10315,1227,-1000.00,7564.45,8564.45,0.00,9564.45,0.03,0
10316,1227,-1000.00,6564.45,7564.45,0.00,7196.18,0.39,0
10317,1227,-1000.00,5564.45,6564.45,7172.27,0.00,0.04,0
10318,1227,-1000.00,4564.45,5564.45,1475.50,4060.65,0.34,0
10319,1227,-1000.00,3564.45,4564.45,0.00,1740.87,0.10,0
10320,1227,-1000.00,2564.45,3564.45,2163.34,2401.11,0.02,0
10321,1227,-1000.00,1564.45,2564.45,0.00,3113.10,0.40,0
10322,1227,-1000.00,564.45,1564.45,0.00,2336.48,0.34,0
10323,1227,-317.44,247.01,1247.01,104.35,213.10,0.33,0
10324,1227,-1000.00,-752.99,247.01,586.58,660.43,0.14,0
10325,1227,-89.70,-842.69,157.31,0.00,89.70,0.20,0
10326,1227,-157.31,-1000.00,0.00,53.07,104.24,0.17,0
10327,1228,-441.90,-441.90,558.10,0.00,441.90,0.29,0
10328,1228,-558.10,-1000.00,0.00,279.05,279.05,0.05,0
10329,1229,-157.96,-157.96,842.04,91.53,66.43,0.13,0
10330,1229,1000.00,842.04,1842.04,0.00,599.62,0.06,1
10331,1229,1000.00,1842.04,2842.04,861.80,980.24,0.10,1
10332,1229,1000.00,2842.04,3842.04,0.00,2842.04,0.40,1
10333,1229,-1000.00,1842.04,2842.04,2835.86,1006.18,0.04,0
10334,1229,1000.00,2842.04,3842.04,1330.02,1512.03,0.37,1
10335,1229,1000.00,3842.04,4842.04,1350.96,2491.09,0.43,1
10336,1229,1000.00,4842.04,5842.04,0.00,4842.04,0.43,1
10337,1229,1000.00,5842.04,6842.04,2085.68,3756.37,0.33,1
10338,1229,-1000.00,4842.04,5842.04,4386.94,2455.10,0.13,0
10339,1229,1000.00,5842.04,6842.04,1639.44,4202.60,0.01,1
10340,1229,0.00,5842.04,6842.04,0.00,0.00,0.15,0
10341,1229,1000.00,6842.04,7842.04,3023.29,3818.76,0.03,1
10342,1229,-1000.00,5842.04,6842.04,5198.97,2643.08,0.21,0
10343,1229,1000.00,6842.04,7842.04,0.00,6842.04,0.35,1
10344,1229,1000.00,7842.04,8842.04,3734.64,4107.41,0.21,1
10345,1229,1000.00,8842.04,9842.04,0.00,2707.67,0.19,1
10346,1229,1000.00,9842.04,10842.04,4048.22,5793.83,0.18,1
10347,1229,1000.00,10842.04,11842.04,255.18,10586.86,0.24,1
10348,1229,1000.00,11842.04,12842.04,0.00,11842.04,0.00,1
10349,1229,1000.00,12842.04,13842.04,1824.00,11018.04,0.44,1
10350,1230,-1000.00,-1000.00,0.00,418.00,582.00,0.21,0
10351,1231,1000.00,1000.00,2000.00,0.00,766.67,0.39,1
10352,1231,1000.00,2000.00,3000.00,0.00,2000.00,0.09,1
10353,1231,1000.00,3000.00,4000.00,153.23,2290.84,0.40,1
10354,1231,-1000.00,2000.00,3000.00,2216.89,1783.11,0.31,0
10355,1231,-1000.00,1000.00,2000.00,2327.01,0.00,0.01,0
10356,1231,1000.00,2000.00,3000.00,0.00,2000.00,0.07,1
10357,1231,1000.00,3000.00,4000.00,0.00,938.08,0.12,1
10358,1231,-1000.00,2000.00,3000.00,2384.24,1615.76,0.25,0
10359,1231,1000.00,3000.00,4000.00,0.00,2805.37,0.37,1
10360,1231,1000.00,4000.00,5000.00,1337.29,2662.71,0.44,1
10361,1231,1000.00,5000.00,6000.00,0.00,4811.59,0.18,1
10362,1231,1000.00,6000.00,7000.00,2475.66,3524.34,0.40,1
10363,1231,-1000.00,5000.00,6000.00,4161.77,2838.23,0.11,0
10364,1231,1000.00,6000.00,7000.00,1623.86,4376.14,0.37,1
10365,1231,-1000.00,5000.00,6000.00,3517.86,3482.14,0.04,0
10366,1231,-1000.00,4000.00,5000.00,3993.84,2006.16,0.36,0
10367,1231,1000.00,5000.00,6000.00,0.00,5000.00,0.00,1
10368,1231,1000.00,6000.00,7000.00,1418.70,4581.30,0.43,1
10369,1231,1000.00,7000.00,8000.00,1935.90,5064.10,0.24,1
10370,1231,-1000.00,6000.00,7000.00,3751.68,2650.28,0.18,0
10371,1231,1000.00,7000.00,8000.00,3500.00,3500.00,0.20,1
10372,1231,1000.00,8000.00,9000.00,1496.63,6503.37,0.41,1
10373,1231,1000.00,9000.00,10000.00,3347.05,5652.95,0.30,1
10374,1231,1000.00,10000.00,11000.00,0.00,10000.00,0.16,1
10375,1231,1000.00,11000.00,12000.00,0.00,9290.53,0.39,1
10376,1231,0.00,11000.00,12000.00,0.00,0.00,0.04,0
10377,1231,1000.00,12000.00,13000.00,0.00,12000.00,0.22,1
10378,1231,1000.00,13000.00,14000.00,4710.23,8289.77,0.31,1
10379,1231,1000.00,14000.00,15000.00,0.00,8297.56,0.19,1
10380,1231,1000.00,15000.00,16000.00,7500.00,7500.00,0.31,1
10381,1231,-1000.00,14000.00,15000.00,7851.86,6036.51,0.23,0
10382,1231,1000.00,15000.00,16000.00,5655.24,9344.76,0.34,1
10383,1231,1000.00,16000.00,17000.00,2695.28,13304.72,0.32,1
10384,1231,1000.00,17000.00,18000.00,0.00,14901.35,0.43,1
10385,1231,1000.00,18000.00,19000.00,9000.00,9000.00,0.01,1
10386,1231,1000.00,19000.00,20000.00,723.29,5179.50,0.21,1
10387,1231,1000.00,20000.00,21000.00,7380.39,12619.61,0.33,1
10388,1231,1000.00,21000.00,22000.00,4859.58,9937.12,0.26,1
10389,1231,1000.00,22000.00,23000.00,11000.00,11000.00,0.17,1
10390,1231,1000.00,23000.00,24000.00,98.10,22901.90,0.43,1
10391,1231,1000.00,24000.00,25000.00,12000.00,12000.00,0.30,1
10392,1232,-1000.00,-1000.00,0.00,0.00,1000.00,0.17,0
10393,1233,1000.00,1000.00,2000.00,0.00,1000.00,0.12,1
10394,1233,1000.00,2000.00,3000.00,0.00,1562.94,0.19,1
10395,1233,1000.00,3000.00,4000.00,1407.92,1592.08,0.15,1
10396,1233,-1000.00,2000.00,3000.00,3599.71,0.00,0.05,0
10397,1233,1000.00,3000.00,4000.00,794.93,2205.07,0.18,1
10398,1233,-1000.00,2000.00,3000.00,2225.89,1774.11,0.43,0
10399,1233,1000.00,3000.00,4000.00,194.33,2805.67,0.32,1
10400,1233,1000.00,4000.00,5000.00,911.60,3088.40,0.35,1
10401,1233,1000.00,5000.00,6000.00,89.77,4910.23,0.39,1
10402,1233,1000.00,6000.00,7000.00,0.00,6000.00,0.14,1
10403,1233,1000.00,7000.00,8000.00,3344.31,3655.69,0.04,1
10404,1233,1000.00,8000.00,9000.00,3270.27,3840.23,0.28,1
10405,1233,-1000.00,7000.00,8000.00,4856.04,4143.96,0.39,0
10406,1233,1000.00,8000.00,9000.00,0.00,6939.70,0.40,1
10407,1233,1000.00,9000.00,10000.00,2186.37,6813.63,0.38,1
10408,1233,1000.00,10000.00,11000.00,0.00,8107.71,0.38,1
10409,1233,1000.00,11000.00,12000.00,0.00,11000.00,0.14,1
10410,1233,1000.00,12000.00,13000.00,0.00,9202.48,0.03,1
10411,1233,-1000.00,11000.00,12000.00,6500.00,6500.00,0.08,0
10412,1233,0.00,11000.00,12000.00,0.00,0.00,0.01,0
10413,1233,-1000.00,10000.00,11000.00,0.00,10479.10,0.43,0
10414,1233,-1000.00,9000.00,10000.00,2409.74,8590.26,0.38,0
10415,1233,-1000.00,8000.00,9000.00,5499.65,4500.35,0.43,0
10416,1233,-1000.00,7000.00,8000.00,2369.27,2850.78,0.22,0
10417,1233,-1000.00,6000.00,7000.00,4088.07,3911.93,0.22,0
10418,1233,-1000.00,5000.00,6000.00,0.00,4689.50,0.02,0
10419,1233,-1000.00,4000.00,5000.00,0.00,3758.21,0.25,0
10420,1233,-1000.00,3000.00,4000.00,2807.19,2192.81,0.18,0
10421,1233,-1000.00,2000.00,3000.00,0.00,4000.00,0.28,0
10422,1233,-1000.00,1000.00,2000.00,730.47,1078.42,0.25,0
10423,1233,-1000.00,0.00,1000.00,1189.91,810.09,0.39,0
10424,1233,-1000.00,-1000.00,0.00,500.00,500.00,0.08,0
10425,1234,-1000.00,-1000.00,0.00,296.50,0.00,0.08,0
10426,1235,-1000.00,-1000.00,0.00,84.14,329.64,0.24,0
10427,1236,-1000.00,-1000.00,0.00,403.03,596.97,0.07,0
10428,1237,-104.16,-104.16,895.84,0.00,104.16,0.10,0
10429,1237,-895.84,-1000.00,0.00,212.19,683.64,0.15,0
10430,1238,-1000.00,-1000.00,0.00,0.00,1000.00,0.07,0
10431,1239,-670.40,-670.40,329.60,0.00,670.40,0.28,0
10432,1239,-329.60,-1000.00,0.00,41.67,287.93,0.43,0
10433,1240,-1000.00,-1000.00,0.00,480.61,519.39,0.02,0
10434,1241,-515.48,-515.48,484.52,0.00,515.48,0.19,0
10435,1241,0.00,-515.48,484.52,0.00,0.00,0.08,0
10436,1241,-484.52,-1000.00,0.00,0.00,484.52,0.07,0
10437,1242,-1000.00,-1000.00,0.00,26.13,973.87,0.23,0
10438,1243,0.00,0.00,1000.00,0.00,1000.00,0.18,0
10439,1243,0.00,0.00,1000.00,493.12,506.88,0.16,0
10440,1243,0.00,0.00,1000.00,33.21,966.79,0.20,0
10441,1243,0.00,0.00,1000.00,188.73,811.27,0.03,0
10442,1243,0.00,0.00,1000.00,309.14,578.51,0.33,0
10443,1243,0.00,0.00,1000.00,0.00,1000.00,0.16,0
10444,1243,0.00,0.00,1000.00,371.19,628.81,0.08,0
10445,1243,0.00,0.00,1000.00,451.42,548.58,0.28,0
10446,1243,0.00,0.00,1000.00,500.00,500.00,0.06,0
10447,1243,0.00,0.00,1000.00,0.00,1000.00,0.14,0
10448,1243,0.00,0.00,1000.00,103.78,876.25,0.43,0
10449,1243,-1000.00,-1000.00,0.00,768.14,231.86,0.21,0
10450,1244,-701.01,-701.01,298.99,325.98,375.03,0.22,0
10451,1244,-284.03,-985.05,14.95,0.00,284.03,0.22,0
10452,1244,-4.17,-989.21,10.79,0.00,4.17,0.10,0
10453,1244,-1000.00,-1989.21,-989.21,5.70,5.09,0.43,0
10454,1245,1000.00,1000.00,2000.00,0.00,1000.00,0.42,1
10455,1245,1000.00,2000.00,3000.00,13.99,1986.01,0.34,1
10456,1245,1000.00,3000.00,4000.00,373.31,2626.69,0.36,1
10457,1245,-1000.00,2000.00,3000.00,3168.73,831.27,0.03,0
10458,1245,1000.00,3000.00,4000.00,1468.43,1531.57,0.17,1
10459,1245,1000.00,4000.00,5000.00,0.00,4000.00,0.44,1
10460,1245,-1000.00,3000.00,4000.00,2707.54,2292.46,0.04,0
10461,1245,-1000.00,2000.00,3000.00,2222.03,1777.97,0.32,0
10462,1245,1000.00,3000.00,4000.00,1302.29,1697.71,0.23,1
10463,1245,0.00,3000.00,4000.00,0.00,0.00,0.02,0
10464,1245,1000.00,4000.00,5000.00,0.00,2647.02,0.35,1
10465,1245,1000.00,5000.00,6000.00,2500.00,2500.00,0.21,1
10466,1245,1000.00,6000.00,7000.00,0.00,6000.00,0.39,1
10467,1245,1000.00,7000.00,8000.00,2489.21,4510.79,0.29,1
10468,1245,1000.00,8000.00,9000.00,1843.30,5536.74,0.36,1
10469,1245,1000.00,9000.00,10000.00,3361.13,5638.87,0.30,1
10470,1245,1000.00,10000.00,11000.00,3891.21,6108.79,0.20,1
10471,1245,1000.00,11000.00,12000.00,4157.19,6842.81,0.41,1
10472,1245,1000.00,12000.00,13000.00,5079.79,6920.21,0.13,1
10473,1245,1000.00,13000.00,14000.00,2999.85,5490.48,0.27,1
10474,1245,1000.00,14000.00,15000.00,0.00,14000.00,0.43,1
10475,1245,-1000.00,13000.00,14000.00,15000.00,0.00,0.06,0
10476,1245,-1000.00,12000.00,13000.00,14000.00,0.00,0.07,0
10477,1245,1000.00,13000.00,14000.00,0.00,13000.00,0.17,1
10478,1245,1000.00,14000.00,15000.00,517.07,13482.93,0.42,1
10479,1245,1000.00,15000.00,16000.00,0.00,15000.00,0.04,1
10480,1245,-1000.00,14000.00,15000.00,10999.55,2630.63,0.14,0
10481,1245,1000.00,15000.00,16000.00,0.00,12501.21,0.21,1
10482,1245,0.00,15000.00,16000.00,0.00,0.00,0.02,0
10483,1245,1000.00,16000.00,17000.00,3533.09,12466.91,0.09,1
10484,1245,1000.00,17000.00,18000.00,4513.42,12486.58,0.43,1
10485,1245,1000.00,18000.00,19000.00,926.12,17073.88,0.26,1
10486,1245,-1000.00,17000.00,18000.00,11243.03,7756.97,0.10,0
10487,1245,1000.00,18000.00,19000.00,9000.00,9000.00,0.07,1
10488,1245,1000.00,19000.00,20000.00,5668.14,13331.86,0.22,1
10489,1245,1000.00,20000.00,21000.00,0.00,20000.00,0.31,1
10490,1245,1000.00,21000.00,22000.00,3522.33,17477.67,0.20,1
10491,1245,1000.00,22000.00,23000.00,3335.21,18664.79,0.32,1
10492,1245,1000.00,23000.00,24000.00,0.00,23000.00,0.29,1
10493,1245,1000.00,24000.00,25000.00,0.00,16974.49,0.22,1
10494,1245,-1000.00,23000.00,24000.00,13037.86,11962.14,0.42,0
10495,1245,1000.00,24000.00,25000.00,11776.06,12223.94,0.10,1
10496,1245,-1000.00,23000.00,24000.00,13424.67,11575.33,0.31,0
10497,1245,-1000.00,22000.00,23000.00,7172.82,5080.61,0.17,0
10498,1245,1000.00,23000.00,24000.00,0.00,14850.01,0.29,1
10499,1245,-1000.00,22000.00,23000.00,24000.00,0.00,0.03,0
10500,1246,-1000.00,-1000.00,0.00,336.53,663.47,0.30,0
10501,1247,-1000.00,-1000.00,0.00,0.00,599.34,0.32,0
10502,1248,-1000.00,-1000.00,0.00,323.41,676.59,0.33,0
10503,1249,-940.20,-940.20,59.80,0.00,940.20,0.34,0
10504,1249,-1000.00,-1940.20,-940.20,19.72,10.40,0.15,0
10505,1250,-848.97,-848.97,151.03,0.00,848.97,0.24,0
10506,1250,-20.70,-869.67,130.33,0.00,20.70,0.16,0
10507,1250,-130.33,-1000.00,0.00,9.01,121.32,0.35,0
10508,1251,1000.00,1000.00,2000.00,419.76,329.36,0.19,1
10509,1251,-1000.00,0.00,1000.00,761.90,1238.10,0.21,0
10510,1251,-221.36,-221.36,778.64,0.00,221.36,0.11,0
10511,1251,-247.84,-469.20,530.80,88.37,159.47,0.39,0
10512,1251,-502.62,-971.82,28.18,13.72,488.90,0.37,0
10513,1251,-14.48,-986.30,13.70,4.38,10.10,0.33,0
10514,1251,-13.70,-1000.00,0.00,6.02,7.67,0.16,0
10515,1251,0.00,-1000.00,0.00,0.00,0.00,0.09,1
10516,1251,-0.00,-1000.00,0.00,0.00,0.00,0.41,0
10517,1252,-798.18,-798.18,201.82,0.00,798.18,0.40,0
10518,1252,-201.82,-1000.00,0.00,82.24,119.58,0.18,0
10519,1253,-1000.00,-1000.00,0.00,424.50,575.50,0.30,0
10520,1254,-959.29,-959.29,40.71,0.00,959.29,0.32,0
10521,1254,-14.43,-973.72,26.28,0.00,14.43,0.25,0
10522,1254,-20.66,-994.38,5.62,3.00,17.66,0.38,0
10523,1254,-5.62,-1000.00,0.00,2.07,3.55,0.31,0
10524,1255,1000.00,1000.00,2000.00,0.00,953.17,0.16,1
10525,1255,1000.00,2000.00,3000.00,0.00,2000.00,0.02,1
10526,1255,1000.00,3000.00,4000.00,673.28,2326.72,0.25,1
10527,1255,1000.00,4000.00,5000.00,0.00,4000.00,0.13,1
10528,1255,1000.00,5000.00,6000.00,2500.00,2500.00,0.07,1
10529,1255,1000.00,6000.00,7000.00,0.00,2797.47,0.24,1
10530,1255,1000.00,7000.00,8000.00,2895.21,4104.79,0.38,1
10531,1255,1000.00,8000.00,9000.00,0.00,89.54,0.04,1
10532,1255,1000.00,9000.00,10000.00,0.00,9000.00,0.13,1
10533,1255,1000.00,10000.00,11000.00,2267.63,7732.37,0.42,1
10534,1255,1000.00,11000.00,12000.00,0.00,11000.00,0.05,1
10535,1255,1000.00,12000.00,13000.00,0.00,12000.00,0.39,1
10536,1255,1000.00,13000.00,14000.00,6500.00,6500.00,0.03,1
10537,1255,1000.00,14000.00,15000.00,4535.61,9464.39,0.34,1
10538,1255,1000.00,15000.00,16000.00,0.00,8961.59,0.12,1
10539,1255,1000.00,16000.00,17000.00,1737.36,14262.64,0.43,1
10540,1255,1000.00,17000.00,18000.00,0.00,16779.16,0.11,1
10541,1255,1000.00,18000.00,19000.00,3130.42,14869.58,0.10,1
10542,1255,1000.00,19000.00,20000.00,8422.88,10577.12,0.16,1
10543,1255,-1000.00,18000.00,19000.00,20000.00,0.00,0.01,0
10544,1255,1000.00,19000.00,20000.00,8653.09,10346.91,0.01,1
10545,1255,0.00,19000.00,20000.00,0.00,0.00,0.01,0
10546,1255,-1000.00,18000.00,19000.00,12655.28,7344.72,0.21,0
10547,1255,1000.00,19000.00,20000.00,0.00,19000.00,0.21,1
10548,1255,1000.00,20000.00,21000.00,0.00,20000.00,0.40,1
10549,1255,-1000.00,19000.00,20000.00,6862.52,4946.97,0.20,0
10550,1255,1000.00,20000.00,21000.00,2893.81,17106.19,0.26,1
10551,1255,1000.00,21000.00,22000.00,0.00,21000.00,0.25,1
10552,1255,0.00,21000.00,22000.00,0.00,0.00,0.06,0
10553,1255,-1000.00,20000.00,21000.00,18982.17,0.00,0.04,0
10554,1255,1000.00,21000.00,22000.00,7610.40,13389.60,0.31,1
10555,1255,1000.00,22000.00,23000.00,124.64,21875.36,0.26,1
10556,1255,1000.00,23000.00,24000.00,8892.10,14107.90,0.22,1
10557,1255,1000.00,24000.00,25000.00,12000.00,12000.00,0.03,1
10558,1255,1000.00,25000.00,26000.00,12376.77,12623.23,0.07,1
10559,1255,1000.00,26000.00,27000.00,0.00,26000.00,0.26,1
10560,1255,1000.00,27000.00,28000.00,0.00,27000.00,0.16,1
10561,1255,-1000.00,26000.00,27000.00,17009.25,10990.75,0.13,0
10562,1256,-1000.00,-1000.00,0.00,0.00,1000.00,0.21,0
10563,1257,-1000.00,-1000.00,0.00,282.51,717.49,0.32,0
10564,1258,1000.00,1000.00,2000.00,796.49,203.51,0.07,1
10565,1258,-1000.00,0.00,1000.00,0.00,1901.12,0.42,0
10566,1258,1000.00,1000.00,2000.00,592.92,407.08,0.25,1
10567,1258,1000.00,2000.00,3000.00,1263.75,736.25,0.02,1
10568,1258,-1000.00,1000.00,2000.00,156.55,2843.45,0.30,0
10569,1258,1000.00,2000.00,3000.00,1421.14,578.86,0.13,1
10570,1258,-1000.00,1000.00,2000.00,352.75,796.19,0.23,0
10571,1258,-1000.00,0.00,1000.00,713.51,1286.49,0.37,0
10572,1258,-135.64,-135.64,864.36,0.00,135.64,0.02,0
10573,1258,1000.00,864.36,1864.36,216.82,0.00,0.17,1
10574,1258,-1000.00,-135.64,864.36,860.41,864.72,0.34,0
10575,1258,-752.55,-888.19,111.81,0.00,752.55,0.36,0
10576,1258,-111.81,-1000.00,0.00,26.13,85.69,0.06,0
10577,1259,-1000.00,-1000.00,0.00,0.00,1000.00,0.36,0
10578,1260,-697.23,-697.23,302.77,248.75,448.48,0.27,0
10579,1260,-302.77,-1000.00,0.00,149.96,152.81,0.02,0
10580,1261,-501.59,-501.59,498.41,288.07,213.52,0.17,0
10581,1261,1000.00,498.41,1498.41,221.75,276.66,0.17,1
10582,1261,1000.00,1498.41,2498.41,0.00,1498.41,0.32,1
10583,1261,1000.00,2498.41,3498.41,39.25,1264.60,0.33,1
10584,1261,-1000.00,1498.41,2498.41,1591.48,1032.34,0.43,0
10585,1261,-1000.00,498.41,1498.41,1920.77,0.00,0.05,0
10586,1261,1000.00,1498.41,2498.41,0.00,1021.12,0.39,1
10587,1261,1000.00,2498.41,3498.41,0.00,782.11,0.24,1
10588,1261,1000.00,3498.41,4498.41,817.84,1858.37,0.40,1
10589,1261,1000.00,4498.41,5498.41,945.76,3552.65,0.43,1
10590,1261,1000.00,5498.41,6498.41,2749.21,2749.21,0.04,1
10591,1261,1000.00,6498.41,7498.41,2021.78,4476.63,0.37,1
10592,1261,1000.00,7498.41,8498.41,942.94,6555.47,0.31,1
10593,1261,1000.00,8498.41,9498.41,3921.09,4577.32,0.12,1
10594,1261,-1000.00,7498.41,8498.41,9498.41,0.00,0.13,0
10595,1261,1000.00,8498.41,9498.41,0.00,8498.41,0.18,1
10596,1261,1000.00,9498.41,10498.41,1171.57,8326.84,0.14,1
10597,1261,1000.00,10498.41,11498.41,0.00,10498.41,0.00,1
10598,1261,1000.00,11498.41,12498.41,3202.91,8295.50,0.17,1
10599,1261,-1000.00,10498.41,11498.41,6365.59,5666.49,0.22,0
10600,1261,1000.00,11498.41,12498.41,5383.73,6114.68,0.37,1
10601,1261,-1000.00,10498.41,11498.41,6919.80,5578.61,0.09,0
10602,1261,1000.00,11498.41,12498.41,0.00,2859.07,0.19,1
10603,1261,1000.00,12498.41,13498.41,314.27,3829.50,0.26,1
10604,1261,-1000.00,11498.41,12498.41,6985.62,6512.79,0.44,0
10605,1261,-1000.00,10498.41,11498.41,2057.74,10440.67,0.42,0
10606,1261,-1000.00,9498.41,10498.41,0.00,9208.11,0.12,0
10607,1261,-1000.00,8498.41,9498.41,0.00,10498.41,0.10,0
10608,1261,-1000.00,7498.41,8498.41,0.00,9498.41,0.12,0
10609,1261,-1000.00,6498.41,7498.41,2789.30,3458.19,0.26,0
10610,1261,-1000.00,5498.41,6498.41,0.00,7020.32,0.42,0
10611,1261,-1000.00,4498.41,5498.41,1428.62,2415.22,0.25,0
10612,1261,-1000.00,3498.41,4498.41,2253.62,3244.79,0.36,0
10613,1261,-1000.00,2498.41,3498.41,145.94,3649.43,0.42,0
10614,1261,-1000.00,1498.41,2498.41,0.00,3498.41,0.27,0
10615,1261,-1000.00,498.41,1498.41,131.16,2367.25,0.30,0
10616,1261,-1000.00,-501.59,498.41,0.00,1498.41,0.02,0
10617,1261,-92.16,-593.75,406.25,0.00,92.16,0.22,0
10618,1261,-1000.00,-1593.75,-593.75,93.83,61.13,0.40,0
10619,1262,1000.00,1000.00,2000.00,1000.00,0.00,0.06,1
10620,1262,-962.78,37.22,1037.22,180.07,782.71,0.42,0
10621,1262,1000.00,1037.22,2037.22,505.21,213.70,0.40,1
10622,1262,-35.20,1002.01,2002.01,0.00,35.20,0.34,0
10623,1262,-1000.00,2.01,1002.01,0.00,2002.01,0.02,0
10624,1262,1000.00,1002.01,2002.01,660.61,0.00,0.27,1
10625,1262,1000.00,2002.01,3002.01,957.52,721.33,0.37,1
10626,1262,-1000.00,1002.01,2002.01,1004.83,1381.30,0.27,0
10627,1262,0.00,1002.01,2002.01,0.00,0.00,0.24,0
10628,1262,-1000.00,2.01,1002.01,0.00,1076.56,0.15,0
10629,1262,-821.83,-819.82,180.18,111.24,710.59,0.09,0
10630,1262,1000.00,180.18,1180.18,57.97,0.00,0.40,1
10631,1262,0.00,180.18,1180.18,0.00,0.00,0.24,0
10632,1262,-400.12,-219.94,780.06,0.00,400.12,0.37,0
10633,1262,-16.38,-236.32,763.68,0.00,16.38,0.00,0
10634,1262,1000.00,763.68,1763.68,763.68,0.00,0.33,1
10635,1262,1000.00,1763.68,2763.68,1763.68,0.00,0.02,1
10636,1262,1000.00,2763.68,3763.68,295.92,0.00,0.44,1
10637,1262,-1000.00,1763.68,2763.68,812.15,1709.97,0.32,0
10638,1262,1000.00,2763.68,3763.68,2555.53,208.15,0.13,1
10639,1262,-1000.00,1763.68,2763.68,1014.52,2749.17,0.02,0
10640,1262,0.00,1763.68,2763.68,0.00,0.00,0.29,0
10641,1262,1000.00,2763.68,3763.68,975.36,0.00,0.38,1
10642,1262,-1000.00,1763.68,2763.68,602.46,3161.22,0.11,0
10643,1262,-421.75,1341.93,2341.93,421.75,0.00,0.19,0
10644,1262,-1000.00,341.93,1341.93,0.00,1939.95,0.23,0
10645,1262,-1000.00,-658.07,341.93,0.00,547.71,0.17,0
10646,1262,-1000.00,-1658.07,-658.07,0.00,40.90,0.39,0
10647,1263,-640.93,-640.93,359.07,0.00,640.93,0.29,0
10648,1263,-359.07,-1000.00,0.00,80.36,278.71,0.32,0
10649,1264,-1000.00,-1000.00,0.00,0.00,1000.00,0.10,0
10650,1265,-1000.00,-1000.00,0.00,770.11,0.00,0.01,0
10651,1266,1000.00,1000.00,2000.00,0.00,1000.00,0.10,1
10652,1266,1000.00,2000.00,3000.00,0.00,2000.00,0.38,1
10653,1266,1000.00,3000.00,4000.00,0.00,425.34,0.15,1
10654,1266,1000.00,4000.00,5000.00,2000.00,2000.00,0.29,1
10655,1266,1000.00,5000.00,6000.00,962.43,4037.57,0.40,1
10656,1266,1000.00,6000.00,7000.00,1836.48,4163.52,0.42,1
10657,1266,1000.00,7000.00,8000.00,0.00,6841.48,0.34,1
10658,1266,1000.00,8000.00,9000.00,1462.85,6537.15,0.18,1
10659,1266,1000.00,9000.00,10000.00,1752.34,7247.66,0.42,1
10660,1266,-1000.00,8000.00,9000.00,8100.04,1899.96,0.12,0
10661,1266,1000.00,9000.00,10000.00,597.11,8402.89,0.35,1
10662,1266,-1000.00,8000.00,9000.00,5787.88,4212.12,0.41,0
10663,1266,1000.00,9000.00,10000.00,1530.33,3553.88,0.32,1
10664,1266,1000.00,10000.00,11000.00,4351.76,5648.24,0.20,1
10665,1266,-1000.00,9000.00,10000.00,5990.98,5009.02,0.28,0
10666,1266,-1000.00,8000.00,9000.00,3488.27,0.00,0.09,0
10667,1266,1000.00,9000.00,10000.00,4224.63,4775.37,0.10,1
10668,1266,1000.00,10000.00,11000.00,2251.53,7748.47,0.31,1
10669,1266,1000.00,11000.00,12000.00,0.00,11000.00,0.13,1
10670,1266,-1000.00,10000.00,11000.00,10059.76,1940.24,0.14,0
10671,1266,1000.00,11000.00,12000.00,5500.00,5500.00,0.04,1
10672,1266,1000.00,12000.00,13000.00,6000.00,6000.00,0.07,1
10673,1266,-1000.00,11000.00,12000.00,8712.13,2690.50,0.24,0
10674,1266,-1000.00,10000.00,11000.00,8116.29,2265.04,0.10,0
10675,1266,-1000.00,9000.00,10000.00,6194.60,4805.40,0.30,0
10676,1266,-1000.00,8000.00,9000.00,0.00,9224.29,0.29,0
10677,1266,-1000.00,7000.00,8000.00,867.32,5397.44,0.35,0
10678,1266,-1000.00,6000.00,7000.00,0.00,8000.00,0.29,0
10679,1266,-1000.00,5000.00,6000.00,2012.73,0.00,0.03,0
10680,1266,-1000.00,4000.00,5000.00,0.00,6000.00,0.07,0
10681,1266,-1000.00,3000.00,4000.00,0.00,5000.00,0.24,0
10682,1266,-1000.00,2000.00,3000.00,1612.06,2387.94,0.31,0
10683,1266,-1000.00,1000.00,2000.00,0.00,3000.00,0.36,0
10684,1266,-1000.00,0.00,1000.00,0.00,1053.69,0.12,0
10685,1266,-924.02,-924.02,75.98,239.80,684.22,0.20,0
10686,1266,-36.48,-960.49,39.51,0.00,36.48,0.15,0
10687,1266,-39.51,-1000.00,0.00,0.00,39.51,0.23,0
10688,1267,-1000.00,-1000.00,0.00,305.72,694.28,0.32,0
10689,1268,1000.00,1000.00,2000.00,476.39,523.61,0.16,1
10690,1268,1000.00,2000.00,3000.00,597.71,1402.29,0.34,1
10691,1268,1000.00,3000.00,4000.00,0.00,3000.00,0.37,1
10692,1268,-1000.00,2000.00,3000.00,1596.36,1374.46,0.23,0
10693,1268,1000.00,3000.00,4000.00,0.00,2257.77,0.36,1
10694,1268,1000.00,4000.00,5000.00,1654.60,2345.40,0.26,1
10695,1268,1000.00,5000.00,6000.00,858.00,4142.00,0.38,1
10696,1268,1000.00,6000.00,7000.00,219.34,2999.09,0.31,1
10697,1268,1000.00,7000.00,8000.00,0.00,7000.00,0.33,1
10698,1268,1000.00,8000.00,9000.00,1749.92,6250.08,0.17,1
10699,1268,1000.00,9000.00,10000.00,1286.23,7713.77,0.36,1
10700,1268,-1000.00,8000.00,9000.00,5137.29,4862.71,0.01,0
10701,1268,1000.00,9000.00,10000.00,0.00,6256.13,0.34,1
10702,1268,-1000.00,8000.00,9000.00,5833.62,1623.35,0.12,0
10703,1268,1000.00,9000.00,10000.00,2400.73,5208.20,0.32,1
10704,1268,1000.00,10000.00,11000.00,0.00,10000.00,0.01,1
10705,1268,1000.00,11000.00,12000.00,0.00,11000.00,0.40,1
10706,1268,-1000.00,10000.00,11000.00,9852.40,2147.60,0.36,0
10707,1268,-607.85,9392.15,10392.15,607.85,0.00,0.11,0
10708,1268,1000.00,10392.15,11392.15,0.00,5685.43,0.34,1
10709,1268,1000.00,11392.15,12392.15,5580.11,5812.04,0.42,1
10710,1268,1000.00,12392.15,13392.15,6118.28,6273.87,0.37,1
10711,1268,1000.00,13392.15,14392.15,0.00,11711.17,0.30,1
10712,1268,-1000.00,12392.15,13392.15,7600.08,6792.07,0.18,0
10713,1268,-1000.00,11392.15,12392.15,0.00,13392.15,0.03,0
10714,1268,-1000.00,10392.15,11392.15,0.00,9294.26,0.21,0
10715,1268,-1000.00,9392.15,10392.15,3392.17,7999.98,0.37,0
10716,1268,-1000.00,8392.15,9392.15,0.00,3514.65,0.24,0
10717,1268,-1000.00,7392.15,8392.15,471.38,8920.77,0.44,0
10718,1268,-1000.00,6392.15,7392.15,378.00,8014.15,0.43,0
10719,1268,-1000.00,5392.15,6392.15,0.00,1442.99,0.12,0
10720,1268,-1000.00,4392.15,5392.15,2255.86,4136.29,0.02,0
10721,1268,0.00,4392.15,5392.15,0.00,0.00,0.04,0
10722,1268,-1000.00,3392.15,4392.15,1007.12,3996.32,0.39,0
10723,1268,-1000.00,2392.15,3392.15,1595.53,2796.62,0.07,0
10724,1268,-1000.00,1392.15,2392.15,2571.82,820.33,0.27,0
10725,1268,-1000.00,392.15,1392.15,499.02,1893.13,0.30,0
10726,1268,-1000.00,-607.85,392.15,0.00,1182.84,0.26,0
10727,1268,-1000.00,-1607.85,-607.85,228.80,163.35,0.15,0
10728,1269,1000.00,1000.00,2000.00,0.00,955.75,0.44,1
10729,1269,-1000.00,0.00,1000.00,1183.04,816.96,0.17,0
10730,1269,-1000.00,-1000.00,0.00,558.25,441.75,0.05,0
10731,1270,-1000.00,-1000.00,0.00,333.02,666.98,0.32,0
10732,1271,-169.71,-169.71,830.29,169.71,0.00,0.10,0
10733,1271,0.00,-169.71,830.29,0.00,0.00,0.05,0
10734,1271,-1000.00,-1169.71,-169.71,0.00,830.29,0.32,0
10735,1272,-1000.00,-1000.00,0.00,0.00,1000.00,0.06,0
10736,1273,-1000.00,-1000.00,0.00,242.43,757.57,0.40,0
10737,1274,1000.00,1000.00,2000.00,50.15,0.00,0.08,1
10738,1274,-1000.00,0.00,1000.00,0.00,2000.00,0.44,0
10739,1274,-1000.00,-1000.00,0.00,21.93,978.07,0.41,0
10740,1275,-1000.00,-1000.00,0.00,361.66,638.34,0.02,0
10741,1276,1000.00,1000.00,2000.00,296.90,703.10,0.33,1
10742,1276,1000.00,2000.00,3000.00,0.00,700.23,0.23,1
10743,1276,1000.00,3000.00,4000.00,0.00,1613.81,0.26,1
10744,1276,1000.00,4000.00,5000.00,1484.23,2515.77,0.02,1
10745,1276,1000.00,5000.00,6000.00,948.73,4051.27,0.31,1
10746,1276,1000.00,6000.00,7000.00,0.00,477.68,0.14,1
10747,1276,-1000.00,5000.00,6000.00,1274.66,1274.44,0.08,0
10748,1276,1000.00,6000.00,7000.00,0.00,4987.01,0.01,1
10749,1276,1000.00,7000.00,8000.00,1819.58,5180.42,0.33,1
10750,1276,1000.00,8000.00,9000.00,4000.00,4000.00,0.24,1
10751,1276,1000.00,9000.00,10000.00,2592.62,6407.38,0.43,1
10752,1276,1000.00,10000.00,11000.00,5000.00,5000.00,0.37,1
10753,1276,-1000.00,9000.00,10000.00,8051.86,2948.14,0.12,0
10754,1276,1000.00,10000.00,11000.00,3439.68,5575.23,0.29,1
10755,1276,1000.00,11000.00,12000.00,5500.00,5500.00,0.29,1
10756,1276,-1000.00,10000.00,11000.00,3529.32,7295.78,0.22,0
10757,1276,-1000.00,9000.00,10000.00,0.00,11000.00,0.14,0
10758,1276,1000.00,10000.00,11000.00,6284.77,3715.23,0.10,1
10759,1276,-1000.00,9000.00,10000.00,0.00,5873.31,0.33,0
10760,1276,1000.00,10000.00,11000.00,7375.96,2624.04,0.14,1
10761,1276,-1000.00,9000.00,10000.00,3011.65,7988.35,0.26,0
10762,1276,-1000.00,8000.00,9000.00,401.94,9598.06,0.05,0
10763,1276,-1000.00,7000.00,8000.00,0.00,9000.00,0.19,0
10764,1276,-1000.00,6000.00,7000.00,3926.02,4073.98,0.39,0
10765,1276,-1000.00,5000.00,6000.00,452.62,6547.38,0.10,0
10766,1276,-1000.00,4000.00,5000.00,1477.52,4522.48,0.35,0
10767,1276,-1000.00,3000.00,4000.00,0.00,4196.66,0.43,0
10768,1276,-1000.00,2000.00,3000.00,2000.00,2000.00,0.06,0
10769,1276,-1000.00,1000.00,2000.00,0.00,3000.00,0.32,0
10770,1276,-1000.00,0.00,1000.00,1000.00,1000.00,0.06,0
10771,1276,-664.98,-664.98,335.02,0.00,664.98,0.32,0
10772,1276,-135.20,-800.18,199.82,0.00,135.20,0.19,0
10773,1276,-155.83,-956.01,43.99,0.00,155.83,0.42,0
10774,1276,-0.12,-956.13,43.87,0.00,0.12,0.01,0
10775,1276,-12.55,-968.68,31.32,0.00,12.55,0.15,0
10776,1276,-31.32,-1000.00,0.00,2.44,28.88,0.42,0
10777,1277,-1000.00,-1000.00,0.00,0.00,1000.00,0.40,0
10778,1278,-1000.00,-1000.00,0.00,0.00,1000.00,0.29,0
10779,1279,-1000.00,-1000.00,0.00,0.00,1000.00,0.24,0
10780,1280,-1000.00,-1000.00,0.00,503.49,496.51,0.17,0
10781,1281,-1000.00,-1000.00,0.00,198.85,801.15,0.37,0
10782,1282,-548.12,-548.12,451.88,0.00,548.12,0.33,0
10783,1282,-402.32,-950.43,49.57,27.08,375.24,0.42,0
10784,1282,-49.57,-1000.00,0.00,0.00,49.57,0.18,0
10785,1283,-1000.00,-1000.00,0.00,424.48,575.52,0.15,0
10786,1284,-364.81,-364.81,635.19,364.81,0.00,0.09,0
10787,1284,-1000.00,-1364.81,-364.81,72.10,223.63,0.25,0
10788,1285,-591.93,-591.93,408.07,0.00,591.93,0.31,0
10789,1285,0.00,-591.93,408.07,0.00,0.00,0.09,0
10790,1285,1000.00,408.07,1408.07,169.84,144.49,0.34,1
10791,1285,-1000.00,-591.93,408.07,0.00,1136.89,0.19,0
10792,1285,0.00,-591.93,408.07,0.00,0.00,0.07,0
10793,1285,-408.07,-1000.00,0.00,0.00,408.07,0.07,0
10794,1286,1000.00,1000.00,2000.00,403.82,596.18,0.23,1
10795,1286,1000.00,2000.00,3000.00,0.00,1906.87,0.43,1
10796,1286,1000.00,3000.00,4000.00,530.54,577.98,0.18,1
10797,1286,1000.00,4000.00,5000.00,1153.56,2846.44,0.42,1
10798,1286,1000.00,5000.00,6000.00,1240.89,3759.11,0.43,1
10799,1286,1000.00,6000.00,7000.00,0.00,5801.32,0.39,1
10800,1286,1000.00,7000.00,8000.00,2171.71,4828.29,0.43,1
10801,1286,1000.00,8000.00,9000.00,2835.55,5164.45,0.30,1
10802,1286,-1000.00,7000.00,8000.00,3301.35,377.10,0.11,0
10803,1286,1000.00,8000.00,9000.00,3105.05,4894.95,0.37,1
10804,1286,1000.00,9000.00,10000.00,0.00,9000.00,0.40,1
10805,1286,1000.00,10000.00,11000.00,0.00,10000.00,0.16,1
10806,1286,1000.00,11000.00,12000.00,2904.39,8095.61,0.43,1
10807,1286,1000.00,12000.00,13000.00,0.00,12000.00,0.21,1
10808,1286,1000.00,13000.00,14000.00,0.00,13000.00,0.29,1
10809,1286,1000.00,14000.00,15000.00,5988.09,8011.91,0.08,1
10810,1286,1000.00,15000.00,16000.00,7068.18,7931.82,0.38,1
10811,1286,1000.00,16000.00,17000.00,0.00,11082.57,0.26,1
10812,1286,1000.00,17000.00,18000.00,0.00,12070.34,0.38,1
10813,1286,1000.00,18000.00,19000.00,8893.15,9106.85,0.20,1
10814,1286,-1000.00,17000.00,18000.00,9845.65,9154.35,0.34,0
10815,1286,1000.00,18000.00,19000.00,3666.28,14333.72,0.39,1
10816,1286,1000.00,19000.00,20000.00,0.00,19000.00,0.20,1
10817,1286,-1000.00,18000.00,19000.00,11044.87,8955.13,0.40,0
10818,1286,1000.00,19000.00,20000.00,5217.04,13782.96,0.40,1
10819,1286,1000.00,20000.00,21000.00,0.00,20000.00,0.39,1
10820,1286,1000.00,21000.00,22000.00,4123.78,7111.73,0.22,1
10821,1286,1000.00,22000.00,23000.00,1047.16,20952.84,0.44,1
10822,1286,1000.00,23000.00,24000.00,0.00,16952.88,0.38,1
10823,1286,1000.00,24000.00,25000.00,0.00,6540.26,0.18,1
10824,1286,1000.00,25000.00,26000.00,0.00,25000.00,0.24,1
10825,1286,1000.00,26000.00,27000.00,0.00,26000.00,0.15,1
10826,1286,1000.00,27000.00,28000.00,12655.62,14344.38,0.31,1
10827,1286,1000.00,28000.00,29000.00,0.00,28000.00,0.38,1
10828,1286,1000.00,29000.00,30000.00,0.00,21003.32,0.03,1
10829,1286,1000.00,30000.00,31000.00,0.00,30000.00,0.04,1
10830,1286,1000.00,31000.00,32000.00,7571.69,23428.31,0.05,1
10831,1286,-1000.00,30000.00,31000.00,30937.97,1062.03,0.12,0
10832,1286,1000.00,31000.00,32000.00,0.00,6585.20,0.06,1
10833,1286,1000.00,32000.00,33000.00,9247.29,22752.71,0.27,1
10834,1286,1000.00,33000.00,34000.00,15416.28,17583.72,0.20,1
10835,1286,1000.00,34000.00,35000.00,13502.04,20497.96,0.43,1
10836,1286,1000.00,35000.00,36000.00,0.00,20742.45,0.33,1
10837,1286,-1000.00,34000.00,35000.00,21251.18,14748.82,0.25,0
10838,1287,-1000.00,-1000.00,0.00,421.57,578.43,0.12,0
10839,1288,-622.81,-622.81,377.19,0.00,622.81,0.36,0
10840,1288,-1000.00,-1622.81,-622.81,114.37,0.00,0.02,0
10841,1289,-1000.00,-1000.00,0.00,314.53,685.47,0.33,0
10842,1290,-1000.00,-1000.00,0.00,102.89,897.11,0.42,0
10843,1291,-874.37,-874.37,125.63,423.33,451.04,0.23,0
10844,1291,-125.63,-1000.00,-0.00,10.62,115.01,0.15,0
10845,1292,-308.36,-308.36,691.64,0.00,308.36,0.08,0
10846,1292,-691.64,-1000.00,0.00,0.00,691.64,0.16,0
10847,1293,-1000.00,-1000.00,0.00,861.07,138.93,0.01,0
10848,1294,1000.00,1000.00,2000.00,475.53,524.47,0.09,1
10849,1294,1000.00,2000.00,3000.00,0.00,2000.00,0.29,1
10850,1294,1000.00,3000.00,4000.00,0.00,866.86,0.12,1
10851,1294,1000.00,4000.00,5000.00,0.00,2124.65,0.14,1
10852,1294,1000.00,5000.00,6000.00,2500.00,2500.00,0.06,1
10853,1294,1000.00,6000.00,7000.00,1898.94,4101.06,0.35,1
10854,1294,1000.00,7000.00,8000.00,3338.85,3661.15,0.32,1
10855,1294,1000.00,8000.00,9000.00,1600.62,6399.38,0.39,1
10856,1294,-1000.00,7000.00,8000.00,3551.40,0.00,0.02,0
10857,1294,-1000.00,6000.00,7000.00,4018.43,3981.57,0.12,0
10858,1294,-1000.00,5000.00,6000.00,1556.17,1235.33,0.15,0
10859,1294,-1000.00,4000.00,5000.00,4353.07,1646.93,0.16,0
10860,1294,1000.00,5000.00,6000.00,161.51,3304.53,0.38,1
10861,1294,1000.00,6000.00,7000.00,0.00,6000.00,0.02,1
10862,1294,1000.00,7000.00,8000.00,0.00,7000.00,0.36,1
10863,1294,1000.00,8000.00,9000.00,0.00,8000.00,0.16,1
10864,1294,1000.00,9000.00,10000.00,4200.92,4799.08,0.41,1
10865,1294,1000.00,10000.00,11000.00,2720.65,7279.35,0.41,1
10866,1294,1000.00,11000.00,12000.00,0.00,6261.90,0.11,1
10867,1294,1000.00,12000.00,13000.00,4093.11,5222.86,0.25,1
10868,1294,-1000.00,11000.00,12000.00,13000.00,0.00,0.01,0
10869,1294,1000.00,12000.00,13000.00,6000.00,6000.00,0.08,1
10870,1294,-1000.00,11000.00,12000.00,8125.16,4874.84,0.33,0
10871,1294,1000.00,12000.00,13000.00,4429.26,7570.74,0.29,1
10872,1294,1000.00,13000.00,14000.00,6500.00,6500.00,0.02,1
10873,1294,1000.00,14000.00,15000.00,516.47,13483.53,0.37,1
10874,1294,1000.00,15000.00,16000.00,7500.00,7500.00,0.02,1
10875,1294,1000.00,16000.00,17000.00,6808.07,9191.93,0.25,1
10876,1294,1000.00,17000.00,18000.00,4585.92,6614.41,0.26,1
10877,1294,1000.00,18000.00,19000.00,2291.25,15708.75,0.40,1
10878,1294,1000.00,19000.00,20000.00,0.00,19000.00,0.17,1
10879,1294,1000.00,20000.00,21000.00,0.00,20000.00,0.18,1
10880,1294,1000.00,21000.00,22000.00,3017.88,17982.12,0.36,1
10881,1294,1000.00,22000.00,23000.00,10655.60,11344.40,0.04,1
10882,1294,1000.00,23000.00,24000.00,1568.68,14243.54,0.12,1
10883,1294,1000.00,24000.00,25000.00,10494.64,13505.36,0.06,1
10884,1294,-1000.00,23000.00,24000.00,13271.53,11728.47,0.25,0
10885,1294,1000.00,24000.00,25000.00,2757.23,10683.78,0.29,1
10886,1294,1000.00,25000.00,26000.00,1376.99,21258.44,0.17,1
10887,1294,-1000.00,24000.00,25000.00,15198.22,10801.78,0.16,0
10888,1294,-1000.00,23000.00,24000.00,22970.42,2029.58,0.04,0
10889,1294,1000.00,24000.00,25000.00,0.00,21771.77,0.26,1
10890,1294,-1000.00,23000.00,24000.00,23080.41,0.00,0.01,0
10891,1294,1000.00,24000.00,25000.00,7665.45,16334.55,0.08,1
10892,1294,1000.00,25000.00,26000.00,0.00,7233.51,0.14,1
10893,1294,1000.00,26000.00,27000.00,0.00,26000.00,0.00,1
10894,1295,-1000.00,-1000.00,0.00,72.17,927.83,0.35,0
10895,1296,-1000.00,-1000.00,0.00,127.09,43.42,0.12,0
10896,1297,-1000.00,-1000.00,0.00,474.16,525.84,0.08,0
10897,1298,-1000.00,-1000.00,0.00,0.00,1000.00,0.15,0
10898,1299,-1000.00,-1000.00,0.00,0.00,1000.00,0.24,0
10899,1300,-449.68,-449.68,550.32,444.62,5.05,0.09,0
10900,1300,1000.00,550.32,1550.32,0.00,550.32,0.08,1
10901,1300,1000.00,1550.32,2550.32,252.07,1298.26,0.30,1
10902,1300,-1000.00,550.32,1550.32,2036.57,513.76,0.01,0
10903,1300,1000.00,1550.32,2550.32,0.00,992.49,0.36,1
10904,1300,1000.00,2550.32,3550.32,0.00,2550.32,0.20,1
10905,1300,1000.00,3550.32,4550.32,1573.55,1976.78,0.16,1
10906,1300,1000.00,4550.32,5550.32,468.58,4081.74,0.40,1
10907,1300,1000.00,5550.32,6550.32,2236.76,3313.56,0.43,1
10908,1300,-1000.00,4550.32,5550.32,2999.63,1115.93,0.16,0
10909,1300,1000.00,5550.32,6550.32,0.00,5550.32,0.16,1
10910,1300,1000.00,6550.32,7550.32,3106.79,3443.53,0.38,1
10911,1300,1000.00,7550.32,8550.32,1703.19,5847.14,0.42,1
10912,1300,1000.00,8550.32,9550.32,608.70,7941.62,0.14,1
10913,1300,1000.00,9550.32,10550.32,3379.83,6170.49,0.40,1
10914,1300,-1000.00,8550.32,9550.32,10550.32,0.00,0.03,0
10915,1300,-1000.00,7550.32,8550.32,5667.40,3882.92,0.03,0
10916,1300,0.00,7550.32,8550.32,0.00,0.00,0.04,0
10917,1300,-1000.00,6550.32,7550.32,4807.07,1577.31,0.15,0
10918,1300,1000.00,7550.32,8550.32,0.00,7550.32,0.22,1
10919,1300,1000.00,8550.32,9550.32,1501.10,7049.22,0.26,1
10920,1300,-1000.00,7550.32,8550.32,5123.71,440.81,0.31,0
10921,1300,1000.00,8550.32,9550.32,1512.98,6835.82,0.43,1
10922,1300,1000.00,9550.32,10550.32,3411.74,6138.59,0.33,1
10923,1300,1000.00,10550.32,11550.32,1410.00,4390.45,0.13,1
10924,1300,1000.00,11550.32,12550.32,625.74,10924.58,0.28,1
10925,1300,1000.00,12550.32,13550.32,0.00,11223.94,0.35,1
10926,1300,1000.00,13550.32,14550.32,0.00,13550.32,0.26,1
10927,1300,1000.00,14550.32,15550.32,0.00,14550.32,0.32,1
10928,1300,1000.00,15550.32,16550.32,3229.80,12320.53,0.20,1
10929,1300,1000.00,16550.32,17550.32,0.00,16550.32,0.37,1
10930,1300,1000.00,17550.32,18550.32,0.00,17550.32,0.09,1
10931,1300,1000.00,18550.32,19550.32,0.00,18550.32,0.02,1
10932,1300,1000.00,19550.32,20550.32,0.00,19550.32,0.22,1
10933,1300,1000.00,20550.32,21550.32,7740.92,12809.41,0.44,1
10934,1300,1000.00,21550.32,22550.32,0.00,21215.95,0.30,1
10935,1300,1000.00,22550.32,23550.32,0.00,20568.66,0.37,1
10936,1300,1000.00,23550.32,24550.32,0.00,23550.32,0.22,1
10937,1300,-1000.00,22550.32,23550.32,18261.05,6289.27,0.06,0
10938,1300,1000.00,23550.32,24550.32,0.00,23550.32,0.14,1
10939,1300,-1000.00,22550.32,23550.32,12702.23,11848.09,0.10,0
10940,1301,0.00,0.00,1000.00,0.00,0.00,0.09,0
10941,1301,-1000.00,-1000.00,0.00,0.00,1000.00,0.41,0
10942,1302,1000.00,1000.00,2000.00,0.00,1000.00,0.40,1
10943,1302,1000.00,2000.00,3000.00,151.82,1848.18,0.01,1
10944,1302,-1000.00,1000.00,2000.00,1572.03,1161.92,0.18,0
10945,1302,1000.00,2000.00,3000.00,1000.00,1000.00,0.07,1
10946,1302,1000.00,3000.00,4000.00,959.36,2040.64,0.41,1
10947,1302,1000.00,4000.00,5000.00,0.00,4000.00,0.44,1
10948,1302,1000.00,5000.00,6000.00,0.00,5000.00,0.11,1
10949,1302,-1000.00,4000.00,5000.00,3903.11,2096.89,0.21,0
10950,1302,1000.00,5000.00,6000.00,2129.80,2870.20,0.22,1
10951,1302,1000.00,6000.00,7000.00,0.00,6000.00,0.31,1
10952,1302,1000.00,7000.00,8000.00,2983.85,4016.15,0.43,1
10953,1302,1000.00,8000.00,9000.00,0.00,8000.00,0.24,1
10954,1302,1000.00,9000.00,10000.00,12.37,8987.63,0.17,1
10955,1302,1000.00,10000.00,11000.00,5000.00,5000.00,0.07,1
10956,1302,1000.00,11000.00,12000.00,3582.29,7417.71,0.17,1
10957,1302,1000.00,12000.00,13000.00,0.00,5747.15,0.16,1
10958,1302,1000.00,13000.00,14000.00,0.00,13000.00,0.32,1
10959,1302,1000.00,14000.00,15000.00,5514.09,8485.91,0.24,1
10960,1302,1000.00,15000.00,16000.00,6711.83,8288.17,0.25,1
10961,1302,1000.00,16000.00,17000.00,1706.19,14293.81,0.30,1
10962,1302,-1000.00,15000.00,16000.00,10433.74,2545.87,0.16,0
10963,1302,1000.00,16000.00,17000.00,582.61,15417.39,0.17,1
10964,1302,-1000.00,15000.00,16000.00,8500.00,8500.00,0.16,0
10965,1302,-1000.00,14000.00,15000.00,0.00,16000.00,0.32,0
10966,1302,-1000.00,13000.00,14000.00,10938.78,3087.11,0.12,0
10967,1302,-1000.00,12000.00,13000.00,0.00,7609.70,0.23,0
10968,1302,-1000.00,11000.00,12000.00,0.00,7529.28,0.33,0
10969,1302,-1000.00,10000.00,11000.00,0.00,7711.10,0.35,0
10970,1302,-1000.00,9000.00,10000.00,4519.33,6480.67,0.38,0
10971,1302,-1000.00,8000.00,9000.00,0.00,8773.65,0.38,0
10972,1302,-1000.00,7000.00,8000.00,3820.14,5179.86,0.10,0
10973,1302,-1000.00,6000.00,7000.00,672.55,7321.42,0.37,0
10974,1302,-1000.00,5000.00,6000.00,6963.10,0.00,0.05,0
10975,1302,-1000.00,4000.00,5000.00,1441.46,4558.54,0.43,0
10976,1302,-1000.00,3000.00,4000.00,2101.85,2898.15,0.44,0
10977,1302,-1000.00,2000.00,3000.00,1064.92,771.00,0.16,0
10978,1302,-1000.00,1000.00,2000.00,1292.36,1707.64,0.24,0
10979,1302,-1000.00,0.00,1000.00,0.00,2000.00,0.01,0
10980,1302,-1000.00,-1000.00,0.00,0.00,1000.00,0.12,0
10981,1303,-1000.00,-1000.00,0.00,96.64,0.00,0.07,0
10982,1304,-916.65,-916.65,83.35,478.10,438.55,0.22,0
10983,1304,-1000.00,-1916.65,-916.65,32.77,50.58,0.14,0
10984,1305,-1000.00,-1000.00,0.00,0.00,1000.00,0.25,0
10985,1306,1000.00,1000.00,2000.00,0.00,795.00,0.38,1
10986,1306,1000.00,2000.00,3000.00,0.00,2000.00,0.34,1
10987,1306,0.00,2000.00,3000.00,0.00,0.00,0.06,0
10988,1306,1000.00,3000.00,4000.00,0.00,1981.64,0.34,1
10989,1306,-1000.00,2000.00,3000.00,2868.06,1131.94,0.39,0
10990,1306,1000.00,3000.00,4000.00,1114.82,1885.18,0.19,1
10991,1306,1000.00,4000.00,5000.00,1504.77,2495.23,0.33,1
10992,1306,1000.00,5000.00,6000.00,0.00,5000.00,0.36,1
10993,1306,1000.00,6000.00,7000.00,1623.20,3287.90,0.31,1
10994,1306,1000.00,7000.00,8000.00,2099.67,4900.33,0.32,1
10995,1306,-1000.00,6000.00,7000.00,4062.62,3937.38,0.37,0
10996,1306,-1000.00,5000.00,6000.00,2772.29,2629.90,0.25,0
10997,1306,-1000.00,4000.00,5000.00,3331.06,2668.94,0.27,0
10998,1306,1000.00,5000.00,6000.00,0.00,4477.67,0.40,1
10999,1306,1000.00,6000.00,7000.00,0.00,6000.00,0.17,1
11000,1306,1000.00,7000.00,8000.00,3500.00,3500.00,0.21,1
11001,1306,1000.00,8000.00,9000.00,3177.91,4822.09,0.32,1
11002,1306,1000.00,9000.00,10000.00,3544.53,5455.47,0.13,1
11003,1306,1000.00,10000.00,11000.00,0.00,10000.00,0.23,1
11004,1306,-1000.00,9000.00,10000.00,10752.14,247.86,0.02,0
11005,1306,1000.00,10000.00,11000.00,0.00,4931.27,0.27,1
11006,1306,-1000.00,9000.00,10000.00,6780.20,4219.80,0.29,0
11007,1306,-1000.00,8000.00,9000.00,2360.16,0.00,0.04,0
11008,1306,-1000.00,7000.00,8000.00,3792.79,1619.41,0.29,0
11009,1306,1000.00,8000.00,9000.00,3899.02,4100.98,0.38,1
11010,1306,1000.00,9000.00,10000.00,2484.97,6515.03,0.36,1
11011,1306,-1000.00,8000.00,9000.00,5148.33,4851.67,0.21,0
11012,1306,1000.00,9000.00,10000.00,1663.96,7336.04,0.23,1
11013,1306,1000.00,10000.00,11000.00,0.00,7227.22,0.34,1
11014,1306,1000.00,11000.00,12000.00,0.00,10422.87,0.04,1
11015,1306,1000.00,12000.00,13000.00,0.00,12000.00,0.05,1
11016,1306,1000.00,13000.00,14000.00,0.00,383.48,0.11,1
11017,1306,1000.00,14000.00,15000.00,3412.01,10587.99,0.08,1
11018,1306,1000.00,15000.00,16000.00,6265.82,8734.18,0.22,1
11019,1306,1000.00,16000.00,17000.00,2190.66,13809.34,0.40,1
11020,1306,1000.00,17000.00,18000.00,0.00,17000.00,0.15,1
11021,1306,-1000.00,16000.00,17000.00,11735.91,1623.18,0.08,0
11022,1306,1000.00,17000.00,18000.00,0.00,17000.00,0.36,1
11023,1306,1000.00,18000.00,19000.00,0.00,12902.84,0.19,1
11024,1306,1000.00,19000.00,20000.00,0.00,105.12,0.07,1
11025,1306,1000.00,20000.00,21000.00,7313.37,12686.63,0.28,1
11026,1306,1000.00,21000.00,22000.00,0.00,21000.00,0.33,1
11027,1306,1000.00,22000.00,23000.00,10445.90,11554.10,0.25,1
11028,1306,1000.00,23000.00,24000.00,480.62,18402.00,0.44,1
11029,1306,-1000.00,22000.00,23000.00,14773.66,9226.34,0.20,0
11030,1306,1000.00,23000.00,24000.00,4933.95,8734.77,0.28,1
11031,1306,-1000.00,22000.00,23000.00,13321.38,10678.62,0.19,0
11032,1306,-1000.00,21000.00,22000.00,12845.88,10154.12,0.23,0
11033,1306,-1000.00,20000.00,21000.00,10143.80,11074.59,0.24,0
11034,1306,-1000.00,19000.00,20000.00,0.00,21000.00,0.18,0
11035,1306,-1000.00,18000.00,19000.00,0.00,20000.00,0.25,0
11036,1306,-1000.00,17000.00,18000.00,0.00,8760.87,0.31,0
11037,1306,-1000.00,16000.00,17000.00,2196.28,11132.99,0.40,0
11038,1306,-1000.00,15000.00,16000.00,2283.61,14716.39,0.43,0
11039,1306,-1000.00,14000.00,15000.00,7828.66,8171.34,0.38,0
11040,1306,-1000.00,13000.00,14000.00,0.00,14920.85,0.31,0
11041,1306,-1000.00,12000.00,13000.00,12794.93,0.00,0.03,0
11042,1306,-1000.00,11000.00,12000.00,1522.62,11477.38,0.17,0
11043,1306,-1000.00,10000.00,11000.00,6000.00,6000.00,0.07,0
11044,1306,-1000.00,9000.00,10000.00,1880.11,5811.84,0.33,0
11045,1306,-1000.00,8000.00,9000.00,0.00,10000.00,0.42,0
11046,1306,-1000.00,7000.00,8000.00,0.00,7738.65,0.33,0
11047,1306,-1000.00,6000.00,7000.00,4000.00,4000.00,0.15,0
11048,1306,-1000.00,5000.00,6000.00,3500.00,3500.00,0.06,0
11049,1306,-1000.00,4000.00,5000.00,1577.51,0.00,0.17,0
11050,1306,-1000.00,3000.00,4000.00,0.00,2308.91,0.23,0
11051,1306,-1000.00,2000.00,3000.00,0.00,4000.00,0.06,0
11052,1306,-1000.00,1000.00,2000.00,1870.66,1129.34,0.28,0
11053,1306,-1000.00,0.00,1000.00,581.01,1418.99,0.38,0
11054,1306,-1000.00,-1000.00,0.00,842.15,157.85,0.01,0
11055,1307,-1000.00,-1000.00,0.00,0.00,1000.00,0.30,0
11056,1308,-483.74,-483.74,516.26,131.54,352.20,0.24,0
11057,1308,-475.20,-958.94,41.06,0.00,475.20,0.43,0
11058,1308,783.37,-175.57,824.43,6.32,0.00,0.23,1
11059,1308,1000.00,824.43,1824.43,565.93,258.50,0.02,1
11060,1308,-981.03,-156.60,843.40,0.00,981.03,0.37,0
11061,1308,1000.00,843.40,1843.40,597.66,245.74,0.33,1
11062,1308,1000.00,1843.40,2843.40,1141.44,701.96,0.09,1
11063,1308,-885.74,957.66,1957.66,0.00,885.74,0.26,0
11064,1308,0.00,957.66,1957.66,0.00,0.00,0.28,0
11065,1308,-1000.00,-42.34,957.66,391.13,1566.53,0.35,0
11066,1308,1000.00,957.66,1957.66,691.77,265.89,0.38,1
11067,1308,-1000.00,-42.34,957.66,106.97,1850.69,0.19,0
11068,1308,1000.00,957.66,1957.66,957.66,0.00,0.16,1
11069,1308,-1000.00,-42.34,957.66,0.00,1321.26,0.36,0
11070,1308,-529.28,-571.62,428.38,0.00,529.28,0.22,0
11071,1308,-428.38,-1000.00,0.00,200.04,228.34,0.07,0
11072,1309,-1000.00,-1000.00,0.00,0.00,1000.00,0.22,0
11073,1310,-914.02,-914.02,85.98,468.35,445.67,0.23,0
11074,1310,-1000.00,-1914.02,-914.02,0.00,85.98,0.18,0
11075,1311,1000.00,1000.00,2000.00,0.00,1000.00,0.19,1
11076,1311,1000.00,2000.00,3000.00,0.00,1340.95,0.28,1
11077,1311,1000.00,3000.00,4000.00,0.00,2475.05,0.28,1
11078,1311,1000.00,4000.00,5000.00,110.30,3889.70,0.26,1
11079,1311,1000.00,5000.00,6000.00,382.44,4617.56,0.37,1
11080,1311,1000.00,6000.00,7000.00,0.00,4388.61,0.10,1
11081,1311,-1000.00,5000.00,6000.00,4594.94,1111.80,0.15,0
11082,1311,1000.00,6000.00,7000.00,0.00,6000.00,0.35,1
11083,1311,-1000.00,5000.00,6000.00,4571.80,2428.20,0.15,0
11084,1311,1000.00,6000.00,7000.00,0.00,6000.00,0.08,1
11085,1311,1000.00,7000.00,8000.00,2426.87,4573.13,0.40,1
11086,1311,1000.00,8000.00,9000.00,0.00,7845.95,0.41,1
11087,1311,0.00,8000.00,9000.00,0.00,0.00,0.06,0
11088,1311,-1000.00,7000.00,8000.00,5038.23,3961.77,0.19,0
11089,1311,1000.00,8000.00,9000.00,0.00,5431.45,0.00,1
11090,1311,-1000.00,7000.00,8000.00,9000.00,0.00,0.01,0
11091,1311,1000.00,8000.00,9000.00,179.59,7820.41,0.18,1
11092,1311,1000.00,9000.00,10000.00,3889.48,5110.52,0.30,1
11093,1311,-1000.00,8000.00,9000.00,2597.20,7402.80,0.11,0
11094,1311,-1000.00,7000.00,8000.00,3868.04,5131.96,0.14,0
11095,1311,-1000.00,6000.00,7000.00,0.00,8000.00,0.07,0
11096,1311,-1000.00,5000.00,6000.00,3611.55,3388.45,0.11,0
11097,1311,-1000.00,4000.00,5000.00,2609.48,3390.52,0.39,0
11098,1311,-1000.00,3000.00,4000.00,0.00,4281.27,0.04,0
11099,1311,-1000.00,2000.00,3000.00,0.00,4000.00,0.23,0
11100,1311,-1000.00,1000.00,2000.00,32.63,1271.38,0.26,0
11101,1311,-1000.00,0.00,1000.00,0.00,1735.32,0.36,0
11102,1311,-1000.00,-1000.00,0.00,0.00,1000.00,0.36,0
11103,1312,-1000.00,-1000.00,0.00,178.21,821.79,0.05,0
11104,1313,-1000.00,-1000.00,0.00,21.44,978.56,0.14,0
11105,1314,1000.00,1000.00,2000.00,0.00,1000.00,0.23,1
11106,1314,1000.00,2000.00,3000.00,37.97,1962.03,0.40,1
11107,1314,1000.00,3000.00,4000.00,0.00,443.55,0.14,1
11108,1314,1000.00,4000.00,5000.00,1105.68,2894.32,0.41,1
11109,1314,-1000.00,3000.00,4000.00,3522.50,1477.50,0.23,0
11110,1314,1000.00,4000.00,5000.00,1228.56,2771.44,0.15,1
11111,1314,1000.00,5000.00,6000.00,2006.72,2993.28,0.36,1
11112,1314,1000.00,6000.00,7000.00,2369.81,3630.19,0.35,1
11113,1314,1000.00,7000.00,8000.00,0.00,7000.00,0.09,1
11114,1314,-1000.00,6000.00,7000.00,5734.14,2265.86,0.06,0
11115,1314,-1000.00,5000.00,6000.00,4082.07,2917.93,0.32,0
11116,1314,1000.00,6000.00,7000.00,0.00,6000.00,0.01,1
11117,1314,1000.00,7000.00,8000.00,3500.00,3500.00,0.25,1
11118,1314,1000.00,8000.00,9000.00,0.00,8000.00,0.38,1
11119,1314,1000.00,9000.00,10000.00,3724.14,5275.86,0.15,1
11120,1314,1000.00,10000.00,11000.00,0.00,8180.19,0.25,1
11121,1314,1000.00,11000.00,12000.00,0.00,7510.80,0.20,1
11122,1314,1000.00,12000.00,13000.00,374.12,8876.82,0.44,1
11123,1314,1000.00,13000.00,14000.00,4373.79,8626.21,0.25,1
11124,1314,-1000.00,12000.00,13000.00,8865.64,5134.36,0.06,0
11125,1314,-1000.00,11000.00,12000.00,6500.00,6500.00,0.41,0
11126,1314,-1000.00,10000.00,11000.00,769.53,11230.47,0.44,0
11127,1314,-1000.00,9000.00,10000.00,5395.62,5604.38,0.12,0
11128,1314,-928.18,8071.82,9071.82,0.00,928.18,0.07,0
11129,1314,-1000.00,7071.82,8071.82,1743.67,7328.16,0.41,0
11130,1314,-1000.00,6071.82,7071.82,0.00,7098.02,0.35,0
11131,1314,0.00,6071.82,7071.82,0.00,0.00,0.06,0
11132,1314,-1000.00,5071.82,6071.82,3048.70,4023.12,0.10,0
11133,1314,-1000.00,4071.82,5071.82,3035.91,3035.91,0.08,0
11134,1314,-1000.00,3071.82,4071.82,1453.00,3618.83,0.33,0
11135,1314,-1000.00,2071.82,3071.82,4071.82,0.00,0.11,0
11136,1314,-1000.00,1071.82,2071.82,913.48,683.55,0.18,0
11137,1314,-1000.00,71.82,1071.82,458.70,1613.13,0.40,0
11138,1314,-1000.00,-928.18,71.82,472.99,598.83,0.08,0
11139,1314,-71.82,-1000.00,0.00,23.31,48.52,0.41,0
11140,1315,-1000.00,-1000.00,0.00,0.00,1000.00,0.19,0
11141,1316,-1000.00,-1000.00,0.00,500.00,500.00,0.01,0
11142,1317,-1000.00,-1000.00,0.00,0.00,1000.00,0.26,0
11143,1318,-1000.00,-1000.00,0.00,0.00,499.15,0.38,0
11144,1319,-1000.00,-1000.00,0.00,0.00,1000.00,0.27,0
11145,1320,-874.76,-874.76,125.24,173.68,701.08,0.38,0
11146,1320,-17.69,-892.46,107.54,0.00,17.69,0.12,0
11147,1320,-107.54,-1000.00,-0.00,35.72,71.82,0.08,0
11148,1321,-1000.00,-1000.00,0.00,0.00,1000.00,0.19,0
11149,1322,-1000.00,-1000.00,0.00,0.00,1000.00,0.18,0
11150,1323,1000.00,1000.00,2000.00,100.31,899.69,0.19,1
11151,1323,1000.00,2000.00,3000.00,151.10,1848.90,0.41,1
11152,1323,1000.00,3000.00,4000.00,0.00,1756.72,0.21,1
11153,1323,1000.00,4000.00,5000.00,538.56,3461.44,0.36,1
11154,1323,1000.00,5000.00,6000.00,1236.74,1827.12,0.24,1
11155,1323,1000.00,6000.00,7000.00,2825.38,3174.62,0.04,1
11156,1323,-1000.00,5000.00,6000.00,3916.73,596.18,0.14,0
11157,1323,1000.00,6000.00,7000.00,1480.77,4519.23,0.36,1
11158,1323,1000.00,7000.00,8000.00,928.50,6071.50,0.25,1
11159,1323,-1000.00,6000.00,7000.00,4070.60,3929.40,0.23,0
11160,1323,-1000.00,5000.00,6000.00,2780.76,1958.68,0.18,0
11161,1323,1000.00,6000.00,7000.00,2837.26,3162.74,0.43,1
11162,1323,1000.00,7000.00,8000.00,3500.00,3500.00,0.21,1
11163,1323,1000.00,8000.00,9000.00,2432.59,5567.41,0.24,1
11164,1323,1000.00,9000.00,10000.00,0.00,9000.00,0.24,1
11165,1323,-1000.00,8000.00,9000.00,6218.18,3074.99,0.17,0
11166,1323,1000.00,9000.00,10000.00,2846.09,6153.91,0.34,1
11167,1323,-1000.00,8000.00,9000.00,4971.42,3754.63,0.19,0
11168,1323,1000.00,9000.00,10000.00,0.00,8412.64,0.37,1
11169,1323,1000.00,10000.00,11000.00,0.00,8306.31,0.39,1
11170,1323,1000.00,11000.00,12000.00,5308.98,5691.02,0.37,1
11171,1323,-1000.00,10000.00,11000.00,6111.08,5888.92,0.05,0
11172,1323,1000.00,11000.00,12000.00,0.00,11000.00,0.29,1
11173,1323,1000.00,12000.00,13000.00,0.00,12000.00,0.01,1
11174,1323,-1000.00,11000.00,12000.00,13000.00,0.00,0.01,0
11175,1323,-1000.00,10000.00,11000.00,0.00,12000.00,0.43,0
11176,1323,-1000.00,9000.00,10000.00,0.00,11000.00,0.02,0
11177,1323,-1000.00,8000.00,9000.00,2342.02,4355.44,0.27,0
11178,1323,-1000.00,7000.00,8000.00,0.00,4367.13,0.04,0
11179,1323,-1000.00,6000.00,7000.00,5202.17,2797.83,0.17,0
11180,1323,-1000.00,5000.00,6000.00,0.00,7000.00,0.07,0
11181,1323,-1000.00,4000.00,5000.00,342.17,825.94,0.18,0
11182,1323,-1000.00,3000.00,4000.00,0.00,2743.03,0.23,0
11183,1323,-1000.00,2000.00,3000.00,0.00,3589.62,0.43,0
11184,1323,-1000.00,1000.00,2000.00,0.00,3000.00,0.34,0
11185,1323,-1000.00,0.00,1000.00,1000.00,1000.00,0.07,0
11186,1323,-1000.00,-1000.00,0.00,0.00,1000.00,0.36,0
11187,1324,-1000.00,-1000.00,0.00,0.00,1000.00,0.24,0
11188,1325,-1000.00,-1000.00,0.00,0.00,1000.00,0.20,0
11189,1326,-416.77,-416.77,583.23,0.00,416.77,0.27,0
11190,1326,0.00,-416.77,583.23,0.00,0.00,0.03,0
11191,1326,-583.23,-1000.00,0.00,132.35,450.88,0.09,0
11192,1327,-1000.00,-1000.00,0.00,188.48,811.52,0.34,0
11193,1328,-829.20,-829.20,170.80,829.20,0.00,0.03,0
11194,1328,1000.00,170.80,1170.80,0.00,170.80,0.08,1
11195,1328,1000.00,1170.80,2170.80,585.40,585.40,0.18,1
11196,1328,1000.00,2170.80,3170.80,0.00,2170.80,0.19,1
11197,1328,1000.00,3170.80,4170.80,953.68,2217.11,0.26,1
11198,1328,1000.00,4170.80,5170.80,0.00,210.43,0.09,1
11199,1328,-1000.00,3170.80,4170.80,3392.56,1778.24,0.30,0
11200,1328,1000.00,4170.80,5170.80,1143.81,3026.99,0.22,1
11201,1328,1000.00,5170.80,6170.80,306.19,436.81,0.14,1
11202,1328,1000.00,6170.80,7170.80,0.00,3195.35,0.01,1
11203,1328,-1000.00,5170.80,6170.80,3913.12,3257.68,0.37,0
11204,1328,-344.18,4826.62,5826.62,344.18,0.00,0.03,0
11205,1328,1000.00,5826.62,6826.62,1291.34,4535.28,0.40,1
11206,1328,1000.00,6826.62,7826.62,0.00,1288.95,0.18,1
11207,1328,-1000.00,5826.62,6826.62,6921.94,904.68,0.09,0
11208,1328,1000.00,6826.62,7826.62,399.20,6427.42,0.19,1
11209,1328,1000.00,7826.62,8826.62,0.00,2678.78,0.21,1
11210,1328,-1000.00,6826.62,7826.62,8826.62,0.00,0.08,0
11211,1328,-1000.00,5826.62,6826.62,1561.97,6264.65,0.38,0
11212,1328,-1000.00,4826.62,5826.62,0.00,6826.62,0.44,0
11213,1328,-1000.00,3826.62,4826.62,1083.04,4743.58,0.33,0
11214,1328,-1000.00,2826.62,3826.62,293.08,2828.68,0.11,0
11215,1328,-1000.00,1826.62,2826.62,0.00,3826.62,0.33,0
11216,1328,-1000.00,826.62,1826.62,0.00,2826.62,0.44,0
11217,1328,-1000.00,-173.38,826.62,0.00,1826.62,0.05,0
11218,1328,-826.62,-1000.00,0.00,413.31,413.31,0.01,0
11219,1329,-1000.00,-1000.00,0.00,708.75,291.25,0.03,0
11220,1329,-0.00,-1000.00,0.00,0.00,0.00,0.02,0
11221,1330,-1000.00,-1000.00,0.00,0.00,369.04,0.25,0
11222,1331,-1000.00,-1000.00,0.00,454.64,545.36,0.15,0
11223,1332,-733.16,-733.16,266.84,364.86,368.29,0.22,0
11224,1332,-219.84,-952.99,47.01,4.11,215.73,0.42,0
11225,1332,-47.01,-1000.00,0.00,0.00,47.01,0.16,0
11226,1333,-1000.00,-1000.00,0.00,86.51,913.49,0.41,0
11227,1334,-792.23,-792.23,207.77,0.00,792.23,0.17,0
11228,1334,-207.77,-1000.00,0.00,0.00,207.77,0.04,0
11229,1335,-1000.00,-1000.00,0.00,0.00,1000.00,0.08,0
11230,1336,-431.99,-431.99,568.01,0.00,431.99,0.06,0
11231,1336,-568.01,-1000.00,0.00,0.00,568.01,0.14,0
11232,1337,-1000.00,-1000.00,0.00,0.00,1000.00,0.22,0
11233,1338,1000.00,1000.00,2000.00,0.00,1000.00,0.31,1
11234,1338,1000.00,2000.00,3000.00,0.00,2000.00,0.13,1
11235,1338,1000.00,3000.00,4000.00,1500.00,1500.00,0.03,1
11236,1338,1000.00,4000.00,5000.00,1974.29,2025.71,0.32,1
11237,1338,1000.00,5000.00,6000.00,0.00,5000.00,0.15,1
11238,1338,1000.00,6000.00,7000.00,0.00,6000.00,0.20,1
11239,1338,1000.00,7000.00,8000.00,0.00,81.22,0.02,1
11240,1338,1000.00,8000.00,9000.00,2687.44,5312.56,0.17,1
11241,1338,1000.00,9000.00,10000.00,0.00,3896.97,0.22,1
11242,1338,1000.00,10000.00,11000.00,0.00,9108.73,0.34,1
11243,1338,1000.00,11000.00,12000.00,0.00,11000.00,0.07,1
11244,1338,1000.00,12000.00,13000.00,0.00,12000.00,0.15,1
11245,1338,1000.00,13000.00,14000.00,2318.68,10681.32,0.40,1
11246,1338,1000.00,14000.00,15000.00,0.00,14000.00,0.07,1
11247,1338,1000.00,15000.00,16000.00,0.00,15000.00,0.42,1
11248,1338,1000.00,16000.00,17000.00,0.00,16000.00,0.14,1
11249,1338,-1000.00,15000.00,16000.00,17000.00,0.00,0.01,0
11250,1338,1000.00,16000.00,17000.00,0.00,15310.35,0.32,1
11251,1338,-1000.00,15000.00,16000.00,10354.53,6645.47,0.09,0
11252,1338,1000.00,16000.00,17000.00,1324.96,9757.63,0.38,1
11253,1338,-1000.00,15000.00,16000.00,9048.19,7951.81,0.38,0
11254,1338,1000.00,16000.00,17000.00,3144.10,6578.22,0.30,1
11255,1338,-1000.00,15000.00,16000.00,9564.58,7435.42,0.22,0
11256,1338,1000.00,16000.00,17000.00,7236.96,8763.04,0.25,1
11257,1338,1000.00,17000.00,18000.00,8500.00,8500.00,0.10,1
11258,1338,1000.00,18000.00,19000.00,7470.27,10529.73,0.26,1
11259,1338,1000.00,19000.00,20000.00,207.15,18792.85,0.33,1
11260,1338,1000.00,20000.00,21000.00,0.00,20000.00,0.38,1
11261,1338,1000.00,21000.00,22000.00,2910.46,18089.54,0.22,1
11262,1338,-1000.00,20000.00,21000.00,6261.01,0.00,0.02,0
11263,1338,1000.00,21000.00,22000.00,0.00,3997.85,0.05,1
11264,1338,1000.00,22000.00,23000.00,0.00,9448.76,0.17,1
11265,1338,1000.00,23000.00,24000.00,11500.00,11500.00,0.24,1
11266,1338,1000.00,24000.00,25000.00,0.00,21832.92,0.43,1
11267,1338,-1000.00,23000.00,24000.00,25000.00,0.00,0.09,0
11268,1338,-1000.00,22000.00,23000.00,14611.40,4761.85,0.11,0
11269,1338,-1000.00,21000.00,22000.00,12210.08,10789.92,0.19,0
11270,1338,1000.00,22000.00,23000.00,9726.95,12273.05,0.26,1
11271,1338,-1000.00,21000.00,22000.00,14552.23,8447.77,0.16,0
11272,1338,-1000.00,20000.00,21000.00,11145.74,10854.26,0.34,0
11273,1338,-1000.00,19000.00,20000.00,13931.95,7068.05,0.13,0
11274,1338,1000.00,20000.00,21000.00,0.00,20000.00,0.18,1
11275,1338,1000.00,21000.00,22000.00,9984.24,11015.76,0.23,1
11276,1338,1000.00,22000.00,23000.00,7149.21,14850.79,0.27,1
11277,1338,1000.00,23000.00,24000.00,0.00,23000.00,0.09,1
11278,1338,-1000.00,22000.00,23000.00,16362.10,7637.90,0.35,0
11279,1338,1000.00,23000.00,24000.00,0.00,23000.00,0.06,1
11280,1338,1000.00,24000.00,25000.00,7791.43,16208.57,0.03,1
11281,1339,-1000.00,-1000.00,0.00,338.69,661.31,0.33,0
11282,1340,-1000.00,-1000.00,0.00,0.00,1000.00,0.10,0
11283,1341,1000.00,1000.00,2000.00,0.00,1000.00,0.31,1
11284,1341,1000.00,2000.00,3000.00,890.07,1109.93,0.18,1
11285,1341,1000.00,3000.00,4000.00,674.76,2325.24,0.07,1
11286,1341,-1000.00,2000.00,3000.00,3160.29,839.71,0.08,0
11287,1341,1000.00,3000.00,4000.00,621.03,2378.97,0.43,1
11288,1341,1000.00,4000.00,5000.00,894.80,3105.20,0.44,1
11289,1341,1000.00,5000.00,6000.00,0.00,4931.30,0.13,1
11290,1341,-482.41,4517.59,5517.59,464.80,17.61,0.11,0
11291,1341,1000.00,5517.59,6517.59,1894.45,3623.14,0.25,1
11292,1341,1000.00,6517.59,7517.59,1416.98,4376.10,0.36,1
11293,1341,-646.24,5871.35,6871.35,646.24,0.00,0.05,0
11294,1341,-298.60,5572.75,6572.75,157.81,140.79,0.09,0
11295,1341,-1000.00,4572.75,5572.75,4136.71,2436.03,0.03,0
11296,1341,-1000.00,3572.75,4572.75,4510.10,0.00,0.02,0
11297,1341,1000.00,4572.75,5572.75,691.33,3881.42,0.09,1
11298,1341,-1000.00,3572.75,4572.75,4146.53,1426.22,0.09,0
11299,1341,1000.00,4572.75,5572.75,0.00,4572.75,0.33,1
11300,1341,1000.00,5572.75,6572.75,1166.15,4406.60,0.25,1
11301,1341,1000.00,6572.75,7572.75,2203.40,4369.35,0.16,1
11302,1341,1000.00,7572.75,8572.75,0.00,7572.75,0.09,1
11303,1341,-1000.00,6572.75,7572.75,4506.08,4066.67,0.27,0
11304,1341,-773.88,5798.87,6798.87,773.88,0.00,0.09,0
11305,1341,1000.00,6798.87,7798.87,0.00,2546.15,0.11,1
11306,1341,1000.00,7798.87,8798.87,3380.76,4418.10,0.37,1
11307,1341,-1000.00,6798.87,7798.87,0.00,8798.87,0.42,0
11308,1341,-1000.00,5798.87,6798.87,1473.72,449.86,0.42,0
11309,1341,-1000.00,4798.87,5798.87,3765.51,0.00,0.34,0
11310,1341,-728.53,4070.34,5070.34,728.53,0.00,0.36,0
11311,1341,-553.70,3516.63,4516.63,553.70,0.00,0.13,0
11312,1341,0.00,3516.63,4516.63,0.00,0.00,0.17,0
11313,1341,-1000.00,2516.63,3516.63,1109.39,0.00,0.41,0
11314,1341,-1000.00,1516.63,2516.63,3516.63,0.00,0.01,0
11315,1341,-1000.00,516.63,1516.63,943.80,1572.84,0.38,0
11316,1341,-1000.00,-483.37,516.63,0.00,1516.63,0.06,0
11317,1342,-1000.00,-1000.00,0.00,492.65,507.35,0.11,0
11318,1343,1000.00,1000.00,2000.00,0.00,1000.00,0.34,1
11319,1343,1000.00,2000.00,3000.00,0.00,1641.52,0.34,1
11320,1343,1000.00,3000.00,4000.00,1478.13,1521.87,0.25,1
11321,1343,1000.00,4000.00,5000.00,2000.00,2000.00,0.24,1
11322,1343,-1000.00,3000.00,4000.00,4219.88,780.12,0.01,0
11323,1343,1000.00,4000.00,5000.00,0.00,2263.06,0.21,1
11324,1343,1000.00,5000.00,6000.00,2500.00,2500.00,0.27,1
11325,1343,1000.00,6000.00,7000.00,1960.85,2796.65,0.30,1
11326,1343,1000.00,7000.00,8000.00,1883.84,5116.16,0.33,1
11327,1343,1000.00,8000.00,9000.00,2012.07,5987.93,0.20,1
11328,1343,1000.00,9000.00,10000.00,0.00,2668.55,0.16,1
11329,1343,1000.00,10000.00,11000.00,0.00,496.10,0.09,1
11330,1343,1000.00,11000.00,12000.00,5500.00,5500.00,0.31,1
11331,1343,-1000.00,10000.00,11000.00,5158.32,0.00,0.06,0
11332,1343,1000.00,11000.00,12000.00,4681.54,6318.46,0.16,1
11333,1343,1000.00,12000.00,13000.00,1884.69,6858.83,0.30,1
11334,1343,1000.00,13000.00,14000.00,6451.56,6548.44,0.24,1
11335,1343,1000.00,14000.00,15000.00,0.00,10190.52,0.39,1
11336,1343,1000.00,15000.00,16000.00,6356.63,8643.37,0.20,1
11337,1343,1000.00,16000.00,17000.00,0.00,7273.92,0.13,1
11338,1343,-1000.00,15000.00,16000.00,6566.66,5334.04,0.19,0
11339,1343,1000.00,16000.00,17000.00,8000.00,8000.00,0.14,1
11340,1343,1000.00,17000.00,18000.00,8000.31,8999.69,0.08,1
11341,1343,1000.00,18000.00,19000.00,2437.74,15562.26,0.43,1
11342,1343,-1000.00,17000.00,18000.00,14027.50,4972.50,0.14,0
11343,1343,1000.00,18000.00,19000.00,9000.00,9000.00,0.11,1
11344,1343,1000.00,19000.00,20000.00,0.00,19000.00,0.26,1
11345,1343,-1000.00,18000.00,19000.00,8091.63,3432.30,0.17,0
11346,1343,-1000.00,17000.00,18000.00,5448.81,0.00,0.01,0
11347,1343,-1000.00,16000.00,17000.00,9931.09,8068.91,0.19,0
11348,1343,-1000.00,15000.00,16000.00,2212.09,298.03,0.11,0
11349,1343,1000.00,16000.00,17000.00,7543.11,8456.89,0.17,1
11350,1343,1000.00,17000.00,18000.00,0.00,10290.77,0.23,1
11351,1343,1000.00,18000.00,19000.00,3355.35,14644.65,0.20,1
11352,1343,-1000.00,17000.00,18000.00,3163.24,1038.67,0.12,0
11353,1343,1000.00,18000.00,19000.00,5432.10,12567.90,0.14,1
11354,1343,1000.00,19000.00,20000.00,0.00,19000.00,0.08,1
11355,1343,-1000.00,18000.00,19000.00,10500.76,9499.24,0.01,0
11356,1343,1000.00,19000.00,20000.00,0.00,10760.36,0.25,1
11357,1343,1000.00,20000.00,21000.00,4411.29,15588.71,0.27,1
11358,1343,-1000.00,19000.00,20000.00,8342.93,0.00,0.04,0
11359,1344,-1000.00,-1000.00,0.00,0.00,1000.00,0.12,0
11360,1345,-120.76,-120.76,879.24,0.00,120.76,0.15,0
11361,1345,-879.24,-1000.00,0.00,0.00,879.24,0.39,0
11362,1346,-1000.00,-1000.00,0.00,0.00,1000.00,0.39,0
11363,1347,-1000.00,-1000.00,0.00,0.00,1000.00,0.16,0
11364,1348,-1000.00,-1000.00,0.00,294.28,705.72,0.28,0
11365,1349,-1000.00,-1000.00,0.00,458.83,541.17,0.16,0
11366,1350,-1000.00,-1000.00,0.00,309.80,690.20,0.33,0
11367,1351,-1000.00,-1000.00,0.00,1000.00,0.00,0.00,0
11368,1352,-1000.00,-1000.00,0.00,0.00,1000.00,0.39,0
11369,1353,-1000.00,-1000.00,0.00,0.00,1000.00,0.05,0
11370,1354,-1000.00,-1000.00,0.00,162.32,837.68,0.14,0
11371,1355,-384.96,-384.96,615.04,0.00,384.96,0.08,0
11372,1355,-615.04,-1000.00,0.00,206.16,408.88,0.30,0
11373,1356,1000.00,1000.00,2000.00,0.00,1000.00,0.08,1
11374,1356,1000.00,2000.00,3000.00,0.00,1256.72,0.25,1
11375,1356,-1000.00,1000.00,2000.00,1682.00,1318.00,0.38,0
11376,1356,1000.00,2000.00,3000.00,0.00,1846.42,0.40,1
11377,1356,1000.00,3000.00,4000.00,0.00,539.84,0.14,1
11378,1356,-1000.00,2000.00,3000.00,2043.03,1956.97,0.13,0
11379,1356,1000.00,3000.00,4000.00,0.00,3000.00,0.16,1
11380,1356,1000.00,4000.00,5000.00,197.35,2771.36,0.30,1
11381,1356,1000.00,5000.00,6000.00,0.00,3224.76,0.38,1
11382,1356,0.00,5000.00,6000.00,0.00,0.00,0.19,0
11383,1356,1000.00,6000.00,7000.00,0.00,2454.76,0.30,1
11384,1356,1000.00,7000.00,8000.00,1807.31,2835.35,0.37,1
11385,1356,0.00,7000.00,8000.00,0.00,0.00,0.08,0
11386,1356,-1000.00,6000.00,7000.00,4403.18,3596.82,0.07,0
11387,1356,-1000.00,5000.00,6000.00,7000.00,0.00,0.03,0
11388,1356,1000.00,6000.00,7000.00,0.00,6000.00,0.12,1
11389,1356,-1000.00,5000.00,6000.00,3681.42,2658.02,0.37,0
11390,1356,1000.00,6000.00,7000.00,0.00,6000.00,0.23,1
11391,1356,-1000.00,5000.00,6000.00,3709.90,3290.10,0.27,0
11392,1356,-1000.00,4000.00,5000.00,0.00,1317.77,0.21,0
11393,1356,-1000.00,3000.00,4000.00,3526.65,0.00,0.11,0
11394,1356,-1000.00,2000.00,3000.00,1392.85,2607.15,0.30,0
11395,1356,-1000.00,1000.00,2000.00,1236.46,1763.54,0.09,0
11396,1356,-1000.00,0.00,1000.00,1038.57,961.43,0.14,0
11397,1356,-1000.00,-1000.00,0.00,0.00,851.34,0.17,0
11398,1357,1000.00,1000.00,2000.00,226.57,773.43,0.40,1
11399,1357,1000.00,2000.00,3000.00,671.88,1328.12,0.12,1
11400,1357,1000.00,3000.00,4000.00,557.13,2442.87,0.34,1
11401,1357,1000.00,4000.00,5000.00,0.00,4000.00,0.14,1
11402,1357,1000.00,5000.00,6000.00,0.00,2657.32,0.32,1
11403,1357,-1000.00,4000.00,5000.00,3117.68,2516.42,0.22,0
11404,1357,1000.00,5000.00,6000.00,1194.54,3805.46,0.30,1
11405,1357,1000.00,6000.00,7000.00,1849.48,4150.52,0.02,1
11406,1357,1000.00,7000.00,8000.00,2367.97,4632.03,0.34,1
11407,1357,1000.00,8000.00,9000.00,1851.09,6148.91,0.37,1
11408,1357,1000.00,9000.00,10000.00,1705.65,7294.35,0.15,1
11409,1357,1000.00,10000.00,11000.00,5000.00,5000.00,0.07,1
11410,1357,1000.00,11000.00,12000.00,0.00,11000.00,0.09,1
11411,1357,1000.00,12000.00,13000.00,0.00,9759.95,0.42,1
11412,1357,1000.00,13000.00,14000.00,4815.51,8184.49,0.17,1
11413,1357,-1000.00,12000.00,13000.00,9440.23,0.00,0.08,0
11414,1357,1000.00,13000.00,14000.00,6500.00,6500.00,0.16,1
11415,1357,1000.00,14000.00,15000.00,0.00,5126.77,0.09,1
11416,1357,1000.00,15000.00,16000.00,0.00,15000.00,0.44,1
11417,1357,1000.00,16000.00,17000.00,5280.27,10719.73,0.29,1
11418,1357,-1000.00,15000.00,16000.00,17000.00,0.00,0.00,0
11419,1357,1000.00,16000.00,17000.00,0.00,4713.81,0.22,1
11420,1357,-1000.00,15000.00,16000.00,11012.11,4676.21,0.12,0
11421,1357,1000.00,16000.00,17000.00,3553.83,12446.17,0.10,1
11422,1357,-1000.00,15000.00,16000.00,12709.21,0.00,0.04,0
11423,1357,-1000.00,14000.00,15000.00,6125.63,9874.37,0.18,0
11424,1357,-1000.00,13000.00,14000.00,4153.99,10846.01,0.35,0
11425,1357,-1000.00,12000.00,13000.00,6062.09,7937.91,0.19,0
11426,1357,-1000.00,11000.00,12000.00,6500.00,6500.00,0.38,0
11427,1357,-1000.00,10000.00,11000.00,4414.40,7585.60,0.23,0
11428,1357,-1000.00,9000.00,10000.00,0.00,11000.00,0.43,0
11429,1357,-1000.00,8000.00,9000.00,4948.85,5051.15,0.39,0
11430,1357,-1000.00,7000.00,8000.00,0.00,9000.00,0.44,0
11431,1357,-1000.00,6000.00,7000.00,4000.00,4000.00,0.11,0
11432,1357,-1000.00,5000.00,6000.00,2490.75,4509.25,0.20,0
11433,1357,-1000.00,4000.00,5000.00,0.00,6000.00,0.33,0
11434,1357,-1000.00,3000.00,4000.00,3340.79,1659.21,0.09,0
11435,1357,-1000.00,2000.00,3000.00,1446.45,2553.55,0.23,0
11436,1357,-1000.00,1000.00,2000.00,744.19,2255.81,0.38,0
11437,1357,-1000.00,0.00,1000.00,387.35,1535.44,0.40,0
11438,1357,-364.63,-364.63,635.37,0.00,364.63,0.17,0
11439,1357,-336.68,-701.31,298.69,0.00,336.68,0.27,0
11440,1357,-240.60,-941.91,58.09,0.00,240.60,0.06,0
11441,1357,-58.09,-1000.00,0.00,20.57,37.51,0.30,0
11442,1358,1000.00,1000.00,2000.00,250.03,477.98,0.28,1
11443,1358,1000.00,2000.00,3000.00,679.16,1320.84,0.33,1
11444,1358,1000.00,3000.00,4000.00,1458.80,1541.20,0.35,1
11445,1358,1000.00,4000.00,5000.00,1681.50,2318.50,0.34,1
11446,1358,1000.00,5000.00,6000.00,1682.41,3317.59,0.07,1
11447,1358,1000.00,6000.00,7000.00,1641.98,4358.02,0.35,1
11448,1358,1000.00,7000.00,8000.00,3417.26,3582.74,0.22,1
11449,1358,-1000.00,6000.00,7000.00,3840.90,448.60,0.13,0
11450,1358,-1000.00,5000.00,6000.00,3605.39,3394.61,0.36,0
11451,1358,1000.00,6000.00,7000.00,0.00,444.35,0.09,1
11452,1358,1000.00,7000.00,8000.00,2878.17,4121.83,0.22,1
11453,1358,1000.00,8000.00,9000.00,3432.43,4567.57,0.33,1
11454,1358,1000.00,9000.00,10000.00,0.00,9000.00,0.35,1
11455,1358,1000.00,10000.00,11000.00,0.00,10000.00,0.13,1
11456,1358,1000.00,11000.00,12000.00,4120.42,6879.58,0.21,1
11457,1358,-1000.00,10000.00,11000.00,6892.85,5107.15,0.07,0
11458,1358,-1000.00,9000.00,10000.00,5959.88,5040.12,0.05,0
11459,1358,1000.00,10000.00,11000.00,4196.71,5803.29,0.34,1
11460,1358,1000.00,11000.00,12000.00,5006.10,5993.90,0.40,1
11461,1358,1000.00,12000.00,13000.00,1900.10,10099.90,0.35,1
11462,1358,-1000.00,11000.00,12000.00,6500.32,4918.60,0.18,0
11463,1358,-1000.00,10000.00,11000.00,6494.70,1400.71,0.12,0
11464,1358,1000.00,11000.00,12000.00,2615.31,8384.69,0.41,1
11465,1358,-1000.00,10000.00,11000.00,6538.54,5461.46,0.30,0
11466,1358,0.00,10000.00,11000.00,0.00,0.00,0.01,0
11467,1358,1000.00,11000.00,12000.00,0.00,7322.20,0.35,1
11468,1358,1000.00,12000.00,13000.00,2589.44,9410.56,0.40,1
11469,1358,1000.00,13000.00,14000.00,0.00,13000.00,0.07,1
11470,1358,1000.00,14000.00,15000.00,0.00,14000.00,0.41,1
11471,1358,1000.00,15000.00,16000.00,0.00,11678.36,0.23,1
11472,1358,1000.00,16000.00,17000.00,7686.41,8313.59,0.42,1
11473,1358,1000.00,17000.00,18000.00,0.00,15317.22,0.43,1
11474,1358,1000.00,18000.00,19000.00,0.00,2570.51,0.13,1
11475,1358,0.00,18000.00,19000.00,0.00,0.00,0.03,0
11476,1358,1000.00,19000.00,20000.00,8672.89,10327.11,0.42,1
11477,1358,1000.00,20000.00,21000.00,3332.92,16667.08,0.27,1
11478,1358,1000.00,21000.00,22000.00,9586.09,11413.91,0.15,1
11479,1358,1000.00,22000.00,23000.00,10436.50,11563.50,0.24,1
11480,1358,1000.00,23000.00,24000.00,0.00,19938.63,0.36,1
11481,1358,-1000.00,22000.00,23000.00,12385.12,11614.88,0.40,0
11482,1358,1000.00,23000.00,24000.00,0.00,14834.12,0.25,1
11483,1359,-1000.00,-1000.00,0.00,152.21,847.79,0.37,0
11484,1360,-1000.00,-1000.00,0.00,173.65,826.35,0.38,0
11485,1361,-1000.00,-1000.00,0.00,859.86,0.00,0.02,0
11486,1362,-1000.00,-1000.00,0.00,94.45,905.55,0.21,0
11487,1363,1000.00,1000.00,2000.00,500.00,500.00,0.08,1
11488,1363,0.00,1000.00,2000.00,0.00,0.00,0.01,0
11489,1363,1000.00,2000.00,3000.00,0.00,1221.66,0.39,1
11490,1363,1000.00,3000.00,4000.00,0.00,1478.46,0.22,1
11491,1363,1000.00,4000.00,5000.00,2000.00,2000.00,0.09,1
11492,1363,-1000.00,3000.00,4000.00,2028.48,485.64,0.34,0
11493,1363,-1000.00,2000.00,3000.00,3194.76,805.24,0.40,0
11494,1363,1000.00,3000.00,4000.00,0.00,1272.80,0.37,1
11495,1363,1000.00,4000.00,5000.00,0.00,3797.49,0.16,1
11496,1363,-730.79,3269.21,4269.21,730.79,0.00,0.40,0
11497,1363,1000.00,4269.21,5269.21,365.74,3903.47,0.32,1
11498,1363,0.00,4269.21,5269.21,0.00,0.00,0.11,0
11499,1363,-744.70,3524.51,4524.51,744.70,0.00,0.02,0
11500,1363,1000.00,4524.51,5524.51,0.00,4524.51,0.06,1
11501,1363,1000.00,5524.51,6524.51,1470.35,2055.09,0.35,1
11502,1363,1000.00,6524.51,7524.51,0.00,1662.82,0.41,1
11503,1363,-1000.00,5524.51,6524.51,7524.51,0.00,0.21,0
11504,1363,-1000.00,4524.51,5524.51,6524.51,0.00,0.33,0
11505,1363,1000.00,5524.51,6524.51,0.00,5524.51,0.03,1
11506,1363,-1000.00,4524.51,5524.51,4853.30,0.00,0.06,0
11507,1363,1000.00,5524.51,6524.51,0.00,1221.67,0.14,1
11508,1363,-426.45,5098.06,6098.06,426.45,0.00,0.43,0
11509,1363,-1000.00,4098.06,5098.06,3212.47,0.00,0.28,0
11510,1363,1000.00,5098.06,6098.06,0.00,1467.94,0.28,1
11511,1363,-1000.00,4098.06,5098.06,6098.06,0.00,0.36,0
11512,1363,0.00,4098.06,5098.06,0.00,0.00,0.01,0
11513,1363,1000.00,5098.06,6098.06,0.00,5098.06,0.13,1
11514,1363,1000.00,6098.06,7098.06,0.00,6098.06,0.18,1
11515,1363,1000.00,7098.06,8098.06,2290.81,4807.25,0.28,1
11516,1363,-1000.00,6098.06,7098.06,2311.26,984.56,0.15,0
11517,1363,1000.00,7098.06,8098.06,0.00,3827.43,0.31,1
11518,1363,-1000.00,6098.06,7098.06,4259.55,3838.51,0.33,0
11519,1363,-1000.00,5098.06,6098.06,4244.61,2853.45,0.31,0
11520,1363,1000.00,6098.06,7098.06,1526.78,4571.29,0.37,1
11521,1363,1000.00,7098.06,8098.06,0.00,5661.99,0.40,1
11522,1363,-1000.00,6098.06,7098.06,4061.19,4036.88,0.29,0
11523,1363,1000.00,7098.06,8098.06,1565.30,5532.76,0.40,1
11524,1363,1000.00,8098.06,9098.06,2568.11,5529.95,0.33,1
11525,1363,-1000.00,7098.06,8098.06,4696.85,4401.21,0.40,0
11526,1363,1000.00,8098.06,9098.06,306.57,7791.49,0.44,1
11527,1363,1000.00,9098.06,10098.06,1966.71,7131.35,0.09,1
11528,1363,1000.00,10098.06,11098.06,0.00,6861.87,0.27,1
11529,1363,0.00,10098.06,11098.06,0.00,0.00,0.06,0
11530,1364,1000.00,1000.00,2000.00,419.71,580.29,0.13,1
11531,1364,1000.00,2000.00,3000.00,0.00,726.26,0.03,1
11532,1364,1000.00,3000.00,4000.00,0.00,3000.00,0.05,1
11533,1364,1000.00,4000.00,5000.00,0.00,4000.00,0.11,1
11534,1364,1000.00,5000.00,6000.00,0.00,5000.00,0.30,1
11535,1364,1000.00,6000.00,7000.00,0.00,6000.00,0.43,1
11536,1364,1000.00,7000.00,8000.00,3182.25,3817.75,0.14,1
11537,1364,-1000.00,6000.00,7000.00,5472.80,2188.21,0.11,0
11538,1364,1000.00,7000.00,8000.00,0.00,2796.52,0.21,1
11539,1364,1000.00,8000.00,9000.00,2301.07,5698.93,0.15,1
11540,1364,1000.00,9000.00,10000.00,0.00,4690.59,0.32,1
11541,1364,1000.00,10000.00,11000.00,2474.14,7525.86,0.29,1
11542,1364,1000.00,11000.00,12000.00,26.02,10973.98,0.12,1
11543,1364,1000.00,12000.00,13000.00,0.00,2580.63,0.17,1
11544,1364,1000.00,13000.00,14000.00,0.00,13000.00,0.09,1
11545,1364,1000.00,14000.00,15000.00,0.00,14000.00,0.12,1
11546,1364,1000.00,15000.00,16000.00,0.00,15000.00,0.02,1
11547,1364,1000.00,16000.00,17000.00,3633.28,12366.72,0.22,1
11548,1364,1000.00,17000.00,18000.00,0.00,10154.76,0.15,1
11549,1364,1000.00,18000.00,19000.00,9000.00,9000.00,0.26,1
11550,1364,-1000.00,17000.00,18000.00,1779.99,0.00,0.04,0
11551,1364,-1000.00,16000.00,17000.00,12418.43,0.00,0.02,0
11552,1364,1000.00,17000.00,18000.00,0.00,17000.00,0.19,1
11553,1364,-1000.00,16000.00,17000.00,6633.07,11366.93,0.31,0
11554,1364,-1000.00,15000.00,16000.00,2319.60,14680.40,0.32,0
11555,1364,-1000.00,14000.00,15000.00,13407.48,0.00,0.00,0
11556,1364,-1000.00,13000.00,14000.00,0.00,13286.28,0.37,0
11557,1364,-1000.00,12000.00,13000.00,0.00,14000.00,0.22,0
11558,1364,-1000.00,11000.00,12000.00,0.00,13000.00,0.05,0
11559,1364,-1000.00,10000.00,11000.00,1898.80,6535.89,0.38,0
11560,1364,-1000.00,9000.00,10000.00,0.00,11000.00,0.28,0
11561,1364,-1000.00,8000.00,9000.00,0.00,5159.51,0.13,0
11562,1364,-1000.00,7000.00,8000.00,0.00,9000.00,0.20,0
11563,1364,-1000.00,6000.00,7000.00,3357.22,4642.78,0.33,0
11564,1364,-1000.00,5000.00,6000.00,0.00,7000.00,0.36,0
11565,1364,-1000.00,4000.00,5000.00,1665.33,2456.16,0.18,0
11566,1364,-1000.00,3000.00,4000.00,0.00,5000.00,0.41,0
11567,1364,-1000.00,2000.00,3000.00,1339.45,2660.55,0.22,0
11568,1364,-1000.00,1000.00,2000.00,1365.50,1634.50,0.21,0
11569,1364,-1000.00,0.00,1000.00,1513.20,486.80,0.24,0
11570,1364,-1000.00,-1000.00,0.00,311.86,308.24,0.23,0
11571,1365,-1000.00,-1000.00,0.00,0.00,1000.00,0.20,0
11572,1366,1000.00,1000.00,2000.00,204.98,634.62,0.35,1
11573,1366,1000.00,2000.00,3000.00,0.00,1696.52,0.04,1
11574,1366,1000.00,3000.00,4000.00,610.61,2389.39,0.37,1
11575,1366,-200.79,2799.21,3799.21,200.79,0.00,0.03,0
11576,1366,1000.00,3799.21,4799.21,0.00,1598.30,0.22,1
11577,1366,1000.00,4799.21,5799.21,0.00,2096.27,0.16,1
11578,1366,1000.00,5799.21,6799.21,0.00,2517.72,0.28,1
11579,1366,1000.00,6799.21,7799.21,0.00,6799.21,0.22,1
11580,1366,1000.00,7799.21,8799.21,2196.94,5602.26,0.20,1
11581,1366,1000.00,8799.21,9799.21,0.00,4872.25,0.24,1
11582,1366,1000.00,9799.21,10799.21,0.00,5585.09,0.27,1
11583,1366,1000.00,10799.21,11799.21,3671.28,7127.93,0.36,1
11584,1366,1000.00,11799.21,12799.21,3294.15,7501.54,0.33,1
11585,1366,0.00,11799.21,12799.21,0.00,0.00,0.02,0
11586,1366,1000.00,12799.21,13799.21,2803.15,9996.06,0.38,1
11587,1366,1000.00,13799.21,14799.21,3290.57,10508.64,0.17,1
11588,1366,1000.00,14799.21,15799.21,4738.99,7701.33,0.35,1
11589,1366,1000.00,15799.21,16799.21,0.00,15799.21,0.08,1
11590,1366,1000.00,16799.21,17799.21,6905.78,9893.43,0.37,1
11591,1366,1000.00,17799.21,18799.21,4393.25,13405.96,0.38,1
11592,1366,1000.00,18799.21,19799.21,0.00,15039.08,0.11,1
11593,1366,-1000.00,17799.21,18799.21,19799.21,0.00,0.15,0
11594,1366,1000.00,18799.21,19799.21,6346.67,12452.54,0.07,1
11595,1366,1000.00,19799.21,20799.21,5987.28,12354.02,0.32,1
11596,1366,1000.00,20799.21,21799.21,9781.85,11017.36,0.22,1
11597,1366,-1000.00,19799.21,20799.21,11213.23,10585.98,0.39,0
11598,1366,1000.00,20799.21,21799.21,6687.60,14111.61,0.42,1
11599,1366,-1000.00,19799.21,20799.21,12592.09,9207.12,0.26,0
11600,1366,1000.00,20799.21,21799.21,6509.84,14289.36,0.18,1
11601,1366,1000.00,21799.21,22799.21,2147.41,8509.08,0.26,1
11602,1366,1000.00,22799.21,23799.21,11399.60,11399.60,0.03,1
11603,1366,-1000.00,21799.21,22799.21,12771.03,11028.17,0.03,0
11604,1366,1000.00,22799.21,23799.21,0.00,1760.69,0.08,1
11605,1366,1000.00,23799.21,24799.21,0.00,8316.16,0.07,1
11606,1366,-1000.00,22799.21,23799.21,3833.00,1637.13,0.13,0
11607,1366,1000.00,23799.21,24799.21,0.00,21158.14,0.29,1
11608,1366,1000.00,24799.21,25799.21,0.00,24799.21,0.20,1
11609,1366,1000.00,25799.21,26799.21,0.00,15407.68,0.21,1
11610,1366,1000.00,26799.21,27799.21,0.00,26799.21,0.12,1
11611,1366,1000.00,27799.21,28799.21,6107.48,21691.73,0.29,1
11612,1366,-1000.00,26799.21,27799.21,18260.01,10539.20,0.19,0
11613,1366,1000.00,27799.21,28799.21,7103.28,20241.16,0.39,1
11614,1366,1000.00,28799.21,29799.21,0.00,20478.56,0.13,1
11615,1366,1000.00,29799.21,30799.21,0.00,22152.98,0.16,1
11616,1366,1000.00,30799.21,31799.21,5.03,16213.30,0.32,1
11617,1366,1000.00,31799.21,32799.21,15899.60,15899.60,0.06,1
11618,1366,1000.00,32799.21,33799.21,0.00,14034.77,0.23,1
11619,1366,1000.00,33799.21,34799.21,5957.56,27841.65,0.03,1
11620,1366,1000.00,34799.21,35799.21,6812.69,27986.52,0.38,1
11621,1366,1000.00,35799.21,36799.21,3862.64,23476.02,0.37,1
11622,1366,-1000.00,34799.21,35799.21,36477.67,0.00,0.08,0
11623,1366,1000.00,35799.21,36799.21,5770.42,30028.78,0.39,1
11624,1366,1000.00,36799.21,37799.21,5396.34,16724.00,0.30,1
11625,1366,1000.00,37799.21,38799.21,6683.83,31115.38,0.11,1
11626,1366,1000.00,38799.21,39799.21,0.00,38799.21,0.01,1
11627,1366,1000.00,39799.21,40799.21,0.00,39799.21,0.10,1
11628,1366,1000.00,40799.21,41799.21,0.00,40799.21,0.13,1
11629,1366,0.00,40799.21,41799.21,0.00,0.00,0.05,0
11630,1366,1000.00,41799.21,42799.21,0.00,41799.21,0.17,1
11631,1366,1000.00,42799.21,43799.21,3449.39,39349.82,0.43,1
11632,1366,1000.00,43799.21,44799.21,0.00,43799.21,0.07,1
11633,1366,1000.00,44799.21,45799.21,12157.11,31935.71,0.39,1
11634,1366,1000.00,45799.21,46799.21,15047.66,30751.55,0.07,1
11635,1366,1000.00,46799.21,47799.21,0.00,13810.84,0.09,1
11636,1366,-1000.00,45799.21,46799.21,31909.90,15889.30,0.26,0
11637,1366,1000.00,46799.21,47799.21,20277.56,26521.65,0.07,1
11638,1366,1000.00,47799.21,48799.21,10289.97,37509.24,0.38,1
11639,1366,1000.00,48799.21,49799.21,22252.46,26546.75,0.35,1
11640,1366,1000.00,49799.21,50799.21,0.00,40962.19,0.27,1
11641,1367,-1000.00,-1000.00,0.00,482.91,336.26,0.17,0
11642,1368,-1000.00,-1000.00,0.00,0.00,1000.00,0.23,0
11643,1369,-1000.00,-1000.00,0.00,0.00,422.36,0.10,0
11644,1370,-869.56,-869.56,130.44,301.28,568.28,0.31,0
11645,1370,-130.44,-1000.00,0.00,27.02,103.42,0.28,0
11646,1371,-474.25,-474.25,525.75,0.00,474.25,0.22,0
11647,1371,-456.62,-930.87,69.13,0.00,456.62,0.43,0
11648,1371,-69.13,-1000.00,0.00,0.00,69.13,0.39,0
11649,1372,1000.00,1000.00,2000.00,0.00,554.87,0.28,1
11650,1372,-1000.00,0.00,1000.00,1037.00,963.00,0.21,0
11651,1372,-1000.00,-1000.00,0.00,1000.00,0.00,0.01,0
11652,1373,1000.00,1000.00,2000.00,186.64,813.36,0.29,1
11653,1373,-142.26,857.74,1857.74,142.26,0.00,0.01,0
11654,1373,1000.00,1857.74,2857.74,0.00,754.43,0.13,1
11655,1373,1000.00,2857.74,3857.74,998.96,1724.80,0.27,1
11656,1373,1000.00,3857.74,4857.74,0.00,2951.95,0.30,1
11657,1373,-1000.00,2857.74,3857.74,3545.67,1312.06,0.16,0
11658,1373,1000.00,3857.74,4857.74,1628.21,2229.52,0.17,1
11659,1373,1000.00,4857.74,5857.74,1357.04,3500.70,0.29,1
11660,1373,1000.00,5857.74,6857.74,2371.96,3485.77,0.24,1
11661,1373,-1000.00,4857.74,5857.74,4164.59,456.31,0.08,0
11662,1373,1000.00,5857.74,6857.74,347.51,5510.22,0.37,1
11663,1373,1000.00,6857.74,7857.74,0.00,3294.81,0.03,1
11664,1373,1000.00,7857.74,8857.74,3314.73,4543.01,0.04,1
11665,1373,1000.00,8857.74,9857.74,0.00,4851.61,0.24,1
11666,1373,1000.00,9857.74,10857.74,4928.87,4928.87,0.29,1
11667,1373,-1000.00,8857.74,9857.74,5660.05,5197.69,0.17,0
11668,1373,1000.00,9857.74,10857.74,0.00,3299.42,0.22,1
11669,1373,1000.00,10857.74,11857.74,0.00,10857.74,0.03,1
11670,1373,1000.00,11857.74,12857.74,3099.47,8758.26,0.16,1
11671,1373,-1000.00,10857.74,11857.74,1827.48,0.00,0.06,0
11672,1373,1000.00,11857.74,12857.74,3204.25,8447.30,0.38,1
11673,1373,1000.00,12857.74,13857.74,0.00,12857.74,0.05,1
11674,1373,1000.00,13857.74,14857.74,4660.49,7219.71,0.28,1
11675,1373,-1000.00,12857.74,13857.74,12424.17,2433.56,0.09,0
11676,1373,1000.00,13857.74,14857.74,0.00,13857.74,0.19,1
11677,1373,1000.00,14857.74,15857.74,2944.29,4007.71,0.11,1
11678,1373,1000.00,15857.74,16857.74,4687.35,11170.39,0.38,1
11679,1373,1000.00,16857.74,17857.74,8428.87,8428.87,0.09,1
11680,1373,1000.00,17857.74,18857.74,8928.87,8928.87,0.07,1
11681,1373,1000.00,18857.74,19857.74,8582.38,10275.35,0.05,1
11682,1373,-1000.00,17857.74,18857.74,12406.70,7451.04,0.29,0
11683,1373,1000.00,18857.74,19857.74,6818.52,12039.21,0.28,1
11684,1374,-1000.00,-1000.00,0.00,163.06,836.94,0.12,0
11685,1375,-1000.00,-1000.00,0.00,0.00,1000.00,0.27,0
11686,1376,-1000.00,-1000.00,0.00,494.04,505.96,0.22,0
11687,1377,-1000.00,-1000.00,0.00,0.00,783.06,0.36,0
11688,1378,-1000.00,-1000.00,0.00,539.73,460.27,0.06,0
11689,1379,-928.24,-928.24,71.76,0.00,928.24,0.41,0
11690,1379,-1000.00,-1928.24,-928.24,27.84,0.00,0.05,0
11691,1380,-1000.00,-1000.00,0.00,356.13,643.87,0.11,0
11692,1381,1000.00,1000.00,2000.00,398.53,561.66,0.27,1
11693,1381,1000.00,2000.00,3000.00,0.00,853.11,0.03,1
11694,1381,1000.00,3000.00,4000.00,0.00,3000.00,0.22,1
11695,1381,1000.00,4000.00,5000.00,0.00,4000.00,0.32,1
11696,1381,1000.00,5000.00,6000.00,0.00,3808.49,0.31,1
11697,1381,1000.00,6000.00,7000.00,3000.00,3000.00,0.27,1
11698,1381,-1000.00,5000.00,6000.00,2484.43,0.00,0.10,0
11699,1381,1000.00,6000.00,7000.00,0.00,3556.05,0.16,1
11700,1381,1000.00,7000.00,8000.00,2892.22,4107.78,0.18,1
11701,1381,1000.00,8000.00,9000.00,0.00,8000.00,0.43,1
11702,1381,1000.00,9000.00,10000.00,4403.97,4596.03,0.11,1
11703,1381,1000.00,10000.00,11000.00,3927.83,6072.17,0.14,1
11704,1381,1000.00,11000.00,12000.00,0.00,11000.00,0.37,1
11705,1381,0.00,11000.00,12000.00,0.00,0.00,0.04,0
11706,1381,-1000.00,10000.00,11000.00,6249.41,5070.72,0.26,0
11707,1381,1000.00,11000.00,12000.00,0.00,9266.55,0.16,1
11708,1381,1000.00,12000.00,13000.00,0.00,12000.00,0.23,1
11709,1381,1000.00,13000.00,14000.00,0.00,2939.79,0.13,1
11710,1381,1000.00,14000.00,15000.00,4219.59,9780.41,0.40,1
11711,1381,1000.00,15000.00,16000.00,0.00,14092.19,0.44,1
11712,1381,1000.00,16000.00,17000.00,5612.95,10387.05,0.32,1
11713,1381,1000.00,17000.00,18000.00,0.00,16625.09,0.16,1
11714,1381,1000.00,18000.00,19000.00,0.00,17230.39,0.24,1
11715,1381,1000.00,19000.00,20000.00,0.00,19000.00,0.14,1
11716,1381,-1000.00,18000.00,19000.00,4868.53,14918.81,0.19,0
11717,1381,-1000.00,17000.00,18000.00,6852.53,12147.47,0.32,0
11718,1381,0.00,17000.00,18000.00,0.00,0.00,0.07,0
11719,1381,-1000.00,16000.00,17000.00,6938.24,0.00,0.03,0
11720,1381,-1000.00,15000.00,16000.00,0.00,16354.76,0.09,0
11721,1381,-1000.00,14000.00,15000.00,4396.31,1482.47,0.13,0
11722,1381,-1000.00,13000.00,14000.00,0.00,2795.35,0.17,0
11723,1381,-1000.00,12000.00,13000.00,1624.65,12375.35,0.41,0
11724,1381,-1000.00,11000.00,12000.00,1199.75,11800.25,0.17,0
11725,1381,-1000.00,10000.00,11000.00,3297.34,8702.66,0.37,0
11726,1381,-1000.00,9000.00,10000.00,5500.00,5500.00,0.18,0
11727,1381,-1000.00,8000.00,9000.00,2678.93,0.00,0.03,0
11728,1381,-1000.00,7000.00,8000.00,0.00,9000.00,0.04,0
11729,1381,-1000.00,6000.00,7000.00,1877.49,6122.51,0.18,0
11730,1381,-1000.00,5000.00,6000.00,3674.32,3325.68,0.06,0
11731,1381,-1000.00,4000.00,5000.00,2576.19,3423.81,0.05,0
11732,1381,-1000.00,3000.00,4000.00,0.00,5000.00,0.42,0
11733,1381,-1000.00,2000.00,3000.00,1432.47,2567.53,0.24,0
11734,1381,-1000.00,1000.00,2000.00,701.93,2298.07,0.43,0
11735,1381,-1000.00,0.00,1000.00,0.00,2000.00,0.20,0
11736,1381,-1000.00,-1000.00,0.00,0.00,1000.00,0.39,0
11737,1382,-741.12,-741.12,258.88,0.00,741.12,0.38,0
11738,1382,-258.88,-1000.00,0.00,97.58,161.31,0.29,0
11739,1383,-916.27,-916.27,83.73,0.00,916.27,0.38,0
11740,1383,-83.73,-1000.00,0.00,0.00,83.73,0.31,0
11741,1384,-1000.00,-1000.00,0.00,0.00,1000.00,0.30,0
11742,1385,-1000.00,-1000.00,0.00,0.00,1000.00,0.01,0
11743,1386,-1000.00,-1000.00,0.00,230.97,769.03,0.35,0
11744,1387,-1000.00,-1000.00,0.00,619.26,380.74,0.05,0
11745,1388,-875.68,-875.68,124.32,0.00,875.68,0.08,0
11746,1388,-124.32,-1000.00,0.00,59.03,65.28,0.04,0
11747,1389,1000.00,1000.00,2000.00,0.00,1000.00,0.03,1
11748,1389,1000.00,2000.00,3000.00,558.15,1441.85,0.23,1
11749,1389,1000.00,3000.00,4000.00,0.00,1005.40,0.13,1
11750,1389,0.00,3000.00,4000.00,0.00,0.00,0.02,0
11751,1389,1000.00,4000.00,5000.00,0.00,855.95,0.19,1
11752,1389,-1000.00,3000.00,4000.00,2726.65,2273.35,0.30,0
11753,1389,1000.00,4000.00,5000.00,0.00,2664.53,0.03,1
11754,1389,1000.00,5000.00,6000.00,1829.69,3170.31,0.26,1
11755,1389,1000.00,6000.00,7000.00,600.48,4396.01,0.40,1
11756,1389,-1000.00,5000.00,6000.00,5372.76,1627.24,0.11,0
11757,1389,1000.00,6000.00,7000.00,0.00,2152.02,0.12,1
11758,1389,-1000.00,5000.00,6000.00,3838.42,3161.58,0.42,0
11759,1389,1000.00,6000.00,7000.00,0.00,3745.26,0.26,1
11760,1389,-1000.00,5000.00,6000.00,3839.72,3160.28,0.06,0
11761,1389,-1000.00,4000.00,5000.00,5174.12,825.88,0.06,0
11762,1389,1000.00,5000.00,6000.00,0.00,4867.12,0.31,1
11763,1389,-1000.00,4000.00,5000.00,6000.00,0.00,0.08,0
11764,1389,1000.00,5000.00,6000.00,2071.96,2928.04,0.23,1
11765,1389,-1000.00,4000.00,5000.00,5479.49,0.00,0.04,0
11766,1389,-1000.00,3000.00,4000.00,4348.46,651.54,0.26,0
11767,1389,1000.00,4000.00,5000.00,0.00,4000.00,0.30,1
11768,1389,1000.00,5000.00,6000.00,260.68,1096.97,0.18,1
11769,1389,1000.00,6000.00,7000.00,1954.22,4045.78,0.39,1
11770,1389,-1000.00,5000.00,6000.00,5106.23,1893.77,0.14,0
11771,1389,1000.00,6000.00,7000.00,0.00,2616.75,0.16,1
11772,1389,-1000.00,5000.00,6000.00,3604.98,3395.02,0.03,0
11773,1389,1000.00,6000.00,7000.00,0.00,6000.00,0.10,1
11774,1389,-1000.00,5000.00,6000.00,3039.70,734.85,0.12,0
11775,1389,-1000.00,4000.00,5000.00,3084.30,2012.15,0.17,0
11776,1389,0.00,4000.00,5000.00,0.00,0.00,0.02,0
11777,1389,1000.00,5000.00,6000.00,2500.00,2500.00,0.01,1
11778,1389,-1000.00,4000.00,5000.00,3174.16,2825.84,0.22,0
11779,1389,-1000.00,3000.00,4000.00,2674.38,2325.62,0.09,0
11780,1389,1000.00,4000.00,5000.00,1553.78,2446.22,0.36,1
11781,1389,1000.00,5000.00,6000.00,1447.85,3552.15,0.11,1
11782,1389,1000.00,6000.00,7000.00,1078.10,4921.90,0.44,1
11783,1389,1000.00,7000.00,8000.00,0.00,4672.95,0.30,1
11784,1389,1000.00,8000.00,9000.00,0.00,8000.00,0.07,1
11785,1390,-937.38,-937.38,62.62,0.00,937.38,0.26,0
11786,1390,-193.01,-1130.39,-130.39,48.25,8.50,0.18,0
11787,1391,1000.00,1000.00,2000.00,0.00,1000.00,0.36,1
11788,1391,1000.00,2000.00,3000.00,0.00,982.15,0.26,1
11789,1391,1000.00,3000.00,4000.00,0.00,3000.00,0.14,1
11790,1391,1000.00,4000.00,5000.00,0.00,3419.17,0.19,1
11791,1391,1000.00,5000.00,6000.00,498.14,4501.86,0.44,1
11792,1391,1000.00,6000.00,7000.00,0.00,6000.00,0.20,1
11793,1391,1000.00,7000.00,8000.00,0.00,7000.00,0.02,1
11794,1391,1000.00,8000.00,9000.00,678.43,5389.86,0.38,1
11795,1391,1000.00,9000.00,10000.00,0.00,9000.00,0.29,1
11796,1391,1000.00,10000.00,11000.00,0.00,10000.00,0.28,1
11797,1391,1000.00,11000.00,12000.00,3014.06,7985.94,0.41,1
11798,1391,1000.00,12000.00,13000.00,6000.00,6000.00,0.02,1
11799,1391,1000.00,13000.00,14000.00,2616.85,10383.15,0.37,1
11800,1391,1000.00,14000.00,15000.00,0.00,14000.00,0.03,1
11801,1391,1000.00,15000.00,16000.00,7500.00,7500.00,0.12,1
11802,1391,1000.00,16000.00,17000.00,7486.13,8513.87,0.33,1
11803,1391,1000.00,17000.00,18000.00,0.00,17000.00,0.32,1
11804,1391,1000.00,18000.00,19000.00,0.00,18000.00,0.04,1
11805,1391,1000.00,19000.00,20000.00,7915.06,11084.94,0.22,1
11806,1391,1000.00,20000.00,21000.00,0.00,15496.61,0.04,1
11807,1391,1000.00,21000.00,22000.00,5947.02,15052.98,0.07,1
11808,1391,-1000.00,20000.00,21000.00,22000.00,0.00,0.05,0
11809,1391,1000.00,21000.00,22000.00,3343.13,10274.84,0.30,1
11810,1391,1000.00,22000.00,23000.00,11000.00,11000.00,0.35,1
11811,1391,1000.00,23000.00,24000.00,3616.12,19383.88,0.02,1
11812,1391,1000.00,24000.00,25000.00,0.00,24000.00,0.03,1
11813,1391,1000.00,25000.00,26000.00,11547.41,13452.59,0.32,1
11814,1391,-1000.00,24000.00,25000.00,15578.64,10421.36,0.35,0
11815,1391,1000.00,25000.00,26000.00,2709.78,22290.22,0.25,1
11816,1391,1000.00,26000.00,27000.00,7255.95,18744.05,0.37,1
11817,1391,1000.00,27000.00,28000.00,4040.21,18254.83,0.37,1
11818,1391,1000.00,28000.00,29000.00,14000.00,14000.00,0.16,1
11819,1391,1000.00,29000.00,30000.00,14500.00,14500.00,0.05,1
11820,1391,1000.00,30000.00,31000.00,0.00,18690.52,0.36,1
11821,1391,1000.00,31000.00,32000.00,11352.87,13530.91,0.24,1
11822,1391,1000.00,32000.00,33000.00,14012.66,17987.34,0.30,1
11823,1391,1000.00,33000.00,34000.00,0.00,33000.00,0.09,1
11824,1391,1000.00,34000.00,35000.00,17000.00,17000.00,0.09,1
11825,1391,1000.00,35000.00,36000.00,0.00,35000.00,0.30,1
11826,1391,1000.00,36000.00,37000.00,5234.89,30765.11,0.11,1
11827,1391,-1000.00,35000.00,36000.00,37000.00,0.00,0.02,0
11828,1391,1000.00,36000.00,37000.00,0.00,32942.37,0.43,1
11829,1391,1000.00,37000.00,38000.00,0.00,37000.00,0.13,1
11830,1392,-1000.00,-1000.00,0.00,209.88,790.12,0.10,0
11831,1393,1000.00,1000.00,2000.00,0.00,1000.00,0.35,1
11832,1393,1000.00,2000.00,3000.00,955.42,1044.58,0.12,1
11833,1393,1000.00,3000.00,4000.00,0.00,1974.29,0.31,1
11834,1393,1000.00,4000.00,5000.00,0.00,4000.00,0.32,1
11835,1393,1000.00,5000.00,6000.00,1459.04,3540.96,0.28,1
11836,1393,1000.00,6000.00,7000.00,0.00,3554.37,0.03,1
11837,1393,1000.00,7000.00,8000.00,2695.22,4304.78,0.40,1
11838,1393,-1000.00,6000.00,7000.00,867.00,272.58,0.12,0
11839,1393,-1000.00,5000.00,6000.00,4268.34,2731.66,0.02,0
11840,1393,1000.00,6000.00,7000.00,420.28,5579.72,0.30,1
11841,1393,1000.00,7000.00,8000.00,2616.84,4383.16,0.25,1
11842,1393,1000.00,8000.00,9000.00,0.00,8000.00,0.01,1
11843,1393,1000.00,9000.00,10000.00,0.00,4781.48,0.03,1
11844,1393,1000.00,10000.00,11000.00,1940.19,5933.74,0.34,1
11845,1393,1000.00,11000.00,12000.00,5500.00,5500.00,0.03,1
11846,1393,-1000.00,10000.00,11000.00,6359.17,5640.83,0.35,0
11847,1393,-1000.00,9000.00,10000.00,6064.84,4935.16,0.40,0
11848,1393,1000.00,10000.00,11000.00,1137.65,5586.01,0.27,1
11849,1393,1000.00,11000.00,12000.00,1594.53,8291.45,0.41,1
11850,1393,1000.00,12000.00,13000.00,2028.33,9971.67,0.40,1
11851,1393,1000.00,13000.00,14000.00,0.00,8741.61,0.26,1
11852,1393,1000.00,14000.00,15000.00,0.00,8646.51,0.30,1
11853,1393,1000.00,15000.00,16000.00,4729.03,10270.97,0.43,1
11854,1393,1000.00,16000.00,17000.00,7011.87,8988.13,0.34,1
11855,1393,-1000.00,15000.00,16000.00,10048.18,2629.08,0.34,0
11856,1393,-1000.00,14000.00,15000.00,2790.17,13209.83,0.41,0
11857,1393,-1000.00,13000.00,14000.00,0.00,3122.86,0.19,0
11858,1393,-1000.00,12000.00,13000.00,11004.09,2255.49,0.18,0
11859,1393,-1000.00,11000.00,12000.00,53.76,12946.24,0.20,0
11860,1393,-1000.00,10000.00,11000.00,9781.81,2062.71,0.38,0
11861,1393,-1000.00,9000.00,10000.00,5845.44,5154.56,0.11,0
11862,1393,-1000.00,8000.00,9000.00,4701.48,5298.52,0.21,0
11863,1393,-1000.00,7000.00,8000.00,0.00,8680.31,0.24,0
11864,1393,-1000.00,6000.00,7000.00,2262.51,5737.49,0.32,0
11865,1393,-1000.00,5000.00,6000.00,5933.61,1066.39,0.06,0
11866,1393,-1000.00,4000.00,5000.00,2532.32,3467.68,0.24,0
11867,1393,-1000.00,3000.00,4000.00,1666.74,3333.26,0.18,0
11868,1393,-1000.00,2000.00,3000.00,0.00,4000.00,0.33,0
11869,1393,-1000.00,1000.00,2000.00,0.00,3000.00,0.32,0
11870,1393,-1000.00,0.00,1000.00,2000.00,0.00,0.05,0
11871,1393,-1000.00,-1000.00,0.00,0.00,1000.00,0.32,0
11872,1394,-796.19,-796.19,203.81,0.00,796.19,0.41,0
11873,1394,-187.79,-983.98,16.02,0.00,187.79,0.35,0
11874,1394,-16.02,-1000.00,0.00,0.00,16.02,0.33,0
11875,1395,-206.25,-206.25,793.75,11.59,194.66,0.18,0
11876,1395,-425.00,-631.25,368.75,0.00,425.00,0.17,0
11877,1395,-368.75,-1000.00,0.00,160.69,208.06,0.31,0
11878,1395,-0.00,-1000.00,0.00,0.00,0.00,0.23,0
11879,1396,1000.00,1000.00,2000.00,0.00,842.21,0.43,1
11880,1396,1000.00,2000.00,3000.00,0.00,712.60,0.24,1
11881,1396,1000.00,3000.00,4000.00,0.00,3000.00,0.32,1
11882,1396,-1000.00,2000.00,3000.00,2817.77,1182.23,0.06,0
11883,1396,0.00,2000.00,3000.00,0.00,0.00,0.00,0
11884,1396,-1000.00,1000.00,2000.00,2109.83,0.00,0.04,0
11885,1396,1000.00,2000.00,3000.00,0.00,904.84,0.27,1
11886,1396,-1000.00,1000.00,2000.00,1515.31,1484.69,0.39,0
11887,1396,1000.00,2000.00,3000.00,967.50,1032.50,0.15,1
11888,1396,1000.00,3000.00,4000.00,0.00,2099.21,0.16,1
11889,1396,1000.00,4000.00,5000.00,1466.58,2533.42,0.25,1
11890,1396,1000.00,5000.00,6000.00,735.44,4264.56,0.32,1
11891,1396,1000.00,6000.00,7000.00,0.00,1887.45,0.27,1
11892,1396,1000.00,7000.00,8000.00,0.00,4757.62,0.27,1
11893,1396,1000.00,8000.00,9000.00,0.00,6864.72,0.25,1
11894,1396,1000.00,9000.00,10000.00,3368.76,5631.24,0.07,1
11895,1396,1000.00,10000.00,11000.00,4324.95,5675.05,0.38,1
11896,1396,-1000.00,9000.00,10000.00,9148.90,1851.10,0.04,0
11897,1396,1000.00,10000.00,11000.00,3145.50,6854.50,0.34,1
11898,1396,1000.00,11000.00,12000.00,5500.00,5500.00,0.13,1
11899,1396,1000.00,12000.00,13000.00,2138.87,9861.13,0.40,1
11900,1396,1000.00,13000.00,14000.00,0.00,4587.59,0.07,1
11901,1396,1000.00,14000.00,15000.00,0.00,14000.00,0.24,1
11902,1396,-1000.00,13000.00,14000.00,9510.80,5417.01,0.15,0
11903,1396,-1000.00,12000.00,13000.00,8368.90,0.00,0.07,0
11904,1396,-1000.00,11000.00,12000.00,3812.18,9187.82,0.35,0
11905,1396,-1000.00,10000.00,11000.00,4466.73,7533.27,0.41,0
11906,1396,-1000.00,9000.00,10000.00,0.00,11000.00,0.11,0
11907,1396,-1000.00,8000.00,9000.00,9486.82,513.18,0.09,0
11908,1396,-1000.00,7000.00,8000.00,3165.41,5834.59,0.29,0
11909,1396,-1000.00,6000.00,7000.00,2986.10,5013.90,0.01,0
11910,1396,-1000.00,5000.00,6000.00,0.00,7000.00,0.14,0
11911,1396,-1000.00,4000.00,5000.00,0.00,6000.00,0.23,0
11912,1396,-1000.00,3000.00,4000.00,3085.00,1915.00,0.13,0
11913,1396,-1000.00,2000.00,3000.00,1150.61,0.00,0.04,0
11914,1396,0.00,2000.00,3000.00,0.00,0.00,0.04,0
11915,1396,-1000.00,1000.00,2000.00,0.00,2593.59,0.18,0
11916,1396,-1000.00,0.00,1000.00,690.22,1309.78,0.30,0
11917,1396,-1000.00,-1000.00,0.00,102.86,897.14,0.43,0
11918,1397,-1000.00,-1000.00,0.00,0.00,190.79,0.03,0
11919,1398,-1000.00,-1000.00,0.00,0.00,1000.00,0.18,0
11920,1399,-1000.00,-1000.00,0.00,167.75,832.25,0.40,0
11921,1400,-317.57,-317.57,682.43,317.57,0.00,0.08,0
11922,1400,-1000.00,-1317.57,-317.57,0.00,299.88,0.29,0
11923,1401,-1000.00,-1000.00,0.00,0.00,223.20,0.20,0
11924,1402,-376.43,-376.43,623.57,0.00,376.43,0.25,0
11925,1402,-613.72,-990.15,9.85,0.00,613.72,0.33,0
11926,1402,1000.00,9.85,1009.85,6.50,0.00,0.06,1
11927,1402,1000.00,1009.85,2009.85,408.34,353.65,0.32,1
11928,1402,0.00,1009.85,2009.85,0.00,0.00,0.16,0
11929,1402,-1000.00,9.85,1009.85,607.41,876.93,0.32,0
11930,1402,-795.35,-785.51,214.49,35.06,760.30,0.44,0
11931,1402,-86.38,-871.89,128.11,0.00,86.38,0.21,0
11932,1402,1000.00,128.11,1128.11,98.76,22.73,0.41,1
11933,1402,-1000.00,-871.89,128.11,0.44,1127.67,0.18,0
11934,1402,-128.11,-1000.00,0.00,55.27,72.84,0.05,0
11935,1403,-1000.00,-1000.00,0.00,366.16,633.84,0.20,0
11936,1404,-1000.00,-1000.00,0.00,112.48,887.52,0.42,0
11937,1405,-1000.00,-1000.00,0.00,748.24,251.76,0.07,0
11938,1406,-1000.00,-1000.00,0.00,0.00,1000.00,0.06,0
11939,1407,-1000.00,-1000.00,0.00,500.00,500.00,0.08,0
11940,1408,-1000.00,-1000.00,0.00,151.98,848.02,0.29,0
11941,1409,1000.00,1000.00,2000.00,0.00,1000.00,0.35,1
11942,1409,1000.00,2000.00,3000.00,645.69,1354.31,0.34,1
11943,1409,1000.00,3000.00,4000.00,925.44,1074.58,0.13,1
11944,1409,1000.00,4000.00,5000.00,1570.10,2429.90,0.30,1
11945,1409,-1000.00,3000.00,4000.00,3493.11,1506.89,0.26,0
11946,1409,1000.00,4000.00,5000.00,833.85,2992.34,0.38,1
11947,1409,1000.00,5000.00,6000.00,2328.88,2671.12,0.10,1
11948,1409,-1000.00,4000.00,5000.00,3034.69,2965.31,0.26,0
11949,1409,1000.00,5000.00,6000.00,1186.38,3813.62,0.27,1
11950,1409,-1000.00,4000.00,5000.00,3621.79,2378.21,0.03,0
11951,1409,1000.00,5000.00,6000.00,0.00,488.30,0.09,1
11952,1409,1000.00,6000.00,7000.00,2754.44,3245.56,0.12,1
11953,1409,1000.00,7000.00,8000.00,2226.49,4773.51,0.42,1
11954,1409,1000.00,8000.00,9000.00,1876.80,6123.20,0.38,1
11955,1409,1000.00,9000.00,10000.00,3248.39,5751.61,0.21,1
11956,1409,-1000.00,8000.00,9000.00,9185.32,814.68,0.07,0
11957,1409,-1000.00,7000.00,8000.00,3772.71,3369.99,0.20,0
11958,1409,-1000.00,6000.00,7000.00,6122.33,1877.67,0.21,0
11959,1409,-1000.00,5000.00,6000.00,3329.26,3059.27,0.21,0
11960,1409,1000.00,6000.00,7000.00,2300.56,3238.95,0.27,1
11961,1409,1000.00,7000.00,8000.00,0.00,6508.08,0.17,1
11962,1409,-1000.00,6000.00,7000.00,5617.99,2382.01,0.04,0
11963,1409,1000.00,7000.00,8000.00,0.00,5179.61,0.35,1
11964,1409,1000.00,8000.00,9000.00,3544.48,4455.52,0.44,1
11965,1409,1000.00,9000.00,10000.00,0.00,9000.00,0.01,1
11966,1409,1000.00,10000.00,11000.00,0.00,10000.00,0.22,1
11967,1409,-1000.00,9000.00,10000.00,7469.63,3530.37,0.10,0
11968,1409,1000.00,10000.00,11000.00,4689.34,5310.66,0.29,1
11969,1409,-1000.00,9000.00,10000.00,5750.06,5249.94,0.36,0
11970,1409,1000.00,10000.00,11000.00,3924.79,6075.21,0.44,1
11971,1409,1000.00,11000.00,12000.00,5500.00,5500.00,0.32,1
11972,1409,1000.00,12000.00,13000.00,0.00,3834.37,0.14,1
11973,1409,1000.00,13000.00,14000.00,5612.34,7387.66,0.02,1
11974,1409,-1000.00,12000.00,13000.00,2376.79,0.00,0.02,0
11975,1409,1000.00,13000.00,14000.00,0.00,13000.00,0.06,1
11976,1409,1000.00,14000.00,15000.00,6734.87,7265.13,0.44,1
11977,1409,1000.00,15000.00,16000.00,6294.51,8705.49,0.41,1
11978,1409,-1000.00,14000.00,15000.00,9646.17,6353.83,0.24,0
11979,1409,1000.00,15000.00,16000.00,7158.83,7841.17,0.09,1
11980,1409,1000.00,16000.00,17000.00,0.00,16000.00,0.41,1
11981,1409,1000.00,17000.00,18000.00,4279.41,12720.59,0.26,1
11982,1409,1000.00,18000.00,19000.00,5168.90,12831.10,0.34,1
11983,1409,-1000.00,17000.00,18000.00,11542.75,7457.25,0.05,0
11984,1409,1000.00,18000.00,19000.00,4740.74,13259.26,0.16,1
11985,1409,1000.00,19000.00,20000.00,9500.00,9500.00,0.00,1
11986,1410,-1000.00,-1000.00,0.00,243.00,757.00,0.30,0
11987,1411,-1000.00,-1000.00,0.00,0.00,1000.00,0.34,0
11988,1412,-1000.00,-1000.00,0.00,175.41,824.59,0.29,0
11989,1412,0.00,-1000.00,0.00,0.00,0.00,0.01,0
11990,1412,-0.00,-1000.00,0.00,0.00,0.00,0.10,0
11991,1413,-1000.00,-1000.00,0.00,0.00,1000.00,0.33,0
11992,1414,1000.00,1000.00,2000.00,459.38,540.62,0.10,1
11993,1414,1000.00,2000.00,3000.00,0.00,358.81,0.13,1
11994,1414,1000.00,3000.00,4000.00,0.00,328.95,0.09,1
11995,1414,1000.00,4000.00,5000.00,1201.22,2798.78,0.04,1
11996,1414,1000.00,5000.00,6000.00,0.00,5000.00,0.31,1
11997,1414,-1000.00,4000.00,5000.00,3287.93,2712.07,0.26,0
11998,1414,1000.00,5000.00,6000.00,0.00,2914.36,0.07,1
11999,1414,1000.00,6000.00,7000.00,0.00,6000.00,0.21,1
12000,1414,1000.00,7000.00,8000.00,1578.54,5421.46,0.43,1
12001,1414,1000.00,8000.00,9000.00,959.82,7040.18,0.17,1
12002,1414,1000.00,9000.00,10000.00,0.00,8749.73,0.35,1
12003,1414,1000.00,10000.00,11000.00,0.00,10000.00,0.04,1
12004,1414,1000.00,11000.00,12000.00,0.00,6254.14,0.18,1
12005,1414,1000.00,12000.00,13000.00,0.00,6749.57,0.04,1
12006,1414,1000.00,13000.00,14000.00,0.00,12740.68,0.36,1
12007,1414,1000.00,14000.00,15000.00,6773.55,7226.45,0.13,1
12008,1414,1000.00,15000.00,16000.00,1829.72,13170.28,0.42,1
12009,1414,-1000.00,14000.00,15000.00,14260.19,0.00,0.03,0
12010,1414,1000.00,15000.00,16000.00,4526.13,10473.87,0.41,1
12011,1414,-1000.00,14000.00,15000.00,7700.49,68.83,0.19,0
12012,1414,-1000.00,13000.00,14000.00,0.00,15000.00,0.07,0
12013,1414,-1000.00,12000.00,13000.00,0.00,5968.19,0.28,0
12014,1414,-1000.00,11000.00,12000.00,0.00,13000.00,0.31,0
12015,1414,-1000.00,10000.00,11000.00,6000.00,6000.00,0.28,0
12016,1414,-1000.00,9000.00,10000.00,4016.86,6983.14,0.34,0
12017,1414,-1000.00,8000.00,9000.00,2902.68,4154.09,0.15,0
12018,1414,-1000.00,7000.00,8000.00,575.56,8424.44,0.38,0
12019,1414,-1000.00,6000.00,7000.00,3953.68,4046.32,0.08,0
12020,1414,-1000.00,5000.00,6000.00,3094.90,3905.10,0.23,0
12021,1414,-1000.00,4000.00,5000.00,1075.13,4924.87,0.43,0
12022,1414,-1000.00,3000.00,4000.00,764.62,2322.11,0.29,0
12023,1414,-1000.00,2000.00,3000.00,3268.13,731.87,0.19,0
12024,1414,-1000.00,1000.00,2000.00,1456.94,1543.06,0.00,0
12025,1414,-1000.00,0.00,1000.00,69.31,0.00,0.10,0
12026,1414,-1000.00,-1000.00,0.00,0.00,1000.00,0.16,0
12027,1415,-484.78,-484.78,515.22,484.78,0.00,0.03,0
12028,1415,-1000.00,-1484.78,-484.78,0.00,515.22,0.14,0
12029,1416,-1000.00,-1000.00,0.00,0.00,1000.00,0.04,0
12030,1417,-954.33,-954.33,45.67,0.00,954.33,0.18,0
12031,1417,-45.67,-1000.00,-0.00,13.45,32.22,0.36,0
12032,1418,-1000.00,-1000.00,0.00,0.00,1000.00,0.08,0
12033,1419,-1000.00,-1000.00,0.00,110.82,889.18,0.39,0
12034,1420,-1000.00,-1000.00,0.00,0.00,686.60,0.40,0
12035,1421,-1000.00,-1000.00,0.00,0.00,1000.00,0.33,0
12036,1422,-1000.00,-1000.00,0.00,224.41,775.59,0.40,0
12037,1423,1000.00,1000.00,2000.00,0.00,546.85,0.31,1
12038,1423,1000.00,2000.00,3000.00,0.00,2000.00,0.36,1
12039,1423,1000.00,3000.00,4000.00,1198.79,1801.21,0.23,1
12040,1423,1000.00,4000.00,5000.00,257.02,3742.98,0.25,1
12041,1423,1000.00,5000.00,6000.00,0.00,5000.00,0.20,1
12042,1423,1000.00,6000.00,7000.00,813.71,5186.29,0.01,1
12043,1423,1000.00,7000.00,8000.00,2984.37,4015.63,0.11,1
12044,1423,1000.00,8000.00,9000.00,0.00,8000.00,0.30,1
12045,1423,-1000.00,7000.00,8000.00,5101.99,3898.01,0.16,0
12046,1423,1000.00,8000.00,9000.00,0.00,6898.62,0.42,1
12047,1423,1000.00,9000.00,10000.00,0.00,4430.11,0.09,1
12048,1423,1000.00,10000.00,11000.00,1841.31,8158.69,0.19,1
12049,1423,1000.00,11000.00,12000.00,4171.79,6828.21,0.15,1
12050,1423,1000.00,12000.00,13000.00,6000.00,6000.00,0.03,1
12051,1423,-1000.00,11000.00,12000.00,2962.22,0.00,0.02,0
12052,1423,1000.00,12000.00,13000.00,0.00,12000.00,0.10,1
12053,1423,1000.00,13000.00,14000.00,6042.67,6957.33,0.25,1
12054,1423,1000.00,14000.00,15000.00,0.00,4213.18,0.14,1
12055,1423,-1000.00,13000.00,14000.00,3215.27,0.00,0.11,0
12056,1423,1000.00,14000.00,15000.00,0.00,7657.69,0.32,1
12057,1423,1000.00,15000.00,16000.00,4986.70,10013.30,0.33,1
12058,1423,-1000.00,14000.00,15000.00,4681.83,2448.32,0.11,0
12059,1423,-1000.00,13000.00,14000.00,9821.62,5178.38,0.09,0
12060,1423,1000.00,14000.00,15000.00,0.00,7437.18,0.25,1
12061,1423,-1000.00,13000.00,14000.00,15000.00,0.00,0.02,0
12062,1423,-1000.00,12000.00,13000.00,7000.00,7000.00,0.01,0
12063,1423,-1000.00,11000.00,12000.00,0.00,9776.58,0.35,0
12064,1423,-1000.00,10000.00,11000.00,0.00,9957.13,0.39,0
12065,1423,-1000.00,9000.00,10000.00,153.26,8840.69,0.33,0
12066,1423,-1000.00,8000.00,9000.00,0.00,10000.00,0.20,0
12067,1423,-1000.00,7000.00,8000.00,312.40,8687.60,0.42,0
12068,1423,-1000.00,6000.00,7000.00,6098.46,655.35,0.25,0
12069,1423,0.00,6000.00,7000.00,0.00,0.00,0.00,0
12070,1423,-1000.00,5000.00,6000.00,0.00,7000.00,0.15,0
12071,1423,-1000.00,4000.00,5000.00,394.60,3733.98,0.37,0
12072,1423,-1000.00,3000.00,4000.00,962.22,4037.78,0.40,0
12073,1423,-1000.00,2000.00,3000.00,2129.18,1870.82,0.18,0
12074,1423,-1000.00,1000.00,2000.00,301.52,2698.48,0.11,0
12075,1423,-1000.00,0.00,1000.00,1000.00,1000.00,0.08,0
12076,1423,-1000.00,-1000.00,0.00,427.59,572.41,0.39,0
12077,1424,-1000.00,-1000.00,0.00,154.80,830.82,0.41,0
12078,1425,1000.00,1000.00,2000.00,0.00,1000.00,0.17,1
12079,1425,-1000.00,0.00,1000.00,1913.82,0.00,0.02,0
12080,1425,1000.00,1000.00,2000.00,0.00,1000.00,0.09,1
12081,1425,1000.00,2000.00,3000.00,138.68,1861.32,0.37,1
12082,1425,1000.00,3000.00,4000.00,1234.62,1765.38,0.21,1
12083,1425,1000.00,4000.00,5000.00,0.00,4000.00,0.11,1
12084,1425,1000.00,5000.00,6000.00,1774.15,3225.85,0.32,1
12085,1425,1000.00,6000.00,7000.00,1601.21,4398.79,0.35,1
12086,1425,1000.00,7000.00,8000.00,2461.19,4538.81,0.38,1
12087,1425,1000.00,8000.00,9000.00,1175.86,6824.14,0.27,1
12088,1425,1000.00,9000.00,10000.00,3137.28,4628.96,0.21,1
12089,1425,1000.00,10000.00,11000.00,3413.98,6586.02,0.21,1
12090,1425,1000.00,11000.00,12000.00,2003.57,8996.43,0.35,1
12091,1425,1000.00,12000.00,13000.00,0.00,10988.26,0.39,1
12092,1425,1000.00,13000.00,14000.00,0.00,13000.00,0.27,1
12093,1425,-1000.00,12000.00,13000.00,9787.43,4212.57,0.12,0
12094,1425,1000.00,13000.00,14000.00,6500.00,6500.00,0.02,1
12095,1425,1000.00,14000.00,15000.00,995.21,13004.79,0.19,1
12096,1425,1000.00,15000.00,16000.00,4586.67,10413.33,0.21,1
12097,1425,-1000.00,14000.00,15000.00,15827.89,0.00,0.23,0
12098,1425,-1000.00,13000.00,14000.00,8596.50,6403.50,0.11,0
12099,1425,-1000.00,12000.00,13000.00,14000.00,0.00,0.15,0
12100,1425,-1000.00,11000.00,12000.00,0.00,11793.04,0.16,0
12101,1425,-946.30,10053.70,11053.70,0.00,946.30,0.13,0
12102,1425,-1000.00,9053.70,10053.70,0.00,11053.70,0.31,0
12103,1425,-1000.00,8053.70,9053.70,2496.64,7557.06,0.15,0
12104,1425,-1000.00,7053.70,8053.70,3945.09,5108.61,0.05,0
12105,1425,-1000.00,6053.70,7053.70,2397.44,5656.26,0.11,0
12106,1425,-1000.00,5053.70,6053.70,1572.11,5481.59,0.29,0
12107,1425,-1000.00,4053.70,5053.70,3950.10,2103.59,0.39,0
12108,1425,-1000.00,3053.70,4053.70,1745.77,3307.92,0.31,0
12109,1425,-1000.00,2053.70,3053.70,0.00,2510.49,0.35,0
12110,1425,-1000.00,1053.70,2053.70,990.22,0.00,0.10,0
12111,1425,-1000.00,53.70,1053.70,753.89,1299.80,0.34,0
12112,1425,-1000.00,-946.30,53.70,163.95,889.74,0.26,0
12113,1425,-53.70,-1000.00,0.00,0.00,53.70,0.39,0
12114,1426,-729.05,-729.05,270.95,315.64,413.41,0.26,0
12115,1426,-270.95,-1000.00,0.00,133.81,137.14,0.13,0
12116,1427,-1000.00,-1000.00,0.00,371.59,628.41,0.30,0
12117,1428,-1000.00,-1000.00,0.00,0.00,1000.00,0.27,0
12118,1429,-1000.00,-1000.00,0.00,261.49,738.51,0.22,0
12119,1430,-1000.00,-1000.00,0.00,0.00,1000.00,0.44,0
12120,1431,-1000.00,-1000.00,0.00,489.56,510.44,0.21,0
12121,1432,-1000.00,-1000.00,0.00,139.80,860.20,0.08,0
12122,1433,-1000.00,-1000.00,0.00,286.11,592.39,0.31,0
12123,1434,-1000.00,-1000.00,0.00,280.79,719.21,0.36,0
12124,1435,1000.00,1000.00,2000.00,0.00,1000.00,0.43,1
12125,1435,1000.00,2000.00,3000.00,817.04,1182.96,0.12,1
12126,1435,-780.82,1219.18,2219.18,780.82,0.00,0.07,0
12127,1435,1000.00,2219.18,3219.18,781.85,1437.34,0.33,1
12128,1435,1000.00,3219.18,4219.18,0.00,3219.18,0.20,1
12129,1435,-1000.00,2219.18,3219.18,4219.18,0.00,0.01,0
12130,1435,1000.00,3219.18,4219.18,1451.93,1767.26,0.31,1
12131,1435,-1000.00,2219.18,3219.18,2615.95,1603.23,0.34,0
12132,1435,1000.00,3219.18,4219.18,0.00,2089.70,0.33,1
12133,1435,-1000.00,2219.18,3219.18,2231.85,616.32,0.14,0
12134,1435,-1000.00,1219.18,2219.18,2711.68,507.51,0.03,0
12135,1435,-1000.00,219.18,1219.18,1171.57,1047.62,0.08,0
12136,1435,1000.00,1219.18,2219.18,49.48,1169.70,0.33,1
12137,1435,1000.00,2219.18,3219.18,0.00,2219.18,0.31,1
12138,1435,-1000.00,1219.18,2219.18,1822.16,1397.02,0.17,0
12139,1435,1000.00,2219.18,3219.18,1109.59,1109.59,0.03,1
12140,1435,-1000.00,1219.18,2219.18,2722.59,496.59,0.12,0
12141,1435,1000.00,2219.18,3219.18,385.60,1833.59,0.42,1
12142,1435,-1000.00,1219.18,2219.18,2410.74,293.66,0.39,0
12143,1435,-1000.00,219.18,1219.18,0.00,2219.18,0.36,0
12144,1435,-916.16,-696.98,303.02,0.00,916.16,0.14,0
12145,1435,-303.02,-1000.00,0.00,69.98,233.04,0.39,0
12146,1436,-718.73,-718.73,281.27,167.40,551.34,0.32,0
12147,1436,-281.27,-1000.00,0.00,135.55,145.72,0.13,0
12148,1437,-1000.00,-1000.00,0.00,0.00,1000.00,0.37,0
12149,1438,-1000.00,-1000.00,0.00,270.92,729.08,0.36,0
12150,1439,1000.00,1000.00,2000.00,324.57,675.43,0.32,1
12151,1439,1000.00,2000.00,3000.00,363.03,1636.97,0.41,1
12152,1439,1000.00,3000.00,4000.00,0.00,3000.00,0.02,1
12153,1439,1000.00,4000.00,5000.00,879.95,3120.05,0.13,1
12154,1439,1000.00,5000.00,6000.00,1835.63,2200.24,0.24,1
12155,1439,1000.00,6000.00,7000.00,2642.20,3357.80,0.16,1
12156,1439,1000.00,7000.00,8000.00,2785.97,4214.03,0.20,1
12157,1439,1000.00,8000.00,9000.00,2246.03,5753.97,0.15,1
12158,1439,-1000.00,7000.00,8000.00,4906.08,4093.92,0.19,0
12159,1439,1000.00,8000.00,9000.00,0.00,2898.03,0.23,1
12160,1439,-1000.00,7000.00,8000.00,3885.99,3343.51,0.24,0
12161,1439,1000.00,8000.00,9000.00,3977.87,4022.13,0.41,1
12162,1439,1000.00,9000.00,10000.00,1101.31,7898.69,0.31,1
12163,1439,1000.00,10000.00,11000.00,4495.37,5504.63,0.10,1
12164,1439,1000.00,11000.00,12000.00,5500.00,5500.00,0.38,1
12165,1439,1000.00,12000.00,13000.00,0.00,5706.94,0.27,1
12166,1439,1000.00,13000.00,14000.00,6500.00,6500.00,0.29,1
12167,1439,1000.00,14000.00,15000.00,3504.79,4875.66,0.21,1
12168,1439,-1000.00,13000.00,14000.00,8068.75,6931.25,0.11,0
12169,1439,1000.00,14000.00,15000.00,3895.81,10104.19,0.38,1
12170,1439,1000.00,15000.00,16000.00,1773.06,12377.52,0.42,1
12171,1439,1000.00,16000.00,17000.00,0.00,16000.00,0.06,1
12172,1439,-1000.00,15000.00,16000.00,11154.49,5845.51,0.28,0
12173,1439,-1000.00,14000.00,15000.00,0.00,16000.00,0.28,0
12174,1439,-1000.00,13000.00,14000.00,971.97,14028.03,0.08,0
12175,1439,-1000.00,12000.00,13000.00,0.00,14000.00,0.04,0
12176,1439,-1000.00,11000.00,12000.00,0.00,13000.00,0.05,0
12177,1439,-1000.00,10000.00,11000.00,0.00,12000.00,0.37,0
12178,1439,-1000.00,9000.00,10000.00,2752.67,8247.33,0.36,0
12179,1439,-1000.00,8000.00,9000.00,3301.58,6698.42,0.29,0
12180,1439,-1000.00,7000.00,8000.00,0.00,9000.00,0.03,0
12181,1439,-1000.00,6000.00,7000.00,858.95,6948.72,0.23,0
12182,1439,-1000.00,5000.00,6000.00,3548.94,3451.06,0.19,0
12183,1439,-1000.00,4000.00,5000.00,3000.00,3000.00,0.25,0
12184,1439,-1000.00,3000.00,4000.00,1867.32,3132.68,0.03,0
12185,1439,-1000.00,2000.00,3000.00,367.82,3632.18,0.26,0
12186,1439,-1000.00,1000.00,2000.00,1856.45,0.00,0.04,0
12187,1439,-225.17,774.83,1774.83,0.00,225.17,0.01,0
12188,1439,-878.79,-103.96,896.04,0.00,878.79,0.29,0
12189,1439,-896.04,-1000.00,0.00,0.00,896.04,0.05,0
12190,1440,-996.72,-996.72,3.28,0.00,996.72,0.21,0
12191,1440,-3.06,-999.79,0.21,0.00,3.06,0.30,0
12192,1440,-0.21,-1000.00,0.00,0.02,0.20,0.44,0
12193,1441,-1000.00,-1000.00,0.00,688.32,311.68,0.02,0
12194,1442,-1000.00,-1000.00,0.00,0.00,1000.00,0.42,0
12195,1443,-1000.00,-1000.00,0.00,0.00,191.25,0.11,0
12196,1444,-1000.00,-1000.00,0.00,0.00,915.62,0.22,0
12197,1445,-1000.00,-1000.00,0.00,317.95,0.00,0.08,0
12198,1446,1000.00,1000.00,2000.00,0.00,1000.00,0.04,1
12199,1446,1000.00,2000.00,3000.00,0.00,2000.00,0.20,1
12200,1446,1000.00,3000.00,4000.00,0.00,3000.00,0.25,1
12201,1446,1000.00,4000.00,5000.00,0.00,4000.00,0.13,1
12202,1446,1000.00,5000.00,6000.00,1408.28,3591.72,0.17,1
12203,1446,1000.00,6000.00,7000.00,0.00,6000.00,0.06,1
12204,1446,1000.00,7000.00,8000.00,3220.66,3779.34,0.18,1
12205,1446,1000.00,8000.00,9000.00,1519.85,6480.15,0.35,1
12206,1446,1000.00,9000.00,10000.00,0.00,919.90,0.14,1
12207,1446,1000.00,10000.00,11000.00,0.00,8083.04,0.42,1
12208,1446,1000.00,11000.00,12000.00,2554.96,8445.04,0.28,1
12209,1446,1000.00,12000.00,13000.00,387.36,11612.64,0.33,1
12210,1446,-1000.00,11000.00,12000.00,7321.41,4582.66,0.20,0
12211,1446,1000.00,12000.00,13000.00,0.00,12000.00,0.03,1
12212,1446,1000.00,13000.00,14000.00,2248.26,4657.74,0.24,1
12213,1446,1000.00,14000.00,15000.00,5073.86,8604.65,0.30,1
12214,1446,1000.00,15000.00,16000.00,0.00,15000.00,0.03,1
12215,1446,1000.00,16000.00,17000.00,0.00,14680.36,0.32,1
12216,1446,1000.00,17000.00,18000.00,8500.00,8500.00,0.19,1
12217,1446,1000.00,18000.00,19000.00,4636.90,13363.10,0.30,1
12218,1446,-1000.00,17000.00,18000.00,10049.41,2685.12,0.15,0
12219,1446,1000.00,18000.00,19000.00,0.00,4760.34,0.20,1
12220,1446,1000.00,19000.00,20000.00,0.00,19000.00,0.04,1
12221,1446,-1000.00,18000.00,19000.00,15528.65,4471.35,0.08,0
12222,1446,1000.00,19000.00,20000.00,2869.09,12312.32,0.26,1
12223,1446,1000.00,20000.00,21000.00,2671.93,8842.15,0.28,1
12224,1446,0.00,20000.00,21000.00,0.00,0.00,0.07,0
12225,1446,1000.00,21000.00,22000.00,0.00,9313.69,0.24,1
12226,1446,-1000.00,20000.00,21000.00,13803.69,8196.31,0.24,0
12227,1446,1000.00,21000.00,22000.00,0.00,21000.00,0.21,1
12228,1446,1000.00,22000.00,23000.00,11000.00,11000.00,0.02,1
12229,1446,-1000.00,21000.00,22000.00,12756.53,10243.47,0.20,0
12230,1446,1000.00,22000.00,23000.00,0.00,22000.00,0.00,1
12231,1446,1000.00,23000.00,24000.00,8736.62,14263.38,0.18,1
12232,1446,1000.00,24000.00,25000.00,12000.00,12000.00,0.02,1
12233,1446,1000.00,25000.00,26000.00,0.00,25000.00,0.37,1
12234,1446,1000.00,26000.00,27000.00,0.00,20218.53,0.14,1
12235,1446,1000.00,27000.00,28000.00,1535.95,25464.05,0.13,1
12236,1446,1000.00,28000.00,29000.00,9460.08,18539.92,0.44,1
12237,1446,1000.00,29000.00,30000.00,2313.58,26686.42,0.15,1
12238,1446,1000.00,30000.00,31000.00,0.00,4569.99,0.14,1
12239,1446,1000.00,31000.00,32000.00,0.00,25419.21,0.02,1
12240,1446,-1000.00,30000.00,31000.00,24227.51,7772.49,0.08,0
12241,1446,-1000.00,29000.00,30000.00,11668.60,11218.41,0.21,0
12242,1446,1000.00,30000.00,31000.00,0.00,30000.00,0.07,1
12243,1446,1000.00,31000.00,32000.00,13855.88,17144.12,0.32,1
12244,1446,1000.00,32000.00,33000.00,0.00,32000.00,0.38,1
12245,1446,-1000.00,31000.00,32000.00,14347.50,18652.50,0.29,0
12246,1446,-1000.00,30000.00,31000.00,0.00,19725.07,0.35,0
12247,1446,-1000.00,29000.00,30000.00,0.00,31000.00,0.41,0
12248,1446,-1000.00,28000.00,29000.00,0.00,7866.27,0.21,0
12249,1446,-1000.00,27000.00,28000.00,11991.27,17008.73,0.20,0
12250,1446,-1000.00,26000.00,27000.00,0.00,28000.00,0.18,0
12251,1446,-1000.00,25000.00,26000.00,0.00,4338.01,0.13,0
12252,1446,-1000.00,24000.00,25000.00,26000.00,0.00,0.01,0
12253,1446,-1000.00,23000.00,24000.00,12334.92,12665.08,0.29,0
12254,1446,-1000.00,22000.00,23000.00,0.00,24000.00,0.33,0
12255,1446,-1000.00,21000.00,22000.00,1723.43,21156.02,0.44,0
12256,1446,-1000.00,20000.00,21000.00,5525.76,2293.11,0.14,0
12257,1446,-1000.00,19000.00,20000.00,0.00,21000.00,0.35,0
12258,1446,0.00,19000.00,20000.00,0.00,0.00,0.09,0
12259,1446,-1000.00,18000.00,19000.00,9157.19,10842.81,0.14,0
12260,1446,-1000.00,17000.00,18000.00,0.00,18574.01,0.32,0
12261,1446,-1000.00,16000.00,17000.00,0.00,18000.00,0.14,0
12262,1446,-1000.00,15000.00,16000.00,7046.08,9077.28,0.26,0
12263,1446,-1000.00,14000.00,15000.00,1428.29,5331.26,0.24,0
12264,1446,-1000.00,13000.00,14000.00,0.00,15000.00,0.32,0
12265,1447,0.00,0.00,1000.00,0.00,0.00,0.04,0
12266,1447,-1000.00,-1000.00,0.00,0.00,1000.00,0.08,0
12267,1448,-1000.00,-1000.00,0.00,417.80,582.20,0.20,0
12268,1449,-1000.00,-1000.00,0.00,0.00,1000.00,0.44,0
12269,1450,-1000.00,-1000.00,0.00,0.00,1000.00,0.24,0
12270,1451,-1000.00,-1000.00,0.00,0.00,1000.00,0.07,0
12271,1452,-1000.00,-1000.00,0.00,0.00,1000.00,0.27,0
12272,1453,0.00,0.00,1000.00,0.00,0.00,0.01,0
12273,1453,-1000.00,-1000.00,0.00,560.36,439.64,0.13,0
12274,1454,-969.59,-969.59,30.41,0.00,969.59,0.34,0
12275,1454,0.00,-969.59,30.41,0.00,0.00,0.14,0
12276,1454,-20.76,-990.35,9.65,5.42,15.34,0.40,0
12277,1454,-5.22,-995.57,4.43,0.00,5.22,0.21,0
12278,1454,-1.10,-996.67,3.33,0.00,1.10,0.24,0
12279,1454,733.07,-263.60,736.40,1.86,1.47,0.18,1
12280,1454,-483.10,-746.71,253.29,121.86,361.25,0.39,0
12281,1454,1000.00,253.29,1253.29,128.12,125.17,0.25,1
12282,1454,1000.00,1253.29,2253.29,765.80,487.50,0.13,1
12283,1454,-1000.00,253.29,1253.29,209.38,1812.98,0.18,0
12284,1454,0.00,253.29,1253.29,0.00,0.00,0.33,0
12285,1454,0.00,253.29,1253.29,0.00,0.00,0.36,0
12286,1454,-1000.00,-746.71,253.29,1253.29,0.00,0.04,0
12287,1454,-253.29,-1000.00,0.00,0.00,253.29,0.16,0
12288,1455,-1000.00,-1000.00,0.00,214.17,785.83,0.39,0
12289,1456,0.00,0.00,1000.00,0.00,0.00,0.07,0
12290,1456,-424.54,-424.54,575.46,22.18,402.36,0.27,0
12291,1456,-517.04,-941.59,58.41,113.60,403.44,0.38,0
12292,1456,-58.41,-1000.00,0.00,12.25,46.16,0.39,0
12293,1457,-1000.00,-1000.00,0.00,233.89,757.59,0.38,0
12294,1458,-359.52,-359.52,640.48,0.00,359.52,0.08,0
12295,1458,-640.48,-1000.00,0.00,286.97,353.51,0.20,0
12296,1459,-336.16,-336.16,663.84,161.45,174.71,0.17,0
12297,1459,-663.84,-1000.00,0.00,134.38,529.45,0.40,0
12298,1460,-1000.00,-1000.00,0.00,171.93,828.07,0.24,0
12299,1461,-1000.00,-1000.00,0.00,532.19,467.81,0.11,0
12300,1462,-1000.00,-1000.00,0.00,677.65,322.35,0.17,0
12301,1463,1000.00,1000.00,2000.00,102.35,897.65,0.43,1
12302,1463,1000.00,2000.00,3000.00,994.01,1005.99,0.10,1
12303,1463,1000.00,3000.00,4000.00,164.65,1830.09,0.36,1
12304,1463,1000.00,4000.00,5000.00,632.34,3367.66,0.18,1
12305,1463,-1000.00,3000.00,4000.00,2838.77,2161.23,0.15,0
12306,1463,1000.00,4000.00,5000.00,1582.01,2417.99,0.30,1
12307,1463,1000.00,5000.00,6000.00,0.00,5000.00,0.08,1
12308,1463,1000.00,6000.00,7000.00,0.00,6000.00,0.35,1
12309,1463,-1000.00,5000.00,6000.00,4289.65,521.80,0.13,0
12310,1463,1000.00,6000.00,7000.00,3000.00,3000.00,0.28,1
12311,1463,-1000.00,5000.00,6000.00,2858.64,2108.37,0.18,0
12312,1463,1000.00,6000.00,7000.00,2134.49,2520.47,0.26,1
12313,1463,1000.00,7000.00,8000.00,0.00,6497.36,0.10,1
12314,1463,1000.00,8000.00,9000.00,0.00,3227.37,0.20,1
12315,1463,1000.00,9000.00,10000.00,0.00,9000.00,0.19,1
12316,1463,1000.00,10000.00,11000.00,3924.47,4462.68,0.25,1
12317,1463,1000.00,11000.00,12000.00,0.00,11000.00,0.29,1
12318,1463,1000.00,12000.00,13000.00,0.00,11305.79,0.16,1
12319,1463,1000.00,13000.00,14000.00,4208.23,8791.77,0.30,1
12320,1463,1000.00,14000.00,15000.00,0.00,5107.50,0.17,1
12321,1463,1000.00,15000.00,16000.00,0.00,15000.00,0.13,1
12322,1463,1000.00,16000.00,17000.00,0.00,13379.52,0.03,1
12323,1463,-1000.00,15000.00,16000.00,13758.24,2314.86,0.13,0
12324,1463,1000.00,16000.00,17000.00,0.00,16000.00,0.16,1
12325,1463,-1000.00,15000.00,16000.00,4162.22,0.00,0.20,0
12326,1463,-1000.00,14000.00,15000.00,0.00,13152.06,0.08,0
12327,1463,-1000.00,13000.00,14000.00,6208.77,8791.23,0.37,0
12328,1463,-1000.00,12000.00,13000.00,6696.07,5702.05,0.20,0
12329,1463,-1000.00,11000.00,12000.00,256.04,12743.96,0.25,0
12330,1463,-1000.00,10000.00,11000.00,0.00,12000.00,0.41,0
12331,1463,-1000.00,9000.00,10000.00,961.57,10038.43,0.10,0
12332,1463,-1000.00,8000.00,9000.00,10000.00,0.00,0.02,0
12333,1463,-1000.00,7000.00,8000.00,1546.07,5953.61,0.34,0
12334,1463,-1000.00,6000.00,7000.00,2169.71,5830.29,0.37,0
12335,1463,-1000.00,5000.00,6000.00,4241.42,2758.58,0.03,0
12336,1463,-1000.00,4000.00,5000.00,3000.00,3000.00,0.32,0
12337,1463,-1000.00,3000.00,4000.00,1209.34,3790.66,0.22,0
12338,1463,-1000.00,2000.00,3000.00,1739.13,2260.87,0.08,0
12339,1463,-1000.00,1000.00,2000.00,1236.07,1763.93,0.18,0
12340,1463,-1000.00,0.00,1000.00,0.00,2000.00,0.25,0
12341,1463,-579.53,-579.53,420.47,0.00,579.53,0.35,0
12342,1463,-420.47,-1000.00,0.00,199.83,220.64,0.36,0
12343,1464,-1000.00,-1000.00,0.00,28.87,971.13,0.33,0
12344,1465,1000.00,1000.00,2000.00,0.00,1000.00,0.38,1
12345,1465,-1000.00,0.00,1000.00,1008.97,991.03,0.06,0
12346,1465,1000.00,1000.00,2000.00,0.00,1000.00,0.08,1
12347,1465,1000.00,2000.00,3000.00,1000.00,1000.00,0.07,1
12348,1465,-1000.00,1000.00,2000.00,3000.00,0.00,0.01,0
12349,1465,1000.00,2000.00,3000.00,0.00,2000.00,0.07,1
12350,1465,1000.00,3000.00,4000.00,0.00,1949.18,0.32,1
12351,1465,-1000.00,2000.00,3000.00,1885.14,432.21,0.11,0
12352,1465,1000.00,3000.00,4000.00,0.00,3000.00,0.01,1
12353,1465,1000.00,4000.00,5000.00,0.00,4000.00,0.16,1
12354,1465,-1000.00,3000.00,4000.00,4447.42,552.58,0.14,0
12355,1465,-1000.00,2000.00,3000.00,2088.57,1105.05,0.20,0
12356,1465,1000.00,3000.00,4000.00,520.83,2479.17,0.41,1
12357,1465,-1000.00,2000.00,3000.00,4000.00,0.00,0.01,0
12358,1465,1000.00,3000.00,4000.00,1500.00,1500.00,0.04,1
12359,1465,1000.00,4000.00,5000.00,0.00,4000.00,0.30,1
12360,1465,1000.00,5000.00,6000.00,388.11,3241.91,0.31,1
12361,1465,1000.00,6000.00,7000.00,0.00,6000.00,0.08,1
12362,1465,1000.00,7000.00,8000.00,0.00,2253.10,0.08,1
12363,1465,1000.00,8000.00,9000.00,0.00,4281.24,0.11,1
12364,1465,1000.00,9000.00,10000.00,0.00,1890.53,0.18,1
12365,1465,1000.00,10000.00,11000.00,0.00,2063.00,0.13,1
12366,1465,-1000.00,9000.00,10000.00,6655.14,4344.86,0.37,0
12367,1465,-1000.00,8000.00,9000.00,0.00,4680.69,0.26,0
12368,1465,-1000.00,7000.00,8000.00,0.00,9000.00,0.25,0
12369,1465,-1000.00,6000.00,7000.00,3694.56,4305.44,0.40,0
12370,1465,-1000.00,5000.00,6000.00,0.00,6773.94,0.01,0
12371,1465,-1000.00,4000.00,5000.00,0.00,3529.56,0.03,0
12372,1465,-1000.00,3000.00,4000.00,598.54,4401.46,0.13,0
12373,1465,-1000.00,2000.00,3000.00,1365.12,2634.88,0.32,0
12374,1465,-1000.00,1000.00,2000.00,389.20,1298.39,0.28,0
12375,1465,-1000.00,0.00,1000.00,0.00,1019.93,0.31,0
12376,1465,-1000.00,-1000.00,0.00,500.00,500.00,0.12,0
12377,1466,-1000.00,-1000.00,0.00,197.35,802.65,0.32,0
12378,1467,-1000.00,-1000.00,0.00,451.01,548.99,0.15,0
12379,1467,-0.00,-1000.00,0.00,0.00,0.00,0.16,0
12380,1467,0.00,-1000.00,0.00,0.00,0.00,0.23,1
12381,1467,-0.00,-1000.00,0.00,0.00,0.00,0.42,0
12382,1468,-1000.00,-1000.00,0.00,0.00,1000.00,0.11,0
12383,1469,-1000.00,-1000.00,0.00,75.52,924.48,0.43,0
12384,1470,-1000.00,-1000.00,0.00,494.91,505.09,0.11,0
12385,1471,1000.00,1000.00,2000.00,0.00,636.27,0.37,1
12386,1471,1000.00,2000.00,3000.00,0.00,1000.62,0.24,1
12387,1471,-1000.00,1000.00,2000.00,1266.79,344.09,0.14,0
12388,1471,1000.00,2000.00,3000.00,697.50,1302.50,0.29,1
12389,1471,1000.00,3000.00,4000.00,0.00,3000.00,0.18,1
12390,1471,1000.00,4000.00,5000.00,0.00,1395.54,0.04,1
12391,1471,-1000.00,3000.00,4000.00,1856.30,0.00,0.00,0
12392,1471,1000.00,4000.00,5000.00,0.00,3289.52,0.44,1
12393,1471,1000.00,5000.00,6000.00,0.00,5000.00,0.00,1
12394,1471,1000.00,6000.00,7000.00,0.00,103.99,0.02,1
12395,1471,1000.00,7000.00,8000.00,0.00,1982.66,0.22,1
12396,1471,-1000.00,6000.00,7000.00,5041.85,2958.15,0.42,0
12397,1471,1000.00,7000.00,8000.00,0.00,7000.00,0.12,1
12398,1471,-1000.00,6000.00,7000.00,1564.57,0.00,0.01,0
12399,1471,1000.00,7000.00,8000.00,0.00,7000.00,0.08,1
12400,1471,1000.00,8000.00,9000.00,1513.17,3674.26,0.28,1
12401,1471,1000.00,9000.00,10000.00,4500.00,4500.00,0.37,1
12402,1471,1000.00,10000.00,11000.00,0.00,10000.00,0.28,1
12403,1471,1000.00,11000.00,12000.00,0.00,11000.00,0.36,1
12404,1471,1000.00,12000.00,13000.00,5289.40,6710.60,0.20,1
12405,1471,1000.00,13000.00,14000.00,3798.66,9201.34,0.37,1
12406,1471,1000.00,14000.00,15000.00,0.00,1910.70,0.05,1
12407,1471,-1000.00,13000.00,14000.00,7500.00,7500.00,0.11,0
12408,1471,-1000.00,12000.00,13000.00,0.00,11081.90,0.41,0
12409,1471,-1000.00,11000.00,12000.00,6215.15,6784.85,0.32,0
12410,1471,-1000.00,10000.00,11000.00,7957.76,1394.93,0.09,0
12411,1471,-1000.00,9000.00,10000.00,0.00,11000.00,0.39,0
12412,1471,-1000.00,8000.00,9000.00,4209.72,5790.28,0.16,0
12413,1471,-1000.00,7000.00,8000.00,0.00,8335.44,0.12,0
12414,1471,-1000.00,6000.00,7000.00,3090.32,4909.68,0.28,0
12415,1471,-1000.00,5000.00,6000.00,0.00,7000.00,0.20,0
12416,1471,-1000.00,4000.00,5000.00,1256.52,4743.48,0.21,0
12417,1471,-1000.00,3000.00,4000.00,1632.48,3367.52,0.34,0
12418,1471,-1000.00,2000.00,3000.00,2393.96,1606.04,0.37,0
12419,1471,-1000.00,1000.00,2000.00,354.50,2645.50,0.44,0
12420,1471,-1000.00,0.00,1000.00,0.00,2000.00,0.39,0
12421,1471,-388.88,-388.88,611.12,80.26,308.62,0.23,0
12422,1471,-1000.00,-1388.88,-388.88,345.09,3.08,0.08,0
12423,1472,1000.00,1000.00,2000.00,95.66,904.34,0.29,1
12424,1472,1000.00,2000.00,3000.00,0.00,1744.91,0.40,1
12425,1472,1000.00,3000.00,4000.00,0.00,1892.00,0.16,1
12426,1472,1000.00,4000.00,5000.00,1974.19,2025.81,0.20,1
12427,1472,-1000.00,3000.00,4000.00,3006.35,1891.29,0.26,0
12428,1472,1000.00,4000.00,5000.00,2000.00,2000.00,0.02,1
12429,1472,1000.00,5000.00,6000.00,0.00,5000.00,0.02,1
12430,1472,1000.00,6000.00,7000.00,1598.61,4401.39,0.15,1
12431,1472,1000.00,7000.00,8000.00,2514.66,4485.34,0.44,1
12432,1472,1000.00,8000.00,9000.00,2879.62,5120.38,0.28,1
12433,1472,1000.00,9000.00,10000.00,0.00,9000.00,0.01,1
12434,1472,1000.00,10000.00,11000.00,3218.69,6781.31,0.34,1
12435,1472,1000.00,11000.00,12000.00,5500.00,5500.00,0.04,1
12436,1472,1000.00,12000.00,13000.00,0.00,12000.00,0.12,1
12437,1472,1000.00,13000.00,14000.00,0.00,612.61,0.08,1
12438,1472,1000.00,14000.00,15000.00,0.00,14000.00,0.03,1
12439,1472,0.00,14000.00,15000.00,0.00,0.00,0.12,0
12440,1472,-1000.00,13000.00,14000.00,15000.00,0.00,0.22,0
12441,1472,1000.00,14000.00,15000.00,3884.66,10115.34,0.35,1
12442,1472,1000.00,15000.00,16000.00,0.00,15000.00,0.15,1
12443,1472,1000.00,16000.00,17000.00,3874.98,12125.02,0.31,1
12444,1472,1000.00,17000.00,18000.00,6739.42,10260.58,0.44,1
12445,1472,1000.00,18000.00,19000.00,6227.87,11772.13,0.27,1
12446,1472,-1000.00,17000.00,18000.00,11817.02,7182.98,0.18,0
12447,1472,1000.00,18000.00,19000.00,0.00,18000.00,0.02,1
12448,1472,1000.00,19000.00,20000.00,2316.60,16683.40,0.40,1
12449,1472,1000.00,20000.00,21000.00,0.00,16613.25,0.27,1
12450,1472,-1000.00,19000.00,20000.00,1538.54,0.00,0.10,0
12451,1472,1000.00,20000.00,21000.00,5519.95,14480.05,0.03,1
12452,1472,-1000.00,19000.00,20000.00,21000.00,0.00,0.14,0
12453,1472,0.00,19000.00,20000.00,0.00,0.00,0.01,0
12454,1472,1000.00,20000.00,21000.00,8692.52,11307.48,0.20,1
12455,1472,1000.00,21000.00,22000.00,6937.06,14062.94,0.30,1
12456,1472,1000.00,22000.00,23000.00,11000.00,11000.00,0.15,1
12457,1472,1000.00,23000.00,24000.00,11500.00,11500.00,0.12,1
12458,1472,1000.00,24000.00,25000.00,5585.87,18414.13,0.25,1
12459,1473,1000.00,1000.00,2000.00,77.57,726.12,0.40,1
12460,1473,-1000.00,0.00,1000.00,1382.70,0.00,0.05,0
12461,1473,1000.00,1000.00,2000.00,89.87,689.38,0.27,1
12462,1473,1000.00,2000.00,3000.00,754.56,1245.44,0.23,1
12463,1473,-1000.00,1000.00,2000.00,2025.66,974.34,0.04,0
12464,1473,1000.00,2000.00,3000.00,1000.00,1000.00,0.12,1
12465,1473,-1000.00,1000.00,2000.00,1428.08,981.92,0.20,0
12466,1473,1000.00,2000.00,3000.00,0.00,2000.00,0.17,1
12467,1473,1000.00,3000.00,4000.00,0.00,3000.00,0.25,1
12468,1473,1000.00,4000.00,5000.00,0.00,4000.00,0.12,1
12469,1473,-1000.00,3000.00,4000.00,1879.48,208.38,0.11,0
12470,1473,1000.00,4000.00,5000.00,0.00,1089.77,0.05,1
12471,1473,1000.00,5000.00,6000.00,1849.12,3150.88,0.21,1
12472,1473,1000.00,6000.00,7000.00,2016.16,3983.84,0.30,1
12473,1473,-1000.00,5000.00,6000.00,5645.10,485.14,0.06,0
12474,1473,0.00,5000.00,6000.00,0.00,0.00,0.14,0
12475,1473,1000.00,6000.00,7000.00,0.00,6000.00,0.30,1
12476,1473,-1000.00,5000.00,6000.00,4185.95,2814.05,0.35,0
12477,1473,1000.00,6000.00,7000.00,2009.87,3990.13,0.24,1
12478,1473,1000.00,7000.00,8000.00,2827.67,4172.33,0.09,1
12479,1473,-1000.00,6000.00,7000.00,6659.75,0.00,0.12,0
12480,1473,-1000.00,5000.00,6000.00,752.34,6247.66,0.25,0
12481,1473,-1000.00,4000.00,5000.00,0.00,5291.52,0.42,0
12482,1473,-1000.00,3000.00,4000.00,2500.00,2500.00,0.03,0
12483,1473,-1000.00,2000.00,3000.00,0.00,2911.58,0.34,0
12484,1473,-1000.00,1000.00,2000.00,1435.78,1564.22,0.24,0
12485,1473,-1000.00,0.00,1000.00,0.00,1757.47,0.29,0
12486,1473,-1000.00,-1000.00,0.00,500.00,500.00,0.02,0
12487,1474,1000.00,1000.00,2000.00,0.00,931.65,0.42,1
12488,1474,1000.00,2000.00,3000.00,417.56,1001.43,0.30,1
12489,1474,1000.00,3000.00,4000.00,0.00,3000.00,0.31,1
12490,1474,1000.00,4000.00,5000.00,0.00,4000.00,0.08,1
12491,1474,-1000.00,3000.00,4000.00,0.00,5000.00,0.43,0
12492,1474,-1000.00,2000.00,3000.00,0.00,2189.50,0.17,0
12493,1474,-1000.00,1000.00,2000.00,0.00,3000.00,0.35,0
12494,1474,-1000.00,0.00,1000.00,0.00,1820.66,0.19,0
12495,1474,-1000.00,-1000.00,0.00,367.42,632.58,0.21,0
12496,1475,-1000.00,-1000.00,0.00,0.00,966.35,0.20,0
12497,1476,-964.51,-964.51,35.49,0.00,964.51,0.23,0
12498,1476,-16.17,-980.67,19.33,0.00,16.17,0.24,0
12499,1476,-8.93,-989.61,10.39,0.00,8.93,0.23,0
12500,1476,-10.39,-1000.00,-0.00,2.87,7.53,0.15,0
12501,1477,-1000.00,-1000.00,0.00,0.00,851.18,0.14,0
12502,1478,1000.00,1000.00,2000.00,0.00,1000.00,0.28,1
12503,1478,1000.00,2000.00,3000.00,0.00,994.40,0.31,1
12504,1478,-1000.00,1000.00,2000.00,2750.58,0.00,0.01,0
12505,1478,1000.00,2000.00,3000.00,480.74,1519.26,0.40,1
12506,1478,-1000.00,1000.00,2000.00,1904.50,0.00,0.01,0
12507,1478,-1000.00,0.00,1000.00,1212.59,787.41,0.12,0
12508,1478,-1000.00,-1000.00,0.00,593.42,406.58,0.24,0
12509,1479,-777.39,-777.39,222.61,0.00,777.39,0.38,0
12510,1479,-208.70,-986.08,13.92,7.72,200.97,0.44,0
12511,1479,-13.92,-1000.00,0.00,3.12,10.79,0.39,0
12512,1480,-1000.00,-1000.00,0.00,491.90,508.10,0.12,0
12513,1481,-1000.00,-1000.00,0.00,163.25,836.75,0.34,0
12514,1482,-828.08,-828.08,171.92,0.00,828.08,0.21,0
12515,1482,-84.75,-912.83,87.17,0.00,84.75,0.15,0
12516,1482,1000.00,87.17,1087.17,17.12,0.00,0.38,1
12517,1482,-1000.00,-912.83,87.17,373.65,713.52,0.27,0
12518,1482,-87.17,-1000.00,0.00,0.00,87.17,0.06,0
12519,1483,-1000.00,-1000.00,0.00,847.67,152.33,0.03,0
12520,1484,-1000.00,-1000.00,0.00,0.00,939.17,0.08,0
12521,1485,-1000.00,-1000.00,0.00,0.00,1000.00,0.33,0
12522,1486,-1000.00,-1000.00,0.00,500.00,500.00,0.04,0
12523,1487,-1000.00,-1000.00,0.00,0.00,1000.00,0.33,0
12524,1488,-1000.00,-1000.00,0.00,377.37,622.63,0.26,0
12525,1489,-702.52,-702.52,297.48,0.00,702.52,0.36,0
12526,1489,0.00,-702.52,297.48,0.00,0.00,0.02,0
12527,1489,-941.56,-1644.08,-644.08,235.39,62.09,0.11,0
12528,1490,-706.40,-706.40,293.60,0.00,706.40,0.37,0
12529,1490,-293.60,-1000.00,0.00,146.80,146.80,0.08,0
12530,1491,1000.00,1000.00,2000.00,0.00,1000.00,0.32,1
12531,1491,1000.00,2000.00,3000.00,369.60,1630.40,0.29,1
12532,1491,1000.00,3000.00,4000.00,0.00,3000.00,0.25,1
12533,1491,1000.00,4000.00,5000.00,0.00,330.62,0.11,1
12534,1491,1000.00,5000.00,6000.00,1011.55,3356.49,0.36,1
12535,1491,1000.00,6000.00,7000.00,0.00,6000.00,0.25,1
12536,1491,-1000.00,5000.00,6000.00,4699.62,0.00,0.03,0
12537,1491,1000.00,6000.00,7000.00,1379.37,4620.63,0.21,1
12538,1491,1000.00,7000.00,8000.00,0.00,1915.48,0.20,1
12539,1491,1000.00,8000.00,9000.00,0.00,8000.00,0.23,1
12540,1491,1000.00,9000.00,10000.00,0.00,5426.39,0.36,1
12541,1491,0.00,9000.00,10000.00,0.00,0.00,0.04,0
12542,1491,1000.00,10000.00,11000.00,1989.58,8010.42,0.30,1
12543,1491,1000.00,11000.00,12000.00,0.00,11000.00,0.23,1
12544,1491,1000.00,12000.00,13000.00,6000.00,6000.00,0.06,1
12545,1491,1000.00,13000.00,14000.00,2122.39,10877.61,0.42,1
12546,1491,-1000.00,12000.00,13000.00,9651.47,4348.53,0.10,0
12547,1491,1000.00,13000.00,14000.00,1392.72,11607.28,0.33,1
12548,1491,1000.00,14000.00,15000.00,1079.09,5084.11,0.26,1
12549,1491,-1000.00,13000.00,14000.00,8029.91,6970.09,0.41,0
12550,1491,-1000.00,12000.00,13000.00,782.50,13217.50,0.21,0
12551,1491,-1000.00,11000.00,12000.00,13000.00,0.00,0.01,0
12552,1491,-1000.00,10000.00,11000.00,5307.55,6692.45,0.09,0
12553,1491,-1000.00,9000.00,10000.00,6016.90,0.00,0.05,0
12554,1491,-1000.00,8000.00,9000.00,0.00,10000.00,0.13,0
12555,1491,-1000.00,7000.00,8000.00,0.00,9000.00,0.35,0
12556,1491,-1000.00,6000.00,7000.00,1584.67,6415.33,0.40,0
12557,1491,-1000.00,5000.00,6000.00,2321.34,4678.66,0.24,0
12558,1491,-1000.00,4000.00,5000.00,1802.32,4197.68,0.13,0
12559,1491,-1000.00,3000.00,4000.00,556.41,4443.59,0.41,0
12560,1491,-1000.00,2000.00,3000.00,1182.96,2817.04,0.25,0
12561,1491,-1000.00,1000.00,2000.00,1618.63,1381.37,0.20,0
12562,1491,-1000.00,0.00,1000.00,2000.00,0.00,0.00,0
12563,1491,-1000.00,-1000.00,0.00,0.00,1000.00,0.35,0
12564,1492,-1000.00,-1000.00,0.00,0.00,1000.00,0.14,0
12565,1493,-1000.00,-1000.00,0.00,0.00,1000.00,0.00,0
12566,1494,1000.00,1000.00,2000.00,0.00,544.33,0.33,1
12567,1494,1000.00,2000.00,3000.00,275.47,1724.53,0.42,1
12568,1494,1000.00,3000.00,4000.00,436.03,2563.97,0.22,1
12569,1494,1000.00,4000.00,5000.00,0.00,4000.00,0.35,1
12570,1494,1000.00,5000.00,6000.00,2500.00,2500.00,0.08,1
12571,1494,-1000.00,4000.00,5000.00,1567.26,1526.43,0.19,0
12572,1494,1000.00,5000.00,6000.00,1.67,4998.33,0.10,1
12573,1494,1000.00,6000.00,7000.00,1648.40,4351.60,0.03,1
12574,1494,-1000.00,5000.00,6000.00,4150.91,2849.09,0.32,0
12575,1494,-1000.00,4000.00,5000.00,5402.39,597.61,0.14,0
12576,1494,0.00,4000.00,5000.00,0.00,0.00,0.07,0
12577,1494,1000.00,5000.00,6000.00,0.00,4565.32,0.04,1
12578,1494,-1000.00,4000.00,5000.00,3488.62,2511.38,0.28,0
12579,1494,1000.00,5000.00,6000.00,0.00,5000.00,0.26,1
12580,1494,1000.00,6000.00,7000.00,1665.63,4334.37,0.37,1
12581,1494,1000.00,7000.00,8000.00,2395.18,4604.82,0.04,1
12582,1494,1000.00,8000.00,9000.00,1728.80,1810.96,0.20,1
12583,1494,1000.00,9000.00,10000.00,2567.83,6432.17,0.38,1
12584,1494,1000.00,10000.00,11000.00,4615.96,5384.04,0.09,1
12585,1494,-1000.00,9000.00,10000.00,1126.69,0.00,0.21,0
12586,1494,1000.00,10000.00,11000.00,0.00,1563.37,0.15,1
12587,1494,-1000.00,9000.00,10000.00,9641.31,1358.69,0.18,0
12588,1494,1000.00,10000.00,11000.00,2787.64,7212.36,0.21,1
12589,1494,1000.00,11000.00,12000.00,2612.62,8387.38,0.32,1
12590,1494,-1000.00,10000.00,11000.00,0.00,12000.00,0.01,0
12591,1494,-1000.00,9000.00,10000.00,4665.47,6334.53,0.23,0
12592,1494,-1000.00,8000.00,9000.00,5436.91,4563.09,0.31,0
12593,1494,-1000.00,7000.00,8000.00,4500.00,4500.00,0.04,0
12594,1494,-1000.00,6000.00,7000.00,3994.85,4005.15,0.31,0
12595,1494,-1000.00,5000.00,6000.00,0.00,4741.64,0.24,0
12596,1494,-1000.00,4000.00,5000.00,5528.90,135.66,0.20,0
12597,1494,-1000.00,3000.00,4000.00,2885.74,1827.82,0.25,0
12598,1494,-1000.00,2000.00,3000.00,1656.26,614.60,0.16,0
12599,1494,-1000.00,1000.00,2000.00,592.25,2407.75,0.24,0
12600,1494,-1000.00,0.00,1000.00,995.14,0.00,0.03,0
12601,1494,-1000.00,-1000.00,0.00,485.99,338.90,0.23,0
12602,1495,-1000.00,-1000.00,0.00,0.00,1000.00,0.30,0
12603,1496,-1000.00,-1000.00,0.00,604.46,395.54,0.08,0
12604,1497,-1000.00,-1000.00,0.00,0.00,1000.00,0.35,0
12605,1498,1000.00,1000.00,2000.00,132.95,67.06,0.43,1
12606,1498,1000.00,2000.00,3000.00,1518.82,0.00,0.19,1
12607,1498,1000.00,3000.00,4000.00,2095.61,280.62,0.25,1
12608,1498,-1000.00,2000.00,3000.00,0.00,3547.67,0.08,0
12609,1498,1000.00,3000.00,4000.00,14.06,0.00,0.41,1
12610,1498,1000.00,4000.00,5000.00,1490.51,0.00,0.42,1
12611,1498,0.00,4000.00,5000.00,0.00,0.00,0.00,0
12612,1498,1000.00,5000.00,6000.00,533.47,0.00,0.02,1
12613,1498,0.00,5000.00,6000.00,0.00,0.00,0.03,0
12614,1498,-1000.00,4000.00,5000.00,0.00,2971.74,0.18,0
12615,1498,1000.00,5000.00,6000.00,3606.55,1393.45,0.18,1
12616,1498,0.00,5000.00,6000.00,0.00,0.00,0.08,0
12617,1498,1000.00,6000.00,7000.00,5688.40,311.60,0.01,1
12618,1498,0.00,6000.00,7000.00,0.00,0.00,0.38,0
12619,1498,-1000.00,5000.00,6000.00,2294.69,4705.31,0.10,0
12620,1498,1000.00,6000.00,7000.00,5898.27,101.73,0.33,1
12621,1498,0.00,6000.00,7000.00,0.00,0.00,0.21,0
12622,1498,0.00,6000.00,7000.00,0.00,0.00,0.13,0
12623,1498,1000.00,7000.00,8000.00,4510.43,0.00,0.06,1
12624,1498,0.00,7000.00,8000.00,0.00,0.00,0.24,0
12625,1498,-1000.00,6000.00,7000.00,394.60,7605.40,0.13,0
12626,1498,0.00,6000.00,7000.00,0.00,0.00,0.26,0
12627,1498,0.00,6000.00,7000.00,0.00,0.00,0.40,0
12628,1498,1000.00,7000.00,8000.00,2134.22,0.00,0.20,1
12629,1498,-1000.00,6000.00,7000.00,5380.10,0.00,0.25,0
12630,1498,0.00,6000.00,7000.00,0.00,0.00,0.20,0
12631,1498,-1000.00,5000.00,6000.00,0.00,4332.92,0.17,0
12632,1498,-1000.00,4000.00,5000.00,3128.34,2871.66,0.19,0
12633,1498,-1000.00,3000.00,4000.00,3389.66,0.00,0.14,0
12634,1498,-1000.00,2000.00,3000.00,2224.42,1775.58,0.29,0
12635,1498,-1000.00,1000.00,2000.00,2595.74,404.26,0.11,0
12636,1498,-1000.00,0.00,1000.00,994.82,1005.18,0.22,0
12637,1498,-250.55,-250.55,749.45,250.55,0.00,0.25,0
12638,1498,-164.40,-414.95,585.05,164.40,0.00,0.43,0
12639,1498,-585.05,-1000.00,0.00,337.00,248.05,0.13,0
12640,1499,1000.00,1000.00,2000.00,0.00,517.03,0.31,1
12641,1499,1000.00,2000.00,3000.00,794.96,1205.04,0.19,1
12642,1499,1000.00,3000.00,4000.00,714.87,804.56,0.21,1
12643,1499,1000.00,4000.00,5000.00,1204.34,2795.66,0.35,1
12644,1499,1000.00,5000.00,6000.00,2500.00,2500.00,0.01,1
12645,1499,1000.00,6000.00,7000.00,3000.00,3000.00,0.04,1
12646,1499,1000.00,7000.00,8000.00,549.78,5703.87,0.40,1
12647,1499,1000.00,8000.00,9000.00,1931.50,6068.50,0.39,1
12648,1499,1000.00,9000.00,10000.00,0.00,9000.00,0.12,1
12649,1499,1000.00,10000.00,11000.00,4467.45,5532.55,0.08,1
12650,1499,0.00,10000.00,11000.00,0.00,0.00,0.05,0
12651,1499,1000.00,11000.00,12000.00,0.00,11000.00,0.16,1
12652,1499,1000.00,12000.00,13000.00,0.00,12000.00,0.41,1
12653,1499,1000.00,13000.00,14000.00,3883.02,9116.98,0.27,1
12654,1499,1000.00,14000.00,15000.00,5398.93,8601.07,0.20,1
12655,1499,1000.00,15000.00,16000.00,7500.00,7500.00,0.08,1
12656,1499,1000.00,16000.00,17000.00,4283.55,5399.07,0.24,1
12657,1499,1000.00,17000.00,18000.00,6999.94,10000.06,0.36,1
12658,1499,1000.00,18000.00,19000.00,8646.15,9353.85,0.16,1
12659,1499,-1000.00,17000.00,18000.00,11780.95,7219.05,0.34,0
12660,1499,-1000.00,16000.00,17000.00,5929.65,0.00,0.06,0
12661,1499,1000.00,17000.00,18000.00,5280.39,11719.61,0.34,1
12662,1499,-1000.00,16000.00,17000.00,6001.93,141.05,0.06,0
12663,1499,-1000.00,15000.00,16000.00,4339.16,12660.84,0.37,0
12664,1499,-1000.00,14000.00,15000.00,0.00,11288.58,0.11,0
12665,1499,-1000.00,13000.00,14000.00,0.00,15000.00,0.15,0
12666,1499,-1000.00,12000.00,13000.00,7000.00,7000.00,0.23,0
12667,1499,-1000.00,11000.00,12000.00,0.00,5720.33,0.10,0
12668,1499,-1000.00,10000.00,11000.00,0.00,12000.00,0.26,0
12669,1499,-1000.00,9000.00,10000.00,6751.99,4248.01,0.10,0
12670,1499,-1000.00,8000.00,9000.00,6181.86,3818.14,0.18,0
12671,1499,-1000.00,7000.00,8000.00,1670.04,7329.96,0.28,0
12672,1499,-1000.00,6000.00,7000.00,1125.29,6874.71,0.42,0
12673,1499,-1000.00,5000.00,6000.00,6844.56,155.44,0.02,0
12674,1499,-1000.00,4000.00,5000.00,0.00,2868.92,0.28,0
12675,1499,-1000.00,3000.00,4000.00,0.00,5000.00,0.41,0
12676,1499,-1000.00,2000.00,3000.00,0.00,4000.00,0.38,0
12677,1499,-55.00,1945.00,2945.00,0.00,55.00,0.03,0
12678,1499,-1000.00,945.00,1945.00,894.18,2050.82,0.07,0
12679,1499,-1000.00,-55.00,945.00,558.67,1386.33,0.32,0
12680,1499,-945.00,-1000.00,0.00,377.16,567.84,0.29,0
12681,1500,-1000.00,-1000.00,0.00,0.00,1000.00,0.22,0
12682,1501,-1000.00,-1000.00,0.00,614.72,385.28,0.12,0
12683,1502,-835.55,-835.55,164.45,0.00,835.55,0.15,0
12684,1502,-1000.00,-1835.55,-835.55,98.62,65.83,0.10,0
12685,1503,1000.00,1000.00,2000.00,391.63,360.11,0.24,1
12686,1503,-1000.00,0.00,1000.00,585.26,1414.74,0.37,0
12687,1503,0.00,0.00,1000.00,0.00,0.00,0.00,0
12688,1503,1000.00,1000.00,2000.00,185.21,0.00,0.36,1
12689,1503,1000.00,2000.00,3000.00,983.36,201.80,0.23,1
12690,1503,-1000.00,1000.00,2000.00,0.00,1439.70,0.33,0
12691,1503,-845.64,154.36,1154.36,304.92,540.73,0.28,0
12692,1503,-1000.00,-845.64,154.36,0.00,1154.36,0.19,0
12693,1503,-79.27,-924.91,75.09,0.00,79.27,0.22,0
12694,1503,-50.76,-975.67,24.33,0.00,50.76,0.26,0
12695,1503,-24.33,-1000.00,0.00,11.04,13.30,0.03,0
12696,1504,-661.04,-661.04,338.96,0.00,661.04,0.38,0
12697,1504,-338.96,-1000.00,0.00,0.00,338.96,0.11,0
12698,1505,1000.00,1000.00,2000.00,0.00,1000.00,0.13,1
12699,1505,1000.00,2000.00,3000.00,5.08,637.24,0.23,1
12700,1505,1000.00,3000.00,4000.00,1397.02,1602.98,0.14,1
12701,1505,1000.00,4000.00,5000.00,1278.46,2721.54,0.35,1
12702,1505,1000.00,5000.00,6000.00,2017.67,2982.33,0.19,1
12703,1505,-1000.00,4000.00,5000.00,3404.10,2595.90,0.34,0
12704,1505,1000.00,5000.00,6000.00,869.36,4130.64,0.32,1
12705,1505,1000.00,6000.00,7000.00,0.00,6000.00,0.17,1
12706,1505,1000.00,7000.00,8000.00,0.00,7000.00,0.11,1
12707,1505,-1000.00,6000.00,7000.00,4526.06,3473.94,0.24,0
12708,1505,1000.00,7000.00,8000.00,0.00,7000.00,0.39,1
12709,1505,1000.00,8000.00,9000.00,0.00,8000.00,0.06,1
12710,1505,1000.00,9000.00,10000.00,1817.51,7182.49,0.20,1
12711,1505,0.00,9000.00,10000.00,0.00,0.00,0.06,0
12712,1505,-1000.00,8000.00,9000.00,5258.15,4741.85,0.17,0
12713,1505,1000.00,9000.00,10000.00,262.34,4196.58,0.30,1
12714,1505,1000.00,10000.00,11000.00,0.00,9831.27,0.24,1
12715,1505,1000.00,11000.00,12000.00,0.00,8198.28,0.39,1
12716,1505,1000.00,12000.00,13000.00,1296.16,10703.84,0.41,1
12717,1505,1000.00,13000.00,14000.00,0.00,5851.91,0.10,1
12718,1505,1000.00,14000.00,15000.00,1070.91,6901.92,0.29,1
12719,1505,1000.00,15000.00,16000.00,2271.68,12728.32,0.04,1
12720,1505,1000.00,16000.00,17000.00,0.00,6554.58,0.16,1
12721,1505,1000.00,17000.00,18000.00,992.47,16007.53,0.14,1
12722,1505,1000.00,18000.00,19000.00,9000.00,9000.00,0.12,1
12723,1505,1000.00,19000.00,20000.00,3539.85,15460.15,0.39,1
12724,1505,1000.00,20000.00,21000.00,0.00,4192.59,0.17,1
12725,1505,1000.00,21000.00,22000.00,7367.63,13632.37,0.06,1
12726,1505,1000.00,22000.00,23000.00,763.39,17084.77,0.41,1
12727,1505,1000.00,23000.00,24000.00,1044.92,21955.08,0.19,1
12728,1505,1000.00,24000.00,25000.00,0.00,14775.40,0.18,1
12729,1505,1000.00,25000.00,26000.00,7499.22,17500.78,0.00,1
12730,1505,1000.00,26000.00,27000.00,9216.09,16783.91,0.09,1
12731,1505,-1000.00,25000.00,26000.00,18542.00,8458.00,0.24,0
12732,1505,-1000.00,24000.00,25000.00,13055.82,12944.18,0.07,0
12733,1505,1000.00,25000.00,26000.00,3054.52,11155.79,0.28,1
12734,1505,1000.00,26000.00,27000.00,12788.58,13211.42,0.15,1
12735,1505,-1000.00,25000.00,26000.00,13266.57,7398.69,0.15,0
12736,1505,1000.00,26000.00,27000.00,9241.74,16758.26,0.35,1
12737,1505,1000.00,27000.00,28000.00,13500.00,13500.00,0.14,1
12738,1505,1000.00,28000.00,29000.00,14000.00,14000.00,0.24,1
12739,1505,1000.00,29000.00,30000.00,0.00,11275.25,0.09,1
12740,1505,1000.00,30000.00,31000.00,15000.00,15000.00,0.34,1
12741,1505,1000.00,31000.00,32000.00,5058.48,25941.52,0.26,1
12742,1505,1000.00,32000.00,33000.00,9250.40,22749.60,0.32,1
12743,1505,1000.00,33000.00,34000.00,0.00,33000.00,0.08,1
12744,1505,1000.00,34000.00,35000.00,17000.00,17000.00,0.04,1
12745,1505,1000.00,35000.00,36000.00,13539.51,21460.49,0.43,1
12746,1505,-1000.00,34000.00,35000.00,1466.36,22853.27,0.37,0
12747,1505,0.00,34000.00,35000.00,0.00,0.00,0.07,0
12748,1505,-1000.00,33000.00,34000.00,0.00,35000.00,0.33,0
12749,1505,-1000.00,32000.00,33000.00,0.00,34000.00,0.25,0
12750,1505,0.00,32000.00,33000.00,0.00,0.00,0.00,0
12751,1505,-1000.00,31000.00,32000.00,12015.76,20984.24,0.36,0
12752,1505,-1000.00,30000.00,31000.00,0.00,20299.16,0.32,0
12753,1505,-1000.00,29000.00,30000.00,0.00,31000.00,0.11,0
12754,1505,-1000.00,28000.00,29000.00,15000.00,15000.00,0.25,0
12755,1505,-1000.00,27000.00,28000.00,9953.78,19046.22,0.05,0
12756,1505,-1000.00,26000.00,27000.00,13965.82,14034.18,0.19,0
12757,1505,-1000.00,25000.00,26000.00,11470.75,15529.25,0.18,0
12758,1505,-1000.00,24000.00,25000.00,26000.00,0.00,0.11,0
12759,1505,-1000.00,23000.00,24000.00,9117.17,0.00,0.05,0
12760,1505,-1000.00,22000.00,23000.00,9579.14,14420.86,0.01,0
12761,1505,-1000.00,21000.00,22000.00,5932.26,17067.74,0.08,0
12762,1505,-1000.00,20000.00,21000.00,0.00,2314.32,0.19,0
12763,1505,-1000.00,19000.00,20000.00,0.00,21000.00,0.03,0
12764,1505,-1000.00,18000.00,19000.00,0.00,8663.27,0.03,0
12765,1505,-1000.00,17000.00,18000.00,4088.91,8085.12,0.28,0
12766,1505,-1000.00,16000.00,17000.00,9205.23,8794.77,0.17,0
12767,1505,-1000.00,15000.00,16000.00,6333.77,10666.23,0.16,0
12768,1505,-1000.00,14000.00,15000.00,0.00,15063.83,0.42,0
12769,1506,-1000.00,-1000.00,0.00,38.91,385.92,0.44,0
12770,1507,-1000.00,-1000.00,0.00,74.88,925.12,0.40,0
12771,1508,-1000.00,-1000.00,0.00,0.00,1000.00,0.40,0
12772,1509,1000.00,1000.00,2000.00,232.57,767.43,0.32,1
12773,1509,1000.00,2000.00,3000.00,0.00,2000.00,0.39,1
12774,1509,1000.00,3000.00,4000.00,0.00,3000.00,0.18,1
12775,1509,1000.00,4000.00,5000.00,0.00,3834.57,0.23,1
12776,1509,1000.00,5000.00,6000.00,2500.00,2500.00,0.20,1
12777,1509,1000.00,6000.00,7000.00,0.00,6000.00,0.11,1
12778,1509,1000.00,7000.00,8000.00,1755.08,2703.90,0.17,1
12779,1509,1000.00,8000.00,9000.00,0.00,4443.98,0.43,1
12780,1509,1000.00,9000.00,10000.00,1724.04,7275.96,0.23,1
12781,1509,0.00,9000.00,10000.00,0.00,0.00,0.42,0
12782,1509,1000.00,10000.00,11000.00,5000.00,5000.00,0.00,1
12783,1509,-1000.00,9000.00,10000.00,4450.68,0.00,0.12,0
12784,1509,-1000.00,8000.00,9000.00,7725.61,2274.39,0.40,0
12785,1509,1000.00,9000.00,10000.00,1016.48,7983.52,0.43,1
12786,1509,1000.00,10000.00,11000.00,0.00,278.59,0.30,1
12787,1509,1000.00,11000.00,12000.00,0.00,3530.79,0.25,1
12788,1509,-1000.00,10000.00,11000.00,3712.10,0.00,0.21,0
12789,1509,-1000.00,9000.00,10000.00,5548.39,5451.61,0.35,0
12790,1509,-1000.00,8000.00,9000.00,5825.11,4174.89,0.16,0
12791,1509,1000.00,9000.00,10000.00,2103.01,6896.99,0.31,1
12792,1509,1000.00,10000.00,11000.00,5000.00,5000.00,0.07,1
12793,1509,-1000.00,9000.00,10000.00,9655.01,1344.99,0.12,0
12794,1509,-1000.00,8000.00,9000.00,5688.34,4311.66,0.08,0
12795,1509,1000.00,9000.00,10000.00,0.00,5626.18,0.35,1
12796,1509,-1000.00,8000.00,9000.00,10000.00,0.00,0.25,0
12797,1509,1000.00,9000.00,10000.00,849.27,4964.33,0.33,1
12798,1509,1000.00,10000.00,11000.00,0.00,5269.19,0.19,1
12799,1509,1000.00,11000.00,12000.00,3269.40,7730.60,0.36,1
12800,1509,1000.00,12000.00,13000.00,0.00,12000.00,0.25,1
12801,1509,1000.00,13000.00,14000.00,0.00,13000.00,0.05,1
12802,1509,-1000.00,12000.00,13000.00,9932.56,1957.57,0.09,0
12803,1509,1000.00,13000.00,14000.00,6026.37,6973.63,0.11,1
12804,1509,1000.00,14000.00,15000.00,7000.00,7000.00,0.21,1
12805,1509,-1000.00,13000.00,14000.00,7724.47,7275.53,0.27,0
12806,1509,1000.00,14000.00,15000.00,4278.22,9721.78,0.31,1
12807,1509,-1000.00,13000.00,14000.00,7529.53,7470.47,0.41,0
12808,1509,1000.00,14000.00,15000.00,5537.63,8462.37,0.25,1
12809,1509,1000.00,15000.00,16000.00,509.55,12649.39,0.43,1
12810,1509,-1000.00,14000.00,15000.00,11259.80,4740.20,0.15,0
12811,1509,1000.00,15000.00,16000.00,0.00,1050.53,0.06,1
12812,1509,1000.00,16000.00,17000.00,8000.00,8000.00,0.24,1
12813,1509,1000.00,17000.00,18000.00,0.00,5362.28,0.19,1
12814,1509,1000.00,18000.00,19000.00,0.00,18000.00,0.19,1
12815,1510,1000.00,1000.00,2000.00,0.00,86.80,0.12,1
12816,1510,1000.00,2000.00,3000.00,0.00,2000.00,0.09,1
12817,1510,1000.00,3000.00,4000.00,132.86,1498.70,0.25,1
12818,1510,-1000.00,2000.00,3000.00,2652.82,1347.18,0.01,0
12819,1510,1000.00,3000.00,4000.00,818.30,2181.70,0.30,1
12820,1510,1000.00,4000.00,5000.00,534.97,3465.03,0.41,1
12821,1510,1000.00,5000.00,6000.00,0.00,1960.24,0.16,1
12822,1510,1000.00,6000.00,7000.00,3000.00,3000.00,0.16,1
12823,1510,1000.00,7000.00,8000.00,3099.20,3900.80,0.25,1
12824,1510,-1000.00,6000.00,7000.00,4698.11,3301.89,0.20,0
12825,1510,-1000.00,5000.00,6000.00,2442.59,0.00,0.01,0
12826,1510,1000.00,6000.00,7000.00,3000.00,3000.00,0.16,1
12827,1510,907.40,6907.40,7907.40,0.00,6.09,0.08,1
12828,1510,-1000.00,5907.40,6907.40,4837.25,3070.14,0.13,0
12829,1510,1000.00,6907.40,7907.40,0.00,6125.86,0.30,1
12830,1510,-1000.00,5907.40,6907.40,4125.80,3781.60,0.43,0
12831,1510,1000.00,6907.40,7907.40,2116.48,3815.95,0.33,1
12832,1510,1000.00,7907.40,8907.40,0.00,7468.07,0.08,1
12833,1510,1000.00,8907.40,9907.40,1716.96,7190.44,0.26,1
12834,1510,1000.00,9907.40,10907.40,2796.71,6679.13,0.34,1
12835,1510,1000.00,10907.40,11907.40,2433.07,8474.33,0.40,1
12836,1510,-1000.00,9907.40,10907.40,9122.07,2785.33,0.07,0
12837,1510,1000.00,10907.40,11907.40,5453.70,5453.70,0.26,1
12838,1510,-1000.00,9907.40,10907.40,9354.83,2552.57,0.02,0
12839,1510,1000.00,10907.40,11907.40,4131.67,6775.73,0.29,1
12840,1510,1000.00,11907.40,12907.40,791.17,11116.23,0.39,1
12841,1510,1000.00,12907.40,13907.40,5162.42,7744.98,0.27,1
12842,1510,1000.00,13907.40,14907.40,6953.70,6953.70,0.20,1
12843,1510,1000.00,14907.40,15907.40,7453.70,7453.70,0.07,1
12844,1510,1000.00,15907.40,16907.40,5645.79,10261.61,0.36,1
12845,1510,1000.00,16907.40,17907.40,5984.95,10922.45,0.42,1
12846,1510,1000.00,17907.40,18907.40,0.00,17907.40,0.14,1
12847,1510,1000.00,18907.40,19907.40,8691.74,10215.66,0.43,1
12848,1510,1000.00,19907.40,20907.40,9953.70,9953.70,0.11,1
12849,1510,-1000.00,18907.40,19907.40,10949.15,2237.24,0.11,0
12850,1510,1000.00,19907.40,20907.40,0.00,19907.40,0.34,1
12851,1510,1000.00,20907.40,21907.40,0.00,7153.33,0.07,1
12852,1510,1000.00,21907.40,22907.40,0.00,15184.36,0.13,1
12853,1510,1000.00,22907.40,23907.40,9561.34,13346.06,0.25,1
12854,1510,1000.00,23907.40,24907.40,0.00,11672.38,0.27,1
12855,1510,-1000.00,22907.40,23907.40,15097.33,9810.07,0.20,0
12856,1511,-1000.00,-1000.00,0.00,500.00,500.00,0.01,0
12857,1512,1000.00,1000.00,2000.00,416.32,583.68,0.20,1
12858,1512,1000.00,2000.00,3000.00,238.46,1761.54,0.43,1
12859,1512,1000.00,3000.00,4000.00,3.49,1413.95,0.36,1
12860,1512,-1000.00,2000.00,3000.00,3032.58,509.88,0.07,0
12861,1512,1000.00,3000.00,4000.00,1500.00,1500.00,0.06,1
12862,1512,-1000.00,2000.00,3000.00,3896.94,103.06,0.01,0
12863,1512,1000.00,3000.00,4000.00,1500.00,1500.00,0.18,1
12864,1512,1000.00,4000.00,5000.00,377.37,3622.63,0.41,1
12865,1512,-1000.00,3000.00,4000.00,3762.18,377.21,0.10,0
12866,1512,1000.00,4000.00,5000.00,1863.95,2136.05,0.21,1
12867,1512,1000.00,5000.00,6000.00,1231.78,1816.99,0.23,1
12868,1512,0.00,5000.00,6000.00,0.00,0.00,0.04,0
12869,1512,-1000.00,4000.00,5000.00,3031.37,2968.63,0.16,0
12870,1512,-1000.00,3000.00,4000.00,2530.18,2469.82,0.02,0
12871,1512,-1000.00,2000.00,3000.00,1774.43,516.29,0.17,0
12872,1512,1000.00,3000.00,4000.00,507.85,2492.15,0.42,1
12873,1512,1000.00,4000.00,5000.00,0.00,4000.00,0.13,1
12874,1512,-1000.00,3000.00,4000.00,2256.24,0.00,0.25,0
12875,1512,1000.00,4000.00,5000.00,1401.65,2598.35,0.42,1
12876,1512,0.00,4000.00,5000.00,0.00,0.00,0.00,0
12877,1512,-1000.00,3000.00,4000.00,4916.28,83.72,0.02,0
12878,1512,-1000.00,2000.00,3000.00,1543.34,2456.66,0.01,0
12879,1512,-1000.00,1000.00,2000.00,1996.48,541.53,0.10,0
12880,1512,-1000.00,0.00,1000.00,613.83,1386.17,0.19,0
12881,1512,-1000.00,-1000.00,0.00,61.50,938.50,0.42,0
12882,1513,1000.00,1000.00,2000.00,0.00,54.42,0.09,1
12883,1513,1000.00,2000.00,3000.00,0.00,2000.00,0.26,1
12884,1513,0.00,2000.00,3000.00,0.00,0.00,0.06,0
12885,1513,1000.00,3000.00,4000.00,0.00,2269.29,0.31,1
12886,1513,1000.00,4000.00,5000.00,0.00,4000.00,0.25,1
12887,1513,0.00,4000.00,5000.00,0.00,0.00,0.03,0
12888,1513,1000.00,5000.00,6000.00,846.41,4153.59,0.29,1
12889,1513,-1000.00,4000.00,5000.00,3645.51,2354.49,0.30,0
12890,1513,-1000.00,3000.00,4000.00,2854.89,1744.75,0.19,0
12891,1513,-1000.00,2000.00,3000.00,2800.71,1199.29,0.20,0
12892,1513,1000.00,3000.00,4000.00,786.84,2213.16,0.06,1
12893,1513,1000.00,4000.00,5000.00,2000.00,2000.00,0.26,1
12894,1513,1000.00,5000.00,6000.00,1791.84,3208.16,0.28,1
12895,1513,1000.00,6000.00,7000.00,2975.66,3024.34,0.16,1
12896,1513,1000.00,7000.00,8000.00,458.85,6541.15,0.14,1
12897,1513,-1000.00,6000.00,7000.00,2803.82,0.00,0.08,0
12898,1513,1000.00,7000.00,8000.00,2108.50,4891.50,0.31,1
12899,1513,1000.00,8000.00,9000.00,3016.82,4983.18,0.42,1
12900,1513,1000.00,9000.00,10000.00,0.00,9000.00,0.40,1
12901,1513,1000.00,10000.00,11000.00,0.00,10000.00,0.30,1
12902,1513,1000.00,11000.00,12000.00,2842.18,8157.82,0.29,1
12903,1513,-1000.00,10000.00,11000.00,9779.24,2220.76,0.15,0
12904,1513,-1000.00,9000.00,10000.00,5656.27,5343.73,0.40,0
12905,1513,1000.00,10000.00,11000.00,0.00,10000.00,0.24,1
12906,1513,1000.00,11000.00,12000.00,125.54,10874.46,0.34,1
12907,1513,1000.00,12000.00,13000.00,0.00,12000.00,0.13,1
12908,1513,1000.00,13000.00,14000.00,4134.21,8865.79,0.40,1
12909,1513,1000.00,14000.00,15000.00,5967.27,8032.73,0.41,1
12910,1513,1000.00,15000.00,16000.00,0.00,15000.00,0.04,1
12911,1513,1000.00,16000.00,17000.00,8000.00,8000.00,0.15,1
12912,1513,1000.00,17000.00,18000.00,8076.70,8923.30,0.36,1
12913,1513,1000.00,18000.00,19000.00,9000.00,9000.00,0.07,1
12914,1513,1000.00,19000.00,20000.00,8804.25,10195.75,0.13,1
12915,1513,1000.00,20000.00,21000.00,2548.72,17451.28,0.35,1
12916,1513,1000.00,21000.00,22000.00,0.00,21000.00,0.12,1
12917,1513,-1000.00,20000.00,21000.00,8881.53,2951.27,0.13,0
12918,1513,1000.00,21000.00,22000.00,8812.56,12187.44,0.18,1
12919,1513,1000.00,22000.00,23000.00,3306.85,18693.15,0.33,1
12920,1513,1000.00,23000.00,24000.00,0.00,22454.01,0.40,1
12921,1513,1000.00,24000.00,25000.00,0.00,24000.00,0.36,1
12922,1513,1000.00,25000.00,26000.00,6046.26,18953.74,0.43,1
12923,1513,1000.00,26000.00,27000.00,4183.62,21816.38,0.32,1
12924,1513,1000.00,27000.00,28000.00,13125.09,13874.91,0.38,1
12925,1513,1000.00,28000.00,29000.00,12089.71,15910.29,0.19,1
12926,1513,0.00,28000.00,29000.00,0.00,0.00,0.05,0
12927,1513,-1000.00,27000.00,28000.00,16404.25,12595.75,0.20,0
12928,1514,-1000.00,-1000.00,0.00,161.55,838.45,0.42,0
12929,1515,-947.05,-947.05,52.95,287.91,659.14,0.36,0
12930,1515,-11.67,-958.72,41.28,0.00,11.67,0.11,0
12931,1515,-41.28,-1000.00,0.00,0.00,41.28,0.32,0
12932,1516,1000.00,1000.00,2000.00,85.17,914.83,0.02,1
12933,1516,1000.00,2000.00,3000.00,102.40,1897.60,0.38,1
12934,1516,-1000.00,1000.00,2000.00,1554.06,1445.94,0.32,0
12935,1516,-1000.00,0.00,1000.00,1069.47,930.53,0.17,0
12936,1516,1000.00,1000.00,2000.00,244.14,755.86,0.23,1
12937,1516,1000.00,2000.00,3000.00,480.91,1519.09,0.35,1
12938,1516,1000.00,3000.00,4000.00,0.00,2347.22,0.41,1
12939,1516,1000.00,4000.00,5000.00,504.17,3495.83,0.41,1
12940,1516,1000.00,5000.00,6000.00,2036.80,2963.20,0.16,1
12941,1516,-1000.00,4000.00,5000.00,3634.76,2238.02,0.43,0
12942,1516,-1000.00,3000.00,4000.00,2962.95,1518.22,0.14,0
12943,1516,1000.00,4000.00,5000.00,534.05,1307.57,0.23,1
12944,1516,1000.00,5000.00,6000.00,469.17,4281.75,0.43,1
12945,1516,1000.00,6000.00,7000.00,1447.52,4552.48,0.30,1
12946,1516,1000.00,7000.00,8000.00,2051.57,4948.43,0.40,1
12947,1516,1000.00,8000.00,9000.00,2597.72,5068.60,0.37,1
12948,1516,1000.00,9000.00,10000.00,2886.52,6113.48,0.28,1
12949,1516,1000.00,10000.00,11000.00,2447.13,7552.87,0.11,1
12950,1516,1000.00,11000.00,12000.00,0.00,4746.42,0.24,1
12951,1516,-1000.00,10000.00,11000.00,6865.81,5134.19,0.13,0
12952,1516,1000.00,11000.00,12000.00,1282.20,9717.80,0.34,1
12953,1516,1000.00,12000.00,13000.00,3965.97,8034.03,0.25,1
12954,1516,1000.00,13000.00,14000.00,0.00,10182.89,0.27,1
12955,1516,-1000.00,12000.00,13000.00,4190.10,0.00,0.41,0
12956,1516,-1000.00,11000.00,12000.00,7773.32,5226.68,0.10,0
12957,1516,1000.00,12000.00,13000.00,3131.10,8868.90,0.27,1
12958,1516,-1000.00,11000.00,12000.00,0.00,13000.00,0.24,0
12959,1516,-1000.00,10000.00,11000.00,2938.19,9061.81,0.08,0
12960,1516,-1000.00,9000.00,10000.00,11000.00,0.00,0.38,0
12961,1516,0.00,9000.00,10000.00,0.00,0.00,0.27,0
12962,1516,-716.93,8283.07,9283.07,716.93,0.00,0.36,0
12963,1516,-1000.00,7283.07,8283.07,9283.07,0.00,0.20,0
12964,1516,-1000.00,6283.07,7283.07,0.00,4011.62,0.27,0
12965,1516,-1000.00,5283.07,6283.07,4107.49,3175.59,0.08,0
12966,1516,-1000.00,4283.07,5283.07,2773.47,0.00,0.01,0
12967,1516,-1000.00,3283.07,4283.07,0.00,5283.07,0.10,0
12968,1516,-1000.00,2283.07,3283.07,1581.10,1760.56,0.34,0
12969,1516,0.00,2283.07,3283.07,0.00,0.00,0.06,0
12970,1516,-1000.00,1283.07,2283.07,0.00,3141.08,0.42,0
12971,1516,-1000.00,283.07,1283.07,1080.93,1202.15,0.30,0
12972,1516,-1000.00,-716.93,283.07,148.57,1134.50,0.30,0
12973,1516,-1000.00,-1716.93,-716.93,0.00,283.07,0.35,0
12974,1517,1000.00,1000.00,2000.00,0.00,1000.00,0.33,1
12975,1517,-1000.00,0.00,1000.00,1226.71,773.29,0.15,0
12976,1517,1000.00,1000.00,2000.00,310.98,689.02,0.19,1
12977,1517,1000.00,2000.00,3000.00,1000.00,1000.00,0.26,1
12978,1517,1000.00,3000.00,4000.00,0.00,1577.57,0.18,1
12979,1517,1000.00,4000.00,5000.00,1256.80,2743.20,0.39,1
12980,1517,1000.00,5000.00,6000.00,1879.65,3120.35,0.11,1
12981,1517,-1000.00,4000.00,5000.00,5079.77,372.17,0.05,0
12982,1517,1000.00,5000.00,6000.00,1172.30,3827.70,0.28,1
12983,1517,-1000.00,4000.00,5000.00,3826.65,1154.43,0.18,0
12984,1517,1000.00,5000.00,6000.00,1392.85,3607.15,0.31,1
12985,1517,1000.00,6000.00,7000.00,3000.00,3000.00,0.03,1
12986,1517,1000.00,7000.00,8000.00,0.00,7000.00,0.06,1
12987,1517,1000.00,8000.00,9000.00,1802.97,4472.26,0.32,1
12988,1517,1000.00,9000.00,10000.00,0.00,9000.00,0.09,1
12989,1517,-1000.00,8000.00,9000.00,10000.00,0.00,0.19,0
12990,1517,-1000.00,7000.00,8000.00,0.00,9000.00,0.07,0
12991,1517,-1000.00,6000.00,7000.00,0.00,8000.00,0.13,0
12992,1517,-1000.00,5000.00,6000.00,0.00,7000.00,0.20,0
12993,1517,-1000.00,4000.00,5000.00,3000.00,3000.00,0.29,0
12994,1517,-1000.00,3000.00,4000.00,1738.85,3261.15,0.31,0
12995,1517,-1000.00,2000.00,3000.00,2000.00,2000.00,0.04,0
12996,1517,-1000.00,1000.00,2000.00,0.00,1024.58,0.24,0
12997,1517,-1000.00,0.00,1000.00,1101.20,898.80,0.23,0
12998,1517,-254.75,-254.75,745.25,0.00,254.75,0.21,0
12999,1517,-745.25,-1000.00,0.00,296.09,449.16,0.07,0
13000,1518,-1000.00,-1000.00,0.00,0.00,1000.00,0.42,0
13001,1519,0.00,0.00,1000.00,0.00,0.00,0.04,0
13002,1519,-581.36,-581.36,418.64,0.00,581.36,0.15,0
13003,1519,-418.64,-1000.00,0.00,1.11,417.53,0.37,0
13004,1520,-759.24,-759.24,240.76,83.90,675.34,0.38,0
13005,1520,-235.03,-994.27,5.73,0.00,235.03,0.44,0
13006,1520,-5.73,-1000.00,0.00,0.00,5.73,0.19,0
13007,1521,1000.00,1000.00,2000.00,684.78,315.22,0.08,1
13008,1521,-1000.00,0.00,1000.00,0.00,2000.00,0.28,0
13009,1521,-1000.00,-1000.00,0.00,35.71,964.29,0.38,0
13010,1522,-1000.00,-1000.00,0.00,0.00,1000.00,0.31,0
13011,1523,-1000.00,-1000.00,0.00,214.47,785.53,0.40,0
13012,1523,-0.00,-1000.00,0.00,0.00,0.00,0.39,0
13013,1523,-0.00,-1000.00,0.00,0.00,0.00,0.18,0
13014,1523,-0.00,-1000.00,-0.00,0.00,0.00,0.35,0
13015,1524,-1000.00,-1000.00,0.00,317.55,682.45,0.34,0
13016,1525,-1000.00,-1000.00,0.00,681.54,119.81,0.08,0
13017,1526,-1000.00,-1000.00,0.00,574.70,425.30,0.02,0
13018,1527,-1000.00,-1000.00,0.00,318.08,681.92,0.34,0
13019,1528,1000.00,1000.00,2000.00,0.00,752.65,0.26,1
13020,1528,1000.00,2000.00,3000.00,0.00,2000.00,0.27,1
13021,1528,1000.00,3000.00,4000.00,0.00,1835.41,0.33,1
13022,1528,-1000.00,2000.00,3000.00,3529.03,470.97,0.02,0
13023,1528,1000.00,3000.00,4000.00,1347.50,1652.50,0.17,1
13024,1528,1000.00,4000.00,5000.00,1941.81,2058.19,0.01,1
13025,1528,1000.00,5000.00,6000.00,0.00,4678.37,0.42,1
13026,1528,1000.00,6000.00,7000.00,2839.81,3160.19,0.15,1
13027,1528,1000.00,7000.00,8000.00,0.00,7000.00,0.09,1
13028,1528,-1000.00,6000.00,7000.00,3153.73,1813.28,0.16,0
13029,1528,1000.00,7000.00,8000.00,2703.39,4296.61,0.22,1
13030,1528,1000.00,8000.00,9000.00,2617.07,5382.93,0.42,1
13031,1528,1000.00,9000.00,10000.00,2985.89,6014.11,0.41,1
13032,1528,1000.00,10000.00,11000.00,0.00,1440.00,0.15,1
13033,1528,-1000.00,9000.00,10000.00,5587.62,5412.38,0.16,0
13034,1528,1000.00,10000.00,11000.00,0.00,10000.00,0.25,1
13035,1528,-1000.00,9000.00,10000.00,7343.46,3656.54,0.04,0
13036,1528,1000.00,10000.00,11000.00,0.00,10000.00,0.15,1
13037,1528,1000.00,11000.00,12000.00,3534.52,6640.17,0.31,1
13038,1528,1000.00,12000.00,13000.00,1786.05,8727.00,0.40,1
13039,1528,1000.00,13000.00,14000.00,0.00,13000.00,0.07,1
13040,1528,1000.00,14000.00,15000.00,3956.60,10043.40,0.24,1
13041,1528,1000.00,15000.00,16000.00,0.00,14680.34,0.44,1
13042,1528,1000.00,16000.00,17000.00,4472.18,11527.82,0.35,1
13043,1528,1000.00,17000.00,18000.00,3682.43,13317.57,0.38,1
13044,1528,-1000.00,16000.00,17000.00,11173.19,6826.81,0.04,0
13045,1528,1000.00,17000.00,18000.00,0.00,17000.00,0.02,1
13046,1528,1000.00,18000.00,19000.00,7916.80,9503.53,0.26,1
13047,1528,1000.00,19000.00,20000.00,8119.56,10880.44,0.13,1
13048,1528,-1000.00,18000.00,19000.00,19137.43,0.00,0.01,0
13049,1528,-1000.00,17000.00,18000.00,15886.53,3107.54,0.06,0
13050,1528,1000.00,18000.00,19000.00,3616.53,14383.47,0.10,1
13051,1528,1000.00,19000.00,20000.00,9343.15,9656.85,0.23,1
13052,1528,1000.00,20000.00,21000.00,0.00,20000.00,0.42,1
13053,1528,1000.00,21000.00,22000.00,0.00,21000.00,0.41,1
13054,1528,-445.50,20554.50,21554.50,445.50,0.00,0.03,0
13055,1528,1000.00,21554.50,22554.50,6775.97,14778.53,0.32,1
13056,1528,1000.00,22554.50,23554.50,9243.87,13310.63,0.27,1
13057,1528,1000.00,23554.50,24554.50,0.00,23554.50,0.26,1
13058,1528,1000.00,24554.50,25554.50,12277.25,12277.25,0.04,1
13059,1528,1000.00,25554.50,26554.50,12777.25,12777.25,0.41,1
13060,1528,1000.00,26554.50,27554.50,9106.26,11816.06,0.25,1
13061,1528,1000.00,27554.50,28554.50,13777.25,13777.25,0.00,1
13062,1529,-329.03,-329.03,670.97,205.14,123.89,0.14,0
13063,1529,1000.00,670.97,1670.97,0.00,670.97,0.20,1
13064,1529,1000.00,1670.97,2670.97,218.43,1452.54,0.31,1
13065,1529,1000.00,2670.97,3670.97,1196.06,1474.91,0.19,1
13066,1529,1000.00,3670.97,4670.97,1571.53,2099.44,0.24,1
13067,1529,1000.00,4670.97,5670.97,0.00,4670.97,0.10,1
13068,1529,1000.00,5670.97,6670.97,0.00,5670.97,0.33,1
13069,1529,1000.00,6670.97,7670.97,3335.48,3335.48,0.02,1
13070,1529,1000.00,7670.97,8670.97,0.00,7670.97,0.20,1
13071,1529,-1000.00,6670.97,7670.97,7035.46,0.00,0.05,0
13072,1529,-1000.00,5670.97,6670.97,3944.40,3726.57,0.33,0
13073,1529,1000.00,6670.97,7670.97,538.63,6132.34,0.44,1
13074,1529,0.00,6670.97,7670.97,0.00,0.00,0.34,0
13075,1529,1000.00,7670.97,8670.97,0.00,7670.97,0.10,1
13076,1529,1000.00,8670.97,9670.97,0.00,3551.06,0.26,1
13077,1529,1000.00,9670.97,10670.97,1159.33,8511.64,0.40,1
13078,1529,0.00,9670.97,10670.97,0.00,0.00,0.05,0
13079,1529,1000.00,10670.97,11670.97,0.00,10670.97,0.08,1
13080,1529,1000.00,11670.97,12670.97,0.00,1046.57,0.13,1
13081,1529,1000.00,12670.97,13670.97,0.00,7311.58,0.29,1
13082,1529,1000.00,13670.97,14670.97,3828.09,9842.88,0.37,1
13083,1529,-1000.00,12670.97,13670.97,9288.44,5382.53,0.24,0
13084,1529,1000.00,13670.97,14670.97,0.00,13670.97,0.31,1
13085,1529,1000.00,14670.97,15670.97,4140.33,6211.65,0.28,1
13086,1529,-1000.00,13670.97,14670.97,4079.88,2007.44,0.19,0
13087,1529,-1000.00,12670.97,13670.97,0.00,14670.97,0.03,0
13088,1529,-1000.00,11670.97,12670.97,0.00,13670.97,0.26,0
13089,1529,-1000.00,10670.97,11670.97,0.00,12121.86,0.07,0
13090,1529,-1000.00,9670.97,10670.97,3843.09,7827.88,0.21,0
13091,1529,-1000.00,8670.97,9670.97,4669.26,2654.66,0.16,0
13092,1529,0.00,8670.97,9670.97,0.00,0.00,0.04,0
13093,1529,-1000.00,7670.97,8670.97,4835.48,4835.48,0.12,0
13094,1529,-1000.00,6670.97,7670.97,4431.89,4239.08,0.20,0
13095,1529,-1000.00,5670.97,6670.97,761.57,6909.40,0.34,0
13096,1529,-1000.00,4670.97,5670.97,0.00,3853.95,0.27,0
13097,1529,-1000.00,3670.97,4670.97,2339.71,3331.26,0.29,0
13098,1529,-1000.00,2670.97,3670.97,1719.05,2108.02,0.30,0
13099,1529,-1000.00,1670.97,2670.97,0.00,1470.85,0.16,0
13100,1529,-1000.00,670.97,1670.97,623.34,1822.97,0.38,0
13101,1529,-1000.00,-329.03,670.97,0.00,1399.64,0.17,0
13102,1529,-606.75,-935.79,64.21,0.00,606.75,0.43,0
13103,1529,-64.21,-1000.00,0.00,10.99,53.22,0.29,0
13104,1530,-558.00,-558.00,442.00,0.00,558.00,0.28,0
13105,1530,-442.00,-1000.00,0.00,0.00,442.00,0.42,0
13106,1531,-1000.00,-1000.00,0.00,706.33,293.67,0.05,0
13107,1532,-1000.00,-1000.00,0.00,344.30,655.70,0.22,0
13108,1533,-1000.00,-1000.00,0.00,553.67,32.06,0.08,0
13109,1534,-720.19,-720.19,279.81,0.00,720.19,0.28,0
13110,1534,-279.81,-1000.00,0.00,120.17,159.64,0.23,0
13111,1535,-254.48,-254.48,745.52,0.00,254.48,0.07,0
13112,1535,-745.52,-1000.00,0.00,306.65,438.87,0.17,0
13113,1536,-1000.00,-1000.00,0.00,0.00,1000.00,0.09,0
13114,1537,-1000.00,-1000.00,0.00,0.00,1000.00,0.01,0
13115,1538,-400.72,-400.72,599.28,0.00,400.72,0.26,0
13116,1538,-233.84,-634.56,365.44,94.55,139.29,0.19,0
13117,1538,-365.44,-1000.00,0.00,0.00,365.44,0.37,0
13118,1539,-611.61,-611.61,388.39,0.00,611.61,0.17,0
13119,1539,-388.39,-1000.00,0.00,0.00,388.39,0.25,0
13120,1540,-1000.00,-1000.00,0.00,0.00,1000.00,0.07,0
13121,1541,-818.46,-818.46,181.54,327.67,490.79,0.27,0
13122,1541,-175.01,-993.48,6.52,0.00,175.01,0.33,0
13123,1541,-3.76,-997.24,2.76,0.00,3.76,0.25,0
13124,1541,-199.78,-1197.02,-197.02,1.39,1.37,0.35,0
13125,1542,-1000.00,-1000.00,0.00,17.08,793.92,0.42,0
13126,1543,-1000.00,-1000.00,0.00,293.64,706.36,0.34,0
13127,1544,-1000.00,-1000.00,0.00,505.02,494.98,0.04,0
13128,1545,-1000.00,-1000.00,0.00,0.00,1000.00,0.01,0
13129,1546,-88.62,-88.62,911.38,88.62,0.00,0.00,0
13130,1546,1000.00,911.38,1911.38,7.30,226.65,0.20,1
13131,1546,1000.00,1911.38,2911.38,0.00,1911.38,0.03,1
13132,1546,0.00,1911.38,2911.38,0.00,0.00,0.03,0
13133,1546,1000.00,2911.38,3911.38,1455.69,1455.69,0.10,1
13134,1546,1000.00,3911.38,4911.38,1670.81,2240.56,0.26,1
13135,1546,1000.00,4911.38,5911.38,1619.63,3291.75,0.30,1
13136,1546,1000.00,5911.38,6911.38,1776.39,2062.84,0.25,1
13137,1546,-1000.00,4911.38,5911.38,5470.50,1440.88,0.04,0
13138,1546,1000.00,5911.38,6911.38,0.00,2973.84,0.19,1
13139,1546,-1000.00,4911.38,5911.38,4337.46,2573.92,0.09,0
13140,1546,1000.00,5911.38,6911.38,2361.56,3549.82,0.24,1
13141,1546,1000.00,6911.38,7911.38,2057.72,4853.66,0.25,1
13142,1546,1000.00,7911.38,8911.38,1565.10,6346.28,0.41,1
13143,1546,1000.00,8911.38,9911.38,3122.98,5788.40,0.22,1
13144,1546,1000.00,9911.38,10911.38,3416.66,6494.72,0.25,1
13145,1546,1000.00,10911.38,11911.38,4491.61,6419.77,0.22,1
13146,1546,1000.00,11911.38,12911.38,3095.16,7035.71,0.35,1
13147,1546,1000.00,12911.38,13911.38,0.00,12911.38,0.17,1
13148,1546,-1000.00,11911.38,12911.38,8745.02,0.00,0.02,0
13149,1546,-1000.00,10911.38,11911.38,1397.10,11514.28,0.14,0
13150,1546,-1000.00,9911.38,10911.38,0.00,7633.68,0.08,0
13151,1546,-1000.00,8911.38,9911.38,4059.26,6852.12,0.30,0
13152,1546,-1000.00,7911.38,8911.38,0.00,9911.38,0.10,0
13153,1546,-1000.00,6911.38,7911.38,4642.84,4268.54,0.12,0
13154,1546,-1000.00,5911.38,6911.38,5598.87,1790.87,0.10,0
13155,1546,-1000.00,4911.38,5911.38,3361.31,3550.07,0.02,0
13156,1546,-1000.00,3911.38,4911.38,980.76,4930.62,0.41,0
13157,1546,-1000.00,2911.38,3911.38,0.00,1289.27,0.25,0
13158,1546,-1000.00,1911.38,2911.38,0.00,3911.38,0.04,0
13159,1546,-1000.00,911.38,1911.38,1628.56,1282.82,0.40,0
13160,1546,-1000.00,-88.62,911.38,1041.04,870.34,0.12,0
13161,1546,-209.02,-297.64,702.36,44.54,164.48,0.17,0
13162,1546,-702.36,-1000.00,0.00,144.74,557.62,0.23,0
13163,1547,1000.00,1000.00,2000.00,99.97,900.03,0.14,1
13164,1547,1000.00,2000.00,3000.00,0.00,2000.00,0.06,1
13165,1547,1000.00,3000.00,4000.00,1476.07,1523.93,0.26,1
13166,1547,1000.00,4000.00,5000.00,0.00,4000.00,0.16,1
13167,1547,1000.00,5000.00,6000.00,2278.39,2721.61,0.24,1
13168,1547,1000.00,6000.00,7000.00,1025.24,4974.76,0.41,1
13169,1547,1000.00,7000.00,8000.00,1298.40,5701.60,0.17,1
13170,1547,1000.00,8000.00,9000.00,0.00,5368.98,0.38,1
13171,1547,1000.00,9000.00,10000.00,0.00,9000.00,0.31,1
13172,1547,1000.00,10000.00,11000.00,3486.42,6513.58,0.12,1
13173,1547,1000.00,11000.00,12000.00,0.00,11000.00,0.43,1
13174,1547,-1000.00,10000.00,11000.00,3335.01,0.00,0.07,0
13175,1547,1000.00,11000.00,12000.00,2278.88,8721.12,0.40,1
13176,1547,1000.00,12000.00,13000.00,1121.26,4309.97,0.25,1
13177,1547,-1000.00,11000.00,12000.00,10285.82,2714.18,0.06,0
13178,1547,1000.00,12000.00,13000.00,0.00,11387.23,0.42,1
13179,1547,1000.00,13000.00,14000.00,3322.24,9677.76,0.29,1
13180,1547,-1000.00,12000.00,13000.00,8705.11,5294.89,0.27,0
13181,1547,1000.00,13000.00,14000.00,0.00,13000.00,0.16,1
13182,1547,1000.00,14000.00,15000.00,6225.37,7774.63,0.38,1
13183,1547,1000.00,15000.00,16000.00,0.00,15000.00,0.03,1
13184,1547,1000.00,16000.00,17000.00,6673.03,9326.97,0.41,1
13185,1547,1000.00,17000.00,18000.00,0.00,17000.00,0.19,1
13186,1547,1000.00,18000.00,19000.00,6327.35,11672.65,0.31,1
13187,1547,-1000.00,17000.00,18000.00,0.00,13160.23,0.38,0
13188,1547,-1000.00,16000.00,17000.00,6441.21,10607.53,0.29,0
13189,1547,-1000.00,15000.00,16000.00,0.00,6365.09,0.12,0
13190,1547,-1000.00,14000.00,15000.00,6523.06,3236.54,0.15,0
13191,1547,-1000.00,13000.00,14000.00,7500.00,7500.00,0.03,0
13192,1547,-1000.00,12000.00,13000.00,4167.42,9832.58,0.35,0
13193,1547,-1000.00,11000.00,12000.00,0.00,2698.33,0.17,0
13194,1547,-1000.00,10000.00,11000.00,4546.12,7453.88,0.25,0
13195,1547,-1000.00,9000.00,10000.00,5500.00,5500.00,0.02,0
13196,1547,-1000.00,8000.00,9000.00,0.00,10000.00,0.41,0
13197,1547,-1000.00,7000.00,8000.00,3261.02,5738.98,0.20,0
13198,1547,-1000.00,6000.00,7000.00,1447.95,6552.05,0.07,0
13199,1547,-1000.00,5000.00,6000.00,4336.88,2663.12,0.06,0
13200,1547,-1000.00,4000.00,5000.00,0.00,4345.32,0.37,0
13201,1547,-1000.00,3000.00,4000.00,0.00,4455.93,0.24,0
13202,1547,-1000.00,2000.00,3000.00,703.70,3296.30,0.00,0
13203,1547,-1000.00,1000.00,2000.00,1839.41,1160.59,0.30,0
13204,1547,-1000.00,0.00,1000.00,450.20,1549.80,0.33,0
13205,1547,-1000.00,-1000.00,0.00,0.00,1000.00,0.37,0
13206,1548,1000.00,1000.00,2000.00,48.69,0.00,0.05,1
13207,1548,-1000.00,0.00,1000.00,0.00,2000.00,0.03,0
13208,1548,0.00,0.00,1000.00,0.00,0.00,0.09,0
13209,1548,1000.00,1000.00,2000.00,326.36,49.76,0.38,1
13210,1548,-1000.00,0.00,1000.00,863.57,1011.87,0.22,0
13211,1548,1000.00,1000.00,2000.00,772.37,227.63,0.11,1
13212,1548,1000.00,2000.00,3000.00,346.73,0.00,0.05,1
13213,1548,1000.00,3000.00,4000.00,3000.00,0.00,0.00,1
13214,1548,-1000.00,2000.00,3000.00,0.00,1475.65,0.37,0
13215,1548,1000.00,3000.00,4000.00,1514.94,1485.06,0.06,1
13216,1548,1000.00,4000.00,5000.00,2562.08,1437.92,0.27,1
13217,1548,0.00,4000.00,5000.00,0.00,0.00,0.14,0
13218,1548,0.00,4000.00,5000.00,0.00,0.00,0.32,0
13219,1548,-1000.00,3000.00,4000.00,995.19,4004.81,0.27,0
13220,1548,-1000.00,2000.00,3000.00,0.00,1331.93,0.35,0
13221,1548,-1000.00,1000.00,2000.00,0.00,2068.71,0.23,0
13222,1548,1000.00,2000.00,3000.00,1158.41,470.94,0.27,1
13223,1548,-1000.00,1000.00,2000.00,0.00,3000.00,0.11,0
13224,1548,-517.44,482.56,1482.56,0.00,517.44,0.35,0
13225,1548,-990.28,-507.72,492.28,0.00,990.28,0.25,0
13226,1548,-289.44,-797.16,202.84,289.44,0.00,0.24,0
13227,1548,-1000.00,-1797.16,-797.16,0.00,141.58,0.29,0
13228,1549,1000.00,1000.00,2000.00,0.00,640.26,0.37,1
13229,1549,0.00,1000.00,2000.00,0.00,0.00,0.04,0
13230,1549,1000.00,2000.00,3000.00,0.00,790.11,0.16,1
13231,1549,-1000.00,1000.00,2000.00,1878.84,1121.16,0.41,0
13232,1549,1000.00,2000.00,3000.00,486.52,1513.48,0.04,1
13233,1549,1000.00,3000.00,4000.00,0.00,3000.00,0.16,1
13234,1549,1000.00,4000.00,5000.00,0.00,4000.00,0.29,1
13235,1549,1000.00,5000.00,6000.00,0.00,5000.00,0.25,1
13236,1549,1000.00,6000.00,7000.00,0.00,6000.00,0.40,1
13237,1549,-1000.00,5000.00,6000.00,4431.76,0.00,0.09,0
13238,1549,1000.00,6000.00,7000.00,1279.73,4087.04,0.37,1
13239,1549,1000.00,7000.00,8000.00,3169.96,3830.04,0.20,1
13240,1549,1000.00,8000.00,9000.00,3827.08,4172.92,0.12,1
13241,1549,1000.00,9000.00,10000.00,3365.46,3536.14,0.22,1
13242,1549,1000.00,10000.00,11000.00,4224.61,5775.39,0.22,1
13243,1549,1000.00,11000.00,12000.00,0.00,6889.20,0.25,1
13244,1549,-1000.00,10000.00,11000.00,5766.31,4687.89,0.23,0
13245,1549,-1000.00,9000.00,10000.00,4304.25,3280.57,0.21,0
13246,1549,1000.00,10000.00,11000.00,2101.05,7898.95,0.39,1
13247,1549,1000.00,11000.00,12000.00,4443.88,6556.12,0.29,1
13248,1549,1000.00,12000.00,13000.00,0.00,5932.43,0.33,1
13249,1549,-1000.00,11000.00,12000.00,4755.69,4.70,0.10,0
13250,1549,1000.00,12000.00,13000.00,0.00,12000.00,0.14,1
13251,1549,1000.00,13000.00,14000.00,737.13,7474.97,0.34,1
13252,1549,-1000.00,12000.00,13000.00,9658.13,4341.87,0.13,0
13253,1549,-1000.00,11000.00,12000.00,4855.70,8144.30,0.29,0
13254,1549,-1000.00,10000.00,11000.00,6000.00,6000.00,0.20,0
13255,1549,-1000.00,9000.00,10000.00,5500.00,5500.00,0.23,0
13256,1549,-1000.00,8000.00,9000.00,374.00,9626.00,0.37,0
13257,1549,-1000.00,7000.00,8000.00,174.28,5881.10,0.38,0
13258,1549,-1000.00,6000.00,7000.00,2987.29,5012.71,0.34,0
13259,1549,-1000.00,5000.00,6000.00,0.00,7000.00,0.03,0
13260,1549,-1000.00,4000.00,5000.00,0.00,3874.03,0.34,0
13261,1549,-1000.00,3000.00,4000.00,2978.10,0.00,0.28,0
13262,1549,-1000.00,2000.00,3000.00,725.36,1042.93,0.17,0
13263,1549,-1000.00,1000.00,2000.00,0.00,3000.00,0.31,0
13264,1549,-1000.00,0.00,1000.00,0.00,1147.66,0.32,0
13265,1549,-1000.00,-1000.00,0.00,31.32,968.68,0.44,0
13266,1550,-1000.00,-1000.00,0.00,366.27,633.73,0.26,0
13267,1551,-1000.00,-1000.00,0.00,241.10,758.90,0.21,0
13268,1551,-0.00,-1000.00,-0.00,0.00,0.00,0.12,0
13269,1552,-1000.00,-1000.00,0.00,0.00,217.14,0.12,0
13270,1553,-1000.00,-1000.00,0.00,282.26,554.48,0.35,0
13271,1554,1000.00,1000.00,2000.00,208.76,791.24,0.40,1
13272,1554,1000.00,2000.00,3000.00,858.56,1141.44,0.15,1
13273,1554,1000.00,3000.00,4000.00,501.08,2498.92,0.40,1
13274,1554,0.00,3000.00,4000.00,0.00,0.00,0.04,0
13275,1554,0.00,3000.00,4000.00,0.00,0.00,0.02,0
13276,1554,1000.00,4000.00,5000.00,2000.00,2000.00,0.08,1
13277,1554,-1000.00,3000.00,4000.00,2705.14,2294.86,0.35,0
13278,1554,1000.00,4000.00,5000.00,641.60,3358.40,0.31,1
13279,1554,1000.00,5000.00,6000.00,2500.00,2500.00,0.14,1
13280,1554,1000.00,6000.00,7000.00,0.00,6000.00,0.37,1
13281,1554,1000.00,7000.00,8000.00,154.71,570.35,0.14,1
13282,1554,1000.00,8000.00,9000.00,0.00,8000.00,0.06,1
13283,1554,1000.00,9000.00,10000.00,0.00,9000.00,0.44,1
13284,1554,1000.00,10000.00,11000.00,0.00,10000.00,0.40,1
13285,1554,1000.00,11000.00,12000.00,1141.74,9858.26,0.43,1
13286,1554,1000.00,12000.00,13000.00,6000.00,6000.00,0.35,1
13287,1554,1000.00,13000.00,14000.00,0.00,13000.00,0.24,1
13288,1554,1000.00,14000.00,15000.00,0.00,14000.00,0.15,1
13289,1554,1000.00,15000.00,16000.00,0.00,5891.08,0.27,1
13290,1554,1000.00,16000.00,17000.00,0.00,16000.00,0.01,1
13291,1554,1000.00,17000.00,18000.00,8500.00,8500.00,0.26,1
13292,1554,1000.00,18000.00,19000.00,8307.86,9692.14,0.30,1
13293,1554,1000.00,19000.00,20000.00,0.00,19000.00,0.33,1
13294,1554,1000.00,20000.00,21000.00,0.00,20000.00,0.17,1
13295,1554,-1000.00,19000.00,20000.00,7093.15,13906.85,0.30,0
13296,1554,-1000.00,18000.00,19000.00,0.00,20000.00,0.15,0
13297,1554,-1000.00,17000.00,18000.00,2031.18,16968.82,0.11,0
13298,1554,-1000.00,16000.00,17000.00,6715.43,11284.57,0.13,0
13299,1554,-1000.00,15000.00,16000.00,2214.59,0.00,0.06,0
13300,1554,-1000.00,14000.00,15000.00,2632.77,13367.23,0.43,0
13301,1554,-1000.00,13000.00,14000.00,8633.42,6366.58,0.11,0
13302,1554,-1000.00,12000.00,13000.00,6303.30,7696.70,0.21,0
13303,1554,-1000.00,11000.00,12000.00,949.80,9873.12,0.41,0
13304,1554,-1000.00,10000.00,11000.00,2886.07,9113.93,0.40,0
13305,1554,-1000.00,9000.00,10000.00,4552.83,6447.17,0.07,0
13306,1554,-1000.00,8000.00,9000.00,3618.33,6381.67,0.17,0
13307,1554,-1000.00,7000.00,8000.00,1540.81,0.00,0.07,0
13308,1554,-1000.00,6000.00,7000.00,0.00,8000.00,0.35,0
13309,1554,-1000.00,5000.00,6000.00,2909.11,4090.89,0.05,0
13310,1554,-1000.00,4000.00,5000.00,0.00,3656.78,0.13,0
13311,1554,-1000.00,3000.00,4000.00,0.00,2746.36,0.38,0
13312,1554,-1000.00,2000.00,3000.00,0.00,3738.65,0.22,0
13313,1554,-1000.00,1000.00,2000.00,0.00,3000.00,0.20,0
13314,1554,-1000.00,0.00,1000.00,921.66,1078.34,0.40,0
13315,1554,-1000.00,-1000.00,0.00,1000.00,0.00,0.02,0
13316,1555,0.00,0.00,1000.00,0.00,0.00,0.06,0
13317,1555,-1000.00,-1000.00,0.00,54.91,945.09,0.38,0
13318,1556,-1000.00,-1000.00,0.00,523.07,476.93,0.20,0
13319,1557,1000.00,1000.00,2000.00,0.00,953.54,0.12,1
13320,1557,1000.00,2000.00,3000.00,880.05,936.05,0.23,1
13321,1557,1000.00,3000.00,4000.00,0.00,3000.00,0.27,1
13322,1557,1000.00,4000.00,5000.00,1289.52,2710.48,0.38,1
13323,1557,1000.00,5000.00,6000.00,2067.44,2932.56,0.27,1
13324,1557,1000.00,6000.00,7000.00,1641.32,4358.68,0.27,1
13325,1557,1000.00,7000.00,8000.00,0.00,6642.72,0.41,1
13326,1557,1000.00,8000.00,9000.00,0.00,4409.27,0.11,1
13327,1557,-1000.00,7000.00,8000.00,1583.19,192.53,0.11,0
13328,1557,1000.00,8000.00,9000.00,0.00,3584.59,0.26,1
13329,1557,-1000.00,7000.00,8000.00,9000.00,0.00,0.06,0
13330,1557,1000.00,8000.00,9000.00,0.00,5920.89,0.39,1
13331,1557,-1000.00,7000.00,8000.00,4931.52,4068.48,0.41,0
13332,1557,1000.00,8000.00,9000.00,3648.26,4351.74,0.16,1
13333,1557,1000.00,9000.00,10000.00,3422.84,5577.16,0.17,1
13334,1557,-1000.00,8000.00,9000.00,10000.00,0.00,0.00,0
13335,1557,1000.00,9000.00,10000.00,2462.50,6537.50,0.30,1
13336,1557,1000.00,10000.00,11000.00,5000.00,5000.00,0.03,1
13337,1557,1000.00,11000.00,12000.00,0.00,2566.59,0.12,1
13338,1557,1000.00,12000.00,13000.00,5506.68,6493.32,0.30,1
13339,1557,1000.00,13000.00,14000.00,3578.20,9421.80,0.37,1
13340,1557,-1000.00,12000.00,13000.00,2700.70,0.00,0.02,0
13341,1557,1000.00,13000.00,14000.00,1301.22,8520.89,0.37,1
13342,1557,-1000.00,12000.00,13000.00,6606.63,1293.97,0.10,0
13343,1557,-1000.00,11000.00,12000.00,6588.70,6411.30,0.06,0
13344,1557,1000.00,12000.00,13000.00,0.00,7627.50,0.17,1
13345,1557,1000.00,13000.00,14000.00,0.00,13000.00,0.31,1
13346,1557,1000.00,14000.00,15000.00,2633.20,11366.80,0.37,1
13347,1557,1000.00,15000.00,16000.00,4723.69,8220.83,0.31,1
13348,1557,1000.00,16000.00,17000.00,0.00,14789.46,0.32,1
13349,1557,1000.00,17000.00,18000.00,7688.83,9311.17,0.27,1
13350,1557,1000.00,18000.00,19000.00,0.00,10596.15,0.29,1
13351,1557,1000.00,19000.00,20000.00,0.00,10497.90,0.06,1
13352,1557,1000.00,20000.00,21000.00,0.00,20000.00,0.04,1
13353,1557,1000.00,21000.00,22000.00,9414.68,11585.32,0.32,1
13354,1557,1000.00,22000.00,23000.00,6088.33,15911.67,0.23,1
13355,1557,1000.00,23000.00,24000.00,0.00,23000.00,0.11,1
13356,1557,1000.00,24000.00,25000.00,0.00,24000.00,0.12,1
13357,1557,1000.00,25000.00,26000.00,0.00,16683.45,0.37,1
13358,1557,1000.00,26000.00,27000.00,13000.00,13000.00,0.26,1
13359,1557,1000.00,27000.00,28000.00,11800.44,15199.56,0.40,1
13360,1557,1000.00,28000.00,29000.00,0.00,28000.00,0.02,1
13361,1557,1000.00,29000.00,30000.00,14500.00,14500.00,0.29,1
13362,1558,-532.70,-532.70,467.30,0.00,532.70,0.18,0
13363,1558,-1000.00,-1532.70,-532.70,221.32,0.00,0.08,0
13364,1559,-1000.00,-1000.00,0.00,444.26,555.74,0.25,0
13365,1560,-1000.00,-1000.00,0.00,591.07,116.22,0.09,0
13366,1561,0.00,0.00,1000.00,0.00,0.00,0.08,0
13367,1561,-1000.00,-1000.00,0.00,280.29,719.71,0.27,0
13368,1562,-1000.00,-1000.00,0.00,268.69,731.31,0.37,0
13369,1563,-1000.00,-1000.00,0.00,0.00,1000.00,0.21,0
13370,1564,-1000.00,-1000.00,0.00,21.51,978.49,0.43,0
13371,1565,-1000.00,-1000.00,0.00,1000.00,0.00,0.01,0
13372,1566,-501.60,-501.60,498.40,0.00,501.60,0.26,0
13373,1566,-498.40,-1000.00,0.00,116.73,381.67,0.39,0
13374,1567,-1000.00,-1000.00,0.00,245.52,754.48,0.37,0
13375,1568,-1000.00,-1000.00,0.00,328.05,671.95,0.22,0
13376,1569,-616.95,-616.95,383.05,0.00,616.95,0.31,0
13377,1569,-383.05,-1000.00,0.00,132.43,250.62,0.28,0
13378,1570,-1000.00,-1000.00,0.00,459.33,540.67,0.01,0
13379,1571,0.00,0.00,1000.00,0.00,0.00,0.07,0
13380,1571,-1000.00,-1000.00,0.00,0.00,1000.00,0.36,0
13381,1572,-1000.00,-1000.00,0.00,355.67,644.33,0.02,0
13382,1573,-1000.00,-1000.00,0.00,222.84,777.16,0.30,0
13383,1574,1000.00,1000.00,2000.00,0.00,1000.00,0.03,1
13384,1574,1000.00,2000.00,3000.00,696.31,1303.69,0.24,1
13385,1574,1000.00,3000.00,4000.00,156.17,1724.09,0.10,1
13386,1574,1000.00,4000.00,5000.00,0.00,4000.00,0.05,1
13387,1574,-1000.00,3000.00,4000.00,3826.18,1173.82,0.22,0
13388,1574,1000.00,4000.00,5000.00,0.00,4000.00,0.08,1
13389,1574,1000.00,5000.00,6000.00,2452.71,2547.29,0.07,1
13390,1574,1000.00,6000.00,7000.00,0.00,3287.37,0.02,1
13391,1574,-1000.00,5000.00,6000.00,4367.19,2632.81,0.29,0
13392,1574,1000.00,6000.00,7000.00,1387.00,4613.00,0.22,1
13393,1574,1000.00,7000.00,8000.00,0.00,7000.00,0.28,1
13394,1574,1000.00,8000.00,9000.00,0.00,8000.00,0.10,1
13395,1574,1000.00,9000.00,10000.00,2439.33,6560.67,0.32,1
13396,1574,1000.00,10000.00,11000.00,0.00,10000.00,0.06,1
13397,1574,1000.00,11000.00,12000.00,5500.00,5500.00,0.18,1
13398,1574,1000.00,12000.00,13000.00,6000.00,6000.00,0.19,1
13399,1574,-1000.00,11000.00,12000.00,2599.49,0.00,0.06,0
13400,1574,1000.00,12000.00,13000.00,5536.64,6463.36,0.28,1
13401,1574,1000.00,13000.00,14000.00,0.00,13000.00,0.28,1
13402,1574,1000.00,14000.00,15000.00,0.00,620.37,0.08,1
13403,1574,-1000.00,13000.00,14000.00,7856.85,7143.15,0.13,0
13404,1574,1000.00,14000.00,15000.00,5238.22,8761.78,0.11,1
13405,1574,1000.00,15000.00,16000.00,1051.64,13948.36,0.32,1
13406,1574,1000.00,16000.00,17000.00,8000.00,8000.00,0.02,1
13407,1574,1000.00,17000.00,18000.00,0.00,17000.00,0.35,1
13408,1574,1000.00,18000.00,19000.00,6613.58,11386.42,0.28,1
13409,1574,1000.00,19000.00,20000.00,0.00,18542.48,0.32,1
13410,1574,1000.00,20000.00,21000.00,129.09,10462.58,0.32,1
13411,1574,0.00,20000.00,21000.00,0.00,0.00,0.02,0
13412,1574,1000.00,21000.00,22000.00,8007.98,12992.02,0.15,1
13413,1574,-1000.00,20000.00,21000.00,3123.50,0.00,0.08,0
13414,1574,1000.00,21000.00,22000.00,0.00,21000.00,0.28,1
13415,1574,1000.00,22000.00,23000.00,0.00,22000.00,0.14,1
13416,1574,-1000.00,21000.00,22000.00,12011.90,10988.10,0.20,0
13417,1574,1000.00,22000.00,23000.00,0.00,11421.32,0.30,1
13418,1574,-1000.00,21000.00,22000.00,12836.06,10163.94,0.39,0
13419,1574,1000.00,22000.00,23000.00,9620.35,12379.65,0.37,1
13420,1574,-1000.00,21000.00,22000.00,15056.85,7943.15,0.26,0
13421,1574,1000.00,22000.00,23000.00,9467.02,12532.98,0.27,1
13422,1574,1000.00,23000.00,24000.00,4145.19,18854.81,0.21,1
13423,1574,1000.00,24000.00,25000.00,12000.00,12000.00,0.23,1
13424,1574,1000.00,25000.00,26000.00,0.00,9163.73,0.09,1
13425,1574,1000.00,26000.00,27000.00,0.00,24601.73,0.25,1
13426,1574,1000.00,27000.00,28000.00,13500.00,13500.00,0.43,1
13427,1574,1000.00,28000.00,29000.00,0.00,22102.24,0.39,1
13428,1575,-1000.00,-1000.00,0.00,0.00,1000.00,0.08,0
13429,1576,-1000.00,-1000.00,0.00,0.00,1000.00,0.44,0
13430,1577,-897.52,-897.52,102.48,593.16,304.36,0.14,0
13431,1577,1000.00,102.48,1102.48,0.00,54.35,0.31,1
13432,1577,1000.00,1102.48,2102.48,46.96,1055.52,0.25,1
13433,1577,1000.00,2102.48,3102.48,0.00,640.42,0.20,1
13434,1577,-1000.00,1102.48,2102.48,1384.45,1284.98,0.21,0
13435,1577,1000.00,2102.48,3102.48,665.37,1437.11,0.33,1
13436,1577,1000.00,3102.48,4102.48,0.00,3102.48,0.21,1
13437,1577,1000.00,4102.48,5102.48,1256.32,2846.16,0.44,1
13438,1577,1000.00,5102.48,6102.48,0.00,5102.48,0.40,1
13439,1577,1000.00,6102.48,7102.48,636.67,5465.81,0.05,1
13440,1577,-1000.00,5102.48,6102.48,5185.91,1916.57,0.01,0
13441,1577,1000.00,6102.48,7102.48,0.00,6025.42,0.23,1
13442,1577,1000.00,7102.48,8102.48,0.00,705.36,0.15,1
13443,1577,1000.00,8102.48,9102.48,0.00,7643.30,0.01,1
13444,1577,1000.00,9102.48,10102.48,3933.43,5169.05,0.24,1
13445,1577,1000.00,10102.48,11102.48,4283.16,5819.32,0.16,1
13446,1577,1000.00,11102.48,12102.48,5551.24,5551.24,0.19,1
13447,1577,1000.00,12102.48,13102.48,3036.54,9065.94,0.18,1
13448,1577,1000.00,13102.48,14102.48,4037.80,9064.69,0.36,1
13449,1577,-1000.00,12102.48,13102.48,9083.30,5019.19,0.30,0
13450,1577,1000.00,13102.48,14102.48,0.00,13102.48,0.19,1
13451,1577,1000.00,14102.48,15102.48,1500.43,12602.05,0.43,1
13452,1577,0.00,14102.48,15102.48,0.00,0.00,0.04,0
13453,1577,1000.00,15102.48,16102.48,5254.35,9848.13,0.29,1
13454,1577,-1000.00,14102.48,15102.48,8979.23,7123.25,0.11,0
13455,1577,-1000.00,13102.48,14102.48,7551.24,7551.24,0.01,0
13456,1577,-1000.00,12102.48,13102.48,5284.49,893.30,0.13,0
13457,1577,-1000.00,11102.48,12102.48,6361.10,6741.39,0.18,0
13458,1577,-1000.00,10102.48,11102.48,0.00,9173.18,0.23,0
13459,1577,-1000.00,9102.48,10102.48,0.00,3229.18,0.05,0
13460,1577,-1000.00,8102.48,9102.48,6009.74,4092.74,0.12,0
13461,1577,-1000.00,7102.48,8102.48,0.00,9102.48,0.17,0
13462,1577,-1000.00,6102.48,7102.48,3215.93,4886.55,0.05,0
13463,1577,-1000.00,5102.48,6102.48,509.08,6593.40,0.33,0
13464,1577,-1000.00,4102.48,5102.48,0.00,4418.26,0.10,0
13465,1577,-1000.00,3102.48,4102.48,592.82,4509.66,0.27,0
13466,1577,-1000.00,2102.48,3102.48,649.88,3452.60,0.41,0
13467,1577,-1000.00,1102.48,2102.48,1559.40,1543.08,0.16,0
13468,1577,-1000.00,102.48,1102.48,385.38,1717.10,0.00,0
13469,1577,-1000.00,-897.52,102.48,0.00,1102.48,0.32,0
13470,1577,-102.48,-1000.00,0.00,0.00,102.48,0.19,0
13471,1578,1000.00,1000.00,2000.00,469.75,530.25,0.10,1
13472,1578,1000.00,2000.00,3000.00,126.58,1873.42,0.17,1
13473,1578,1000.00,3000.00,4000.00,0.00,3000.00,0.29,1
13474,1578,1000.00,4000.00,5000.00,1594.47,2405.53,0.23,1
13475,1578,1000.00,5000.00,6000.00,1237.89,3762.11,0.13,1
13476,1578,1000.00,6000.00,7000.00,0.00,5875.64,0.26,1
13477,1578,1000.00,7000.00,8000.00,0.00,6825.92,0.08,1
13478,1578,-1000.00,6000.00,7000.00,5938.53,0.00,0.02,0
13479,1578,1000.00,7000.00,8000.00,0.00,7000.00,0.30,1
13480,1578,-1000.00,6000.00,7000.00,4987.49,2652.59,0.23,0
13481,1578,1000.00,7000.00,8000.00,2997.92,4002.08,0.13,1
13482,1578,1000.00,8000.00,9000.00,736.58,7263.42,0.42,1
13483,1578,1000.00,9000.00,10000.00,0.00,9000.00,0.31,1
13484,1578,1000.00,10000.00,11000.00,2962.36,7037.64,0.37,1
13485,1578,1000.00,11000.00,12000.00,4449.02,6550.98,0.38,1
13486,1578,1000.00,12000.00,13000.00,5706.47,6293.53,0.18,1
13487,1578,-1000.00,11000.00,12000.00,8213.24,4786.76,0.29,0
13488,1578,-1000.00,10000.00,11000.00,6990.41,1603.28,0.10,0
13489,1578,-1000.00,9000.00,10000.00,5952.59,5047.41,0.14,0
13490,1578,-1000.00,8000.00,9000.00,4548.46,5451.54,0.43,0
13491,1578,-1000.00,7000.00,8000.00,0.00,9000.00,0.29,0
13492,1578,-1000.00,6000.00,7000.00,0.00,2215.36,0.19,0
13493,1578,-1000.00,5000.00,6000.00,0.00,7000.00,0.38,0
13494,1578,-1000.00,4000.00,5000.00,3017.44,2982.56,0.41,0
13495,1578,-1000.00,3000.00,4000.00,0.00,5000.00,0.37,0
13496,1578,-1000.00,2000.00,3000.00,1021.27,2978.73,0.26,0
13497,1578,-1000.00,1000.00,2000.00,1500.00,1500.00,0.12,0
13498,1578,-1000.00,0.00,1000.00,2000.00,0.00,0.01,0
13499,1578,-611.14,-611.14,388.86,0.00,611.14,0.14,0
13500,1578,-221.22,-832.35,167.65,91.77,129.44,0.24,0
13501,1578,-167.65,-1000.00,0.00,83.82,83.82,0.18,0
13502,1579,1000.00,1000.00,2000.00,0.00,1000.00,0.10,1
13503,1579,1000.00,2000.00,3000.00,464.00,1536.00,0.39,1
13504,1579,1000.00,3000.00,4000.00,0.00,3000.00,0.17,1
13505,1579,1000.00,4000.00,5000.00,0.00,658.63,0.21,1
13506,1579,1000.00,5000.00,6000.00,0.00,5000.00,0.28,1
13507,1579,1000.00,6000.00,7000.00,0.00,6000.00,0.09,1
13508,1579,1000.00,7000.00,8000.00,3250.52,3749.48,0.26,1
13509,1579,1000.00,8000.00,9000.00,3367.03,4632.97,0.17,1
13510,1579,1000.00,9000.00,10000.00,2677.86,6322.14,0.35,1
13511,1579,1000.00,10000.00,11000.00,0.00,10000.00,0.42,1
13512,1579,1000.00,11000.00,12000.00,2189.33,8810.67,0.41,1
13513,1579,1000.00,12000.00,13000.00,0.00,12000.00,0.07,1
13514,1579,1000.00,13000.00,14000.00,6500.00,6500.00,0.11,1
13515,1579,1000.00,14000.00,15000.00,4710.03,9289.97,0.18,1
13516,1579,1000.00,15000.00,16000.00,2794.33,12205.67,0.27,1
13517,1579,1000.00,16000.00,17000.00,4438.02,11561.98,0.23,1
13518,1579,1000.00,17000.00,18000.00,0.00,12747.83,0.05,1
13519,1579,-1000.00,16000.00,17000.00,14213.32,3786.68,0.15,0
13520,1579,1000.00,17000.00,18000.00,1446.81,15553.19,0.27,1
13521,1579,-1000.00,16000.00,17000.00,16655.37,0.00,0.04,0
13522,1579,1000.00,17000.00,18000.00,3501.81,9991.02,0.25,1
13523,1579,-1000.00,16000.00,17000.00,9983.66,8016.34,0.41,0
13524,1579,1000.00,17000.00,18000.00,0.00,17000.00,0.30,1
13525,1579,-1000.00,16000.00,17000.00,11650.58,4782.87,0.12,0
13526,1579,-1000.00,15000.00,16000.00,17000.00,0.00,0.06,0
13527,1579,1000.00,16000.00,17000.00,6770.48,9229.52,0.26,1
13528,1579,1000.00,17000.00,18000.00,449.48,14621.22,0.42,1
13529,1579,1000.00,18000.00,19000.00,0.00,18000.00,0.30,1
13530,1579,1000.00,19000.00,20000.00,5620.00,13380.00,0.24,1
13531,1579,-1000.00,18000.00,19000.00,9614.04,7869.59,0.25,0
13532,1579,1000.00,19000.00,20000.00,2789.27,11202.56,0.21,1
13533,1579,1000.00,20000.00,21000.00,0.00,20000.00,0.07,1
13534,1579,1000.00,21000.00,22000.00,0.00,21000.00,0.06,1
13535,1579,1000.00,22000.00,23000.00,3298.85,18701.15,0.37,1
13536,1579,1000.00,23000.00,24000.00,6308.37,16691.63,0.36,1
13537,1579,-1000.00,22000.00,23000.00,22490.38,1509.62,0.07,0
13538,1579,1000.00,23000.00,24000.00,9598.89,13401.11,0.40,1
13539,1579,1000.00,24000.00,25000.00,0.00,24000.00,0.18,1
13540,1579,1000.00,25000.00,26000.00,0.00,25000.00,0.25,1
13541,1580,-1000.00,-1000.00,0.00,0.00,1000.00,0.30,0
13542,1581,-1000.00,-1000.00,0.00,0.00,1000.00,0.11,0
13543,1582,-174.16,-174.16,825.84,0.00,174.16,0.17,0
13544,1582,-825.84,-1000.00,0.00,0.00,825.84,0.09,0
13545,1583,-964.13,-964.13,35.87,0.00,964.13,0.43,0
13546,1583,-33.30,-997.43,2.57,0.00,33.30,0.41,0
13547,1583,-2.57,-1000.00,0.00,0.78,1.79,0.23,0
13548,1584,-1000.00,-1000.00,0.00,0.00,1000.00,0.03,0
13549,1585,-1000.00,-1000.00,0.00,383.56,616.44,0.03,0
13550,1586,-1000.00,-1000.00,0.00,0.00,1000.00,0.21,0
13551,1587,1000.00,1000.00,2000.00,417.90,582.10,0.23,1
13552,1587,1000.00,2000.00,3000.00,0.00,2000.00,0.22,1
13553,1587,0.00,2000.00,3000.00,0.00,0.00,0.04,0
13554,1587,1000.00,3000.00,4000.00,1247.09,1307.33,0.28,1
13555,1587,-766.70,2233.30,3233.30,414.92,351.78,0.14,0
13556,1587,1000.00,3233.30,4233.30,780.84,1800.89,0.17,1
13557,1587,1000.00,4233.30,5233.30,1710.94,2522.36,0.44,1
13558,1587,1000.00,5233.30,6233.30,1828.51,3404.79,0.32,1
13559,1587,1000.00,6233.30,7233.30,2103.20,4130.10,0.09,1
13560,1587,-1000.00,5233.30,6233.30,3028.05,92.03,0.10,0
13561,1587,1000.00,6233.30,7233.30,0.00,1750.69,0.03,1
13562,1587,-1000.00,5233.30,6233.30,5831.90,1401.40,0.03,0
13563,1587,1000.00,6233.30,7233.30,2038.72,4194.58,0.10,1
13564,1587,1000.00,7233.30,8233.30,0.00,4120.08,0.29,1
13565,1587,-1000.00,6233.30,7233.30,5602.00,2631.30,0.11,0
13566,1587,1000.00,7233.30,8233.30,620.42,6612.89,0.14,1
13567,1587,1000.00,8233.30,9233.30,0.00,7004.36,0.21,1
13568,1587,-1000.00,7233.30,8233.30,9233.30,0.00,0.12,0
13569,1587,1000.00,8233.30,9233.30,0.00,5672.78,0.35,1
13570,1587,-1000.00,7233.30,8233.30,6024.34,3208.96,0.26,0
13571,1587,-1000.00,6233.30,7233.30,4784.57,3448.73,0.38,0
13572,1587,-1000.00,5233.30,6233.30,3271.82,3961.48,0.24,0
13573,1587,-1000.00,4233.30,5233.30,0.00,4740.55,0.07,0
13574,1587,-1000.00,3233.30,4233.30,0.00,1487.72,0.19,0
13575,1587,-1000.00,2233.30,3233.30,1794.56,1922.22,0.23,0
13576,1587,-1000.00,1233.30,2233.30,400.45,2698.08,0.42,0
13577,1587,-1000.00,233.30,1233.30,354.40,1878.90,0.42,0
13578,1587,-1000.00,-766.70,233.30,400.96,832.34,0.22,0
13579,1587,-233.30,-1000.00,0.00,0.00,233.30,0.33,0
13580,1588,-1000.00,-1000.00,0.00,417.57,582.43,0.15,0
13581,1589,-1000.00,-1000.00,0.00,643.66,356.34,0.14,0
13582,1590,-1000.00,-1000.00,0.00,232.87,278.04,0.21,0
13583,1591,-1000.00,-1000.00,0.00,0.00,120.24,0.20,0
13584,1592,-1000.00,-1000.00,0.00,114.66,853.68,0.43,0
13585,1593,-1000.00,-1000.00,0.00,113.87,886.13,0.31,0
13586,1594,-1000.00,-1000.00,0.00,0.00,1000.00,0.09,0
13587,1595,1000.00,1000.00,2000.00,0.00,1000.00,0.03,1
13588,1595,1000.00,2000.00,3000.00,0.00,2000.00,0.37,1
13589,1595,1000.00,3000.00,4000.00,1446.61,1553.39,0.27,1
13590,1595,1000.00,4000.00,5000.00,1518.49,2481.51,0.30,1
13591,1595,1000.00,5000.00,6000.00,0.00,2383.30,0.25,1
13592,1595,1000.00,6000.00,7000.00,2710.79,3289.21,0.33,1
13593,1595,1000.00,7000.00,8000.00,3500.00,3500.00,0.18,1
13594,1595,1000.00,8000.00,9000.00,0.00,256.63,0.03,1
13595,1595,1000.00,9000.00,10000.00,2845.08,6154.92,0.27,1
13596,1595,1000.00,10000.00,11000.00,2941.26,7058.74,0.27,1
13597,1595,1000.00,11000.00,12000.00,0.00,11000.00,0.07,1
13598,1595,1000.00,12000.00,13000.00,4653.87,4977.10,0.31,1
13599,1595,1000.00,13000.00,14000.00,0.00,12121.76,0.44,1
13600,1595,1000.00,14000.00,15000.00,0.00,2081.73,0.34,1
13601,1595,-1000.00,13000.00,14000.00,4575.24,991.82,0.12,0
13602,1595,1000.00,14000.00,15000.00,6616.55,7383.45,0.14,1
13603,1595,1000.00,15000.00,16000.00,4533.94,10466.06,0.17,1
13604,1595,1000.00,16000.00,17000.00,0.00,12794.82,0.21,1
13605,1595,1000.00,17000.00,18000.00,7176.97,9823.03,0.37,1
13606,1595,1000.00,18000.00,19000.00,7202.16,10797.84,0.31,1
13607,1595,1000.00,19000.00,20000.00,2131.98,16868.02,0.16,1
13608,1596,1000.00,1000.00,2000.00,0.00,1000.00,0.13,1
13609,1596,1000.00,2000.00,3000.00,210.93,1789.07,0.30,1
13610,1596,1000.00,3000.00,4000.00,834.61,2165.39,0.05,1
13611,1596,1000.00,4000.00,5000.00,2000.00,2000.00,0.01,1
13612,1596,1000.00,5000.00,6000.00,0.00,5000.00,0.32,1
13613,1596,1000.00,6000.00,7000.00,726.63,5273.37,0.42,1
13614,1596,1000.00,7000.00,8000.00,0.00,4258.94,0.19,1
13615,1596,1000.00,8000.00,9000.00,4000.00,4000.00,0.01,1
13616,1596,1000.00,9000.00,10000.00,0.00,8707.11,0.18,1
13617,1596,-1000.00,8000.00,9000.00,8881.80,506.08,0.07,0
13618,1596,-1000.00,7000.00,8000.00,6802.55,2197.45,0.03,0
13619,1596,1000.00,8000.00,9000.00,1679.81,5246.56,0.35,1
13620,1596,1000.00,9000.00,10000.00,0.00,9000.00,0.11,1
13621,1596,1000.00,10000.00,11000.00,1000.62,8999.38,0.43,1
13622,1596,1000.00,11000.00,12000.00,887.41,10112.59,0.39,1
13623,1596,-1000.00,10000.00,11000.00,6405.16,5594.84,0.29,0
13624,1596,1000.00,11000.00,12000.00,5382.37,5617.63,0.41,1
13625,1596,1000.00,12000.00,13000.00,3311.03,8688.97,0.36,1
13626,1596,1000.00,13000.00,14000.00,0.00,12729.47,0.36,1
13627,1596,1000.00,14000.00,15000.00,4306.23,9693.77,0.18,1
13628,1596,-1000.00,13000.00,14000.00,7512.76,7487.24,0.39,0
13629,1596,1000.00,14000.00,15000.00,3273.16,10726.84,0.39,1
13630,1596,1000.00,15000.00,16000.00,0.00,7523.77,0.04,1
13631,1596,1000.00,16000.00,17000.00,8000.00,8000.00,0.01,1
13632,1596,1000.00,17000.00,18000.00,8157.73,8842.27,0.39,1
13633,1596,1000.00,18000.00,19000.00,0.00,18000.00,0.38,1
13634,1596,1000.00,19000.00,20000.00,9500.00,9500.00,0.35,1
13635,1596,1000.00,20000.00,21000.00,0.00,20000.00,0.42,1
13636,1596,1000.00,21000.00,22000.00,6402.49,14084.37,0.34,1
13637,1596,1000.00,22000.00,23000.00,6984.96,15015.04,0.29,1
13638,1596,1000.00,23000.00,24000.00,3664.55,19335.45,0.32,1
13639,1596,1000.00,24000.00,25000.00,1529.34,21088.51,0.42,1
13640,1596,1000.00,25000.00,26000.00,6473.55,18526.45,0.37,1
13641,1596,-1000.00,24000.00,25000.00,17137.64,4028.23,0.09,0
13642,1596,1000.00,25000.00,26000.00,8220.27,16779.73,0.23,1
13643,1596,1000.00,26000.00,27000.00,0.00,18604.79,0.39,1
13644,1596,1000.00,27000.00,28000.00,11805.54,15194.46,0.26,1
13645,1596,1000.00,28000.00,29000.00,9612.12,18387.88,0.39,1
13646,1596,1000.00,29000.00,30000.00,8486.25,20513.75,0.37,1
13647,1596,0.00,29000.00,30000.00,0.00,0.00,0.02,0
13648,1596,-1000.00,28000.00,29000.00,21383.36,8616.64,0.00,0
13649,1596,1000.00,29000.00,30000.00,0.00,27945.28,0.14,1
13650,1596,1000.00,30000.00,31000.00,0.00,30000.00,0.40,1
13651,1596,-1000.00,29000.00,30000.00,24209.30,6790.70,0.21,0
13652,1597,-1000.00,-1000.00,0.00,0.00,1000.00,0.19,0
13653,1598,-938.23,-938.23,61.77,0.00,938.23,0.04,0
13654,1598,-52.12,-990.34,9.66,0.00,52.12,0.26,0
13655,1598,-1000.00,-1990.34,-990.34,6.40,3.25,0.22,0
13656,1599,-1000.00,-1000.00,0.00,0.00,1000.00,0.17,0
13657,1600,-1000.00,-1000.00,0.00,456.02,543.98,0.16,0
13658,1601,1000.00,1000.00,2000.00,447.99,552.01,0.25,1
13659,1601,1000.00,2000.00,3000.00,499.65,1500.35,0.35,1
13660,1601,-1000.00,1000.00,2000.00,1548.58,1451.42,0.29,0
13661,1601,1000.00,2000.00,3000.00,0.00,1874.82,0.21,1
13662,1601,1000.00,3000.00,4000.00,0.00,3000.00,0.37,1
13663,1601,1000.00,4000.00,5000.00,786.81,2649.54,0.38,1
13664,1601,1000.00,5000.00,6000.00,1657.38,3342.62,0.30,1
13665,1601,1000.00,6000.00,7000.00,1803.58,4196.42,0.36,1
13666,1601,1000.00,7000.00,8000.00,0.00,4295.49,0.35,1
13667,1601,0.00,7000.00,8000.00,0.00,0.00,0.01,0
13668,1601,-1000.00,6000.00,7000.00,6347.87,0.00,0.04,0
13669,1601,1000.00,7000.00,8000.00,2796.74,4203.26,0.21,1
13670,1601,-1000.00,6000.00,7000.00,4723.08,3276.92,0.10,0
13671,1601,-1000.00,5000.00,6000.00,4382.41,2617.59,0.10,0
13672,1601,1000.00,6000.00,7000.00,469.30,5530.70,0.44,1
13673,1601,1000.00,7000.00,8000.00,2854.94,4145.06,0.38,1
13674,1601,1000.00,8000.00,9000.00,0.00,8000.00,0.32,1
13675,1601,1000.00,9000.00,10000.00,4173.04,4826.96,0.15,1
13676,1601,0.00,9000.00,10000.00,0.00,0.00,0.03,0
13677,1601,1000.00,10000.00,11000.00,5000.00,5000.00,0.32,1
13678,1601,1000.00,11000.00,12000.00,0.00,4446.17,0.27,1
13679,1601,1000.00,12000.00,13000.00,5241.42,6758.58,0.20,1
13680,1601,1000.00,13000.00,14000.00,0.00,10241.98,0.22,1
13681,1601,1000.00,14000.00,15000.00,0.00,5008.18,0.24,1
13682,1601,-1000.00,13000.00,14000.00,1705.20,0.00,0.04,0
13683,1601,1000.00,14000.00,15000.00,1450.15,12549.85,0.17,1
13684,1601,1000.00,15000.00,16000.00,0.00,15000.00,0.27,1
13685,1601,1000.00,16000.00,17000.00,7824.34,8175.66,0.32,1
13686,1601,1000.00,17000.00,18000.00,739.11,11364.70,0.38,1
13687,1601,1000.00,18000.00,19000.00,0.00,14920.08,0.13,1
13688,1601,1000.00,19000.00,20000.00,0.00,19000.00,0.33,1
13689,1601,1000.00,20000.00,21000.00,5316.19,10507.02,0.29,1
13690,1601,1000.00,21000.00,22000.00,8224.55,12775.45,0.20,1
13691,1601,0.00,21000.00,22000.00,0.00,0.00,0.03,0
13692,1601,1000.00,22000.00,23000.00,11000.00,11000.00,0.33,1
13693,1601,1000.00,23000.00,24000.00,5695.52,17304.48,0.43,1
13694,1601,1000.00,24000.00,25000.00,824.98,13274.85,0.33,1
13695,1601,-1000.00,23000.00,24000.00,20171.02,4828.98,0.10,0
13696,1601,1000.00,24000.00,25000.00,6515.87,17484.13,0.37,1
13697,1602,-1000.00,-1000.00,0.00,0.00,1000.00,0.37,0
13698,1603,1000.00,1000.00,2000.00,0.00,608.89,0.29,1
13699,1603,1000.00,2000.00,3000.00,0.00,1192.21,0.35,1
13700,1603,-1000.00,1000.00,2000.00,1826.41,1173.59,0.08,0
13701,1603,-1000.00,0.00,1000.00,1319.41,680.59,0.06,0
13702,1603,1000.00,1000.00,2000.00,0.00,493.51,0.21,1
13703,1603,1000.00,2000.00,3000.00,198.05,1801.95,0.27,1
13704,1603,1000.00,3000.00,4000.00,1500.00,1500.00,0.02,1
13705,1603,1000.00,4000.00,5000.00,1289.43,2710.57,0.32,1
13706,1603,-1000.00,3000.00,4000.00,2602.72,2397.28,0.22,0
13707,1603,1000.00,4000.00,5000.00,2000.00,2000.00,0.01,1
13708,1603,-1000.00,3000.00,4000.00,2362.68,0.00,0.04,0
13709,1603,1000.00,4000.00,5000.00,1227.07,2772.93,0.23,1
13710,1603,1000.00,5000.00,6000.00,0.00,5000.00,0.26,1
13711,1603,1000.00,6000.00,7000.00,0.00,6000.00,0.35,1
13712,1603,1000.00,7000.00,8000.00,1831.96,5168.04,0.37,1
13713,1603,-1000.00,6000.00,7000.00,6369.79,0.00,0.00,0
13714,1603,-1000.00,5000.00,6000.00,4361.94,2638.06,0.30,0
13715,1603,1000.00,6000.00,7000.00,2122.62,3877.38,0.28,1
13716,1603,1000.00,7000.00,8000.00,0.00,7000.00,0.05,1
13717,1603,1000.00,8000.00,9000.00,0.00,8000.00,0.38,1
13718,1603,1000.00,9000.00,10000.00,0.00,9000.00,0.03,1
13719,1603,1000.00,10000.00,11000.00,1459.20,5078.37,0.31,1
13720,1603,-1000.00,9000.00,10000.00,8266.26,2733.74,0.06,0
13721,1603,1000.00,10000.00,11000.00,4034.32,5965.68,0.34,1
13722,1603,-1000.00,9000.00,10000.00,0.00,11000.00,0.26,0
13723,1603,-1000.00,8000.00,9000.00,0.00,2187.00,0.09,0
13724,1603,-1000.00,7000.00,8000.00,4500.00,4500.00,0.05,0
13725,1603,-1000.00,6000.00,7000.00,0.00,8000.00,0.36,0
13726,1603,-1000.00,5000.00,6000.00,3676.85,3323.15,0.41,0
13727,1603,-1000.00,4000.00,5000.00,0.00,2384.16,0.04,0
13728,1603,-1000.00,3000.00,4000.00,410.85,1555.17,0.23,0
13729,1603,-1000.00,2000.00,3000.00,2982.79,1017.21,0.22,0
13730,1603,-1000.00,1000.00,2000.00,341.04,2658.96,0.15,0
13731,1603,-1000.00,0.00,1000.00,264.67,1735.33,0.30,0
13732,1603,-1000.00,-1000.00,0.00,432.60,567.40,0.34,0
13733,1604,-1000.00,-1000.00,0.00,500.00,500.00,0.03,0
13734,1605,-1000.00,-1000.00,0.00,0.00,1000.00,0.02,0
13735,1606,-306.39,-306.39,693.61,0.00,306.39,0.20,0
13736,1606,-166.03,-472.42,527.58,0.00,166.03,0.19,0
13737,1606,-474.00,-946.42,53.58,18.63,455.37,0.44,0
13738,1606,-53.58,-1000.00,0.00,0.00,53.58,0.28,0
13739,1607,1000.00,1000.00,2000.00,470.72,529.28,0.20,1
13740,1607,1000.00,2000.00,3000.00,0.00,974.72,0.21,1
13741,1607,1000.00,3000.00,4000.00,492.35,2507.65,0.43,1
13742,1607,1000.00,4000.00,5000.00,1383.58,2616.42,0.42,1
13743,1607,1000.00,5000.00,6000.00,0.00,3983.38,0.39,1
13744,1607,1000.00,6000.00,7000.00,0.00,5673.48,0.40,1
13745,1607,-1000.00,5000.00,6000.00,3580.37,3419.63,0.38,0
13746,1607,1000.00,6000.00,7000.00,2017.04,3982.96,0.38,1
13747,1607,-1000.00,5000.00,6000.00,1011.87,469.30,0.13,0
13748,1607,1000.00,6000.00,7000.00,1845.20,4154.80,0.06,1
13749,1607,-1000.00,5000.00,6000.00,6292.90,0.00,0.11,0
13750,1607,-1000.00,4000.00,5000.00,3124.50,2875.50,0.05,0
13751,1607,1000.00,5000.00,6000.00,0.00,4510.96,0.37,1
13752,1607,1000.00,6000.00,7000.00,0.00,6000.00,0.40,1
13753,1607,-1000.00,5000.00,6000.00,3580.30,3419.70,0.25,0
13754,1607,1000.00,6000.00,7000.00,2671.84,3328.16,0.42,1
13755,1607,1000.00,7000.00,8000.00,3496.04,3503.96,0.22,1
13756,1607,1000.00,8000.00,9000.00,562.95,7437.05,0.44,1
13757,1607,1000.00,9000.00,10000.00,0.00,9000.00,0.40,1
13758,1607,1000.00,10000.00,11000.00,3648.66,5389.17,0.28,1
13759,1607,-1000.00,9000.00,10000.00,6790.30,4209.70,0.31,0
13760,1607,1000.00,10000.00,11000.00,0.00,10000.00,0.15,1
13761,1607,1000.00,11000.00,12000.00,0.00,11000.00,0.31,1
13762,1607,1000.00,12000.00,13000.00,4929.28,7070.72,0.19,1
13763,1607,-1000.00,11000.00,12000.00,1700.23,11299.77,0.43,0
13764,1607,-1000.00,10000.00,11000.00,0.00,9621.36,0.17,0
13765,1607,-1000.00,9000.00,10000.00,0.00,4578.92,0.27,0
13766,1607,-1000.00,8000.00,9000.00,0.00,344.17,0.44,0
13767,1607,-1000.00,7000.00,8000.00,1925.88,7074.12,0.28,0
13768,1607,0.00,7000.00,8000.00,0.00,0.00,0.06,0
13769,1607,-1000.00,6000.00,7000.00,3848.48,2666.82,0.30,0
13770,1607,-1000.00,5000.00,6000.00,3475.02,0.00,0.30,0
13771,1607,-1000.00,4000.00,5000.00,2071.35,3928.65,0.41,0
13772,1607,-1000.00,3000.00,4000.00,3348.22,1651.78,0.25,0
13773,1608,-1000.00,-1000.00,0.00,0.00,126.98,0.14,0
13774,1609,1000.00,1000.00,2000.00,0.00,1000.00,0.08,1
13775,1609,1000.00,2000.00,3000.00,0.00,1830.18,0.39,1
13776,1609,-1000.00,1000.00,2000.00,1551.63,1448.37,0.22,0
13777,1609,1000.00,2000.00,3000.00,0.00,2000.00,0.03,1
13778,1609,-566.45,1433.55,2433.55,566.45,0.00,0.07,0
13779,1609,1000.00,2433.55,3433.55,0.00,2433.55,0.31,1
13780,1609,1000.00,3433.55,4433.55,112.62,1864.76,0.33,1
13781,1609,1000.00,4433.55,5433.55,0.00,4433.55,0.27,1
13782,1609,1000.00,5433.55,6433.55,1460.48,3973.07,0.27,1
13783,1609,1000.00,6433.55,7433.55,0.00,5954.43,0.27,1
13784,1609,1000.00,7433.55,8433.55,0.00,7433.55,0.11,1
13785,1609,1000.00,8433.55,9433.55,0.00,8433.55,0.12,1
13786,1609,1000.00,9433.55,10433.55,2355.15,7078.41,0.27,1
13787,1609,1000.00,10433.55,11433.55,0.00,10433.55,0.36,1
13788,1609,-1000.00,9433.55,10433.55,7570.62,3862.93,0.21,0
13789,1609,1000.00,10433.55,11433.55,1248.48,9185.08,0.34,1
13790,1609,-1000.00,9433.55,10433.55,4769.54,517.92,0.10,0
13791,1609,1000.00,10433.55,11433.55,5070.39,5363.16,0.23,1
13792,1609,-1000.00,9433.55,10433.55,5831.68,5601.88,0.15,0
13793,1609,1000.00,10433.55,11433.55,448.98,9984.58,0.29,1
13794,1609,1000.00,11433.55,12433.55,0.00,9894.84,0.29,1
13795,1609,1000.00,12433.55,13433.55,6143.66,6289.89,0.37,1
13796,1609,1000.00,13433.55,14433.55,0.00,13433.55,0.04,1
13797,1609,1000.00,14433.55,15433.55,1432.93,13000.62,0.10,1
13798,1609,1000.00,15433.55,16433.55,0.00,15433.55,0.00,1
13799,1609,-1000.00,14433.55,15433.55,8243.59,8189.96,0.18,0
13800,1609,1000.00,15433.55,16433.55,4129.69,11303.86,0.11,1
13801,1609,0.00,15433.55,16433.55,0.00,0.00,0.00,0
13802,1609,1000.00,16433.55,17433.55,8216.78,8216.78,0.12,1
13803,1609,1000.00,17433.55,18433.55,5117.72,12315.83,0.33,1
13804,1609,1000.00,18433.55,19433.55,5668.17,11633.02,0.22,1
13805,1609,1000.00,19433.55,20433.55,0.00,9144.28,0.05,1
13806,1609,-1000.00,18433.55,19433.55,11633.90,3402.22,0.13,0
13807,1609,1000.00,19433.55,20433.55,7624.31,11809.25,0.23,1
13808,1609,-1000.00,18433.55,19433.55,11103.11,9330.44,0.25,0
13809,1609,-1000.00,17433.55,18433.55,4311.41,0.00,0.06,0
13810,1609,1000.00,18433.55,19433.55,2611.38,15822.17,0.34,1
13811,1609,1000.00,19433.55,20433.55,0.00,6853.95,0.03,1
13812,1609,1000.00,20433.55,21433.55,0.00,12122.65,0.31,1
13813,1609,1000.00,21433.55,22433.55,10659.40,10774.16,0.11,1
13814,1609,-1000.00,20433.55,21433.55,13015.31,9418.24,0.38,0
13815,1609,-1000.00,19433.55,20433.55,11212.28,10221.27,0.02,0
13816,1609,-1000.00,18433.55,19433.55,17786.86,0.00,0.03,0
13817,1609,1000.00,19433.55,20433.55,8036.87,11396.69,0.30,1
13818,1609,-1000.00,18433.55,19433.55,20433.55,0.00,0.03,0
13819,1610,-1000.00,-1000.00,0.00,386.65,613.35,0.15,0
13820,1611,-815.84,-815.84,184.16,0.00,815.84,0.37,0
13821,1611,-143.52,-959.35,40.65,0.00,143.52,0.26,0
13822,1611,-23.63,-982.98,17.02,0.00,23.63,0.09,0
13823,1611,-10.63,-993.62,6.38,2.78,7.86,0.34,0
13824,1611,17.22,-976.39,23.61,0.12,0.00,0.09,1
13825,1611,-23.51,-999.90,0.10,0.00,23.51,0.40,0
13826,1611,8.09,-991.81,8.19,0.05,0.04,0.29,1
13827,1611,-8.19,-1000.00,0.00,0.00,8.19,0.00,0
13828,1612,-1000.00,-1000.00,0.00,0.00,1000.00,0.24,0
13829,1613,-1000.00,-1000.00,0.00,555.31,444.69,0.11,0
13830,1614,-1000.00,-1000.00,0.00,29.72,970.28,0.36,0
13831,1614,0.00,-1000.00,0.00,0.00,0.00,0.09,1
13832,1614,-0.00,-1000.00,0.00,0.00,0.00,0.34,0
13833,1614,0.00,-1000.00,0.00,0.00,0.00,0.01,1
13834,1614,0.00,-1000.00,0.00,0.00,0.00,0.36,1
13835,1614,0.00,-1000.00,0.00,0.00,0.00,0.37,1
13836,1614,-0.00,-1000.00,0.00,0.00,0.00,0.20,0
13837,1614,0.00,-1000.00,0.00,0.00,0.00,0.41,1
13838,1614,-0.00,-1000.00,0.00,0.00,0.00,0.03,0
13839,1615,-1000.00,-1000.00,0.00,593.90,406.10,0.13,0
13840,1616,-1000.00,-1000.00,0.00,0.00,57.21,0.13,0
13841,1617,-583.38,-583.38,416.62,256.83,326.55,0.22,0
13842,1617,-416.62,-1000.00,0.00,0.00,416.62,0.44,0
13843,1618,1000.00,1000.00,2000.00,0.00,827.25,0.21,1
13844,1618,1000.00,2000.00,3000.00,0.00,1329.60,0.26,1
13845,1618,1000.00,3000.00,4000.00,1309.71,1690.29,0.26,1
13846,1618,1000.00,4000.00,5000.00,0.00,4000.00,0.43,1
13847,1618,1000.00,5000.00,6000.00,0.00,1980.76,0.14,1
13848,1618,1000.00,6000.00,7000.00,0.00,6000.00,0.29,1
13849,1618,1000.00,7000.00,8000.00,0.00,3808.23,0.32,1
13850,1618,0.00,7000.00,8000.00,0.00,0.00,0.03,0
13851,1618,1000.00,8000.00,9000.00,0.00,6121.23,0.41,1
13852,1618,1000.00,9000.00,10000.00,0.00,9000.00,0.27,1
13853,1618,1000.00,10000.00,11000.00,0.00,10000.00,0.42,1
13854,1618,1000.00,11000.00,12000.00,3502.07,7497.93,0.13,1
13855,1618,1000.00,12000.00,13000.00,0.00,12000.00,0.16,1
13856,1618,1000.00,13000.00,14000.00,3259.89,8676.90,0.35,1
13857,1618,1000.00,14000.00,15000.00,0.00,14000.00,0.42,1
13858,1618,1000.00,15000.00,16000.00,488.18,14511.82,0.44,1
13859,1618,1000.00,16000.00,17000.00,0.00,16000.00,0.36,1
13860,1618,1000.00,17000.00,18000.00,1560.78,15439.22,0.11,1
13861,1618,-1000.00,16000.00,17000.00,18000.00,0.00,0.02,0
13862,1618,1000.00,17000.00,18000.00,0.00,17000.00,0.41,1
13863,1618,1000.00,18000.00,19000.00,7071.13,10928.87,0.40,1
13864,1618,1000.00,19000.00,20000.00,51.15,4414.61,0.20,1
13865,1618,1000.00,20000.00,21000.00,0.00,12530.72,0.30,1
13866,1618,1000.00,21000.00,22000.00,0.00,21000.00,0.18,1
13867,1618,1000.00,22000.00,23000.00,10394.39,11605.61,0.22,1
13868,1618,0.00,22000.00,23000.00,0.00,0.00,0.03,0
13869,1618,1000.00,23000.00,24000.00,0.00,23000.00,0.14,1
13870,1618,-1000.00,22000.00,23000.00,1286.37,0.00,0.10,0
13871,1618,1000.00,23000.00,24000.00,0.00,23000.00,0.14,1
13872,1618,1000.00,24000.00,25000.00,11774.27,12225.73,0.27,1
13873,1618,-1000.00,23000.00,24000.00,14767.57,6947.35,0.20,0
13874,1618,1000.00,24000.00,25000.00,3526.18,20473.82,0.42,1
13875,1618,1000.00,25000.00,26000.00,24.37,5278.76,0.19,1
13876,1618,1000.00,26000.00,27000.00,0.00,26000.00,0.10,1
13877,1618,1000.00,27000.00,28000.00,0.00,15277.97,0.06,1
13878,1618,1000.00,28000.00,29000.00,0.00,28000.00,0.28,1
13879,1618,1000.00,29000.00,30000.00,12817.54,16182.46,0.17,1
13880,1618,1000.00,30000.00,31000.00,0.00,12461.44,0.15,1
13881,1618,-1000.00,29000.00,30000.00,16955.02,14044.98,0.29,0
13882,1618,1000.00,30000.00,31000.00,0.00,30000.00,0.34,1
13883,1618,1000.00,31000.00,32000.00,0.00,31000.00,0.16,1
13884,1618,1000.00,32000.00,33000.00,0.00,15293.07,0.17,1
13885,1618,1000.00,33000.00,34000.00,0.00,33000.00,0.44,1
13886,1618,1000.00,34000.00,35000.00,17000.00,17000.00,0.07,1
13887,1618,1000.00,35000.00,36000.00,15881.54,19118.46,0.17,1
13888,1618,1000.00,36000.00,37000.00,1823.77,22593.22,0.34,1
13889,1618,-1000.00,35000.00,36000.00,29975.52,6919.82,0.07,0
13890,1618,-1000.00,34000.00,35000.00,18000.00,18000.00,0.27,0
13891,1618,-1000.00,33000.00,34000.00,0.00,19045.12,0.12,0
13892,1618,-1000.00,32000.00,33000.00,17000.00,17000.00,0.41,0
13893,1618,-1000.00,31000.00,32000.00,0.00,33000.00,0.25,0
13894,1618,-1000.00,30000.00,31000.00,10181.73,6719.93,0.19,0
13895,1618,-1000.00,29000.00,30000.00,6132.91,12370.99,0.26,0
13896,1618,-1000.00,28000.00,29000.00,0.00,12030.70,0.16,0
13897,1618,-1000.00,27000.00,28000.00,0.00,29000.00,0.13,0
13898,1618,-1000.00,26000.00,27000.00,2531.49,13200.59,0.30,0
13899,1618,-1000.00,25000.00,26000.00,4785.35,0.00,0.15,0
13900,1618,-1000.00,24000.00,25000.00,0.00,15042.83,0.23,0
13901,1618,-1000.00,23000.00,24000.00,7336.80,17663.20,0.32,0
13902,1618,-1000.00,22000.00,23000.00,0.00,24000.00,0.04,0
13903,1618,-1000.00,21000.00,22000.00,13124.94,9875.06,0.05,0
13904,1618,-1000.00,20000.00,21000.00,0.00,22000.00,0.17,0
13905,1618,-1000.00,19000.00,20000.00,0.00,21000.00,0.04,0
13906,1618,0.00,19000.00,20000.00,0.00,0.00,0.07,0
13907,1618,-1000.00,18000.00,19000.00,0.00,6099.49,0.23,0
13908,1618,-1000.00,17000.00,18000.00,9336.29,800.30,0.10,0
13909,1618,-1000.00,16000.00,17000.00,6197.47,11802.53,0.30,0
13910,1618,-1000.00,15000.00,16000.00,16555.26,310.46,0.12,0
13911,1618,-1000.00,14000.00,15000.00,0.00,16000.00,0.16,0
13912,1618,-1000.00,13000.00,14000.00,6831.13,8168.87,0.02,0
13913,1619,-1000.00,-1000.00,0.00,0.00,713.45,0.13,0
13914,1620,0.00,0.00,1000.00,0.00,0.00,0.04,0
13915,1620,-1000.00,-1000.00,0.00,0.00,1000.00,0.27,0
13916,1621,-1000.00,-1000.00,0.00,151.81,848.19,0.42,0
13917,1622,-1000.00,-1000.00,0.00,386.34,613.66,0.03,0
13918,1623,-474.17,-474.17,525.83,0.00,474.17,0.10,0
13919,1623,1000.00,525.83,1525.83,104.79,0.00,0.03,1
13920,1623,-596.89,-71.06,928.94,0.00,596.89,0.21,0
13921,1623,-928.94,-1000.00,0.00,385.20,543.75,0.10,0
13922,1624,-358.42,-358.42,641.58,0.00,358.42,0.25,0
13923,1624,-641.58,-1000.00,0.00,0.00,641.58,0.06,0
13924,1625,1000.00,1000.00,2000.00,261.66,245.52,0.20,1
13925,1625,1000.00,2000.00,3000.00,1106.86,893.14,0.14,1
13926,1625,-1000.00,1000.00,2000.00,0.00,3000.00,0.12,0
13927,1625,1000.00,2000.00,3000.00,2000.00,0.00,0.13,1
13928,1625,-1000.00,1000.00,2000.00,937.51,2062.49,0.19,0
13929,1625,-1000.00,0.00,1000.00,1000.00,1000.00,0.21,0
13930,1625,-1000.00,-1000.00,0.00,419.31,580.69,0.11,0
13931,1626,-1000.00,-1000.00,0.00,298.10,701.90,0.35,0
13932,1627,1000.00,1000.00,2000.00,36.21,963.79,0.21,1
13933,1627,1000.00,2000.00,3000.00,247.41,1752.59,0.26,1
13934,1627,1000.00,3000.00,4000.00,735.88,2264.12,0.42,1
13935,1627,1000.00,4000.00,5000.00,0.00,4000.00,0.32,1
13936,1627,1000.00,5000.00,6000.00,1136.23,3863.77,0.04,1
13937,1627,1000.00,6000.00,7000.00,0.00,3551.08,0.06,1
13938,1627,-1000.00,5000.00,6000.00,4328.01,2671.99,0.25,0
13939,1627,1000.00,6000.00,7000.00,0.00,3799.83,0.28,1
13940,1627,1000.00,7000.00,8000.00,1859.42,5140.58,0.28,1
13941,1627,-1000.00,6000.00,7000.00,4267.83,3732.17,0.01,0
13942,1627,1000.00,7000.00,8000.00,0.00,1376.06,0.15,1
13943,1627,1000.00,8000.00,9000.00,0.00,8000.00,0.17,1
13944,1627,1000.00,9000.00,10000.00,4500.00,4500.00,0.15,1
13945,1627,1000.00,10000.00,11000.00,0.00,7127.47,0.24,1
13946,1627,1000.00,11000.00,12000.00,0.00,11000.00,0.10,1
13947,1627,1000.00,12000.00,13000.00,0.00,6861.30,0.32,1
13948,1627,1000.00,13000.00,14000.00,0.00,2942.56,0.09,1
13949,1627,1000.00,14000.00,15000.00,2997.04,11002.96,0.40,1
13950,1627,1000.00,15000.00,16000.00,0.00,6192.32,0.14,1
13951,1627,-1000.00,14000.00,15000.00,11032.86,4967.14,0.11,0
13952,1627,1000.00,15000.00,16000.00,4865.01,10134.99,0.35,1
13953,1627,-1000.00,14000.00,15000.00,8667.57,7332.43,0.34,0
13954,1627,-1000.00,13000.00,14000.00,0.00,4195.85,0.11,0
13955,1627,-1000.00,12000.00,13000.00,0.00,14000.00,0.32,0
13956,1627,-1000.00,11000.00,12000.00,0.00,12383.17,0.39,0
13957,1627,-1000.00,10000.00,11000.00,0.00,12000.00,0.12,0
13958,1627,-1000.00,9000.00,10000.00,4374.68,1864.78,0.17,0
13959,1627,-1000.00,8000.00,9000.00,0.00,10000.00,0.05,0
13960,1627,-1000.00,7000.00,8000.00,295.92,1446.39,0.17,0
13961,1627,-1000.00,6000.00,7000.00,0.00,8000.00,0.05,0
13962,1627,-1000.00,5000.00,6000.00,3042.76,3957.24,0.10,0
13963,1627,-1000.00,4000.00,5000.00,0.00,6000.00,0.16,0
13964,1627,-1000.00,3000.00,4000.00,0.00,5000.00,0.28,0
13965,1627,-1000.00,2000.00,3000.00,390.64,2773.24,0.39,0
13966,1627,-1000.00,1000.00,2000.00,2507.83,492.17,0.06,0
13967,1627,-1000.00,0.00,1000.00,183.08,1816.92,0.42,0
13968,1627,-1000.00,-1000.00,0.00,20.76,979.24,0.26,0
13969,1628,-758.40,-758.40,241.60,0.00,758.40,0.26,0
13970,1628,-241.60,-1000.00,0.00,50.75,190.85,0.15,0
13971,1629,-1000.00,-1000.00,0.00,0.00,1000.00,0.34,0
13972,1630,-1000.00,-1000.00,0.00,518.69,481.31,0.13,0
13973,1631,1000.00,1000.00,2000.00,0.00,635.27,0.36,1
13974,1631,-1000.00,0.00,1000.00,602.70,1397.30,0.34,0
13975,1631,-1000.00,-1000.00,0.00,500.00,500.00,0.04,0
13976,1632,-1000.00,-1000.00,0.00,500.00,500.00,0.06,0
13977,1633,-1000.00,-1000.00,0.00,333.51,666.49,0.31,0
13978,1634,-1000.00,-1000.00,0.00,200.15,799.85,0.24,0
13979,1635,-890.18,-890.18,109.82,890.18,0.00,0.01,0
13980,1635,-1000.00,-1890.18,-890.18,0.00,109.82,0.09,0
13981,1636,-1000.00,-1000.00,0.00,209.30,790.70,0.40,0
13982,1637,-1000.00,-1000.00,0.00,0.00,568.11,0.33,0
13983,1638,1000.00,1000.00,2000.00,0.00,678.11,0.11,1
13984,1638,1000.00,2000.00,3000.00,640.56,1359.44,0.34,1
13985,1638,1000.00,3000.00,4000.00,0.00,3000.00,0.42,1
13986,1638,1000.00,4000.00,5000.00,1364.07,2635.93,0.17,1
13987,1638,1000.00,5000.00,6000.00,2003.39,2996.61,0.12,1
13988,1638,-1000.00,4000.00,5000.00,6000.00,0.00,0.10,0
13989,1638,1000.00,5000.00,6000.00,0.00,5000.00,0.29,1
13990,1638,1000.00,6000.00,7000.00,710.65,2756.25,0.22,1
13991,1638,-1000.00,5000.00,6000.00,5201.01,1798.99,0.16,0
13992,1638,1000.00,6000.00,7000.00,0.00,5885.00,0.21,1
13993,1638,1000.00,7000.00,8000.00,921.15,4346.84,0.35,1
13994,1638,1000.00,8000.00,9000.00,4000.00,4000.00,0.01,1
13995,1638,1000.00,9000.00,10000.00,0.00,9000.00,0.11,1
13996,1638,1000.00,10000.00,11000.00,0.00,10000.00,0.33,1
13997,1638,1000.00,11000.00,12000.00,737.74,10262.26,0.27,1
13998,1638,1000.00,12000.00,13000.00,4972.30,7027.70,0.28,1
13999,1638,-1000.00,11000.00,12000.00,5423.75,0.00,0.08,0
14000,1638,1000.00,12000.00,13000.00,2842.68,9157.32,0.30,1
14001,1638,1000.00,13000.00,14000.00,6500.00,6500.00,0.23,1
14002,1638,1000.00,14000.00,15000.00,0.00,11992.61,0.20,1
14003,1638,1000.00,15000.00,16000.00,0.00,14894.77,0.26,1
14004,1638,-1000.00,14000.00,15000.00,15818.41,0.00,0.04,0
14005,1638,-1000.00,13000.00,14000.00,11145.02,3854.98,0.06,0
14006,1638,1000.00,14000.00,15000.00,2857.24,11142.76,0.26,1
14007,1638,1000.00,15000.00,16000.00,0.00,5762.11,0.28,1
14008,1638,-1000.00,14000.00,15000.00,10062.79,5937.21,0.25,0
14009,1638,1000.00,15000.00,16000.00,7036.96,7963.04,0.19,1
14010,1638,1000.00,16000.00,17000.00,0.00,11436.39,0.08,1
14011,1638,1000.00,17000.00,18000.00,6577.57,10422.43,0.33,1
14012,1638,1000.00,18000.00,19000.00,3241.09,14758.91,0.35,1
14013,1638,1000.00,19000.00,20000.00,9500.00,9500.00,0.12,1
14014,1638,1000.00,20000.00,21000.00,10000.00,10000.00,0.08,1
14015,1639,-1000.00,-1000.00,0.00,0.00,1000.00,0.05,0
14016,1640,-612.17,-612.17,387.83,0.00,612.17,0.33,0
14017,1640,-387.83,-1000.00,0.00,126.55,261.27,0.34,0
14018,1641,-1000.00,-1000.00,0.00,0.00,1000.00,0.31,0
14019,1642,1000.00,1000.00,2000.00,0.00,1000.00,0.03,1
14020,1642,1000.00,2000.00,3000.00,0.00,1921.65,0.43,1
14021,1642,1000.00,3000.00,4000.00,0.00,3000.00,0.01,1
14022,1642,1000.00,4000.00,5000.00,1142.77,2857.23,0.28,1
14023,1642,1000.00,5000.00,6000.00,2500.00,2500.00,0.10,1
14024,1642,1000.00,6000.00,7000.00,587.34,1306.80,0.19,1
14025,1642,1000.00,7000.00,8000.00,0.00,7000.00,0.15,1
14026,1642,1000.00,8000.00,9000.00,0.00,4166.65,0.16,1
14027,1642,-1000.00,7000.00,8000.00,5164.60,1878.06,0.16,0
14028,1642,1000.00,8000.00,9000.00,4000.00,4000.00,0.24,1
14029,1642,1000.00,9000.00,10000.00,197.56,8802.44,0.33,1
14030,1642,1000.00,10000.00,11000.00,5000.00,5000.00,0.17,1
14031,1642,-1000.00,9000.00,10000.00,5500.00,5500.00,0.42,0
14032,1642,-1000.00,8000.00,9000.00,2192.34,7807.66,0.06,0
14033,1642,-1000.00,7000.00,8000.00,0.00,9000.00,0.30,0
14034,1642,-1000.00,6000.00,7000.00,3655.69,4344.31,0.41,0
14035,1642,-1000.00,5000.00,6000.00,2741.79,4258.21,0.12,0
14036,1642,-1000.00,4000.00,5000.00,0.00,2455.56,0.42,0
14037,1642,-1000.00,3000.00,4000.00,0.00,3131.49,0.31,0
14038,1642,-738.48,2261.52,3261.52,738.48,0.00,0.24,0
14039,1642,-1000.00,1261.52,2261.52,0.00,1139.88,0.20,0
14040,1642,-1000.00,261.52,1261.52,1130.76,1130.76,0.16,0
14041,1642,-1000.00,-738.48,261.52,0.00,1261.52,0.26,0
14042,1642,-1000.00,-1738.48,-738.48,0.00,132.28,0.16,0
14043,1643,-1000.00,-1000.00,0.00,500.00,500.00,0.04,0
14044,1644,1000.00,1000.00,2000.00,191.95,782.64,0.39,1
14045,1644,1000.00,2000.00,3000.00,108.03,1891.97,0.44,1
14046,1644,-1000.00,1000.00,2000.00,1668.82,1331.18,0.10,0
14047,1644,1000.00,2000.00,3000.00,0.00,2000.00,0.43,1
14048,1644,1000.00,3000.00,4000.00,1390.86,1609.14,0.19,1
14049,1644,1000.00,4000.00,5000.00,1493.76,2506.24,0.02,1
14050,1644,-1000.00,3000.00,4000.00,2832.77,2167.23,0.20,0
14051,1644,1000.00,4000.00,5000.00,2000.00,2000.00,0.13,1
14052,1644,1000.00,5000.00,6000.00,0.00,3436.39,0.36,1
14053,1644,1000.00,6000.00,7000.00,3000.00,3000.00,0.27,1
14054,1644,1000.00,7000.00,8000.00,757.45,6242.55,0.33,1
14055,1644,1000.00,8000.00,9000.00,3098.93,4901.07,0.39,1
14056,1644,1000.00,9000.00,10000.00,4178.87,4821.13,0.42,1
14057,1644,-1000.00,8000.00,9000.00,5128.66,1502.65,0.12,0
14058,1644,0.00,8000.00,9000.00,0.00,0.00,0.19,0
14059,1644,1000.00,9000.00,10000.00,0.00,7484.96,0.42,1
14060,1644,1000.00,10000.00,11000.00,0.00,10000.00,0.30,1
14061,1644,1000.00,11000.00,12000.00,3890.30,7109.70,0.01,1
14062,1644,-1000.00,10000.00,11000.00,7754.08,4245.92,0.16,0
14063,1644,1000.00,11000.00,12000.00,0.00,11000.00,0.38,1
14064,1644,1000.00,12000.00,13000.00,0.00,9364.22,0.18,1
14065,1644,1000.00,13000.00,14000.00,6272.64,6727.36,0.13,1
14066,1644,-1000.00,12000.00,13000.00,9103.61,338.56,0.20,0
14067,1644,-1000.00,11000.00,12000.00,0.00,1621.70,0.15,0
14068,1644,-1000.00,10000.00,11000.00,0.00,12000.00,0.27,0
14069,1644,-1000.00,9000.00,10000.00,4375.52,6624.48,0.23,0
14070,1644,-1000.00,8000.00,9000.00,0.00,10000.00,0.23,0
14071,1644,-1000.00,7000.00,8000.00,4190.80,4809.20,0.31,0
14072,1644,-1000.00,6000.00,7000.00,4000.00,4000.00,0.02,0
14073,1644,-1000.00,5000.00,6000.00,0.00,7000.00,0.06,0
14074,1644,-1000.00,4000.00,5000.00,2304.32,3695.68,0.19,0
14075,1644,-1000.00,3000.00,4000.00,0.00,5000.00,0.28,0
14076,1644,-1000.00,2000.00,3000.00,0.00,4000.00,0.24,0
14077,1644,-1000.00,1000.00,2000.00,1783.86,1216.14,0.37,0
14078,1644,-1000.00,0.00,1000.00,0.00,2000.00,0.43,0
14079,1644,-1000.00,-1000.00,0.00,0.00,1000.00,0.23,0
14080,1645,-1000.00,-1000.00,0.00,0.00,716.29,0.18,0
14081,1646,-1000.00,-1000.00,0.00,0.00,1000.00,0.21,0
14082,1647,-1000.00,-1000.00,0.00,239.51,760.49,0.31,0
14083,1648,0.00,0.00,1000.00,0.00,0.00,0.25,0
14084,1648,-1000.00,-1000.00,0.00,109.58,432.27,0.42,0
14085,1649,-1000.00,-1000.00,0.00,324.82,675.18,0.21,0
14086,1650,-1000.00,-1000.00,0.00,0.00,1000.00,0.23,0
14087,1651,-1000.00,-1000.00,0.00,0.00,578.83,0.33,0
14088,1652,-1000.00,-1000.00,0.00,0.00,1000.00,0.09,0
14089,1653,-1000.00,-1000.00,0.00,580.09,419.91,0.18,0
14090,1654,-1000.00,-1000.00,0.00,0.00,1000.00,0.28,0
14091,1655,-1000.00,-1000.00,0.00,237.57,762.43,0.24,0
14092,1656,-849.51,-849.51,150.49,0.00,849.51,0.29,0
14093,1656,-140.60,-990.11,9.89,0.00,140.60,0.21,0
14094,1656,-5.73,-995.84,4.16,0.00,5.73,0.16,0
14095,1656,-4.16,-1000.00,0.00,1.48,2.67,0.17,0
14096,1657,-1000.00,-1000.00,0.00,0.00,1000.00,0.13,0
14097,1658,-1000.00,-1000.00,0.00,0.00,1000.00,0.07,0
14098,1659,-1000.00,-1000.00,0.00,418.39,581.61,0.22,0
14099,1660,-372.02,-372.02,627.98,372.02,0.00,0.08,0
14100,1660,0.00,-372.02,627.98,0.00,0.00,0.03,0
14101,1660,1000.00,627.98,1627.98,0.00,627.98,0.07,1
14102,1660,1000.00,1627.98,2627.98,25.78,1602.20,0.13,1
14103,1660,1000.00,2627.98,3627.98,1122.51,1318.29,0.25,1
14104,1660,1000.00,3627.98,4627.98,1626.74,2001.24,0.21,1
14105,1660,1000.00,4627.98,5627.98,0.00,4627.98,0.20,1
14106,1660,-1000.00,3627.98,4627.98,3685.97,1505.96,0.12,0
14107,1660,1000.00,4627.98,5627.98,1587.47,3040.51,0.44,1
14108,1660,1000.00,5627.98,6627.98,1316.27,4311.71,0.29,1
14109,1660,1000.00,6627.98,7627.98,0.00,6573.72,0.06,1
14110,1660,1000.00,7627.98,8627.98,3813.99,3813.99,0.11,1
14111,1660,1000.00,8627.98,9627.98,3442.99,5184.99,0.24,1
14112,1660,1000.00,9627.98,10627.98,0.00,9627.98,0.28,1
14113,1660,1000.00,10627.98,11627.98,0.00,10627.98,0.21,1
14114,1660,1000.00,11627.98,12627.98,5492.98,6135.00,0.09,1
14115,1660,1000.00,12627.98,13627.98,0.00,12627.98,0.06,1
14116,1660,1000.00,13627.98,14627.98,0.00,13627.98,0.32,1
14117,1660,1000.00,14627.98,15627.98,6918.92,7709.06,0.14,1
14118,1660,1000.00,15627.98,16627.98,0.00,8680.72,0.33,1
14119,1660,1000.00,16627.98,17627.98,7323.70,9304.28,0.13,1
14120,1660,1000.00,17627.98,18627.98,8813.99,8813.99,0.22,1
14121,1660,1000.00,18627.98,19627.98,3995.65,9011.88,0.33,1
14122,1660,1000.00,19627.98,20627.98,9813.99,9813.99,0.07,1
14123,1660,-1000.00,18627.98,19627.98,14417.36,6210.62,0.05,0
14124,1660,1000.00,19627.98,20627.98,0.00,19627.98,0.35,1
14125,1660,1000.00,20627.98,21627.98,0.00,20627.98,0.44,1
14126,1660,1000.00,21627.98,22627.98,0.00,21627.98,0.11,1
14127,1660,1000.00,22627.98,23627.98,0.00,17779.21,0.22,1
14128,1660,1000.00,23627.98,24627.98,9199.79,14428.19,0.25,1
14129,1660,1000.00,24627.98,25627.98,0.00,24627.98,0.13,1
14130,1660,-1000.00,23627.98,24627.98,22934.16,2693.81,0.01,0
14131,1660,1000.00,24627.98,25627.98,4572.03,20055.94,0.04,1
14132,1660,-1000.00,23627.98,24627.98,15480.27,10147.71,0.02,0
14133,1660,1000.00,24627.98,25627.98,12003.71,12624.26,0.31,1
14134,1660,-1000.00,23627.98,24627.98,17424.02,8203.96,0.09,0
14135,1660,1000.00,24627.98,25627.98,0.00,24627.98,0.31,1
14136,1660,1000.00,25627.98,26627.98,0.00,25627.98,0.11,1
14137,1660,-1000.00,24627.98,25627.98,18902.72,7725.26,0.06,0
14138,1660,-1000.00,23627.98,24627.98,17692.72,7935.25,0.04,0
14139,1660,1000.00,24627.98,25627.98,0.00,24627.98,0.14,1
14140,1661,-1000.00,-1000.00,0.00,346.50,653.50,0.30,0
14141,1662,-1000.00,-1000.00,0.00,0.00,1000.00,0.04,0
14142,1663,-996.41,-996.41,3.59,0.00,996.41,0.44,0
14143,1663,-3.59,-1000.00,0.00,1.48,2.11,0.22,0
14144,1664,-849.94,-849.94,150.06,138.88,711.06,0.38,0
14145,1664,-65.57,-915.51,84.49,0.00,65.57,0.20,0
14146,1664,-1000.00,-1915.51,-915.51,54.27,0.00,0.06,0
14147,1665,1000.00,1000.00,2000.00,626.38,303.75,0.13,1
14148,1665,-1000.00,0.00,1000.00,0.00,2000.00,0.13,0
14149,1665,1000.00,1000.00,2000.00,79.84,0.00,0.09,1
14150,1665,-1000.00,0.00,1000.00,0.00,1038.90,0.22,0
14151,1665,-1000.00,-1000.00,0.00,0.00,1000.00,0.40,0
14152,1666,-1000.00,-1000.00,0.00,601.40,398.60,0.16,0
14153,1667,-1000.00,-1000.00,0.00,598.83,401.17,0.16,0
14154,1668,-1000.00,-1000.00,0.00,100.53,899.47,0.43,0
14155,1669,-925.16,-925.16,74.84,584.56,340.60,0.15,0
14156,1669,1000.00,74.84,1074.84,0.00,74.84,0.34,1
14157,1669,1000.00,1074.84,2074.84,0.00,1074.84,0.44,1
14158,1669,1000.00,2074.84,3074.84,500.07,1574.77,0.21,1
14159,1669,1000.00,3074.84,4074.84,0.00,2693.28,0.23,1
14160,1669,-1000.00,2074.84,3074.84,2402.12,1672.72,0.30,0
14161,1669,-1000.00,1074.84,2074.84,1538.00,0.00,0.00,0
14162,1669,1000.00,2074.84,3074.84,0.00,2074.84,0.14,1
14163,1669,1000.00,3074.84,4074.84,1131.48,1943.37,0.43,1
14164,1669,1000.00,4074.84,5074.84,1069.34,3005.50,0.37,1
14165,1669,1000.00,5074.84,6074.84,0.00,1168.19,0.16,1
14166,1669,-1000.00,4074.84,5074.84,3087.82,2987.02,0.42,0
14167,1669,1000.00,5074.84,6074.84,0.00,5074.84,0.43,1
14168,1669,1000.00,6074.84,7074.84,2734.81,3340.03,0.14,1
14169,1669,1000.00,7074.84,8074.84,0.00,2905.63,0.22,1
14170,1669,1000.00,8074.84,9074.84,1363.85,3093.43,0.24,1
14171,1669,1000.00,9074.84,10074.84,0.00,9074.84,0.41,1
14172,1669,1000.00,10074.84,11074.84,317.63,9757.21,0.44,1
14173,1669,-1000.00,9074.84,10074.84,7247.88,3826.97,0.05,0
14174,1669,1000.00,10074.84,11074.84,1746.46,8328.38,0.24,1
14175,1669,1000.00,11074.84,12074.84,0.00,11074.84,0.42,1
14176,1669,-1000.00,10074.84,11074.84,7419.72,4655.12,0.09,0
14177,1669,-1000.00,9074.84,10074.84,1096.46,9978.39,0.21,0
14178,1669,-1000.00,8074.84,9074.84,2712.70,7362.15,0.27,0
14179,1669,0.00,8074.84,9074.84,0.00,0.00,0.05,0
14180,1669,-1000.00,7074.84,8074.84,2594.63,6480.22,0.28,0
14181,1669,-1000.00,6074.84,7074.84,2113.93,5960.91,0.22,0
14182,1669,-1000.00,5074.84,6074.84,780.72,6294.12,0.13,0
14183,1669,-1000.00,4074.84,5074.84,0.00,4248.57,0.20,0
14184,1669,-1000.00,3074.84,4074.84,1.26,1957.70,0.33,0
14185,1669,-1000.00,2074.84,3074.84,0.00,4074.84,0.06,0
14186,1669,-1000.00,1074.84,2074.84,0.00,3074.84,0.24,0
14187,1669,-1000.00,74.84,1074.84,549.51,1087.87,0.30,0
14188,1669,-827.70,-752.86,247.14,0.00,827.70,0.34,0
14189,1669,-247.14,-1000.00,0.00,0.00,247.14,0.02,0
14190,1670,-1000.00,-1000.00,0.00,199.47,800.53,0.30,0
14191,1671,0.00,0.00,1000.00,0.00,0.00,0.01,0
14192,1671,-1000.00,-1000.00,0.00,483.34,516.66,0.04,0
14193,1672,1000.00,1000.00,2000.00,0.00,1000.00,0.26,1
14194,1672,-751.34,248.66,1248.66,562.81,188.53,0.13,0
14195,1672,1000.00,1248.66,2248.66,0.00,1248.66,0.07,1
14196,1672,-1000.00,248.66,1248.66,1565.40,614.04,0.19,0
14197,1672,1000.00,1248.66,2248.66,0.00,1248.66,0.08,1
14198,1672,1000.00,2248.66,3248.66,0.00,2248.66,0.15,1
14199,1672,-1000.00,1248.66,2248.66,2776.53,472.13,0.04,0
14200,1672,1000.00,2248.66,3248.66,643.17,1605.49,0.23,1
14201,1672,1000.00,3248.66,4248.66,1567.12,1681.54,0.17,1
14202,1672,1000.00,4248.66,5248.66,2124.33,2124.33,0.05,1
14203,1672,1000.00,5248.66,6248.66,725.12,4523.54,0.25,1
14204,1672,-1000.00,4248.66,5248.66,4580.65,1668.00,0.21,0
14205,1672,1000.00,5248.66,6248.66,407.91,4840.75,0.28,1
14206,1672,1000.00,6248.66,7248.66,0.00,6248.66,0.31,1
14207,1672,1000.00,7248.66,8248.66,3136.52,4112.14,0.42,1
14208,1672,1000.00,8248.66,9248.66,2254.85,5993.81,0.44,1
14209,1672,1000.00,9248.66,10248.66,0.00,9248.66,0.20,1
14210,1672,1000.00,10248.66,11248.66,0.00,7757.03,0.41,1
14211,1672,1000.00,11248.66,12248.66,5199.84,6048.82,0.12,1
14212,1672,0.00,11248.66,12248.66,0.00,0.00,0.01,0
14213,1672,1000.00,12248.66,13248.66,585.04,11663.62,0.35,1
14214,1672,1000.00,13248.66,14248.66,0.00,13248.66,0.16,1
14215,1672,-1000.00,12248.66,13248.66,0.00,14248.66,0.06,0
14216,1672,-1000.00,11248.66,12248.66,0.00,7837.70,0.04,0
14217,1672,-1000.00,10248.66,11248.66,0.00,7691.68,0.27,0
14218,1672,-1000.00,9248.66,10248.66,3279.58,7969.08,0.22,0
14219,1672,-1000.00,8248.66,9248.66,0.00,6182.52,0.36,0
14220,1672,-1000.00,7248.66,8248.66,813.28,4992.21,0.33,0
14221,1672,-1000.00,6248.66,7248.66,0.00,3093.89,0.09,0
14222,1672,-1000.00,5248.66,6248.66,2901.15,4347.51,0.22,0
14223,1672,-1000.00,4248.66,5248.66,392.26,5856.40,0.11,0
14224,1672,-1000.00,3248.66,4248.66,0.00,5181.73,0.44,0
14225,1672,-1000.00,2248.66,3248.66,0.00,4248.66,0.24,0
14226,1672,-1000.00,1248.66,2248.66,985.75,2262.91,0.33,0
14227,1672,-1000.00,248.66,1248.66,766.16,1482.50,0.08,0
14228,1672,-1000.00,-751.34,248.66,372.43,876.23,0.32,0
14229,1672,0.00,-751.34,248.66,0.00,0.00,0.04,0
14230,1672,-1000.00,-1751.34,-751.34,129.81,118.85,0.19,0
14231,1673,-778.77,-778.77,221.23,0.00,778.77,0.41,0
14232,1673,-221.23,-1000.00,0.00,61.73,159.50,0.36,0
14233,1674,-1000.00,-1000.00,0.00,30.25,969.75,0.40,0
14234,1675,-1000.00,-1000.00,0.00,198.75,95.60,0.13,0
14235,1676,-1000.00,-1000.00,0.00,304.54,166.33,0.15,0
14236,1677,1000.00,1000.00,2000.00,0.00,865.93,0.29,1
14237,1677,1000.00,2000.00,3000.00,0.00,2000.00,0.34,1
14238,1677,1000.00,3000.00,4000.00,0.00,3000.00,0.17,1
14239,1677,1000.00,4000.00,5000.00,1132.47,2867.53,0.43,1
14240,1677,1000.00,5000.00,6000.00,0.00,540.62,0.29,1
14241,1677,-1000.00,4000.00,5000.00,2224.72,0.00,0.34,0
14242,1677,1000.00,5000.00,6000.00,246.16,274.23,0.19,1
14243,1677,0.00,5000.00,6000.00,0.00,0.00,0.24,0
14244,1677,1000.00,6000.00,7000.00,1782.13,4217.87,0.29,1
14245,1677,1000.00,7000.00,8000.00,0.00,3760.04,0.34,1
14246,1677,1000.00,8000.00,9000.00,0.00,1828.52,0.18,1
14247,1677,1000.00,9000.00,10000.00,0.00,4785.03,0.10,1
14248,1677,0.00,9000.00,10000.00,0.00,0.00,0.12,0
14249,1677,1000.00,10000.00,11000.00,0.00,10000.00,0.12,1
14250,1677,1000.00,11000.00,12000.00,3943.96,7056.04,0.23,1
14251,1677,1000.00,12000.00,13000.00,915.36,6288.21,0.26,1
14252,1677,1000.00,13000.00,14000.00,5321.97,7678.03,0.43,1
14253,1677,1000.00,14000.00,15000.00,0.00,14000.00,0.37,1
14254,1677,1000.00,15000.00,16000.00,533.96,12960.21,0.44,1
14255,1677,-1000.00,14000.00,15000.00,0.00,10122.69,0.38,0
14256,1677,-1000.00,13000.00,14000.00,11174.83,3825.17,0.23,0
14257,1677,-1000.00,12000.00,13000.00,0.00,14000.00,0.26,0
14258,1677,-1000.00,11000.00,12000.00,3344.85,9655.15,0.34,0
14259,1677,-1000.00,10000.00,11000.00,12000.00,0.00,0.07,0
14260,1677,-1000.00,9000.00,10000.00,0.00,7757.88,0.11,0
14261,1677,-1000.00,8000.00,9000.00,656.60,9343.40,0.36,0
14262,1677,-1000.00,7000.00,8000.00,1339.27,7660.73,0.18,0
14263,1677,-1000.00,6000.00,7000.00,0.00,6535.74,0.37,0
14264,1677,-1000.00,5000.00,6000.00,1439.87,3477.44,0.30,0
14265,1677,-1000.00,4000.00,5000.00,2979.20,3020.80,0.07,0
14266,1677,-1000.00,3000.00,4000.00,4261.43,738.57,0.07,0
14267,1677,-1000.00,2000.00,3000.00,0.00,4000.00,0.10,0
14268,1677,-1000.00,1000.00,2000.00,1998.18,453.05,0.32,0
14269,1677,-1000.00,0.00,1000.00,0.00,2000.00,0.04,0
14270,1677,-1000.00,-1000.00,0.00,0.00,962.83,0.22,0
14271,1678,1000.00,1000.00,2000.00,254.88,745.12,0.37,1
14272,1678,1000.00,2000.00,3000.00,519.29,1377.72,0.35,1
14273,1678,1000.00,3000.00,4000.00,840.54,2159.46,0.21,1
14274,1678,1000.00,4000.00,5000.00,1733.44,2266.56,0.05,1
14275,1678,1000.00,5000.00,6000.00,639.31,4360.69,0.27,1
14276,1678,1000.00,6000.00,7000.00,0.00,3951.53,0.38,1
14277,1678,1000.00,7000.00,8000.00,10.93,6989.07,0.21,1
14278,1678,1000.00,8000.00,9000.00,0.00,5242.70,0.07,1
14279,1678,1000.00,9000.00,10000.00,0.00,2234.94,0.20,1
14280,1678,1000.00,10000.00,11000.00,5000.00,5000.00,0.07,1
14281,1678,1000.00,11000.00,12000.00,0.00,8379.65,0.13,1
14282,1678,1000.00,12000.00,13000.00,3787.04,8212.96,0.32,1
14283,1678,1000.00,13000.00,14000.00,0.00,13000.00,0.31,1
14284,1678,1000.00,14000.00,15000.00,0.00,14000.00,0.21,1
14285,1678,1000.00,15000.00,16000.00,0.00,11907.84,0.07,1
14286,1678,0.00,15000.00,16000.00,0.00,0.00,0.06,0
14287,1678,-1000.00,14000.00,15000.00,7355.35,0.00,0.06,0
14288,1678,1000.00,15000.00,16000.00,7500.00,7500.00,0.10,1
14289,1678,-1000.00,14000.00,15000.00,8742.28,7257.72,0.19,0
14290,1678,-1000.00,13000.00,14000.00,1890.76,13109.24,0.16,0
14291,1678,-1000.00,12000.00,13000.00,0.00,14000.00,0.08,0
14292,1678,-1000.00,11000.00,12000.00,4733.33,4440.05,0.36,0
14293,1678,-1000.00,10000.00,11000.00,0.00,2538.69,0.29,0
14294,1678,-1000.00,9000.00,10000.00,5650.27,5349.73,0.00,0
14295,1678,1000.00,10000.00,11000.00,0.00,10000.00,0.19,1
14296,1678,1000.00,11000.00,12000.00,836.23,10163.77,0.42,1
14297,1678,1000.00,12000.00,13000.00,0.00,3266.11,0.09,1
14298,1678,1000.00,13000.00,14000.00,0.00,7638.57,0.34,1
14299,1678,1000.00,14000.00,15000.00,5733.63,8266.37,0.16,1
14300,1678,1000.00,15000.00,16000.00,217.84,14782.16,0.29,1
14301,1678,-1000.00,14000.00,15000.00,8043.65,7956.35,0.23,0
14302,1678,1000.00,15000.00,16000.00,6129.43,8870.57,0.22,1
14303,1678,1000.00,16000.00,17000.00,0.00,11227.80,0.20,1
14304,1678,1000.00,17000.00,18000.00,0.00,13660.21,0.11,1
14305,1678,1000.00,18000.00,19000.00,0.00,18000.00,0.02,1
14306,1678,1000.00,19000.00,20000.00,9500.00,9500.00,0.31,1
14307,1678,1000.00,20000.00,21000.00,0.00,20000.00,0.28,1
14308,1678,1000.00,21000.00,22000.00,10500.00,10500.00,0.06,1
14309,1678,1000.00,22000.00,23000.00,7554.29,14445.71,0.25,1
14310,1678,1000.00,23000.00,24000.00,10924.55,12075.45,0.43,1
14311,1678,1000.00,24000.00,25000.00,0.00,24000.00,0.09,1
14312,1678,1000.00,25000.00,26000.00,2235.30,22764.70,0.43,1
14313,1678,1000.00,26000.00,27000.00,10983.49,15016.51,0.26,1
14314,1678,1000.00,27000.00,28000.00,0.00,27000.00,0.34,1
14315,1678,1000.00,28000.00,29000.00,0.00,28000.00,0.15,1
14316,1678,1000.00,29000.00,30000.00,7051.60,21948.40,0.42,1
14317,1678,1000.00,30000.00,31000.00,9842.86,20157.14,0.18,1
14318,1679,-1000.00,-1000.00,0.00,456.46,543.54,0.15,0
14319,1680,-1000.00,-1000.00,0.00,46.96,953.04,0.25,0
14320,1681,-1000.00,-1000.00,0.00,213.30,786.70,0.22,0
14321,1682,0.00,0.00,1000.00,0.00,0.00,0.05,0
14322,1682,-1000.00,-1000.00,0.00,120.47,879.53,0.41,0
14323,1683,1000.00,1000.00,2000.00,341.14,539.65,0.28,1
14324,1683,-1000.00,0.00,1000.00,1152.75,714.41,0.16,0
14325,1683,1000.00,1000.00,2000.00,0.00,1000.00,0.12,1
14326,1683,1000.00,2000.00,3000.00,747.01,1252.99,0.07,1
14327,1683,1000.00,3000.00,4000.00,1006.94,1993.06,0.44,1
14328,1683,1000.00,4000.00,5000.00,0.00,2545.14,0.07,1
14329,1683,1000.00,5000.00,6000.00,0.00,5000.00,0.23,1
14330,1683,1000.00,6000.00,7000.00,3000.00,3000.00,0.13,1
14331,1683,1000.00,7000.00,8000.00,0.00,7000.00,0.26,1
14332,1683,1000.00,8000.00,9000.00,0.00,6891.92,0.36,1
14333,1683,1000.00,9000.00,10000.00,4500.00,4500.00,0.18,1
14334,1683,1000.00,10000.00,11000.00,0.00,10000.00,0.14,1
14335,1683,-1000.00,9000.00,10000.00,6629.28,4370.72,0.30,0
14336,1683,1000.00,10000.00,11000.00,2295.38,7704.62,0.28,1
14337,1683,1000.00,11000.00,12000.00,0.00,4088.55,0.20,1
14338,1683,1000.00,12000.00,13000.00,6000.00,6000.00,0.37,1
14339,1683,-1000.00,11000.00,12000.00,8851.48,0.00,0.03,0
14340,1683,1000.00,12000.00,13000.00,1968.18,2108.56,0.17,1
14341,1683,1000.00,13000.00,14000.00,0.00,13000.00,0.41,1
14342,1683,1000.00,14000.00,15000.00,456.05,9907.16,0.37,1
14343,1683,-1000.00,13000.00,14000.00,9487.21,5512.79,0.34,0
14344,1683,1000.00,14000.00,15000.00,4644.70,9355.30,0.33,1
14345,1683,1000.00,15000.00,16000.00,7369.68,7630.32,0.17,1
14346,1683,1000.00,16000.00,17000.00,1987.06,9613.40,0.35,1
14347,1683,1000.00,17000.00,18000.00,4246.06,12753.94,0.37,1
14348,1683,1000.00,18000.00,19000.00,8136.52,9863.48,0.19,1
14349,1683,1000.00,19000.00,20000.00,0.00,19000.00,0.36,1
14350,1683,-1000.00,18000.00,19000.00,15873.63,4126.37,0.05,0
14351,1683,1000.00,19000.00,20000.00,6129.26,12870.74,0.34,1
14352,1683,1000.00,20000.00,21000.00,0.00,20000.00,0.05,1
14353,1683,1000.00,21000.00,22000.00,0.00,13715.77,0.08,1
14354,1683,1000.00,22000.00,23000.00,5244.38,16755.62,0.17,1
14355,1683,1000.00,23000.00,24000.00,0.00,8334.49,0.14,1
14356,1683,1000.00,24000.00,25000.00,0.00,20955.90,0.26,1
14357,1683,1000.00,25000.00,26000.00,5492.36,19507.64,0.34,1
14358,1683,1000.00,26000.00,27000.00,0.00,15522.20,0.07,1
14359,1683,1000.00,27000.00,28000.00,10250.39,16749.61,0.30,1
14360,1683,1000.00,28000.00,29000.00,0.00,10619.78,0.23,1
14361,1683,0.00,28000.00,29000.00,0.00,0.00,0.01,0
14362,1683,1000.00,29000.00,30000.00,0.00,4885.78,0.07,1
14363,1683,1000.00,30000.00,31000.00,14570.30,15429.70,0.16,1
14364,1683,-1000.00,29000.00,30000.00,17546.10,13453.90,0.18,0
14365,1683,-1000.00,28000.00,29000.00,17175.04,0.00,0.06,0
14366,1683,1000.00,29000.00,30000.00,0.00,29000.00,0.19,1
14367,1683,-1000.00,28000.00,29000.00,6284.01,23715.99,0.24,0
14368,1683,-1000.00,27000.00,28000.00,0.00,29000.00,0.17,0
14369,1683,-1000.00,26000.00,27000.00,1108.51,26891.49,0.39,0
14370,1683,-1000.00,25000.00,26000.00,976.75,26023.25,0.15,0
14371,1683,-1000.00,24000.00,25000.00,0.00,26000.00,0.23,0
14372,1683,-1000.00,23000.00,24000.00,0.00,1627.81,0.09,0
14373,1683,-1000.00,22000.00,23000.00,9914.07,14085.93,0.40,0
14374,1683,-1000.00,21000.00,22000.00,0.00,18450.42,0.40,0
14375,1683,-1000.00,20000.00,21000.00,2207.50,19792.50,0.37,0
14376,1683,-1000.00,19000.00,20000.00,1732.82,5522.84,0.21,0
14377,1683,-1000.00,18000.00,19000.00,8025.77,11974.23,0.29,0
14378,1683,-1000.00,17000.00,18000.00,0.00,12419.97,0.31,0
14379,1683,-1000.00,16000.00,17000.00,12569.41,5430.59,0.04,0
14380,1683,-1000.00,15000.00,16000.00,0.00,17000.00,0.16,0
14381,1683,-1000.00,14000.00,15000.00,0.00,15238.43,0.33,0
14382,1683,-1000.00,13000.00,14000.00,2382.75,12617.25,0.41,0
14383,1683,-1000.00,12000.00,13000.00,3112.33,10887.67,0.29,0
14384,1683,-1000.00,11000.00,12000.00,0.00,5900.34,0.15,0
14385,1683,-1000.00,10000.00,11000.00,0.00,12000.00,0.31,0
14386,1683,-1000.00,9000.00,10000.00,1397.44,7871.04,0.39,0
14387,1683,-1000.00,8000.00,9000.00,0.00,10000.00,0.38,0
14388,1683,-1000.00,7000.00,8000.00,0.00,7183.07,0.41,0
14389,1683,-1000.00,6000.00,7000.00,3514.52,4485.48,0.09,0
14390,1683,-1000.00,5000.00,6000.00,0.00,3544.66,0.32,0
14391,1684,-1000.00,-1000.00,0.00,0.00,450.27,0.27,0
14392,1685,-311.48,-311.48,688.52,0.00,311.48,0.22,0
14393,1685,-688.52,-1000.00,0.00,221.80,466.72,0.29,0
14394,1686,-1000.00,-1000.00,0.00,500.00,500.00,0.03,0
14395,1687,-187.03,-187.03,812.97,0.00,187.03,0.14,0
14396,1687,-812.97,-1000.00,0.00,0.00,812.97,0.28,0
14397,1688,-1000.00,-1000.00,0.00,0.00,1000.00,0.30,0
14398,1689,-1000.00,-1000.00,0.00,438.67,561.33,0.02,0
14399,1690,-1000.00,-1000.00,0.00,0.00,1000.00,0.18,0
14400,1691,-1000.00,-1000.00,0.00,541.88,458.12,0.18,0
14401,1692,1000.00,1000.00,2000.00,0.00,1000.00,0.23,1
14402,1692,1000.00,2000.00,3000.00,638.53,1361.47,0.34,1
14403,1692,-1000.00,1000.00,2000.00,1590.31,1409.69,0.01,0
14404,1692,1000.00,2000.00,3000.00,0.00,1410.46,0.44,1
14405,1692,1000.00,3000.00,4000.00,869.47,1456.33,0.37,1
14406,1692,1000.00,4000.00,5000.00,1354.34,2645.66,0.30,1
14407,1692,1000.00,5000.00,6000.00,0.00,5000.00,0.06,1
14408,1692,1000.00,6000.00,7000.00,0.00,4365.35,0.42,1
14409,1692,-1000.00,5000.00,6000.00,5227.41,1772.59,0.11,0
14410,1692,1000.00,6000.00,7000.00,0.00,1557.54,0.28,1
14411,1692,1000.00,7000.00,8000.00,3500.00,3500.00,0.10,1
14412,1692,1000.00,8000.00,9000.00,867.93,7132.07,0.24,1
14413,1692,1000.00,9000.00,10000.00,2761.40,6238.60,0.39,1
14414,1692,1000.00,10000.00,11000.00,3731.82,6268.18,0.21,1
14415,1692,1000.00,11000.00,12000.00,0.00,11000.00,0.03,1
14416,1692,1000.00,12000.00,13000.00,5657.41,6342.59,0.41,1
14417,1692,-1000.00,11000.00,12000.00,4800.30,989.25,0.21,0
14418,1692,-1000.00,10000.00,11000.00,478.83,11521.17,0.37,0
14419,1692,-1000.00,9000.00,10000.00,3520.47,7479.53,0.16,0
14420,1692,-1000.00,8000.00,9000.00,9860.22,0.00,0.30,0
14421,1692,-1000.00,7000.00,8000.00,1270.24,7729.76,0.43,0
14422,1692,-1000.00,6000.00,7000.00,0.00,3616.15,0.13,0
14423,1692,-1000.00,5000.00,6000.00,1374.96,5625.04,0.31,0
14424,1692,-1000.00,4000.00,5000.00,0.00,1382.44,0.24,0
14425,1692,-1000.00,3000.00,4000.00,936.22,4063.78,0.10,0
14426,1692,-1000.00,2000.00,3000.00,1882.38,2117.62,0.30,0
14427,1692,-1000.00,1000.00,2000.00,1277.61,1722.39,0.27,0
14428,1692,-1000.00,0.00,1000.00,882.10,467.00,0.18,0
14429,1692,-1000.00,-1000.00,0.00,572.50,427.50,0.29,0
14430,1693,1000.00,1000.00,2000.00,0.00,1000.00,0.25,1
14431,1693,1000.00,2000.00,3000.00,0.00,1427.14,0.37,1
14432,1693,1000.00,3000.00,4000.00,0.00,3000.00,0.02,1
14433,1693,1000.00,4000.00,5000.00,122.68,3877.32,0.09,1
14434,1693,1000.00,5000.00,6000.00,1920.18,3079.82,0.32,1
14435,1693,1000.00,6000.00,7000.00,2750.74,3249.26,0.21,1
14436,1693,-1000.00,5000.00,6000.00,4380.17,2619.83,0.05,0
14437,1693,1000.00,6000.00,7000.00,1520.50,4362.66,0.39,1
14438,1693,-1000.00,5000.00,6000.00,3846.35,3153.65,0.36,0
14439,1693,-1000.00,4000.00,5000.00,6000.00,0.00,0.01,0
14440,1693,-1000.00,3000.00,4000.00,882.56,411.35,0.15,0
14441,1693,1000.00,4000.00,5000.00,791.54,3208.46,0.40,1
14442,1693,1000.00,5000.00,6000.00,2500.00,2500.00,0.28,1
14443,1693,1000.00,6000.00,7000.00,673.27,5326.73,0.15,1
14444,1693,1000.00,7000.00,8000.00,3500.00,3500.00,0.03,1
14445,1693,1000.00,8000.00,9000.00,0.00,8000.00,0.01,1
14446,1693,1000.00,9000.00,10000.00,0.00,7987.73,0.30,1
14447,1693,1000.00,10000.00,11000.00,1993.56,8006.44,0.19,1
14448,1693,1000.00,11000.00,12000.00,0.00,8647.68,0.34,1
14449,1693,1000.00,12000.00,13000.00,5802.28,6197.72,0.24,1
14450,1693,1000.00,13000.00,14000.00,0.00,13000.00,0.04,1
14451,1693,1000.00,14000.00,15000.00,3714.71,10285.29,0.38,1
14452,1693,1000.00,15000.00,16000.00,5309.91,9690.09,0.31,1
14453,1693,1000.00,16000.00,17000.00,5518.31,10481.69,0.43,1
14454,1693,1000.00,17000.00,18000.00,2268.22,14731.78,0.42,1
14455,1693,1000.00,18000.00,19000.00,0.00,18000.00,0.00,1
14456,1693,1000.00,19000.00,20000.00,0.00,16619.53,0.33,1
14457,1693,1000.00,20000.00,21000.00,0.00,9168.74,0.21,1
14458,1693,1000.00,21000.00,22000.00,4150.27,16849.73,0.43,1
14459,1693,1000.00,22000.00,23000.00,0.00,19610.92,0.17,1
14460,1693,1000.00,23000.00,24000.00,0.00,23000.00,0.17,1
14461,1693,1000.00,24000.00,25000.00,0.00,15385.36,0.28,1
14462,1693,1000.00,25000.00,26000.00,9025.09,15974.91,0.41,1
14463,1693,-1000.00,24000.00,25000.00,7891.10,0.00,0.04,0
14464,1693,1000.00,25000.00,26000.00,0.00,15185.25,0.09,1
14465,1693,-1000.00,24000.00,25000.00,3685.32,2333.66,0.14,0
14466,1693,1000.00,25000.00,26000.00,0.00,25000.00,0.25,1
14467,1693,1000.00,26000.00,27000.00,9822.52,16177.48,0.35,1
14468,1694,-732.92,-732.92,267.08,0.00,732.92,0.39,0
14469,1694,-267.08,-1000.00,0.00,0.00,267.08,0.37,0
14470,1695,-1000.00,-1000.00,0.00,0.00,407.19,0.21,0
14471,1696,0.00,0.00,1000.00,0.00,0.00,0.02,0
14472,1696,-1000.00,-1000.00,0.00,473.06,178.87,0.13,0
14473,1697,-1000.00,-1000.00,0.00,0.00,1000.00,0.04,0
14474,1698,-1000.00,-1000.00,0.00,302.52,697.48,0.35,0
14475,1699,-151.90,-151.90,848.10,0.00,151.90,0.06,0
14476,1699,-848.10,-1000.00,0.00,424.05,424.05,0.02,0
14477,1700,-1000.00,-1000.00,0.00,118.78,881.22,0.39,0
14478,1701,-1000.00,-1000.00,0.00,0.00,673.57,0.35,0
14479,1702,-1000.00,-1000.00,0.00,0.00,1000.00,0.29,0
14480,1703,0.00,0.00,1000.00,0.00,0.00,0.05,0
14481,1703,-1000.00,-1000.00,0.00,299.45,700.55,0.32,0
14482,1704,-1000.00,-1000.00,0.00,0.00,670.91,0.12,0
14483,1705,1000.00,1000.00,2000.00,437.31,562.69,0.01,1
14484,1705,1000.00,2000.00,3000.00,0.00,2000.00,0.36,1
14485,1705,1000.00,3000.00,4000.00,0.00,3000.00,0.18,1
14486,1705,1000.00,4000.00,5000.00,1536.84,2463.16,0.31,1
14487,1705,0.00,4000.00,5000.00,0.00,0.00,0.00,0
14488,1705,1000.00,5000.00,6000.00,1689.48,3220.03,0.32,1
14489,1705,1000.00,6000.00,7000.00,0.00,6000.00,0.36,1
14490,1705,1000.00,7000.00,8000.00,0.00,7000.00,0.34,1
14491,1705,1000.00,8000.00,9000.00,0.00,5239.36,0.05,1
14492,1705,1000.00,9000.00,10000.00,0.00,9000.00,0.38,1
14493,1705,1000.00,10000.00,11000.00,0.00,10000.00,0.05,1
14494,1705,1000.00,11000.00,12000.00,4738.01,6261.99,0.21,1
14495,1705,-1000.00,10000.00,11000.00,7794.15,4205.85,0.08,0
14496,1705,1000.00,11000.00,12000.00,0.00,9912.22,0.11,1
14497,1705,1000.00,12000.00,13000.00,0.00,12000.00,0.44,1
14498,1705,1000.00,13000.00,14000.00,0.00,10383.65,0.14,1
14499,1705,1000.00,14000.00,15000.00,0.00,14000.00,0.20,1
14500,1705,1000.00,15000.00,16000.00,5166.97,9833.03,0.11,1
14501,1705,1000.00,16000.00,17000.00,8000.00,8000.00,0.08,1
14502,1705,-393.09,15606.91,16606.91,393.09,0.00,0.08,0
14503,1705,1000.00,16606.91,17606.91,0.00,16606.91,0.17,1
14504,1705,1000.00,17606.91,18606.91,8803.45,8803.45,0.08,1
14505,1705,1000.00,18606.91,19606.91,0.00,13119.76,0.34,1
14506,1705,1000.00,19606.91,20606.91,2732.22,16874.69,0.31,1
14507,1705,1000.00,20606.91,21606.91,3806.62,9020.40,0.29,1
14508,1705,1000.00,21606.91,22606.91,4939.60,16667.31,0.03,1
14509,1705,1000.00,22606.91,23606.91,0.00,22606.91,0.18,1
14510,1705,1000.00,23606.91,24606.91,1630.60,21976.31,0.12,1
14511,1705,1000.00,24606.91,25606.91,11367.44,13239.46,0.11,1
14512,1705,1000.00,25606.91,26606.91,540.30,25066.61,0.21,1
14513,1705,1000.00,26606.91,27606.91,0.00,21571.14,0.05,1
14514,1705,1000.00,27606.91,28606.91,0.00,27606.91,0.15,1
14515,1705,1000.00,28606.91,29606.91,0.00,7739.97,0.21,1
14516,1705,1000.00,29606.91,30606.91,13061.94,16544.97,0.36,1
14517,1705,1000.00,30606.91,31606.91,0.00,20039.00,0.30,1
14518,1705,1000.00,31606.91,32606.91,103.96,31502.95,0.44,1
14519,1705,-1000.00,30606.91,31606.91,14494.92,0.00,0.08,0
14520,1705,1000.00,31606.91,32606.91,15012.78,15521.17,0.24,1
14521,1705,1000.00,32606.91,33606.91,0.00,25139.94,0.43,1
14522,1705,1000.00,33606.91,34606.91,0.00,33606.91,0.25,1
14523,1705,1000.00,34606.91,35606.91,8989.99,25616.92,0.42,1
14524,1705,1000.00,35606.91,36606.91,0.00,34322.79,0.28,1
14525,1705,-1000.00,34606.91,35606.91,19872.98,16733.93,0.33,0
14526,1705,-1000.00,33606.91,34606.91,19382.78,16224.13,0.12,0
14527,1705,-1000.00,32606.91,33606.91,20368.75,14238.16,0.18,0
14528,1705,1000.00,33606.91,34606.91,1600.18,26275.83,0.30,1
14529,1705,-1000.00,32606.91,33606.91,3567.44,0.00,0.10,0
14530,1705,1000.00,33606.91,34606.91,0.00,31964.54,0.17,1
14531,1705,1000.00,34606.91,35606.91,0.00,34606.91,0.25,1
14532,1705,1000.00,35606.91,36606.91,0.00,26186.77,0.27,1
14533,1705,1000.00,36606.91,37606.91,16442.21,20164.70,0.31,1
14534,1705,1000.00,37606.91,38606.91,6104.84,31502.07,0.38,1
14535,1705,1000.00,38606.91,39606.91,0.00,35278.90,0.44,1
14536,1705,1000.00,39606.91,40606.91,0.00,39606.91,0.14,1
14537,1705,1000.00,40606.91,41606.91,0.00,40606.91,0.32,1
14538,1705,1000.00,41606.91,42606.91,14399.21,27207.70,0.39,1
14539,1705,1000.00,42606.91,43606.91,10807.64,31799.27,0.39,1
14540,1705,-1000.00,41606.91,42606.91,24264.61,19342.30,0.16,0
14541,1705,1000.00,42606.91,43606.91,0.00,30523.34,0.41,1
14542,1705,1000.00,43606.91,44606.91,21803.45,21803.45,0.01,1
14543,1705,-1000.00,42606.91,43606.91,16393.80,0.00,0.10,0
14544,1705,1000.00,43606.91,44606.91,0.00,43606.91,0.23,1
14545,1705,1000.00,44606.91,45606.91,0.00,16540.54,0.07,1
14546,1705,1000.00,45606.91,46606.91,3730.30,24068.41,0.33,1
14547,1705,-1000.00,44606.91,45606.91,44555.78,2051.13,0.12,0
14548,1705,1000.00,45606.91,46606.91,0.00,45606.91,0.21,1
14549,1705,1000.00,46606.91,47606.91,0.00,29331.53,0.22,1
14550,1705,1000.00,47606.91,48606.91,0.00,13561.28,0.20,1
14551,1705,1000.00,48606.91,49606.91,24303.45,24303.45,0.04,1
14552,1706,1000.00,1000.00,2000.00,0.00,720.52,0.34,1
14553,1706,1000.00,2000.00,3000.00,0.00,2000.00,0.28,1
14554,1706,-66.94,1933.06,2933.06,49.97,16.97,0.25,0
14555,1706,1000.00,2933.06,3933.06,0.00,2933.06,0.38,1
14556,1706,1000.00,3933.06,4933.06,0.00,3933.06,0.06,1
14557,1706,-1000.00,2933.06,3933.06,2425.04,1477.57,0.23,0
14558,1706,1000.00,3933.06,4933.06,809.47,3123.59,0.40,1
14559,1706,1000.00,4933.06,5933.06,0.00,2776.28,0.37,1
14560,1706,1000.00,5933.06,6933.06,1.00,5932.05,0.42,1
14561,1706,1000.00,6933.06,7933.06,0.00,5943.73,0.27,1
14562,1706,1000.00,7933.06,8933.06,2233.58,3272.99,0.14,1
14563,1706,1000.00,8933.06,9933.06,0.00,8933.06,0.10,1
14564,1706,1000.00,9933.06,10933.06,0.00,9933.06,0.01,1
14565,1706,-1000.00,8933.06,9933.06,6147.10,0.00,0.03,0
14566,1706,1000.00,9933.06,10933.06,3286.62,5408.43,0.34,1
14567,1706,1000.00,10933.06,11933.06,5024.21,5908.85,0.35,1
14568,1706,1000.00,11933.06,12933.06,0.00,3688.85,0.18,1
14569,1706,1000.00,12933.06,13933.06,6127.09,6805.97,0.17,1
14570,1706,1000.00,13933.06,14933.06,0.00,8677.62,0.39,1
14571,1706,1000.00,14933.06,15933.06,7466.53,7466.53,0.02,1
14572,1706,1000.00,15933.06,16933.06,5990.28,9942.77,0.30,1
14573,1706,1000.00,16933.06,17933.06,6595.01,10338.05,0.04,1
14574,1706,-1000.00,15933.06,16933.06,7039.57,4873.58,0.21,0
14575,1706,-1000.00,14933.06,15933.06,12022.60,4910.46,0.07,0
14576,1706,1000.00,15933.06,16933.06,0.00,15933.06,0.04,1
14577,1706,1000.00,16933.06,17933.06,0.00,16933.06,0.18,1
14578,1706,-1000.00,15933.06,16933.06,10393.28,1682.58,0.13,0
14579,1706,1000.00,16933.06,17933.06,0.00,16933.06,0.10,1
14580,1706,1000.00,17933.06,18933.06,1745.38,16187.68,0.31,1
14581,1706,-1000.00,16933.06,17933.06,12855.26,0.00,0.06,0
14582,1706,1000.00,17933.06,18933.06,0.00,16427.74,0.39,1
14583,1706,1000.00,18933.06,19933.06,9334.18,9598.88,0.20,1
14584,1706,1000.00,19933.06,20933.06,0.00,10431.86,0.36,1
14585,1706,1000.00,20933.06,21933.06,6993.91,13939.15,0.26,1
14586,1706,1000.00,21933.06,22933.06,0.00,21933.06,0.19,1
14587,1706,1000.00,22933.06,23933.06,0.00,15262.34,0.42,1
14588,1706,1000.00,23933.06,24933.06,0.00,23933.06,0.12,1
14589,1706,1000.00,24933.06,25933.06,11836.05,13097.00,0.22,1
14590,1706,1000.00,25933.06,26933.06,0.00,11172.54,0.15,1
14591,1706,1000.00,26933.06,27933.06,0.00,16346.09,0.15,1
14592,1706,1000.00,27933.06,28933.06,0.00,14123.14,0.27,1
14593,1706,1000.00,28933.06,29933.06,0.00,28933.06,0.13,1
14594,1706,1000.00,29933.06,30933.06,9097.67,20835.39,0.34,1
14595,1706,-1000.00,28933.06,29933.06,1340.76,0.00,0.12,0
14596,1706,1000.00,29933.06,30933.06,0.00,16033.73,0.35,1
14597,1706,1000.00,30933.06,31933.06,1918.42,29014.63,0.10,1
14598,1706,1000.00,31933.06,32933.06,15966.53,15966.53,0.21,1
14599,1706,-1000.00,30933.06,31933.06,17422.57,15510.49,0.04,0
14600,1706,-1000.00,29933.06,30933.06,0.00,31933.06,0.22,0
14601,1706,0.00,29933.06,30933.06,0.00,0.00,0.01,0
14602,1706,0.00,29933.06,30933.06,0.00,0.00,0.07,0
14603,1706,-1000.00,28933.06,29933.06,0.00,30933.06,0.32,0
14604,1706,-1000.00,27933.06,28933.06,1615.81,17168.14,0.39,0
14605,1706,-1000.00,26933.06,27933.06,16639.94,12293.12,0.15,0
14606,1706,-1000.00,25933.06,26933.06,10623.25,17309.80,0.04,0
14607,1706,-1000.00,24933.06,25933.06,0.00,26933.06,0.29,0
14608,1706,-1000.00,23933.06,24933.06,0.00,25933.06,0.22,0
14609,1706,-1000.00,22933.06,23933.06,7104.45,17828.60,0.02,0
14610,1706,-1000.00,21933.06,22933.06,0.00,23933.06,0.10,0
14611,1706,-1000.00,20933.06,21933.06,0.00,22933.06,0.06,0
14612,1706,-1000.00,19933.06,20933.06,7775.46,14157.59,0.30,0
14613,1706,-1000.00,18933.06,19933.06,5472.00,8434.39,0.31,0
14614,1706,-1000.00,17933.06,18933.06,13428.17,6504.88,0.15,0
14615,1706,-1000.00,16933.06,17933.06,7731.28,11201.78,0.30,0
14616,1706,-1000.00,15933.06,16933.06,0.00,17933.06,0.29,0
14617,1706,-1000.00,14933.06,15933.06,6641.16,2291.75,0.19,0
14618,1706,-1000.00,13933.06,14933.06,0.00,9642.34,0.03,0
14619,1706,-1000.00,12933.06,13933.06,3130.06,11802.99,0.39,0
14620,1706,-1000.00,11933.06,12933.06,0.00,11255.58,0.35,0
14621,1706,-1000.00,10933.06,11933.06,5868.01,7065.05,0.30,0
14622,1706,-1000.00,9933.06,10933.06,0.00,4093.49,0.11,0
14623,1706,-1000.00,8933.06,9933.06,0.00,10933.06,0.26,0
14624,1706,-1000.00,7933.06,8933.06,9933.06,0.00,0.01,0
14625,1706,-1000.00,6933.06,7933.06,1985.71,6947.35,0.28,0
14626,1706,-1000.00,5933.06,6933.06,3122.95,4810.11,0.22,0
14627,1706,-1000.00,4933.06,5933.06,3466.53,3466.53,0.08,0
14628,1706,-1000.00,3933.06,4933.06,476.77,4308.52,0.40,0
14629,1706,-1000.00,2933.06,3933.06,2727.60,2205.46,0.04,0
14630,1706,-1000.00,1933.06,2933.06,0.00,3005.35,0.40,0
14631,1706,0.00,1933.06,2933.06,0.00,0.00,0.09,0
14632,1706,-1000.00,933.06,1933.06,1491.01,1442.04,0.36,0
14633,1706,-1000.00,-66.94,933.06,0.00,1933.06,0.39,0
14634,1706,-1000.00,-1066.94,-66.94,266.13,0.00,0.10,0
14635,1707,-1000.00,-1000.00,0.00,247.43,752.57,0.38,0
14636,1708,-1000.00,-1000.00,0.00,542.42,457.58,0.12,0
14637,1709,0.00,0.00,1000.00,0.00,0.00,0.06,0
14638,1709,-1000.00,-1000.00,0.00,244.49,755.51,0.28,0
14639,1710,1000.00,1000.00,2000.00,167.07,832.93,0.42,1
14640,1710,1000.00,2000.00,3000.00,308.97,1691.03,0.42,1
14641,1710,1000.00,3000.00,4000.00,1374.78,1625.22,0.04,1
14642,1710,1000.00,4000.00,5000.00,1262.88,2737.12,0.31,1
14643,1710,1000.00,5000.00,6000.00,635.88,4364.12,0.39,1
14644,1710,1000.00,6000.00,7000.00,0.00,6000.00,0.23,1
14645,1710,-1000.00,5000.00,6000.00,3628.18,0.00,0.08,0
14646,1710,1000.00,6000.00,7000.00,2125.73,3874.27,0.05,1
14647,1710,1000.00,7000.00,8000.00,0.00,7000.00,0.05,1
14648,1710,1000.00,8000.00,9000.00,3836.18,4163.82,0.23,1
14649,1710,1000.00,9000.00,10000.00,4307.43,4692.57,0.36,1
14650,1710,-1000.00,8000.00,9000.00,5237.33,4762.67,0.08,0
14651,1710,1000.00,9000.00,10000.00,1427.26,7572.74,0.07,1
14652,1710,1000.00,10000.00,11000.00,1211.81,8788.19,0.43,1
14653,1710,1000.00,11000.00,12000.00,4040.24,6959.76,0.31,1
14654,1710,1000.00,12000.00,13000.00,0.00,9164.65,0.41,1
14655,1710,1000.00,13000.00,14000.00,0.00,8579.65,0.14,1
14656,1710,1000.00,14000.00,15000.00,6585.91,7414.09,0.12,1
14657,1710,1000.00,15000.00,16000.00,0.00,12185.10,0.20,1
14658,1710,1000.00,16000.00,17000.00,0.00,16000.00,0.20,1
14659,1710,1000.00,17000.00,18000.00,7907.23,9092.77,0.37,1
14660,1710,1000.00,18000.00,19000.00,774.74,17225.26,0.44,1
14661,1710,-1000.00,17000.00,18000.00,9500.00,9500.00,0.27,0
14662,1710,-1000.00,16000.00,17000.00,5647.27,12352.73,0.25,0
14663,1710,-1000.00,15000.00,16000.00,0.00,12024.17,0.36,0
14664,1710,-1000.00,14000.00,15000.00,3368.62,12631.38,0.14,0
14665,1710,-1000.00,13000.00,14000.00,7668.64,7331.36,0.19,0
14666,1710,-1000.00,12000.00,13000.00,3417.39,10582.61,0.31,0
14667,1710,-1000.00,11000.00,12000.00,0.00,12646.04,0.32,0
14668,1710,-1000.00,10000.00,11000.00,990.59,11009.41,0.27,0
14669,1710,-1000.00,9000.00,10000.00,5486.21,5513.79,0.11,0
14670,1710,-1000.00,8000.00,9000.00,7226.91,2773.09,0.15,0
14671,1710,-1000.00,7000.00,8000.00,0.00,9000.00,0.32,0
14672,1710,-1000.00,6000.00,7000.00,3000.22,4999.78,0.35,0
14673,1710,-1000.00,5000.00,6000.00,7000.00,0.00,0.00,0
14674,1710,-1000.00,4000.00,5000.00,5929.42,0.00,0.02,0
14675,1710,-1000.00,3000.00,4000.00,2132.73,2867.27,0.19,0
14676,1710,-1000.00,2000.00,3000.00,0.00,4000.00,0.10,0
14677,1710,-1000.00,1000.00,2000.00,0.00,3000.00,0.06,0
14678,1710,-1000.00,0.00,1000.00,686.20,1313.80,0.26,0
14679,1710,-817.90,-817.90,182.10,201.66,616.24,0.34,0
14680,1710,-1000.00,-1817.90,-817.90,102.75,79.35,0.09,0
14681,1711,-625.61,-625.61,374.39,51.36,574.26,0.36,0
14682,1711,-374.39,-1000.00,0.00,187.19,187.19,0.02,0
14683,1712,1000.00,1000.00,2000.00,0.00,882.16,0.26,1
14684,1712,-553.67,446.33,1446.33,351.44,202.23,0.15,0
14685,1712,1000.00,1446.33,2446.33,0.00,640.11,0.31,1
14686,1712,-1000.00,446.33,1446.33,1570.55,825.22,0.20,0
14687,1712,1000.00,1446.33,2446.33,0.00,1446.33,0.18,1
14688,1712,-1000.00,446.33,1446.33,1318.34,1128.00,0.02,0
14689,1712,-1000.00,-553.67,446.33,1418.64,27.69,0.03,0
14690,1712,1000.00,446.33,1446.33,211.14,235.20,0.24,1
14691,1712,1000.00,1446.33,2446.33,723.17,723.17,0.13,1
14692,1712,1000.00,2446.33,3446.33,1108.41,1337.92,0.25,1
14693,1712,1000.00,3446.33,4446.33,0.00,3402.89,0.27,1
14694,1712,1000.00,4446.33,5446.33,1430.71,3015.62,0.13,1
14695,1712,1000.00,5446.33,6446.33,0.00,5446.33,0.33,1
14696,1712,1000.00,6446.33,7446.33,1577.66,4005.50,0.35,1
14697,1712,1000.00,7446.33,8446.33,0.00,4288.97,0.25,1
14698,1712,-1000.00,6446.33,7446.33,5277.34,2511.15,0.13,0
14699,1712,1000.00,7446.33,8446.33,0.00,6343.07,0.32,1
14700,1712,-1000.00,6446.33,7446.33,4675.25,3771.09,0.31,0
14701,1712,-1000.00,5446.33,6446.33,3290.23,2013.46,0.16,0
14702,1712,1000.00,6446.33,7446.33,0.00,3224.36,0.06,1
14703,1712,1000.00,7446.33,8446.33,2537.91,4908.42,0.41,1
14704,1712,-1000.00,6446.33,7446.33,5956.29,2490.05,0.25,0
14705,1712,-1000.00,5446.33,6446.33,1520.80,5925.54,0.34,0
14706,1712,-1000.00,4446.33,5446.33,0.00,6287.02,0.36,0
14707,1712,-1000.00,3446.33,4446.33,292.23,3805.45,0.12,0
14708,1712,-1000.00,2446.33,3446.33,0.00,4446.33,0.16,0
14709,1712,-1000.00,1446.33,2446.33,1723.17,1723.17,0.13,0
14710,1712,-1000.00,446.33,1446.33,0.00,1948.36,0.30,0
14711,1712,0.00,446.33,1446.33,0.00,0.00,0.00,0
14712,1712,-1000.00,-553.67,446.33,719.81,726.52,0.07,0
14713,1712,-446.33,-1000.00,0.00,126.03,320.31,0.36,0
14714,1713,-1000.00,-1000.00,0.00,114.86,885.14,0.13,0
14715,1714,-1000.00,-1000.00,0.00,560.31,107.61,0.09,0
14716,1715,-1000.00,-1000.00,0.00,730.12,269.88,0.07,0
14717,1716,-1000.00,-1000.00,0.00,0.00,1000.00,0.11,0
14718,1717,-1000.00,-1000.00,0.00,398.68,601.32,0.24,0
14719,1718,1000.00,1000.00,2000.00,220.92,685.95,0.36,1
14720,1718,1000.00,2000.00,3000.00,46.68,1953.32,0.10,1
14721,1718,1000.00,3000.00,4000.00,0.00,2536.75,0.40,1
14722,1718,1000.00,4000.00,5000.00,1309.91,2690.09,0.38,1
14723,1718,1000.00,5000.00,6000.00,2500.00,2500.00,0.14,1
14724,1718,1000.00,6000.00,7000.00,0.00,6000.00,0.07,1
14725,1718,1000.00,7000.00,8000.00,1961.15,5038.85,0.37,1
14726,1718,-1000.00,6000.00,7000.00,0.00,8000.00,0.35,0
14727,1718,-1000.00,5000.00,6000.00,4424.94,2575.06,0.37,0
14728,1718,-1000.00,4000.00,5000.00,4248.94,1751.06,0.04,0
14729,1718,0.00,4000.00,5000.00,0.00,0.00,0.19,0
14730,1718,0.00,4000.00,5000.00,0.00,0.00,0.15,0
14731,1718,-1000.00,3000.00,4000.00,2392.60,1441.83,0.31,0
14732,1718,-1000.00,2000.00,3000.00,0.00,1907.28,0.43,0
14733,1718,-1000.00,1000.00,2000.00,2510.78,0.00,0.02,0
14734,1718,-1000.00,0.00,1000.00,1558.17,441.83,0.09,0
14735,1718,-1000.00,-1000.00,0.00,0.00,650.55,0.23,0
14736,1719,-1000.00,-1000.00,0.00,0.00,1000.00,0.30,0
14737,1720,1000.00,1000.00,2000.00,314.49,629.38,0.32,1
14738,1720,1000.00,2000.00,3000.00,0.00,1124.36,0.23,1
14739,1720,1000.00,3000.00,4000.00,355.51,2644.49,0.30,1
14740,1720,1000.00,4000.00,5000.00,0.00,4000.00,0.04,1
14741,1720,1000.00,5000.00,6000.00,1324.30,3675.70,0.25,1
14742,1720,-1000.00,4000.00,5000.00,3447.82,2552.18,0.05,0
14743,1720,1000.00,5000.00,6000.00,2156.81,2843.19,0.17,1
14744,1720,1000.00,6000.00,7000.00,0.00,5512.52,0.43,1
14745,1720,1000.00,7000.00,8000.00,1497.43,5502.57,0.31,1
14746,1720,1000.00,8000.00,9000.00,2745.70,5254.30,0.31,1
14747,1720,1000.00,9000.00,10000.00,4500.00,4500.00,0.13,1
14748,1720,1000.00,10000.00,11000.00,5000.00,5000.00,0.27,1
14749,1720,1000.00,11000.00,12000.00,5500.00,5500.00,0.20,1
14750,1720,1000.00,12000.00,13000.00,0.00,12000.00,0.17,1
14751,1720,1000.00,13000.00,14000.00,0.00,1839.33,0.05,1
14752,1720,-1000.00,12000.00,13000.00,7559.32,6440.68,0.12,0
14753,1720,1000.00,13000.00,14000.00,0.00,13000.00,0.34,1
14754,1720,1000.00,14000.00,15000.00,2659.14,11340.86,0.40,1
14755,1720,-1000.00,13000.00,14000.00,6477.31,1450.14,0.13,0
14756,1720,1000.00,14000.00,15000.00,0.00,14000.00,0.38,1
14757,1720,1000.00,15000.00,16000.00,0.00,8261.08,0.32,1
14758,1720,1000.00,16000.00,17000.00,6249.03,9750.97,0.33,1
14759,1720,1000.00,17000.00,18000.00,0.00,5297.88,0.26,1
14760,1720,1000.00,18000.00,19000.00,0.00,18000.00,0.39,1
14761,1720,0.00,18000.00,19000.00,0.00,0.00,0.11,0
14762,1720,0.00,18000.00,19000.00,0.00,0.00,0.05,0
14763,1720,1000.00,19000.00,20000.00,5989.98,13010.02,0.32,1
14764,1720,1000.00,20000.00,21000.00,0.00,6002.06,0.23,1
14765,1720,1000.00,21000.00,22000.00,5117.08,15882.92,0.38,1
14766,1720,-1000.00,20000.00,21000.00,9575.47,7244.88,0.19,0
14767,1720,1000.00,21000.00,22000.00,8512.89,12487.11,0.14,1
14768,1720,1000.00,22000.00,23000.00,0.00,22000.00,0.40,1
14769,1720,1000.00,23000.00,24000.00,7651.08,15348.92,0.27,1
14770,1720,1000.00,24000.00,25000.00,10728.75,13271.25,0.39,1
14771,1720,1000.00,25000.00,26000.00,2042.38,12909.99,0.35,1
14772,1720,1000.00,26000.00,27000.00,0.00,26000.00,0.35,1
14773,1720,1000.00,27000.00,28000.00,13500.00,13500.00,0.01,1
14774,1720,1000.00,28000.00,29000.00,0.00,19780.50,0.31,1
14775,1720,1000.00,29000.00,30000.00,0.00,10839.97,0.07,1
14776,1720,1000.00,30000.00,31000.00,11454.87,18545.13,0.20,1
14777,1720,-1000.00,29000.00,30000.00,31000.00,0.00,0.02,0
14778,1720,1000.00,30000.00,31000.00,15000.00,15000.00,0.30,1
14779,1720,1000.00,31000.00,32000.00,0.00,12513.40,0.10,1
14780,1720,1000.00,32000.00,33000.00,0.00,21056.05,0.33,1
14781,1720,1000.00,33000.00,34000.00,14068.46,18931.54,0.05,1
14782,1720,-1000.00,32000.00,33000.00,7344.86,9264.54,0.21,0
14783,1720,-1000.00,31000.00,32000.00,13157.27,19842.73,0.23,0
14784,1720,-1000.00,30000.00,31000.00,0.00,32000.00,0.01,0
14785,1720,-1000.00,29000.00,30000.00,0.00,31000.00,0.06,0
14786,1720,-1000.00,28000.00,29000.00,0.00,30000.00,0.10,0
14787,1720,-1000.00,27000.00,28000.00,0.00,29000.00,0.29,0
14788,1720,-1000.00,26000.00,27000.00,15804.39,12195.61,0.34,0
14789,1720,-1000.00,25000.00,26000.00,11480.70,2850.95,0.14,0
14790,1720,-1000.00,24000.00,25000.00,0.00,26000.00,0.01,0
14791,1720,-1000.00,23000.00,24000.00,0.00,25000.00,0.07,0
14792,1720,-1000.00,22000.00,23000.00,10353.43,13646.57,0.39,0
14793,1720,-1000.00,21000.00,22000.00,12169.10,10830.90,0.09,0
14794,1720,-1000.00,20000.00,21000.00,0.00,22000.00,0.24,0
14795,1720,-1000.00,19000.00,20000.00,6939.49,14060.51,0.32,0
14796,1720,-1000.00,18000.00,19000.00,3347.68,16652.32,0.39,0
14797,1720,-1000.00,17000.00,18000.00,0.00,19000.00,0.07,0
14798,1720,-1000.00,16000.00,17000.00,2554.16,15445.84,0.43,0
14799,1720,-1000.00,15000.00,16000.00,8500.00,8500.00,0.31,0
14800,1720,-1000.00,14000.00,15000.00,6200.35,9799.65,0.35,0
14801,1721,1000.00,1000.00,2000.00,111.04,217.04,0.19,1
14802,1721,1000.00,2000.00,3000.00,0.00,1212.82,0.36,1
14803,1721,1000.00,3000.00,4000.00,0.00,1256.74,0.22,1
14804,1721,1000.00,4000.00,5000.00,1866.04,2133.96,0.02,1
14805,1721,1000.00,5000.00,6000.00,1727.01,3272.99,0.21,1
14806,1721,1000.00,6000.00,7000.00,0.00,6000.00,0.27,1
14807,1721,1000.00,7000.00,8000.00,3342.49,3657.51,0.18,1
14808,1721,1000.00,8000.00,9000.00,2168.01,2551.89,0.21,1
14809,1721,1000.00,9000.00,10000.00,3303.40,5696.60,0.30,1
14810,1721,1000.00,10000.00,11000.00,0.00,4133.99,0.25,1
14811,1721,1000.00,11000.00,12000.00,4074.78,6925.22,0.21,1
14812,1721,1000.00,12000.00,13000.00,0.00,3509.27,0.19,1
14813,1721,1000.00,13000.00,14000.00,6500.00,6500.00,0.02,1
14814,1721,1000.00,14000.00,15000.00,0.00,14000.00,0.02,1
14815,1721,1000.00,15000.00,16000.00,5162.11,9837.89,0.09,1
14816,1721,1000.00,16000.00,17000.00,7216.81,8783.19,0.03,1
14817,1721,1000.00,17000.00,18000.00,0.00,17000.00,0.01,1
14818,1721,1000.00,18000.00,19000.00,0.00,18000.00,0.03,1
14819,1721,1000.00,19000.00,20000.00,0.00,19000.00,0.40,1
14820,1721,1000.00,20000.00,21000.00,5891.35,14108.65,0.27,1
14821,1721,1000.00,21000.00,22000.00,6915.10,14084.90,0.08,1
14822,1721,1000.00,22000.00,23000.00,0.00,7277.36,0.09,1
14823,1721,1000.00,23000.00,24000.00,11214.28,11785.72,0.20,1
14824,1721,-1000.00,22000.00,23000.00,12000.00,12000.00,0.37,0
14825,1721,-1000.00,21000.00,22000.00,0.00,21762.60,0.41,0
14826,1721,-1000.00,20000.00,21000.00,434.08,21565.92,0.25,0
14827,1721,-1000.00,19000.00,20000.00,9597.60,8769.90,0.21,0
14828,1721,-1000.00,18000.00,19000.00,0.00,20000.00,0.43,0
14829,1721,-1000.00,17000.00,18000.00,8082.09,10917.91,0.04,0
14830,1721,-1000.00,16000.00,17000.00,2464.68,3660.53,0.18,0
14831,1721,-1000.00,15000.00,16000.00,1453.60,0.00,0.05,0
14832,1721,-1000.00,14000.00,15000.00,10267.16,0.00,0.06,0
14833,1721,-1000.00,13000.00,14000.00,7500.00,7500.00,0.42,0
14834,1721,-1000.00,12000.00,13000.00,4226.47,7281.70,0.30,0
14835,1721,-1000.00,11000.00,12000.00,0.00,7423.61,0.25,0
14836,1721,-1000.00,10000.00,11000.00,5219.21,6780.79,0.26,0
14837,1721,-1000.00,9000.00,10000.00,2526.38,4866.22,0.27,0
14838,1721,-1000.00,8000.00,9000.00,0.00,10000.00,0.27,0
14839,1721,-1000.00,7000.00,8000.00,3069.50,5930.50,0.11,0
14840,1721,-1000.00,6000.00,7000.00,3596.51,4403.49,0.02,0
14841,1721,-1000.00,5000.00,6000.00,0.00,6338.37,0.43,0
14842,1721,-1000.00,4000.00,5000.00,1765.31,3791.19,0.33,0
14843,1721,-1000.00,3000.00,4000.00,0.00,4718.28,0.37,0
14844,1721,-1000.00,2000.00,3000.00,2130.75,1869.25,0.09,0
14845,1721,-1000.00,1000.00,2000.00,0.00,3000.00,0.10,0
14846,1721,1000.00,2000.00,3000.00,1000.00,1000.00,0.12,1
14847,1721,1000.00,3000.00,4000.00,1500.00,1500.00,0.03,1
14848,1721,1000.00,4000.00,5000.00,0.00,4000.00,0.33,1
14849,1721,1000.00,5000.00,6000.00,310.64,4689.36,0.44,1
14850,1721,-1000.00,4000.00,5000.00,0.00,4071.83,0.38,0
14851,1721,-1000.00,3000.00,4000.00,0.00,5000.00,0.11,0
14852,1721,-1000.00,2000.00,3000.00,987.25,3012.75,0.36,0
14853,1721,-1000.00,1000.00,2000.00,1500.00,1500.00,0.19,0
14854,1721,-1000.00,0.00,1000.00,1743.43,256.57,0.03,0
14855,1721,-286.52,-286.52,713.48,286.52,0.00,0.06,0
14856,1721,-1000.00,-1286.52,-286.52,0.00,581.99,0.43,0
14857,1722,-12.19,-12.19,987.81,0.00,12.19,0.24,0
14858,1722,-292.44,-304.63,695.37,0.00,292.44,0.29,0
14859,1722,-695.37,-1000.00,0.00,0.00,695.37,0.13,0
14860,1723,-1000.00,-1000.00,0.00,0.00,1000.00,0.41,0
14861,1724,1000.00,1000.00,2000.00,0.00,696.48,0.39,1
14862,1724,1000.00,2000.00,3000.00,357.41,1642.59,0.42,1
14863,1724,1000.00,3000.00,4000.00,1500.00,1500.00,0.04,1
14864,1724,1000.00,4000.00,5000.00,166.70,3833.30,0.25,1
14865,1724,1000.00,5000.00,6000.00,0.00,3240.65,0.36,1
14866,1724,1000.00,6000.00,7000.00,0.00,981.95,0.10,1
14867,1724,-1000.00,5000.00,6000.00,2913.40,4086.60,0.21,0
14868,1724,-1000.00,4000.00,5000.00,1785.36,2367.07,0.29,0
14869,1724,-1000.00,3000.00,4000.00,0.00,2694.02,0.26,0
14870,1724,-1000.00,2000.00,3000.00,3042.45,957.55,0.20,0
14871,1724,-1000.00,1000.00,2000.00,0.00,3000.00,0.09,0
14872,1724,-1000.00,0.00,1000.00,721.23,1278.77,0.36,0
14873,1724,-1000.00,-1000.00,0.00,0.00,1000.00,0.31,0
14874,1725,-873.31,-873.31,126.69,599.59,273.72,0.18,0
14875,1725,-1000.00,-1873.31,-873.31,0.00,99.37,0.42,0
14876,1726,-1000.00,-1000.00,0.00,489.15,510.85,0.10,0
14877,1727,1000.00,1000.00,2000.00,0.00,317.35,0.23,1
14878,1727,1000.00,2000.00,3000.00,684.87,1315.13,0.33,1
14879,1727,1000.00,3000.00,4000.00,0.00,3000.00,0.30,1
14880,1727,1000.00,4000.00,5000.00,0.00,3462.82,0.41,1
14881,1727,1000.00,5000.00,6000.00,0.00,3100.98,0.26,1
14882,1727,1000.00,6000.00,7000.00,2902.37,3097.63,0.00,1
14883,1727,0.00,6000.00,7000.00,0.00,0.00,0.05,0
14884,1727,-1000.00,5000.00,6000.00,2941.81,0.00,0.01,0
14885,1727,1000.00,6000.00,7000.00,0.00,6000.00,0.11,1
14886,1727,-1000.00,5000.00,6000.00,3145.83,1388.03,0.14,0
14887,1727,-1000.00,4000.00,5000.00,3005.57,2994.43,0.01,0
14888,1727,1000.00,5000.00,6000.00,1283.74,3716.26,0.41,1
14889,1727,-1000.00,4000.00,5000.00,4733.27,1266.73,0.03,0
14890,1727,1000.00,5000.00,6000.00,0.00,4945.57,0.44,1
14891,1727,1000.00,6000.00,7000.00,2202.89,3797.11,0.10,1
14892,1727,1000.00,7000.00,8000.00,3500.00,3500.00,0.36,1
14893,1727,-1000.00,6000.00,7000.00,4868.59,3131.41,0.07,0
14894,1727,-1000.00,5000.00,6000.00,5101.49,1898.51,0.04,0
14895,1727,1000.00,6000.00,7000.00,1886.38,4113.62,0.14,1
14896,1727,1000.00,7000.00,8000.00,2480.00,4520.00,0.40,1
14897,1727,1000.00,8000.00,9000.00,1497.55,6502.45,0.28,1
14898,1727,-1000.00,7000.00,8000.00,9000.00,0.00,0.01,0
14899,1727,1000.00,8000.00,9000.00,858.09,7141.91,0.16,1
14900,1727,-1000.00,7000.00,8000.00,4880.68,4119.32,0.10,0
14901,1727,1000.00,8000.00,9000.00,0.00,8000.00,0.26,1
14902,1727,1000.00,9000.00,10000.00,0.00,7201.87,0.19,1
14903,1727,1000.00,10000.00,11000.00,5000.00,5000.00,0.08,1
14904,1727,1000.00,11000.00,12000.00,0.00,11000.00,0.27,1
14905,1727,-1000.00,10000.00,11000.00,6621.97,5378.03,0.41,0
14906,1727,1000.00,11000.00,12000.00,0.00,7881.89,0.30,1
14907,1727,1000.00,12000.00,13000.00,5162.17,6837.83,0.26,1
14908,1727,-1000.00,11000.00,12000.00,2271.06,1009.81,0.13,0
14909,1727,-1000.00,10000.00,11000.00,9123.88,1410.34,0.14,0
14910,1727,-1000.00,9000.00,10000.00,0.00,9190.59,0.13,0
14911,1727,-1000.00,8000.00,9000.00,7004.88,2995.12,0.17,0
14912,1727,-1000.00,7000.00,8000.00,0.00,7732.92,0.41,0
14913,1727,0.00,7000.00,8000.00,0.00,0.00,0.02,0
14914,1727,-1000.00,6000.00,7000.00,0.00,8000.00,0.34,0
14915,1727,-1000.00,5000.00,6000.00,0.00,7000.00,0.03,0
14916,1727,-1000.00,4000.00,5000.00,1506.27,0.00,0.21,0
14917,1727,-1000.00,3000.00,4000.00,3182.23,1347.01,0.25,0
14918,1728,1000.00,1000.00,2000.00,571.17,385.86,0.24,1
14919,1728,-1000.00,0.00,1000.00,0.00,2000.00,0.08,0
14920,1728,-213.17,-213.17,786.83,0.00,213.17,0.23,0
14921,1728,-347.24,-560.41,439.59,0.00,347.24,0.03,0
14922,1728,1000.00,439.59,1439.59,263.22,127.88,0.25,1
14923,1728,-426.81,12.78,1012.78,0.00,426.81,0.22,0
14924,1728,-829.91,-817.12,182.88,0.00,829.91,0.16,0
14925,1728,-182.88,-1000.00,0.00,0.00,182.88,0.15,0
14926,1729,-1000.00,-1000.00,0.00,464.12,535.88,0.05,0
14927,1730,1000.00,1000.00,2000.00,442.91,557.09,0.23,1
14928,1730,1000.00,2000.00,3000.00,145.48,1854.52,0.44,1
14929,1730,1000.00,3000.00,4000.00,1153.57,1846.43,0.29,1
14930,1730,1000.00,4000.00,5000.00,0.00,2211.75,0.27,1
14931,1730,1000.00,5000.00,6000.00,202.68,4797.32,0.40,1
14932,1730,1000.00,6000.00,7000.00,0.00,6000.00,0.32,1
14933,1730,1000.00,7000.00,8000.00,3500.00,3500.00,0.20,1
14934,1730,1000.00,8000.00,9000.00,1643.44,6356.56,0.41,1
14935,1730,1000.00,9000.00,10000.00,0.00,1285.77,0.04,1
14936,1730,1000.00,10000.00,11000.00,5000.00,5000.00,0.03,1
14937,1730,1000.00,11000.00,12000.00,0.00,10532.68,0.40,1
14938,1730,1000.00,12000.00,13000.00,2546.25,9453.75,0.28,1
14939,1730,1000.00,13000.00,14000.00,6500.00,6500.00,0.03,1
14940,1730,1000.00,14000.00,15000.00,0.00,11283.98,0.28,1
14941,1730,1000.00,15000.00,16000.00,0.00,15000.00,0.13,1
14942,1730,0.00,15000.00,16000.00,0.00,0.00,0.00,0
14943,1730,1000.00,16000.00,17000.00,0.00,16000.00,0.13,1
14944,1730,1000.00,17000.00,18000.00,6338.50,10661.50,0.26,1
14945,1730,1000.00,18000.00,19000.00,6153.28,11846.72,0.00,1
14946,1730,1000.00,19000.00,20000.00,0.00,18221.52,0.43,1
14947,1730,1000.00,20000.00,21000.00,6949.67,13050.33,0.07,1
14948,1730,-1000.00,19000.00,20000.00,10170.26,0.00,0.01,0
14949,1730,1000.00,20000.00,21000.00,0.00,18690.93,0.37,1
14950,1730,1000.00,21000.00,22000.00,1041.91,19958.09,0.44,1
14951,1730,1000.00,22000.00,23000.00,8307.97,13692.03,0.34,1
14952,1730,1000.00,23000.00,24000.00,9181.44,13818.56,0.30,1
14953,1730,1000.00,24000.00,25000.00,10353.45,13646.55,0.32,1
14954,1730,1000.00,25000.00,26000.00,0.00,22854.98,0.29,1
14955,1730,1000.00,26000.00,27000.00,0.00,22569.98,0.35,1
14956,1730,1000.00,27000.00,28000.00,13500.00,13500.00,0.14,1
14957,1730,1000.00,28000.00,29000.00,0.00,28000.00,0.07,1
14958,1730,1000.00,29000.00,30000.00,0.00,7676.39,0.09,1
14959,1730,1000.00,30000.00,31000.00,0.00,30000.00,0.06,1
14960,1730,1000.00,31000.00,32000.00,0.00,31000.00,0.17,1
14961,1730,0.00,31000.00,32000.00,0.00,0.00,0.08,0
14962,1730,1000.00,32000.00,33000.00,16000.00,16000.00,0.05,1
14963,1731,-1000.00,-1000.00,0.00,263.71,736.29,0.37,0
14964,1731,-0.00,-1000.00,-0.00,0.00,0.00,0.11,0
14965,1732,-1000.00,-1000.00,0.00,397.76,602.24,0.05,0
14966,1733,-1000.00,-1000.00,0.00,399.66,600.34,0.25,0
14967,1733,-0.00,-1000.00,0.00,0.00,0.00,0.11,0
14968,1734,1000.00,1000.00,2000.00,317.18,682.82,0.30,1
14969,1734,1000.00,2000.00,3000.00,0.00,1661.35,0.26,1
14970,1734,1000.00,3000.00,4000.00,1349.40,1650.60,0.24,1
14971,1734,1000.00,4000.00,5000.00,0.00,4000.00,0.05,1
14972,1734,1000.00,5000.00,6000.00,0.00,3798.42,0.40,1
14973,1734,1000.00,6000.00,7000.00,0.00,6000.00,0.34,1
14974,1734,1000.00,7000.00,8000.00,0.00,6883.70,0.38,1
14975,1734,1000.00,8000.00,9000.00,0.00,2108.96,0.23,1
14976,1734,1000.00,9000.00,10000.00,2466.21,6533.79,0.28,1
14977,1734,-1000.00,8000.00,9000.00,6838.12,3161.88,0.10,0
14978,1734,1000.00,9000.00,10000.00,0.00,9000.00,0.01,1
14979,1734,1000.00,10000.00,11000.00,86.13,5429.19,0.26,1
14980,1734,1000.00,11000.00,12000.00,4853.97,6146.03,0.18,1
14981,1734,1000.00,12000.00,13000.00,0.00,12000.00,0.02,1
14982,1734,1000.00,13000.00,14000.00,0.00,13000.00,0.19,1
14983,1734,1000.00,14000.00,15000.00,5138.08,8861.92,0.27,1
14984,1734,1000.00,15000.00,16000.00,7404.07,7595.93,0.07,1
14985,1734,1000.00,16000.00,17000.00,8000.00,8000.00,0.43,1
14986,1734,-1000.00,15000.00,16000.00,3001.88,513.57,0.12,0
14987,1734,1000.00,16000.00,17000.00,5338.67,10661.33,0.38,1
14988,1734,1000.00,17000.00,18000.00,8500.00,8500.00,0.38,1
14989,1734,-1000.00,16000.00,17000.00,4763.09,0.00,0.06,0
14990,1734,1000.00,17000.00,18000.00,1171.66,14356.79,0.43,1
14991,1734,-1000.00,16000.00,17000.00,9000.00,9000.00,0.20,0
14992,1734,-1000.00,15000.00,16000.00,3561.44,13438.56,0.35,0
14993,1734,-1000.00,14000.00,15000.00,5746.14,9135.79,0.33,0
14994,1734,-1000.00,13000.00,14000.00,7397.51,7602.49,0.20,0
14995,1734,-1000.00,12000.00,13000.00,0.00,14000.00,0.09,0
14996,1734,-1000.00,11000.00,12000.00,5632.31,7367.69,0.41,0
14997,1734,-1000.00,10000.00,11000.00,0.00,12000.00,0.27,0
14998,1734,-1000.00,9000.00,10000.00,3793.27,7206.73,0.25,0
14999,1734,-1000.00,8000.00,9000.00,5000.00,5000.00,0.02,0
15000,1734,-1000.00,7000.00,8000.00,0.00,2648.01,0.19,0
15001,1734,-1000.00,6000.00,7000.00,4000.00,4000.00,0.04,0
15002,1734,-1000.00,5000.00,6000.00,0.00,7000.00,0.19,0
15003,1734,-1000.00,4000.00,5000.00,3000.00,3000.00,0.32,0
15004,1734,-1000.00,3000.00,4000.00,0.00,5000.00,0.33,0
15005,1734,-1000.00,2000.00,3000.00,1336.21,2663.79,0.27,0
15006,1734,-1000.00,1000.00,2000.00,1378.63,1621.37,0.08,0
15007,1734,-1000.00,0.00,1000.00,386.74,49.05,0.10,0
15008,1734,-1000.00,-1000.00,0.00,0.00,1000.00,0.28,0
15009,1735,-1000.00,-1000.00,0.00,550.92,449.08,0.13,0
15010,1736,1000.00,1000.00,2000.00,0.00,1000.00,0.20,1
15011,1736,1000.00,2000.00,3000.00,748.23,1251.77,0.25,1
15012,1736,1000.00,3000.00,4000.00,1252.66,1747.34,0.16,1
15013,1736,1000.00,4000.00,5000.00,0.00,3810.38,0.22,1
15014,1736,1000.00,5000.00,6000.00,0.00,5000.00,0.09,1
15015,1736,-1000.00,4000.00,5000.00,6000.00,0.00,0.01,0
15016,1736,1000.00,5000.00,6000.00,1367.35,3632.65,0.40,1
15017,1736,1000.00,6000.00,7000.00,0.00,6000.00,0.36,1
15018,1736,1000.00,7000.00,8000.00,835.94,3438.74,0.32,1
15019,1736,-1000.00,6000.00,7000.00,6700.08,312.46,0.10,0
15020,1736,1000.00,7000.00,8000.00,1337.13,5662.87,0.35,1
15021,1736,1000.00,8000.00,9000.00,1477.47,6522.53,0.11,1
15022,1736,1000.00,9000.00,10000.00,3047.56,5952.44,0.34,1
15023,1736,1000.00,10000.00,11000.00,2071.58,7928.42,0.40,1
15024,1736,1000.00,11000.00,12000.00,5155.34,5844.66,0.28,1
15025,1736,-1000.00,10000.00,11000.00,1380.15,0.00,0.03,0
15026,1736,1000.00,11000.00,12000.00,5500.00,5500.00,0.07,1
15027,1736,1000.00,12000.00,13000.00,0.00,12000.00,0.20,1
15028,1736,1000.00,13000.00,14000.00,6500.00,6500.00,0.17,1
15029,1736,-1000.00,12000.00,13000.00,14000.00,0.00,0.00,0
15030,1736,-1000.00,11000.00,12000.00,5272.90,7727.10,0.20,0
15031,1736,-1000.00,10000.00,11000.00,1166.13,10833.87,0.18,0
15032,1736,-1000.00,9000.00,10000.00,51.45,8537.23,0.42,0
15033,1736,-1000.00,8000.00,9000.00,7049.58,2950.42,0.04,0
15034,1736,-1000.00,7000.00,8000.00,4675.45,4324.55,0.15,0
15035,1736,-1000.00,6000.00,7000.00,0.00,5392.20,0.43,0
15036,1736,-1000.00,5000.00,6000.00,4048.81,1803.19,0.16,0
15037,1736,-1000.00,4000.00,5000.00,1105.93,1440.01,0.17,0
15038,1736,-1000.00,3000.00,4000.00,0.00,5000.00,0.10,0
15039,1736,-1000.00,2000.00,3000.00,0.00,4000.00,0.22,0
15040,1736,-1000.00,1000.00,2000.00,0.00,3000.00,0.39,0
15041,1736,-1000.00,0.00,1000.00,2000.00,0.00,0.02,0
15042,1736,-1000.00,-1000.00,0.00,0.00,1000.00,0.41,0
15043,1737,-1000.00,-1000.00,0.00,0.00,1000.00,0.37,0
15044,1738,0.00,0.00,1000.00,0.00,0.00,0.02,0
15045,1738,1000.00,1000.00,2000.00,0.00,753.11,0.06,1
15046,1738,1000.00,2000.00,3000.00,0.00,2000.00,0.36,1
15047,1738,-1000.00,1000.00,2000.00,2530.89,469.11,0.08,0
15048,1738,1000.00,2000.00,3000.00,0.00,2000.00,0.04,1
15049,1738,1000.00,3000.00,4000.00,1500.00,1500.00,0.41,1
15050,1738,1000.00,4000.00,5000.00,1877.73,2122.27,0.32,1
15051,1738,1000.00,5000.00,6000.00,0.00,5000.00,0.34,1
15052,1738,1000.00,6000.00,7000.00,2662.86,3337.14,0.28,1
15053,1738,1000.00,7000.00,8000.00,1059.61,5940.39,0.26,1
15054,1738,1000.00,8000.00,9000.00,0.00,2507.91,0.15,1
15055,1738,-1000.00,7000.00,8000.00,3321.95,0.00,0.02,0
15056,1738,1000.00,8000.00,9000.00,0.00,8000.00,0.24,1
15057,1738,1000.00,9000.00,10000.00,4500.00,4500.00,0.08,1
15058,1738,1000.00,10000.00,11000.00,0.00,10000.00,0.22,1
15059,1738,1000.00,11000.00,12000.00,4919.91,6080.09,0.14,1
15060,1738,1000.00,12000.00,13000.00,2704.23,8718.98,0.40,1
15061,1738,1000.00,13000.00,14000.00,6245.81,6754.19,0.12,1
15062,1738,1000.00,14000.00,15000.00,0.00,11131.58,0.14,1
15063,1738,1000.00,15000.00,16000.00,7500.00,7500.00,0.20,1
15064,1738,-1000.00,14000.00,15000.00,13380.83,2619.17,0.08,0
15065,1738,1000.00,15000.00,16000.00,0.00,15000.00,0.21,1
15066,1738,1000.00,16000.00,17000.00,7606.28,8393.72,0.17,1
15067,1738,1000.00,17000.00,18000.00,1876.00,15124.00,0.33,1
15068,1738,1000.00,18000.00,19000.00,7878.53,10121.47,0.15,1
15069,1738,1000.00,19000.00,20000.00,0.00,16095.98,0.24,1
15070,1738,1000.00,20000.00,21000.00,10000.00,10000.00,0.07,1
15071,1738,-1000.00,19000.00,20000.00,20297.36,0.00,0.02,0
15072,1738,1000.00,20000.00,21000.00,7899.67,12100.33,0.29,1
15073,1738,1000.00,21000.00,22000.00,0.00,20308.33,0.17,1
15074,1738,1000.00,22000.00,23000.00,0.00,22000.00,0.22,1
15075,1738,1000.00,23000.00,24000.00,6898.43,16101.57,0.08,1
15076,1738,1000.00,24000.00,25000.00,10833.65,13166.35,0.15,1
15077,1738,1000.00,25000.00,26000.00,0.00,5521.97,0.11,1
15078,1738,1000.00,26000.00,27000.00,13000.00,13000.00,0.09,1
15079,1738,1000.00,27000.00,28000.00,0.00,14486.24,0.27,1
15080,1738,-1000.00,26000.00,27000.00,15376.76,12623.24,0.42,0
15081,1739,-1000.00,-1000.00,0.00,0.00,1000.00,0.35,0
15082,1740,1000.00,1000.00,2000.00,0.00,1000.00,0.02,1
15083,1740,-1.67,998.33,1998.33,1.67,0.00,0.03,0
15084,1740,1000.00,1998.33,2998.33,0.00,1629.45,0.43,1
15085,1740,-1000.00,998.33,1998.33,1045.26,0.00,0.05,0
15086,1740,1000.00,1998.33,2998.33,857.27,1141.06,0.15,1
15087,1740,1000.00,2998.33,3998.33,833.06,2165.27,0.23,1
15088,1740,1000.00,3998.33,4998.33,0.00,3564.74,0.19,1
15089,1740,1000.00,4998.33,5998.33,0.00,4998.33,0.13,1
15090,1740,1000.00,5998.33,6998.33,2999.16,2999.16,0.05,1
15091,1740,1000.00,6998.33,7998.33,0.00,6998.33,0.04,1
15092,1740,1000.00,7998.33,8998.33,0.00,1445.84,0.16,1
15093,1740,1000.00,8998.33,9998.33,0.00,8998.33,0.34,1
15094,1740,1000.00,9998.33,10998.33,2757.39,7240.93,0.14,1
15095,1740,1000.00,10998.33,11998.33,3276.78,7721.54,0.32,1
15096,1740,1000.00,11998.33,12998.33,4992.11,7006.21,0.28,1
15097,1740,1000.00,12998.33,13998.33,0.00,7770.23,0.29,1
15098,1740,-1000.00,11998.33,12998.33,7700.68,6297.65,0.15,0
15099,1740,1000.00,12998.33,13998.33,0.00,6960.34,0.24,1
15100,1740,1000.00,13998.33,14998.33,2377.05,11621.28,0.41,1
15101,1740,1000.00,14998.33,15998.33,7499.16,7499.16,0.15,1
15102,1740,1000.00,15998.33,16998.33,6199.56,9798.77,0.26,1
15103,1740,1000.00,16998.33,17998.33,1168.39,15829.94,0.37,1
15104,1740,1000.00,17998.33,18998.33,0.00,17998.33,0.18,1
15105,1740,-1000.00,16998.33,17998.33,16253.72,2744.61,0.17,0
15106,1740,-1000.00,15998.33,16998.33,0.00,17998.33,0.01,0
15107,1740,-1000.00,14998.33,15998.33,7966.81,9031.51,0.21,0
15108,1740,-1000.00,13998.33,14998.33,5425.30,10573.02,0.33,0
15109,1740,-1000.00,12998.33,13998.33,0.00,14998.33,0.11,0
15110,1740,-1000.00,11998.33,12998.33,0.00,13998.33,0.30,0
15111,1740,-1000.00,10998.33,11998.33,0.00,12998.33,0.20,0
15112,1740,-1000.00,9998.33,10998.33,1657.46,9768.97,0.42,0
15113,1740,-1000.00,8998.33,9998.33,3567.05,0.00,0.06,0
15114,1740,-1000.00,7998.33,8998.33,4999.16,4999.16,0.01,0
15115,1740,-1000.00,6998.33,7998.33,0.00,8998.33,0.21,0
15116,1740,-1000.00,5998.33,6998.33,0.00,7998.33,0.03,0
15117,1740,-1000.00,4998.33,5998.33,2371.04,4627.29,0.15,0
15118,1740,-1000.00,3998.33,4998.33,938.48,5059.84,0.41,0
15119,1740,-1000.00,2998.33,3998.33,4633.07,92.03,0.04,0
15120,1740,-1000.00,1998.33,2998.33,0.00,2292.71,0.05,0
15121,1740,-1000.00,998.33,1998.33,876.37,2121.96,0.35,0
15122,1740,-1000.00,-1.67,998.33,0.00,1998.33,0.39,0
15123,1740,-1000.00,-1001.67,-1.67,557.15,0.00,0.08,0
15124,1741,-298.59,-298.59,701.41,31.81,266.78,0.22,0
15125,1741,-634.91,-933.50,66.50,0.00,634.91,0.44,0
15126,1741,-1000.00,-1933.50,-933.50,44.74,21.76,0.08,0
15127,1742,-1000.00,-1000.00,0.00,439.52,560.48,0.17,0
15128,1743,-1000.00,-1000.00,0.00,0.00,510.21,0.36,0
15129,1744,-1000.00,-1000.00,0.00,0.00,1000.00,0.23,0
15130,1745,-1000.00,-1000.00,0.00,420.75,579.25,0.14,0
15131,1746,-1000.00,-1000.00,0.00,0.00,935.35,0.21,0
15132,1747,1000.00,1000.00,2000.00,0.00,1000.00,0.41,1
15133,1747,1000.00,2000.00,3000.00,0.00,2000.00,0.26,1
15134,1747,1000.00,3000.00,4000.00,829.17,2170.83,0.32,1
15135,1747,-837.59,2162.41,3162.41,603.27,234.32,0.11,0
15136,1747,1000.00,3162.41,4162.41,0.00,3162.41,0.39,1
15137,1747,1000.00,4162.41,5162.41,0.00,4162.41,0.11,1
15138,1747,-1000.00,3162.41,4162.41,5162.41,0.00,0.02,0
15139,1747,1000.00,4162.41,5162.41,0.00,4162.41,0.27,1
15140,1747,1000.00,5162.41,6162.41,0.00,1258.37,0.05,1
15141,1747,-1000.00,4162.41,5162.41,4494.42,1667.99,0.16,0
15142,1747,1000.00,5162.41,6162.41,0.00,4516.37,0.24,1
15143,1747,-1000.00,4162.41,5162.41,3345.29,2817.12,0.32,0
15144,1747,1000.00,5162.41,6162.41,0.00,5162.41,0.14,1
15145,1747,1000.00,6162.41,7162.41,2346.41,3816.00,0.26,1
15146,1747,-1000.00,5162.41,6162.41,7162.41,0.00,0.04,0
15147,1747,1000.00,6162.41,7162.41,4069.20,2093.21,0.25,1
15148,1747,-1000.00,5162.41,6162.41,2073.29,4465.59,0.34,0
15149,1747,-1000.00,4162.41,5162.41,0.00,6162.41,0.26,0
15150,1747,-1000.00,3162.41,4162.41,0.00,5162.41,0.16,0
15151,1747,-1000.00,2162.41,3162.41,836.85,1060.17,0.15,0
15152,1747,1000.00,3162.41,4162.41,1958.51,1203.91,0.08,1
15153,1747,-1000.00,2162.41,3162.41,1236.09,2926.32,0.25,0
15154,1747,-1000.00,1162.41,2162.41,855.12,2307.29,0.37,0
15155,1747,1000.00,2162.41,3162.41,1126.29,1036.12,0.38,1
15156,1747,1000.00,3162.41,4162.41,2044.46,0.00,0.03,1
15157,1747,-1000.00,2162.41,3162.41,1798.67,2363.74,0.07,0
15158,1747,-1000.00,1162.41,2162.41,0.00,2160.67,0.35,0
15159,1747,-1000.00,162.41,1162.41,884.73,1277.68,0.44,0
15160,1747,-1000.00,-837.59,162.41,0.00,1142.05,0.20,0
15161,1747,-162.41,-1000.00,0.00,0.00,162.41,0.02,0
15162,1748,-1000.00,-1000.00,0.00,36.15,963.85,0.33,0
15163,1749,-1000.00,-1000.00,0.00,0.00,1000.00,0.25,0
15164,1750,-1000.00,-1000.00,0.00,0.00,998.75,0.37,0
15165,1751,-345.03,-345.03,654.97,0.00,345.03,0.18,0
15166,1751,-384.36,-729.39,270.61,0.00,384.36,0.24,0
15167,1751,-121.24,-850.63,149.37,0.00,121.24,0.22,0
15168,1751,-92.03,-942.66,57.34,0.00,92.03,0.35,0
15169,1751,-57.34,-1000.00,0.00,23.56,33.78,0.24,0
15170,1752,-1000.00,-1000.00,0.00,323.77,676.23,0.15,0
15171,1753,1000.00,1000.00,2000.00,0.00,628.19,0.32,1
15172,1753,1000.00,2000.00,3000.00,0.00,822.78,0.24,1
15173,1753,1000.00,3000.00,4000.00,212.03,2787.97,0.38,1
15174,1753,1000.00,4000.00,5000.00,1827.82,2172.18,0.20,1
15175,1753,1000.00,5000.00,6000.00,0.00,5000.00,0.12,1
15176,1753,1000.00,6000.00,7000.00,1386.77,4613.23,0.37,1
15177,1753,1000.00,7000.00,8000.00,0.00,7000.00,0.26,1
15178,1753,1000.00,8000.00,9000.00,0.00,8000.00,0.30,1
15179,1753,1000.00,9000.00,10000.00,2772.54,6227.46,0.22,1
15180,1753,1000.00,10000.00,11000.00,2291.13,7708.87,0.25,1
15181,1753,1000.00,11000.00,12000.00,2792.27,8207.73,0.22,1
15182,1753,1000.00,12000.00,13000.00,3105.77,8894.23,0.33,1
15183,1753,0.00,12000.00,13000.00,0.00,0.00,0.04,0
15184,1753,1000.00,13000.00,14000.00,0.00,13000.00,0.43,1
15185,1753,1000.00,14000.00,15000.00,0.00,6826.95,0.22,1
15186,1753,1000.00,15000.00,16000.00,0.00,12391.61,0.25,1
15187,1753,1000.00,16000.00,17000.00,7792.76,8207.24,0.14,1
15188,1753,1000.00,17000.00,18000.00,1801.22,3305.39,0.18,1
15189,1753,1000.00,18000.00,19000.00,3732.35,10327.59,0.33,1
15190,1753,1000.00,19000.00,20000.00,0.00,19000.00,0.24,1
15191,1753,1000.00,20000.00,21000.00,1079.31,9009.03,0.30,1
15192,1753,1000.00,21000.00,22000.00,218.71,20781.29,0.07,1
15193,1753,1000.00,22000.00,23000.00,850.12,20205.11,0.43,1
15194,1753,1000.00,23000.00,24000.00,11500.00,11500.00,0.03,1
15195,1753,1000.00,24000.00,25000.00,0.00,24000.00,0.09,1
15196,1753,-1000.00,23000.00,24000.00,22768.46,0.00,0.03,0
15197,1753,1000.00,24000.00,25000.00,0.00,21342.00,0.42,1
15198,1753,1000.00,25000.00,26000.00,0.00,25000.00,0.27,1
15199,1753,1000.00,26000.00,27000.00,7959.73,13969.33,0.29,1
15200,1753,0.00,26000.00,27000.00,0.00,0.00,0.04,0
15201,1753,-1000.00,25000.00,26000.00,15508.85,11491.15,0.03,0
15202,1753,1000.00,26000.00,27000.00,3313.47,22686.53,0.33,1
15203,1753,1000.00,27000.00,28000.00,4843.47,22156.53,0.38,1
15204,1753,1000.00,28000.00,29000.00,4367.18,18945.05,0.14,1
15205,1753,1000.00,29000.00,30000.00,0.00,3186.18,0.03,1
15206,1753,1000.00,30000.00,31000.00,15000.00,15000.00,0.05,1
15207,1753,1000.00,31000.00,32000.00,7816.44,23183.56,0.39,1
15208,1753,1000.00,32000.00,33000.00,0.00,32000.00,0.33,1
15209,1753,1000.00,33000.00,34000.00,11776.65,21223.35,0.35,1
15210,1753,0.00,33000.00,34000.00,0.00,0.00,0.01,0
15211,1754,-1000.00,-1000.00,0.00,125.79,874.21,0.31,0
15212,1755,-935.26,-935.26,64.74,719.57,215.69,0.13,0
15213,1755,-1000.00,-1935.26,-935.26,0.00,64.74,0.36,0
15214,1756,1000.00,1000.00,2000.00,396.31,603.69,0.29,1
15215,1756,1000.00,2000.00,3000.00,11.35,1988.65,0.41,1
15216,1756,1000.00,3000.00,4000.00,0.00,1547.60,0.24,1
15217,1756,1000.00,4000.00,5000.00,0.00,1708.04,0.01,1
15218,1756,1000.00,5000.00,6000.00,2090.41,2909.59,0.15,1
15219,1756,-1000.00,4000.00,5000.00,3436.72,2563.28,0.31,0
15220,1756,1000.00,5000.00,6000.00,272.52,4727.48,0.35,1
15221,1756,1000.00,6000.00,7000.00,0.00,6000.00,0.28,1
15222,1756,1000.00,7000.00,8000.00,2114.18,4885.82,0.27,1
15223,1756,1000.00,8000.00,9000.00,0.00,3591.35,0.08,1
15224,1756,-1000.00,7000.00,8000.00,8214.02,785.98,0.07,0
15225,1756,1000.00,8000.00,9000.00,1619.86,6380.14,0.35,1
15226,1756,1000.00,9000.00,10000.00,0.00,9000.00,0.16,1
15227,1756,-1000.00,8000.00,9000.00,10000.00,0.00,0.01,0
15228,1756,1000.00,9000.00,10000.00,0.00,9000.00,0.03,1
15229,1756,1000.00,10000.00,11000.00,2448.00,7552.00,0.35,1
15230,1756,1000.00,11000.00,12000.00,0.00,11000.00,0.25,1
15231,1756,1000.00,12000.00,13000.00,0.00,12000.00,0.39,1
15232,1756,1000.00,13000.00,14000.00,0.00,13000.00,0.42,1
15233,1756,1000.00,14000.00,15000.00,6288.53,7711.47,0.24,1
15234,1756,1000.00,15000.00,16000.00,624.86,12055.01,0.42,1
15235,1756,1000.00,16000.00,17000.00,4690.67,11309.33,0.34,1
15236,1756,-1000.00,15000.00,16000.00,10272.42,6727.58,0.36,0
15237,1756,-1000.00,14000.00,15000.00,0.00,13941.57,0.38,0
15238,1756,-1000.00,13000.00,14000.00,0.00,15000.00,0.33,0
15239,1756,-1000.00,12000.00,13000.00,7000.00,7000.00,0.12,0
15240,1756,-1000.00,11000.00,12000.00,0.00,13000.00,0.30,0
15241,1756,-1000.00,10000.00,11000.00,3755.03,6293.32,0.17,0
15242,1756,-1000.00,9000.00,10000.00,0.00,11000.00,0.38,0
15243,1756,-1000.00,8000.00,9000.00,2973.82,5100.07,0.29,0
15244,1756,-1000.00,7000.00,8000.00,0.00,9000.00,0.03,0
15245,1756,-1000.00,6000.00,7000.00,0.00,8000.00,0.12,0
15246,1756,-1000.00,5000.00,6000.00,3331.25,3668.75,0.44,0
15247,1756,-1000.00,4000.00,5000.00,0.00,6000.00,0.28,0
15248,1756,-1000.00,3000.00,4000.00,242.89,4757.11,0.44,0
15249,1756,-878.19,2121.81,3121.81,0.00,878.19,0.19,0
15250,1756,-1000.00,1121.81,2121.81,1646.73,1475.09,0.16,0
15251,1756,-1000.00,121.81,1121.81,369.27,0.00,0.01,0
15252,1756,-1000.00,-878.19,121.81,36.38,1085.43,0.29,0
15253,1756,-121.81,-1000.00,-0.00,57.15,64.66,0.24,0
15254,1757,-1000.00,-1000.00,0.00,0.00,367.78,0.17,0
15255,1758,-1000.00,-1000.00,0.00,81.89,918.11,0.39,0
15256,1759,1000.00,1000.00,2000.00,27.20,325.84,0.25,1
15257,1759,1000.00,2000.00,3000.00,0.00,2000.00,0.22,1
15258,1759,1000.00,3000.00,4000.00,1500.00,1500.00,0.00,1
15259,1759,-1000.00,2000.00,3000.00,1540.14,310.78,0.15,0
15260,1759,-1000.00,1000.00,2000.00,0.00,1424.74,0.31,0
15261,1759,-1000.00,0.00,1000.00,1034.31,965.69,0.23,0
15262,1759,-1000.00,-1000.00,0.00,221.82,778.18,0.38,0
15263,1760,-644.12,-644.12,355.88,0.00,644.12,0.06,0
15264,1760,-355.88,-1000.00,0.00,173.04,182.84,0.29,0
15265,1761,-1000.00,-1000.00,0.00,642.68,357.32,0.10,0
15266,1762,-1000.00,-1000.00,0.00,0.00,1000.00,0.22,0
15267,1763,-1000.00,-1000.00,0.00,0.00,301.80,0.19,0
15268,1764,1000.00,1000.00,2000.00,500.00,500.00,0.07,1
15269,1764,1000.00,2000.00,3000.00,1000.00,1000.00,0.07,1
15270,1764,1000.00,3000.00,4000.00,944.88,2055.12,0.11,1
15271,1764,1000.00,4000.00,5000.00,1557.48,2442.52,0.30,1
15272,1764,1000.00,5000.00,6000.00,593.46,3045.16,0.35,1
15273,1764,1000.00,6000.00,7000.00,0.00,6000.00,0.18,1
15274,1764,1000.00,7000.00,8000.00,3500.00,3500.00,0.03,1
15275,1764,1000.00,8000.00,9000.00,0.00,8000.00,0.01,1
15276,1764,1000.00,9000.00,10000.00,3873.59,5126.41,0.21,1
15277,1764,1000.00,10000.00,11000.00,0.00,10000.00,0.11,1
15278,1764,1000.00,11000.00,12000.00,0.00,11000.00,0.26,1
15279,1764,1000.00,12000.00,13000.00,5533.74,6466.26,0.22,1
15280,1764,1000.00,13000.00,14000.00,0.00,6869.49,0.28,1
15281,1764,1000.00,14000.00,15000.00,2395.84,7890.57,0.33,1
15282,1764,-1000.00,13000.00,14000.00,6944.81,3101.28,0.16,0
15283,1764,1000.00,14000.00,15000.00,4691.66,9308.34,0.15,1
15284,1764,-1000.00,13000.00,14000.00,6471.22,4378.77,0.19,0
15285,1764,1000.00,14000.00,15000.00,3269.15,10730.85,0.37,1
15286,1764,-1000.00,13000.00,14000.00,7639.24,7360.76,0.09,0
15287,1764,1000.00,14000.00,15000.00,0.00,14000.00,0.32,1
15288,1764,-1000.00,13000.00,14000.00,9810.50,5189.50,0.31,0
15289,1764,-1000.00,12000.00,13000.00,9890.43,4109.57,0.02,0
15290,1764,-1000.00,11000.00,12000.00,9057.26,3942.74,0.23,0
15291,1764,1000.00,12000.00,13000.00,0.00,4249.48,0.20,1
15292,1764,1000.00,13000.00,14000.00,6500.00,6500.00,0.01,1
15293,1764,1000.00,14000.00,15000.00,0.00,8203.90,0.14,1
15294,1764,1000.00,15000.00,16000.00,4536.31,10463.69,0.23,1
15295,1764,1000.00,16000.00,17000.00,0.00,16000.00,0.40,1
15296,1764,-1000.00,15000.00,16000.00,6333.51,6003.40,0.20,0
15297,1764,1000.00,16000.00,17000.00,0.00,6025.77,0.24,1
15298,1764,1000.00,17000.00,18000.00,0.00,9627.06,0.36,1
15299,1764,1000.00,18000.00,19000.00,4469.38,13530.62,0.39,1
15300,1764,1000.00,19000.00,20000.00,9500.00,9500.00,0.06,1
15301,1764,1000.00,20000.00,21000.00,0.00,20000.00,0.02,1
15302,1764,1000.00,21000.00,22000.00,6860.60,14139.40,0.18,1
15303,1764,-1000.00,20000.00,21000.00,15206.26,6793.74,0.06,0
15304,1764,1000.00,21000.00,22000.00,0.00,7058.30,0.24,1
15305,1764,-1000.00,20000.00,21000.00,15198.92,6801.08,0.01,0
15306,1764,1000.00,21000.00,22000.00,0.00,21000.00,0.26,1
15307,1764,1000.00,22000.00,23000.00,4622.82,17377.18,0.33,1
15308,1764,1000.00,23000.00,24000.00,9677.65,13322.35,0.43,1
15309,1764,1000.00,24000.00,25000.00,0.00,16487.77,0.25,1
15310,1764,1000.00,25000.00,26000.00,0.00,5837.61,0.15,1
15311,1764,1000.00,26000.00,27000.00,0.00,11408.37,0.30,1
15312,1764,1000.00,27000.00,28000.00,0.00,27000.00,0.25,1
15313,1764,1000.00,28000.00,29000.00,0.00,21310.14,0.41,1
15314,1764,1000.00,29000.00,30000.00,0.00,21401.05,0.36,1
15315,1764,-1000.00,28000.00,29000.00,10458.71,0.00,0.03,0
15316,1765,1000.00,1000.00,2000.00,0.00,863.31,0.43,1
15317,1765,1000.00,2000.00,3000.00,1000.00,1000.00,0.09,1
15318,1765,1000.00,3000.00,4000.00,1350.90,1649.10,0.37,1
15319,1765,1000.00,4000.00,5000.00,0.00,894.94,0.11,1
15320,1765,1000.00,5000.00,6000.00,2498.58,2501.42,0.14,1
15321,1765,1000.00,6000.00,7000.00,0.00,6000.00,0.36,1
15322,1765,0.00,6000.00,7000.00,0.00,0.00,0.07,0
15323,1765,1000.00,7000.00,8000.00,2599.99,4400.01,0.20,1
15324,1765,1000.00,8000.00,9000.00,0.00,8000.00,0.06,1
15325,1765,1000.00,9000.00,10000.00,0.00,9000.00,0.07,1
15326,1765,-1000.00,8000.00,9000.00,5201.45,4798.55,0.32,0
15327,1765,1000.00,9000.00,10000.00,0.00,9000.00,0.01,1
15328,1765,1000.00,10000.00,11000.00,0.00,7956.69,0.38,1
15329,1765,1000.00,11000.00,12000.00,0.00,6709.85,0.03,1
15330,1765,1000.00,12000.00,13000.00,6000.00,6000.00,0.03,1
15331,1765,-1000.00,11000.00,12000.00,7013.95,5986.05,0.42,0
15332,1765,1000.00,12000.00,13000.00,6000.00,6000.00,0.24,1
15333,1765,1000.00,13000.00,14000.00,6500.00,6500.00,0.02,1
15334,1765,-1000.00,12000.00,13000.00,7000.00,7000.00,0.17,0
15335,1765,-1000.00,11000.00,12000.00,0.00,6020.80,0.15,0
15336,1765,-1000.00,10000.00,11000.00,0.00,12000.00,0.36,0
15337,1765,-1000.00,9000.00,10000.00,5890.44,5109.56,0.15,0
15338,1765,-1000.00,8000.00,9000.00,4496.60,5503.40,0.02,0
15339,1765,-1000.00,7000.00,8000.00,6010.29,2989.71,0.25,0
15340,1765,-1000.00,6000.00,7000.00,401.67,7598.33,0.09,0
15341,1765,-1000.00,5000.00,6000.00,0.00,4089.99,0.06,0
15342,1765,-1000.00,4000.00,5000.00,1590.74,4409.26,0.34,0
15343,1765,-1000.00,3000.00,4000.00,3395.29,1604.71,0.01,0
15344,1765,-1000.00,2000.00,3000.00,251.60,1999.15,0.32,0
15345,1765,-1000.00,1000.00,2000.00,0.00,3000.00,0.22,0
15346,1765,-375.02,624.98,1624.98,0.00,375.02,0.17,0
15347,1765,-1000.00,-375.02,624.98,0.00,1624.98,0.01,0
15348,1765,-505.45,-880.46,119.54,0.00,505.45,0.13,0
15349,1765,-119.54,-1000.00,0.00,51.10,68.43,0.03,0
15350,1766,0.00,0.00,1000.00,0.00,1000.00,0.24,0
15351,1766,0.00,0.00,1000.00,0.00,1000.00,0.34,0
15352,1766,-803.04,-803.04,196.96,651.81,151.24,0.09,0
15353,1766,0.00,-803.04,196.96,74.05,122.91,0.34,0
15354,1766,-156.70,-959.75,40.25,84.74,71.96,0.20,0
15355,1766,0.00,-959.75,40.25,10.63,29.62,0.21,0
15356,1766,0.00,-959.75,40.25,0.00,38.56,0.40,0
15357,1766,0.00,-959.75,40.25,15.36,24.89,0.35,0
15358,1766,-40.25,-1000.00,0.00,30.50,9.75,0.01,0
15359,1767,-1000.00,-1000.00,0.00,715.60,284.40,0.06,0
15360,1768,-1000.00,-1000.00,0.00,500.00,500.00,0.08,0
15361,1769,1000.00,1000.00,2000.00,0.00,519.22,0.29,1
15362,1769,1000.00,2000.00,3000.00,0.00,2000.00,0.04,1
15363,1769,1000.00,3000.00,4000.00,1500.00,1500.00,0.06,1
15364,1769,1000.00,4000.00,5000.00,0.00,4000.00,0.33,1
15365,1769,1000.00,5000.00,6000.00,0.00,5000.00,0.25,1
15366,1769,-1000.00,4000.00,5000.00,6000.00,0.00,0.01,0
15367,1769,1000.00,5000.00,6000.00,417.99,4582.01,0.44,1
15368,1769,1000.00,6000.00,7000.00,361.25,5638.75,0.44,1
15369,1769,1000.00,7000.00,8000.00,1672.03,2901.83,0.25,1
15370,1769,1000.00,8000.00,9000.00,0.00,4997.45,0.36,1
15371,1769,1000.00,9000.00,10000.00,0.00,9000.00,0.32,1
15372,1769,1000.00,10000.00,11000.00,4604.08,5395.92,0.11,1
15373,1769,-1000.00,9000.00,10000.00,1371.94,0.00,0.09,0
15374,1769,1000.00,10000.00,11000.00,691.63,9308.37,0.22,1
15375,1769,-1000.00,9000.00,10000.00,6712.68,4287.32,0.18,0
15376,1769,-1000.00,8000.00,9000.00,10000.00,0.00,0.00,0
15377,1769,1000.00,9000.00,10000.00,0.00,2703.31,0.09,1
15378,1769,1000.00,10000.00,11000.00,0.00,4020.18,0.12,1
15379,1769,1000.00,11000.00,12000.00,2924.37,8075.63,0.40,1
15380,1769,1000.00,12000.00,13000.00,0.00,12000.00,0.37,1
15381,1769,-1000.00,11000.00,12000.00,7919.59,5080.41,0.22,0
15382,1769,1000.00,12000.00,13000.00,0.00,12000.00,0.00,1
15383,1769,1000.00,13000.00,14000.00,0.00,13000.00,0.26,1
15384,1769,1000.00,14000.00,15000.00,0.00,14000.00,0.42,1
15385,1769,-1000.00,13000.00,14000.00,10262.74,4737.26,0.15,0
15386,1769,-1000.00,12000.00,13000.00,5261.25,8738.75,0.26,0
15387,1769,-1000.00,11000.00,12000.00,0.00,6379.15,0.28,0
15388,1769,-1000.00,10000.00,11000.00,0.00,8271.39,0.33,0
15389,1769,-1000.00,9000.00,10000.00,4623.72,6376.28,0.21,0
15390,1769,-1000.00,8000.00,9000.00,984.06,9015.94,0.43,0
15391,1769,-1000.00,7000.00,8000.00,4500.00,4500.00,0.08,0
15392,1769,-1000.00,6000.00,7000.00,1519.63,1009.69,0.15,0
15393,1769,-1000.00,5000.00,6000.00,0.00,4862.82,0.17,0
15394,1769,-1000.00,4000.00,5000.00,0.00,6000.00,0.27,0
15395,1769,-1000.00,3000.00,4000.00,2651.56,2348.44,0.32,0
15396,1769,-1000.00,2000.00,3000.00,2137.34,1862.66,0.42,0
15397,1769,-1000.00,1000.00,2000.00,0.00,2538.08,0.20,0
15398,1769,-1000.00,0.00,1000.00,489.38,1510.62,0.31,0
15399,1769,-948.68,-948.68,51.32,93.73,854.94,0.42,0
15400,1769,-23.37,-972.04,27.96,9.48,13.89,0.20,0
15401,1769,-16.47,-988.52,11.48,0.00,16.47,0.35,0
15402,1769,-11.48,-1000.00,0.00,5.62,5.86,0.34,0
15403,1770,-1000.00,-1000.00,0.00,318.06,681.94,0.26,0
15404,1771,-917.64,-917.64,82.36,66.01,851.62,0.43,0
15405,1771,-1000.00,-1917.64,-917.64,82.36,0.00,0.01,0
15406,1772,-1000.00,-1000.00,0.00,27.34,972.66,0.14,0
15407,1773,-1000.00,-1000.00,0.00,0.00,1000.00,0.33,0
15408,1774,-1000.00,-1000.00,0.00,0.00,51.15,0.13,0
15409,1775,-1000.00,-1000.00,0.00,415.09,584.91,0.03,0
15410,1776,1000.00,1000.00,2000.00,159.50,840.50,0.39,1
15411,1776,1000.00,2000.00,3000.00,273.63,1726.37,0.43,1
15412,1776,1000.00,3000.00,4000.00,0.00,3000.00,0.29,1
15413,1776,1000.00,4000.00,5000.00,401.05,3110.45,0.41,1
15414,1776,1000.00,5000.00,6000.00,0.00,5000.00,0.25,1
15415,1776,1000.00,6000.00,7000.00,0.00,3782.48,0.27,1
15416,1776,1000.00,7000.00,8000.00,0.00,7000.00,0.16,1
15417,1776,1000.00,8000.00,9000.00,0.00,6293.14,0.39,1
15418,1776,1000.00,9000.00,10000.00,3568.51,5431.49,0.30,1
15419,1776,-1000.00,8000.00,9000.00,6054.69,3945.31,0.04,0
15420,1776,1000.00,9000.00,10000.00,4500.00,4500.00,0.32,1
15421,1776,1000.00,10000.00,11000.00,2763.65,6875.28,0.35,1
15422,1776,1000.00,11000.00,12000.00,1034.37,9965.63,0.32,1
15423,1776,1000.00,12000.00,13000.00,0.00,8949.27,0.20,1
15424,1776,-1000.00,11000.00,12000.00,9372.48,3627.52,0.02,0
15425,1776,1000.00,12000.00,13000.00,0.00,2055.11,0.00,1
15426,1776,1000.00,13000.00,14000.00,1923.37,11076.63,0.20,1
15427,1776,1000.00,14000.00,15000.00,0.00,9667.85,0.08,1
15428,1776,1000.00,15000.00,16000.00,6977.16,8022.84,0.12,1
15429,1776,1000.00,16000.00,17000.00,3710.05,12289.95,0.14,1
15430,1776,1000.00,17000.00,18000.00,0.00,11782.42,0.28,1
15431,1776,-1000.00,16000.00,17000.00,3730.05,14269.95,0.21,0
15432,1776,-1000.00,15000.00,16000.00,3492.67,13507.33,0.37,0
15433,1776,-1000.00,14000.00,15000.00,4284.19,11715.81,0.16,0
15434,1776,-1000.00,13000.00,14000.00,2588.61,0.00,0.09,0
15435,1776,-1000.00,12000.00,13000.00,6883.30,7116.70,0.03,0
15436,1776,-1000.00,11000.00,12000.00,0.00,9948.44,0.41,0
15437,1776,-1000.00,10000.00,11000.00,0.00,12000.00,0.19,0
15438,1776,-1000.00,9000.00,10000.00,3629.76,7370.24,0.32,0
15439,1776,-1000.00,8000.00,9000.00,5000.00,5000.00,0.39,0
15440,1776,-1000.00,7000.00,8000.00,0.00,9000.00,0.37,0
15441,1776,-1000.00,6000.00,7000.00,0.00,8000.00,0.21,0
15442,1776,-1000.00,5000.00,6000.00,0.00,4902.58,0.20,0
15443,1776,-1000.00,4000.00,5000.00,1343.10,4656.90,0.40,0
15444,1776,-1000.00,3000.00,4000.00,854.79,4145.21,0.04,0
15445,1776,-1000.00,2000.00,3000.00,223.12,3776.88,0.43,0
15446,1776,-1000.00,1000.00,2000.00,0.00,3000.00,0.16,0
15447,1776,1000.00,2000.00,3000.00,0.00,1902.75,0.24,1
15448,1776,1000.00,3000.00,4000.00,440.93,2280.06,0.40,1
15449,1776,1000.00,4000.00,5000.00,970.93,3029.07,0.39,1
15450,1776,-1000.00,3000.00,4000.00,4540.34,0.00,0.00,0
15451,1776,1000.00,4000.00,5000.00,0.00,1428.03,0.23,1
15452,1776,0.00,4000.00,5000.00,0.00,0.00,0.01,0
15453,1776,1000.00,5000.00,6000.00,782.17,3838.88,0.40,1
15454,1776,1000.00,6000.00,7000.00,2423.45,3576.55,0.24,1
15455,1776,1000.00,7000.00,8000.00,0.00,3309.79,0.29,1
15456,1776,1000.00,8000.00,9000.00,0.00,8000.00,0.19,1
15457,1776,1000.00,9000.00,10000.00,0.00,9000.00,0.31,1
15458,1776,-1000.00,8000.00,9000.00,2426.43,2171.44,0.18,0
15459,1776,1000.00,9000.00,10000.00,2490.22,6509.78,0.35,1
15460,1776,1000.00,10000.00,11000.00,3288.29,6711.71,0.34,1
15461,1776,1000.00,11000.00,12000.00,5500.00,5500.00,0.05,1
15462,1776,-1000.00,10000.00,11000.00,12000.00,0.00,0.00,0
15463,1776,1000.00,11000.00,12000.00,0.00,7689.65,0.13,1
15464,1776,1000.00,12000.00,13000.00,6000.00,6000.00,0.09,1
15465,1776,1000.00,13000.00,14000.00,0.00,10366.39,0.29,1
15466,1776,-1000.00,12000.00,13000.00,7222.07,6777.93,0.06,0
15467,1776,1000.00,13000.00,14000.00,4670.83,8329.17,0.38,1
15468,1776,1000.00,14000.00,15000.00,0.00,14000.00,0.16,1
15469,1777,1000.00,1000.00,2000.00,0.00,941.42,0.23,1
15470,1777,1000.00,2000.00,3000.00,595.26,1404.74,0.34,1
15471,1777,1000.00,3000.00,4000.00,491.52,2218.62,0.39,1
15472,1777,1000.00,4000.00,5000.00,1257.59,2742.41,0.34,1
15473,1777,1000.00,5000.00,6000.00,1393.72,3606.28,0.36,1
15474,1777,1000.00,6000.00,7000.00,2972.40,3027.60,0.13,1
15475,1777,1000.00,7000.00,8000.00,3223.39,3776.61,0.18,1
15476,1777,1000.00,8000.00,9000.00,792.25,7207.75,0.29,1
15477,1777,1000.00,9000.00,10000.00,3026.18,5973.82,0.29,1
15478,1777,1000.00,10000.00,11000.00,4198.08,5801.92,0.23,1
15479,1777,1000.00,11000.00,12000.00,2439.87,8560.13,0.28,1
15480,1777,1000.00,12000.00,13000.00,2252.10,3267.33,0.21,1
15481,1777,1000.00,13000.00,14000.00,0.00,8319.08,0.31,1
15482,1777,1000.00,14000.00,15000.00,0.00,10077.78,0.40,1
15483,1777,1000.00,15000.00,16000.00,0.00,15000.00,0.03,1
15484,1777,1000.00,16000.00,17000.00,0.00,16000.00,0.33,1
15485,1777,1000.00,17000.00,18000.00,0.00,17000.00,0.25,1
15486,1777,1000.00,18000.00,19000.00,0.00,5625.84,0.12,1
15487,1777,1000.00,19000.00,20000.00,0.00,19000.00,0.35,1
15488,1777,1000.00,20000.00,21000.00,5184.15,14815.85,0.21,1
15489,1777,1000.00,21000.00,22000.00,0.00,8053.63,0.15,1
15490,1777,1000.00,22000.00,23000.00,0.00,5030.07,0.18,1
15491,1777,1000.00,23000.00,24000.00,5967.56,17032.44,0.37,1
15492,1777,1000.00,24000.00,25000.00,5402.39,18597.61,0.41,1
15493,1777,1000.00,25000.00,26000.00,0.00,25000.00,0.20,1
15494,1777,1000.00,26000.00,27000.00,0.00,2065.12,0.14,1
15495,1777,-1000.00,25000.00,26000.00,17345.35,9654.65,0.05,0
15496,1777,1000.00,26000.00,27000.00,12228.11,13771.89,0.40,1
15497,1777,1000.00,27000.00,28000.00,10155.92,16844.08,0.28,1
15498,1777,1000.00,28000.00,29000.00,0.00,14691.28,0.28,1
15499,1777,1000.00,29000.00,30000.00,7126.14,20455.13,0.36,1
15500,1777,1000.00,30000.00,31000.00,13722.92,16277.08,0.29,1
15501,1777,1000.00,31000.00,32000.00,0.00,31000.00,0.33,1
15502,1777,1000.00,32000.00,33000.00,15299.32,16700.68,0.16,1
15503,1777,1000.00,33000.00,34000.00,0.00,33000.00,0.20,1
15504,1777,1000.00,34000.00,35000.00,0.00,31031.42,0.06,1
15505,1777,1000.00,35000.00,36000.00,6074.84,28925.16,0.36,1
15506,1777,1000.00,36000.00,37000.00,2704.69,27925.62,0.41,1
15507,1777,-1000.00,35000.00,36000.00,12457.82,7732.69,0.18,0
15508,1777,1000.00,36000.00,37000.00,15595.26,20404.74,0.27,1
15509,1777,1000.00,37000.00,38000.00,0.00,37000.00,0.12,1
15510,1777,-1000.00,36000.00,37000.00,22817.03,15182.97,0.36,0
15511,1777,1000.00,37000.00,38000.00,2082.22,34917.78,0.36,1
15512,1777,1000.00,38000.00,39000.00,11910.76,21031.69,0.31,1
15513,1777,1000.00,39000.00,40000.00,5848.19,33151.81,0.42,1
15514,1777,1000.00,40000.00,41000.00,1659.49,29600.53,0.40,1
15515,1777,1000.00,41000.00,42000.00,0.00,15073.15,0.21,1
15516,1777,-1000.00,40000.00,41000.00,21000.00,21000.00,0.13,0
15517,1777,-1000.00,39000.00,40000.00,0.00,31776.53,0.26,0
15518,1777,-1000.00,38000.00,39000.00,0.00,28898.08,0.40,0
15519,1777,-1000.00,37000.00,38000.00,15954.60,22972.27,0.28,0
15520,1777,-1000.00,36000.00,37000.00,19000.00,19000.00,0.18,0
15521,1777,-1000.00,35000.00,36000.00,5497.39,31502.61,0.43,0
15522,1777,-1000.00,34000.00,35000.00,0.00,36000.00,0.28,0
15523,1777,-1000.00,33000.00,34000.00,0.00,30963.96,0.42,0
15524,1777,-1000.00,32000.00,33000.00,0.00,6368.22,0.14,0
15525,1777,-1000.00,31000.00,32000.00,1857.18,31142.82,0.31,0
15526,1777,-1000.00,30000.00,31000.00,5842.26,26157.74,0.16,0
15527,1777,-1000.00,29000.00,30000.00,15500.00,15500.00,0.10,0
15528,1777,-1000.00,28000.00,29000.00,0.00,19831.08,0.28,0
15529,1777,-1000.00,27000.00,28000.00,0.00,24087.93,0.20,0
15530,1777,-1000.00,26000.00,27000.00,10102.23,17897.77,0.27,0
15531,1777,-1000.00,25000.00,26000.00,0.00,27000.00,0.07,0
15532,1777,-1000.00,24000.00,25000.00,2717.95,11625.20,0.29,0
15533,1777,-1000.00,23000.00,24000.00,6432.78,18567.22,0.23,0
15534,1777,-1000.00,22000.00,23000.00,0.00,12070.68,0.16,0
15535,1777,-1000.00,21000.00,22000.00,808.61,9059.51,0.27,0
15536,1777,-1000.00,20000.00,21000.00,9414.66,12585.34,0.16,0
15537,1778,-1000.00,-1000.00,0.00,0.00,306.37,0.09,0
15538,1779,-1000.00,-1000.00,0.00,0.00,783.49,0.18,0
15539,1780,-85.94,-85.94,914.06,85.94,0.00,0.09,0
15540,1780,1000.00,914.06,1914.06,243.41,670.65,0.33,1
15541,1780,-1000.00,-85.94,914.06,999.01,915.04,0.18,0
15542,1780,1000.00,914.06,1914.06,389.83,524.23,0.05,1
15543,1780,0.00,914.06,1914.06,0.00,0.00,0.08,0
15544,1780,-1000.00,-85.94,914.06,1429.03,485.03,0.02,0
15545,1780,-477.27,-563.22,436.78,477.27,0.00,0.01,0
15546,1780,1000.00,436.78,1436.78,0.00,436.78,0.29,1
15547,1780,1000.00,1436.78,2436.78,0.00,1170.48,0.35,1
15548,1780,1000.00,2436.78,3436.78,1188.29,1248.49,0.11,1
15549,1780,-1000.00,1436.78,2436.78,3436.78,0.00,0.03,0
15550,1780,1000.00,2436.78,3436.78,1216.01,1220.77,0.22,1
15551,1780,1000.00,3436.78,4436.78,0.00,1094.22,0.10,1
15552,1780,1000.00,4436.78,5436.78,2218.39,2218.39,0.04,1
15553,1780,1000.00,5436.78,6436.78,2718.39,2718.39,0.32,1
15554,1780,1000.00,6436.78,7436.78,2036.66,4400.13,0.34,1
15555,1780,1000.00,7436.78,8436.78,3718.39,3718.39,0.14,1
15556,1780,1000.00,8436.78,9436.78,0.00,8436.78,0.23,1
15557,1780,1000.00,9436.78,10436.78,3625.89,5810.89,0.13,1
15558,1780,1000.00,10436.78,11436.78,0.00,8880.90,0.33,1
15559,1780,1000.00,11436.78,12436.78,4464.17,6972.61,0.26,1
15560,1780,1000.00,12436.78,13436.78,2128.07,10308.71,0.40,1
15561,1780,1000.00,13436.78,14436.78,1617.66,10872.99,0.42,1
15562,1780,1000.00,14436.78,15436.78,0.00,14436.78,0.10,1
15563,1780,-1000.00,13436.78,14436.78,12458.21,2978.57,0.16,0
15564,1780,-1000.00,12436.78,13436.78,0.00,7292.85,0.07,0
15565,1780,-1000.00,11436.78,12436.78,5282.18,8154.60,0.33,0
15566,1780,-1000.00,10436.78,11436.78,0.00,6843.45,0.23,0
15567,1780,-1000.00,9436.78,10436.78,2743.82,8692.96,0.06,0
15568,1780,-1000.00,8436.78,9436.78,0.00,6310.33,0.40,0
15569,1780,-1000.00,7436.78,8436.78,4054.45,5382.34,0.21,0
15570,1780,-1000.00,6436.78,7436.78,0.00,8436.78,0.28,0
15571,1780,-1000.00,5436.78,6436.78,3718.39,3718.39,0.00,0
15572,1780,-1000.00,4436.78,5436.78,1372.86,4402.71,0.37,0
15573,1780,-1000.00,3436.78,4436.78,1934.01,3502.77,0.19,0
15574,1780,-1000.00,2436.78,3436.78,0.00,4436.78,0.31,0
15575,1780,-1000.00,1436.78,2436.78,3436.78,0.00,0.05,0
15576,1780,-1000.00,436.78,1436.78,1171.56,1265.22,0.02,0
15577,1780,0.00,436.78,1436.78,0.00,0.00,0.09,0
15578,1780,-1000.00,-563.22,436.78,476.19,960.60,0.18,0
15579,1780,-436.78,-1000.00,0.00,0.00,436.78,0.22,0
15580,1781,1000.00,1000.00,2000.00,0.00,699.09,0.27,1
15581,1781,1000.00,2000.00,3000.00,290.81,1709.19,0.31,1
15582,1781,1000.00,3000.00,4000.00,621.06,2378.94,0.36,1
15583,1781,1000.00,4000.00,5000.00,0.00,4000.00,0.01,1
15584,1781,1000.00,5000.00,6000.00,1543.12,3456.88,0.35,1
15585,1781,-1000.00,4000.00,5000.00,1440.53,0.00,0.09,0
15586,1781,1000.00,5000.00,6000.00,1478.77,3104.57,0.36,1
15587,1781,1000.00,6000.00,7000.00,0.00,6000.00,0.02,1
15588,1781,1000.00,7000.00,8000.00,1215.10,5245.77,0.34,1
15589,1781,1000.00,8000.00,9000.00,0.00,2194.00,0.20,1
15590,1781,-1000.00,7000.00,8000.00,5471.61,3528.39,0.14,0
15591,1781,1000.00,8000.00,9000.00,0.00,2579.28,0.23,1
15592,1781,1000.00,9000.00,10000.00,3284.98,5715.02,0.28,1
15593,1781,1000.00,10000.00,11000.00,2131.80,7868.20,0.10,1
15594,1781,1000.00,11000.00,12000.00,5500.00,5500.00,0.03,1
15595,1781,1000.00,12000.00,13000.00,0.00,12000.00,0.39,1
15596,1781,1000.00,13000.00,14000.00,0.00,5001.38,0.12,1
15597,1781,1000.00,14000.00,15000.00,0.00,7944.43,0.23,1
15598,1781,1000.00,15000.00,16000.00,6904.15,8095.85,0.15,1
15599,1781,1000.00,16000.00,17000.00,7211.26,8788.74,0.08,1
15600,1781,-1000.00,15000.00,16000.00,9371.38,7628.62,0.15,0
15601,1781,1000.00,16000.00,17000.00,8000.00,8000.00,0.05,1
15602,1781,1000.00,17000.00,18000.00,0.00,17000.00,0.40,1
15603,1781,1000.00,18000.00,19000.00,6292.49,11707.51,0.33,1
15604,1781,1000.00,19000.00,20000.00,5392.41,13607.59,0.35,1
15605,1781,1000.00,20000.00,21000.00,906.16,14283.67,0.39,1
15606,1781,1000.00,21000.00,22000.00,0.00,14379.37,0.39,1
15607,1781,1000.00,22000.00,23000.00,0.00,22000.00,0.02,1
15608,1781,-1000.00,21000.00,22000.00,18293.24,2634.08,0.07,0
15609,1781,1000.00,22000.00,23000.00,0.00,6860.73,0.23,1
15610,1781,1000.00,23000.00,24000.00,6095.62,16904.38,0.35,1
15611,1781,1000.00,24000.00,25000.00,4488.31,19511.69,0.33,1
15612,1781,1000.00,25000.00,26000.00,0.00,25000.00,0.35,1
15613,1781,1000.00,26000.00,27000.00,0.00,5069.57,0.07,1
15614,1781,1000.00,27000.00,28000.00,7009.28,19990.72,0.34,1
15615,1781,1000.00,28000.00,29000.00,0.00,28000.00,0.14,1
15616,1781,1000.00,29000.00,30000.00,1333.42,25156.17,0.43,1
15617,1781,1000.00,30000.00,31000.00,12021.27,17978.73,0.29,1
15618,1781,1000.00,31000.00,32000.00,0.00,31000.00,0.24,1
15619,1781,1000.00,32000.00,33000.00,6107.19,22118.30,0.37,1
15620,1781,1000.00,33000.00,34000.00,0.00,9627.22,0.11,1
15621,1781,1000.00,34000.00,35000.00,13271.08,20728.92,0.23,1
15622,1781,1000.00,35000.00,36000.00,2713.10,32286.90,0.29,1
15623,1781,1000.00,36000.00,37000.00,14056.43,21943.57,0.19,1
15624,1781,1000.00,37000.00,38000.00,13528.36,23471.64,0.31,1
15625,1781,1000.00,38000.00,39000.00,4495.61,24417.08,0.37,1
15626,1781,1000.00,39000.00,40000.00,7783.12,31216.88,0.41,1
15627,1782,-1000.00,-1000.00,0.00,462.31,0.00,0.01,0
15628,1783,-1000.00,-1000.00,0.00,0.00,1000.00,0.06,0
15629,1784,0.00,0.00,1000.00,0.00,0.00,0.04,0
15630,1784,-1000.00,-1000.00,0.00,0.00,1000.00,0.00,0
15631,1785,1000.00,1000.00,2000.00,0.00,1000.00,0.10,1
15632,1785,1000.00,2000.00,3000.00,0.00,2000.00,0.02,1
15633,1785,1000.00,3000.00,4000.00,1497.96,1502.04,0.15,1
15634,1785,-1000.00,2000.00,3000.00,3212.96,787.04,0.18,0
15635,1785,1000.00,3000.00,4000.00,0.00,702.20,0.17,1
15636,1785,1000.00,4000.00,5000.00,0.00,4000.00,0.42,1
15637,1785,1000.00,5000.00,6000.00,17.55,1912.15,0.07,1
15638,1785,-1000.00,4000.00,5000.00,2848.42,0.00,0.04,0
15639,1785,1000.00,5000.00,6000.00,1483.03,3516.97,0.30,1
15640,1785,1000.00,6000.00,7000.00,1591.89,4408.11,0.21,1
15641,1785,1000.00,7000.00,8000.00,2287.09,4712.91,0.28,1
15642,1785,1000.00,8000.00,9000.00,2645.18,5354.82,0.24,1
15643,1785,1000.00,9000.00,10000.00,4500.00,4500.00,0.36,1
15644,1785,1000.00,10000.00,11000.00,0.00,9837.30,0.17,1
15645,1785,1000.00,11000.00,12000.00,0.00,11000.00,0.01,1
15646,1785,1000.00,12000.00,13000.00,0.00,6096.22,0.30,1
15647,1785,1000.00,13000.00,14000.00,5565.66,7434.34,0.19,1
15648,1785,1000.00,14000.00,15000.00,3810.61,10189.39,0.37,1
15649,1785,1000.00,15000.00,16000.00,5491.26,9508.74,0.26,1
15650,1785,1000.00,16000.00,17000.00,1621.92,14378.08,0.31,1
15651,1785,1000.00,17000.00,18000.00,4850.59,11806.51,0.35,1
15652,1785,1000.00,18000.00,19000.00,7113.79,10886.21,0.32,1
15653,1785,-1000.00,17000.00,18000.00,16189.47,2810.53,0.04,0
15654,1785,1000.00,18000.00,19000.00,1096.01,3846.33,0.19,1
15655,1785,1000.00,19000.00,20000.00,0.00,9399.92,0.29,1
15656,1785,0.00,19000.00,20000.00,0.00,0.00,0.00,0
15657,1785,1000.00,20000.00,21000.00,0.00,18881.81,0.43,1
15658,1785,1000.00,21000.00,22000.00,2126.93,18873.07,0.43,1
15659,1785,1000.00,22000.00,23000.00,11000.00,11000.00,0.27,1
15660,1785,1000.00,23000.00,24000.00,726.23,9021.15,0.26,1
15661,1785,-1000.00,22000.00,23000.00,8961.21,632.71,0.10,0
15662,1785,-1000.00,21000.00,22000.00,11872.55,11127.45,0.06,0
15663,1785,1000.00,22000.00,23000.00,0.00,22000.00,0.13,1
15664,1785,-1000.00,21000.00,22000.00,17040.53,5959.47,0.19,0
15665,1785,1000.00,22000.00,23000.00,9709.41,12290.59,0.30,1
15666,1785,1000.00,23000.00,24000.00,0.00,15215.05,0.37,1
15667,1785,1000.00,24000.00,25000.00,0.00,19363.36,0.22,1
15668,1785,1000.00,25000.00,26000.00,0.00,25000.00,0.08,1
15669,1785,1000.00,26000.00,27000.00,0.00,26000.00,0.32,1
15670,1785,1000.00,27000.00,28000.00,11759.74,15240.26,0.06,1
15671,1785,0.00,27000.00,28000.00,0.00,0.00,0.01,0
15672,1786,-1000.00,-1000.00,0.00,0.00,1000.00,0.22,0
15673,1787,-684.69,-684.69,315.31,76.64,608.05,0.36,0
15674,1787,-315.31,-1000.00,0.00,0.00,315.31,0.09,0
15675,1788,-1000.00,-1000.00,0.00,0.00,981.68,0.37,0
15676,1789,1000.00,1000.00,2000.00,577.86,0.00,0.06,1
15677,1789,-1000.00,0.00,1000.00,0.00,1850.68,0.27,0
15678,1789,-853.84,-853.84,146.16,0.00,853.84,0.35,0
15679,1789,-146.16,-1000.00,0.00,70.25,75.91,0.39,0
15680,1790,-1000.00,-1000.00,0.00,428.55,571.45,0.27,0
15681,1791,-1000.00,-1000.00,0.00,222.28,777.72,0.39,0
15682,1792,1000.00,1000.00,2000.00,0.00,1000.00,0.19,1
15683,1792,1000.00,2000.00,3000.00,843.14,1156.86,0.02,1
15684,1792,1000.00,3000.00,4000.00,939.21,2060.79,0.32,1
15685,1792,1000.00,4000.00,5000.00,0.00,4000.00,0.28,1
15686,1792,1000.00,5000.00,6000.00,0.00,1233.00,0.16,1
15687,1792,1000.00,6000.00,7000.00,557.51,4291.14,0.40,1
15688,1792,-1000.00,5000.00,6000.00,3530.15,3469.85,0.43,0
15689,1792,1000.00,6000.00,7000.00,3000.00,3000.00,0.09,1
15690,1792,1000.00,7000.00,8000.00,0.00,6243.23,0.24,1
15691,1792,1000.00,8000.00,9000.00,3402.71,4597.29,0.30,1
15692,1792,1000.00,9000.00,10000.00,3078.84,5921.16,0.37,1
15693,1792,1000.00,10000.00,11000.00,0.00,7419.05,0.41,1
15694,1792,1000.00,11000.00,12000.00,0.00,6738.03,0.30,1
15695,1792,1000.00,12000.00,13000.00,3430.59,7549.63,0.33,1
15696,1792,-1000.00,11000.00,12000.00,7237.31,5762.69,0.20,0
15697,1792,1000.00,12000.00,13000.00,0.00,9364.12,0.31,1
15698,1792,1000.00,13000.00,14000.00,0.00,1512.98,0.06,1
15699,1792,1000.00,14000.00,15000.00,0.00,14000.00,0.19,1
15700,1792,-1000.00,13000.00,14000.00,15000.00,0.00,0.09,0
15701,1792,-1000.00,12000.00,13000.00,7236.81,6763.19,0.21,0
15702,1792,-1000.00,11000.00,12000.00,0.00,13000.00,0.26,0
15703,1792,-1000.00,10000.00,11000.00,1995.57,10004.43,0.29,0
15704,1792,-1000.00,9000.00,10000.00,0.00,11000.00,0.16,0
15705,1792,-1000.00,8000.00,9000.00,4635.15,5364.85,0.25,0
15706,1792,-1000.00,7000.00,8000.00,3739.52,5260.48,0.11,0
15707,1792,-1000.00,6000.00,7000.00,2189.56,5810.44,0.30,0
15708,1792,-1000.00,5000.00,6000.00,0.00,7000.00,0.05,0
15709,1792,-1000.00,4000.00,5000.00,2002.77,3997.23,0.41,0
15710,1792,-1000.00,3000.00,4000.00,1178.79,3821.21,0.42,0
15711,1792,-1000.00,2000.00,3000.00,0.00,2804.61,0.22,0
15712,1792,-1000.00,1000.00,2000.00,556.25,2443.75,0.37,0
15713,1792,-1000.00,0.00,1000.00,641.53,1358.47,0.32,0
15714,1792,-1000.00,-1000.00,0.00,408.86,591.14,0.27,0
15715,1793,1000.00,1000.00,2000.00,0.00,1000.00,0.06,1
15716,1793,1000.00,2000.00,3000.00,462.11,1537.89,0.25,1
15717,1793,1000.00,3000.00,4000.00,0.00,1857.80,0.03,1
15718,1793,-1000.00,2000.00,3000.00,2206.75,1793.25,0.00,0
15719,1793,-1000.00,1000.00,2000.00,1615.95,1384.05,0.33,0
15720,1793,1000.00,2000.00,3000.00,0.00,1803.84,0.19,1
15721,1793,-1000.00,1000.00,2000.00,1867.43,1132.57,0.19,0
15722,1793,1000.00,2000.00,3000.00,0.00,2000.00,0.04,1
15723,1793,1000.00,3000.00,4000.00,1500.00,1500.00,0.06,1
15724,1793,1000.00,4000.00,5000.00,0.00,4000.00,0.37,1
15725,1793,-1000.00,3000.00,4000.00,2772.17,2227.83,0.19,0
15726,1793,1000.00,4000.00,5000.00,629.48,3177.11,0.41,1
15727,1793,1000.00,5000.00,6000.00,0.00,2137.13,0.24,1
15728,1793,1000.00,6000.00,7000.00,0.00,5391.44,0.25,1
15729,1793,1000.00,7000.00,8000.00,0.00,3167.40,0.25,1
15730,1793,1000.00,8000.00,9000.00,0.00,6574.45,0.42,1
15731,1793,1000.00,9000.00,10000.00,2701.28,6298.72,0.43,1
15732,1793,-1000.00,8000.00,9000.00,2121.12,0.00,0.01,0
15733,1793,1000.00,9000.00,10000.00,4500.00,4500.00,0.12,1
15734,1793,1000.00,10000.00,11000.00,0.00,10000.00,0.24,1
15735,1793,1000.00,11000.00,12000.00,5500.00,5500.00,0.02,1
15736,1793,1000.00,12000.00,13000.00,394.35,8919.86,0.41,1
15737,1793,-1000.00,11000.00,12000.00,7260.28,5739.72,0.40,0
15738,1793,-1000.00,10000.00,11000.00,9723.13,2276.87,0.06,0
15739,1793,1000.00,11000.00,12000.00,0.00,7662.38,0.14,1
15740,1793,1000.00,12000.00,13000.00,1431.32,10568.68,0.40,1
15741,1793,1000.00,13000.00,14000.00,3176.65,9823.35,0.36,1
15742,1793,1000.00,14000.00,15000.00,0.00,6666.46,0.14,1
15743,1793,1000.00,15000.00,16000.00,7500.00,7500.00,0.11,1
15744,1793,1000.00,16000.00,17000.00,7773.17,8226.83,0.13,1
15745,1793,-1000.00,15000.00,16000.00,4663.05,4198.58,0.18,0
15746,1793,1000.00,16000.00,17000.00,0.00,16000.00,0.40,1
15747,1793,1000.00,17000.00,18000.00,7223.25,9776.75,0.12,1
15748,1793,-1000.00,16000.00,17000.00,3432.84,1220.97,0.14,0
15749,1793,0.00,16000.00,17000.00,0.00,0.00,0.08,0
15750,1793,1000.00,17000.00,18000.00,0.00,16776.86,0.36,1
15751,1793,1000.00,18000.00,19000.00,3931.28,14068.72,0.38,1
15752,1793,1000.00,19000.00,20000.00,8544.75,10455.25,0.17,1
15753,1793,1000.00,20000.00,21000.00,0.00,20000.00,0.33,1
15754,1793,1000.00,21000.00,22000.00,10500.00,10500.00,0.19,1
15755,1793,1000.00,22000.00,23000.00,153.68,21846.32,0.24,1
15756,1793,-1000.00,21000.00,22000.00,6926.17,0.00,0.08,0
15757,1793,1000.00,22000.00,23000.00,6548.82,15451.18,0.34,1
15758,1793,1000.00,23000.00,24000.00,0.00,23000.00,0.00,1
15759,1793,1000.00,24000.00,25000.00,0.00,24000.00,0.38,1
15760,1793,1000.00,25000.00,26000.00,12500.00,12500.00,0.03,1
15761,1793,1000.00,26000.00,27000.00,12501.30,13498.70,0.13,1
15762,1793,-1000.00,25000.00,26000.00,13500.00,13500.00,0.37,0
15763,1793,-1000.00,24000.00,25000.00,9356.01,16643.99,0.03,0
15764,1793,-1000.00,23000.00,24000.00,0.00,25000.00,0.38,0
15765,1793,-1000.00,22000.00,23000.00,2401.86,14452.95,0.36,0
15766,1793,-1000.00,21000.00,22000.00,10860.40,12139.60,0.24,0
15767,1793,-1000.00,20000.00,21000.00,11649.10,10350.90,0.16,0
15768,1793,-1000.00,19000.00,20000.00,0.00,21000.00,0.10,0
15769,1793,-1000.00,18000.00,19000.00,9359.41,10640.59,0.16,0
15770,1793,-1000.00,17000.00,18000.00,4232.59,14767.41,0.26,0
15771,1793,-1000.00,16000.00,17000.00,0.00,7468.59,0.27,0
15772,1793,-1000.00,15000.00,16000.00,4594.31,12405.69,0.38,0
15773,1793,-1000.00,14000.00,15000.00,5311.15,10688.85,0.33,0
15774,1793,-1000.00,13000.00,14000.00,5975.64,9024.36,0.07,0
15775,1793,-1000.00,12000.00,13000.00,5564.80,8435.20,0.18,0
15776,1793,-1000.00,11000.00,12000.00,0.00,13000.00,0.05,0
15777,1793,-1000.00,10000.00,11000.00,0.00,12000.00,0.05,0
15778,1793,-1000.00,9000.00,10000.00,0.00,11000.00,0.18,0
15779,1793,-1000.00,8000.00,9000.00,0.00,10000.00,0.43,0
15780,1793,-1000.00,7000.00,8000.00,4149.45,4850.55,0.13,0
15781,1793,-1000.00,6000.00,7000.00,3970.20,4029.80,0.11,0
15782,1794,1000.00,1000.00,2000.00,0.00,775.23,0.16,1
15783,1794,1000.00,2000.00,3000.00,0.00,159.17,0.11,1
15784,1794,1000.00,3000.00,4000.00,0.00,1127.72,0.14,1
15785,1794,0.00,3000.00,4000.00,0.00,0.00,0.02,0
15786,1794,1000.00,4000.00,5000.00,0.00,4000.00,0.25,1
15787,1794,1000.00,5000.00,6000.00,1248.97,3751.03,0.38,1
15788,1794,1000.00,6000.00,7000.00,384.82,5615.18,0.43,1
15789,1794,1000.00,7000.00,8000.00,294.63,6705.37,0.32,1
15790,1794,1000.00,8000.00,9000.00,0.00,5517.18,0.06,1
15791,1794,-1000.00,7000.00,8000.00,5274.37,3725.63,0.16,0
15792,1794,1000.00,8000.00,9000.00,1845.06,6154.94,0.31,1
15793,1794,1000.00,9000.00,10000.00,1198.47,7801.53,0.33,1
15794,1794,-1000.00,8000.00,9000.00,8193.20,761.97,0.05,0
15795,1794,1000.00,9000.00,10000.00,0.00,8333.69,0.44,1
15796,1794,1000.00,10000.00,11000.00,3454.23,6545.77,0.26,1
15797,1794,1000.00,11000.00,12000.00,1717.22,9282.78,0.23,1
15798,1794,1000.00,12000.00,13000.00,6000.00,6000.00,0.40,1
15799,1794,1000.00,13000.00,14000.00,3572.81,9427.19,0.30,1
15800,1794,-1000.00,12000.00,13000.00,7331.07,6668.93,0.20,0
15801,1794,1000.00,13000.00,14000.00,2796.51,10203.49,0.40,1
15802,1794,1000.00,14000.00,15000.00,0.00,13958.26,0.20,1
15803,1794,-1000.00,13000.00,14000.00,12542.35,2085.53,0.06,0
15804,1794,-1000.00,12000.00,13000.00,8620.31,5379.69,0.19,0
15805,1794,-1000.00,11000.00,12000.00,4628.46,8371.54,0.29,0
15806,1794,-1000.00,10000.00,11000.00,3986.15,8013.85,0.33,0
15807,1794,-1000.00,9000.00,10000.00,3465.20,7534.80,0.31,0
15808,1794,-1000.00,8000.00,9000.00,5094.51,4905.49,0.29,0
15809,1794,-1000.00,7000.00,8000.00,0.00,8061.97,0.29,0
15810,1794,-1000.00,6000.00,7000.00,4000.00,4000.00,0.06,0
15811,1794,-1000.00,5000.00,6000.00,3549.81,3450.19,0.09,0
15812,1794,-1000.00,4000.00,5000.00,0.00,6000.00,0.38,0
15813,1794,-1000.00,3000.00,4000.00,2375.68,2624.32,0.19,0
15814,1794,-1000.00,2000.00,3000.00,0.00,4000.00,0.13,0
15815,1794,-1000.00,1000.00,2000.00,0.00,2803.72,0.17,0
15816,1794,-1000.00,0.00,1000.00,274.58,1663.00,0.42,0
15817,1794,-1000.00,-1000.00,0.00,721.04,278.96,0.01,0
15818,1795,-968.18,-968.18,31.82,0.00,968.18,0.30,0
15819,1795,-31.82,-1000.00,0.00,14.43,17.39,0.17,0
15820,1796,-1000.00,-1000.00,0.00,0.00,831.12,0.13,0
15821,1797,-1000.00,-1000.00,0.00,99.24,900.76,0.20,0
15822,1798,1000.00,1000.00,2000.00,491.59,508.41,0.19,1
15823,1798,1000.00,2000.00,3000.00,968.42,1031.58,0.12,1
15824,1798,1000.00,3000.00,4000.00,829.17,2170.83,0.39,1
15825,1798,1000.00,4000.00,5000.00,1233.72,2766.28,0.33,1
15826,1798,1000.00,5000.00,6000.00,0.00,1843.53,0.17,1
15827,1798,1000.00,6000.00,7000.00,1282.59,4717.41,0.23,1
15828,1798,0.00,6000.00,7000.00,0.00,0.00,0.07,0
15829,1798,1000.00,7000.00,8000.00,3214.14,3785.86,0.24,1
15830,1798,1000.00,8000.00,9000.00,1228.06,6771.94,0.43,1
15831,1798,-1000.00,7000.00,8000.00,5525.06,3474.94,0.16,0
15832,1798,1000.00,8000.00,9000.00,3676.63,4323.37,0.16,1
15833,1798,1000.00,9000.00,10000.00,4500.00,4500.00,0.01,1
15834,1798,1000.00,10000.00,11000.00,3240.77,6759.23,0.36,1
15835,1798,1000.00,11000.00,12000.00,0.00,11000.00,0.02,1
15836,1798,1000.00,12000.00,13000.00,5610.29,6389.71,0.15,1
15837,1798,1000.00,13000.00,14000.00,5120.53,7879.47,0.24,1
15838,1798,-1000.00,12000.00,13000.00,10093.37,3906.63,0.05,0
15839,1798,1000.00,13000.00,14000.00,499.27,12500.73,0.08,1
15840,1798,1000.00,14000.00,15000.00,0.00,5773.51,0.24,1
15841,1798,1000.00,15000.00,16000.00,3996.02,11003.98,0.30,1
15842,1798,1000.00,16000.00,17000.00,0.00,16000.00,0.29,1
15843,1798,1000.00,17000.00,18000.00,0.00,14446.70,0.43,1
15844,1798,-1000.00,16000.00,17000.00,3340.55,14659.45,0.19,0
15845,1798,-1000.00,15000.00,16000.00,0.00,17000.00,0.32,0
15846,1798,-1000.00,14000.00,15000.00,10813.45,0.00,0.01,0
15847,1798,-1000.00,13000.00,14000.00,4490.27,10509.73,0.22,0
15848,1798,-1000.00,12000.00,13000.00,5293.48,8706.52,0.31,0
15849,1798,-1000.00,11000.00,12000.00,0.00,13000.00,0.31,0
15850,1798,-821.33,10178.67,11178.67,0.00,821.33,0.06,0
15851,1798,-1000.00,9178.67,10178.67,7926.14,3252.53,0.17,0
15852,1798,-1000.00,8178.67,9178.67,3221.33,6957.35,0.26,0
15853,1798,-1000.00,7178.67,8178.67,1503.57,7675.10,0.37,0
15854,1798,0.00,7178.67,8178.67,0.00,0.00,0.04,0
15855,1798,-1000.00,6178.67,7178.67,4089.34,4089.34,0.32,0
15856,1798,0.00,6178.67,7178.67,0.00,0.00,0.03,0
15857,1798,-1000.00,5178.67,6178.67,1925.47,5253.21,0.32,0
15858,1798,-1000.00,4178.67,5178.67,1226.21,2411.13,0.27,0
15859,1798,-1000.00,3178.67,4178.67,0.00,5178.67,0.16,0
15860,1798,-1000.00,2178.67,3178.67,1998.40,2180.28,0.42,0
15861,1798,-1000.00,1178.67,2178.67,0.00,3178.67,0.08,0
15862,1798,-1000.00,178.67,1178.67,824.48,1354.20,0.29,0
15863,1798,-1000.00,-821.33,178.67,190.08,988.59,0.38,0
15864,1798,-178.67,-1000.00,0.00,0.00,178.67,0.03,0
15865,1799,-1000.00,-1000.00,0.00,500.00,500.00,0.01,0
15866,1800,-1000.00,-1000.00,0.00,529.48,470.52,0.19,0
15867,1800,0.00,-1000.00,0.00,0.00,0.00,0.29,1
15868,1800,0.00,-1000.00,0.00,0.00,0.00,0.23,1
15869,1800,0.00,-1000.00,0.00,0.00,0.00,0.39,1
15870,1800,0.00,-1000.00,0.00,0.00,0.00,0.03,1
15871,1800,0.00,-1000.00,0.00,0.00,0.00,0.13,1
15872,1800,0.33,-999.67,0.33,0.00,0.00,0.13,1
15873,1800,62.95,-936.72,63.28,0.00,0.33,0.19,1
15874,1800,1000.00,63.28,1063.28,0.00,63.28,0.01,1
15875,1800,1000.00,1063.28,2063.28,0.00,421.64,0.11,1
15876,1800,1000.00,2063.28,3063.28,922.96,1140.31,0.15,1
15877,1800,-1000.00,1063.28,2063.28,1937.42,1125.85,0.12,0
15878,1800,1000.00,2063.28,3063.28,662.32,1400.96,0.29,1
15879,1800,1000.00,3063.28,4063.28,0.00,2822.22,0.27,1
15880,1800,1000.00,4063.28,5063.28,2031.64,2031.64,0.42,1
15881,1800,1000.00,5063.28,6063.28,2122.87,2940.41,0.26,1
15882,1800,1000.00,6063.28,7063.28,0.00,6063.28,0.11,1
15883,1800,-1000.00,5063.28,6063.28,3531.64,3531.64,0.08,0
15884,1800,-1000.00,4063.28,5063.28,3651.38,2411.90,0.14,0
15885,1800,-1000.00,3063.28,4063.28,0.00,2567.46,0.27,0
15886,1800,-1000.00,2063.28,3063.28,1864.88,627.06,0.13,0
15887,1800,-1000.00,1063.28,2063.28,1531.64,1531.64,0.26,0
15888,1800,-945.67,117.61,1117.61,141.97,803.70,0.26,0
15889,1800,-1000.00,-882.39,117.61,0.00,1117.61,0.30,0
15890,1800,-117.61,-1000.00,0.00,0.00,117.61,0.07,0
15891,1801,-1000.00,-1000.00,0.00,259.82,740.18,0.27,0
15892,1802,-1000.00,-1000.00,0.00,0.00,350.13,0.14,0
15893,1803,-854.40,-854.40,145.60,0.00,854.40,0.38,0
15894,1803,-145.60,-1000.00,0.00,64.79,80.81,0.10,0
15895,1804,-1000.00,-1000.00,0.00,14.27,985.73,0.43,0
15896,1805,-1000.00,-1000.00,0.00,909.59,38.86,0.04,0
15897,1806,-1000.00,-1000.00,0.00,500.00,500.00,0.09,0
15898,1807,-1000.00,-1000.00,0.00,273.09,122.18,0.16,0
15899,1808,-859.43,-859.43,140.57,0.00,859.43,0.31,0
15900,1808,-140.57,-1000.00,0.00,0.00,140.57,0.12,0
15901,1809,-1000.00,-1000.00,0.00,0.00,739.16,0.34,0
15902,1810,-1000.00,-1000.00,0.00,0.00,67.98,0.02,0
15903,1811,-1000.00,-1000.00,0.00,142.44,857.56,0.38,0
15904,1812,-1000.00,-1000.00,0.00,500.00,500.00,0.00,0
15905,1813,-660.77,-660.77,339.23,281.11,379.66,0.23,0
15906,1813,-339.23,-1000.00,0.00,99.04,240.18,0.26,0
15907,1814,1000.00,1000.00,2000.00,0.00,967.77,0.35,1
15908,1814,1000.00,2000.00,3000.00,269.01,1316.43,0.37,1
15909,1814,1000.00,3000.00,4000.00,0.00,3000.00,0.19,1
15910,1814,1000.00,4000.00,5000.00,0.00,4000.00,0.18,1
15911,1814,1000.00,5000.00,6000.00,0.00,5000.00,0.22,1
15912,1814,1000.00,6000.00,7000.00,3000.00,3000.00,0.25,1
15913,1814,-1000.00,5000.00,6000.00,4630.48,2369.52,0.08,0
15914,1814,-1000.00,4000.00,5000.00,3442.56,2557.44,0.12,0
15915,1814,1000.00,5000.00,6000.00,531.64,4468.36,0.38,1
15916,1814,1000.00,6000.00,7000.00,936.06,5063.94,0.44,1
15917,1814,1000.00,7000.00,8000.00,0.00,7000.00,0.39,1
15918,1814,1000.00,8000.00,9000.00,0.00,8000.00,0.31,1
15919,1814,1000.00,9000.00,10000.00,0.00,8053.93,0.41,1
15920,1814,1000.00,10000.00,11000.00,0.00,651.87,0.14,1
15921,1814,1000.00,11000.00,12000.00,2670.79,8329.21,0.27,1
15922,1814,1000.00,12000.00,13000.00,6000.00,6000.00,0.43,1
15923,1814,-1000.00,11000.00,12000.00,6566.50,6433.50,0.38,0
15924,1814,1000.00,12000.00,13000.00,5245.49,6754.51,0.36,1
15925,1814,1000.00,13000.00,14000.00,0.00,8495.08,0.04,1
15926,1814,1000.00,14000.00,15000.00,0.00,10769.62,0.26,1
15927,1814,1000.00,15000.00,16000.00,0.00,15000.00,0.26,1
15928,1814,1000.00,16000.00,17000.00,0.00,2857.99,0.15,1
15929,1814,1000.00,17000.00,18000.00,5600.98,10243.94,0.34,1
15930,1814,1000.00,18000.00,19000.00,0.00,18000.00,0.40,1
15931,1814,-1000.00,17000.00,18000.00,0.00,17088.34,0.00,0
15932,1814,-1000.00,16000.00,17000.00,5382.64,9804.92,0.31,0
15933,1814,-1000.00,15000.00,16000.00,0.00,13730.43,0.44,0
15934,1814,-1000.00,14000.00,15000.00,0.00,5698.19,0.08,0
15935,1814,-1000.00,13000.00,14000.00,0.00,15000.00,0.22,0
15936,1814,-1000.00,12000.00,13000.00,7000.00,7000.00,0.29,0
15937,1814,-1000.00,11000.00,12000.00,0.00,13000.00,0.36,0
15938,1814,-1000.00,10000.00,11000.00,4820.96,7179.04,0.24,0
15939,1814,-1000.00,9000.00,10000.00,0.00,1091.10,0.16,0
15940,1814,-1000.00,8000.00,9000.00,377.43,9622.57,0.29,0
15941,1814,-1000.00,7000.00,8000.00,4496.34,4503.66,0.21,0
15942,1814,-1000.00,6000.00,7000.00,3125.60,4874.40,0.37,0
15943,1814,-1000.00,5000.00,6000.00,2778.61,0.00,0.00,0
15944,1814,-1000.00,4000.00,5000.00,0.00,4553.18,0.21,0
15945,1814,-1000.00,3000.00,4000.00,1885.93,3114.07,0.14,0
15946,1814,-1000.00,2000.00,3000.00,0.00,3898.11,0.38,0
15947,1814,-1000.00,1000.00,2000.00,0.00,3000.00,0.22,0
15948,1814,-1000.00,0.00,1000.00,0.00,1110.31,0.29,0
15949,1814,-1000.00,-1000.00,0.00,720.83,279.17,0.01,0
15950,1815,-1000.00,-1000.00,0.00,250.46,338.76,0.28,0
15951,1816,-1000.00,-1000.00,0.00,279.33,720.67,0.34,0
15952,1817,-1000.00,-1000.00,0.00,0.00,1000.00,0.34,0
15953,1818,-1000.00,-1000.00,0.00,0.00,1000.00,0.21,0
15954,1819,-1000.00,-1000.00,0.00,365.35,634.65,0.34,0
15955,1820,-1000.00,-1000.00,0.00,0.00,331.33,0.25,0
15956,1821,-17.55,-17.55,982.45,0.00,17.55,0.03,0
15957,1821,-716.66,-734.21,265.79,114.58,602.08,0.35,0
15958,1821,-265.79,-1000.00,0.00,0.00,265.79,0.23,0
15959,1822,1000.00,1000.00,2000.00,500.00,500.00,0.08,1
15960,1822,1000.00,2000.00,3000.00,722.85,1277.15,0.10,1
15961,1822,1000.00,3000.00,4000.00,934.47,1150.88,0.23,1
15962,1822,-1000.00,2000.00,3000.00,1277.80,1036.02,0.18,0
15963,1822,1000.00,3000.00,4000.00,0.00,2901.81,0.39,1
15964,1822,1000.00,4000.00,5000.00,685.84,3314.16,0.34,1
15965,1822,0.00,4000.00,5000.00,0.00,0.00,0.14,0
15966,1822,1000.00,5000.00,6000.00,0.00,5000.00,0.42,1
15967,1822,1000.00,6000.00,7000.00,0.00,2626.80,0.13,1
15968,1822,1000.00,7000.00,8000.00,3103.67,3896.33,0.27,1
15969,1822,1000.00,8000.00,9000.00,1392.92,3188.98,0.27,1
15970,1822,-1000.00,7000.00,8000.00,9000.00,0.00,0.08,0
15971,1822,-1000.00,6000.00,7000.00,1965.24,1097.22,0.16,0
15972,1822,-1000.00,5000.00,6000.00,718.46,319.15,0.12,0
15973,1822,1000.00,6000.00,7000.00,0.00,6000.00,0.41,1
15974,1822,1000.00,7000.00,8000.00,336.36,6663.64,0.44,1
15975,1822,1000.00,8000.00,9000.00,1399.89,6600.11,0.29,1
15976,1822,1000.00,9000.00,10000.00,2022.99,6977.01,0.22,1
15977,1822,1000.00,10000.00,11000.00,0.00,10000.00,0.41,1
15978,1822,1000.00,11000.00,12000.00,1565.13,9434.87,0.35,1
15979,1822,1000.00,12000.00,13000.00,6000.00,6000.00,0.25,1
15980,1822,1000.00,13000.00,14000.00,0.00,11200.10,0.28,1
15981,1822,1000.00,14000.00,15000.00,6434.18,7565.82,0.16,1
15982,1822,1000.00,15000.00,16000.00,0.00,15000.00,0.01,1
15983,1822,-1000.00,14000.00,15000.00,10679.54,5320.46,0.25,0
15984,1822,-1000.00,13000.00,14000.00,2885.78,12114.22,0.35,0
15985,1822,-1000.00,12000.00,13000.00,0.00,4703.04,0.25,0
15986,1822,-1000.00,11000.00,12000.00,0.00,13000.00,0.23,0
15987,1822,-1000.00,10000.00,11000.00,6000.00,6000.00,0.41,0
15988,1822,-1000.00,9000.00,10000.00,0.00,11000.00,0.18,0
15989,1822,-1000.00,8000.00,9000.00,3239.55,6760.45,0.27,0
15990,1822,-1000.00,7000.00,8000.00,4500.00,4500.00,0.01,0
15991,1822,-1000.00,6000.00,7000.00,2132.63,5867.37,0.16,0
15992,1822,-1000.00,5000.00,6000.00,0.00,7000.00,0.31,0
15993,1822,-1000.00,4000.00,5000.00,537.82,5462.18,0.13,0
15994,1822,-1000.00,3000.00,4000.00,876.53,4123.47,0.20,0
15995,1822,-1000.00,2000.00,3000.00,0.00,4000.00,0.26,0
15996,1822,-1000.00,1000.00,2000.00,0.00,1865.69,0.35,0
15997,1822,-1000.00,0.00,1000.00,762.59,1237.41,0.09,0
15998,1822,-1000.00,-1000.00,0.00,367.62,632.38,0.33,0
15999,1823,0.00,0.00,1000.00,0.00,0.00,0.03,0
16000,1823,1000.00,1000.00,2000.00,275.21,724.79,0.34,1
16001,1823,-1000.00,0.00,1000.00,1470.59,529.41,0.05,0
16002,1823,1000.00,1000.00,2000.00,0.00,1000.00,0.40,1
16003,1823,-1000.00,0.00,1000.00,1434.04,565.96,0.05,0
16004,1823,1000.00,1000.00,2000.00,404.46,595.54,0.12,1
16005,1823,1000.00,2000.00,3000.00,48.09,433.22,0.19,1
16006,1823,-1000.00,1000.00,2000.00,905.54,635.95,0.17,0
16007,1823,1000.00,2000.00,3000.00,381.39,1618.61,0.09,1
16008,1823,1000.00,3000.00,4000.00,961.15,2038.85,0.36,1
16009,1823,1000.00,4000.00,5000.00,0.00,4000.00,0.12,1
16010,1823,1000.00,5000.00,6000.00,467.41,4532.59,0.39,1
16011,1823,1000.00,6000.00,7000.00,2848.98,3151.02,0.02,1
16012,1823,-1000.00,5000.00,6000.00,3567.03,3432.97,0.01,0
16013,1823,1000.00,6000.00,7000.00,1429.96,4570.04,0.41,1
16014,1823,1000.00,7000.00,8000.00,0.00,4127.37,0.34,1
16015,1823,1000.00,8000.00,9000.00,4000.00,4000.00,0.01,1
16016,1823,1000.00,9000.00,10000.00,0.00,3822.76,0.07,1
16017,1823,1000.00,10000.00,11000.00,3449.10,6550.90,0.10,1
16018,1823,1000.00,11000.00,12000.00,0.00,11000.00,0.10,1
16019,1823,1000.00,12000.00,13000.00,4536.84,7463.16,0.15,1
16020,1823,1000.00,13000.00,14000.00,4119.65,8880.35,0.26,1
16021,1823,1000.00,14000.00,15000.00,432.32,8629.12,0.36,1
16022,1823,1000.00,15000.00,16000.00,73.94,14926.06,0.42,1
16023,1823,1000.00,16000.00,17000.00,0.00,8299.31,0.26,1
16024,1823,0.00,16000.00,17000.00,0.00,0.00,0.08,0
16025,1823,1000.00,17000.00,18000.00,5082.76,11917.24,0.06,1
16026,1823,1000.00,18000.00,19000.00,3432.24,14567.76,0.39,1
16027,1823,1000.00,19000.00,20000.00,6725.46,12274.54,0.29,1
16028,1823,1000.00,20000.00,21000.00,5530.63,14469.37,0.37,1
16029,1823,1000.00,21000.00,22000.00,5179.86,15820.14,0.40,1
16030,1823,1000.00,22000.00,23000.00,9168.25,12831.75,0.24,1
16031,1823,1000.00,23000.00,24000.00,6820.37,16179.63,0.30,1
16032,1823,1000.00,24000.00,25000.00,0.00,24000.00,0.33,1
16033,1823,-1000.00,23000.00,24000.00,14114.96,10885.04,0.41,0
16034,1823,0.00,23000.00,24000.00,0.00,0.00,0.03,0
16035,1823,0.00,23000.00,24000.00,0.00,0.00,0.02,0
16036,1823,1000.00,24000.00,25000.00,11565.65,12434.35,0.12,1
16037,1823,1000.00,25000.00,26000.00,0.00,6622.16,0.20,1
16038,1823,1000.00,26000.00,27000.00,10489.69,15510.31,0.38,1
16039,1823,1000.00,27000.00,28000.00,11278.05,15721.95,0.22,1
16040,1824,-1000.00,-1000.00,0.00,500.00,500.00,0.06,0
16041,1825,-1000.00,-1000.00,0.00,125.51,874.49,0.42,0
16042,1826,-1000.00,-1000.00,0.00,314.59,685.41,0.35,0
16043,1827,-486.29,-486.29,513.71,0.00,486.29,0.21,0
16044,1827,-432.77,-919.06,80.94,0.00,432.77,0.17,0
16045,1827,-63.15,-982.21,17.79,0.00,63.15,0.40,0
16046,1827,-17.79,-1000.00,0.00,0.00,17.79,0.34,0
16047,1828,-861.28,-861.28,138.72,0.00,861.28,0.28,0
16048,1828,-4.50,-865.78,134.22,0.00,4.50,0.37,0
16049,1828,0.00,-865.78,134.22,0.00,0.00,0.36,0
16050,1828,-33.94,-899.72,100.28,2.13,31.81,0.41,0
16051,1828,-81.74,-981.46,18.54,0.00,81.74,0.08,0
16052,1828,-9.57,-991.04,8.96,0.00,9.57,0.02,0
16053,1828,634.44,-356.60,643.40,2.73,0.00,0.14,1
16054,1828,1000.00,643.40,1643.40,582.15,0.00,0.05,1
16055,1828,-157.51,485.89,1485.89,0.00,157.51,0.25,0
16056,1828,1000.00,1485.89,2485.89,1253.46,232.43,0.25,1
16057,1828,-1000.00,485.89,1485.89,0.00,1108.83,0.26,0
16058,1828,1000.00,1485.89,2485.89,1485.89,0.00,0.03,1
16059,1828,-138.85,1347.04,2347.04,0.00,138.85,0.27,0
16060,1828,1000.00,2347.04,3347.04,1752.05,595.00,0.19,1
16061,1828,0.00,2347.04,3347.04,0.00,0.00,0.07,0
16062,1828,1000.00,3347.04,4347.04,1710.68,1636.37,0.40,1
16063,1828,-1000.00,2347.04,3347.04,1758.39,2588.66,0.33,0
16064,1828,-1000.00,1347.04,2347.04,1473.96,1873.09,0.41,0
16065,1828,0.00,1347.04,2347.04,0.00,0.00,0.11,0
16066,1828,-1000.00,347.04,1347.04,969.56,1377.48,0.15,0
16067,1828,-104.46,242.58,1242.58,0.00,104.46,0.04,0
16068,1828,1000.00,1242.58,2242.58,700.41,0.00,0.13,1
16069,1828,-1000.00,242.58,1242.58,1692.90,549.69,0.16,0
16070,1828,-1000.00,-757.42,242.58,101.06,213.65,0.40,0
16071,1828,-91.54,-848.96,151.04,76.22,15.32,0.30,0
16072,1828,-151.04,-1000.00,0.00,79.55,71.49,0.25,0
16073,1829,-1000.00,-1000.00,0.00,0.00,1000.00,0.21,0
16074,1830,-278.30,-278.30,721.70,0.00,278.30,0.06,0
16075,1830,-697.31,-975.61,24.39,0.00,697.31,0.33,0
16076,1830,-11.46,-987.07,12.93,0.00,11.46,0.20,0
16077,1830,-12.93,-1000.00,0.00,6.39,6.53,0.37,0
16078,1831,-1000.00,-1000.00,0.00,0.00,1000.00,0.28,0
16079,1832,-1000.00,-1000.00,0.00,570.49,249.83,0.13,0
16080,1833,-1000.00,-1000.00,0.00,937.23,62.77,0.01,0
16081,1834,0.00,0.00,1000.00,0.00,0.00,0.24,0
16082,1834,1000.00,1000.00,2000.00,322.85,0.00,0.18,1
16083,1834,-824.31,175.69,1175.69,0.00,824.31,0.34,0
16084,1834,-695.52,-519.83,480.17,0.00,695.52,0.30,0
16085,1834,-368.76,-888.59,111.41,0.00,368.76,0.23,0
16086,1834,-56.39,-944.98,55.02,0.00,56.39,0.35,0
16087,1834,-17.69,-962.67,37.33,0.00,17.69,0.35,0
16088,1834,-37.33,-1000.00,0.00,13.72,23.62,0.24,0
16089,1835,-1000.00,-1000.00,0.00,0.00,666.05,0.13,0
16090,1836,-819.97,-819.97,180.03,172.63,647.34,0.36,0
16091,1836,-180.03,-1000.00,0.00,0.00,180.03,0.02,0
16092,1837,-723.78,-723.78,276.22,121.56,602.22,0.35,0
16093,1837,-71.34,-795.11,204.89,0.00,71.34,0.20,0
16094,1837,-204.89,-1000.00,0.00,0.00,204.89,0.15,0
16095,1838,-721.02,-721.02,278.98,0.00,721.02,0.25,0
16096,1838,-278.98,-1000.00,0.00,0.00,278.98,0.10,0
16097,1839,-1000.00,-1000.00,0.00,0.00,1000.00,0.19,0
16098,1840,1000.00,1000.00,2000.00,89.36,910.64,0.21,1
16099,1840,1000.00,2000.00,3000.00,1000.00,1000.00,0.01,1
16100,1840,-1000.00,1000.00,2000.00,1159.82,364.89,0.14,0
16101,1840,1000.00,2000.00,3000.00,0.00,2000.00,0.05,1
16102,1840,1000.00,3000.00,4000.00,0.00,1078.72,0.15,1
16103,1840,1000.00,4000.00,5000.00,1987.25,2012.75,0.20,1
16104,1840,1000.00,5000.00,6000.00,0.00,5000.00,0.04,1
16105,1840,1000.00,6000.00,7000.00,747.33,1404.69,0.19,1
16106,1840,0.00,6000.00,7000.00,0.00,0.00,0.01,0
16107,1840,1000.00,7000.00,8000.00,3129.94,3870.06,0.26,1
16108,1840,1000.00,8000.00,9000.00,0.00,2419.51,0.10,1
16109,1840,1000.00,9000.00,10000.00,4392.77,4607.23,0.44,1
16110,1840,-1000.00,8000.00,9000.00,5244.57,1096.53,0.10,0
16111,1840,1000.00,9000.00,10000.00,0.00,9000.00,0.04,1
16112,1840,1000.00,10000.00,11000.00,0.00,10000.00,0.03,1
16113,1840,1000.00,11000.00,12000.00,4502.63,6497.37,0.27,1
16114,1840,1000.00,12000.00,13000.00,3060.07,8939.93,0.09,1
16115,1840,1000.00,13000.00,14000.00,249.53,9616.00,0.35,1
16116,1840,1000.00,14000.00,15000.00,0.00,9264.36,0.14,1
16117,1840,-1000.00,13000.00,14000.00,15000.00,0.00,0.02,0
16118,1840,1000.00,14000.00,15000.00,0.00,3853.65,0.20,1
16119,1840,1000.00,15000.00,16000.00,4556.11,10443.89,0.36,1
16120,1840,1000.00,16000.00,17000.00,6297.82,9702.18,0.27,1
16121,1840,1000.00,17000.00,18000.00,0.00,13698.42,0.07,1
16122,1840,1000.00,18000.00,19000.00,0.00,9248.30,0.09,1
16123,1840,1000.00,19000.00,20000.00,2891.35,16108.65,0.42,1
16124,1840,1000.00,20000.00,21000.00,10000.00,10000.00,0.01,1
16125,1840,-1000.00,19000.00,20000.00,19493.08,1506.92,0.04,0
16126,1840,1000.00,20000.00,21000.00,0.00,12149.44,0.33,1
16127,1840,-1000.00,19000.00,20000.00,12882.95,8117.05,0.36,0
16128,1840,1000.00,20000.00,21000.00,0.00,20000.00,0.37,1
16129,1840,1000.00,21000.00,22000.00,10500.00,10500.00,0.00,1
16130,1840,1000.00,22000.00,23000.00,0.00,820.68,0.08,1
16131,1840,1000.00,23000.00,24000.00,0.00,23000.00,0.34,1
16132,1840,1000.00,24000.00,25000.00,3304.73,20695.27,0.06,1
16133,1840,1000.00,25000.00,26000.00,655.53,7092.37,0.23,1
16134,1840,-1000.00,24000.00,25000.00,14071.10,11928.90,0.08,0
16135,1840,1000.00,25000.00,26000.00,11809.32,13190.68,0.09,1
16136,1840,1000.00,26000.00,27000.00,0.00,20146.64,0.41,1
16137,1840,1000.00,27000.00,28000.00,7881.38,19118.62,0.35,1
16138,1840,1000.00,28000.00,29000.00,0.00,28000.00,0.33,1
16139,1841,1000.00,1000.00,2000.00,756.88,243.12,0.02,1
16140,1841,1000.00,2000.00,3000.00,1330.98,0.00,0.23,1
16141,1841,-1000.00,1000.00,2000.00,0.00,1665.87,0.34,0
16142,1841,1000.00,2000.00,3000.00,687.88,0.00,0.22,1
16143,1841,1000.00,3000.00,4000.00,1745.74,1254.26,0.06,1
16144,1841,-1000.00,2000.00,3000.00,1376.75,2623.25,0.09,0
16145,1841,1000.00,3000.00,4000.00,1182.21,0.00,0.30,1
16146,1841,0.00,3000.00,4000.00,0.00,0.00,0.14,0
16147,1841,1000.00,4000.00,5000.00,2289.67,1710.33,0.33,1
16148,1841,1000.00,5000.00,6000.00,5000.00,0.00,0.02,1
16149,1841,1000.00,6000.00,7000.00,3966.45,0.00,0.09,1
16150,1841,-1000.00,5000.00,6000.00,0.00,1202.43,0.29,0
16151,1841,0.00,5000.00,6000.00,0.00,0.00,0.26,0
16152,1841,-1000.00,4000.00,5000.00,0.00,6000.00,0.01,0
16153,1841,-1000.00,3000.00,4000.00,1701.30,3298.70,0.18,0
16154,1841,-1000.00,2000.00,3000.00,1972.81,2027.19,0.22,0
16155,1841,-1000.00,1000.00,2000.00,1004.91,1995.09,0.23,0
16156,1841,-1000.00,0.00,1000.00,0.00,2000.00,0.01,0
16157,1841,-597.27,-597.27,402.73,0.00,597.27,0.01,0
16158,1841,-402.73,-1000.00,0.00,0.00,402.73,0.18,0
16159,1842,-1000.00,-1000.00,0.00,0.00,1000.00,0.44,0
16160,1843,-1000.00,-1000.00,0.00,134.72,704.92,0.41,0
16161,1844,-1000.00,-1000.00,0.00,268.08,0.00,0.12,0
16162,1845,-1000.00,-1000.00,0.00,0.00,1000.00,0.06,0
16163,1846,-1000.00,-1000.00,0.00,0.00,817.41,0.22,0
16164,1847,-1000.00,-1000.00,0.00,0.00,1000.00,0.23,0
16165,1848,-802.82,-802.82,197.18,0.00,802.82,0.31,0
16166,1848,-197.18,-1000.00,0.00,8.71,188.47,0.41,0
16167,1849,0.00,0.00,1000.00,0.00,1000.00,0.22,0
16168,1849,0.00,0.00,1000.00,116.12,883.88,0.43,0
16169,1849,0.00,0.00,1000.00,0.00,893.18,0.43,0
16170,1849,0.00,0.00,1000.00,212.25,738.42,0.39,0
16171,1849,0.00,0.00,1000.00,0.00,987.26,0.23,0
16172,1849,-708.07,-708.07,291.93,439.95,268.12,0.25,0
16173,1849,0.00,-708.07,291.93,0.00,291.93,0.06,0
16174,1849,0.00,-708.07,291.93,0.00,291.93,0.37,0
16175,1849,0.00,-708.07,291.93,0.00,182.87,0.22,0
16176,1849,0.00,-708.07,291.93,87.33,204.60,0.38,0
16177,1849,0.00,-708.07,291.93,66.76,225.17,0.31,0
16178,1849,0.00,-708.07,291.93,145.97,145.97,0.14,0
16179,1849,0.00,-708.07,291.93,0.00,75.83,0.35,0
16180,1849,0.00,-708.07,291.93,107.11,184.83,0.22,0
16181,1849,0.00,-708.07,291.93,0.00,291.93,0.33,0
16182,1849,0.00,-708.07,291.93,0.00,291.93,0.12,0
16183,1849,0.00,-708.07,291.93,13.49,278.44,0.43,0
16184,1849,0.00,-708.07,291.93,139.52,152.41,0.29,0
16185,1849,0.00,-708.07,291.93,145.97,145.97,0.38,0
16186,1849,0.00,-708.07,291.93,0.00,291.93,0.04,0
16187,1849,0.00,-708.07,291.93,28.11,28.43,0.15,0
16188,1849,-67.58,-775.65,224.35,67.58,0.00,0.19,0
16189,1849,0.00,-775.65,224.35,0.00,0.00,0.09,0
16190,1849,0.00,-775.65,224.35,59.42,152.05,0.40,0
16191,1849,0.00,-775.65,224.35,104.24,120.10,0.23,0
16192,1849,0.00,-775.65,224.35,0.00,0.00,0.26,0
16193,1849,0.00,-775.65,224.35,0.00,0.00,0.04,0
16194,1849,0.00,-775.65,224.35,34.74,189.61,0.37,0
16195,1849,0.00,-775.65,224.35,0.00,224.35,0.11,0
16196,1849,0.00,-775.65,224.35,112.17,112.17,0.01,0
16197,1849,0.00,-775.65,224.35,0.00,224.35,0.02,0
16198,1849,0.00,-775.65,224.35,0.00,224.35,0.03,0
16199,1849,0.00,-775.65,224.35,0.00,169.45,0.20,0
16200,1849,0.00,-775.65,224.35,112.17,112.17,0.03,0
16201,1849,-189.98,-965.63,34.37,179.08,10.90,0.12,0
16202,1849,0.00,-965.63,34.37,0.00,34.37,0.00,0
16203,1849,0.00,-965.63,34.37,0.00,0.00,0.28,0
16204,1849,0.00,-965.63,34.37,0.00,34.37,0.28,0
16205,1849,0.00,-965.63,34.37,17.18,17.18,0.27,0
16206,1849,0.00,-965.63,34.37,2.39,14.87,0.29,0
16207,1849,0.00,-965.63,34.37,17.18,17.18,0.15,0
16208,1849,0.00,-965.63,34.37,0.35,23.07,0.38,0
16209,1850,-1000.00,-1000.00,0.00,88.61,911.39,0.16,0
16210,1851,1000.00,1000.00,2000.00,434.86,154.98,0.13,1
16211,1851,1000.00,2000.00,3000.00,1099.56,128.15,0.09,1
16212,1851,-1000.00,1000.00,2000.00,118.16,1680.79,0.10,0
16213,1851,-1000.00,0.00,1000.00,617.06,1382.94,0.34,0
16214,1851,0.00,0.00,1000.00,0.00,0.00,0.18,0
16215,1851,-1000.00,-1000.00,0.00,0.00,1000.00,0.07,0
16216,1852,-1000.00,-1000.00,0.00,199.56,800.44,0.36,0
16217,1853,-881.67,-881.67,118.33,115.87,765.81,0.40,0
16218,1853,-118.33,-1000.00,0.00,0.00,118.33,0.16,0
16219,1854,-1000.00,-1000.00,0.00,647.76,352.24,0.04,0
16220,1855,1000.00,1000.00,2000.00,0.00,1000.00,0.34,1
16221,1855,1000.00,2000.00,3000.00,296.97,1166.45,0.34,1
16222,1855,1000.00,3000.00,4000.00,0.00,3000.00,0.17,1
16223,1855,1000.00,4000.00,5000.00,1927.01,2072.99,0.07,1
16224,1855,1000.00,5000.00,6000.00,1506.96,3493.04,0.41,1
16225,1855,1000.00,6000.00,7000.00,1322.19,4677.81,0.39,1
16226,1855,1000.00,7000.00,8000.00,2720.38,4195.46,0.35,1
16227,1855,1000.00,8000.00,9000.00,0.00,8000.00,0.10,1
16228,1855,1000.00,9000.00,10000.00,4500.00,4500.00,0.26,1
16229,1855,1000.00,10000.00,11000.00,0.00,6853.76,0.22,1
16230,1855,-1000.00,9000.00,10000.00,6702.52,4297.48,0.15,0
16231,1855,1000.00,10000.00,11000.00,0.00,10000.00,0.07,1
16232,1855,1000.00,11000.00,12000.00,5500.00,5500.00,0.10,1
16233,1855,1000.00,12000.00,13000.00,2505.26,4156.20,0.23,1
16234,1855,1000.00,13000.00,14000.00,0.00,13000.00,0.02,1
16235,1855,1000.00,14000.00,15000.00,0.00,3489.39,0.09,1
16236,1855,1000.00,15000.00,16000.00,0.00,8346.27,0.25,1
16237,1855,1000.00,16000.00,17000.00,7553.55,8446.45,0.41,1
16238,1855,1000.00,17000.00,18000.00,1653.70,15346.30,0.43,1
16239,1855,1000.00,18000.00,19000.00,5654.53,12345.47,0.39,1
16240,1855,1000.00,19000.00,20000.00,7900.77,11099.23,0.09,1
16241,1855,1000.00,20000.00,21000.00,2345.17,6552.25,0.24,1
16242,1855,-1000.00,19000.00,20000.00,11921.29,9078.71,0.14,0
16243,1855,1000.00,20000.00,21000.00,8528.13,11471.87,0.32,1
16244,1855,1000.00,21000.00,22000.00,8330.42,12669.58,0.09,1
16245,1855,1000.00,22000.00,23000.00,0.00,22000.00,0.18,1
16246,1855,1000.00,23000.00,24000.00,11074.50,11925.50,0.15,1
16247,1855,1000.00,24000.00,25000.00,4714.75,19285.25,0.27,1
16248,1855,1000.00,25000.00,26000.00,0.00,18979.18,0.40,1
16249,1855,1000.00,26000.00,27000.00,0.00,26000.00,0.08,1
16250,1855,1000.00,27000.00,28000.00,0.00,27000.00,0.15,1
16251,1855,1000.00,28000.00,29000.00,0.00,28000.00,0.42,1
16252,1855,1000.00,29000.00,30000.00,10605.75,18394.25,0.34,1
16253,1855,1000.00,30000.00,31000.00,0.00,11404.99,0.23,1
16254,1855,1000.00,31000.00,32000.00,2749.40,20800.60,0.38,1
16255,1855,0.00,31000.00,32000.00,0.00,0.00,0.01,0
16256,1855,0.00,31000.00,32000.00,0.00,0.00,0.10,0
16257,1855,1000.00,32000.00,33000.00,16000.00,16000.00,0.13,1
16258,1856,-1000.00,-1000.00,0.00,0.00,396.57,0.11,0
16259,1857,1000.00,1000.00,2000.00,460.78,539.22,0.18,1
16260,1857,1000.00,2000.00,3000.00,128.25,584.28,0.22,1
16261,1857,1000.00,3000.00,4000.00,1087.11,1912.89,0.31,1
16262,1857,1000.00,4000.00,5000.00,0.00,1761.76,0.16,1
16263,1857,-1000.00,3000.00,4000.00,2694.84,2305.16,0.31,0
16264,1857,1000.00,4000.00,5000.00,0.00,2907.04,0.39,1
16265,1857,1000.00,5000.00,6000.00,2456.74,2543.26,0.00,1
16266,1857,-1000.00,4000.00,5000.00,0.00,4386.63,0.39,0
16267,1857,-1000.00,3000.00,4000.00,3518.96,394.26,0.33,0
16268,1857,-1000.00,2000.00,3000.00,778.09,1498.68,0.37,0
16269,1857,-1000.00,1000.00,2000.00,1208.23,1791.77,0.13,0
16270,1857,-917.27,82.73,1082.73,734.40,182.86,0.37,0
16271,1857,-1000.00,-917.27,82.73,0.00,757.77,0.43,0
16272,1857,-1000.00,-1917.27,-917.27,0.00,78.53,0.34,0
16273,1858,1000.00,1000.00,2000.00,0.00,1000.00,0.36,1
16274,1858,1000.00,2000.00,3000.00,1000.00,1000.00,0.04,1
16275,1858,1000.00,3000.00,4000.00,824.99,2175.01,0.39,1
16276,1858,1000.00,4000.00,5000.00,743.87,2898.82,0.38,1
16277,1858,1000.00,5000.00,6000.00,1834.93,3165.07,0.28,1
16278,1858,1000.00,6000.00,7000.00,0.00,6000.00,0.01,1
16279,1858,1000.00,7000.00,8000.00,1078.37,5921.63,0.42,1
16280,1858,-829.95,6170.05,7170.05,829.95,0.00,0.11,0
16281,1858,1000.00,7170.05,8170.05,3585.03,3585.03,0.26,1
16282,1858,1000.00,8170.05,9170.05,952.45,3043.29,0.26,1
16283,1858,1000.00,9170.05,10170.05,0.00,3643.80,0.21,1
16284,1858,1000.00,10170.05,11170.05,543.08,9626.98,0.26,1
16285,1858,-1000.00,9170.05,10170.05,5702.56,3334.36,0.16,0
16286,1858,1000.00,10170.05,11170.05,0.00,9129.76,0.41,1
16287,1858,1000.00,11170.05,12170.05,0.00,11068.98,0.25,1
16288,1858,0.00,11170.05,12170.05,0.00,0.00,0.05,0
16289,1858,1000.00,12170.05,13170.05,3791.17,8378.89,0.23,1
16290,1858,1000.00,13170.05,14170.05,0.00,13170.05,0.04,1
16291,1858,-1000.00,12170.05,13170.05,14170.05,0.00,0.08,0
16292,1858,1000.00,13170.05,14170.05,2615.66,10554.39,0.40,1
16293,1858,1000.00,14170.05,15170.05,5628.75,8541.30,0.04,1
16294,1858,-1000.00,13170.05,14170.05,8069.18,7100.87,0.38,0
16295,1858,0.00,13170.05,14170.05,0.00,0.00,0.09,0
16296,1858,1000.00,14170.05,15170.05,776.86,13393.19,0.02,1
16297,1858,1000.00,15170.05,16170.05,0.00,15170.05,0.26,1
16298,1858,1000.00,16170.05,17170.05,0.00,16170.05,0.40,1
16299,1858,1000.00,17170.05,18170.05,0.00,17170.05,0.09,1
16300,1858,1000.00,18170.05,19170.05,0.00,18170.05,0.37,1
16301,1858,0.00,18170.05,19170.05,0.00,0.00,0.07,0
16302,1858,1000.00,19170.05,20170.05,0.00,4902.27,0.14,1
16303,1858,1000.00,20170.05,21170.05,0.00,18553.88,0.14,1
16304,1858,-1000.00,19170.05,20170.05,17733.90,3436.16,0.03,0
16305,1858,1000.00,20170.05,21170.05,0.00,20170.05,0.05,1
16306,1858,1000.00,21170.05,22170.05,0.00,12140.36,0.31,1
16307,1858,1000.00,22170.05,23170.05,8651.13,13518.92,0.32,1
16308,1858,1000.00,23170.05,24170.05,2110.29,17790.78,0.40,1
16309,1858,-1000.00,22170.05,23170.05,18934.00,5236.05,0.06,0
16310,1858,1000.00,23170.05,24170.05,11585.03,11585.03,0.05,1
16311,1858,1000.00,24170.05,25170.05,10200.67,13969.38,0.26,1
16312,1858,1000.00,25170.05,26170.05,0.00,25170.05,0.23,1
16313,1858,1000.00,26170.05,27170.05,0.00,21358.09,0.42,1
16314,1859,-1000.00,-1000.00,0.00,199.57,800.43,0.08,0
16315,1860,1000.00,1000.00,2000.00,0.00,1000.00,0.30,1
16316,1860,1000.00,2000.00,3000.00,0.00,2000.00,0.22,1
16317,1860,1000.00,3000.00,4000.00,751.47,2248.53,0.36,1
16318,1860,1000.00,4000.00,5000.00,0.00,4000.00,0.01,1
16319,1860,1000.00,5000.00,6000.00,0.00,4932.53,0.35,1
16320,1860,-1000.00,4000.00,5000.00,3117.95,2168.52,0.17,0
16321,1860,1000.00,5000.00,6000.00,0.00,3795.31,0.41,1
16322,1860,1000.00,6000.00,7000.00,1211.65,4788.35,0.41,1
16323,1860,1000.00,7000.00,8000.00,0.00,4144.74,0.31,1
16324,1860,1000.00,8000.00,9000.00,1632.92,6367.08,0.10,1
16325,1860,1000.00,9000.00,10000.00,4500.00,4500.00,0.00,1
16326,1860,-1000.00,8000.00,9000.00,6286.09,3713.91,0.09,0
16327,1860,1000.00,9000.00,10000.00,4126.59,4873.41,0.16,1
16328,1860,1000.00,10000.00,11000.00,75.72,9924.28,0.17,1
16329,1860,1000.00,11000.00,12000.00,3881.86,7118.14,0.13,1
16330,1860,1000.00,12000.00,13000.00,0.00,12000.00,0.17,1
16331,1860,1000.00,13000.00,14000.00,0.00,13000.00,0.10,1
16332,1860,1000.00,14000.00,15000.00,0.00,10963.29,0.40,1
16333,1860,1000.00,15000.00,16000.00,0.00,15000.00,0.38,1
16334,1860,1000.00,16000.00,17000.00,0.00,15461.45,0.34,1
16335,1860,1000.00,17000.00,18000.00,0.00,17000.00,0.08,1
16336,1860,1000.00,18000.00,19000.00,7012.25,10987.75,0.29,1
16337,1860,1000.00,19000.00,20000.00,0.00,19000.00,0.05,1
16338,1860,1000.00,20000.00,21000.00,0.00,11926.67,0.18,1
16339,1860,1000.00,21000.00,22000.00,5367.60,15632.40,0.36,1
16340,1860,1000.00,22000.00,23000.00,11000.00,11000.00,0.06,1
16341,1860,1000.00,23000.00,24000.00,5382.29,17617.71,0.05,1
16342,1860,-1000.00,22000.00,23000.00,9540.69,0.00,0.01,0
16343,1860,1000.00,23000.00,24000.00,0.00,8301.10,0.11,1
16344,1860,-1000.00,22000.00,23000.00,10077.04,7021.91,0.21,0
16345,1860,-1000.00,21000.00,22000.00,9767.06,1186.84,0.10,0
16346,1860,-1000.00,20000.00,21000.00,13673.83,8326.17,0.03,0
16347,1860,1000.00,21000.00,22000.00,362.76,20637.24,0.39,1
16348,1860,1000.00,22000.00,23000.00,0.00,22000.00,0.36,1
16349,1860,1000.00,23000.00,24000.00,0.00,1655.02,0.07,1
16350,1860,1000.00,24000.00,25000.00,10949.93,13050.07,0.17,1
16351,1860,-1000.00,23000.00,24000.00,15184.53,8036.10,0.14,0
16352,1860,1000.00,24000.00,25000.00,0.00,24000.00,0.39,1
16353,1860,1000.00,25000.00,26000.00,8086.52,16913.48,0.35,1
16354,1860,1000.00,26000.00,27000.00,11179.93,14820.07,0.16,1
16355,1860,1000.00,27000.00,28000.00,0.00,27000.00,0.11,1
16356,1860,-1000.00,26000.00,27000.00,19369.36,8630.64,0.15,0
16357,1860,1000.00,27000.00,28000.00,0.00,14025.62,0.30,1
16358,1860,1000.00,28000.00,29000.00,0.00,9971.56,0.25,1
16359,1860,1000.00,29000.00,30000.00,0.00,29000.00,0.29,1
16360,1860,1000.00,30000.00,31000.00,4887.13,25112.87,0.43,1
16361,1860,1000.00,31000.00,32000.00,2242.01,28757.99,0.16,1
16362,1860,-1000.00,30000.00,31000.00,6099.91,25900.09,0.11,0
16363,1860,-1000.00,29000.00,30000.00,16561.80,4214.35,0.11,0
16364,1860,-1000.00,28000.00,29000.00,15000.00,15000.00,0.03,0
16365,1860,-1000.00,27000.00,28000.00,4801.32,24198.68,0.19,0
16366,1860,-1000.00,26000.00,27000.00,3628.80,24371.20,0.41,0
16367,1860,-1000.00,25000.00,26000.00,0.00,27000.00,0.17,0
16368,1860,-1000.00,24000.00,25000.00,12521.15,13478.85,0.04,0
16369,1860,-1000.00,23000.00,24000.00,0.00,23987.47,0.33,0
16370,1860,-1000.00,22000.00,23000.00,2676.44,21323.56,0.43,0
16371,1860,-1000.00,21000.00,22000.00,8144.34,14855.66,0.37,0
16372,1860,-1000.00,20000.00,21000.00,0.00,18213.09,0.33,0
16373,1860,-1000.00,19000.00,20000.00,13857.46,7142.54,0.10,0
16374,1860,-1000.00,18000.00,19000.00,7608.53,12391.47,0.16,0
16375,1860,-1000.00,17000.00,18000.00,5105.14,13894.86,0.37,0
16376,1860,-1000.00,16000.00,17000.00,5902.96,12097.04,0.21,0
16377,1860,-1000.00,15000.00,16000.00,0.00,17000.00,0.41,0
16378,1860,-1000.00,14000.00,15000.00,0.00,16000.00,0.43,0
16379,1860,-1000.00,13000.00,14000.00,0.00,15000.00,0.02,0
16380,1860,-1000.00,12000.00,13000.00,7000.00,7000.00,0.01,0
16381,1860,-1000.00,11000.00,12000.00,0.00,13000.00,0.33,0
16382,1860,-1000.00,10000.00,11000.00,8152.50,3847.50,0.01,0
16383,1860,-1000.00,9000.00,10000.00,4763.50,6236.50,0.24,0
16384,1860,-1000.00,8000.00,9000.00,7863.25,0.00,0.06,0
16385,1861,1000.00,1000.00,2000.00,0.00,1000.00,0.36,1
16386,1861,1000.00,2000.00,3000.00,200.82,1799.18,0.03,1
16387,1861,1000.00,3000.00,4000.00,574.27,1323.18,0.27,1
16388,1861,1000.00,4000.00,5000.00,1043.83,2956.17,0.30,1
16389,1861,1000.00,5000.00,6000.00,0.00,3250.26,0.14,1
16390,1861,1000.00,6000.00,7000.00,0.00,6000.00,0.41,1
16391,1861,1000.00,7000.00,8000.00,3500.00,3500.00,0.23,1
16392,1861,1000.00,8000.00,9000.00,0.00,8000.00,0.25,1
16393,1861,1000.00,9000.00,10000.00,3740.42,5259.58,0.18,1
16394,1861,1000.00,10000.00,11000.00,0.00,9706.64,0.34,1
16395,1861,1000.00,11000.00,12000.00,0.00,11000.00,0.07,1
16396,1861,1000.00,12000.00,13000.00,6000.00,6000.00,0.41,1
16397,1861,1000.00,13000.00,14000.00,0.00,13000.00,0.15,1
16398,1861,1000.00,14000.00,15000.00,0.00,14000.00,0.41,1
16399,1861,-1000.00,13000.00,14000.00,8272.46,6727.54,0.40,0
16400,1861,1000.00,14000.00,15000.00,14000.00,0.00,0.04,1
16401,1861,-1000.00,13000.00,14000.00,0.00,15000.00,0.30,0
16402,1861,1000.00,14000.00,15000.00,2726.72,0.00,0.02,1
16403,1861,-1000.00,13000.00,14000.00,7005.51,7994.49,0.12,0
16404,1861,-1000.00,12000.00,13000.00,0.00,6676.92,0.19,0
16405,1861,1000.00,13000.00,14000.00,9685.94,3264.05,0.09,1
16406,1861,1000.00,14000.00,15000.00,8603.86,5396.14,0.26,1
16407,1861,-1000.00,13000.00,14000.00,0.00,4057.92,0.06,0
16408,1861,-1000.00,12000.00,13000.00,6139.21,7860.79,0.28,0
16409,1861,-1000.00,11000.00,12000.00,5053.40,7946.60,0.42,0
16410,1861,-1000.00,10000.00,11000.00,1735.70,6245.53,0.31,0
16411,1861,-1000.00,9000.00,10000.00,3055.27,7944.73,0.24,0
16412,1861,-1000.00,8000.00,9000.00,5000.00,5000.00,0.15,0
16413,1861,-1000.00,7000.00,8000.00,0.00,9000.00,0.35,0
16414,1861,-1000.00,6000.00,7000.00,3307.09,4692.91,0.30,0
16415,1861,-1000.00,5000.00,6000.00,2754.82,4245.18,0.24,0
16416,1861,-1000.00,4000.00,5000.00,0.00,6000.00,0.05,0
16417,1861,1000.00,5000.00,6000.00,2635.41,380.12,0.10,1
16418,1861,-1000.00,4000.00,5000.00,0.00,6000.00,0.20,0
16419,1861,-1000.00,3000.00,4000.00,2500.00,2500.00,0.05,0
16420,1861,-1000.00,2000.00,3000.00,448.32,3551.68,0.42,0
16421,1861,-1000.00,1000.00,2000.00,934.24,2065.76,0.20,0
16422,1861,1000.00,2000.00,3000.00,883.81,0.00,0.04,1
16423,1861,1000.00,3000.00,4000.00,0.00,3000.00,0.22,1
16424,1861,1000.00,4000.00,5000.00,10.53,2861.42,0.40,1
16425,1861,-954.69,3045.31,4045.31,954.69,0.00,0.06,0
16426,1861,1000.00,4045.31,5045.31,2022.66,2022.66,0.05,1
16427,1861,-1000.00,3045.31,4045.31,3638.64,0.00,0.05,0
16428,1861,1000.00,4045.31,5045.31,0.00,4045.31,0.19,1
16429,1861,-1000.00,3045.31,4045.31,3548.83,1496.48,0.28,0
16430,1861,1000.00,4045.31,5045.31,976.68,3068.63,0.13,1
16431,1861,1000.00,5045.31,6045.31,1999.14,3046.17,0.37,1
16432,1861,1000.00,6045.31,7045.31,0.00,6045.31,0.44,1
16433,1861,-1000.00,5045.31,6045.31,3725.33,3319.99,0.30,0
16434,1861,1000.00,6045.31,7045.31,2796.84,2833.11,0.23,1
16435,1861,1000.00,7045.31,8045.31,2444.59,4600.72,0.24,1
16436,1861,-1000.00,6045.31,7045.31,4571.36,3473.96,0.15,0
16437,1861,1000.00,7045.31,8045.31,2976.40,4068.92,0.36,1
16438,1861,1000.00,8045.31,9045.31,2152.86,5892.45,0.22,1
16439,1861,-1000.00,7045.31,8045.31,6445.70,1122.76,0.14,0
16440,1861,1000.00,8045.31,9045.31,2660.86,4035.61,0.30,1
16441,1862,-1000.00,-1000.00,0.00,500.00,500.00,0.07,0
16442,1863,-1000.00,-1000.00,0.00,508.42,491.58,0.02,0
16443,1864,-1000.00,-1000.00,0.00,0.00,407.35,0.23,0
16444,1865,-987.11,-987.11,12.89,414.41,572.70,0.27,0
16445,1865,-10.76,-997.87,2.13,0.00,10.76,0.41,0
16446,1865,-91.70,-1089.57,-89.57,0.52,0.00,0.05,0
16447,1866,1000.00,1000.00,2000.00,54.65,803.23,0.42,1
16448,1866,1000.00,2000.00,3000.00,806.28,1193.72,0.03,1
16449,1866,1000.00,3000.00,4000.00,0.00,722.03,0.20,1
16450,1866,1000.00,4000.00,5000.00,1474.11,2525.89,0.30,1
16451,1866,1000.00,5000.00,6000.00,2070.62,2929.38,0.37,1
16452,1866,1000.00,6000.00,7000.00,0.00,700.10,0.14,1
16453,1866,-1000.00,5000.00,6000.00,4604.11,2395.89,0.12,0
16454,1866,1000.00,6000.00,7000.00,0.00,6000.00,0.37,1
16455,1866,1000.00,7000.00,8000.00,0.00,7000.00,0.10,1
16456,1866,1000.00,8000.00,9000.00,0.00,3903.05,0.19,1
16457,1866,1000.00,9000.00,10000.00,3829.23,5170.77,0.41,1
16458,1866,1000.00,10000.00,11000.00,1562.01,8437.99,0.34,1
16459,1866,-1000.00,9000.00,10000.00,8843.04,2156.96,0.20,0
16460,1866,1000.00,10000.00,11000.00,0.00,6782.12,0.19,1
16461,1866,1000.00,11000.00,12000.00,0.00,11000.00,0.10,1
16462,1866,1000.00,12000.00,13000.00,0.00,12000.00,0.33,1
16463,1866,1000.00,13000.00,14000.00,2834.06,10165.94,0.38,1
16464,1866,1000.00,14000.00,15000.00,0.00,14000.00,0.02,1
16465,1866,-1000.00,13000.00,14000.00,9322.01,5677.99,0.14,0
16466,1866,1000.00,14000.00,15000.00,0.00,5688.39,0.17,1
16467,1866,-1000.00,13000.00,14000.00,7895.53,7104.47,0.23,0
16468,1866,-1000.00,12000.00,13000.00,0.00,13323.36,0.30,0
16469,1866,-1000.00,11000.00,12000.00,3682.76,9317.24,0.34,0
16470,1866,-1000.00,10000.00,11000.00,9162.36,2837.64,0.02,0
16471,1866,-1000.00,9000.00,10000.00,0.00,8987.95,0.33,0
16472,1866,-1000.00,8000.00,9000.00,2931.65,6521.90,0.34,0
16473,1866,-1000.00,7000.00,8000.00,3894.13,5105.87,0.19,0
16474,1866,-1000.00,6000.00,7000.00,4000.00,4000.00,0.07,0
16475,1866,-1000.00,5000.00,6000.00,1821.77,5178.23,0.27,0
16476,1866,-1000.00,4000.00,5000.00,0.00,6000.00,0.35,0
16477,1866,-1000.00,3000.00,4000.00,2240.82,2759.18,0.40,0
16478,1866,-1000.00,2000.00,3000.00,1962.40,2037.60,0.12,0
16479,1866,-1000.00,1000.00,2000.00,0.00,3000.00,0.24,0
16480,1866,-1000.00,0.00,1000.00,0.00,1437.95,0.13,0
16481,1866,-198.02,-198.02,801.98,0.00,198.02,0.10,0
16482,1866,0.00,-198.02,801.98,0.00,0.00,0.00,0
16483,1866,-801.98,-1000.00,0.00,400.99,400.99,0.04,0
16484,1867,-1000.00,-1000.00,0.00,22.09,510.53,0.32,0
16485,1868,-1000.00,-1000.00,0.00,0.00,1000.00,0.28,0
16486,1869,-883.82,-883.82,116.18,0.00,883.82,0.24,0
16487,1869,-116.18,-1000.00,0.00,58.09,58.09,0.03,0
16488,1870,-1000.00,-1000.00,0.00,0.00,1000.00,0.12,0
16489,1871,-835.87,-835.87,164.13,0.00,835.87,0.42,0
16490,1871,0.00,-835.87,164.13,0.00,0.00,0.04,0
16491,1871,1000.00,164.13,1164.13,82.76,81.37,0.25,1
16492,1871,0.00,164.13,1164.13,0.00,0.00,0.11,0
16493,1871,1000.00,1164.13,2164.13,1122.56,0.00,0.01,1
16494,1871,0.00,1164.13,2164.13,0.00,0.00,0.00,0
16495,1871,-1000.00,164.13,1164.13,0.00,2164.13,0.21,0
16496,1871,-1000.00,-835.87,164.13,320.32,843.81,0.33,0
16497,1871,-65.80,-901.67,98.33,0.00,65.80,0.30,0
16498,1871,-98.33,-1000.00,0.00,0.28,98.05,0.21,0
16499,1872,1000.00,1000.00,2000.00,448.92,551.08,0.16,1
16500,1872,1000.00,2000.00,3000.00,850.85,1149.15,0.24,1
16501,1872,1000.00,3000.00,4000.00,0.00,3000.00,0.36,1
16502,1872,-1000.00,2000.00,3000.00,2622.44,0.00,0.04,0
16503,1872,1000.00,3000.00,4000.00,1009.24,1990.76,0.27,1
16504,1872,-1000.00,2000.00,3000.00,2346.40,1653.60,0.33,0
16505,1872,-1000.00,1000.00,2000.00,1648.97,1351.03,0.16,0
16506,1872,1000.00,2000.00,3000.00,608.43,1391.57,0.17,1
16507,1872,1000.00,3000.00,4000.00,886.13,2113.87,0.34,1
16508,1872,1000.00,4000.00,5000.00,0.00,3153.49,0.26,1
16509,1872,1000.00,5000.00,6000.00,2247.10,2752.90,0.33,1
16510,1872,-1000.00,4000.00,5000.00,3405.31,2594.69,0.14,0
16511,1872,1000.00,5000.00,6000.00,0.00,5000.00,0.23,1
16512,1872,1000.00,6000.00,7000.00,2204.71,3795.29,0.22,1
16513,1872,1000.00,7000.00,8000.00,0.00,7000.00,0.00,1
16514,1872,1000.00,8000.00,9000.00,2713.21,5286.79,0.26,1
16515,1872,1000.00,9000.00,10000.00,0.00,5279.29,0.03,1
16516,1872,1000.00,10000.00,11000.00,3373.16,6626.84,0.18,1
16517,1872,1000.00,11000.00,12000.00,752.72,10247.28,0.44,1
16518,1872,1000.00,12000.00,13000.00,0.00,10721.16,0.32,1
16519,1872,1000.00,13000.00,14000.00,4816.04,8183.96,0.27,1
16520,1872,-1000.00,12000.00,13000.00,8814.31,5185.69,0.28,0
16521,1872,-1000.00,11000.00,12000.00,7878.86,5121.14,0.08,0
16522,1872,-1000.00,10000.00,11000.00,5160.41,6839.59,0.20,0
16523,1872,-1000.00,9000.00,10000.00,5801.70,0.00,0.06,0
16524,1872,-1000.00,8000.00,9000.00,3290.00,6710.00,0.34,0
16525,1872,-1000.00,7000.00,8000.00,4500.00,4500.00,0.04,0
16526,1872,0.00,7000.00,8000.00,0.00,0.00,0.11,0
16527,1872,-1000.00,6000.00,7000.00,0.00,7958.85,0.44,0
16528,1872,-1000.00,5000.00,6000.00,0.00,3973.11,0.03,0
16529,1872,-1000.00,4000.00,5000.00,621.75,5378.25,0.38,0
16530,1872,-1000.00,3000.00,4000.00,2233.72,1557.37,0.17,0
16531,1872,-1000.00,2000.00,3000.00,0.00,4000.00,0.39,0
16532,1872,-1000.00,1000.00,2000.00,659.06,2340.94,0.40,0
16533,1872,-1000.00,0.00,1000.00,262.79,1737.21,0.42,0
16534,1872,-1000.00,-1000.00,0.00,397.06,602.94,0.40,0
16535,1873,-1000.00,-1000.00,0.00,0.00,1000.00,0.10,0
16536,1874,1000.00,1000.00,2000.00,500.00,500.00,0.03,1
16537,1874,1000.00,2000.00,3000.00,429.43,558.40,0.21,1
16538,1874,1000.00,3000.00,4000.00,800.87,2199.13,0.36,1
16539,1874,1000.00,4000.00,5000.00,1281.84,2718.16,0.33,1
16540,1874,1000.00,5000.00,6000.00,0.00,1607.75,0.22,1
16541,1874,-1000.00,4000.00,5000.00,3346.17,2653.83,0.11,0
16542,1874,1000.00,5000.00,6000.00,0.00,5000.00,0.22,1
16543,1874,1000.00,6000.00,7000.00,2957.27,3042.73,0.15,1
16544,1874,1000.00,7000.00,8000.00,0.00,5044.38,0.35,1
16545,1874,1000.00,8000.00,9000.00,0.00,8000.00,0.11,1
16546,1874,1000.00,9000.00,10000.00,2016.85,6983.15,0.43,1
16547,1874,1000.00,10000.00,11000.00,4073.28,5926.72,0.44,1
16548,1874,-1000.00,9000.00,10000.00,5075.97,5924.03,0.44,0
16549,1874,-1000.00,8000.00,9000.00,806.52,9193.48,0.38,0
16550,1874,-1000.00,7000.00,8000.00,0.00,9000.00,0.27,0
16551,1874,-1000.00,6000.00,7000.00,5570.76,2429.24,0.23,0
16552,1874,-1000.00,5000.00,6000.00,0.00,7000.00,0.27,0
16553,1874,-1000.00,4000.00,5000.00,4274.80,1488.89,0.15,0
16554,1874,-1000.00,3000.00,4000.00,0.00,5000.00,0.13,0
16555,1874,-1000.00,2000.00,3000.00,2000.00,2000.00,0.08,0
16556,1874,-1000.00,1000.00,2000.00,0.00,2361.73,0.17,0
16557,1874,-1000.00,0.00,1000.00,1251.65,748.35,0.34,0
16558,1874,-1000.00,-1000.00,0.00,0.00,1000.00,0.07,0
16559,1875,-1000.00,-1000.00,0.00,0.00,1000.00,0.39,0
16560,1876,-1000.00,-1000.00,0.00,303.21,696.79,0.34,0
16561,1877,-1000.00,-1000.00,0.00,444.51,555.49,0.18,0
16562,1878,-1000.00,-1000.00,0.00,71.58,928.42,0.35,0
16563,1879,-1000.00,-1000.00,0.00,0.00,780.70,0.28,0
16564,1880,-1000.00,-1000.00,0.00,354.93,645.07,0.37,0
16565,1881,-1000.00,-1000.00,0.00,0.00,1000.00,0.23,0
16566,1882,-1000.00,-1000.00,0.00,0.00,1000.00,0.06,0
16567,1883,0.00,0.00,1000.00,0.00,0.00,0.16,0
16568,1883,1000.00,1000.00,2000.00,934.87,0.00,0.12,1
16569,1883,1000.00,2000.00,3000.00,917.92,588.90,0.32,1
16570,1883,-531.70,1468.30,2468.30,0.00,531.70,0.23,0
16571,1883,1000.00,2468.30,3468.30,46.76,0.00,0.37,1
16572,1883,-1000.00,1468.30,2468.30,1582.10,1886.20,0.02,0
16573,1883,-730.51,737.79,1737.79,0.00,730.51,0.42,0
16574,1883,-1000.00,-262.21,737.79,852.79,885.00,0.04,0
16575,1883,-415.37,-677.58,322.42,60.22,355.15,0.43,0
16576,1883,0.00,-677.58,322.42,0.00,0.00,0.10,0
16577,1883,1000.00,322.42,1322.42,47.67,0.00,0.43,1
16578,1883,0.00,322.42,1322.42,0.00,0.00,0.11,0
16579,1883,-1000.00,-677.58,322.42,573.02,749.40,0.06,0
16580,1883,-322.42,-1000.00,0.00,0.00,322.42,0.20,0
16581,1884,-691.86,-691.86,308.14,11.34,680.52,0.41,0
16582,1884,-196.70,-888.55,111.45,0.00,196.70,0.18,0
16583,1884,1000.00,111.45,1111.45,82.22,29.22,0.12,1
16584,1884,-241.59,-130.15,869.85,0.00,241.59,0.33,0
16585,1884,0.00,-130.15,869.85,0.00,0.00,0.01,0
16586,1884,-869.85,-1000.00,-0.00,424.47,445.38,0.23,0
16587,1885,-1000.00,-1000.00,0.00,0.00,1000.00,0.11,0
16588,1886,-1000.00,-1000.00,0.00,0.00,1000.00,0.17,0
16589,1887,-1000.00,-1000.00,0.00,348.28,651.72,0.32,0
16590,1888,-1000.00,-1000.00,0.00,468.93,531.07,0.14,0
16591,1889,-1000.00,-1000.00,0.00,0.00,1000.00,0.26,0
16592,1890,1000.00,1000.00,2000.00,0.00,475.53,0.28,1
16593,1890,1000.00,2000.00,3000.00,0.00,567.36,0.15,1
16594,1890,1000.00,3000.00,4000.00,0.00,3000.00,0.19,1
16595,1890,-1000.00,2000.00,3000.00,2194.88,1805.12,0.01,0
16596,1890,1000.00,3000.00,4000.00,0.00,1980.77,0.33,1
16597,1890,1000.00,4000.00,5000.00,0.00,4000.00,0.19,1
16598,1890,1000.00,5000.00,6000.00,0.00,4029.30,0.08,1
16599,1890,1000.00,6000.00,7000.00,0.00,6000.00,0.09,1
16600,1890,1000.00,7000.00,8000.00,1331.35,5668.65,0.39,1
16601,1890,1000.00,8000.00,9000.00,0.00,8000.00,0.40,1
16602,1890,1000.00,9000.00,10000.00,0.00,5949.50,0.32,1
16603,1890,1000.00,10000.00,11000.00,3815.28,6184.72,0.25,1
16604,1890,1000.00,11000.00,12000.00,3637.74,7362.26,0.20,1
16605,1890,-1000.00,10000.00,11000.00,8294.36,3705.64,0.04,0
16606,1890,1000.00,11000.00,12000.00,0.00,5566.79,0.06,1
16607,1890,1000.00,12000.00,13000.00,0.00,12000.00,0.39,1
16608,1890,0.00,12000.00,13000.00,0.00,0.00,0.08,0
16609,1890,1000.00,13000.00,14000.00,0.00,10703.97,0.29,1
16610,1890,1000.00,14000.00,15000.00,0.00,14000.00,0.08,1
16611,1890,1000.00,15000.00,16000.00,0.00,15000.00,0.30,1
16612,1890,1000.00,16000.00,17000.00,1430.95,14569.05,0.31,1
16613,1890,1000.00,17000.00,18000.00,8500.00,8500.00,0.34,1
16614,1890,1000.00,18000.00,19000.00,0.00,15568.23,0.22,1
16615,1890,1000.00,19000.00,20000.00,7386.19,11613.81,0.24,1
16616,1890,0.00,19000.00,20000.00,0.00,0.00,0.01,0
16617,1890,1000.00,20000.00,21000.00,9077.11,10922.89,0.43,1
16618,1890,1000.00,21000.00,22000.00,0.00,21000.00,0.34,1
16619,1890,-1000.00,20000.00,21000.00,9142.73,4678.32,0.15,0
16620,1890,1000.00,21000.00,22000.00,0.00,21000.00,0.24,1
16621,1890,1000.00,22000.00,23000.00,7500.09,14499.91,0.16,1
16622,1890,1000.00,23000.00,24000.00,0.00,8157.19,0.10,1
16623,1890,-1000.00,22000.00,23000.00,7981.67,0.00,0.00,0
16624,1890,1000.00,23000.00,24000.00,0.00,23000.00,0.06,1
16625,1890,-1000.00,22000.00,23000.00,8946.81,6601.15,0.19,0
16626,1890,1000.00,23000.00,24000.00,7001.81,15998.19,0.29,1
16627,1890,1000.00,24000.00,25000.00,5856.91,18143.09,0.00,1
16628,1890,1000.00,25000.00,26000.00,0.00,25000.00,0.22,1
16629,1890,1000.00,26000.00,27000.00,0.00,17310.23,0.16,1
16630,1890,1000.00,27000.00,28000.00,10452.80,16547.20,0.21,1
16631,1890,1000.00,28000.00,29000.00,0.00,24096.20,0.05,1
16632,1890,1000.00,29000.00,30000.00,14500.00,14500.00,0.00,1
16633,1890,1000.00,30000.00,31000.00,0.00,30000.00,0.37,1
16634,1890,1000.00,31000.00,32000.00,0.00,16847.46,0.21,1
16635,1890,1000.00,32000.00,33000.00,4093.39,27906.61,0.41,1
16636,1890,1000.00,33000.00,34000.00,3757.11,29242.89,0.17,1
16637,1890,1000.00,34000.00,35000.00,3986.20,6345.69,0.15,1
16638,1890,1000.00,35000.00,36000.00,2472.64,12431.82,0.25,1
16639,1890,1000.00,36000.00,37000.00,0.00,36000.00,0.01,1
16640,1890,1000.00,37000.00,38000.00,8579.13,28420.87,0.39,1
16641,1890,0.00,37000.00,38000.00,0.00,0.00,0.10,0
16642,1890,1000.00,38000.00,39000.00,5121.60,32878.40,0.30,1
16643,1890,1000.00,39000.00,40000.00,0.00,39000.00,0.36,1
16644,1890,0.00,39000.00,40000.00,0.00,0.00,0.10,0
16645,1890,1000.00,40000.00,41000.00,0.00,40000.00,0.00,1
16646,1890,1000.00,41000.00,42000.00,18399.23,22600.77,0.21,1
16647,1890,1000.00,42000.00,43000.00,0.00,5641.23,0.12,1
16648,1890,-1000.00,41000.00,42000.00,9511.90,8229.70,0.18,0
16649,1890,1000.00,42000.00,43000.00,3488.94,38511.06,0.39,1
16650,1890,0.00,42000.00,43000.00,0.00,0.00,0.01,0
16651,1890,1000.00,43000.00,44000.00,0.00,32861.63,0.21,1
16652,1890,1000.00,44000.00,45000.00,8936.83,35063.17,0.30,1
16653,1890,-1000.00,43000.00,44000.00,22758.51,22241.49,0.16,0
16654,1890,1000.00,44000.00,45000.00,3914.38,4674.05,0.15,1
16655,1890,1000.00,45000.00,46000.00,20479.67,24520.33,0.24,1
16656,1890,1000.00,46000.00,47000.00,16790.99,29209.01,0.29,1
16657,1890,1000.00,47000.00,48000.00,0.00,47000.00,0.40,1
16658,1890,1000.00,48000.00,49000.00,0.00,33873.14,0.31,1
16659,1890,1000.00,49000.00,50000.00,0.00,49000.00,0.31,1
16660,1890,1000.00,50000.00,51000.00,0.00,32715.20,0.37,1
16661,1891,-1000.00,-1000.00,0.00,1000.00,0.00,0.02,0
16662,1892,-1000.00,-1000.00,0.00,529.15,470.85,0.12,0
16663,1893,-826.60,-826.60,173.40,0.00,826.60,0.42,0
16664,1893,-173.40,-1000.00,0.00,0.00,173.40,0.32,0
16665,1894,-52.12,-52.12,947.88,0.00,52.12,0.11,0
16666,1894,-947.88,-1000.00,0.00,172.17,775.71,0.30,0
16667,1895,-997.84,-997.84,2.16,0.00,997.84,0.15,0
16668,1895,-2.16,-1000.00,0.00,0.15,2.02,0.41,0
16669,1896,-580.47,-580.47,419.53,398.79,181.69,0.14,0
16670,1896,1000.00,419.53,1419.53,0.00,419.53,0.05,1
16671,1896,1000.00,1419.53,2419.53,0.00,304.05,0.18,1
16672,1896,1000.00,2419.53,3419.53,538.15,1881.38,0.43,1
16673,1896,-1000.00,1419.53,2419.53,2498.07,921.46,0.02,0
16674,1896,1000.00,2419.53,3419.53,278.87,2140.66,0.42,1
16675,1896,1000.00,3419.53,4419.53,1409.11,2010.42,0.41,1
16676,1896,-1000.00,2419.53,3419.53,2250.38,2106.77,0.22,0
16677,1896,1000.00,3419.53,4419.53,0.00,2745.84,0.07,1
16678,1896,1000.00,4419.53,5419.53,0.00,4419.53,0.37,1
16679,1896,1000.00,5419.53,6419.53,345.34,2701.59,0.22,1
16680,1896,1000.00,6419.53,7419.53,2426.63,3992.90,0.22,1
16681,1896,1000.00,7419.53,8419.53,0.00,7419.53,0.17,1
16682,1896,1000.00,8419.53,9419.53,4042.75,4376.77,0.23,1
16683,1896,-1000.00,7419.53,8419.53,6457.72,2961.80,0.29,0
16684,1896,1000.00,8419.53,9419.53,2262.87,6156.65,0.13,1
16685,1896,1000.00,9419.53,10419.53,0.00,9419.53,0.11,1
16686,1896,1000.00,10419.53,11419.53,0.00,6876.01,0.13,1
16687,1896,1000.00,11419.53,12419.53,1287.96,10131.56,0.43,1
16688,1896,1000.00,12419.53,13419.53,1329.93,4321.54,0.25,1
16689,1896,1000.00,13419.53,14419.53,2438.94,10980.59,0.34,1
16690,1896,1000.00,14419.53,15419.53,4208.81,10210.72,0.39,1
16691,1896,1000.00,15419.53,16419.53,0.00,15419.53,0.25,1
16692,1896,1000.00,16419.53,17419.53,0.00,14208.97,0.27,1
16693,1896,-1000.00,15419.53,16419.53,0.00,17419.53,0.44,0
16694,1896,0.00,15419.53,16419.53,0.00,0.00,0.02,0
16695,1896,-1000.00,14419.53,15419.53,1960.87,4137.19,0.40,0
16696,1896,-1000.00,13419.53,14419.53,0.00,5499.19,0.23,0
16697,1896,-1000.00,12419.53,13419.53,0.00,10262.58,0.39,0
16698,1896,-1000.00,11419.53,12419.53,9624.61,3794.91,0.31,0
16699,1896,-1000.00,10419.53,11419.53,5681.15,4031.03,0.39,0
16700,1896,-1000.00,9419.53,10419.53,0.00,10768.22,0.13,0
16701,1896,-1000.00,8419.53,9419.53,0.00,4228.43,0.06,0
16702,1896,-1000.00,7419.53,8419.53,1398.02,8021.51,0.36,0
16703,1897,0.00,0.00,1000.00,0.00,0.00,0.04,0
16704,1897,-1000.00,-1000.00,0.00,0.00,1000.00,0.17,0
16705,1898,-1000.00,-1000.00,0.00,0.00,1000.00,0.31,0
16706,1899,0.00,0.00,1000.00,0.00,0.00,0.38,0
16707,1899,-936.90,-936.90,63.10,0.00,936.90,0.00,0
16708,1899,1000.00,63.10,1063.10,33.93,29.17,0.14,1
16709,1899,0.00,63.10,1063.10,0.00,0.00,0.28,0
16710,1899,1000.00,1063.10,2063.10,593.53,0.00,0.12,1
16711,1899,-1000.00,63.10,1063.10,0.00,1253.17,0.06,0
16712,1899,-1000.00,-936.90,63.10,285.84,777.27,0.06,0
16713,1899,1000.00,63.10,1063.10,60.83,0.00,0.02,1
16714,1899,1000.00,1063.10,2063.10,1063.10,0.00,0.06,1
16715,1899,1000.00,2063.10,3063.10,678.62,0.00,0.15,1
16716,1899,1000.00,3063.10,4063.10,2799.58,263.53,0.36,1
16717,1899,1000.00,4063.10,5063.10,3458.70,0.00,0.19,1
16718,1899,1000.00,5063.10,6063.10,274.13,0.00,0.38,1
16719,1899,-1000.00,4063.10,5063.10,3031.55,3031.55,0.00,0
16720,1899,1000.00,5063.10,6063.10,5063.10,0.00,0.01,1
16721,1899,1000.00,6063.10,7063.10,4178.63,1884.48,0.35,1
16722,1899,1000.00,7063.10,8063.10,637.17,0.00,0.15,1
16723,1899,-1000.00,6063.10,7063.10,0.00,3455.15,0.30,0
16724,1899,-1000.00,5063.10,6063.10,1799.85,4242.16,0.25,0
16725,1899,-1000.00,4063.10,5063.10,2728.81,2856.81,0.22,0
16726,1899,1000.00,5063.10,6063.10,1033.84,499.21,0.19,1
16727,1899,-1000.00,4063.10,5063.10,0.00,1712.30,0.37,0
16728,1899,0.00,4063.10,5063.10,0.00,0.00,0.05,0
16729,1899,-1000.00,3063.10,4063.10,0.00,3923.80,0.14,0
16730,1899,-1000.00,2063.10,3063.10,207.39,1364.28,0.29,0
16731,1899,-1000.00,1063.10,2063.10,0.00,992.94,0.35,0
16732,1899,0.00,1063.10,2063.10,0.00,0.00,0.42,0
16733,1899,-1000.00,63.10,1063.10,0.00,764.93,0.36,0
16734,1899,-1000.00,-936.90,63.10,1063.10,0.00,0.34,0
16735,1899,-63.10,-1000.00,0.00,33.49,29.61,0.14,0
16736,1900,-1000.00,-1000.00,0.00,0.00,1000.00,0.21,0
16737,1901,-1000.00,-1000.00,0.00,0.00,1000.00,0.35,0
16738,1902,-1000.00,-1000.00,0.00,319.39,680.61,0.34,0
16739,1902,-0.00,-1000.00,0.00,0.00,0.00,0.41,0
16740,1902,-0.00,-1000.00,0.00,0.00,0.00,0.41,0
16741,1903,1000.00,1000.00,2000.00,0.00,304.10,0.22,1
16742,1903,1000.00,2000.00,3000.00,259.14,1740.86,0.42,1
16743,1903,1000.00,3000.00,4000.00,0.00,2391.05,0.15,1
16744,1903,1000.00,4000.00,5000.00,0.00,4000.00,0.04,1
16745,1903,1000.00,5000.00,6000.00,0.00,5000.00,0.04,1
16746,1903,-1000.00,4000.00,5000.00,3210.95,2789.05,0.18,0
16747,1903,1000.00,5000.00,6000.00,2500.00,2500.00,0.01,1
16748,1903,1000.00,6000.00,7000.00,0.00,4355.28,0.33,1
16749,1903,1000.00,7000.00,8000.00,1314.15,5685.85,0.23,1
16750,1903,-1000.00,6000.00,7000.00,4046.92,3953.08,0.43,0
16751,1903,0.00,6000.00,7000.00,0.00,0.00,0.07,0
16752,1903,1000.00,7000.00,8000.00,2965.51,4034.49,0.44,1
16753,1903,1000.00,8000.00,9000.00,0.00,6523.56,0.33,1
16754,1903,1000.00,9000.00,10000.00,0.00,3253.04,0.18,1
16755,1903,1000.00,10000.00,11000.00,2086.83,7913.17,0.25,1
16756,1903,1000.00,11000.00,12000.00,0.00,11000.00,0.27,1
16757,1903,1000.00,12000.00,13000.00,0.00,8772.05,0.06,1
16758,1903,1000.00,13000.00,14000.00,0.00,13000.00,0.20,1
16759,1903,1000.00,14000.00,15000.00,1040.71,12959.29,0.08,1
16760,1903,1000.00,15000.00,16000.00,6765.19,8234.81,0.40,1
16761,1903,-1000.00,14000.00,15000.00,9656.32,6343.68,0.07,0
16762,1903,1000.00,15000.00,16000.00,2565.96,12434.04,0.42,1
16763,1903,1000.00,16000.00,17000.00,0.00,16000.00,0.42,1
16764,1903,1000.00,17000.00,18000.00,6177.25,10822.75,0.30,1
16765,1903,1000.00,18000.00,19000.00,0.00,7872.25,0.29,1
16766,1903,1000.00,19000.00,20000.00,9250.54,9749.46,0.01,1
16767,1903,1000.00,20000.00,21000.00,3559.73,16440.27,0.42,1
16768,1903,1000.00,21000.00,22000.00,0.00,21000.00,0.00,1
16769,1903,1000.00,22000.00,23000.00,0.00,17596.20,0.36,1
16770,1903,1000.00,23000.00,24000.00,9283.32,13716.68,0.21,1
16771,1903,1000.00,24000.00,25000.00,4842.84,19157.16,0.41,1
16772,1903,-1000.00,23000.00,24000.00,14907.45,10092.55,0.31,0
16773,1903,1000.00,24000.00,25000.00,0.00,21820.47,0.03,1
16774,1903,1000.00,25000.00,26000.00,0.00,25000.00,0.36,1
16775,1903,-1000.00,24000.00,25000.00,23685.01,2314.99,0.02,0
16776,1903,1000.00,25000.00,26000.00,0.00,11542.59,0.29,1
16777,1903,-1000.00,24000.00,25000.00,16807.03,9192.97,0.02,0
16778,1903,1000.00,25000.00,26000.00,12500.00,12500.00,0.00,1
16779,1904,-1000.00,-1000.00,0.00,500.00,500.00,0.01,0
16780,1905,-642.22,-642.22,357.78,0.00,642.22,0.26,0
16781,1905,0.00,-642.22,357.78,0.00,0.00,0.05,0
16782,1905,-255.25,-897.47,102.53,86.42,168.83,0.28,0
16783,1905,-54.88,-952.35,47.65,0.00,54.88,0.23,0
16784,1905,-47.65,-1000.00,0.00,0.33,47.32,0.40,0
16785,1905,-0.00,-1000.00,0.00,0.00,0.00,0.02,0
16786,1906,1000.00,1000.00,2000.00,350.15,640.45,0.31,1
16787,1906,1000.00,2000.00,3000.00,5.28,738.34,0.26,1
16788,1906,1000.00,3000.00,4000.00,0.00,3000.00,0.41,1
16789,1906,-1000.00,2000.00,3000.00,1196.41,1111.40,0.19,0
16790,1906,1000.00,3000.00,4000.00,0.00,2455.06,0.15,1
16791,1906,1000.00,4000.00,5000.00,2000.00,2000.00,0.04,1
16792,1906,1000.00,5000.00,6000.00,450.27,2384.28,0.30,1
16793,1906,1000.00,6000.00,7000.00,2408.96,3591.04,0.16,1
16794,1906,1000.00,7000.00,8000.00,1349.97,5650.03,0.31,1
16795,1906,1000.00,8000.00,9000.00,0.00,8000.00,0.17,1
16796,1906,1000.00,9000.00,10000.00,4386.69,4613.31,0.23,1
16797,1906,-1000.00,8000.00,9000.00,6331.05,3668.95,0.02,0
16798,1906,1000.00,9000.00,10000.00,3449.37,5550.63,0.30,1
16799,1906,1000.00,10000.00,11000.00,2640.11,6870.99,0.35,1
16800,1906,1000.00,11000.00,12000.00,2424.10,7040.26,0.35,1
16801,1906,1000.00,12000.00,13000.00,5425.29,6574.71,0.13,1
16802,1906,1000.00,13000.00,14000.00,6204.52,6795.48,0.11,1
16803,1906,1000.00,14000.00,15000.00,0.00,14000.00,0.24,1
16804,1906,1000.00,15000.00,16000.00,0.00,3772.61,0.20,1
16805,1906,1000.00,16000.00,17000.00,1271.16,4406.23,0.12,1
16806,1906,1000.00,17000.00,18000.00,2736.31,14263.69,0.42,1
16807,1906,1000.00,18000.00,19000.00,0.00,7249.34,0.26,1
16808,1906,-1000.00,17000.00,18000.00,12639.08,2094.47,0.12,0
16809,1906,-1000.00,16000.00,17000.00,7441.94,10076.87,0.26,0
16810,1906,-1000.00,15000.00,16000.00,0.00,17000.00,0.14,0
16811,1906,-1000.00,14000.00,15000.00,501.20,15498.80,0.03,0
16812,1906,-1000.00,13000.00,14000.00,0.00,15000.00,0.11,0
16813,1906,-1000.00,12000.00,13000.00,0.00,6924.09,0.30,0
16814,1906,-1000.00,11000.00,12000.00,278.08,8174.53,0.37,0
16815,1906,-1000.00,10000.00,11000.00,6000.00,6000.00,0.03,0
16816,1906,-1000.00,9000.00,10000.00,2817.91,8182.09,0.37,0
16817,1906,-1000.00,8000.00,9000.00,0.00,10000.00,0.09,0
16818,1906,-1000.00,7000.00,8000.00,4500.00,4500.00,0.00,0
16819,1906,-1000.00,6000.00,7000.00,0.00,8000.00,0.37,0
16820,1906,-1000.00,5000.00,6000.00,0.00,7000.00,0.09,0
16821,1906,-1000.00,4000.00,5000.00,0.00,6000.00,0.39,0
16822,1906,-1000.00,3000.00,4000.00,1400.91,717.44,0.14,0
16823,1906,-1000.00,2000.00,3000.00,0.00,4000.00,0.24,0
16824,1906,-1000.00,1000.00,2000.00,1046.72,1953.28,0.26,0
16825,1906,-1000.00,0.00,1000.00,956.50,1043.50,0.12,0
16826,1906,-822.28,-822.28,177.72,358.28,464.00,0.25,0
16827,1906,-1000.00,-1822.28,-822.28,141.93,35.78,0.14,0
16828,1907,-1000.00,-1000.00,0.00,541.79,458.21,0.16,0
16829,1908,1000.00,1000.00,2000.00,0.00,299.78,0.18,1
16830,1908,1000.00,2000.00,3000.00,87.23,1491.78,0.41,1
16831,1908,0.00,2000.00,3000.00,0.00,0.00,0.07,0
16832,1908,-1000.00,1000.00,2000.00,1999.92,1000.08,0.26,0
16833,1908,1000.00,2000.00,3000.00,803.11,1196.89,0.02,1
16834,1908,1000.00,3000.00,4000.00,0.00,3000.00,0.04,1
16835,1908,1000.00,4000.00,5000.00,0.00,4000.00,0.20,1
16836,1908,1000.00,5000.00,6000.00,0.00,5000.00,0.08,1
16837,1908,1000.00,6000.00,7000.00,0.00,5679.90,0.23,1
16838,1908,-1000.00,5000.00,6000.00,3526.00,3474.00,0.07,0
16839,1908,1000.00,6000.00,7000.00,0.00,6000.00,0.03,1
16840,1908,1000.00,7000.00,8000.00,1735.24,5264.76,0.39,1
16841,1908,1000.00,8000.00,9000.00,2200.00,5800.00,0.25,1
16842,1908,1000.00,9000.00,10000.00,3227.66,5772.34,0.28,1
16843,1908,-1000.00,8000.00,9000.00,6347.21,3652.79,0.14,0
16844,1908,-1000.00,7000.00,8000.00,4617.45,4382.55,0.18,0
16845,1908,1000.00,8000.00,9000.00,1124.33,6875.67,0.38,1
16846,1908,1000.00,9000.00,10000.00,1899.90,7100.10,0.11,1
16847,1908,1000.00,10000.00,11000.00,0.00,9492.51,0.00,1
16848,1908,1000.00,11000.00,12000.00,4096.20,6903.80,0.24,1
16849,1908,1000.00,12000.00,13000.00,3927.83,8072.17,0.34,1
16850,1908,1000.00,13000.00,14000.00,0.00,1263.75,0.03,1
16851,1908,1000.00,14000.00,15000.00,5930.56,8069.44,0.27,1
16852,1908,1000.00,15000.00,16000.00,1562.44,13437.56,0.43,1
16853,1908,-1000.00,14000.00,15000.00,12348.13,0.00,0.06,0
16854,1908,-1000.00,13000.00,14000.00,0.00,5940.60,0.19,0
16855,1908,-1000.00,12000.00,13000.00,2562.51,9423.60,0.38,0
16856,1908,-1000.00,11000.00,12000.00,8616.44,2420.61,0.12,0
16857,1908,0.00,11000.00,12000.00,0.00,0.00,0.07,0
16858,1908,-1000.00,10000.00,11000.00,0.00,12000.00,0.07,0
16859,1908,-1000.00,9000.00,10000.00,6704.73,4295.27,0.23,0
16860,1908,-1000.00,8000.00,9000.00,0.00,8701.70,0.37,0
16861,1908,-1000.00,7000.00,8000.00,0.00,8438.91,0.23,0
16862,1908,-1000.00,6000.00,7000.00,3373.93,4626.07,0.16,0
16863,1908,-1000.00,5000.00,6000.00,2531.17,4468.83,0.09,0
16864,1908,-1000.00,4000.00,5000.00,0.00,6000.00,0.12,0
16865,1908,-1000.00,3000.00,4000.00,1744.63,5.99,0.10,0
16866,1908,-1000.00,2000.00,3000.00,1564.11,2435.89,0.25,0
16867,1908,-1000.00,1000.00,2000.00,3000.00,0.00,0.00,0
16868,1908,-1000.00,0.00,1000.00,0.00,2000.00,0.42,0
16869,1908,-1000.00,-1000.00,0.00,1000.00,0.00,0.08,0
16870,1909,-1000.00,-1000.00,0.00,108.10,891.90,0.43,0
16871,1910,-975.84,-975.84,24.16,136.30,839.54,0.42,0
16872,1910,-24.16,-1000.00,0.00,0.00,24.16,0.12,0
16873,1911,-454.19,-454.19,545.81,0.00,454.19,0.21,0
16874,1911,-492.23,-946.42,53.58,0.00,492.23,0.42,0
16875,1911,-53.58,-1000.00,0.00,5.04,48.54,0.44,0
16876,1912,1000.00,1000.00,2000.00,44.91,955.09,0.40,1
16877,1912,1000.00,2000.00,3000.00,654.15,1345.85,0.31,1
16878,1912,1000.00,3000.00,4000.00,930.60,2069.40,0.36,1
16879,1912,1000.00,4000.00,5000.00,0.00,4000.00,0.14,1
16880,1912,1000.00,5000.00,6000.00,0.00,2112.75,0.04,1
16881,1912,1000.00,6000.00,7000.00,1030.23,4969.77,0.42,1
16882,1912,1000.00,7000.00,8000.00,488.78,6511.22,0.41,1
16883,1912,1000.00,8000.00,9000.00,0.00,8000.00,0.16,1
16884,1912,1000.00,9000.00,10000.00,0.00,6626.24,0.38,1
16885,1912,1000.00,10000.00,11000.00,922.68,9077.32,0.42,1
16886,1912,1000.00,11000.00,12000.00,0.00,8204.26,0.27,1
16887,1912,1000.00,12000.00,13000.00,5775.60,6224.40,0.13,1
16888,1912,1000.00,13000.00,14000.00,0.00,13000.00,0.13,1
16889,1912,1000.00,14000.00,15000.00,2106.65,7910.19,0.33,1
16890,1912,1000.00,15000.00,16000.00,7500.00,7500.00,0.03,1
16891,1912,1000.00,16000.00,17000.00,4861.50,11138.50,0.25,1
16892,1912,-1000.00,15000.00,16000.00,5918.58,4385.81,0.17,0
16893,1912,-1000.00,14000.00,15000.00,7693.16,8306.84,0.39,0
16894,1912,-1000.00,13000.00,14000.00,0.00,15000.00,0.31,0
16895,1912,-1000.00,12000.00,13000.00,4898.13,9101.87,0.26,0
16896,1912,-1000.00,11000.00,12000.00,0.00,10116.23,0.35,0
16897,1912,-1000.00,10000.00,11000.00,7132.07,4867.93,0.16,0
16898,1912,-1000.00,9000.00,10000.00,0.00,7897.56,0.12,0
16899,1912,-1000.00,8000.00,9000.00,4569.08,4351.74,0.21,0
16900,1912,-1000.00,7000.00,8000.00,2067.35,0.00,0.05,0
16901,1912,-1000.00,6000.00,7000.00,0.00,6795.88,0.16,0
16902,1912,-1000.00,5000.00,6000.00,0.00,7000.00,0.20,0
16903,1912,-1000.00,4000.00,5000.00,0.00,3582.61,0.31,0
16904,1912,-1000.00,3000.00,4000.00,3278.16,1721.84,0.08,0
16905,1912,-1000.00,2000.00,3000.00,0.00,1403.80,0.24,0
16906,1912,-1000.00,1000.00,2000.00,0.00,2306.10,0.41,0
16907,1912,-1000.00,0.00,1000.00,0.00,1203.68,0.13,0
16908,1912,-1000.00,-1000.00,0.00,305.54,694.46,0.18,0
16909,1913,-1000.00,-1000.00,0.00,0.00,1000.00,0.38,0
16910,1914,-714.31,-714.31,285.69,0.00,714.31,0.03,0
16911,1914,-285.69,-1000.00,0.00,43.81,241.88,0.42,0
16912,1915,0.00,0.00,1000.00,0.00,0.00,0.01,0
16913,1915,-1000.00,-1000.00,0.00,66.26,933.74,0.13,0
16914,1916,-1000.00,-1000.00,0.00,733.05,266.95,0.03,0
16915,1917,1000.00,1000.00,2000.00,503.48,0.00,0.26,1
16916,1917,-1000.00,0.00,1000.00,361.42,1638.58,0.12,0
16917,1917,1000.00,1000.00,2000.00,182.04,144.52,0.41,1
16918,1917,0.00,1000.00,2000.00,0.00,0.00,0.07,0
16919,1917,-200.20,799.80,1799.80,0.00,200.20,0.44,0
16920,1917,-749.64,50.16,1050.16,263.48,486.16,0.39,0
16921,1917,1000.00,1050.16,2050.16,944.42,0.00,0.13,1
16922,1917,1000.00,2050.16,3050.16,1040.47,558.74,0.33,1
16923,1917,1000.00,3050.16,4050.16,1914.84,1135.32,0.15,1
16924,1917,0.00,3050.16,4050.16,0.00,0.00,0.24,0
16925,1917,-1000.00,2050.16,3050.16,0.00,4050.16,0.02,0
16926,1917,0.00,2050.16,3050.16,0.00,0.00,0.44,0
16927,1917,0.00,2050.16,3050.16,0.00,0.00,0.08,0
16928,1917,0.00,2050.16,3050.16,0.00,0.00,0.38,0
16929,1917,-1000.00,1050.16,2050.16,777.47,2272.69,0.06,0
16930,1917,1000.00,2050.16,3050.16,296.20,154.35,0.43,1
16931,1917,1000.00,3050.16,4050.16,1147.41,0.00,0.33,1
16932,1917,0.00,3050.16,4050.16,0.00,0.00,0.17,0
16933,1917,1000.00,4050.16,5050.16,411.40,140.30,0.44,1
16934,1917,1000.00,5050.16,6050.16,4251.66,0.00,0.02,1
16935,1917,1000.00,6050.16,7050.16,6050.16,0.00,0.18,1
16936,1917,-1000.00,5050.16,6050.16,2710.96,4339.21,0.10,0
16937,1917,1000.00,6050.16,7050.16,5828.15,222.01,0.21,1
16938,1917,-1000.00,5050.16,6050.16,0.00,4549.28,0.01,0
16939,1917,1000.00,6050.16,7050.16,787.78,0.00,0.35,1
16940,1917,-1000.00,5050.16,6050.16,1607.28,5001.82,0.23,0
16941,1917,1000.00,6050.16,7050.16,2988.84,2059.18,0.29,1
16942,1917,-1000.00,5050.16,6050.16,579.22,5801.90,0.18,0
16943,1917,1000.00,6050.16,7050.16,1255.07,0.00,0.40,1
16944,1917,0.00,6050.16,7050.16,0.00,0.00,0.33,0
16945,1917,-471.45,5578.71,6578.71,0.00,471.45,0.05,0
16946,1917,0.00,5578.71,6578.71,0.00,0.00,0.17,0
16947,1918,1000.00,1000.00,2000.00,62.41,937.59,0.18,1
16948,1918,-1000.00,0.00,1000.00,1054.05,945.95,0.07,0
16949,1918,1000.00,1000.00,2000.00,0.00,1000.00,0.14,1
16950,1918,-1000.00,0.00,1000.00,818.05,646.01,0.19,0
16951,1918,1000.00,1000.00,2000.00,75.28,924.72,0.34,1
16952,1918,1000.00,2000.00,3000.00,0.00,2000.00,0.15,1
16953,1918,1000.00,3000.00,4000.00,707.01,2292.99,0.39,1
16954,1918,1000.00,4000.00,5000.00,0.00,4000.00,0.04,1
16955,1918,1000.00,5000.00,6000.00,0.00,4862.42,0.34,1
16956,1918,1000.00,6000.00,7000.00,1069.26,4930.74,0.41,1
16957,1918,1000.00,7000.00,8000.00,495.08,6162.43,0.43,1
16958,1918,1000.00,8000.00,9000.00,0.00,5868.61,0.15,1
16959,1918,1000.00,9000.00,10000.00,2599.36,6400.64,0.37,1
16960,1918,1000.00,10000.00,11000.00,2946.38,7053.62,0.34,1
16961,1918,1000.00,11000.00,12000.00,3336.39,7663.61,0.37,1
16962,1918,1000.00,12000.00,13000.00,3701.86,8298.14,0.35,1
16963,1918,1000.00,13000.00,14000.00,828.58,12171.42,0.21,1
16964,1918,-1000.00,12000.00,13000.00,5529.61,2472.12,0.14,0
16965,1918,1000.00,13000.00,14000.00,0.00,13000.00,0.25,1
16966,1918,-1000.00,12000.00,13000.00,8924.79,5075.21,0.14,0
16967,1918,1000.00,13000.00,14000.00,0.00,6592.89,0.28,1
16968,1918,1000.00,14000.00,15000.00,7000.00,7000.00,0.14,1
16969,1918,1000.00,15000.00,16000.00,6625.99,8374.01,0.24,1
16970,1918,1000.00,16000.00,17000.00,0.00,16000.00,0.44,1
16971,1918,1000.00,17000.00,18000.00,6052.82,10947.18,0.29,1
16972,1918,1000.00,18000.00,19000.00,0.00,18000.00,0.32,1
16973,1918,1000.00,19000.00,20000.00,860.45,8696.64,0.30,1
16974,1918,1000.00,20000.00,21000.00,0.00,20000.00,0.36,1
16975,1918,1000.00,21000.00,22000.00,0.00,19605.56,0.15,1
16976,1918,1000.00,22000.00,23000.00,0.00,8914.51,0.17,1
16977,1918,1000.00,23000.00,24000.00,0.00,23000.00,0.37,1
16978,1918,1000.00,24000.00,25000.00,11657.08,12342.92,0.21,1
16979,1918,0.00,24000.00,25000.00,0.00,0.00,0.02,0
16980,1918,-1000.00,23000.00,24000.00,14280.28,10719.72,0.23,0
16981,1918,-1000.00,22000.00,23000.00,21129.50,2870.50,0.04,0
16982,1918,1000.00,23000.00,24000.00,0.00,23000.00,0.16,1
16983,1918,-1000.00,22000.00,23000.00,12934.91,11065.09,0.35,0
16984,1918,1000.00,23000.00,24000.00,0.00,14904.82,0.01,1
16985,1918,-1000.00,22000.00,23000.00,6894.09,2007.24,0.12,0
16986,1918,1000.00,23000.00,24000.00,11500.00,11500.00,0.10,1
16987,1918,1000.00,24000.00,25000.00,8344.29,15655.71,0.28,1
16988,1918,1000.00,25000.00,26000.00,388.91,24611.09,0.31,1
16989,1918,1000.00,26000.00,27000.00,3345.08,22654.92,0.42,1
16990,1918,0.00,26000.00,27000.00,0.00,0.00,0.07,0
16991,1918,1000.00,27000.00,28000.00,0.00,27000.00,0.01,1
16992,1918,-1000.00,26000.00,27000.00,0.00,28000.00,0.02,0
16993,1918,-1000.00,25000.00,26000.00,0.00,27000.00,0.32,0
16994,1918,-1000.00,24000.00,25000.00,0.00,10209.13,0.27,0
16995,1918,-1000.00,23000.00,24000.00,1322.77,23677.23,0.11,0
16996,1918,-1000.00,22000.00,23000.00,21345.96,1961.58,0.05,0
16997,1918,-1000.00,21000.00,22000.00,0.00,23000.00,0.34,0
16998,1918,-1000.00,20000.00,21000.00,0.00,16996.02,0.03,0
16999,1918,-1000.00,19000.00,20000.00,5698.73,1752.79,0.13,0
17000,1918,-1000.00,18000.00,19000.00,4050.13,0.00,0.09,0
17001,1918,-1000.00,17000.00,18000.00,5930.20,13069.80,0.35,0
17002,1918,-1000.00,16000.00,17000.00,1119.46,16880.54,0.17,0
17003,1918,-1000.00,15000.00,16000.00,8500.00,8500.00,0.05,0
17004,1918,-1000.00,14000.00,15000.00,103.84,15896.16,0.01,0
17005,1918,-1000.00,13000.00,14000.00,0.00,5158.48,0.26,0
17006,1918,-1000.00,12000.00,13000.00,2377.34,11622.66,0.42,0
17007,1918,-1000.00,11000.00,12000.00,0.00,6249.83,0.19,0
17008,1918,-1000.00,10000.00,11000.00,3706.39,4190.13,0.23,0
17009,1918,-1000.00,9000.00,10000.00,2867.28,8132.72,0.24,0
17010,1918,-1000.00,8000.00,9000.00,3962.17,6037.83,0.23,0
17011,1919,-1000.00,-1000.00,0.00,0.00,1000.00,0.16,0
17012,1920,1000.00,1000.00,2000.00,0.00,1000.00,0.27,1
17013,1920,1000.00,2000.00,3000.00,0.00,1955.30,0.36,1
17014,1920,1000.00,3000.00,4000.00,1235.63,1764.37,0.21,1
17015,1920,1000.00,4000.00,5000.00,0.00,4000.00,0.15,1
17016,1920,1000.00,5000.00,6000.00,2427.93,2572.07,0.15,1
17017,1920,1000.00,6000.00,7000.00,2374.41,3625.59,0.32,1
17018,1920,-1000.00,5000.00,6000.00,0.00,2590.17,0.11,0
17019,1920,-1000.00,4000.00,5000.00,1184.36,4815.64,0.44,0
17020,1920,-1000.00,3000.00,4000.00,2741.72,198.22,0.08,0
17021,1920,-1000.00,2000.00,3000.00,1344.85,2655.15,0.40,0
17022,1920,-1000.00,1000.00,2000.00,0.00,3000.00,0.02,0
17023,1920,-1000.00,0.00,1000.00,712.79,1287.21,0.20,0
17024,1920,-1000.00,-1000.00,0.00,48.10,788.25,0.44,0
17025,1921,-1000.00,-1000.00,0.00,0.00,1000.00,0.40,0
17026,1922,0.00,0.00,1000.00,0.00,0.00,0.01,0
17027,1922,-554.37,-554.37,445.63,0.00,554.37,0.25,0
17028,1922,-249.97,-804.35,195.65,0.00,249.97,0.28,0
17029,1922,-195.65,-1000.00,0.00,86.58,109.08,0.20,0
17030,1923,-1000.00,-1000.00,0.00,214.90,644.86,0.35,0
17031,1924,-1000.00,-1000.00,0.00,30.86,969.14,0.35,0
17032,1925,1000.00,1000.00,2000.00,201.13,798.87,0.40,1
17033,1925,1000.00,2000.00,3000.00,0.00,1489.84,0.03,1
17034,1925,1000.00,3000.00,4000.00,1021.95,1233.26,0.23,1
17035,1925,1000.00,4000.00,5000.00,0.00,4000.00,0.42,1
17036,1925,1000.00,5000.00,6000.00,2500.00,2500.00,0.02,1
17037,1925,1000.00,6000.00,7000.00,0.00,6000.00,0.24,1
17038,1925,1000.00,7000.00,8000.00,0.00,7000.00,0.17,1
17039,1925,1000.00,8000.00,9000.00,0.00,6944.62,0.24,1
17040,1925,1000.00,9000.00,10000.00,0.00,6572.85,0.23,1
17041,1925,-1000.00,8000.00,9000.00,6579.65,3420.35,0.12,0
17042,1925,1000.00,9000.00,10000.00,710.89,6427.66,0.39,1
17043,1925,1000.00,10000.00,11000.00,4373.89,5626.11,0.35,1
17044,1925,-1000.00,9000.00,10000.00,5292.73,0.00,0.02,0
17045,1925,1000.00,10000.00,11000.00,0.00,9674.97,0.32,1
17046,1925,1000.00,11000.00,12000.00,1431.35,6814.95,0.25,1
17047,1925,1000.00,12000.00,13000.00,4730.70,7269.30,0.24,1
17048,1925,1000.00,13000.00,14000.00,0.00,13000.00,0.23,1
17049,1925,1000.00,14000.00,15000.00,4416.67,9583.33,0.27,1
17050,1925,1000.00,15000.00,16000.00,259.84,14740.16,0.31,1
17051,1925,0.00,15000.00,16000.00,0.00,0.00,0.05,0
17052,1925,1000.00,16000.00,17000.00,0.00,12671.57,0.42,1
17053,1925,-1000.00,15000.00,16000.00,11362.64,5637.36,0.30,0
17054,1925,-1000.00,14000.00,15000.00,8218.54,7781.46,0.02,0
17055,1925,1000.00,15000.00,16000.00,0.00,3231.88,0.12,1
17056,1925,1000.00,16000.00,17000.00,0.00,15617.83,0.29,1
17057,1925,-1000.00,15000.00,16000.00,15167.83,1832.17,0.06,0
17058,1925,1000.00,16000.00,17000.00,3469.22,12530.78,0.30,1
17059,1925,1000.00,17000.00,18000.00,1139.52,5571.74,0.23,1
17060,1925,1000.00,18000.00,19000.00,0.00,14456.02,0.29,1
17061,1925,1000.00,19000.00,20000.00,5163.50,11382.75,0.32,1
17062,1925,1000.00,20000.00,21000.00,6683.96,9249.66,0.25,1
17063,1925,1000.00,21000.00,22000.00,2874.59,4301.31,0.17,1
17064,1925,1000.00,22000.00,23000.00,0.00,22000.00,0.18,1
17065,1925,1000.00,23000.00,24000.00,0.00,9205.84,0.08,1
17066,1925,1000.00,24000.00,25000.00,0.00,24000.00,0.19,1
17067,1925,1000.00,25000.00,26000.00,5507.50,19492.50,0.40,1
17068,1925,1000.00,26000.00,27000.00,3972.94,22027.06,0.42,1
17069,1925,1000.00,27000.00,28000.00,0.00,27000.00,0.29,1
17070,1925,1000.00,28000.00,29000.00,0.00,9212.38,0.14,1
17071,1925,1000.00,29000.00,30000.00,9750.33,19249.67,0.09,1
17072,1925,1000.00,30000.00,31000.00,0.00,30000.00,0.08,1
17073,1925,1000.00,31000.00,32000.00,12035.98,18964.02,0.15,1
17074,1925,1000.00,32000.00,33000.00,0.00,32000.00,0.10,1
17075,1926,-1000.00,-1000.00,0.00,379.46,620.54,0.10,0
17076,1927,1000.00,1000.00,2000.00,107.52,850.19,0.42,1
17077,1927,1000.00,2000.00,3000.00,0.00,696.71,0.25,1
17078,1927,1000.00,3000.00,4000.00,224.14,2775.86,0.44,1
17079,1927,1000.00,4000.00,5000.00,717.83,3282.17,0.17,1
17080,1927,1000.00,5000.00,6000.00,0.00,5000.00,0.40,1
17081,1927,1000.00,6000.00,7000.00,786.57,5213.43,0.16,1
17082,1927,1000.00,7000.00,8000.00,0.00,1184.90,0.17,1
17083,1927,0.00,7000.00,8000.00,0.00,0.00,0.10,0
17084,1927,1000.00,8000.00,9000.00,0.00,8000.00,0.06,1
17085,1927,1000.00,9000.00,10000.00,2752.79,6247.21,0.06,1
17086,1927,1000.00,10000.00,11000.00,1265.80,8734.20,0.18,1
17087,1927,-1000.00,9000.00,10000.00,9046.37,1953.63,0.05,0
17088,1927,-1000.00,8000.00,9000.00,5145.89,4854.11,0.11,0
17089,1927,1000.00,9000.00,10000.00,1784.96,7215.04,0.38,1
17090,1927,1000.00,10000.00,11000.00,0.00,10000.00,0.24,1
17091,1927,1000.00,11000.00,12000.00,4172.99,6827.01,0.06,1
17092,1927,-1000.00,10000.00,11000.00,6749.94,5250.06,0.05,0
17093,1927,1000.00,11000.00,12000.00,0.00,11000.00,0.15,1
17094,1927,1000.00,12000.00,13000.00,5759.15,6240.85,0.15,1
17095,1927,1000.00,13000.00,14000.00,660.77,12339.23,0.30,1
17096,1927,1000.00,14000.00,15000.00,6371.77,7628.23,0.25,1
17097,1927,1000.00,15000.00,16000.00,5001.27,9998.73,0.34,1
17098,1927,-1000.00,14000.00,15000.00,3264.49,12735.51,0.31,0
17099,1927,-1000.00,13000.00,14000.00,0.00,15000.00,0.11,0
17100,1927,-1000.00,12000.00,13000.00,3199.54,4507.00,0.22,0
17101,1927,-1000.00,11000.00,12000.00,0.00,13000.00,0.36,0
17102,1927,-1000.00,10000.00,11000.00,1145.45,10854.55,0.36,0
17103,1927,-1000.00,9000.00,10000.00,5500.00,5500.00,0.06,0
17104,1927,-1000.00,8000.00,9000.00,0.00,10000.00,0.03,0
17105,1927,-1000.00,7000.00,8000.00,0.00,8995.38,0.32,0
17106,1927,-1000.00,6000.00,7000.00,4000.00,4000.00,0.03,0
17107,1927,-1000.00,5000.00,6000.00,0.00,7000.00,0.43,0
17108,1927,-1000.00,4000.00,5000.00,0.00,6000.00,0.15,0
17109,1927,-1000.00,3000.00,4000.00,2500.00,2500.00,0.00,0
17110,1927,-1000.00,2000.00,3000.00,2975.74,0.00,0.07,0
17111,1927,-1000.00,1000.00,2000.00,1920.34,1079.66,0.09,0
17112,1927,-826.30,173.70,1173.70,0.00,826.30,0.29,0
17113,1927,1000.00,1173.70,2173.70,112.91,1060.79,0.14,1
17114,1927,1000.00,2173.70,3173.70,340.52,1833.18,0.12,1
17115,1927,1000.00,3173.70,4173.70,1586.85,1586.85,0.08,1
17116,1927,1000.00,4173.70,5173.70,9.11,2960.51,0.39,1
17117,1927,1000.00,5173.70,6173.70,0.00,5173.70,0.07,1
17118,1927,1000.00,6173.70,7173.70,0.00,4624.07,0.33,1
17119,1927,1000.00,7173.70,8173.70,0.00,7173.70,0.08,1
17120,1927,1000.00,8173.70,9173.70,1727.72,6445.98,0.41,1
17121,1927,-1000.00,7173.70,8173.70,5876.12,3297.58,0.12,0
17122,1927,-1000.00,6173.70,7173.70,4801.41,3372.29,0.15,0
17123,1927,1000.00,7173.70,8173.70,3568.34,3605.36,0.22,1
17124,1927,1000.00,8173.70,9173.70,2839.85,5333.85,0.30,1
17125,1927,1000.00,9173.70,10173.70,0.00,1779.40,0.18,1
17126,1927,1000.00,10173.70,11173.70,689.62,4134.35,0.27,1
17127,1927,1000.00,11173.70,12173.70,0.00,5186.29,0.25,1
17128,1927,1000.00,12173.70,13173.70,0.00,12173.70,0.22,1
17129,1928,-1000.00,-1000.00,0.00,366.11,633.89,0.27,0
17130,1929,1000.00,1000.00,2000.00,0.00,1000.00,0.27,1
17131,1929,-1000.00,0.00,1000.00,1053.26,946.74,0.16,0
17132,1929,1000.00,1000.00,2000.00,184.61,815.39,0.37,1
17133,1929,-765.40,234.60,1234.60,431.60,333.80,0.16,0
17134,1929,1000.00,1234.60,2234.60,515.96,718.65,0.14,1
17135,1929,-1000.00,234.60,1234.60,1230.39,1004.21,0.01,0
17136,1929,-773.23,-538.62,461.38,601.03,172.20,0.15,0
17137,1929,1000.00,461.38,1461.38,90.11,271.82,0.33,1
17138,1929,1000.00,1461.38,2461.38,0.00,1006.89,0.00,1
17139,1929,1000.00,2461.38,3461.38,397.19,2064.19,0.17,1
17140,1929,1000.00,3461.38,4461.38,0.00,3461.38,0.04,1
17141,1929,1000.00,4461.38,5461.38,0.00,3420.60,0.28,1
17142,1929,1000.00,5461.38,6461.38,0.00,3141.12,0.16,1
17143,1929,1000.00,6461.38,7461.38,1609.90,2000.50,0.21,1
17144,1929,1000.00,7461.38,8461.38,0.00,5111.16,0.32,1
17145,1929,1000.00,8461.38,9461.38,181.58,7329.08,0.43,1
17146,1929,1000.00,9461.38,10461.38,0.00,7805.16,0.34,1
17147,1929,-1000.00,8461.38,9461.38,4915.24,2304.63,0.14,0
17148,1929,1000.00,9461.38,10461.38,2025.82,4706.25,0.30,1
17149,1929,1000.00,10461.38,11461.38,3956.52,6504.86,0.26,1
17150,1929,1000.00,11461.38,12461.38,0.00,5606.51,0.32,1
17151,1929,-1000.00,10461.38,11461.38,6374.25,6087.13,0.34,0
17152,1929,1000.00,11461.38,12461.38,0.00,6108.26,0.26,1
17153,1929,1000.00,12461.38,13461.38,0.00,8367.90,0.28,1
17154,1929,-1000.00,11461.38,12461.38,6730.69,6730.69,0.43,0
17155,1929,-1000.00,10461.38,11461.38,0.00,12461.38,0.17,0
17156,1929,-1000.00,9461.38,10461.38,649.44,0.00,0.07,0
17157,1929,-1000.00,8461.38,9461.38,3774.33,6687.05,0.32,0
17158,1929,-1000.00,7461.38,8461.38,0.00,9461.38,0.16,0
17159,1929,-1000.00,6461.38,7461.38,0.00,8461.38,0.37,0
17160,1929,-1000.00,5461.38,6461.38,3982.07,3479.31,0.33,0
17161,1929,-1000.00,4461.38,5461.38,4073.72,536.41,0.08,0
17162,1929,-1000.00,3461.38,4461.38,0.00,5461.38,0.38,0
17163,1929,-1000.00,2461.38,3461.38,0.00,4461.38,0.20,0
17164,1929,-1000.00,1461.38,2461.38,1142.63,2318.75,0.40,0
17165,1929,-1000.00,461.38,1461.38,0.00,2461.38,0.13,0
17166,1929,-1000.00,-538.62,461.38,0.00,1461.38,0.39,0
17167,1929,-461.38,-1000.00,0.00,0.00,461.38,0.40,0
17168,1930,-711.59,-711.59,288.41,223.05,488.54,0.29,0
17169,1930,-288.41,-1000.00,0.00,0.00,288.41,0.23,0
17170,1931,-1000.00,-1000.00,0.00,0.00,429.16,0.29,0
17171,1932,-1000.00,-1000.00,0.00,491.10,0.00,0.02,0
17172,1933,-472.46,-472.46,527.54,472.46,0.00,0.20,0
17173,1933,0.00,-472.46,527.54,0.00,0.00,0.16,0
17174,1933,-1000.00,-1472.46,-472.46,113.74,226.37,0.39,0
17175,1934,-1000.00,-1000.00,0.00,330.09,669.91,0.07,0
17176,1935,-1000.00,-1000.00,0.00,390.55,609.45,0.11,0
17177,1936,1000.00,1000.00,2000.00,0.00,160.52,0.06,1
17178,1936,1000.00,2000.00,3000.00,0.00,545.57,0.20,1
17179,1936,-1000.00,1000.00,2000.00,1184.13,196.51,0.11,0
17180,1936,-1000.00,0.00,1000.00,1497.71,502.29,0.04,0
17181,1936,1000.00,1000.00,2000.00,0.00,1000.00,0.42,1
17182,1936,1000.00,2000.00,3000.00,559.09,1440.91,0.05,1
17183,1936,1000.00,3000.00,4000.00,0.00,3000.00,0.02,1
17184,1936,1000.00,4000.00,5000.00,2000.00,2000.00,0.13,1
17185,1936,1000.00,5000.00,6000.00,2058.67,2941.33,0.25,1
17186,1936,1000.00,6000.00,7000.00,0.00,6000.00,0.40,1
17187,1936,1000.00,7000.00,8000.00,2047.67,4952.33,0.33,1
17188,1936,1000.00,8000.00,9000.00,1608.44,6391.56,0.41,1
17189,1936,1000.00,9000.00,10000.00,2476.01,6523.99,0.17,1
17190,1936,1000.00,10000.00,11000.00,2918.98,7081.02,0.07,1
17191,1936,1000.00,11000.00,12000.00,874.05,10125.95,0.39,1
17192,1936,1000.00,12000.00,13000.00,0.00,12000.00,0.26,1
17193,1936,1000.00,13000.00,14000.00,4392.38,8607.62,0.03,1
17194,1936,-1000.00,12000.00,13000.00,7388.35,6611.65,0.03,0
17195,1936,1000.00,13000.00,14000.00,5120.41,7879.59,0.31,1
17196,1936,1000.00,14000.00,15000.00,1189.61,12810.39,0.33,1
17197,1936,1000.00,15000.00,16000.00,7345.96,7654.04,0.34,1
17198,1936,1000.00,16000.00,17000.00,814.95,15185.05,0.39,1
17199,1936,-1000.00,15000.00,16000.00,8947.23,8052.77,0.25,0
17200,1936,1000.00,16000.00,17000.00,0.00,14549.12,0.37,1
17201,1936,1000.00,17000.00,18000.00,8500.00,8500.00,0.35,1
17202,1936,1000.00,18000.00,19000.00,4761.05,13238.95,0.34,1
17203,1936,1000.00,19000.00,20000.00,4800.75,14199.25,0.34,1
17204,1936,1000.00,20000.00,21000.00,6129.52,13870.48,0.01,1
17205,1936,1000.00,21000.00,22000.00,5962.40,15037.60,0.33,1
17206,1936,1000.00,22000.00,23000.00,0.00,20628.76,0.22,1
17207,1936,1000.00,23000.00,24000.00,0.00,23000.00,0.35,1
17208,1936,1000.00,24000.00,25000.00,0.00,24000.00,0.18,1
17209,1936,-1000.00,23000.00,24000.00,15011.25,9988.75,0.27,0
17210,1936,1000.00,24000.00,25000.00,8178.76,15821.24,0.32,1
17211,1936,-1000.00,23000.00,24000.00,13302.26,11697.74,0.39,0
17212,1936,1000.00,24000.00,25000.00,1339.95,22660.05,0.35,1
17213,1936,1000.00,25000.00,26000.00,0.00,25000.00,0.10,1
17214,1936,-1000.00,24000.00,25000.00,11092.90,355.52,0.09,0
17215,1936,1000.00,25000.00,26000.00,0.00,22328.32,0.38,1
17216,1936,1000.00,26000.00,27000.00,12127.10,13872.90,0.13,1
17217,1936,1000.00,27000.00,28000.00,0.00,20862.25,0.10,1
17218,1936,1000.00,28000.00,29000.00,0.00,17210.12,0.33,1
17219,1936,1000.00,29000.00,30000.00,0.00,1550.79,0.04,1
17220,1936,1000.00,30000.00,31000.00,0.00,30000.00,0.02,1
17221,1936,1000.00,31000.00,32000.00,0.00,21273.40,0.38,1
17222,1936,1000.00,32000.00,33000.00,0.00,4147.86,0.09,1
17223,1936,1000.00,33000.00,34000.00,0.00,19595.19,0.35,1
17224,1936,1000.00,34000.00,35000.00,17000.00,17000.00,0.07,1
17225,1937,-342.61,-342.61,657.39,188.75,153.87,0.18,0
17226,1937,-1000.00,-1342.61,-342.61,0.00,195.30,0.17,0
17227,1938,-1000.00,-1000.00,0.00,300.21,699.79,0.27,0
17228,1939,-907.88,-907.88,92.12,0.00,907.88,0.39,0
17229,1939,-79.62,-987.50,12.50,0.00,79.62,0.43,0
17230,1939,-8.55,-996.05,3.95,0.00,8.55,0.34,0
17231,1939,-2.43,-998.47,1.53,0.00,2.43,0.21,0
17232,1939,-0.30,-998.77,1.23,0.00,0.30,0.21,0
17233,1939,-160.63,-1159.40,-159.40,1.23,0.00,0.04,0
17234,1940,-1000.00,-1000.00,0.00,182.91,817.09,0.42,0
17235,1941,-1000.00,-1000.00,0.00,0.00,1000.00,0.07,0
17236,1942,-1000.00,-1000.00,0.00,0.00,1000.00,0.38,0
17237,1943,-1000.00,-1000.00,0.00,1000.00,0.00,0.00,0
17238,1944,-1000.00,-1000.00,0.00,1.35,998.65,0.12,0
17239,1945,1000.00,1000.00,2000.00,179.76,820.24,0.40,1
17240,1945,1000.00,2000.00,3000.00,888.55,1111.45,0.20,1
17241,1945,-1000.00,1000.00,2000.00,2029.94,970.06,0.15,0
17242,1945,1000.00,2000.00,3000.00,875.16,1124.84,0.24,1
17243,1945,1000.00,3000.00,4000.00,0.00,1617.44,0.24,1
17244,1945,1000.00,4000.00,5000.00,290.17,3061.62,0.41,1
17245,1945,1000.00,5000.00,6000.00,2500.00,2500.00,0.39,1
17246,1945,1000.00,6000.00,7000.00,2671.28,3328.72,0.28,1
17247,1945,1000.00,7000.00,8000.00,0.00,5270.18,0.25,1
17248,1945,1000.00,8000.00,9000.00,3880.74,4119.26,0.34,1
17249,1945,1000.00,9000.00,10000.00,0.00,9000.00,0.14,1
17250,1945,1000.00,10000.00,11000.00,5000.00,5000.00,0.07,1
17251,1945,1000.00,11000.00,12000.00,4246.66,6753.34,0.04,1
17252,1945,1000.00,12000.00,13000.00,1909.02,10090.98,0.18,1
17253,1945,1000.00,13000.00,14000.00,1713.41,11286.59,0.13,1
17254,1945,1000.00,14000.00,15000.00,0.00,14000.00,0.32,1
17255,1945,1000.00,15000.00,16000.00,2621.17,12378.83,0.43,1
17256,1945,1000.00,16000.00,17000.00,6961.55,9038.45,0.21,1
17257,1945,-1000.00,15000.00,16000.00,8500.00,8500.00,0.09,0
17258,1945,-1000.00,14000.00,15000.00,2058.50,13941.50,0.42,0
17259,1945,-1000.00,13000.00,14000.00,0.00,15000.00,0.19,0
17260,1945,-1000.00,12000.00,13000.00,0.00,14000.00,0.36,0
17261,1945,-1000.00,11000.00,12000.00,1451.67,4555.55,0.25,0
17262,1945,-1000.00,10000.00,11000.00,0.00,7093.13,0.24,0
17263,1945,-1000.00,9000.00,10000.00,0.00,8161.21,0.27,0
17264,1945,-1000.00,8000.00,9000.00,721.37,9278.63,0.36,0
17265,1945,-1000.00,7000.00,8000.00,1354.32,7645.68,0.42,0
17266,1945,-1000.00,6000.00,7000.00,1401.67,6598.33,0.24,0
17267,1945,-1000.00,5000.00,6000.00,0.00,7000.00,0.05,0
17268,1945,-1000.00,4000.00,5000.00,0.00,3496.46,0.03,0
17269,1945,-1000.00,3000.00,4000.00,2554.92,2445.08,0.09,0
17270,1945,-1000.00,2000.00,3000.00,0.00,2554.19,0.25,0
17271,1945,-1000.00,1000.00,2000.00,390.60,2609.40,0.42,0
17272,1945,-1000.00,0.00,1000.00,216.19,1783.81,0.19,0
17273,1945,-583.09,-583.09,416.91,45.93,537.16,0.33,0
17274,1945,-416.91,-1000.00,0.00,200.80,216.10,0.23,0
17275,1946,-1000.00,-1000.00,0.00,0.00,1000.00,0.18,0
17276,1947,-278.99,-278.99,721.01,179.55,99.45,0.15,0
17277,1947,-1000.00,-1278.99,-278.99,360.50,360.50,0.05,0
17278,1948,1000.00,1000.00,2000.00,0.00,1000.00,0.40,1
17279,1948,1000.00,2000.00,3000.00,158.40,1841.60,0.12,1
17280,1948,-1000.00,1000.00,2000.00,1575.05,1424.95,0.09,0
17281,1948,1000.00,2000.00,3000.00,0.00,2000.00,0.21,1
17282,1948,1000.00,3000.00,4000.00,0.00,3000.00,0.20,1
17283,1948,1000.00,4000.00,5000.00,0.00,2260.97,0.34,1
17284,1948,1000.00,5000.00,6000.00,0.00,4138.98,0.43,1
17285,1948,1000.00,6000.00,7000.00,0.00,4798.31,0.40,1
17286,1948,1000.00,7000.00,8000.00,0.00,7000.00,0.17,1
17287,1948,1000.00,8000.00,9000.00,182.70,3538.73,0.29,1
17288,1948,1000.00,9000.00,10000.00,0.00,9000.00,0.31,1
17289,1948,1000.00,10000.00,11000.00,0.00,10000.00,0.19,1
17290,1948,1000.00,11000.00,12000.00,0.00,10252.00,0.17,1
17291,1948,1000.00,12000.00,13000.00,0.00,1832.36,0.03,1
17292,1948,1000.00,13000.00,14000.00,0.00,13000.00,0.15,1
17293,1948,1000.00,14000.00,15000.00,4692.67,9307.33,0.24,1
17294,1948,1000.00,15000.00,16000.00,0.00,5315.66,0.27,1
17295,1948,1000.00,16000.00,17000.00,8000.00,8000.00,0.12,1
17296,1948,1000.00,17000.00,18000.00,540.08,4617.75,0.21,1
17297,1948,1000.00,18000.00,19000.00,3048.40,14951.60,0.40,1
17298,1948,1000.00,19000.00,20000.00,4167.82,14832.18,0.40,1
17299,1948,1000.00,20000.00,21000.00,0.00,7281.63,0.07,1
17300,1948,1000.00,21000.00,22000.00,5194.21,15805.79,0.39,1
17301,1948,-1000.00,20000.00,21000.00,7904.59,14095.41,0.31,0
17302,1948,-1000.00,19000.00,20000.00,0.00,21000.00,0.22,0
17303,1948,-1000.00,18000.00,19000.00,9272.73,10727.27,0.10,0
17304,1948,-1000.00,17000.00,18000.00,0.00,14221.12,0.34,0
17305,1948,-1000.00,16000.00,17000.00,0.00,18000.00,0.41,0
17306,1948,-1000.00,15000.00,16000.00,13719.75,3280.25,0.13,0
17307,1948,-1000.00,14000.00,15000.00,0.00,16000.00,0.14,0
17308,1948,-1000.00,13000.00,14000.00,0.00,15000.00,0.34,0
17309,1948,-1000.00,12000.00,13000.00,5698.79,8301.21,0.22,0
17310,1948,-1000.00,11000.00,12000.00,7074.80,5925.20,0.20,0
17311,1948,-1000.00,10000.00,11000.00,6000.00,6000.00,0.36,0
17312,1948,-1000.00,9000.00,10000.00,0.00,9461.75,0.20,0
17313,1948,-1000.00,8000.00,9000.00,0.00,10000.00,0.12,0
17314,1948,-1000.00,7000.00,8000.00,7629.61,1370.39,0.06,0
17315,1948,-1000.00,6000.00,7000.00,0.00,8000.00,0.10,0
17316,1948,-1000.00,5000.00,6000.00,3500.00,3500.00,0.01,0
17317,1948,-1000.00,4000.00,5000.00,985.13,4282.81,0.39,0
17318,1948,-1000.00,3000.00,4000.00,0.00,5000.00,0.30,0
17319,1948,-1000.00,2000.00,3000.00,0.00,4000.00,0.10,0
17320,1948,-1000.00,1000.00,2000.00,207.01,2792.99,0.39,0
17321,1948,-1000.00,0.00,1000.00,751.54,1248.46,0.19,0
17322,1948,-538.05,-538.05,461.95,90.93,447.12,0.31,0
17323,1948,-461.95,-1000.00,0.00,0.00,461.95,0.08,0
17324,1949,1000.00,1000.00,2000.00,0.00,469.27,0.19,1
17325,1949,1000.00,2000.00,3000.00,321.74,1212.31,0.34,1
17326,1949,1000.00,3000.00,4000.00,0.00,3000.00,0.11,1
17327,1949,1000.00,4000.00,5000.00,0.00,4000.00,0.38,1
17328,1949,1000.00,5000.00,6000.00,2286.40,2713.60,0.16,1
17329,1949,1000.00,6000.00,7000.00,410.38,4812.04,0.39,1
17330,1949,1000.00,7000.00,8000.00,846.35,6153.65,0.32,1
17331,1949,0.00,7000.00,8000.00,0.00,0.00,0.07,0
17332,1949,1000.00,8000.00,9000.00,3541.13,4458.87,0.15,1
17333,1949,1000.00,9000.00,10000.00,3668.32,5331.68,0.30,1
17334,1949,1000.00,10000.00,11000.00,0.00,10000.00,0.14,1
17335,1949,-1000.00,9000.00,10000.00,8060.65,2939.35,0.08,0
17336,1949,1000.00,10000.00,11000.00,0.00,9098.42,0.42,1
17337,1949,1000.00,11000.00,12000.00,5500.00,5500.00,0.00,1
17338,1949,1000.00,12000.00,13000.00,2407.53,5674.71,0.30,1
17339,1949,1000.00,13000.00,14000.00,0.00,10960.50,0.41,1
17340,1949,1000.00,14000.00,15000.00,3686.70,10313.30,0.29,1
17341,1949,1000.00,15000.00,16000.00,2150.06,12849.94,0.13,1
17342,1949,1000.00,16000.00,17000.00,4359.19,11640.81,0.44,1
17343,1949,-1000.00,15000.00,16000.00,7833.17,9166.83,0.31,0
17344,1949,-1000.00,14000.00,15000.00,0.00,16000.00,0.20,0
17345,1949,-1000.00,13000.00,14000.00,1122.56,13751.39,0.43,0
17346,1949,-1000.00,12000.00,13000.00,12156.30,1843.70,0.03,0
17347,1949,-1000.00,11000.00,12000.00,0.00,13000.00,0.10,0
17348,1949,-1000.00,10000.00,11000.00,377.33,0.00,0.01,0
17349,1949,-1000.00,9000.00,10000.00,0.00,11000.00,0.01,0
17350,1949,-1000.00,8000.00,9000.00,0.00,10000.00,0.02,0
17351,1949,-1000.00,7000.00,8000.00,2549.51,6450.49,0.41,0
17352,1949,-1000.00,6000.00,7000.00,0.00,8000.00,0.41,0
17353,1949,-1000.00,5000.00,6000.00,2177.85,4822.15,0.17,0
17354,1949,0.00,5000.00,6000.00,0.00,0.00,0.03,0
17355,1949,-1000.00,4000.00,5000.00,508.34,3470.01,0.39,0
17356,1949,-1000.00,3000.00,4000.00,0.00,5000.00,0.44,0
17357,1949,-1000.00,2000.00,3000.00,2783.39,0.00,0.05,0
17358,1949,-1000.00,1000.00,2000.00,0.00,2392.47,0.36,0
17359,1949,-1000.00,0.00,1000.00,0.00,1805.57,0.35,0
17360,1949,-1000.00,-1000.00,0.00,0.00,1000.00,0.33,0
17361,1950,0.00,0.00,1000.00,0.00,0.00,0.09,0
17362,1950,-531.85,-531.85,468.15,370.17,161.68,0.15,0
17363,1950,0.00,-531.85,468.15,0.00,0.00,0.00,0
17364,1950,-1000.00,-1531.85,-531.85,157.62,310.52,0.37,0
17365,1951,-1000.00,-1000.00,0.00,500.00,500.00,0.00,0
17366,1952,-686.67,-686.67,313.33,0.00,686.67,0.38,0
17367,1952,-1000.00,-1686.67,-686.67,83.64,0.00,0.07,0
17368,1953,-1000.00,-1000.00,0.00,339.36,660.64,0.29,0
17369,1954,-1000.00,-1000.00,0.00,288.14,711.86,0.35,0
17370,1955,-1000.00,-1000.00,0.00,392.90,607.10,0.21,0
17371,1956,-1000.00,-1000.00,0.00,117.76,882.24,0.02,0
17372,1957,-1000.00,-1000.00,0.00,0.00,1000.00,0.25,0
17373,1958,0.00,0.00,1000.00,0.00,0.00,0.10,0
17374,1958,-1000.00,-1000.00,0.00,0.00,1000.00,0.31,0
17375,1959,-1000.00,-1000.00,0.00,0.00,1000.00,0.33,0
17376,1960,-1000.00,-1000.00,0.00,447.02,552.98,0.16,0
17377,1961,-1000.00,-1000.00,0.00,0.00,1000.00,0.24,0
17378,1962,-1000.00,-1000.00,0.00,358.94,641.06,0.14,0
17379,1963,-605.53,-605.53,394.47,0.00,605.53,0.15,0
17380,1963,-394.47,-1000.00,0.00,31.07,363.40,0.24,0
17381,1964,-1000.00,-1000.00,0.00,208.51,791.49,0.35,0
17382,1965,-1000.00,-1000.00,0.00,0.00,1000.00,0.15,0
17383,1966,1000.00,1000.00,2000.00,0.00,528.41,0.31,1
17384,1966,1000.00,2000.00,3000.00,0.00,2000.00,0.35,1
17385,1966,1000.00,3000.00,4000.00,37.11,2962.89,0.32,1
17386,1966,1000.00,4000.00,5000.00,0.00,2466.60,0.34,1
17387,1966,1000.00,5000.00,6000.00,801.04,4198.96,0.42,1
17388,1966,1000.00,6000.00,7000.00,2573.63,3426.37,0.22,1
17389,1966,1000.00,7000.00,8000.00,2117.45,4882.55,0.35,1
17390,1966,1000.00,8000.00,9000.00,0.00,8000.00,0.13,1
17391,1966,1000.00,9000.00,10000.00,0.00,9000.00,0.39,1
17392,1966,1000.00,10000.00,11000.00,0.00,9847.46,0.27,1
17393,1966,1000.00,11000.00,12000.00,5469.75,5530.25,0.11,1
17394,1966,1000.00,12000.00,13000.00,0.00,6939.32,0.18,1
17395,1966,1000.00,13000.00,14000.00,0.00,9.73,0.11,1
17396,1966,1000.00,14000.00,15000.00,0.00,14000.00,0.20,1
17397,1966,-1000.00,13000.00,14000.00,10273.55,4726.45,0.08,0
17398,1966,1000.00,14000.00,15000.00,0.00,8238.42,0.35,1
17399,1966,1000.00,15000.00,16000.00,4005.96,10994.04,0.05,1
17400,1966,1000.00,16000.00,17000.00,0.00,16000.00,0.35,1
17401,1966,1000.00,17000.00,18000.00,0.00,17000.00,0.17,1
17402,1966,-1000.00,16000.00,17000.00,6954.44,10769.40,0.22,0
17403,1966,-1000.00,15000.00,16000.00,4194.28,12805.72,0.36,0
17404,1966,-1000.00,14000.00,15000.00,0.00,16000.00,0.28,0
17405,1966,-1000.00,13000.00,14000.00,0.00,6543.46,0.00,0
17406,1966,-1000.00,12000.00,13000.00,4278.14,9019.06,0.33,0
17407,1966,-1000.00,11000.00,12000.00,0.00,10046.62,0.37,0
17408,1966,-1000.00,10000.00,11000.00,0.00,11520.24,0.37,0
17409,1966,-1000.00,9000.00,10000.00,2297.10,8702.90,0.39,0
17410,1966,-1000.00,8000.00,9000.00,0.00,5964.92,0.35,0
17411,1966,-1000.00,7000.00,8000.00,0.00,9000.00,0.11,0
17412,1966,-1000.00,6000.00,7000.00,0.00,4262.81,0.24,0
17413,1966,-1000.00,5000.00,6000.00,0.00,7000.00,0.05,0
17414,1966,-1000.00,4000.00,5000.00,4891.94,1108.06,0.06,0
17415,1966,-1000.00,3000.00,4000.00,0.00,5000.00,0.09,0
17416,1966,-1000.00,2000.00,3000.00,0.00,4000.00,0.25,0
17417,1966,0.00,2000.00,3000.00,0.00,0.00,0.07,0
17418,1966,-604.79,1395.21,2395.21,0.00,604.79,0.16,0
17419,1966,-1000.00,395.21,1395.21,1541.56,853.65,0.19,0
17420,1966,-1000.00,-604.79,395.21,618.56,776.65,0.22,0
17421,1966,-395.21,-1000.00,0.00,189.54,205.67,0.30,0
17422,1967,-1000.00,-1000.00,0.00,0.00,1000.00,0.18,0
17423,1968,-1000.00,-1000.00,0.00,499.98,500.02,0.10,0
17424,1969,0.00,0.00,1000.00,0.00,0.00,0.04,0
17425,1969,1000.00,1000.00,2000.00,285.36,714.64,0.30,1
17426,1969,1000.00,2000.00,3000.00,0.00,2000.00,0.03,1
17427,1969,-1000.00,1000.00,2000.00,2274.86,725.14,0.09,0
17428,1969,1000.00,2000.00,3000.00,859.53,1140.47,0.18,1
17429,1969,1000.00,3000.00,4000.00,1500.00,1500.00,0.06,1
17430,1969,-1000.00,2000.00,3000.00,2707.32,670.13,0.10,0
17431,1969,-1000.00,1000.00,2000.00,1725.70,1274.30,0.15,0
17432,1969,1000.00,2000.00,3000.00,677.56,1322.44,0.24,1
17433,1969,1000.00,3000.00,4000.00,808.38,1712.09,0.26,1
17434,1969,1000.00,4000.00,5000.00,1296.43,2703.57,0.32,1
17435,1969,1000.00,5000.00,6000.00,0.00,1684.13,0.17,1
17436,1969,1000.00,6000.00,7000.00,2710.85,3289.15,0.26,1
17437,1969,1000.00,7000.00,8000.00,0.00,3083.86,0.27,1
17438,1969,1000.00,8000.00,9000.00,3172.14,4827.86,0.06,1
17439,1969,-669.85,7330.15,8330.15,644.97,24.88,0.11,0
17440,1969,1000.00,8330.15,9330.15,0.00,7809.90,0.43,1
17441,1969,1000.00,9330.15,10330.15,0.00,8870.52,0.05,1
17442,1969,1000.00,10330.15,11330.15,3402.02,6928.12,0.36,1
17443,1969,1000.00,11330.15,12330.15,5077.77,6252.38,0.10,1
17444,1969,1000.00,12330.15,13330.15,0.00,7066.13,0.32,1
17445,1969,1000.00,13330.15,14330.15,0.00,13330.15,0.33,1
17446,1969,-1000.00,12330.15,13330.15,7165.07,7165.07,0.38,0
17447,1969,-1000.00,11330.15,12330.15,5801.58,7528.56,0.25,0
17448,1969,-1000.00,10330.15,11330.15,3806.05,8524.10,0.07,0
17449,1969,-1000.00,9330.15,10330.15,2711.51,8618.64,0.22,0
17450,1969,-1000.00,8330.15,9330.15,0.00,7120.30,0.10,0
17451,1969,-1000.00,7330.15,8330.15,3911.82,5418.32,0.18,0
17452,1969,-1000.00,6330.15,7330.15,3919.24,4410.90,0.30,0
17453,1969,-1000.00,5330.15,6330.15,2365.70,3977.94,0.33,0
17454,1969,-1000.00,4330.15,5330.15,1304.96,4551.16,0.38,0
17455,1969,-1000.00,3330.15,4330.15,505.45,3921.48,0.39,0
17456,1969,-1000.00,2330.15,3330.15,0.00,4330.15,0.16,0
17457,1969,-1000.00,1330.15,2330.15,0.00,2512.27,0.07,0
17458,1969,-1000.00,330.15,1330.15,259.85,2070.30,0.39,0
17459,1969,-1000.00,-669.85,330.15,665.07,665.07,0.06,0
17460,1969,-1000.00,-1669.85,-669.85,167.85,162.29,0.13,0
17461,1970,1000.00,1000.00,2000.00,0.00,875.10,0.41,1
17462,1970,1000.00,2000.00,3000.00,1000.00,1000.00,0.09,1
17463,1970,-439.02,1560.98,2560.98,439.02,0.00,0.10,0
17464,1970,1000.00,2560.98,3560.98,1135.87,1425.11,0.24,1
17465,1970,1000.00,3560.98,4560.98,1760.07,1800.90,0.39,1
17466,1970,1000.00,4560.98,5560.98,0.00,599.99,0.15,1
17467,1970,1000.00,5560.98,6560.98,0.00,1650.74,0.16,1
17468,1970,1000.00,6560.98,7560.98,1159.24,5113.60,0.40,1
17469,1970,1000.00,7560.98,8560.98,2853.65,4707.33,0.07,1
17470,1970,1000.00,8560.98,9560.98,3203.48,5357.50,0.11,1
17471,1970,1000.00,9560.98,10560.98,1977.87,7583.10,0.23,1
17472,1970,1000.00,10560.98,11560.98,0.00,10560.98,0.07,1
17473,1970,1000.00,11560.98,12560.98,0.00,11560.98,0.40,1
17474,1970,0.00,11560.98,12560.98,0.00,0.00,0.04,0
17475,1970,1000.00,12560.98,13560.98,3535.16,6731.60,0.30,1
17476,1970,-1000.00,11560.98,12560.98,6585.29,5670.87,0.28,0
17477,1970,1000.00,12560.98,13560.98,3806.38,8754.59,0.36,1
17478,1970,1000.00,13560.98,14560.98,0.00,13560.98,0.33,1
17479,1970,1000.00,14560.98,15560.98,0.00,7887.42,0.11,1
17480,1970,-1000.00,13560.98,14560.98,14865.76,695.22,0.02,0
17481,1970,1000.00,14560.98,15560.98,3462.48,11098.49,0.42,1
17482,1970,-1000.00,13560.98,14560.98,10375.53,5185.45,0.11,0
17483,1970,1000.00,14560.98,15560.98,0.00,7391.29,0.21,1
17484,1970,1000.00,15560.98,16560.98,6647.33,8913.65,0.20,1
17485,1970,1000.00,16560.98,17560.98,0.00,16560.98,0.33,1
17486,1970,1000.00,17560.98,18560.98,4466.89,13094.08,0.06,1
17487,1970,-1000.00,16560.98,17560.98,5411.31,13149.67,0.33,0
17488,1970,-1000.00,15560.98,16560.98,14019.84,1312.71,0.19,0
17489,1970,-1000.00,14560.98,15560.98,5970.17,0.00,0.06,0
17490,1970,-1000.00,13560.98,14560.98,651.68,14896.61,0.18,0
17491,1970,-1000.00,12560.98,13560.98,1975.01,9029.89,0.28,0
17492,1970,-1000.00,11560.98,12560.98,5180.57,292.80,0.27,0
17493,1970,-1000.00,10560.98,11560.98,3689.44,8871.54,0.01,0
17494,1970,-1000.00,9560.98,10560.98,492.64,4812.99,0.36,0
17495,1970,-1000.00,8560.98,9560.98,5280.49,5280.49,0.00,0
17496,1970,-1000.00,7560.98,8560.98,548.91,9012.06,0.31,0
17497,1970,-1000.00,6560.98,7560.98,4801.82,3759.16,0.21,0
17498,1970,-1000.00,5560.98,6560.98,0.00,7560.98,0.40,0
17499,1970,-1000.00,4560.98,5560.98,0.00,6560.98,0.39,0
17500,1970,-1000.00,3560.98,4560.98,1311.98,4249.00,0.44,0
17501,1970,-1000.00,2560.98,3560.98,2091.84,2469.14,0.22,0
17502,1970,-1000.00,1560.98,2560.98,0.00,2317.39,0.06,0
17503,1970,-1000.00,560.98,1560.98,182.19,2378.79,0.20,0
17504,1970,-1000.00,-439.02,560.98,232.59,668.29,0.35,0
17505,1970,-310.04,-749.06,250.94,270.19,39.86,0.10,0
17506,1971,-1000.00,-1000.00,0.00,0.00,1000.00,0.33,0
17507,1972,-1000.00,-1000.00,0.00,0.00,85.47,0.07,0
17508,1973,-951.51,-951.51,48.49,0.00,951.51,0.13,0
17509,1973,-48.49,-1000.00,0.00,0.00,48.49,0.39,0
17510,1974,-1000.00,-1000.00,0.00,0.00,662.60,0.34,0
17511,1975,1000.00,1000.00,2000.00,319.41,680.59,0.20,1
17512,1975,-1000.00,0.00,1000.00,1013.74,986.26,0.18,0
17513,1975,1000.00,1000.00,2000.00,0.00,1000.00,0.12,1
17514,1975,1000.00,2000.00,3000.00,569.29,1430.71,0.36,1
17515,1975,1000.00,3000.00,4000.00,870.51,2129.49,0.33,1
17516,1975,1000.00,4000.00,5000.00,203.74,3796.26,0.18,1
17517,1975,-1000.00,3000.00,4000.00,3702.52,1297.48,0.12,0
17518,1975,1000.00,4000.00,5000.00,0.00,4000.00,0.24,1
17519,1975,1000.00,5000.00,6000.00,0.00,1825.94,0.18,1
17520,1975,1000.00,6000.00,7000.00,0.00,6000.00,0.02,1
17521,1975,1000.00,7000.00,8000.00,0.00,7000.00,0.22,1
17522,1975,1000.00,8000.00,9000.00,0.00,8000.00,0.16,1
17523,1975,1000.00,9000.00,10000.00,0.00,9000.00,0.40,1
17524,1975,1000.00,10000.00,11000.00,1428.60,8571.40,0.38,1
17525,1975,1000.00,11000.00,12000.00,1962.84,3845.67,0.24,1
17526,1975,1000.00,12000.00,13000.00,0.00,12000.00,0.29,1
17527,1975,1000.00,13000.00,14000.00,0.00,13000.00,0.35,1
17528,1975,1000.00,14000.00,15000.00,4686.04,9313.96,0.33,1
17529,1975,1000.00,15000.00,16000.00,2259.92,12740.08,0.37,1
17530,1975,1000.00,16000.00,17000.00,0.00,16000.00,0.05,1
17531,1975,1000.00,17000.00,18000.00,3883.22,13116.78,0.24,1
17532,1975,-1000.00,16000.00,17000.00,9912.90,8087.10,0.09,0
17533,1975,1000.00,17000.00,18000.00,7774.21,9225.79,0.16,1
17534,1975,1000.00,18000.00,19000.00,0.00,16533.55,0.16,1
17535,1975,-1000.00,17000.00,18000.00,15695.25,3304.75,0.13,0
17536,1975,1000.00,18000.00,19000.00,4964.76,13035.24,0.38,1
17537,1975,1000.00,19000.00,20000.00,0.00,19000.00,0.19,1
17538,1975,1000.00,20000.00,21000.00,7950.11,12049.89,0.23,1
17539,1975,-1000.00,19000.00,20000.00,14636.20,6363.80,0.16,0
17540,1975,1000.00,20000.00,21000.00,6587.24,12050.58,0.32,1
17541,1975,1000.00,21000.00,22000.00,0.00,14678.36,0.14,1
17542,1975,1000.00,22000.00,23000.00,3545.11,18454.89,0.43,1
17543,1975,1000.00,23000.00,24000.00,4484.24,16655.72,0.40,1
17544,1975,1000.00,24000.00,25000.00,1748.32,22251.68,0.36,1
17545,1975,1000.00,25000.00,26000.00,5749.80,19250.20,0.11,1
17546,1975,1000.00,26000.00,27000.00,12432.24,13567.76,0.11,1
17547,1975,1000.00,27000.00,28000.00,2209.98,24560.97,0.44,1
17548,1975,1000.00,28000.00,29000.00,0.00,28000.00,0.00,1
17549,1975,1000.00,29000.00,30000.00,0.00,29000.00,0.23,1
17550,1976,-1000.00,-1000.00,0.00,681.34,318.66,0.01,0
17551,1977,-1000.00,-1000.00,0.00,0.00,1000.00,0.36,0
17552,1978,-1000.00,-1000.00,0.00,425.52,574.48,0.30,0
17553,1979,-1000.00,-1000.00,0.00,500.00,500.00,0.04,0
17554,1980,-1000.00,-1000.00,0.00,0.00,1000.00,0.32,0
17555,1981,-1000.00,-1000.00,0.00,359.99,640.01,0.13,0
17556,1982,-1000.00,-1000.00,0.00,0.00,1000.00,0.11,0
17557,1983,1000.00,1000.00,2000.00,0.00,1000.00,0.27,1
17558,1983,1000.00,2000.00,3000.00,162.50,1837.50,0.19,1
17559,1983,1000.00,3000.00,4000.00,0.00,3000.00,0.36,1
17560,1983,1000.00,4000.00,5000.00,0.00,1542.60,0.06,1
17561,1983,1000.00,5000.00,6000.00,0.00,4586.61,0.31,1
17562,1983,1000.00,6000.00,7000.00,0.00,5532.41,0.34,1
17563,1983,-1000.00,5000.00,6000.00,3621.88,0.00,0.04,0
17564,1983,1000.00,6000.00,7000.00,2300.28,3699.72,0.25,1
17565,1983,1000.00,7000.00,8000.00,0.00,5750.51,0.30,1
17566,1983,1000.00,8000.00,9000.00,4000.00,4000.00,0.05,1
17567,1983,1000.00,9000.00,10000.00,0.00,3427.23,0.02,1
17568,1983,1000.00,10000.00,11000.00,917.71,9082.29,0.43,1
17569,1983,1000.00,11000.00,12000.00,0.00,11000.00,0.17,1
17570,1983,1000.00,12000.00,13000.00,4727.15,7272.85,0.28,1
17571,1983,1000.00,13000.00,14000.00,4432.03,8567.97,0.33,1
17572,1983,1000.00,14000.00,15000.00,0.00,7157.55,0.31,1
17573,1983,1000.00,15000.00,16000.00,0.00,1007.06,0.12,1
17574,1983,-1000.00,14000.00,15000.00,9625.79,6374.21,0.13,0
17575,1983,1000.00,15000.00,16000.00,950.80,14049.20,0.44,1
17576,1983,1000.00,16000.00,17000.00,4570.99,11429.01,0.13,1
17577,1983,1000.00,17000.00,18000.00,0.00,17000.00,0.08,1
17578,1983,1000.00,18000.00,19000.00,0.00,18000.00,0.22,1
17579,1983,0.00,18000.00,19000.00,0.00,0.00,0.00,0
17580,1983,-1000.00,17000.00,18000.00,5772.29,0.00,0.02,0
17581,1983,-1000.00,16000.00,17000.00,0.00,18000.00,0.40,0
17582,1983,-1000.00,15000.00,16000.00,3162.83,12559.52,0.38,0
17583,1983,-524.72,14475.28,15475.28,0.00,524.72,0.09,0
17584,1983,-1000.00,13475.28,14475.28,4737.71,10737.57,0.21,0
17585,1983,-1000.00,12475.28,13475.28,9408.89,5066.39,0.01,0
17586,1983,-1000.00,11475.28,12475.28,0.00,13475.28,0.28,0
17587,1983,-1000.00,10475.28,11475.28,707.37,11767.91,0.40,0
17588,1983,-1000.00,9475.28,10475.28,0.00,11475.28,0.32,0
17589,1983,-1000.00,8475.28,9475.28,0.00,9814.07,0.35,0
17590,1983,-1000.00,7475.28,8475.28,0.00,8205.78,0.04,0
17591,1983,-1000.00,6475.28,7475.28,0.00,2854.07,0.20,0
17592,1983,-1000.00,5475.28,6475.28,3080.87,4394.41,0.15,0
17593,1983,-1000.00,4475.28,5475.28,2494.52,132.67,0.10,0
17594,1983,-1000.00,3475.28,4475.28,0.00,5475.28,0.09,0
17595,1983,-1000.00,2475.28,3475.28,0.00,4475.28,0.07,0
17596,1983,-1000.00,1475.28,2475.28,0.00,3475.28,0.03,0
17597,1983,-1000.00,475.28,1475.28,1398.13,1077.15,0.29,0
17598,1983,-803.59,-328.31,671.69,0.00,803.59,0.29,0
17599,1983,-671.69,-1000.00,0.00,0.00,671.69,0.35,0
17600,1984,1000.00,1000.00,2000.00,0.00,405.80,0.03,1
17601,1984,1000.00,2000.00,3000.00,437.70,1562.30,0.39,1
17602,1984,1000.00,3000.00,4000.00,0.00,2984.71,0.36,1
17603,1984,1000.00,4000.00,5000.00,0.00,2998.12,0.17,1
17604,1984,1000.00,5000.00,6000.00,0.00,4369.55,0.29,1
17605,1984,1000.00,6000.00,7000.00,0.00,6000.00,0.19,1
17606,1984,1000.00,7000.00,8000.00,883.17,6116.83,0.43,1
17607,1984,-1000.00,6000.00,7000.00,4150.12,3849.88,0.07,0
17608,1984,-1000.00,5000.00,6000.00,6832.57,0.00,0.03,0
17609,1984,1000.00,6000.00,7000.00,0.00,6000.00,0.35,1
17610,1984,1000.00,7000.00,8000.00,2152.61,4847.39,0.24,1
17611,1984,1000.00,8000.00,9000.00,0.00,6811.75,0.00,1
17612,1984,-1000.00,7000.00,8000.00,2388.04,0.00,0.05,0
17613,1984,1000.00,8000.00,9000.00,1986.46,6013.54,0.17,1
17614,1984,1000.00,9000.00,10000.00,0.00,9000.00,0.28,1
17615,1984,-1000.00,8000.00,9000.00,5529.40,4470.60,0.22,0
17616,1984,1000.00,9000.00,10000.00,1893.45,7106.55,0.17,1
17617,1984,1000.00,10000.00,11000.00,0.00,10000.00,0.04,1
17618,1984,-1000.00,9000.00,10000.00,5239.97,5760.03,0.39,0
17619,1984,-289.91,8710.09,9710.09,0.00,289.91,0.04,0
17620,1984,-1000.00,7710.09,8710.09,2604.76,6178.23,0.35,0
17621,1984,-1000.00,6710.09,7710.09,0.00,8710.09,0.03,0
17622,1984,-1000.00,5710.09,6710.09,1656.98,6053.11,0.30,0
17623,1984,-1000.00,4710.09,5710.09,3355.05,3355.05,0.01,0
17624,1984,-1000.00,3710.09,4710.09,2855.05,2855.05,0.03,0
17625,1984,-1000.00,2710.09,3710.09,2064.11,2645.99,0.28,0
17626,1984,-1000.00,1710.09,2710.09,0.00,3020.68,0.34,0
17627,1984,-1000.00,710.09,1710.09,1576.02,1134.07,0.07,0
17628,1984,-1000.00,-289.91,710.09,0.00,1710.09,0.33,0
17629,1984,-710.09,-1000.00,0.00,203.26,506.83,0.36,0
17630,1985,-1000.00,-1000.00,0.00,0.00,1000.00,0.11,0
17631,1986,1000.00,1000.00,2000.00,2.01,997.99,0.22,1
17632,1986,1000.00,2000.00,3000.00,0.00,1568.92,0.26,1
17633,1986,1000.00,3000.00,4000.00,0.00,2477.67,0.14,1
17634,1986,1000.00,4000.00,5000.00,0.00,4000.00,0.03,1
17635,1986,1000.00,5000.00,6000.00,995.71,4004.29,0.38,1
17636,1986,1000.00,6000.00,7000.00,0.00,4106.55,0.36,1
17637,1986,1000.00,7000.00,8000.00,1400.34,5599.66,0.22,1
17638,1986,1000.00,8000.00,9000.00,1786.96,5601.91,0.36,1
17639,1986,1000.00,9000.00,10000.00,3003.76,5996.24,0.09,1
17640,1986,1000.00,10000.00,11000.00,2792.13,7207.87,0.30,1
17641,1986,1000.00,11000.00,12000.00,0.00,7814.56,0.11,1
17642,1986,1000.00,12000.00,13000.00,517.05,4915.47,0.27,1
17643,1986,1000.00,13000.00,14000.00,0.00,13000.00,0.00,1
17644,1986,1000.00,14000.00,15000.00,0.00,13039.28,0.29,1
17645,1986,1000.00,15000.00,16000.00,3495.53,11504.47,0.39,1
17646,1986,1000.00,16000.00,17000.00,8000.00,8000.00,0.03,1
17647,1986,-1000.00,15000.00,16000.00,13022.98,3977.02,0.02,0
17648,1986,1000.00,16000.00,17000.00,4734.36,6606.54,0.24,1
17649,1986,1000.00,17000.00,18000.00,0.00,17000.00,0.25,1
17650,1986,1000.00,18000.00,19000.00,4633.28,13366.72,0.14,1
17651,1986,1000.00,19000.00,20000.00,901.21,18098.79,0.37,1
17652,1986,1000.00,20000.00,21000.00,6265.40,13734.60,0.43,1
17653,1986,1000.00,21000.00,22000.00,0.00,5817.79,0.15,1
17654,1986,0.00,21000.00,22000.00,0.00,0.00,0.02,0
17655,1986,1000.00,22000.00,23000.00,0.00,6591.77,0.12,1
17656,1986,1000.00,23000.00,24000.00,6309.95,16690.05,0.30,1
17657,1986,1000.00,24000.00,25000.00,2871.05,21128.95,0.42,1
17658,1986,1000.00,25000.00,26000.00,0.00,25000.00,0.09,1
17659,1986,1000.00,26000.00,27000.00,5652.21,19786.11,0.41,1
17660,1986,1000.00,27000.00,28000.00,0.00,26215.68,0.32,1
17661,1986,1000.00,28000.00,29000.00,0.00,25304.68,0.15,1
17662,1986,1000.00,29000.00,30000.00,4546.26,24453.74,0.19,1
17663,1986,1000.00,30000.00,31000.00,1285.14,28714.86,0.14,1
17664,1986,1000.00,31000.00,32000.00,1904.24,29095.76,0.43,1
17665,1986,1000.00,32000.00,33000.00,9676.75,22323.25,0.06,1
17666,1986,1000.00,33000.00,34000.00,0.00,33000.00,0.27,1
17667,1986,1000.00,34000.00,35000.00,0.00,34000.00,0.42,1
17668,1986,-1000.00,33000.00,34000.00,17659.35,17340.65,0.21,0
17669,1986,1000.00,34000.00,35000.00,5109.50,28890.50,0.19,1
17670,1986,1000.00,35000.00,36000.00,447.84,34552.16,0.03,1
17671,1986,1000.00,36000.00,37000.00,18000.00,18000.00,0.33,1
17672,1986,1000.00,37000.00,38000.00,14854.11,22145.89,0.25,1
17673,1986,1000.00,38000.00,39000.00,0.00,38000.00,0.06,1
17674,1986,1000.00,39000.00,40000.00,15356.65,23643.35,0.40,1
17675,1986,1000.00,40000.00,41000.00,4400.22,15062.41,0.21,1
17676,1987,-54.89,-54.89,945.11,54.89,0.00,0.09,0
17677,1987,1000.00,945.11,1945.11,0.00,526.25,0.28,1
17678,1987,-1000.00,-54.89,945.11,1038.25,906.86,0.11,0
17679,1987,1000.00,945.11,1945.11,0.00,626.54,0.32,1
17680,1987,-1000.00,-54.89,945.11,987.91,957.21,0.11,0
17681,1987,1000.00,945.11,1945.11,0.00,945.11,0.01,1
17682,1987,1000.00,1945.11,2945.11,0.00,1803.84,0.43,1
17683,1987,-1000.00,945.11,1945.11,1590.49,1354.62,0.14,0
17684,1987,1000.00,1945.11,2945.11,94.62,1850.50,0.21,1
17685,1987,1000.00,2945.11,3945.11,1472.56,1472.56,0.07,1
17686,1987,1000.00,3945.11,4945.11,1836.72,2108.39,0.18,1
17687,1987,1000.00,4945.11,5945.11,0.00,4945.11,0.13,1
17688,1987,1000.00,5945.11,6945.11,2006.03,3939.08,0.26,1
17689,1987,1000.00,6945.11,7945.11,685.66,3238.47,0.29,1
17690,1987,1000.00,7945.11,8945.11,2058.19,5886.92,0.28,1
17691,1987,1000.00,8945.11,9945.11,4295.77,4649.34,0.25,1
17692,1987,1000.00,9945.11,10945.11,1025.21,8919.91,0.43,1
17693,1987,-1000.00,8945.11,9945.11,5642.66,5302.45,0.17,0
17694,1987,1000.00,9945.11,10945.11,0.00,3051.79,0.12,1
17695,1987,1000.00,10945.11,11945.11,0.00,2590.86,0.17,1
17696,1987,1000.00,11945.11,12945.11,4457.79,7487.32,0.02,1
17697,1987,1000.00,12945.11,13945.11,5371.49,7573.62,0.43,1
17698,1987,-1000.00,11945.11,12945.11,7371.58,6573.53,0.05,0
17699,1987,1000.00,12945.11,13945.11,0.00,5376.88,0.19,1
17700,1987,1000.00,13945.11,14945.11,0.00,13945.11,0.07,1
17701,1987,1000.00,14945.11,15945.11,0.00,14945.11,0.35,1
17702,1987,1000.00,15945.11,16945.11,3167.87,12777.24,0.39,1
17703,1987,1000.00,16945.11,17945.11,0.00,13166.36,0.24,1
17704,1987,1000.00,17945.11,18945.11,0.00,10732.75,0.29,1
17705,1987,1000.00,18945.11,19945.11,6486.32,12458.80,0.15,1
17706,1987,1000.00,19945.11,20945.11,0.00,19945.11,0.24,1
17707,1987,1000.00,20945.11,21945.11,670.35,20274.76,0.30,1
17708,1987,1000.00,21945.11,22945.11,0.00,21945.11,0.37,1
17709,1987,0.00,21945.11,22945.11,0.00,0.00,0.05,0
17710,1987,-1000.00,20945.11,21945.11,9162.07,0.00,0.07,0
17711,1987,1000.00,21945.11,22945.11,6566.20,15378.92,0.39,1
17712,1987,1000.00,22945.11,23945.11,4313.98,18631.13,0.43,1
17713,1987,1000.00,23945.11,24945.11,4906.58,19038.53,0.12,1
17714,1987,1000.00,24945.11,25945.11,0.00,15061.70,0.27,1
17715,1987,1000.00,25945.11,26945.11,4254.67,21271.04,0.41,1
17716,1987,1000.00,26945.11,27945.11,0.00,26945.11,0.10,1
17717,1987,0.00,26945.11,27945.11,0.00,0.00,0.01,0
17718,1987,1000.00,27945.11,28945.11,0.00,15926.48,0.01,1
17719,1987,1000.00,28945.11,29945.11,14472.56,14472.56,0.20,1
17720,1987,-1000.00,27945.11,28945.11,13149.63,0.00,0.08,0
17721,1988,-678.35,-678.35,321.65,0.00,678.35,0.22,0
17722,1988,-305.66,-984.00,16.00,0.00,305.66,0.44,0
17723,1988,-16.00,-1000.00,0.00,3.53,12.47,0.25,0
17724,1989,-1000.00,-1000.00,0.00,446.13,553.87,0.07,0
17725,1990,-1000.00,-1000.00,0.00,331.61,668.39,0.26,0
17726,1991,-1000.00,-1000.00,0.00,0.00,1000.00,0.13,0
17727,1992,-1000.00,-1000.00,0.00,315.78,684.22,0.19,0
17728,1993,-1000.00,-1000.00,0.00,236.17,763.83,0.06,0
17729,1994,-1000.00,-1000.00,0.00,0.00,1000.00,0.40,0
17730,1995,-1000.00,-1000.00,0.00,3.32,996.68,0.33,0
17731,1996,-1000.00,-1000.00,0.00,0.00,1000.00,0.12,0
17732,1997,1000.00,1000.00,2000.00,668.43,331.57,0.01,1
17733,1997,-1000.00,0.00,1000.00,529.61,1470.39,0.34,0
17734,1997,0.00,0.00,1000.00,0.00,0.00,0.15,0
17735,1997,-1000.00,-1000.00,0.00,500.00,500.00,0.29,0
17736,1998,-1000.00,-1000.00,0.00,506.32,493.68,0.13,0
17737,1999,-813.83,-813.83,186.17,0.00,813.83,0.11,0
17738,1999,-116.53,-930.36,69.64,31.85,84.68,0.28,0
17739,1999,-69.64,-1000.00,0.00,0.00,69.64,0.13,0
17740,2000,1000.00,1000.00,2000.00,336.97,663.03,0.33,1
17741,2000,1000.00,2000.00,3000.00,227.85,961.30,0.30,1
17742,2000,1000.00,3000.00,4000.00,0.00,3000.00,0.19,1
17743,2000,1000.00,4000.00,5000.00,0.00,4000.00,0.06,1
17744,2000,1000.00,5000.00,6000.00,0.00,4313.41,0.41,1
17745,2000,1000.00,6000.00,7000.00,93.22,4867.42,0.42,1
17746,2000,1000.00,7000.00,8000.00,1443.61,4237.67,0.34,1
17747,2000,1000.00,8000.00,9000.00,0.00,8000.00,0.15,1
17748,2000,1000.00,9000.00,10000.00,0.00,9000.00,0.30,1
17749,2000,1000.00,10000.00,11000.00,0.00,10000.00,0.40,1
17750,2000,1000.00,11000.00,12000.00,0.00,10384.10,0.13,1
17751,2000,1000.00,12000.00,13000.00,3415.30,8584.70,0.30,1
17752,2000,1000.00,13000.00,14000.00,985.09,12014.91,0.31,1
17753,2000,1000.00,14000.00,15000.00,5898.72,8101.28,0.17,1
17754,2000,1000.00,15000.00,16000.00,0.00,8022.78,0.32,1
17755,2000,1000.00,16000.00,17000.00,0.00,16000.00,0.14,1
17756,2000,1000.00,17000.00,18000.00,0.00,17000.00,0.13,1
17757,2000,1000.00,18000.00,19000.00,1089.51,16910.49,0.32,1
17758,2000,1000.00,19000.00,20000.00,9500.00,9500.00,0.03,1
17759,2000,0.00,19000.00,20000.00,0.00,0.00,0.07,0
17760,2000,1000.00,20000.00,21000.00,0.00,1331.69,0.13,1
17761,2000,-1000.00,19000.00,20000.00,11161.82,9838.18,0.43,0
17762,2000,1000.00,20000.00,21000.00,0.00,20000.00,0.27,1
17763,2000,1000.00,21000.00,22000.00,0.00,21000.00,0.18,1
17764,2000,-1000.00,20000.00,21000.00,11634.34,10365.66,0.05,0
17765,2000,1000.00,21000.00,22000.00,0.00,21000.00,0.26,1
17766,2000,1000.00,22000.00,23000.00,0.00,22000.00,0.39,1
17767,2000,1000.00,23000.00,24000.00,0.00,17443.21,0.09,1
17768,2000,1000.00,24000.00,25000.00,3218.00,12047.35,0.31,1
17769,2000,1000.00,25000.00,26000.00,0.00,15987.99,0.27,1
17770,2000,-1000.00,24000.00,25000.00,16381.10,0.00,0.00,0
17771,2000,1000.00,25000.00,26000.00,0.00,16589.58,0.26,1
17772,2000,-1000.00,24000.00,25000.00,13230.28,12769.72,0.11,0
17773,2000,1000.00,25000.00,26000.00,0.00,15152.67,0.02,1
17774,2000,1000.00,26000.00,27000.00,3891.96,11675.41,0.20,1
17775,2000,0.00,26000.00,27000.00,0.00,0.00,0.00,0
17776,2000,1000.00,27000.00,28000.00,0.00,12447.32,0.16,1
17777,2000,1000.00,28000.00,29000.00,1382.30,26617.70,0.36,1
17778,2000,1000.00,29000.00,30000.00,10478.44,15965.78,0.30,1
17779,2000,1000.00,30000.00,31000.00,12009.62,17990.38,0.21,1
17780,2000,1000.00,31000.00,32000.00,13724.15,17275.85,0.24,1
17781,2001,1000.00,1000.00,2000.00,87.57,912.43,0.42,1
17782,2001,-1000.00,0.00,1000.00,1344.20,655.80,0.05,0
17783,2001,1000.00,1000.00,2000.00,0.00,982.73,0.26,1
17784,2001,1000.00,2000.00,3000.00,38.35,1961.65,0.11,1
17785,2001,1000.00,3000.00,4000.00,844.56,2155.44,0.37,1
17786,2001,1000.00,4000.00,5000.00,0.00,4000.00,0.35,1
17787,2001,1000.00,5000.00,6000.00,2067.78,2932.22,0.07,1
17788,2001,1000.00,6000.00,7000.00,2221.32,3778.68,0.19,1
17789,2001,1000.00,7000.00,8000.00,2215.54,4784.46,0.15,1
17790,2001,1000.00,8000.00,9000.00,0.00,8000.00,0.17,1
17791,2001,-1000.00,7000.00,8000.00,3045.36,0.00,0.01,0
17792,2001,1000.00,8000.00,9000.00,0.00,8000.00,0.26,1
17793,2001,1000.00,9000.00,10000.00,0.00,6775.14,0.28,1
17794,2001,1000.00,10000.00,11000.00,0.00,10000.00,0.12,1
17795,2001,1000.00,11000.00,12000.00,0.00,11000.00,0.26,1
17796,2001,1000.00,12000.00,13000.00,6000.00,6000.00,0.23,1
17797,2001,1000.00,13000.00,14000.00,6500.00,6500.00,0.12,1
17798,2001,1000.00,14000.00,15000.00,0.00,9403.54,0.37,1
17799,2001,1000.00,15000.00,16000.00,0.00,15000.00,0.35,1
17800,2001,1000.00,16000.00,17000.00,0.00,16000.00,0.33,1
17801,2001,1000.00,17000.00,18000.00,2633.92,14366.08,0.37,1
17802,2001,1000.00,18000.00,19000.00,4099.13,13900.87,0.06,1
17803,2001,1000.00,19000.00,20000.00,7879.74,11120.26,0.28,1
17804,2001,1000.00,20000.00,21000.00,10000.00,10000.00,0.03,1
17805,2001,-1000.00,19000.00,20000.00,12726.40,8273.60,0.09,0
17806,2001,-1000.00,18000.00,19000.00,7720.46,12279.54,0.30,0
17807,2001,-1000.00,17000.00,18000.00,6400.78,12599.22,0.28,0
17808,2001,-1000.00,16000.00,17000.00,12759.55,5240.45,0.10,0
17809,2001,-1000.00,15000.00,16000.00,8500.00,8500.00,0.41,0
17810,2001,-1000.00,14000.00,15000.00,6350.41,9649.59,0.23,0
17811,2001,-1000.00,13000.00,14000.00,0.00,15000.00,0.39,0
17812,2001,-1000.00,12000.00,13000.00,0.00,14000.00,0.00,0
17813,2001,-1000.00,11000.00,12000.00,1377.43,11622.57,0.19,0
17814,2001,-1000.00,10000.00,11000.00,0.00,6232.96,0.22,0
17815,2001,-1000.00,9000.00,10000.00,674.93,6655.65,0.36,0
17816,2001,-1000.00,8000.00,9000.00,5000.00,5000.00,0.06,0
17817,2001,-1000.00,7000.00,8000.00,0.00,9000.00,0.44,0
17818,2001,-1000.00,6000.00,7000.00,4000.00,4000.00,0.06,0
17819,2001,-1000.00,5000.00,6000.00,0.00,5507.79,0.38,0
17820,2001,-1000.00,4000.00,5000.00,1802.64,4197.36,0.34,0
17821,2001,-1000.00,3000.00,4000.00,1730.16,3269.84,0.23,0
17822,2001,0.00,3000.00,4000.00,0.00,0.00,0.09,0
17823,2001,0.00,3000.00,4000.00,0.00,0.00,0.07,0
17824,2001,-1000.00,2000.00,3000.00,2409.23,1590.77,0.15,0
17825,2001,-1000.00,1000.00,2000.00,0.00,3000.00,0.30,0
17826,2001,-1000.00,0.00,1000.00,386.13,1613.87,0.05,0
17827,2001,-1000.00,-1000.00,0.00,0.00,1000.00,0.26,0
17828,2002,-1000.00,-1000.00,0.00,327.12,672.88,0.06,0
17829,2003,1000.00,1000.00,2000.00,192.66,740.05,0.38,1
17830,2003,1000.00,2000.00,3000.00,0.00,2000.00,0.25,1
17831,2003,1000.00,3000.00,4000.00,0.00,3000.00,0.35,1
17832,2003,1000.00,4000.00,5000.00,823.60,3176.40,0.40,1
17833,2003,1000.00,5000.00,6000.00,0.00,3275.48,0.18,1
17834,2003,1000.00,6000.00,7000.00,2134.98,3865.02,0.27,1
17835,2003,1000.00,7000.00,8000.00,0.00,7000.00,0.29,1
17836,2003,1000.00,8000.00,9000.00,0.00,5413.09,0.13,1
17837,2003,1000.00,9000.00,10000.00,0.00,3366.03,0.24,1
17838,2003,-1000.00,8000.00,9000.00,5281.57,4718.43,0.42,0
17839,2003,1000.00,9000.00,10000.00,2726.03,6273.97,0.24,1
17840,2003,-1000.00,8000.00,9000.00,5640.11,2792.90,0.14,0
17841,2003,-1000.00,7000.00,8000.00,1206.23,523.92,0.13,0
17842,2003,1000.00,8000.00,9000.00,0.00,4120.30,0.29,1
17843,2003,1000.00,9000.00,10000.00,0.00,8259.34,0.31,1
17844,2003,1000.00,10000.00,11000.00,4292.46,5707.54,0.13,1
17845,2003,1000.00,11000.00,12000.00,0.00,11000.00,0.15,1
17846,2003,1000.00,12000.00,13000.00,3474.56,8525.44,0.37,1
17847,2003,-1000.00,11000.00,12000.00,8744.86,4255.14,0.09,0
17848,2003,0.00,11000.00,12000.00,0.00,0.00,0.02,0
17849,2003,1000.00,12000.00,13000.00,0.00,4236.41,0.15,1
17850,2003,-1000.00,11000.00,12000.00,13000.00,0.00,0.01,0
17851,2003,1000.00,12000.00,13000.00,3254.42,8745.58,0.36,1
17852,2003,1000.00,13000.00,14000.00,6500.00,6500.00,0.09,1
17853,2003,1000.00,14000.00,15000.00,7000.00,7000.00,0.31,1
17854,2003,1000.00,15000.00,16000.00,0.00,15000.00,0.02,1
17855,2003,1000.00,16000.00,17000.00,0.00,16000.00,0.33,1
17856,2003,1000.00,17000.00,18000.00,0.00,11604.78,0.29,1
17857,2003,1000.00,18000.00,19000.00,458.65,14084.45,0.41,1
17858,2003,-1000.00,17000.00,18000.00,7862.43,6724.24,0.20,0
17859,2003,-1000.00,16000.00,17000.00,9143.66,8856.34,0.21,0
17860,2003,1000.00,17000.00,18000.00,0.00,5122.98,0.22,1
17861,2003,1000.00,18000.00,19000.00,0.00,18000.00,0.40,1
17862,2003,-1000.00,17000.00,18000.00,15030.87,3969.13,0.19,0
17863,2003,1000.00,18000.00,19000.00,0.00,18000.00,0.39,1
17864,2003,1000.00,19000.00,20000.00,0.00,19000.00,0.42,1
17865,2003,1000.00,20000.00,21000.00,0.00,20000.00,0.09,1
17866,2003,1000.00,21000.00,22000.00,8591.59,10194.25,0.24,1
17867,2003,1000.00,22000.00,23000.00,1114.33,20885.67,0.42,1
17868,2003,1000.00,23000.00,24000.00,11500.00,11500.00,0.02,1
17869,2003,1000.00,24000.00,25000.00,696.98,23303.02,0.44,1
17870,2003,1000.00,25000.00,26000.00,0.00,25000.00,0.12,1
17871,2003,1000.00,26000.00,27000.00,7076.82,18923.18,0.32,1
17872,2003,1000.00,27000.00,28000.00,0.00,11160.20,0.06,1
17873,2003,1000.00,28000.00,29000.00,0.00,28000.00,0.34,1
17874,2003,1000.00,29000.00,30000.00,0.00,29000.00,0.38,1
17875,2003,1000.00,30000.00,31000.00,13452.49,16547.51,0.25,1
17876,2003,1000.00,31000.00,32000.00,0.00,31000.00,0.24,1
17877,2003,-1000.00,30000.00,31000.00,4984.98,27015.02,0.06,0
17878,2003,-1000.00,29000.00,30000.00,15605.49,15394.51,0.10,0
17879,2003,-1000.00,28000.00,29000.00,7809.86,22190.14,0.38,0
17880,2003,-1000.00,27000.00,28000.00,811.78,28188.22,0.44,0
17881,2003,-1000.00,26000.00,27000.00,13546.04,14453.96,0.42,0
17882,2003,-1000.00,25000.00,26000.00,0.00,14086.41,0.28,0
17883,2003,-1000.00,24000.00,25000.00,11579.21,14420.79,0.07,0
17884,2003,-1000.00,23000.00,24000.00,5024.11,19975.89,0.41,0
17885,2003,-1000.00,22000.00,23000.00,1128.48,13832.94,0.34,0
17886,2003,-1000.00,21000.00,22000.00,6743.85,16256.15,0.36,0
17887,2003,-1000.00,20000.00,21000.00,6039.32,15960.68,0.29,0
17888,2003,-1000.00,19000.00,20000.00,0.00,18183.19,0.35,0
17889,2003,-1000.00,18000.00,19000.00,10276.36,9723.64,0.36,0
17890,2003,-1000.00,17000.00,18000.00,0.00,19000.00,0.29,0
17891,2003,-1000.00,16000.00,17000.00,5456.11,12543.89,0.34,0
17892,2003,-1000.00,15000.00,16000.00,2553.21,14446.79,0.22,0
17893,2003,-1000.00,14000.00,15000.00,5985.46,10014.54,0.25,0
17894,2003,-1000.00,13000.00,14000.00,0.00,15000.00,0.34,0
17895,2003,-1000.00,12000.00,13000.00,7000.00,7000.00,0.12,0
17896,2003,-1000.00,11000.00,12000.00,1160.54,8449.39,0.37,0
17897,2003,-1000.00,10000.00,11000.00,1337.60,0.00,0.03,0
17898,2003,-1000.00,9000.00,10000.00,0.00,2237.01,0.17,0
17899,2003,-1000.00,8000.00,9000.00,604.20,5785.77,0.35,0
17900,2004,-910.05,-910.05,89.95,0.00,910.05,0.21,0
17901,2004,-89.64,-999.69,0.31,0.00,89.64,0.33,0
17902,2004,-0.31,-1000.00,0.00,0.00,0.31,0.05,0
17903,2005,-247.68,-247.68,752.32,0.00,247.68,0.20,0
17904,2005,-752.32,-1000.00,0.00,323.62,428.69,0.25,0
17905,2006,-830.19,-830.19,169.81,0.00,830.19,0.09,0
17906,2006,-132.20,-962.39,37.61,0.00,132.20,0.15,0
17907,2006,-37.61,-1000.00,0.00,0.18,37.43,0.33,0
17908,2007,-562.41,-562.41,437.59,0.00,562.41,0.21,0
17909,2007,-437.59,-1000.00,0.00,33.24,404.35,0.22,0
17910,2008,-733.26,-733.26,266.74,0.00,733.26,0.22,0
17911,2008,-159.05,-892.31,107.69,0.00,159.05,0.16,0
17912,2008,-107.69,-1000.00,0.00,30.90,76.79,0.36,0
17913,2009,-1000.00,-1000.00,0.00,190.34,809.66,0.41,0
17914,2010,-141.49,-141.49,858.51,141.49,0.00,0.31,0
17915,2010,-277.21,-418.69,581.31,277.21,0.00,0.09,0
17916,2010,-581.31,-1000.00,0.00,358.40,222.91,0.43,0
17917,2011,-1000.00,-1000.00,0.00,999.03,0.97,0.02,0
17918,2012,-178.98,-178.98,821.02,0.00,178.98,0.17,0
17919,2012,-821.02,-1000.00,0.00,0.00,821.02,0.22,0
17920,2013,-1000.00,-1000.00,0.00,480.69,519.31,0.04,0
17921,2014,1000.00,1000.00,2000.00,412.87,587.13,0.04,1
17922,2014,1000.00,2000.00,3000.00,280.04,1719.96,0.40,1
17923,2014,1000.00,3000.00,4000.00,0.00,3000.00,0.37,1
17924,2014,1000.00,4000.00,5000.00,318.06,3681.94,0.27,1
17925,2014,1000.00,5000.00,6000.00,0.00,4553.14,0.26,1
17926,2014,1000.00,6000.00,7000.00,1174.74,3962.00,0.36,1
17927,2014,1000.00,7000.00,8000.00,3428.79,3571.21,0.07,1
17928,2014,1000.00,8000.00,9000.00,0.00,7619.92,0.04,1
17929,2014,1000.00,9000.00,10000.00,4441.63,4558.37,0.13,1
17930,2014,1000.00,10000.00,11000.00,4508.12,5491.88,0.09,1
17931,2014,-1000.00,9000.00,10000.00,5265.73,2086.08,0.15,0
17932,2014,1000.00,10000.00,11000.00,0.00,6992.85,0.36,1
17933,2014,-1000.00,9000.00,10000.00,5588.96,5411.04,0.15,0
17934,2014,1000.00,10000.00,11000.00,0.00,5071.53,0.26,1
17935,2014,1000.00,11000.00,12000.00,5500.00,5500.00,0.06,1
17936,2014,-1000.00,10000.00,11000.00,7361.63,4638.37,0.23,0
17937,2014,1000.00,11000.00,12000.00,0.00,11000.00,0.04,1
17938,2014,1000.00,12000.00,13000.00,0.00,3051.68,0.15,1
17939,2014,-1000.00,11000.00,12000.00,8751.13,0.00,0.07,0
17940,2014,1000.00,12000.00,13000.00,0.00,4.92,0.10,1
17941,2014,1000.00,13000.00,14000.00,0.00,13000.00,0.01,1
17942,2014,1000.00,14000.00,15000.00,4695.08,9304.92,0.33,1
17943,2014,1000.00,15000.00,16000.00,1266.31,13733.69,0.16,1
17944,2014,1000.00,16000.00,17000.00,0.00,16000.00,0.31,1
17945,2014,-1000.00,15000.00,16000.00,3066.27,2471.95,0.15,0
17946,2014,1000.00,16000.00,17000.00,0.00,16000.00,0.25,1
17947,2014,1000.00,17000.00,18000.00,0.00,17000.00,0.19,1
17948,2014,-1000.00,16000.00,17000.00,9501.11,4950.81,0.15,0
17949,2014,1000.00,17000.00,18000.00,3837.41,11835.09,0.20,1
17950,2014,1000.00,18000.00,19000.00,0.00,10627.42,0.16,1
17951,2014,1000.00,19000.00,20000.00,2098.96,16901.04,0.34,1
17952,2014,-1000.00,18000.00,19000.00,202.98,19797.02,0.23,0
17953,2014,-1000.00,17000.00,18000.00,0.00,2037.31,0.08,0
17954,2014,-1000.00,16000.00,17000.00,0.00,4122.01,0.02,0
17955,2014,-1000.00,15000.00,16000.00,13288.40,3711.60,0.18,0
17956,2014,0.00,15000.00,16000.00,0.00,0.00,0.00,0
17957,2014,-1000.00,14000.00,15000.00,0.00,9532.48,0.19,0
17958,2014,-1000.00,13000.00,14000.00,0.00,4910.96,0.15,0
17959,2014,-1000.00,12000.00,13000.00,7000.00,7000.00,0.00,0
17960,2014,-1000.00,11000.00,12000.00,3841.10,9158.90,0.09,0
17961,2014,-1000.00,10000.00,11000.00,0.00,3600.09,0.29,0
17962,2015,1000.00,1000.00,2000.00,78.66,921.34,0.41,1
17963,2015,1000.00,2000.00,3000.00,655.31,1344.69,0.30,1
17964,2015,1000.00,3000.00,4000.00,0.00,3000.00,0.10,1
17965,2015,-1000.00,2000.00,3000.00,2845.89,1154.11,0.07,0
17966,2015,1000.00,3000.00,4000.00,0.00,3000.00,0.00,1
17967,2015,1000.00,4000.00,5000.00,0.00,4000.00,0.35,1
17968,2015,1000.00,5000.00,6000.00,0.00,5000.00,0.39,1
17969,2015,1000.00,6000.00,7000.00,0.00,6000.00,0.44,1
17970,2015,1000.00,7000.00,8000.00,1735.76,5264.24,0.38,1
17971,2015,1000.00,8000.00,9000.00,0.00,8000.00,0.33,1
17972,2015,1000.00,9000.00,10000.00,1181.21,7818.79,0.42,1
17973,2015,1000.00,10000.00,11000.00,0.00,10000.00,0.01,1
17974,2015,-1000.00,9000.00,10000.00,5543.86,5456.14,0.15,0
17975,2015,1000.00,10000.00,11000.00,809.62,9190.38,0.39,1
17976,2015,1000.00,11000.00,12000.00,0.00,7659.34,0.27,1
17977,2015,-1000.00,10000.00,11000.00,6341.11,0.00,0.05,0
17978,2015,1000.00,11000.00,12000.00,3622.74,7377.26,0.10,1
17979,2015,1000.00,12000.00,13000.00,0.00,12000.00,0.37,1
17980,2015,1000.00,13000.00,14000.00,0.00,6908.13,0.27,1
17981,2015,0.00,13000.00,14000.00,0.00,0.00,0.02,0
17982,2015,1000.00,14000.00,15000.00,12.58,4923.68,0.25,1
17983,2015,-1000.00,13000.00,14000.00,10883.66,4116.34,0.04,0
17984,2015,-1000.00,12000.00,13000.00,2074.86,11925.14,0.14,0
17985,2015,-1000.00,11000.00,12000.00,1997.59,11002.41,0.34,0
17986,2015,-1000.00,10000.00,11000.00,3749.62,8250.38,0.26,0
17987,2015,-1000.00,9000.00,10000.00,6709.95,4290.05,0.25,0
17988,2015,-1000.00,8000.00,9000.00,0.00,10000.00,0.18,0
17989,2015,-1000.00,7000.00,8000.00,4768.03,2341.93,0.14,0
17990,2015,-1000.00,6000.00,7000.00,0.00,8000.00,0.16,0
17991,2015,0.00,6000.00,7000.00,0.00,0.00,0.04,0
17992,2015,-1000.00,5000.00,6000.00,273.82,6726.18,0.44,0
17993,2015,-1000.00,4000.00,5000.00,0.00,6000.00,0.34,0
17994,2015,-1000.00,3000.00,4000.00,2041.85,2958.15,0.27,0
17995,2015,-1000.00,2000.00,3000.00,0.00,2204.88,0.31,0
17996,2015,-1000.00,1000.00,2000.00,0.00,3000.00,0.39,0
17997,2015,-1000.00,0.00,1000.00,0.00,2000.00,0.01,0
17998,2015,-1000.00,-1000.00,0.00,0.00,1000.00,0.22,0
17999,2016,-1000.00,-1000.00,0.00,0.00,1000.00,0.19,0
18000,2017,-1000.00,-1000.00,0.00,453.65,181.07,0.13,0
18001,2018,1000.00,1000.00,2000.00,0.00,261.89,0.20,1
18002,2018,1000.00,2000.00,3000.00,0.00,789.76,0.26,1
18003,2018,-1000.00,1000.00,2000.00,2096.34,903.66,0.13,0
18004,2018,1000.00,2000.00,3000.00,0.00,2000.00,0.00,1
18005,2018,1000.00,3000.00,4000.00,385.12,2614.88,0.31,1
18006,2018,1000.00,4000.00,5000.00,1135.88,2864.12,0.22,1
18007,2018,1000.00,5000.00,6000.00,0.00,2430.40,0.32,1
18008,2018,1000.00,6000.00,7000.00,2068.69,3931.31,0.32,1
18009,2018,1000.00,7000.00,8000.00,0.00,5768.24,0.40,1
18010,2018,1000.00,8000.00,9000.00,0.00,1279.10,0.09,1
18011,2018,1000.00,9000.00,10000.00,4500.00,4500.00,0.12,1
18012,2018,1000.00,10000.00,11000.00,0.00,1842.35,0.15,1
18013,2018,1000.00,11000.00,12000.00,3856.04,7143.96,0.28,1
18014,2018,1000.00,12000.00,13000.00,0.00,12000.00,0.14,1
18015,2018,-1000.00,11000.00,12000.00,9194.59,3805.41,0.22,0
18016,2018,1000.00,12000.00,13000.00,3187.60,4179.06,0.24,1
18017,2018,-1000.00,11000.00,12000.00,13000.00,0.00,0.04,0
18018,2018,1000.00,12000.00,13000.00,5833.36,5916.46,0.24,1
18019,2018,1000.00,13000.00,14000.00,0.00,11777.63,0.20,1
18020,2018,-1000.00,12000.00,13000.00,0.00,14000.00,0.44,0
18021,2018,-1000.00,11000.00,12000.00,7090.45,5909.55,0.07,0
18022,2018,-1000.00,10000.00,11000.00,4110.07,7889.93,0.13,0
18023,2018,-1000.00,9000.00,10000.00,0.00,1789.33,0.16,0
18024,2018,-1000.00,8000.00,9000.00,0.00,10000.00,0.06,0
18025,2018,-1000.00,7000.00,8000.00,0.00,8409.01,0.43,0
18026,2018,-1000.00,6000.00,7000.00,4217.48,3782.52,0.14,0
18027,2018,-1000.00,5000.00,6000.00,0.00,7000.00,0.30,0
18028,2018,-1000.00,4000.00,5000.00,3470.72,2529.28,0.13,0
18029,2018,-1000.00,3000.00,4000.00,0.00,5000.00,0.24,0
18030,2018,-1000.00,2000.00,3000.00,542.67,3457.33,0.28,0
18031,2018,-1000.00,1000.00,2000.00,742.17,2257.83,0.32,0
18032,2018,-1000.00,0.00,1000.00,0.00,2000.00,0.32,0
18033,2018,-1000.00,-1000.00,0.00,308.26,691.74,0.27,0
18034,2019,-645.91,-645.91,354.09,58.17,587.75,0.39,0
18035,2019,-354.09,-1000.00,0.00,157.07,197.01,0.27,0
18036,2020,-1000.00,-1000.00,0.00,657.13,342.87,0.10,0
18037,2021,-1000.00,-1000.00,0.00,500.00,500.00,0.04,0
18038,2022,1000.00,1000.00,2000.00,0.00,485.56,0.14,1
18039,2022,1000.00,2000.00,3000.00,0.00,2000.00,0.07,1
18040,2022,1000.00,3000.00,4000.00,1296.70,1703.30,0.05,1
18041,2022,1000.00,4000.00,5000.00,0.00,11.42,0.11,1
18042,2022,-1000.00,3000.00,4000.00,2369.24,163.97,0.09,0
18043,2022,-1000.00,2000.00,3000.00,2520.22,1479.78,0.32,0
18044,2022,1000.00,3000.00,4000.00,685.99,2314.01,0.26,1
18045,2022,1000.00,4000.00,5000.00,0.00,3382.39,0.27,1
18046,2022,1000.00,5000.00,6000.00,0.00,1068.95,0.18,1
18047,2022,1000.00,6000.00,7000.00,0.00,2652.05,0.10,1
18048,2022,1000.00,7000.00,8000.00,1738.73,5261.27,0.17,1
18049,2022,-1000.00,6000.00,7000.00,4957.74,3042.26,0.28,0
18050,2022,1000.00,7000.00,8000.00,2702.64,4297.36,0.29,1
18051,2022,1000.00,8000.00,9000.00,0.00,4749.28,0.34,1
18052,2022,1000.00,9000.00,10000.00,4132.68,4867.32,0.19,1
18053,2022,1000.00,10000.00,11000.00,0.00,5623.79,0.26,1
18054,2022,1000.00,11000.00,12000.00,5354.45,5645.55,0.44,1
18055,2022,1000.00,12000.00,13000.00,0.00,12000.00,0.32,1
18056,2022,1000.00,13000.00,14000.00,0.00,13000.00,0.40,1
18057,2022,0.00,13000.00,14000.00,0.00,0.00,0.10,0
18058,2022,1000.00,14000.00,15000.00,0.00,14000.00,0.27,1
18059,2022,1000.00,15000.00,16000.00,3996.23,11003.77,0.37,1
18060,2022,-1000.00,14000.00,15000.00,8568.44,7431.56,0.12,0
18061,2022,-1000.00,13000.00,14000.00,5966.60,9033.40,0.12,0
18062,2022,-1000.00,12000.00,13000.00,0.00,5158.81,0.22,0
18063,2022,-1000.00,11000.00,12000.00,0.00,13000.00,0.22,0
18064,2022,-1000.00,10000.00,11000.00,5205.43,6794.57,0.10,0
18065,2022,-1000.00,9000.00,10000.00,0.00,4690.03,0.17,0
18066,2022,-1000.00,8000.00,9000.00,0.00,3278.52,0.21,0
18067,2022,-1000.00,7000.00,8000.00,4500.00,4500.00,0.08,0
18068,2022,-1000.00,6000.00,7000.00,0.00,8000.00,0.13,0
18069,2022,-1000.00,5000.00,6000.00,875.90,6124.10,0.32,0
18070,2022,-1000.00,4000.00,5000.00,686.39,3781.72,0.36,0
18071,2022,-1000.00,3000.00,4000.00,2648.90,2351.10,0.39,0
18072,2022,-1000.00,2000.00,3000.00,2817.11,718.46,0.09,0
18073,2022,-1000.00,1000.00,2000.00,0.00,3000.00,0.23,0
18074,2022,-428.98,571.02,1571.02,0.00,428.98,0.19,0
18075,2022,-1000.00,-428.98,571.02,618.14,952.87,0.20,0
18076,2022,-1000.00,-1428.98,-428.98,293.82,277.20,0.44,0
18077,2023,-1000.00,-1000.00,0.00,209.68,790.32,0.37,0
18078,2024,-753.04,-753.04,246.96,0.00,753.04,0.33,0
18079,2024,-246.96,-1000.00,0.00,0.00,246.96,0.06,0
18080,2025,-1000.00,-1000.00,0.00,0.00,938.46,0.40,0
18081,2026,-869.40,-869.40,130.60,0.00,869.40,0.41,0
18082,2026,-1000.00,-1869.40,-869.40,41.38,10.66,0.12,0
18083,2027,-1000.00,-1000.00,0.00,0.00,1000.00,0.35,0
18084,2028,-1000.00,-1000.00,0.00,0.00,1000.00,0.24,0
18085,2029,-1000.00,-1000.00,0.00,377.57,622.43,0.11,0
18086,2030,-1000.00,-1000.00,0.00,401.77,598.23,0.31,0
18087,2031,-839.40,-839.40,160.60,7.35,832.06,0.43,0
18088,2031,-160.60,-1000.00,0.00,63.50,97.10,0.24,0
18089,2032,-827.78,-827.78,172.22,0.00,827.78,0.19,0
18090,2032,-172.22,-1000.00,0.00,84.46,87.76,0.11,0
18091,2033,-1000.00,-1000.00,0.00,0.00,1000.00,0.15,0
18092,2034,-1000.00,-1000.00,0.00,14.42,985.58,0.43,0
18093,2035,1000.00,1000.00,2000.00,0.00,1000.00,0.24,1
18094,2035,1000.00,2000.00,3000.00,605.05,1394.95,0.25,1
18095,2035,1000.00,3000.00,4000.00,926.52,2073.48,0.29,1
18096,2035,1000.00,4000.00,5000.00,0.00,2015.08,0.21,1
18097,2035,1000.00,5000.00,6000.00,0.00,4398.41,0.35,1
18098,2035,-1000.00,4000.00,5000.00,3027.28,2972.72,0.03,0
18099,2035,1000.00,5000.00,6000.00,2500.00,2500.00,0.13,1
18100,2035,-1000.00,4000.00,5000.00,4601.32,0.00,0.10,0
18101,2035,1000.00,5000.00,6000.00,0.00,5000.00,0.08,1
18102,2035,1000.00,6000.00,7000.00,2438.93,3561.07,0.28,1
18103,2035,1000.00,7000.00,8000.00,0.00,1242.90,0.16,1
18104,2035,1000.00,8000.00,9000.00,4000.00,4000.00,0.02,1
18105,2035,1000.00,9000.00,10000.00,1505.54,6674.11,0.39,1
18106,2035,1000.00,10000.00,11000.00,4725.42,5274.58,0.14,1
18107,2035,-1000.00,9000.00,10000.00,8660.72,2339.28,0.01,0
18108,2035,1000.00,10000.00,11000.00,0.00,10000.00,0.07,1
18109,2035,1000.00,11000.00,12000.00,0.00,11000.00,0.20,1
18110,2035,-1000.00,10000.00,11000.00,10060.22,1939.78,0.07,0
18111,2035,1000.00,11000.00,12000.00,604.68,10395.32,0.02,1
18112,2035,1000.00,12000.00,13000.00,3164.67,8835.33,0.17,1
18113,2035,1000.00,13000.00,14000.00,0.00,9321.88,0.11,1
18114,2035,1000.00,14000.00,15000.00,7000.00,7000.00,0.38,1
18115,2035,-1000.00,13000.00,14000.00,12380.79,2619.21,0.19,0
18116,2035,1000.00,14000.00,15000.00,0.00,14000.00,0.30,1
18117,2035,1000.00,15000.00,16000.00,0.00,15000.00,0.04,1
18118,2035,0.00,15000.00,16000.00,0.00,0.00,0.08,0
18119,2035,1000.00,16000.00,17000.00,0.00,16000.00,0.35,1
18120,2035,-1000.00,15000.00,16000.00,9296.42,687.54,0.08,0
18121,2035,1000.00,16000.00,17000.00,7160.37,8839.63,0.23,1
18122,2035,1000.00,17000.00,18000.00,0.00,12679.55,0.38,1
18123,2035,0.00,17000.00,18000.00,0.00,0.00,0.01,0
18124,2035,1000.00,18000.00,19000.00,811.91,4943.03,0.21,1
18125,2035,1000.00,19000.00,20000.00,0.00,19000.00,0.03,1
18126,2035,1000.00,20000.00,21000.00,0.00,20000.00,0.03,1
18127,2035,1000.00,21000.00,22000.00,6239.26,14760.74,0.13,1
18128,2035,1000.00,22000.00,23000.00,8263.82,13736.18,0.30,1
18129,2035,1000.00,23000.00,24000.00,7659.87,15340.13,0.09,1
18130,2035,1000.00,24000.00,25000.00,10661.99,13338.01,0.25,1
18131,2035,1000.00,25000.00,26000.00,8136.90,12379.42,0.27,1
18132,2035,1000.00,26000.00,27000.00,0.00,26000.00,0.31,1
18133,2035,1000.00,27000.00,28000.00,0.00,15297.21,0.11,1
18134,2035,1000.00,28000.00,29000.00,14000.00,14000.00,0.01,1
18135,2035,1000.00,29000.00,30000.00,0.00,29000.00,0.30,1
18136,2035,1000.00,30000.00,31000.00,0.00,30000.00,0.38,1
18137,2035,1000.00,31000.00,32000.00,11599.33,19400.67,0.30,1
18138,2035,1000.00,32000.00,33000.00,11989.13,20010.87,0.21,1
18139,2036,-787.31,-787.31,212.69,0.00,787.31,0.40,0
18140,2036,-212.69,-1000.00,0.00,35.21,177.48,0.33,0
18141,2037,-1000.00,-1000.00,0.00,176.33,823.67,0.27,0
18142,2038,0.00,0.00,1000.00,0.00,0.00,0.01,0
18143,2038,-1000.00,-1000.00,0.00,344.85,655.15,0.32,0
18144,2039,-1000.00,-1000.00,0.00,403.07,596.93,0.18,0
18145,2040,-1000.00,-1000.00,0.00,0.00,1000.00,0.08,0
18146,2041,-1000.00,-1000.00,0.00,366.41,633.59,0.31,0
18147,2042,-1000.00,-1000.00,0.00,0.00,1000.00,0.20,0
18148,2043,-1000.00,-1000.00,0.00,230.73,769.27,0.16,0
18149,2044,-111.22,-111.22,888.78,0.00,111.22,0.35,0
18150,2044,-888.78,-1000.00,0.00,95.35,793.43,0.30,0
18151,2045,1000.00,1000.00,2000.00,987.99,0.00,0.07,1
18152,2045,1000.00,2000.00,3000.00,328.62,0.00,0.11,1
18153,2045,0.00,2000.00,3000.00,0.00,0.00,0.40,0
18154,2045,1000.00,3000.00,4000.00,699.48,107.88,0.41,1
18155,2045,1000.00,4000.00,5000.00,3382.30,0.00,0.27,1
18156,2045,-1000.00,3000.00,4000.00,1122.04,2718.70,0.28,0
18157,2045,1000.00,4000.00,5000.00,1410.69,0.00,0.10,1
18158,2045,1000.00,5000.00,6000.00,3316.18,0.00,0.08,1
18159,2045,0.00,5000.00,6000.00,0.00,0.00,0.10,0
18160,2045,-1000.00,4000.00,5000.00,0.00,4995.38,0.08,0
18161,2045,1000.00,5000.00,6000.00,605.63,0.00,0.01,1
18162,2045,1000.00,6000.00,7000.00,4666.36,1067.75,0.18,1
18163,2045,-1000.00,5000.00,6000.00,0.00,5555.33,0.04,0
18164,2045,1000.00,6000.00,7000.00,6000.00,0.00,0.03,1
18165,2045,1000.00,7000.00,8000.00,2961.65,1698.20,0.26,1
18166,2045,-1000.00,6000.00,7000.00,602.71,1347.92,0.43,0
18167,2045,-1000.00,5000.00,6000.00,0.00,2503.99,0.20,0
18168,2045,1000.00,6000.00,7000.00,5901.36,98.64,0.41,1
18169,2045,0.00,6000.00,7000.00,0.00,0.00,0.05,0
18170,2045,1000.00,7000.00,8000.00,1902.70,837.27,0.40,1
18171,2045,0.00,7000.00,8000.00,0.00,0.00,0.01,0
18172,2045,-1000.00,6000.00,7000.00,0.00,1655.36,0.14,0
18173,2045,-1000.00,5000.00,6000.00,2634.64,0.00,0.34,0
18174,2045,-1000.00,4000.00,5000.00,0.00,2854.00,0.24,0
18175,2045,-1000.00,3000.00,4000.00,0.00,2288.13,0.19,0
18176,2045,0.00,3000.00,4000.00,0.00,0.00,0.19,0
18177,2045,-1000.00,2000.00,3000.00,0.00,2112.01,0.24,0
18178,2045,-1000.00,1000.00,2000.00,0.00,3000.00,0.08,0
18179,2045,-1000.00,0.00,1000.00,1095.36,904.64,0.13,0
18180,2045,-1000.00,-1000.00,0.00,483.64,516.36,0.01,0
18181,2046,-1000.00,-1000.00,0.00,223.49,776.51,0.22,0
18182,2046,-0.00,-1000.00,0.00,0.00,0.00,0.37,0
18183,2046,-0.00,-1000.00,0.00,0.00,0.00,0.39,0
18184,2046,-0.00,-1000.00,-0.00,0.00,0.00,0.12,0
18185,2047,-1000.00,-1000.00,0.00,0.00,1000.00,0.16,0
18186,2048,-1000.00,-1000.00,0.00,367.80,632.20,0.30,0
18187,2049,1000.00,1000.00,2000.00,277.17,633.33,0.33,1
18188,2049,1000.00,2000.00,3000.00,0.00,2000.00,0.16,1
18189,2049,1000.00,3000.00,4000.00,0.00,2094.14,0.13,1
18190,2049,1000.00,4000.00,5000.00,2000.00,2000.00,0.03,1
18191,2049,1000.00,5000.00,6000.00,2500.00,2500.00,0.03,1
18192,2049,1000.00,6000.00,7000.00,3000.00,3000.00,0.31,1
18193,2049,1000.00,7000.00,8000.00,0.00,7000.00,0.03,1
18194,2049,1000.00,8000.00,9000.00,4000.00,4000.00,0.06,1
18195,2049,1000.00,9000.00,10000.00,0.00,8846.24,0.20,1
18196,2049,1000.00,10000.00,11000.00,0.00,5485.73,0.29,1
18197,2049,1000.00,11000.00,12000.00,0.00,2807.12,0.18,1
18198,2049,1000.00,12000.00,13000.00,4120.23,7879.77,0.15,1
18199,2049,-1000.00,11000.00,12000.00,6875.57,6124.43,0.26,0
18200,2049,-1000.00,10000.00,11000.00,6134.33,5865.67,0.21,0
18201,2049,-1000.00,9000.00,10000.00,5457.17,0.00,0.05,0
18202,2049,1000.00,10000.00,11000.00,0.00,7115.56,0.40,1
18203,2049,-1000.00,9000.00,10000.00,9591.16,0.00,0.01,0
18204,2049,1000.00,10000.00,11000.00,0.00,10000.00,0.16,1
18205,2049,1000.00,11000.00,12000.00,0.00,11000.00,0.00,1
18206,2049,1000.00,12000.00,13000.00,5512.02,6487.98,0.16,1
18207,2049,1000.00,13000.00,14000.00,0.00,13000.00,0.37,1
18208,2049,1000.00,14000.00,15000.00,0.00,4783.73,0.13,1
18209,2049,1000.00,15000.00,16000.00,0.00,15000.00,0.00,1
18210,2049,1000.00,16000.00,17000.00,0.00,5283.77,0.04,1
18211,2049,1000.00,17000.00,18000.00,7687.92,8213.85,0.23,1
18212,2049,1000.00,18000.00,19000.00,0.00,7635.08,0.10,1
18213,2049,1000.00,19000.00,20000.00,0.00,18261.49,0.16,1
18214,2049,1000.00,20000.00,21000.00,6202.64,13797.36,0.39,1
18215,2049,1000.00,21000.00,22000.00,4925.10,16074.90,0.18,1
18216,2049,1000.00,22000.00,23000.00,0.00,17282.10,0.40,1
18217,2049,1000.00,23000.00,24000.00,8408.26,14591.74,0.26,1
18218,2049,1000.00,24000.00,25000.00,2220.81,10979.65,0.29,1
18219,2050,-1000.00,-1000.00,0.00,0.00,1000.00,0.15,0
18220,2051,-768.39,-768.39,231.61,0.00,768.39,0.41,0
18221,2051,0.00,-768.39,231.61,0.00,0.00,0.10,0
18222,2051,1000.00,231.61,1231.61,36.19,0.00,0.06,1
18223,2051,-1000.00,-768.39,231.61,0.00,1231.61,0.08,0
18224,2051,-231.61,-1000.00,0.00,95.65,135.97,0.42,0
18225,2052,-1000.00,-1000.00,0.00,0.00,1000.00,0.05,0
18226,2053,-1000.00,-1000.00,0.00,0.00,1000.00,0.11,0
18227,2054,-1000.00,-1000.00,0.00,385.56,614.44,0.30,0
18228,2055,-1000.00,-1000.00,0.00,553.20,446.80,0.09,0
18229,2056,-634.65,-634.65,365.35,0.00,634.65,0.31,0
18230,2056,-104.06,-738.71,261.29,0.00,104.06,0.08,0
18231,2056,-261.29,-1000.00,0.00,36.15,225.14,0.43,0
18232,2057,-389.91,-389.91,610.09,0.00,389.91,0.22,0
18233,2057,-610.09,-1000.00,0.00,184.18,425.91,0.30,0
18234,2058,-1000.00,-1000.00,0.00,0.00,1000.00,0.36,0
18235,2059,-580.47,-580.47,419.53,0.00,580.47,0.32,0
18236,2059,-419.53,-1000.00,0.00,0.00,419.53,0.29,0
18237,2060,-881.45,-881.45,118.55,0.00,881.45,0.34,0
18238,2060,-96.19,-977.64,22.36,0.00,96.19,0.06,0
18239,2060,-22.36,-1000.00,0.00,10.88,11.48,0.35,0
18240,2061,-1000.00,-1000.00,0.00,0.00,1000.00,0.27,0
18241,2062,-924.94,-924.94,75.06,0.00,924.94,0.41,0
18242,2062,-1000.00,-1924.94,-924.94,52.87,22.20,0.10,0
18243,2063,-912.77,-912.77,87.23,9.12,903.65,0.44,0
18244,2063,-87.23,-1000.00,0.00,0.00,87.23,0.27,0
18245,2064,-1000.00,-1000.00,0.00,0.00,367.11,0.19,0
18246,2065,-1000.00,-1000.00,0.00,518.17,481.83,0.11,0
18247,2066,-1000.00,-1000.00,0.00,134.68,865.32,0.41,0
18248,2067,-1000.00,-1000.00,0.00,0.00,1000.00,0.06,0
18249,2068,-1000.00,-1000.00,0.00,121.26,878.74,0.42,0
18250,2069,-1000.00,-1000.00,0.00,0.00,1000.00,0.38,0
18251,2070,1000.00,1000.00,2000.00,15.96,955.92,0.44,1
18252,2070,1000.00,2000.00,3000.00,0.00,2000.00,0.16,1
18253,2070,1000.00,3000.00,4000.00,0.00,3000.00,0.28,1
18254,2070,1000.00,4000.00,5000.00,456.08,3543.92,0.42,1
18255,2070,1000.00,5000.00,6000.00,0.00,5000.00,0.23,1
18256,2070,1000.00,6000.00,7000.00,0.00,4504.27,0.38,1
18257,2070,1000.00,7000.00,8000.00,0.00,2619.55,0.08,1
18258,2070,1000.00,8000.00,9000.00,1044.55,4521.75,0.33,1
18259,2070,1000.00,9000.00,10000.00,567.87,5937.70,0.38,1
18260,2070,-1000.00,8000.00,9000.00,5581.30,4418.70,0.15,0
18261,2070,1000.00,9000.00,10000.00,3454.96,5545.04,0.39,1
18262,2070,1000.00,10000.00,11000.00,2850.73,7149.27,0.36,1
18263,2070,1000.00,11000.00,12000.00,0.00,11000.00,0.02,1
18264,2070,1000.00,12000.00,13000.00,2844.05,9155.95,0.06,1
18265,2070,1000.00,13000.00,14000.00,0.00,13000.00,0.32,1
18266,2070,1000.00,14000.00,15000.00,4180.54,8127.44,0.31,1
18267,2070,1000.00,15000.00,16000.00,5604.04,9395.96,0.16,1
18268,2070,-1000.00,14000.00,15000.00,8907.53,7092.47,0.17,0
18269,2070,0.00,14000.00,15000.00,0.00,0.00,0.00,0
18270,2070,-1000.00,13000.00,14000.00,8624.86,6375.14,0.19,0
18271,2070,1000.00,14000.00,15000.00,0.00,14000.00,0.07,1
18272,2070,-1000.00,13000.00,14000.00,7500.00,7500.00,0.02,0
18273,2070,-1000.00,12000.00,13000.00,0.00,14000.00,0.10,0
18274,2070,-1000.00,11000.00,12000.00,3041.55,6297.71,0.28,0
18275,2070,-1000.00,10000.00,11000.00,0.00,12000.00,0.01,0
18276,2070,-1000.00,9000.00,10000.00,2447.43,8552.57,0.38,0
18277,2070,-1000.00,8000.00,9000.00,0.00,2092.45,0.08,0
18278,2070,-1000.00,7000.00,8000.00,0.00,9000.00,0.00,0
18279,2070,-1000.00,6000.00,7000.00,0.00,4558.78,0.31,0
18280,2070,-1000.00,5000.00,6000.00,3399.07,3600.93,0.41,0
18281,2070,-1000.00,4000.00,5000.00,0.00,6000.00,0.39,0
18282,2070,-1000.00,3000.00,4000.00,1174.92,3825.08,0.10,0
18283,2070,-397.37,2602.63,3602.63,0.00,397.37,0.10,0
18284,2070,-1000.00,1602.63,2602.63,1529.96,2072.67,0.15,0
18285,2070,-1000.00,602.63,1602.63,811.59,1791.05,0.33,0
18286,2070,-1000.00,-397.37,602.63,0.00,1602.63,0.25,0
18287,2070,-344.82,-742.19,257.81,0.00,344.82,0.34,0
18288,2070,1000.00,257.81,1257.81,0.00,234.07,0.18,1
18289,2070,1000.00,1257.81,2257.81,0.00,777.26,0.21,1
18290,2070,1000.00,2257.81,3257.81,312.05,1945.76,0.30,1
18291,2070,1000.00,3257.81,4257.81,0.00,3257.81,0.07,1
18292,2070,1000.00,4257.81,5257.81,816.49,1441.39,0.23,1
18293,2070,1000.00,5257.81,6257.81,1363.58,3894.23,0.10,1
18294,2070,1000.00,6257.81,7257.81,248.86,4982.90,0.42,1
18295,2070,1000.00,7257.81,8257.81,2127.71,5130.09,0.32,1
18296,2070,1000.00,8257.81,9257.81,0.00,8257.81,0.22,1
18297,2070,-1000.00,7257.81,8257.81,5153.98,4103.83,0.12,0
18298,2070,1000.00,8257.81,9257.81,2028.86,6228.94,0.38,1
18299,2070,1000.00,9257.81,10257.81,0.00,5190.49,0.32,1
18300,2070,1000.00,10257.81,11257.81,4762.15,5495.65,0.02,1
18301,2070,1000.00,11257.81,12257.81,0.00,8001.18,0.29,1
18302,2070,1000.00,12257.81,13257.81,755.29,11502.52,0.23,1
18303,2070,1000.00,13257.81,14257.81,0.00,13257.81,0.28,1
18304,2070,1000.00,14257.81,15257.81,4148.92,10108.89,0.40,1
18305,2070,-1000.00,13257.81,14257.81,6354.34,5548.09,0.25,0
18306,2070,1000.00,14257.81,15257.81,0.00,14257.81,0.29,1
18307,2070,1000.00,15257.81,16257.81,0.00,10428.90,0.32,1
18308,2070,1000.00,16257.81,17257.81,0.00,16257.81,0.14,1
18309,2070,1000.00,17257.81,18257.81,4759.47,12498.33,0.36,1
18310,2071,1000.00,1000.00,2000.00,70.19,929.81,0.25,1
18311,2071,1000.00,2000.00,3000.00,906.53,1093.47,0.17,1
18312,2071,1000.00,3000.00,4000.00,0.00,2295.21,0.27,1
18313,2071,1000.00,4000.00,5000.00,0.00,4000.00,0.09,1
18314,2071,1000.00,5000.00,6000.00,0.00,5000.00,0.43,1
18315,2071,1000.00,6000.00,7000.00,0.00,2884.59,0.31,1
18316,2071,1000.00,7000.00,8000.00,0.00,7000.00,0.03,1
18317,2071,1000.00,8000.00,9000.00,0.00,8000.00,0.39,1
18318,2071,1000.00,9000.00,10000.00,0.00,3585.83,0.28,1
18319,2071,1000.00,10000.00,11000.00,2685.88,7314.12,0.37,1
18320,2071,1000.00,11000.00,12000.00,4834.86,6165.14,0.20,1
18321,2071,1000.00,12000.00,13000.00,981.39,11018.61,0.34,1
18322,2071,1000.00,13000.00,14000.00,3893.62,9106.38,0.41,1
18323,2071,1000.00,14000.00,15000.00,0.00,6778.04,0.31,1
18324,2071,-1000.00,13000.00,14000.00,13989.45,0.00,0.09,0
18325,2071,1000.00,14000.00,15000.00,0.00,14000.00,0.32,1
18326,2071,1000.00,15000.00,16000.00,0.00,9901.64,0.31,1
18327,2071,1000.00,16000.00,17000.00,2077.63,13922.37,0.13,1
18328,2071,1000.00,17000.00,18000.00,319.08,16680.92,0.34,1
18329,2071,1000.00,18000.00,19000.00,0.00,5074.46,0.14,1
18330,2071,-1000.00,17000.00,18000.00,9944.71,9055.29,0.26,0
18331,2071,1000.00,18000.00,19000.00,4027.75,13972.25,0.32,1
18332,2071,-1000.00,17000.00,18000.00,7629.65,6012.68,0.19,0
18333,2071,1000.00,18000.00,19000.00,7605.78,10394.22,0.27,1
18334,2071,-1000.00,17000.00,18000.00,12064.55,6935.45,0.27,0
18335,2071,-1000.00,16000.00,17000.00,9000.00,9000.00,0.04,0
18336,2071,-1000.00,15000.00,16000.00,0.00,17000.00,0.36,0
18337,2071,-1000.00,14000.00,15000.00,0.00,11431.57,0.39,0
18338,2071,-1000.00,13000.00,14000.00,3702.78,11297.22,0.36,0
18339,2071,-1000.00,12000.00,13000.00,0.00,14000.00,0.06,0
18340,2071,-1000.00,11000.00,12000.00,7445.87,894.17,0.08,0
18341,2071,-1000.00,10000.00,11000.00,0.00,12000.00,0.20,0
18342,2071,-1000.00,9000.00,10000.00,4311.49,5985.90,0.22,0
18343,2071,-1000.00,8000.00,9000.00,388.27,6840.65,0.38,0
18344,2071,-1000.00,7000.00,8000.00,1785.27,7214.73,0.11,0
18345,2071,-1000.00,6000.00,7000.00,0.00,8000.00,0.41,0
18346,2071,-1000.00,5000.00,6000.00,3500.00,3500.00,0.32,0
18347,2071,-1000.00,4000.00,5000.00,0.00,6000.00,0.41,0
18348,2071,-1000.00,3000.00,4000.00,483.40,4516.60,0.34,0
18349,2071,-1000.00,2000.00,3000.00,0.00,4000.00,0.21,0
18350,2071,-1000.00,1000.00,2000.00,0.00,1742.18,0.34,0
18351,2071,-1000.00,0.00,1000.00,0.00,1030.56,0.09,0
18352,2071,1000.00,1000.00,2000.00,411.47,0.00,0.10,1
18353,2072,1000.00,1000.00,2000.00,448.70,551.30,0.18,1
18354,2072,1000.00,2000.00,3000.00,0.00,2000.00,0.25,1
18355,2072,-149.82,1850.18,2850.18,149.82,0.00,0.06,0
18356,2072,1000.00,2850.18,3850.18,828.64,1799.65,0.33,1
18357,2072,0.00,2850.18,3850.18,0.00,0.00,0.09,0
18358,2072,-1000.00,1850.18,2850.18,2565.19,1284.99,0.23,0
18359,2072,1000.00,2850.18,3850.18,0.00,2850.18,0.12,1
18360,2072,1000.00,3850.18,4850.18,0.00,3850.18,0.33,1
18361,2072,1000.00,4850.18,5850.18,2425.09,2425.09,0.09,1
18362,2072,1000.00,5850.18,6850.18,0.00,2876.23,0.04,1
18363,2072,-1000.00,4850.18,5850.18,4486.84,2363.35,0.10,0
18364,2072,-1000.00,3850.18,4850.18,3187.96,2662.22,0.34,0
18365,2072,-1000.00,2850.18,3850.18,3244.83,430.12,0.08,0
18366,2072,1000.00,3850.18,4850.18,0.00,104.24,0.09,1
18367,2072,1000.00,4850.18,5850.18,0.00,3106.65,0.02,1
18368,2072,-1000.00,3850.18,4850.18,3612.21,2237.97,0.10,0
18369,2072,1000.00,4850.18,5850.18,0.00,4850.18,0.19,1
18370,2072,1000.00,5850.18,6850.18,2372.20,3477.99,0.23,1
18371,2072,-1000.00,4850.18,5850.18,3297.33,2941.11,0.21,0
18372,2072,-1000.00,3850.18,4850.18,3903.33,0.00,0.09,0
18373,2072,1000.00,4850.18,5850.18,1722.73,3127.45,0.28,1
18374,2072,1000.00,5850.18,6850.18,0.00,5850.18,0.38,1
18375,2072,1000.00,6850.18,7850.18,0.00,6850.18,0.18,1
18376,2072,1000.00,7850.18,8850.18,1759.77,6090.41,0.20,1
18377,2072,1000.00,8850.18,9850.18,3987.91,4862.27,0.36,1
18378,2072,1000.00,9850.18,10850.18,2182.50,7164.09,0.38,1
18379,2072,1000.00,10850.18,11850.18,4364.50,6485.68,0.37,1
18380,2072,1000.00,11850.18,12850.18,1172.79,10677.39,0.44,1
18381,2072,1000.00,12850.18,13850.18,0.00,12850.18,0.21,1
18382,2072,1000.00,13850.18,14850.18,6925.09,6925.09,0.01,1
18383,2072,1000.00,14850.18,15850.18,0.00,14850.18,0.13,1
18384,2072,1000.00,15850.18,16850.18,0.00,15850.18,0.10,1
18385,2072,1000.00,16850.18,17850.18,0.00,16850.18,0.19,1
18386,2072,1000.00,17850.18,18850.18,5908.45,11941.73,0.31,1
18387,2072,-1000.00,16850.18,17850.18,10979.77,7870.41,0.16,0
18388,2072,-545.24,16304.94,17304.94,545.24,0.00,0.07,0
18389,2072,0.00,16304.94,17304.94,0.00,0.00,0.07,0
18390,2072,1000.00,17304.94,18304.94,1787.59,12232.52,0.39,1
18391,2072,1000.00,18304.94,19304.94,0.00,18304.94,0.23,1
18392,2072,1000.00,19304.94,20304.94,1177.84,18127.10,0.42,1
18393,2072,1000.00,20304.94,21304.94,0.00,20304.94,0.17,1
18394,2073,-835.65,-835.65,164.35,0.00,835.65,0.22,0
18395,2073,-164.35,-1000.00,0.00,67.43,96.92,0.20,0
18396,2074,-1000.00,-1000.00,0.00,0.00,583.91,0.39,0
18397,2075,-1000.00,-1000.00,0.00,500.00,500.00,0.05,0
18398,2076,-1000.00,-1000.00,0.00,0.00,1000.00,0.16,0
18399,2077,-384.08,-384.08,615.92,0.00,384.08,0.09,0
18400,2077,-1000.00,-1384.08,-384.08,334.95,167.89,0.14,0
18401,2078,-1000.00,-1000.00,0.00,0.00,1000.00,0.35,0
18402,2079,0.00,0.00,1000.00,0.00,0.00,0.01,0
18403,2079,0.00,0.00,1000.00,0.00,0.00,0.01,0
18404,2079,-1000.00,-1000.00,0.00,325.55,674.45,0.12,0
18405,2080,-1000.00,-1000.00,0.00,0.00,1000.00,0.23,0
18406,2081,-694.24,-694.24,305.76,219.82,474.42,0.29,0
18407,2081,-244.13,-938.37,61.63,0.00,244.13,0.15,0
18408,2081,-61.63,-1000.00,0.00,16.55,45.08,0.37,0
18409,2082,-1000.00,-1000.00,0.00,0.00,1000.00,0.36,0
18410,2083,-1000.00,-1000.00,0.00,627.00,373.00,0.06,0
18411,2084,-1000.00,-1000.00,0.00,523.12,476.88,0.06,0
18412,2085,-1000.00,-1000.00,0.00,0.00,401.72,0.10,0
18413,2086,-1000.00,-1000.00,0.00,500.00,500.00,0.07,0
18414,2087,-1000.00,-1000.00,0.00,530.33,418.10,0.19,0
18415,2088,-1000.00,-1000.00,0.00,440.93,559.07,0.18,0
18416,2089,1000.00,1000.00,2000.00,129.93,436.19,0.28,1
18417,2089,1000.00,2000.00,3000.00,0.00,2000.00,0.32,1
18418,2089,1000.00,3000.00,4000.00,0.00,3000.00,0.36,1
18419,2089,-1000.00,2000.00,3000.00,2206.56,1663.36,0.18,0
18420,2089,1000.00,3000.00,4000.00,6.73,2993.27,0.32,1
18421,2089,1000.00,4000.00,5000.00,1515.21,2484.79,0.22,1
18422,2089,-1000.00,3000.00,4000.00,4751.74,0.00,0.05,0
18423,2089,1000.00,4000.00,5000.00,0.00,1608.13,0.23,1
18424,2089,-1000.00,3000.00,4000.00,4143.43,439.01,0.07,0
18425,2089,1000.00,4000.00,5000.00,2000.00,2000.00,0.10,1
18426,2089,1000.00,5000.00,6000.00,2293.61,2706.39,0.19,1
18427,2089,1000.00,6000.00,7000.00,0.00,2954.78,0.12,1
18428,2089,-1000.00,5000.00,6000.00,4109.57,2890.43,0.39,0
18429,2089,1000.00,6000.00,7000.00,0.00,6000.00,0.43,1
18430,2089,-1000.00,5000.00,6000.00,6614.80,0.00,0.01,0
18431,2089,1000.00,6000.00,7000.00,2586.62,3413.38,0.23,1
18432,2089,1000.00,7000.00,8000.00,3012.11,3987.89,0.21,1
18433,2089,1000.00,8000.00,9000.00,0.00,8000.00,0.26,1
18434,2089,1000.00,9000.00,10000.00,2259.94,3994.40,0.26,1
18435,2089,1000.00,10000.00,11000.00,2102.45,7897.55,0.09,1
18436,2089,1000.00,11000.00,12000.00,1927.74,9072.26,0.42,1
18437,2089,-1000.00,10000.00,11000.00,6000.00,6000.00,0.21,0
18438,2089,-1000.00,9000.00,10000.00,0.00,9990.28,0.19,0
18439,2089,-1000.00,8000.00,9000.00,0.00,9331.53,0.43,0
18440,2089,-1000.00,7000.00,8000.00,2977.49,6022.51,0.30,0
18441,2089,0.00,7000.00,8000.00,0.00,0.00,0.06,0
18442,2089,-1000.00,6000.00,7000.00,0.00,5625.54,0.31,0
18443,2089,-1000.00,5000.00,6000.00,0.00,7000.00,0.29,0
18444,2089,-1000.00,4000.00,5000.00,0.00,6000.00,0.02,0
18445,2089,-1000.00,3000.00,4000.00,2102.61,2897.39,0.09,0
18446,2089,-504.92,2495.08,3495.08,0.00,504.92,0.15,0
18447,2089,-1000.00,1495.08,2495.08,697.69,0.00,0.06,0
18448,2089,-1000.00,495.08,1495.08,1098.61,1208.78,0.30,0
18449,2089,-1000.00,-504.92,495.08,0.00,1495.08,0.26,0
18450,2089,-495.08,-1000.00,0.00,0.00,495.08,0.24,0
18451,2090,-1000.00,-1000.00,0.00,99.05,900.95,0.34,0
18452,2091,1000.00,1000.00,2000.00,0.00,347.59,0.11,1
18453,2091,1000.00,2000.00,3000.00,811.54,1188.46,0.28,1
18454,2091,-1000.00,1000.00,2000.00,1954.70,1045.30,0.07,0
18455,2091,1000.00,2000.00,3000.00,0.00,1161.05,0.14,1
18456,2091,1000.00,3000.00,4000.00,1397.04,1602.96,0.25,1
18457,2091,1000.00,4000.00,5000.00,0.00,2986.73,0.32,1
18458,2091,-1000.00,3000.00,4000.00,2616.85,2383.15,0.17,0
18459,2091,1000.00,4000.00,5000.00,1846.01,2153.99,0.20,1
18460,2091,1000.00,5000.00,6000.00,2497.23,2502.77,0.19,1
18461,2091,1000.00,6000.00,7000.00,0.00,5653.71,0.43,1
18462,2091,1000.00,7000.00,8000.00,1916.72,5083.28,0.33,1
18463,2091,1000.00,8000.00,9000.00,0.00,3489.79,0.23,1
18464,2091,1000.00,9000.00,10000.00,2824.04,6175.96,0.33,1
18465,2091,1000.00,10000.00,11000.00,0.00,6596.91,0.26,1
18466,2091,1000.00,11000.00,12000.00,0.00,11000.00,0.17,1
18467,2091,1000.00,12000.00,13000.00,0.00,12000.00,0.28,1
18468,2091,1000.00,13000.00,14000.00,0.00,12098.53,0.42,1
18469,2091,-1000.00,12000.00,13000.00,8025.13,5974.87,0.32,0
18470,2091,1000.00,13000.00,14000.00,3614.09,9385.91,0.39,1
18471,2091,-1000.00,12000.00,13000.00,7826.20,6173.80,0.37,0
18472,2091,-1000.00,11000.00,12000.00,0.00,13000.00,0.23,0
18473,2091,-1000.00,10000.00,11000.00,0.00,12000.00,0.17,0
18474,2091,-1000.00,9000.00,10000.00,0.00,11000.00,0.15,0
18475,2091,-1000.00,8000.00,9000.00,4003.66,5996.34,0.34,0
18476,2091,-1000.00,7000.00,8000.00,7370.91,0.00,0.02,0
18477,2091,-1000.00,6000.00,7000.00,4093.37,3906.63,0.38,0
18478,2091,-1000.00,5000.00,6000.00,0.00,7000.00,0.38,0
18479,2091,0.00,5000.00,6000.00,0.00,0.00,0.03,0
18480,2091,-1000.00,4000.00,5000.00,2763.18,3236.82,0.17,0
18481,2091,-1000.00,3000.00,4000.00,3724.38,1275.62,0.13,0
18482,2091,-1000.00,2000.00,3000.00,2000.00,2000.00,0.02,0
18483,2091,-1000.00,1000.00,2000.00,1844.88,989.81,0.23,0
18484,2091,-1000.00,0.00,1000.00,848.64,1151.36,0.19,0
18485,2091,-353.53,-353.53,646.47,0.00,353.53,0.04,0
18486,2091,-622.74,-976.28,23.72,0.00,622.74,0.39,0
18487,2091,-23.72,-1000.00,0.00,11.49,12.23,0.09,0
18488,2092,-456.52,-456.52,543.48,0.00,456.52,0.12,0
18489,2092,-401.73,-858.26,141.74,0.00,401.73,0.36,0
18490,2092,-140.45,-998.71,1.29,0.00,140.45,0.32,0
18491,2092,-1000.00,-1998.71,-998.71,0.83,0.00,0.02,0
18492,2093,-285.69,-285.69,714.31,0.00,285.69,0.22,0
18493,2093,-497.40,-783.09,216.91,0.00,497.40,0.34,0
18494,2093,-163.10,-946.20,53.80,80.09,83.01,0.22,0
18495,2093,-53.80,-1000.00,0.00,0.00,53.80,0.19,0
18496,2094,-1000.00,-1000.00,0.00,28.48,328.50,0.24,0
18497,2095,1000.00,1000.00,2000.00,184.52,815.48,0.30,1
18498,2095,1000.00,2000.00,3000.00,0.00,1475.87,0.40,1
18499,2095,1000.00,3000.00,4000.00,0.00,1569.77,0.19,1
18500,2095,1000.00,4000.00,5000.00,0.00,4000.00,0.06,1
18501,2095,1000.00,5000.00,6000.00,1233.47,3766.53,0.27,1
18502,2095,1000.00,6000.00,7000.00,1395.42,4604.58,0.38,1
18503,2095,1000.00,7000.00,8000.00,0.00,4193.85,0.27,1
18504,2095,1000.00,8000.00,9000.00,1844.08,6155.92,0.34,1
18505,2095,1000.00,9000.00,10000.00,2994.19,6005.81,0.20,1
18506,2095,1000.00,10000.00,11000.00,1101.88,4232.51,0.27,1
18507,2095,1000.00,11000.00,12000.00,4443.03,6556.97,0.32,1
18508,2095,1000.00,12000.00,13000.00,2409.10,6719.11,0.33,1
18509,2095,1000.00,13000.00,14000.00,0.00,13000.00,0.13,1
18510,2095,1000.00,14000.00,15000.00,0.00,12935.20,0.11,1
18511,2095,-1000.00,13000.00,14000.00,10639.22,585.38,0.09,0
18512,2095,1000.00,14000.00,15000.00,0.00,9960.73,0.39,1
18513,2095,-1000.00,13000.00,14000.00,9387.91,5612.09,0.27,0
18514,2095,1000.00,14000.00,15000.00,0.00,14000.00,0.34,1
18515,2095,0.00,14000.00,15000.00,0.00,0.00,0.01,0
18516,2095,1000.00,15000.00,16000.00,4528.50,10471.50,0.34,1
18517,2095,1000.00,16000.00,17000.00,0.00,16000.00,0.33,1
18518,2095,1000.00,17000.00,18000.00,993.32,16006.68,0.44,1
18519,2095,-1000.00,16000.00,17000.00,0.00,18000.00,0.03,0
18520,2095,-1000.00,15000.00,16000.00,4866.31,0.00,0.09,0
18521,2095,-1000.00,14000.00,15000.00,0.00,16000.00,0.11,0
18522,2095,-1000.00,13000.00,14000.00,0.00,15000.00,0.26,0
18523,2095,-1000.00,12000.00,13000.00,0.00,6406.36,0.22,0
18524,2095,-1000.00,11000.00,12000.00,0.00,13000.00,0.20,0
18525,2095,-1000.00,10000.00,11000.00,7522.80,4477.20,0.20,0
18526,2095,-1000.00,9000.00,10000.00,0.00,11000.00,0.24,0
18527,2095,-1000.00,8000.00,9000.00,3469.49,6530.51,0.10,0
18528,2095,-1000.00,7000.00,8000.00,1194.55,0.00,0.03,0
18529,2095,0.00,7000.00,8000.00,0.00,0.00,0.05,0
18530,2095,-1000.00,6000.00,7000.00,0.00,5092.04,0.20,0
18531,2095,-1000.00,5000.00,6000.00,3100.54,3899.46,0.29,0
18532,2095,-1000.00,4000.00,5000.00,2601.90,3398.10,0.26,0
18533,2095,-1000.00,3000.00,4000.00,784.95,1923.60,0.25,0
18534,2095,-1000.00,2000.00,3000.00,2110.11,0.00,0.03,0
18535,2095,-1000.00,1000.00,2000.00,0.00,2081.75,0.23,0
18536,2095,-1000.00,0.00,1000.00,89.48,1910.52,0.38,0
18537,2095,-1000.00,-1000.00,0.00,0.00,1000.00,0.32,0
18538,2096,-1000.00,-1000.00,0.00,0.00,925.19,0.36,0
18539,2097,1000.00,1000.00,2000.00,487.27,512.73,0.17,1
18540,2097,1000.00,2000.00,3000.00,0.00,1156.69,0.25,1
18541,2097,1000.00,3000.00,4000.00,0.00,3000.00,0.13,1
18542,2097,-1000.00,2000.00,3000.00,2100.34,1899.66,0.27,0
18543,2097,1000.00,3000.00,4000.00,744.95,2255.05,0.20,1
18544,2097,1000.00,4000.00,5000.00,1631.65,2368.35,0.29,1
18545,2097,-1000.00,3000.00,4000.00,3026.06,1637.60,0.14,0
18546,2097,1000.00,4000.00,5000.00,2000.00,2000.00,0.21,1
18547,2097,1000.00,5000.00,6000.00,1923.00,1974.73,0.22,1
18548,2097,1000.00,6000.00,7000.00,1807.52,4192.48,0.35,1
18549,2097,1000.00,7000.00,8000.00,1908.42,5091.58,0.30,1
18550,2097,1000.00,8000.00,9000.00,0.00,8000.00,0.04,1
18551,2097,1000.00,9000.00,10000.00,858.85,8141.15,0.18,1
18552,2097,-1000.00,8000.00,9000.00,7325.32,2674.68,0.09,0
18553,2097,1000.00,9000.00,10000.00,3926.27,5073.73,0.16,1
18554,2097,1000.00,10000.00,11000.00,4967.69,5032.31,0.33,1
18555,2097,-1000.00,9000.00,10000.00,8624.39,2375.61,0.07,0
18556,2097,-1000.00,8000.00,9000.00,4211.85,3881.87,0.22,0
18557,2097,1000.00,9000.00,10000.00,792.20,8207.80,0.28,1
18558,2097,1000.00,10000.00,11000.00,3951.44,4101.22,0.25,1
18559,2097,1000.00,11000.00,12000.00,4496.31,6503.69,0.20,1
18560,2097,1000.00,12000.00,13000.00,0.00,2877.77,0.06,1
18561,2097,1000.00,13000.00,14000.00,0.00,13000.00,0.08,1
18562,2097,1000.00,14000.00,15000.00,0.00,6408.40,0.24,1
18563,2097,1000.00,15000.00,16000.00,4434.80,10565.20,0.35,1
18564,2097,1000.00,16000.00,17000.00,0.00,13063.80,0.35,1
18565,2097,1000.00,17000.00,18000.00,7418.98,9581.02,0.19,1
18566,2097,1000.00,18000.00,19000.00,8762.17,9237.83,0.05,1
18567,2097,1000.00,19000.00,20000.00,0.00,19000.00,0.12,1
18568,2097,1000.00,20000.00,21000.00,6185.67,13814.33,0.35,1
18569,2097,-1000.00,19000.00,20000.00,21000.00,0.00,0.09,0
18570,2097,1000.00,20000.00,21000.00,0.00,20000.00,0.22,1
18571,2097,1000.00,21000.00,22000.00,0.00,3586.51,0.13,1
18572,2097,1000.00,22000.00,23000.00,11000.00,11000.00,0.00,1
18573,2097,1000.00,23000.00,24000.00,0.00,9806.12,0.09,1
18574,2097,1000.00,24000.00,25000.00,0.00,22468.49,0.36,1
18575,2097,1000.00,25000.00,26000.00,4032.11,14744.59,0.34,1
18576,2097,-1000.00,24000.00,25000.00,25218.59,0.00,0.02,0
18577,2097,1000.00,25000.00,26000.00,8082.40,16917.60,0.06,1
18578,2097,1000.00,26000.00,27000.00,0.00,26000.00,0.31,1
18579,2097,1000.00,27000.00,28000.00,6994.01,20005.99,0.32,1
18580,2097,1000.00,28000.00,29000.00,0.00,6656.25,0.15,1
18581,2097,1000.00,29000.00,30000.00,0.00,4390.09,0.16,1
18582,2097,1000.00,30000.00,31000.00,15000.00,15000.00,0.04,1
18583,2097,-1000.00,29000.00,30000.00,20118.83,0.00,0.06,0
18584,2097,-1000.00,28000.00,29000.00,84.09,29915.91,0.42,0
18585,2097,-1000.00,27000.00,28000.00,0.00,12093.46,0.19,0
18586,2097,-1000.00,26000.00,27000.00,7204.13,20795.87,0.37,0
18587,2097,-1000.00,25000.00,26000.00,13500.00,13500.00,0.04,0
18588,2097,-1000.00,24000.00,25000.00,16623.60,9376.40,0.10,0
18589,2097,-1000.00,23000.00,24000.00,9090.76,15909.24,0.44,0
18590,2097,-1000.00,22000.00,23000.00,0.00,21976.09,0.37,0
18591,2097,-1000.00,21000.00,22000.00,0.00,13833.97,0.24,0
18592,2097,-1000.00,20000.00,21000.00,13458.93,8541.07,0.14,0
18593,2097,-1000.00,19000.00,20000.00,7005.17,13994.83,0.16,0
18594,2097,-1000.00,18000.00,19000.00,12669.16,1846.34,0.08,0
18595,2097,-1000.00,17000.00,18000.00,0.00,2115.62,0.12,0
18596,2097,-1000.00,16000.00,17000.00,4502.75,13497.25,0.04,0
18597,2097,-1000.00,15000.00,16000.00,5412.39,11587.61,0.05,0
18598,2097,-1000.00,14000.00,15000.00,9488.35,6511.65,0.13,0
18599,2097,-1000.00,13000.00,14000.00,1600.38,0.00,0.01,0
18600,2097,-1000.00,12000.00,13000.00,0.00,10091.63,0.13,0
18601,2097,-1000.00,11000.00,12000.00,2812.45,10187.55,0.40,0
18602,2097,-1000.00,10000.00,11000.00,0.00,12000.00,0.23,0
18603,2097,-1000.00,9000.00,10000.00,4946.18,6053.82,0.16,0
18604,2097,-1000.00,8000.00,9000.00,0.00,9808.79,0.29,0
18605,2097,0.00,8000.00,9000.00,0.00,0.00,0.02,0
18606,2097,-1000.00,7000.00,8000.00,0.00,7591.54,0.19,0
18607,2098,1000.00,1000.00,2000.00,0.00,1000.00,0.35,1
18608,2098,1000.00,2000.00,3000.00,71.94,1928.06,0.11,1
18609,2098,1000.00,3000.00,4000.00,1264.77,1735.23,0.27,1
18610,2098,1000.00,4000.00,5000.00,0.00,2347.51,0.21,1
18611,2098,1000.00,5000.00,6000.00,38.74,2200.88,0.28,1
18612,2098,1000.00,6000.00,7000.00,2166.76,3833.24,0.32,1
18613,2098,1000.00,7000.00,8000.00,174.71,6825.29,0.44,1
18614,2098,1000.00,8000.00,9000.00,0.00,8000.00,0.42,1
18615,2098,1000.00,9000.00,10000.00,2065.90,6934.10,0.39,1
18616,2098,1000.00,10000.00,11000.00,0.00,5615.67,0.00,1
18617,2098,1000.00,11000.00,12000.00,0.00,11000.00,0.39,1
18618,2098,1000.00,12000.00,13000.00,0.00,8713.34,0.28,1
18619,2098,1000.00,13000.00,14000.00,5785.86,7214.14,0.18,1
18620,2098,1000.00,14000.00,15000.00,0.00,6544.55,0.26,1
18621,2098,1000.00,15000.00,16000.00,4584.40,7783.33,0.28,1
18622,2098,1000.00,16000.00,17000.00,1762.15,14237.85,0.44,1
18623,2098,1000.00,17000.00,18000.00,6517.39,10482.61,0.22,1
18624,2098,1000.00,18000.00,19000.00,1527.07,7305.97,0.27,1
18625,2098,1000.00,19000.00,20000.00,0.00,19000.00,0.17,1
18626,2098,1000.00,20000.00,21000.00,2222.85,17777.15,0.37,1
18627,2098,1000.00,21000.00,22000.00,578.04,19955.22,0.44,1
18628,2098,1000.00,22000.00,23000.00,8243.06,13756.94,0.31,1
18629,2098,1000.00,23000.00,24000.00,3707.29,5282.03,0.19,1
18630,2098,1000.00,24000.00,25000.00,12000.00,12000.00,0.12,1
18631,2098,1000.00,25000.00,26000.00,2490.87,22509.13,0.23,1
18632,2098,1000.00,26000.00,27000.00,0.00,26000.00,0.16,1
18633,2098,1000.00,27000.00,28000.00,0.00,22021.18,0.34,1
18634,2098,1000.00,28000.00,29000.00,3273.47,24726.53,0.04,1
18635,2098,1000.00,29000.00,30000.00,0.00,29000.00,0.05,1
18636,2098,1000.00,30000.00,31000.00,0.00,22717.86,0.28,1
18637,2098,-1000.00,29000.00,30000.00,5604.88,0.00,0.01,0
18638,2098,1000.00,30000.00,31000.00,0.00,30000.00,0.33,1
18639,2098,1000.00,31000.00,32000.00,15172.42,15827.58,0.19,1
18640,2098,-1000.00,30000.00,31000.00,12566.84,2697.25,0.08,0
18641,2098,1000.00,31000.00,32000.00,1947.38,29052.62,0.44,1
18642,2098,1000.00,32000.00,33000.00,4456.30,27543.70,0.43,1
18643,2098,1000.00,33000.00,34000.00,16500.00,16500.00,0.06,1
18644,2098,1000.00,34000.00,35000.00,15676.70,18323.30,0.15,1
18645,2098,-1000.00,33000.00,34000.00,21904.70,13095.30,0.13,0
18646,2098,1000.00,34000.00,35000.00,0.00,34000.00,0.29,1
18647,2099,1000.00,1000.00,2000.00,236.58,763.42,0.38,1
18648,2099,-1000.00,0.00,1000.00,401.51,1598.49,0.41,0
18649,2099,-1000.00,-1000.00,0.00,177.50,822.50,0.21,0
18650,2100,-1000.00,-1000.00,0.00,313.94,686.06,0.35,0
18651,2101,-1000.00,-1000.00,0.00,0.00,1000.00,0.18,0
18652,2102,-1000.00,-1000.00,0.00,0.00,1000.00,0.07,0
18653,2103,-1000.00,-1000.00,0.00,429.02,570.98,0.19,0
18654,2104,-1000.00,-1000.00,0.00,0.00,1000.00,0.12,0
18655,2105,-1000.00,-1000.00,0.00,3.30,996.70,0.44,0
18656,2106,-1000.00,-1000.00,0.00,504.78,495.22,0.20,0
18657,2107,-1000.00,-1000.00,0.00,0.00,1000.00,0.15,0
18658,2108,1000.00,1000.00,2000.00,239.09,760.91,0.34,1
18659,2108,1000.00,2000.00,3000.00,0.00,2000.00,0.06,1
18660,2108,1000.00,3000.00,4000.00,934.63,2065.37,0.30,1
18661,2108,-1000.00,2000.00,3000.00,2189.14,1810.86,0.38,0
18662,2108,-1000.00,1000.00,2000.00,1200.96,0.00,0.01,0
18663,2108,1000.00,2000.00,3000.00,701.48,788.55,0.22,1
18664,2108,1000.00,3000.00,4000.00,1055.64,1944.36,0.30,1
18665,2108,1000.00,4000.00,5000.00,61.99,3938.01,0.19,1
18666,2108,1000.00,5000.00,6000.00,990.75,4009.25,0.34,1
18667,2108,1000.00,6000.00,7000.00,2235.15,3764.85,0.39,1
18668,2108,1000.00,7000.00,8000.00,0.00,7000.00,0.10,1
18669,2108,1000.00,8000.00,9000.00,3059.43,4940.57,0.25,1
18670,2108,1000.00,9000.00,10000.00,968.26,8031.74,0.39,1
18671,2108,1000.00,10000.00,11000.00,0.00,10000.00,0.13,1
18672,2108,1000.00,11000.00,12000.00,2623.48,8376.52,0.35,1
18673,2108,1000.00,12000.00,13000.00,0.00,12000.00,0.26,1
18674,2108,1000.00,13000.00,14000.00,0.00,3191.94,0.13,1
18675,2108,1000.00,14000.00,15000.00,0.00,14000.00,0.02,1
18676,2108,1000.00,15000.00,16000.00,0.00,14146.44,0.43,1
18677,2108,1000.00,16000.00,17000.00,1387.38,11759.91,0.34,1
18678,2108,1000.00,17000.00,18000.00,6047.20,10952.80,0.37,1
18679,2108,-1000.00,16000.00,17000.00,9000.00,9000.00,0.30,0
18680,2108,-1000.00,15000.00,16000.00,0.00,17000.00,0.21,0
18681,2108,-1000.00,14000.00,15000.00,8000.00,8000.00,0.07,0
18682,2108,-1000.00,13000.00,14000.00,4241.29,10758.71,0.19,0
18683,2108,-1000.00,12000.00,13000.00,291.26,13708.74,0.32,0
18684,2108,-1000.00,11000.00,12000.00,0.00,13000.00,0.10,0
18685,2108,-1000.00,10000.00,11000.00,4232.15,7767.85,0.32,0
18686,2108,-1000.00,9000.00,10000.00,0.00,11000.00,0.16,0
18687,2108,-1000.00,8000.00,9000.00,0.00,9586.62,0.24,0
18688,2108,-1000.00,7000.00,8000.00,0.00,8420.02,0.31,0
18689,2108,-1000.00,6000.00,7000.00,0.00,8000.00,0.33,0
18690,2108,-1000.00,5000.00,6000.00,2295.78,4498.69,0.32,0
18691,2108,-1000.00,4000.00,5000.00,3000.00,3000.00,0.12,0
18692,2108,-1000.00,3000.00,4000.00,1055.73,3944.27,0.40,0
18693,2108,-1000.00,2000.00,3000.00,0.00,4000.00,0.27,0
18694,2108,-1000.00,1000.00,2000.00,1526.71,1473.29,0.25,0
18695,2108,-1000.00,0.00,1000.00,893.09,0.00,0.07,0
18696,2108,-872.61,-872.61,127.39,0.00,872.61,0.32,0
18697,2108,-127.39,-1000.00,0.00,49.15,78.24,0.29,0
18698,2109,-657.01,-657.01,342.99,657.01,0.00,0.03,0
18699,2109,1000.00,342.99,1342.99,0.00,342.99,0.39,1
18700,2109,1000.00,1342.99,2342.99,250.79,1092.20,0.11,1
18701,2109,1000.00,2342.99,3342.99,128.57,2214.42,0.44,1
18702,2109,1000.00,3342.99,4342.99,1671.50,1671.50,0.03,1
18703,2109,1000.00,4342.99,5342.99,797.77,3545.22,0.42,1
18704,2109,1000.00,5342.99,6342.99,2334.96,3008.03,0.26,1
18705,2109,1000.00,6342.99,7342.99,0.00,2117.26,0.24,1
18706,2109,1000.00,7342.99,8342.99,3322.00,4020.99,0.17,1
18707,2109,1000.00,8342.99,9342.99,2098.76,6244.24,0.31,1
18708,2109,1000.00,9342.99,10342.99,2331.84,7011.16,0.21,1
18709,2109,1000.00,10342.99,11342.99,717.31,9625.68,0.25,1
18710,2109,1000.00,11342.99,12342.99,5606.05,5736.94,0.41,1
18711,2109,1000.00,12342.99,13342.99,3739.11,8603.89,0.35,1
18712,2109,1000.00,13342.99,14342.99,0.00,11447.01,0.35,1
18713,2109,1000.00,14342.99,15342.99,4499.74,9843.26,0.27,1
18714,2109,1000.00,15342.99,16342.99,6235.47,9107.52,0.24,1
18715,2109,1000.00,16342.99,17342.99,8171.50,8171.50,0.20,1
18716,2109,1000.00,17342.99,18342.99,995.36,14784.09,0.43,1
18717,2109,-1000.00,16342.99,17342.99,13521.43,4821.57,0.20,0
18718,2109,1000.00,17342.99,18342.99,0.00,11137.97,0.24,1
18719,2109,1000.00,18342.99,19342.99,1599.12,16743.88,0.10,1
18720,2109,-1000.00,17342.99,18342.99,10407.64,8935.35,0.19,0
18721,2109,1000.00,18342.99,19342.99,7509.37,10833.63,0.10,1
18722,2109,1000.00,19342.99,20342.99,3835.20,9277.80,0.29,1
18723,2109,1000.00,20342.99,21342.99,0.00,20342.99,0.17,1
18724,2109,1000.00,21342.99,22342.99,2314.38,19021.73,0.43,1
18725,2109,1000.00,22342.99,23342.99,5126.65,11348.30,0.21,1
18726,2109,1000.00,23342.99,24342.99,5747.89,17595.10,0.39,1
18727,2109,0.00,23342.99,24342.99,0.00,0.00,0.00,0
18728,2109,1000.00,24342.99,25342.99,6423.65,17919.35,0.35,1
18729,2109,1000.00,25342.99,26342.99,0.00,21425.53,0.05,1
18730,2109,1000.00,26342.99,27342.99,9599.23,16743.77,0.24,1
18731,2109,1000.00,27342.99,28342.99,4748.89,11868.41,0.29,1
18732,2109,1000.00,28342.99,29342.99,11420.52,16922.48,0.17,1
18733,2109,1000.00,29342.99,30342.99,13640.67,15702.32,0.26,1
18734,2109,1000.00,30342.99,31342.99,0.00,30342.99,0.28,1
18735,2109,-1000.00,29342.99,30342.99,19391.12,11951.87,0.10,0
18736,2109,1000.00,30342.99,31342.99,12800.14,17542.86,0.38,1
18737,2110,-753.66,-753.66,246.34,120.50,633.16,0.36,0
18738,2110,-246.34,-1000.00,0.00,0.00,246.34,0.11,0
18739,2111,1000.00,1000.00,2000.00,508.72,491.28,0.20,1
18740,2111,-1000.00,0.00,1000.00,0.00,2000.00,0.34,0
18741,2111,-1000.00,-1000.00,0.00,333.47,666.53,0.19,0
18742,2112,-899.31,-899.31,100.69,0.00,899.31,0.16,0
18743,2112,-74.86,-974.16,25.84,0.00,74.86,0.38,0
18744,2112,1000.00,25.84,1025.84,6.76,0.00,0.38,1
18745,2112,1000.00,1025.84,2025.84,793.58,232.25,0.22,1
18746,2112,-1000.00,25.84,1025.84,111.28,1591.01,0.32,0
18747,2112,-864.08,-838.24,161.76,0.00,864.08,0.01,0
18748,2112,1000.00,161.76,1161.76,97.39,64.38,0.08,1
18749,2112,-1000.00,-838.24,161.76,562.57,599.19,0.38,0
18750,2112,1000.00,161.76,1161.76,83.86,77.90,0.12,1
18751,2112,-1000.00,-838.24,161.76,262.33,899.44,0.00,0
18752,2112,-161.76,-1000.00,0.00,66.66,95.10,0.06,0
18753,2113,-1000.00,-1000.00,0.00,425.11,574.89,0.19,0
18754,2114,1000.00,1000.00,2000.00,423.93,576.07,0.24,1
18755,2114,1000.00,2000.00,3000.00,914.69,1085.31,0.18,1
18756,2114,1000.00,3000.00,4000.00,282.59,2717.41,0.43,1
18757,2114,1000.00,4000.00,5000.00,1265.34,2734.66,0.01,1
18758,2114,1000.00,5000.00,6000.00,2289.21,2710.79,0.22,1
18759,2114,1000.00,6000.00,7000.00,3000.00,3000.00,0.04,1
18760,2114,1000.00,7000.00,8000.00,261.90,6626.55,0.44,1
18761,2114,1000.00,8000.00,9000.00,2360.47,5639.53,0.36,1
18762,2114,1000.00,9000.00,10000.00,3275.68,5724.32,0.26,1
18763,2114,1000.00,10000.00,11000.00,0.00,10000.00,0.32,1
18764,2114,1000.00,11000.00,12000.00,0.00,11000.00,0.21,1
18765,2114,1000.00,12000.00,13000.00,1558.78,10441.22,0.24,1
18766,2114,1000.00,13000.00,14000.00,0.00,13000.00,0.26,1
18767,2114,1000.00,14000.00,15000.00,3048.30,10951.70,0.38,1
18768,2114,-1000.00,13000.00,14000.00,5030.99,726.89,0.11,0
18769,2114,1000.00,14000.00,15000.00,770.61,11197.23,0.42,1
18770,2114,1000.00,15000.00,16000.00,5756.91,9243.09,0.18,1
18771,2114,1000.00,16000.00,17000.00,1135.85,14864.15,0.16,1
18772,2114,1000.00,17000.00,18000.00,5066.86,11933.14,0.34,1
18773,2114,-1000.00,16000.00,17000.00,12936.24,1890.10,0.07,0
18774,2114,1000.00,17000.00,18000.00,0.00,1859.28,0.14,1
18775,2114,1000.00,18000.00,19000.00,3984.18,14015.82,0.39,1
18776,2114,1000.00,19000.00,20000.00,0.00,19000.00,0.15,1
18777,2114,1000.00,20000.00,21000.00,5164.31,14835.69,0.37,1
18778,2114,1000.00,21000.00,22000.00,0.00,21000.00,0.14,1
18779,2114,1000.00,22000.00,23000.00,2929.11,12858.87,0.34,1
18780,2114,1000.00,23000.00,24000.00,0.00,11854.52,0.21,1
18781,2114,1000.00,24000.00,25000.00,12000.00,12000.00,0.16,1
18782,2114,1000.00,25000.00,26000.00,10600.44,14399.56,0.27,1
18783,2114,1000.00,26000.00,27000.00,255.91,7824.83,0.22,1
18784,2114,1000.00,27000.00,28000.00,0.00,27000.00,0.24,1
18785,2114,1000.00,28000.00,29000.00,0.00,28000.00,0.15,1
18786,2114,1000.00,29000.00,30000.00,5802.02,23197.98,0.41,1
18787,2114,1000.00,30000.00,31000.00,0.00,12684.33,0.15,1
18788,2114,1000.00,31000.00,32000.00,0.00,31000.00,0.10,1
18789,2114,1000.00,32000.00,33000.00,9027.01,22972.99,0.33,1
18790,2114,1000.00,33000.00,34000.00,6247.73,26752.27,0.13,1
18791,2114,-1000.00,32000.00,33000.00,34000.00,0.00,0.01,0
18792,2114,1000.00,33000.00,34000.00,0.00,33000.00,0.30,1
18793,2114,-1000.00,32000.00,33000.00,16470.66,9601.64,0.16,0
18794,2114,1000.00,33000.00,34000.00,8703.51,23410.22,0.36,1
18795,2114,1000.00,34000.00,35000.00,11776.37,18551.26,0.20,1
18796,2114,1000.00,35000.00,36000.00,0.00,35000.00,0.16,1
18797,2114,0.00,35000.00,36000.00,0.00,0.00,0.05,0
18798,2114,1000.00,36000.00,37000.00,16162.57,19837.43,0.12,1
18799,2114,-1000.00,35000.00,36000.00,22618.67,14381.33,0.12,0
18800,2114,1000.00,36000.00,37000.00,0.00,32953.17,0.20,1
18801,2114,-1000.00,35000.00,36000.00,18500.00,18500.00,0.01,0
18802,2114,-1000.00,34000.00,35000.00,4528.59,3256.66,0.14,0
18803,2114,-1000.00,33000.00,34000.00,0.00,35000.00,0.05,0
18804,2114,-1000.00,32000.00,33000.00,0.00,34000.00,0.35,0
18805,2114,-1000.00,31000.00,32000.00,16500.00,16500.00,0.34,0
18806,2114,-1000.00,30000.00,31000.00,13114.70,18885.30,0.27,0
18807,2114,-1000.00,29000.00,30000.00,21398.40,9601.60,0.10,0
18808,2114,-1000.00,28000.00,29000.00,0.00,30000.00,0.27,0
18809,2114,-1000.00,27000.00,28000.00,0.00,29000.00,0.08,0
18810,2114,-1000.00,26000.00,27000.00,9606.78,18393.22,0.29,0
18811,2114,-1000.00,25000.00,26000.00,0.00,20875.44,0.35,0
18812,2114,-1000.00,24000.00,25000.00,13000.00,13000.00,0.07,0
18813,2114,-1000.00,23000.00,24000.00,4066.64,20933.36,0.14,0
18814,2114,-1000.00,22000.00,23000.00,0.00,24000.00,0.24,0
18815,2114,-1000.00,21000.00,22000.00,10183.34,12816.66,0.26,0
18816,2114,-1000.00,20000.00,21000.00,0.00,22000.00,0.24,0
18817,2114,-1000.00,19000.00,20000.00,0.00,7775.66,0.17,0
18818,2114,-1000.00,18000.00,19000.00,5243.97,9747.06,0.28,0
18819,2114,-1000.00,17000.00,18000.00,7649.10,11350.90,0.28,0
18820,2114,-1000.00,16000.00,17000.00,9000.00,9000.00,0.06,0
18821,2114,-1000.00,15000.00,16000.00,0.00,15552.17,0.28,0
18822,2115,-1000.00,-1000.00,0.00,106.62,893.38,0.13,0
18823,2116,-656.10,-656.10,343.90,0.00,656.10,0.33,0
18824,2116,-343.90,-1000.00,0.00,0.00,343.90,0.05,0
18825,2117,-1000.00,-1000.00,0.00,480.31,519.69,0.23,0
18826,2118,1000.00,1000.00,2000.00,265.74,27.49,0.14,1
18827,2118,-310.23,689.77,1689.77,0.00,310.23,0.04,0
18828,2118,-457.10,232.67,1232.67,0.00,457.10,0.33,0
18829,2118,1000.00,1232.67,2232.67,734.00,498.67,0.22,1
18830,2118,-900.88,331.80,1331.80,0.00,900.88,0.23,0
18831,2118,-1000.00,-668.20,331.80,0.00,1331.80,0.30,0
18832,2118,-254.01,-922.21,77.79,0.00,254.01,0.42,0
18833,2118,-77.79,-1000.00,0.00,38.89,38.89,0.12,0
18834,2119,1000.00,1000.00,2000.00,0.00,1000.00,0.43,1
18835,2119,1000.00,2000.00,3000.00,0.00,300.13,0.11,1
18836,2119,-1000.00,1000.00,2000.00,2604.54,395.46,0.15,0
18837,2119,1000.00,2000.00,3000.00,0.00,2000.00,0.05,1
18838,2119,-1000.00,1000.00,2000.00,1899.92,775.24,0.16,0
18839,2119,-1000.00,0.00,1000.00,1840.12,159.88,0.06,0
18840,2119,-1000.00,-1000.00,0.00,534.64,465.36,0.15,0
18841,2120,-1000.00,-1000.00,0.00,570.37,429.63,0.09,0
18842,2121,1000.00,1000.00,2000.00,402.99,585.07,0.28,1
18843,2121,1000.00,2000.00,3000.00,0.00,1694.43,0.15,1
18844,2121,1000.00,3000.00,4000.00,0.00,3000.00,0.32,1
18845,2121,1000.00,4000.00,5000.00,0.00,3364.00,0.42,1
18846,2121,1000.00,5000.00,6000.00,0.00,4460.02,0.43,1
18847,2121,1000.00,6000.00,7000.00,3000.00,3000.00,0.11,1
18848,2121,1000.00,7000.00,8000.00,2091.83,4908.17,0.33,1
18849,2121,1000.00,8000.00,9000.00,0.00,5402.47,0.21,1
18850,2121,-535.73,7464.27,8464.27,535.73,0.00,0.02,0
18851,2121,1000.00,8464.27,9464.27,0.00,909.98,0.12,1
18852,2121,1000.00,9464.27,10464.27,4732.13,4732.13,0.24,1
18853,2121,1000.00,10464.27,11464.27,0.00,10464.27,0.02,1
18854,2121,-1000.00,9464.27,10464.27,2604.43,8859.84,0.28,0
18855,2121,-1000.00,8464.27,9464.27,0.00,8097.49,0.25,0
18856,2121,-1000.00,7464.27,8464.27,0.00,9464.27,0.24,0
18857,2121,-1000.00,6464.27,7464.27,0.00,2162.17,0.05,0
18858,2121,-1000.00,5464.27,6464.27,0.00,7464.27,0.18,0
18859,2121,-1000.00,4464.27,5464.27,6464.27,0.00,0.00,0
18860,2121,-1000.00,3464.27,4464.27,0.00,5464.27,0.07,0
18861,2121,-1000.00,2464.27,3464.27,0.00,4171.39,0.32,0
18862,2121,-1000.00,1464.27,2464.27,1182.05,2282.22,0.25,0
18863,2121,1000.00,2464.27,3464.27,1545.51,0.00,0.01,1
18864,2121,-1000.00,1464.27,2464.27,1591.05,1873.22,0.27,0
18865,2121,-1000.00,464.27,1464.27,764.35,1699.92,0.22,0
18866,2121,-1000.00,-535.73,464.27,575.65,888.62,0.23,0
18867,2121,-464.27,-1000.00,0.00,217.75,246.52,0.44,0
18868,2122,1000.00,1000.00,2000.00,284.71,715.29,0.14,1
18869,2122,1000.00,2000.00,3000.00,328.46,672.68,0.23,1
18870,2122,1000.00,3000.00,4000.00,1406.56,1593.44,0.04,1
18871,2122,1000.00,4000.00,5000.00,1596.48,2403.52,0.16,1
18872,2122,1000.00,5000.00,6000.00,2383.15,2616.85,0.44,1
18873,2122,1000.00,6000.00,7000.00,827.81,5172.19,0.43,1
18874,2122,1000.00,7000.00,8000.00,721.89,5351.72,0.40,1
18875,2122,1000.00,8000.00,9000.00,3464.46,4535.54,0.15,1
18876,2122,1000.00,9000.00,10000.00,290.38,8709.62,0.44,1
18877,2122,1000.00,10000.00,11000.00,2133.81,7866.19,0.14,1
18878,2122,-1000.00,9000.00,10000.00,5643.32,5356.68,0.22,0
18879,2122,1000.00,10000.00,11000.00,0.00,6802.92,0.06,1
18880,2122,1000.00,11000.00,12000.00,0.00,11000.00,0.32,1
18881,2122,1000.00,12000.00,13000.00,0.00,7987.69,0.21,1
18882,2122,1000.00,13000.00,14000.00,3002.24,9997.76,0.14,1
18883,2122,1000.00,14000.00,15000.00,809.60,13190.40,0.09,1
18884,2122,1000.00,15000.00,16000.00,0.00,4032.97,0.17,1
18885,2122,1000.00,16000.00,17000.00,0.00,16000.00,0.40,1
18886,2122,1000.00,17000.00,18000.00,8500.00,8500.00,0.02,1
18887,2122,1000.00,18000.00,19000.00,0.00,16965.56,0.10,1
18888,2122,1000.00,19000.00,20000.00,0.00,5009.78,0.09,1
18889,2122,1000.00,20000.00,21000.00,0.00,4768.51,0.20,1
18890,2122,1000.00,21000.00,22000.00,10267.28,10732.72,0.14,1
18891,2122,1000.00,22000.00,23000.00,0.00,22000.00,0.05,1
18892,2122,1000.00,23000.00,24000.00,0.00,23000.00,0.21,1
18893,2122,1000.00,24000.00,25000.00,1380.18,22619.82,0.40,1
18894,2122,-1000.00,23000.00,24000.00,12970.96,12029.04,0.20,0
18895,2122,1000.00,24000.00,25000.00,12000.00,12000.00,0.03,1
18896,2122,-1000.00,23000.00,24000.00,16985.20,8014.80,0.02,0
18897,2122,-1000.00,22000.00,23000.00,12813.74,11186.26,0.04,0
18898,2122,1000.00,23000.00,24000.00,0.00,10397.33,0.06,1
18899,2122,1000.00,24000.00,25000.00,0.00,21209.52,0.03,1
18900,2122,0.00,24000.00,25000.00,0.00,0.00,0.04,0
18901,2122,1000.00,25000.00,26000.00,11687.43,13312.57,0.12,1
18902,2122,1000.00,26000.00,27000.00,0.00,26000.00,0.36,1
18903,2122,1000.00,27000.00,28000.00,3123.34,23876.66,0.29,1
18904,2122,1000.00,28000.00,29000.00,0.00,6538.27,0.17,1
18905,2122,1000.00,29000.00,30000.00,0.00,27534.52,0.33,1
18906,2122,1000.00,30000.00,31000.00,0.00,13663.28,0.16,1
18907,2122,-1000.00,29000.00,30000.00,19614.64,11385.36,0.05,0
18908,2122,1000.00,30000.00,31000.00,8781.74,21218.26,0.15,1
18909,2123,-1000.00,-1000.00,0.00,269.07,730.93,0.36,0
18910,2124,1000.00,1000.00,2000.00,101.33,898.67,0.43,1
18911,2124,-1000.00,0.00,1000.00,1710.63,289.37,0.03,0
18912,2124,1000.00,1000.00,2000.00,0.00,1000.00,0.25,1
18913,2124,1000.00,2000.00,3000.00,1000.00,1000.00,0.01,1
18914,2124,1000.00,3000.00,4000.00,1.36,2808.85,0.44,1
18915,2124,-1000.00,2000.00,3000.00,2761.63,1238.37,0.25,0
18916,2124,1000.00,3000.00,4000.00,1500.00,1500.00,0.10,1
18917,2124,1000.00,4000.00,5000.00,855.88,3144.12,0.38,1
18918,2124,1000.00,5000.00,6000.00,0.00,3932.80,0.29,1
18919,2124,1000.00,6000.00,7000.00,817.75,5182.25,0.28,1
18920,2124,1000.00,7000.00,8000.00,0.00,7000.00,0.40,1
18921,2124,1000.00,8000.00,9000.00,0.00,4862.72,0.06,1
18922,2124,1000.00,9000.00,10000.00,0.00,5140.11,0.29,1
18923,2124,1000.00,10000.00,11000.00,5000.00,5000.00,0.06,1
18924,2124,1000.00,11000.00,12000.00,4528.45,6471.55,0.23,1
18925,2124,1000.00,12000.00,13000.00,3718.14,8281.86,0.23,1
18926,2124,-1000.00,11000.00,12000.00,7202.79,5797.21,0.18,0
18927,2124,1000.00,12000.00,13000.00,3237.64,5412.28,0.14,1
18928,2124,1000.00,13000.00,14000.00,399.66,12600.34,0.35,1
18929,2124,1000.00,14000.00,15000.00,5511.87,8488.13,0.39,1
18930,2124,-1000.00,13000.00,14000.00,7500.00,7500.00,0.13,0
18931,2124,-1000.00,12000.00,13000.00,7000.00,7000.00,0.04,0
18932,2124,-1000.00,11000.00,12000.00,5968.73,7031.27,0.20,0
18933,2124,-1000.00,10000.00,11000.00,1873.57,8711.52,0.39,0
18934,2124,-1000.00,9000.00,10000.00,0.00,5965.48,0.17,0
18935,2124,-1000.00,8000.00,9000.00,0.00,10000.00,0.23,0
18936,2124,-1000.00,7000.00,8000.00,2303.40,6696.60,0.38,0
18937,2124,-1000.00,6000.00,7000.00,8000.00,0.00,0.02,0
18938,2124,-1000.00,5000.00,6000.00,2516.36,4483.64,0.30,0
18939,2124,-1000.00,4000.00,5000.00,2688.46,3311.54,0.13,0
18940,2124,-1000.00,3000.00,4000.00,820.68,4179.32,0.33,0
18941,2124,-1000.00,2000.00,3000.00,0.00,4000.00,0.42,0
18942,2124,-1000.00,1000.00,2000.00,1211.37,1788.63,0.29,0
18943,2124,-1000.00,0.00,1000.00,463.45,1536.55,0.27,0
18944,2124,-1000.00,-1000.00,0.00,0.00,1000.00,0.39,0
18945,2125,-1000.00,-1000.00,0.00,0.00,1000.00,0.21,0
18946,2126,1000.00,1000.00,2000.00,202.71,387.26,0.25,1
18947,2126,1000.00,2000.00,3000.00,754.64,1245.36,0.30,1
18948,2126,1000.00,3000.00,4000.00,1320.74,1443.34,0.23,1
18949,2126,1000.00,4000.00,5000.00,0.00,3332.77,0.33,1
18950,2126,1000.00,5000.00,6000.00,526.36,4473.64,0.02,1
18951,2126,1000.00,6000.00,7000.00,1937.78,4062.22,0.03,1
18952,2126,1000.00,7000.00,8000.00,0.00,7000.00,0.35,1
18953,2126,1000.00,8000.00,9000.00,0.00,8000.00,0.01,1
18954,2126,1000.00,9000.00,10000.00,0.00,9000.00,0.04,1
18955,2126,1000.00,10000.00,11000.00,3371.32,4686.32,0.26,1
18956,2126,1000.00,11000.00,12000.00,4471.38,6528.62,0.28,1
18957,2126,1000.00,12000.00,13000.00,0.00,10453.49,0.43,1
18958,2126,1000.00,13000.00,14000.00,0.00,13000.00,0.29,1
18959,2126,1000.00,14000.00,15000.00,7000.00,7000.00,0.07,1
18960,2126,1000.00,15000.00,16000.00,0.00,2769.29,0.11,1
18961,2126,1000.00,16000.00,17000.00,0.00,15103.84,0.13,1
18962,2126,-1000.00,15000.00,16000.00,11544.52,5455.48,0.09,0
18963,2126,-1000.00,14000.00,15000.00,4100.15,1108.86,0.12,0
18964,2126,-1000.00,13000.00,14000.00,4587.87,2514.72,0.15,0
18965,2126,1000.00,14000.00,15000.00,4885.55,9114.45,0.23,1
18966,2126,1000.00,15000.00,16000.00,6073.98,8926.02,0.24,1
18967,2126,1000.00,16000.00,17000.00,0.00,9301.45,0.31,1
18968,2126,-1000.00,15000.00,16000.00,5322.59,11677.41,0.16,0
18969,2126,-1000.00,14000.00,15000.00,2012.70,13987.30,0.43,0
18970,2126,-1000.00,13000.00,14000.00,0.00,2626.29,0.08,0
18971,2126,-1000.00,12000.00,13000.00,9341.89,0.00,0.04,0
18972,2126,-1000.00,11000.00,12000.00,5143.98,7856.02,0.26,0
18973,2126,-1000.00,10000.00,11000.00,5796.35,6203.65,0.12,0
18974,2126,-1000.00,9000.00,10000.00,0.00,11000.00,0.00,0
18975,2126,-1000.00,8000.00,9000.00,2484.43,7515.57,0.36,0
18976,2126,-1000.00,7000.00,8000.00,2798.93,6201.07,0.29,0
18977,2126,-1000.00,6000.00,7000.00,1690.12,6309.88,0.29,0
18978,2126,-1000.00,5000.00,6000.00,4493.94,2506.06,0.13,0
18979,2126,-1000.00,4000.00,5000.00,2233.03,3766.97,0.26,0
18980,2126,-1000.00,3000.00,4000.00,1584.19,3415.81,0.08,0
18981,2126,-1000.00,2000.00,3000.00,580.96,3419.04,0.42,0
18982,2126,-1000.00,1000.00,2000.00,912.46,2087.54,0.35,0
18983,2126,0.00,1000.00,2000.00,0.00,0.00,0.06,0
18984,2126,-1000.00,0.00,1000.00,1065.68,934.32,0.20,0
18985,2126,-904.83,-904.83,95.17,246.41,658.42,0.35,0
18986,2126,-95.17,-1000.00,0.00,0.00,95.17,0.43,0
18987,2127,-1000.00,-1000.00,0.00,40.25,623.74,0.37,0
18988,2128,-453.94,-453.94,546.06,0.00,453.94,0.12,0
18989,2128,-546.06,-1000.00,0.00,203.62,342.44,0.17,0
18990,2129,-1000.00,-1000.00,0.00,304.87,695.13,0.33,0
18991,2130,-1000.00,-1000.00,0.00,68.71,123.24,0.43,0
18992,2131,1000.00,1000.00,2000.00,0.00,715.16,0.26,1
18993,2131,1000.00,2000.00,3000.00,0.00,2000.00,0.08,1
18994,2131,1000.00,3000.00,4000.00,1455.48,1544.52,0.14,1
18995,2131,1000.00,4000.00,5000.00,215.28,3784.72,0.44,1
18996,2131,1000.00,5000.00,6000.00,1005.68,3994.32,0.41,1
18997,2131,1000.00,6000.00,7000.00,0.00,3579.30,0.24,1
18998,2131,1000.00,7000.00,8000.00,3500.00,3500.00,0.23,1
18999,2131,1000.00,8000.00,9000.00,3664.10,4335.90,0.17,1
19000,2131,1000.00,9000.00,10000.00,0.00,9000.00,0.28,1
19001,2131,1000.00,10000.00,11000.00,1279.55,8720.45,0.42,1
19002,2131,1000.00,11000.00,12000.00,0.00,11000.00,0.11,1
19003,2131,1000.00,12000.00,13000.00,5128.33,6871.67,0.13,1
19004,2131,1000.00,13000.00,14000.00,6500.00,6500.00,0.00,1
19005,2131,1000.00,14000.00,15000.00,0.00,6389.48,0.24,1
19006,2131,1000.00,15000.00,16000.00,0.00,9992.71,0.04,1
19007,2131,1000.00,16000.00,17000.00,0.00,16000.00,0.07,1
19008,2131,1000.00,17000.00,18000.00,2314.05,6539.86,0.26,1
19009,2131,1000.00,18000.00,19000.00,0.00,18000.00,0.17,1
19010,2131,1000.00,19000.00,20000.00,1936.88,2032.84,0.15,1
19011,2131,1000.00,20000.00,21000.00,1910.17,18089.83,0.28,1
19012,2131,1000.00,21000.00,22000.00,0.00,7539.85,0.16,1
19013,2131,1000.00,22000.00,23000.00,11000.00,11000.00,0.03,1
19014,2131,1000.00,23000.00,24000.00,3900.42,19099.58,0.20,1
19015,2131,-1000.00,22000.00,23000.00,12379.26,11620.74,0.13,0
19016,2131,1000.00,23000.00,24000.00,8732.06,14267.94,0.30,1
19017,2131,1000.00,24000.00,25000.00,2431.44,3298.96,0.16,1
19018,2131,1000.00,25000.00,26000.00,0.00,25000.00,0.14,1
19019,2131,1000.00,26000.00,27000.00,0.00,5651.61,0.10,1
19020,2131,1000.00,27000.00,28000.00,0.00,4232.33,0.11,1
19021,2131,1000.00,28000.00,29000.00,0.00,28000.00,0.08,1
19022,2131,1000.00,29000.00,30000.00,12000.87,16999.13,0.17,1
19023,2131,1000.00,30000.00,31000.00,5535.95,24464.05,0.18,1
19024,2131,-1000.00,29000.00,30000.00,20883.70,10116.30,0.04,0
19025,2131,1000.00,30000.00,31000.00,6584.75,23415.25,0.23,1
19026,2131,1000.00,31000.00,32000.00,5227.97,25772.03,0.43,1
19027,2131,1000.00,32000.00,33000.00,10376.74,21623.26,0.29,1
19028,2131,1000.00,33000.00,34000.00,11572.89,21427.11,0.32,1
19029,2131,1000.00,34000.00,35000.00,0.00,13828.43,0.17,1
19030,2131,1000.00,35000.00,36000.00,8183.00,25599.29,0.39,1
19031,2131,-1000.00,34000.00,35000.00,21772.56,14227.44,0.13,0
19032,2131,1000.00,35000.00,36000.00,0.00,23110.47,0.12,1
19033,2132,1000.00,1000.00,2000.00,101.28,549.11,0.33,1
19034,2132,-1000.00,0.00,1000.00,1015.79,984.21,0.06,0
19035,2132,1000.00,1000.00,2000.00,0.00,1000.00,0.17,1
19036,2132,1000.00,2000.00,3000.00,0.00,2000.00,0.17,1
19037,2132,1000.00,3000.00,4000.00,531.62,2468.38,0.09,1
19038,2132,1000.00,4000.00,5000.00,818.00,3182.00,0.24,1
19039,2132,1000.00,5000.00,6000.00,0.00,5000.00,0.11,1
19040,2132,1000.00,6000.00,7000.00,2467.30,3532.70,0.04,1
19041,2132,1000.00,7000.00,8000.00,0.00,7000.00,0.22,1
19042,2132,1000.00,8000.00,9000.00,4000.00,4000.00,0.10,1
19043,2132,1000.00,9000.00,10000.00,0.00,9000.00,0.42,1
19044,2132,1000.00,10000.00,11000.00,3853.03,5414.58,0.27,1
19045,2132,0.00,10000.00,11000.00,0.00,0.00,0.02,0
19046,2132,1000.00,11000.00,12000.00,0.00,8809.97,0.14,1
19047,2132,1000.00,12000.00,13000.00,0.00,12000.00,0.13,1
19048,2132,1000.00,13000.00,14000.00,0.00,13000.00,0.12,1
19049,2132,1000.00,14000.00,15000.00,0.00,8471.25,0.08,1
19050,2132,1000.00,15000.00,16000.00,0.00,15000.00,0.08,1
19051,2132,1000.00,16000.00,17000.00,3741.71,12258.29,0.39,1
19052,2132,1000.00,17000.00,18000.00,0.00,9288.92,0.32,1
19053,2132,1000.00,18000.00,19000.00,0.00,18000.00,0.09,1
19054,2132,1000.00,19000.00,20000.00,0.00,6582.98,0.24,1
19055,2132,1000.00,20000.00,21000.00,0.00,15823.64,0.10,1
19056,2132,1000.00,21000.00,22000.00,0.00,884.15,0.09,1
19057,2132,1000.00,22000.00,23000.00,9724.94,12275.06,0.13,1
19058,2132,1000.00,23000.00,24000.00,0.00,23000.00,0.18,1
19059,2132,1000.00,24000.00,25000.00,0.00,4820.45,0.15,1
19060,2132,1000.00,25000.00,26000.00,0.00,20217.98,0.17,1
19061,2132,-1000.00,24000.00,25000.00,13668.28,12331.72,0.31,0
19062,2132,1000.00,25000.00,26000.00,0.00,25000.00,0.08,1
19063,2132,1000.00,26000.00,27000.00,0.00,26000.00,0.06,1
19064,2132,1000.00,27000.00,28000.00,6745.19,17801.85,0.35,1
19065,2132,1000.00,28000.00,29000.00,11298.22,16701.78,0.27,1
19066,2132,1000.00,29000.00,30000.00,1906.71,27093.29,0.42,1
19067,2132,1000.00,30000.00,31000.00,8936.54,21063.46,0.36,1
19068,2132,1000.00,31000.00,32000.00,9141.12,21858.88,0.20,1
19069,2132,1000.00,32000.00,33000.00,9102.03,22897.97,0.36,1
19070,2132,1000.00,33000.00,34000.00,10116.96,22883.04,0.33,1
19071,2132,1000.00,34000.00,35000.00,15194.63,18805.37,0.12,1
19072,2132,-1000.00,33000.00,34000.00,5548.35,729.13,0.12,0
19073,2132,1000.00,34000.00,35000.00,0.00,34000.00,0.23,1
19074,2132,-1000.00,33000.00,34000.00,4793.52,0.00,0.06,0
19075,2132,1000.00,34000.00,35000.00,0.00,8061.86,0.15,1
19076,2132,1000.00,35000.00,36000.00,0.00,28032.81,0.36,1
19077,2132,1000.00,36000.00,37000.00,0.00,36000.00,0.39,1
19078,2132,-1000.00,35000.00,36000.00,21870.14,15129.86,0.28,0
19079,2132,1000.00,36000.00,37000.00,11115.81,14075.13,0.23,1
19080,2132,-1000.00,35000.00,36000.00,18500.00,18500.00,0.37,0
19081,2132,-1000.00,34000.00,35000.00,0.00,34920.96,0.44,0
19082,2132,-1000.00,33000.00,34000.00,0.00,26651.63,0.41,0
19083,2132,-1000.00,32000.00,33000.00,25537.39,5665.02,0.08,0
19084,2132,-1000.00,31000.00,32000.00,7980.92,0.00,0.03,0
19085,2132,-1000.00,30000.00,31000.00,0.00,32000.00,0.07,0
19086,2132,-1000.00,29000.00,30000.00,0.00,16893.33,0.33,0
19087,2132,-1000.00,28000.00,29000.00,839.94,29160.06,0.44,0
19088,2132,-1000.00,27000.00,28000.00,11525.94,17474.06,0.29,0
19089,2132,-1000.00,26000.00,27000.00,0.00,15025.44,0.32,0
19090,2132,-1000.00,25000.00,26000.00,13500.00,13500.00,0.03,0
19091,2132,-1000.00,24000.00,25000.00,0.00,12816.94,0.30,0
19092,2132,-1000.00,23000.00,24000.00,9070.25,10386.40,0.23,0
19093,2132,-1000.00,22000.00,23000.00,0.00,24000.00,0.14,0
19094,2132,-1000.00,21000.00,22000.00,6487.74,2970.35,0.14,0
19095,2132,-1000.00,20000.00,21000.00,0.00,22000.00,0.23,0
19096,2132,-1000.00,19000.00,20000.00,0.00,21000.00,0.18,0
19097,2132,-1000.00,18000.00,19000.00,2645.41,17354.59,0.43,0
19098,2132,-1000.00,17000.00,18000.00,0.00,7498.42,0.21,0
19099,2132,-1000.00,16000.00,17000.00,710.61,17289.39,0.17,0
19100,2133,1000.00,1000.00,2000.00,252.79,747.21,0.06,1
19101,2133,-569.54,430.46,1430.46,569.54,0.00,0.06,0
19102,2133,1000.00,1430.46,2430.46,0.00,1430.46,0.08,1
19103,2133,1000.00,2430.46,3430.46,0.00,2430.46,0.44,1
19104,2133,1000.00,3430.46,4430.46,1715.23,1715.23,0.07,1
19105,2133,1000.00,4430.46,5430.46,0.00,4430.46,0.14,1
19106,2133,1000.00,5430.46,6430.46,0.00,5430.46,0.09,1
19107,2133,1000.00,6430.46,7430.46,2137.28,4293.18,0.22,1
19108,2133,1000.00,7430.46,8430.46,0.00,1426.85,0.04,1
19109,2133,1000.00,8430.46,9430.46,0.00,8430.46,0.16,1
19110,2133,1000.00,9430.46,10430.46,4715.23,4715.23,0.24,1
19111,2133,-1000.00,8430.46,9430.46,9792.07,0.00,0.02,0
19112,2133,1000.00,9430.46,10430.46,4715.23,4715.23,0.03,1
19113,2133,1000.00,10430.46,11430.46,1530.76,6853.66,0.37,1
19114,2133,1000.00,11430.46,12430.46,0.00,11430.46,0.17,1
19115,2133,1000.00,12430.46,13430.46,1596.18,10834.27,0.40,1
19116,2133,1000.00,13430.46,14430.46,0.00,9582.71,0.39,1
19117,2133,1000.00,14430.46,15430.46,7002.22,7428.24,0.38,1
19118,2133,1000.00,15430.46,16430.46,3312.70,6422.31,0.26,1
19119,2133,1000.00,16430.46,17430.46,8215.23,8215.23,0.13,1
19120,2133,1000.00,17430.46,18430.46,8715.23,8715.23,0.08,1
19121,2133,1000.00,18430.46,19430.46,5351.92,13078.54,0.15,1
19122,2133,1000.00,19430.46,20430.46,604.00,15307.60,0.41,1
19123,2133,1000.00,20430.46,21430.46,0.00,18002.88,0.25,1
19124,2133,1000.00,21430.46,22430.46,6124.53,15305.93,0.29,1
19125,2133,1000.00,22430.46,23430.46,0.00,22430.46,0.13,1
19126,2133,1000.00,23430.46,24430.46,0.00,16556.89,0.39,1
19127,2133,1000.00,24430.46,25430.46,0.00,6511.68,0.04,1
19128,2133,1000.00,25430.46,26430.46,9436.20,15994.26,0.29,1
19129,2133,1000.00,26430.46,27430.46,4804.74,13506.74,0.30,1
19130,2133,1000.00,27430.46,28430.46,10707.09,16723.37,0.33,1
19131,2133,1000.00,28430.46,29430.46,0.00,11877.96,0.07,1
19132,2133,1000.00,29430.46,30430.46,0.00,27031.15,0.05,1
19133,2133,-1000.00,28430.46,29430.46,6759.20,2227.67,0.13,0
19134,2133,1000.00,29430.46,30430.46,2843.94,15726.34,0.32,1
19135,2133,1000.00,30430.46,31430.46,9783.03,20647.43,0.34,1
19136,2133,1000.00,31430.46,32430.46,0.00,31430.46,0.34,1
19137,2133,1000.00,32430.46,33430.46,0.00,32430.46,0.29,1
19138,2133,1000.00,33430.46,34430.46,1554.99,28000.82,0.43,1
19139,2133,1000.00,34430.46,35430.46,17215.23,17215.23,0.04,1
19140,2133,1000.00,35430.46,36430.46,17715.23,17715.23,0.09,1
19141,2133,1000.00,36430.46,37430.46,15516.28,20914.18,0.27,1
19142,2133,-1000.00,35430.46,36430.46,30905.69,6524.77,0.10,0
19143,2134,-1000.00,-1000.00,0.00,255.46,744.54,0.38,0
19144,2135,-277.00,-277.00,723.00,0.00,277.00,0.18,0
19145,2135,-723.00,-1000.00,0.00,0.00,723.00,0.10,0
19146,2136,-502.95,-502.95,497.05,192.63,310.31,0.39,0
19147,2136,-368.51,-871.45,128.55,0.00,368.51,0.34,0
19148,2136,-114.13,-985.59,14.41,0.00,114.13,0.32,0
19149,2136,1000.00,14.41,1014.41,8.76,0.00,0.13,1
19150,2136,-899.58,-885.16,114.84,0.00,899.58,0.22,0
19151,2136,-114.84,-1000.00,0.00,19.22,95.61,0.14,0
19152,2137,1000.00,1000.00,2000.00,500.00,500.00,0.00,1
19153,2137,1000.00,2000.00,3000.00,208.05,1149.06,0.34,1
19154,2137,1000.00,3000.00,4000.00,1026.45,1973.55,0.29,1
19155,2137,1000.00,4000.00,5000.00,0.00,4000.00,0.18,1
19156,2137,1000.00,5000.00,6000.00,1124.40,3875.60,0.38,1
19157,2137,1000.00,6000.00,7000.00,0.00,2644.89,0.23,1
19158,2137,1000.00,7000.00,8000.00,0.00,2948.04,0.25,1
19159,2137,1000.00,8000.00,9000.00,0.00,4583.93,0.22,1
19160,2137,1000.00,9000.00,10000.00,820.40,8179.60,0.43,1
19161,2137,1000.00,10000.00,11000.00,1541.75,8458.25,0.28,1
19162,2137,1000.00,11000.00,12000.00,0.00,11000.00,0.23,1
19163,2137,1000.00,12000.00,13000.00,3727.29,4850.10,0.24,1
19164,2137,1000.00,13000.00,14000.00,3766.05,9233.95,0.35,1
19165,2137,1000.00,14000.00,15000.00,518.29,13481.71,0.19,1
19166,2137,1000.00,15000.00,16000.00,5503.89,9496.11,0.29,1
19167,2137,1000.00,16000.00,17000.00,6230.04,9769.96,0.14,1
19168,2137,1000.00,17000.00,18000.00,0.00,17000.00,0.41,1
19169,2137,0.00,17000.00,18000.00,0.00,0.00,0.07,0
19170,2137,-1000.00,16000.00,17000.00,12662.77,5337.23,0.00,0
19171,2137,1000.00,17000.00,18000.00,7117.35,9882.65,0.36,1
19172,2137,1000.00,18000.00,19000.00,0.00,18000.00,0.04,1
19173,2137,1000.00,19000.00,20000.00,0.00,18551.29,0.06,1
19174,2137,1000.00,20000.00,21000.00,0.00,20000.00,0.27,1
19175,2137,1000.00,21000.00,22000.00,628.14,19737.15,0.44,1
19176,2137,1000.00,22000.00,23000.00,8672.32,13327.68,0.41,1
19177,2137,1000.00,23000.00,24000.00,2805.50,20194.50,0.43,1
19178,2137,1000.00,24000.00,25000.00,4439.29,15715.86,0.20,1
19179,2137,1000.00,25000.00,26000.00,0.00,25000.00,0.11,1
19180,2137,1000.00,26000.00,27000.00,0.00,20432.06,0.37,1
19181,2137,-1000.00,25000.00,26000.00,18401.60,8598.40,0.10,0
19182,2137,1000.00,26000.00,27000.00,7510.85,18489.15,0.25,1
19183,2137,-1000.00,25000.00,26000.00,17958.26,9041.74,0.13,0
19184,2137,1000.00,26000.00,27000.00,0.00,25968.76,0.13,1
19185,2137,1000.00,27000.00,28000.00,6711.75,20288.25,0.30,1
19186,2137,-1000.00,26000.00,27000.00,14228.65,13771.35,0.27,0
19187,2137,1000.00,27000.00,28000.00,9360.73,17639.27,0.31,1
19188,2137,-1000.00,26000.00,27000.00,5929.02,19438.21,0.37,0
19189,2138,1000.00,1000.00,2000.00,0.00,631.95,0.20,1
19190,2138,1000.00,2000.00,3000.00,296.45,1703.55,0.42,1
19191,2138,1000.00,3000.00,4000.00,1068.10,1931.90,0.28,1
19192,2138,1000.00,4000.00,5000.00,1390.18,2609.82,0.32,1
19193,2138,1000.00,5000.00,6000.00,2298.96,2701.04,0.17,1
19194,2138,1000.00,6000.00,7000.00,2510.16,3489.84,0.20,1
19195,2138,1000.00,7000.00,8000.00,3184.07,3815.93,0.27,1
19196,2138,1000.00,8000.00,9000.00,0.00,6142.33,0.30,1
19197,2138,1000.00,9000.00,10000.00,4500.00,4500.00,0.01,1
19198,2138,1000.00,10000.00,11000.00,4518.14,5481.86,0.22,1
19199,2138,1000.00,11000.00,12000.00,2543.71,8456.29,0.37,1
19200,2138,1000.00,12000.00,13000.00,0.00,11728.12,0.38,1
19201,2138,1000.00,13000.00,14000.00,338.88,12661.12,0.37,1
19202,2138,1000.00,14000.00,15000.00,0.00,11462.50,0.42,1
19203,2138,1000.00,15000.00,16000.00,0.00,15000.00,0.25,1
19204,2138,1000.00,16000.00,17000.00,0.00,9423.48,0.30,1
19205,2138,1000.00,17000.00,18000.00,6595.08,10404.92,0.25,1
19206,2138,1000.00,18000.00,19000.00,8442.08,9557.92,0.09,1
19207,2138,1000.00,19000.00,20000.00,0.00,19000.00,0.25,1
19208,2138,1000.00,20000.00,21000.00,0.00,20000.00,0.00,1
19209,2138,1000.00,21000.00,22000.00,6796.94,14203.06,0.31,1
19210,2138,1000.00,22000.00,23000.00,0.00,15134.70,0.30,1
19211,2138,-1000.00,21000.00,22000.00,11500.00,11500.00,0.33,0
19212,2138,-1000.00,20000.00,21000.00,4215.86,17784.14,0.40,0
19213,2138,-1000.00,19000.00,20000.00,10109.54,10474.60,0.23,0
19214,2138,-1000.00,18000.00,19000.00,8839.71,11160.29,0.17,0
19215,2138,-1000.00,17000.00,18000.00,13867.65,4787.91,0.10,0
19216,2138,-1000.00,16000.00,17000.00,131.71,11933.83,0.38,0
19217,2138,-1000.00,15000.00,16000.00,0.00,15754.35,0.17,0
19218,2138,-1000.00,14000.00,15000.00,1883.00,10798.79,0.37,0
19219,2138,-1000.00,13000.00,14000.00,3449.17,11550.83,0.40,0
19220,2138,-1000.00,12000.00,13000.00,0.00,14000.00,0.38,0
19221,2138,-1000.00,11000.00,12000.00,0.00,13000.00,0.21,0
19222,2138,-1000.00,10000.00,11000.00,0.00,12000.00,0.04,0
19223,2138,-1000.00,9000.00,10000.00,0.00,4321.27,0.10,0
19224,2138,-1000.00,8000.00,9000.00,3014.73,6985.27,0.33,0
19225,2138,-1000.00,7000.00,8000.00,0.00,4913.06,0.21,0
19226,2138,-1000.00,6000.00,7000.00,667.84,7332.16,0.36,0
19227,2138,-1000.00,5000.00,6000.00,3500.00,3500.00,0.07,0
19228,2138,-1000.00,4000.00,5000.00,0.00,5124.85,0.23,0
19229,2138,-1000.00,3000.00,4000.00,0.00,5000.00,0.39,0
19230,2138,-1000.00,2000.00,3000.00,2379.73,1620.27,0.12,0
19231,2138,-1000.00,1000.00,2000.00,0.00,3000.00,0.33,0
19232,2138,-1000.00,0.00,1000.00,753.70,1246.30,0.12,0
19233,2138,-1000.00,-1000.00,0.00,743.70,256.30,0.05,0
19234,2139,-1000.00,-1000.00,0.00,575.41,424.59,0.07,0
19235,2140,-683.69,-683.69,316.31,304.52,379.16,0.24,0
19236,2140,-108.98,-792.67,207.33,0.00,108.98,0.09,0
19237,2140,-207.33,-1000.00,0.00,0.00,207.33,0.37,0
19238,2141,-1000.00,-1000.00,0.00,273.04,726.96,0.30,0
19239,2142,-1000.00,-1000.00,0.00,0.00,419.39,0.18,0
19240,2143,1000.00,1000.00,2000.00,43.72,956.28,0.07,1
19241,2143,1000.00,2000.00,3000.00,316.33,1683.67,0.38,1
19242,2143,1000.00,3000.00,4000.00,0.00,1998.56,0.22,1
19243,2143,1000.00,4000.00,5000.00,0.00,1543.05,0.26,1
19244,2143,1000.00,5000.00,6000.00,1514.69,3485.31,0.26,1
19245,2143,1000.00,6000.00,7000.00,0.00,6000.00,0.27,1
19246,2143,1000.00,7000.00,8000.00,1452.78,5547.22,0.38,1
19247,2143,1000.00,8000.00,9000.00,148.99,7851.01,0.26,1
19248,2143,1000.00,9000.00,10000.00,0.00,6910.49,0.41,1
19249,2143,1000.00,10000.00,11000.00,4481.16,5518.84,0.42,1
19250,2143,1000.00,11000.00,12000.00,0.00,11000.00,0.33,1
19251,2143,-1000.00,10000.00,11000.00,7029.31,4970.69,0.03,0
19252,2143,-1000.00,9000.00,10000.00,5753.97,5246.03,0.01,0
19253,2143,1000.00,10000.00,11000.00,2435.38,7564.62,0.38,1
19254,2143,1000.00,11000.00,12000.00,1806.61,9193.39,0.41,1
19255,2143,-1000.00,10000.00,11000.00,6577.82,5422.18,0.18,0
19256,2143,1000.00,11000.00,12000.00,0.00,5010.38,0.29,1
19257,2143,1000.00,12000.00,13000.00,5450.06,6549.94,0.34,1
19258,2143,-1000.00,11000.00,12000.00,3180.62,9819.38,0.03,0
19259,2143,-1000.00,10000.00,11000.00,1308.92,10691.08,0.41,0
19260,2143,-1000.00,9000.00,10000.00,0.00,5095.22,0.14,0
19261,2143,-1000.00,8000.00,9000.00,0.00,8575.99,0.44,0
19262,2143,-1000.00,7000.00,8000.00,0.00,2780.56,0.22,0
19263,2143,1000.00,8000.00,9000.00,3356.00,4644.00,0.38,1
19264,2143,1000.00,9000.00,10000.00,0.00,3569.60,0.26,1
19265,2143,1000.00,10000.00,11000.00,458.94,6301.03,0.36,1
19266,2143,1000.00,11000.00,12000.00,186.02,10569.66,0.44,1
19267,2143,1000.00,12000.00,13000.00,0.00,3747.97,0.04,1
19268,2143,1000.00,13000.00,14000.00,4059.54,8940.46,0.18,1
19269,2143,1000.00,14000.00,15000.00,0.00,5906.47,0.26,1
19270,2143,1000.00,15000.00,16000.00,0.00,12370.67,0.38,1
19271,2143,1000.00,16000.00,17000.00,5923.21,10076.79,0.23,1
19272,2143,1000.00,17000.00,18000.00,0.00,17000.00,0.02,1
19273,2143,1000.00,18000.00,19000.00,0.00,18000.00,0.21,1
19274,2143,1000.00,19000.00,20000.00,6377.81,12622.19,0.12,1
19275,2143,1000.00,20000.00,21000.00,9037.50,10962.50,0.33,1
19276,2143,1000.00,21000.00,22000.00,3682.27,17317.73,0.20,1
19277,2143,-1000.00,20000.00,21000.00,13140.11,8859.89,0.14,0
19278,2143,1000.00,21000.00,22000.00,0.00,21000.00,0.29,1
19279,2143,1000.00,22000.00,23000.00,4286.17,13364.30,0.30,1
19280,2143,1000.00,23000.00,24000.00,0.00,18393.79,0.38,1
19281,2143,1000.00,24000.00,25000.00,0.00,24000.00,0.33,1
19282,2143,1000.00,25000.00,26000.00,4493.98,20506.02,0.19,1
19283,2143,1000.00,26000.00,27000.00,11679.28,14320.72,0.22,1
19284,2143,1000.00,27000.00,28000.00,13500.00,13500.00,0.22,1
19285,2143,1000.00,28000.00,29000.00,14000.00,14000.00,0.09,1
19286,2143,-1000.00,27000.00,28000.00,19422.14,9577.86,0.08,0
19287,2144,-817.03,-817.03,182.97,177.00,640.02,0.37,0
19288,2144,-182.97,-1000.00,0.00,0.00,182.97,0.02,0
19289,2145,-1000.00,-1000.00,0.00,0.00,1000.00,0.02,0
19290,2146,-1000.00,-1000.00,0.00,0.00,1000.00,0.28,0
19291,2147,-1000.00,-1000.00,0.00,500.00,500.00,0.02,0
19292,2148,-1000.00,-1000.00,0.00,0.00,1000.00,0.40,0
19293,2149,-510.90,-510.90,489.10,0.00,510.90,0.31,0
19294,2149,-401.38,-912.28,87.72,0.00,401.38,0.25,0
19295,2149,-87.72,-1000.00,0.00,0.00,87.72,0.34,0
19296,2150,-1000.00,-1000.00,0.00,438.42,561.58,0.18,0
19297,2151,-1000.00,-1000.00,0.00,0.00,1000.00,0.34,0
19298,2152,-563.58,-563.58,436.42,384.70,178.88,0.14,0
19299,2152,-361.83,-925.41,74.59,250.66,111.17,0.13,0
19300,2152,-1000.00,-1925.41,-925.41,0.00,74.59,0.29,0
19301,2153,-1000.00,-1000.00,0.00,876.40,123.60,0.05,0
19302,2154,-1000.00,-1000.00,0.00,0.00,745.27,0.32,0
19303,2155,-568.73,-568.73,431.27,0.00,568.73,0.29,0
19304,2155,-431.27,-1000.00,0.00,215.63,215.63,0.04,0
19305,2156,1000.00,1000.00,2000.00,27.35,713.64,0.39,1
19306,2156,-944.24,55.76,1055.76,944.24,0.00,0.06,0
19307,2156,1000.00,1055.76,2055.76,255.20,800.56,0.39,1
19308,2156,1000.00,2055.76,3055.76,531.42,1144.89,0.31,1
19309,2156,1000.00,3055.76,4055.76,1305.30,1750.45,0.04,1
19310,2156,1000.00,4055.76,5055.76,1169.64,2886.12,0.18,1
19311,2156,1000.00,5055.76,6055.76,0.00,4787.19,0.05,1
19312,2156,1000.00,6055.76,7055.76,1692.92,4362.83,0.05,1
19313,2156,1000.00,7055.76,8055.76,0.00,2831.97,0.05,1
19314,2156,1000.00,8055.76,9055.76,1408.61,6647.15,0.24,1
19315,2156,1000.00,9055.76,10055.76,4216.19,4839.57,0.11,1
19316,2156,1000.00,10055.76,11055.76,0.00,10055.76,0.20,1
19317,2156,-1000.00,9055.76,10055.76,7094.16,947.46,0.08,0
19318,2156,1000.00,10055.76,11055.76,0.00,10055.76,0.41,1
19319,2156,1000.00,11055.76,12055.76,350.73,10705.03,0.39,1
19320,2156,1000.00,12055.76,13055.76,708.00,11347.76,0.37,1
19321,2156,1000.00,13055.76,14055.76,2952.10,10103.65,0.36,1
19322,2156,1000.00,14055.76,15055.76,5804.78,8250.98,0.04,1
19323,2156,1000.00,15055.76,16055.76,0.00,4599.60,0.16,1
19324,2156,-1000.00,14055.76,15055.76,14040.69,0.00,0.03,0
19325,2156,1000.00,15055.76,16055.76,0.00,7123.22,0.06,1
19326,2156,-1000.00,14055.76,15055.76,8938.83,7116.93,0.01,0
19327,2156,1000.00,15055.76,16055.76,163.87,12658.07,0.43,1
19328,2156,1000.00,16055.76,17055.76,0.00,16055.76,0.32,1
19329,2156,1000.00,17055.76,18055.76,5724.70,11331.06,0.31,1
19330,2156,1000.00,18055.76,19055.76,0.00,18055.76,0.40,1
19331,2156,1000.00,19055.76,20055.76,0.00,19055.76,0.23,1
19332,2156,1000.00,20055.76,21055.76,5380.25,14675.51,0.37,1
19333,2156,1000.00,21055.76,22055.76,0.00,16730.88,0.19,1
19334,2156,1000.00,22055.76,23055.76,9469.96,12585.80,0.30,1
19335,2156,1000.00,23055.76,24055.76,0.00,20613.67,0.09,1
19336,2156,1000.00,24055.76,25055.76,258.59,17868.44,0.40,1
19337,2156,1000.00,25055.76,26055.76,0.00,22032.55,0.41,1
19338,2156,1000.00,26055.76,27055.76,0.00,26055.76,0.28,1
19339,2156,1000.00,27055.76,28055.76,0.00,18182.13,0.16,1
19340,2156,1000.00,28055.76,29055.76,511.85,27543.91,0.41,1
19341,2157,-1000.00,-1000.00,0.00,431.82,568.18,0.22,0
19342,2158,-1000.00,-1000.00,0.00,237.65,762.35,0.32,0
19343,2159,0.00,0.00,1000.00,0.00,0.00,0.15,0
19344,2159,-1000.00,-1000.00,0.00,422.12,256.46,0.33,0
19345,2160,-1000.00,-1000.00,0.00,488.35,388.15,0.19,0
19346,2161,-333.90,-333.90,666.10,0.00,333.90,0.12,0
19347,2161,-666.10,-1000.00,0.00,299.31,366.79,0.25,0
19348,2162,-1000.00,-1000.00,0.00,469.27,530.73,0.21,0
19349,2163,-767.13,-767.13,232.87,461.93,305.20,0.17,0
19350,2163,-27.14,-794.27,205.73,27.14,0.00,0.03,0
19351,2163,1000.00,205.73,1205.73,0.00,205.73,0.06,1
19352,2163,-64.98,140.75,1140.75,64.98,0.00,0.10,0
19353,2163,1000.00,1140.75,2140.75,268.91,871.84,0.36,1
19354,2163,-1000.00,140.75,1140.75,644.87,587.96,0.20,0
19355,2163,1000.00,1140.75,2140.75,0.00,284.00,0.14,1
19356,2163,1000.00,2140.75,3140.75,1070.38,1070.38,0.06,1
19357,2163,1000.00,3140.75,4140.75,1570.38,1570.38,0.36,1
19358,2163,1000.00,4140.75,5140.75,0.00,4140.75,0.21,1
19359,2163,1000.00,5140.75,6140.75,380.53,4081.86,0.42,1
19360,2163,1000.00,6140.75,7140.75,0.00,6140.75,0.07,1
19361,2163,1000.00,7140.75,8140.75,31.63,4936.26,0.39,1
19362,2163,-641.55,6499.20,7499.20,641.55,0.00,0.08,0
19363,2163,1000.00,7499.20,8499.20,1377.72,6121.49,0.29,1
19364,2163,1000.00,8499.20,9499.20,3334.56,5164.64,0.01,1
19365,2163,1000.00,9499.20,10499.20,0.00,3455.22,0.24,1
19366,2163,1000.00,10499.20,11499.20,992.12,1038.16,0.14,1
19367,2163,1000.00,11499.20,12499.20,2428.23,9070.97,0.39,1
19368,2163,1000.00,12499.20,13499.20,0.00,12499.20,0.39,1
19369,2163,1000.00,13499.20,14499.20,4657.32,8841.88,0.26,1
19370,2163,1000.00,14499.20,15499.20,7249.60,7249.60,0.05,1
19371,2163,-1000.00,13499.20,14499.20,5225.49,10273.72,0.30,0
19372,2163,-1000.00,12499.20,13499.20,7560.46,6938.75,0.05,0
19373,2163,-1000.00,11499.20,12499.20,0.00,8288.86,0.35,0
19374,2163,-1000.00,10499.20,11499.20,3784.20,8367.84,0.34,0
19375,2163,-1000.00,9499.20,10499.20,0.00,7362.29,0.31,0
19376,2163,-1000.00,8499.20,9499.20,5249.60,5249.60,0.33,0
19377,2163,-1000.00,7499.20,8499.20,8030.53,1468.67,0.04,0
19378,2163,-1000.00,6499.20,7499.20,2579.70,5919.51,0.25,0
19379,2163,-1000.00,5499.20,6499.20,1163.55,6335.65,0.34,0
19380,2163,-1000.00,4499.20,5499.20,2165.99,4333.21,0.31,0
19381,2163,-1000.00,3499.20,4499.20,2749.60,2749.60,0.00,0
19382,2163,-1000.00,2499.20,3499.20,0.00,4499.20,0.04,0
19383,2163,-1000.00,1499.20,2499.20,1374.17,2125.04,0.26,0
19384,2163,-1000.00,499.20,1499.20,259.88,1030.37,0.27,0
19385,2163,-911.20,-411.99,588.01,194.02,717.18,0.30,0
19386,2163,-274.83,-686.82,313.18,5.28,269.55,0.29,0
19387,2163,-27.93,-714.75,285.25,0.00,27.93,0.11,0
19388,2163,-260.91,-975.66,24.34,0.00,260.91,0.38,0
19389,2163,-24.34,-1000.00,0.00,0.00,24.34,0.24,0
19390,2164,0.00,0.00,1000.00,0.00,0.00,0.05,0
19391,2164,-176.23,-176.23,823.77,0.00,176.23,0.03,0
19392,2164,-823.77,-1000.00,0.00,378.25,445.52,0.40,0
19393,2165,-1000.00,-1000.00,0.00,416.38,583.62,0.24,0
19394,2166,-1000.00,-1000.00,0.00,0.00,1000.00,0.04,0
19395,2167,-331.59,-331.59,668.41,0.00,331.59,0.17,0
19396,2167,-668.41,-1000.00,0.00,71.00,597.40,0.38,0
19397,2168,-1000.00,-1000.00,0.00,332.82,667.18,0.17,0
19398,2169,-1000.00,-1000.00,0.00,0.00,1000.00,0.32,0
19399,2170,-1000.00,-1000.00,0.00,699.16,300.84,0.10,0
19400,2171,-556.43,-556.43,443.57,0.00,556.43,0.13,0
19401,2171,-344.48,-900.90,99.10,0.00,344.48,0.39,0
19402,2171,-99.10,-1000.00,0.00,10.85,88.25,0.23,0
19403,2172,0.00,0.00,1000.00,0.00,0.00,0.10,0
19404,2172,-877.75,-877.75,122.25,0.00,877.75,0.43,0
19405,2172,-82.15,-959.90,40.10,3.22,78.93,0.37,0
19406,2172,-40.10,-1000.00,0.00,16.26,23.84,0.17,0
19407,2173,1000.00,1000.00,2000.00,11.13,599.15,0.35,1
19408,2173,-1000.00,0.00,1000.00,961.08,821.53,0.20,0
19409,2173,1000.00,1000.00,2000.00,338.10,661.90,0.29,1
19410,2173,-1000.00,0.00,1000.00,1520.52,479.48,0.06,0
19411,2173,1000.00,1000.00,2000.00,0.00,1000.00,0.14,1
19412,2173,1000.00,2000.00,3000.00,481.72,1518.28,0.24,1
19413,2173,1000.00,3000.00,4000.00,0.00,3000.00,0.25,1
19414,2173,1000.00,4000.00,5000.00,0.00,2354.43,0.15,1
19415,2173,1000.00,5000.00,6000.00,0.00,3523.60,0.35,1
19416,2173,1000.00,6000.00,7000.00,0.00,6000.00,0.04,1
19417,2173,1000.00,7000.00,8000.00,3500.00,3500.00,0.06,1
19418,2173,1000.00,8000.00,9000.00,3679.49,4320.51,0.20,1
19419,2173,1000.00,9000.00,10000.00,0.00,3332.71,0.20,1
19420,2173,1000.00,10000.00,11000.00,4182.17,5817.83,0.12,1
19421,2173,1000.00,11000.00,12000.00,321.82,10678.18,0.43,1
19422,2173,1000.00,12000.00,13000.00,0.00,12000.00,0.07,1
19423,2173,1000.00,13000.00,14000.00,0.00,13000.00,0.00,1
19424,2173,1000.00,14000.00,15000.00,2477.35,7784.88,0.32,1
19425,2173,1000.00,15000.00,16000.00,0.00,1343.08,0.14,1
19426,2173,1000.00,16000.00,17000.00,8000.00,8000.00,0.19,1
19427,2173,1000.00,17000.00,18000.00,0.00,17000.00,0.03,1
19428,2173,1000.00,18000.00,19000.00,0.00,18000.00,0.33,1
19429,2173,1000.00,19000.00,20000.00,0.00,13536.70,0.39,1
19430,2173,-1000.00,18000.00,19000.00,18315.22,1684.78,0.02,0
19431,2173,-1000.00,17000.00,18000.00,12989.52,6010.48,0.30,0
19432,2173,-1000.00,16000.00,17000.00,0.00,18000.00,0.26,0
19433,2173,-1000.00,15000.00,16000.00,6021.35,10978.65,0.34,0
19434,2173,-1000.00,14000.00,15000.00,0.00,7896.82,0.15,0
19435,2173,-1000.00,13000.00,14000.00,0.00,15000.00,0.36,0
19436,2173,-1000.00,12000.00,13000.00,0.00,14000.00,0.10,0
19437,2173,-1000.00,11000.00,12000.00,2096.68,9535.23,0.39,0
19438,2173,-1000.00,10000.00,11000.00,442.83,1535.16,0.15,0
19439,2173,-1000.00,9000.00,10000.00,4574.81,6425.19,0.07,0
19440,2173,-1000.00,8000.00,9000.00,2788.35,7211.65,0.36,0
19441,2173,-1000.00,7000.00,8000.00,0.00,3829.57,0.23,0
19442,2173,-1000.00,6000.00,7000.00,0.00,7833.64,0.24,0
19443,2173,-1000.00,5000.00,6000.00,2048.28,4951.72,0.35,0
19444,2173,-1000.00,4000.00,5000.00,0.00,4938.20,0.39,0
19445,2173,-1000.00,3000.00,4000.00,697.82,4302.18,0.43,0
19446,2173,-1000.00,2000.00,3000.00,0.00,3416.18,0.14,0
19447,2173,-1000.00,1000.00,2000.00,0.00,2342.15,0.27,0
19448,2174,1000.00,1000.00,2000.00,0.00,358.82,0.24,1
19449,2174,1000.00,2000.00,3000.00,0.00,1874.71,0.31,1
19450,2174,1000.00,3000.00,4000.00,0.00,3000.00,0.25,1
19451,2174,1000.00,4000.00,5000.00,725.06,3274.94,0.41,1
19452,2174,1000.00,5000.00,6000.00,934.58,3587.82,0.38,1
19453,2174,1000.00,6000.00,7000.00,0.00,6000.00,0.08,1
19454,2174,1000.00,7000.00,8000.00,2177.75,3722.86,0.29,1
19455,2174,1000.00,8000.00,9000.00,2801.77,5198.23,0.32,1
19456,2174,1000.00,9000.00,10000.00,0.00,9000.00,0.15,1
19457,2174,-1000.00,8000.00,9000.00,7585.67,2414.33,0.19,0
19458,2174,1000.00,9000.00,10000.00,0.00,8459.56,0.34,1
19459,2174,1000.00,10000.00,11000.00,4070.18,5929.82,0.33,1
19460,2174,1000.00,11000.00,12000.00,1188.07,9811.93,0.44,1
19461,2174,0.00,11000.00,12000.00,0.00,0.00,0.06,0
19462,2174,1000.00,12000.00,13000.00,1249.32,10750.68,0.07,1
19463,2174,1000.00,13000.00,14000.00,1021.94,11978.06,0.41,1
19464,2174,1000.00,14000.00,15000.00,231.20,13768.80,0.42,1
19465,2174,1000.00,15000.00,16000.00,4097.94,10902.06,0.25,1
19466,2174,1000.00,16000.00,17000.00,7452.66,8547.34,0.13,1
19467,2174,-1000.00,15000.00,16000.00,6408.58,0.00,0.08,0
19468,2174,1000.00,16000.00,17000.00,8000.00,8000.00,0.43,1
19469,2174,1000.00,17000.00,18000.00,0.00,17000.00,0.28,1
19470,2174,1000.00,18000.00,19000.00,0.00,18000.00,0.23,1
19471,2174,1000.00,19000.00,20000.00,6272.48,12727.52,0.33,1
19472,2174,-1000.00,18000.00,19000.00,10000.00,10000.00,0.30,0
19473,2174,-1000.00,17000.00,18000.00,0.00,19000.00,0.29,0
19474,2174,-1000.00,16000.00,17000.00,7002.74,10997.26,0.12,0
19475,2174,-1000.00,15000.00,16000.00,529.51,7135.97,0.28,0
19476,2174,-1000.00,14000.00,15000.00,0.00,16000.00,0.16,0
19477,2174,-1000.00,13000.00,14000.00,0.00,15000.00,0.11,0
19478,2174,-1000.00,12000.00,13000.00,7000.00,7000.00,0.09,0
19479,2174,-1000.00,11000.00,12000.00,0.00,8541.80,0.38,0
19480,2174,-1000.00,10000.00,11000.00,4701.49,7298.51,0.13,0
19481,2174,-1000.00,9000.00,10000.00,0.00,11000.00,0.31,0
19482,2174,-1000.00,8000.00,9000.00,3408.84,6591.16,0.31,0
19483,2174,-1000.00,7000.00,8000.00,6669.07,2330.93,0.17,0
19484,2174,-1000.00,6000.00,7000.00,2711.23,5288.77,0.27,0
19485,2174,-1000.00,5000.00,6000.00,1466.91,5533.09,0.11,0
19486,2174,-1000.00,4000.00,5000.00,1120.63,4879.37,0.36,0
19487,2174,-1000.00,3000.00,4000.00,0.00,5000.00,0.02,0
19488,2174,-1000.00,2000.00,3000.00,0.00,4000.00,0.43,0
19489,2174,-1000.00,1000.00,2000.00,125.43,2874.57,0.18,0
19490,2174,-1000.00,0.00,1000.00,1000.00,1000.00,0.03,0
19491,2174,-601.88,-601.88,398.12,0.00,601.88,0.35,0
19492,2174,1000.00,398.12,1398.12,199.06,199.06,0.09,1
19493,2174,1000.00,1398.12,2398.12,356.43,1041.70,0.37,1
19494,2174,1000.00,2398.12,3398.12,118.22,1532.89,0.37,1
19495,2174,1000.00,3398.12,4398.12,0.00,3398.12,0.34,1
19496,2174,1000.00,4398.12,5398.12,0.00,2590.22,0.34,1
19497,2174,-1000.00,3398.12,4398.12,2760.34,2637.78,0.16,0
19498,2174,1000.00,4398.12,5398.12,0.00,2487.19,0.20,1
19499,2174,1000.00,5398.12,6398.12,1713.56,3684.56,0.35,1
19500,2174,1000.00,6398.12,7398.12,1917.61,3877.53,0.32,1
19501,2174,-1000.00,5398.12,6398.12,2146.47,102.70,0.11,0
19502,2174,1000.00,6398.12,7398.12,0.00,6398.12,0.04,1
19503,2174,1000.00,7398.12,8398.12,2532.26,4865.87,0.18,1
19504,2174,1000.00,8398.12,9398.12,2010.07,6388.05,0.42,1
19505,2174,1000.00,9398.12,10398.12,0.00,7339.51,0.29,1
19506,2174,1000.00,10398.12,11398.12,0.00,8476.74,0.35,1
19507,2175,-703.70,-703.70,296.30,0.00,703.70,0.26,0
19508,2175,-296.30,-1000.00,0.00,81.35,214.95,0.31,0
19509,2176,-709.44,-709.44,290.56,285.97,423.47,0.25,0
19510,2176,-290.56,-1000.00,0.00,141.79,148.78,0.09,0
19511,2177,-516.79,-516.79,483.21,0.00,516.79,0.05,0
19512,2177,-237.23,-754.02,245.98,0.00,237.23,0.18,0
19513,2177,-245.98,-1000.00,0.00,88.12,157.86,0.32,0
19514,2178,-1000.00,-1000.00,0.00,0.00,1000.00,0.28,0
19515,2179,-1000.00,-1000.00,0.00,0.00,1000.00,0.40,0
19516,2180,-1000.00,-1000.00,0.00,0.00,1000.00,0.10,0
19517,2181,-1000.00,-1000.00,0.00,166.43,833.57,0.08,0
19518,2182,-1000.00,-1000.00,0.00,0.00,382.95,0.44,0
19519,2183,-1000.00,-1000.00,0.00,495.41,504.59,0.05,0
19520,2184,-642.90,-642.90,357.10,0.00,642.90,0.16,0
19521,2184,-1000.00,-1642.90,-642.90,120.47,0.00,0.01,0
19522,2185,-1000.00,-1000.00,0.00,320.58,679.42,0.32,0
19523,2186,-672.86,-672.86,327.14,0.00,672.86,0.15,0
19524,2186,-327.14,-1000.00,0.00,131.63,195.51,0.08,0
19525,2187,-1000.00,-1000.00,0.00,18.14,981.86,0.39,0
19526,2188,-1000.00,-1000.00,0.00,0.00,1000.00,0.38,0
19527,2189,-1000.00,-1000.00,0.00,0.00,1000.00,0.23,0
19528,2190,0.00,0.00,1000.00,0.00,0.00,0.04,0
19529,2190,-803.10,-803.10,196.90,0.00,803.10,0.38,0
19530,2190,-75.91,-879.01,120.99,0.00,75.91,0.22,0
19531,2190,-89.91,-968.93,31.07,0.00,89.91,0.37,0
19532,2190,-1000.00,-1968.93,-968.93,8.49,3.70,0.14,0
19533,2191,-763.10,-763.10,236.90,341.40,421.70,0.24,0
19534,2191,-63.55,-826.66,173.34,0.00,63.55,0.21,0
19535,2191,-76.66,-903.31,96.69,10.18,66.48,0.26,0
19536,2191,-1000.00,-1903.31,-903.31,60.58,36.11,0.34,0
19537,2192,-1000.00,-1000.00,0.00,251.73,748.27,0.03,0
19538,2193,1000.00,1000.00,2000.00,0.00,886.96,0.41,1
19539,2193,1000.00,2000.00,3000.00,474.63,1525.37,0.36,1
19540,2193,1000.00,3000.00,4000.00,0.00,3000.00,0.06,1
19541,2193,1000.00,4000.00,5000.00,1076.04,1206.99,0.20,1
19542,2193,1000.00,5000.00,6000.00,1379.58,3620.42,0.02,1
19543,2193,-1000.00,4000.00,5000.00,1799.29,0.00,0.09,0
19544,2193,0.00,4000.00,5000.00,0.00,0.00,0.00,0
19545,2193,1000.00,5000.00,6000.00,0.00,1776.21,0.04,1
19546,2193,1000.00,6000.00,7000.00,0.00,6000.00,0.00,1
19547,2193,1000.00,7000.00,8000.00,1991.08,5008.92,0.23,1
19548,2193,1000.00,8000.00,9000.00,0.00,4019.96,0.30,1
19549,2193,1000.00,9000.00,10000.00,3632.35,5062.69,0.27,1
19550,2193,1000.00,10000.00,11000.00,1194.35,6724.92,0.37,1
19551,2193,1000.00,11000.00,12000.00,0.00,11000.00,0.29,1
19552,2193,1000.00,12000.00,13000.00,0.00,12000.00,0.06,1
19553,2193,1000.00,13000.00,14000.00,0.00,12627.02,0.10,1
19554,2193,1000.00,14000.00,15000.00,1473.09,10579.90,0.40,1
19555,2193,1000.00,15000.00,16000.00,0.00,15000.00,0.17,1
19556,2193,1000.00,16000.00,17000.00,4390.66,11609.34,0.36,1
19557,2193,1000.00,17000.00,18000.00,0.00,13661.14,0.11,1
19558,2193,1000.00,18000.00,19000.00,0.00,9011.88,0.18,1
19559,2193,1000.00,19000.00,20000.00,6359.04,12640.96,0.32,1
19560,2193,1000.00,20000.00,21000.00,0.00,20000.00,0.08,1
19561,2193,1000.00,21000.00,22000.00,0.00,13361.12,0.32,1
19562,2193,-1000.00,20000.00,21000.00,2453.89,0.00,0.08,0
19563,2193,-1000.00,19000.00,20000.00,17159.26,3840.74,0.06,0
19564,2193,-1000.00,18000.00,19000.00,0.00,14591.39,0.37,0
19565,2193,-1000.00,17000.00,18000.00,9142.42,9857.58,0.15,0
19566,2193,-1000.00,16000.00,17000.00,0.00,17073.78,0.03,0
19567,2193,-1000.00,15000.00,16000.00,0.00,8160.34,0.22,0
19568,2193,-1000.00,14000.00,15000.00,12167.29,3832.71,0.03,0
19569,2193,-1000.00,13000.00,14000.00,2900.72,1349.83,0.14,0
19570,2193,-1000.00,12000.00,13000.00,0.00,5923.61,0.27,0
19571,2193,-1000.00,11000.00,12000.00,7260.23,5739.77,0.03,0
19572,2193,-1000.00,10000.00,11000.00,0.00,12000.00,0.41,0
19573,2193,-1000.00,9000.00,10000.00,6477.15,4522.85,0.06,0
19574,2193,-1000.00,8000.00,9000.00,3302.01,6697.99,0.31,0
19575,2193,-1000.00,7000.00,8000.00,3650.77,5349.23,0.02,0
19576,2193,-1000.00,6000.00,7000.00,1441.07,6558.93,0.29,0
19577,2193,-1000.00,5000.00,6000.00,0.00,7000.00,0.11,0
19578,2193,-1000.00,4000.00,5000.00,836.40,5163.60,0.33,0
19579,2193,-1000.00,3000.00,4000.00,415.03,4584.97,0.05,0
19580,2193,-1000.00,2000.00,3000.00,564.76,3435.24,0.40,0
19581,2193,-1000.00,1000.00,2000.00,676.27,2323.73,0.26,0
19582,2193,-1000.00,0.00,1000.00,242.51,1757.49,0.42,0
19583,2194,-1000.00,-1000.00,0.00,404.58,595.42,0.18,0
19584,2195,1000.00,1000.00,2000.00,0.00,1000.00,0.08,1
19585,2195,1000.00,2000.00,3000.00,0.00,1976.70,0.26,1
19586,2195,1000.00,3000.00,4000.00,1275.52,1724.48,0.08,1
19587,2195,1000.00,4000.00,5000.00,1222.78,2777.22,0.32,1
19588,2195,-1000.00,3000.00,4000.00,1831.50,3168.50,0.28,0
19589,2195,-1000.00,2000.00,3000.00,1271.07,2728.93,0.28,0
19590,2195,-1000.00,1000.00,2000.00,1362.59,1637.41,0.13,0
19591,2195,-1000.00,0.00,1000.00,440.04,1368.58,0.39,0
19592,2195,-1000.00,-1000.00,0.00,0.00,1000.00,0.12,0
19593,2196,-321.44,-321.44,678.56,321.44,0.00,0.19,0
19594,2196,-1000.00,-1321.44,-321.44,0.00,464.96,0.42,0
19595,2197,-319.50,-319.50,680.50,0.00,319.50,0.10,0
19596,2197,1000.00,680.50,1680.50,160.92,66.08,0.33,1
19597,2197,1000.00,1680.50,2680.50,1356.66,0.00,0.09,1
19598,2197,-1000.00,680.50,1680.50,0.00,2239.87,0.13,0
19599,2197,-382.15,298.35,1298.35,0.00,382.15,0.13,0
19600,2197,-1000.00,-701.65,298.35,649.18,649.18,0.01,0
19601,2197,-116.03,-817.67,182.33,0.00,116.03,0.31,0
19602,2197,-182.33,-1000.00,0.00,71.79,110.54,0.22,0
19603,2198,1000.00,1000.00,2000.00,3.17,346.28,0.24,1
19604,2198,1000.00,2000.00,3000.00,635.19,1364.81,0.29,1
19605,2198,1000.00,3000.00,4000.00,0.00,3000.00,0.09,1
19606,2198,1000.00,4000.00,5000.00,0.00,4000.00,0.12,1
19607,2198,1000.00,5000.00,6000.00,0.00,5000.00,0.34,1
19608,2198,1000.00,6000.00,7000.00,2276.57,3723.43,0.18,1
19609,2198,1000.00,7000.00,8000.00,0.00,7000.00,0.28,1
19610,2198,-1000.00,6000.00,7000.00,3753.30,0.00,0.05,0
19611,2198,1000.00,7000.00,8000.00,0.00,7000.00,0.34,1
19612,2198,1000.00,8000.00,9000.00,0.00,7374.69,0.21,1
19613,2198,1000.00,9000.00,10000.00,0.00,9000.00,0.13,1
19614,2198,1000.00,10000.00,11000.00,422.05,6650.08,0.38,1
19615,2198,-1000.00,9000.00,10000.00,6603.26,4396.74,0.13,0
19616,2198,-1000.00,8000.00,9000.00,5901.92,4098.08,0.05,0
19617,2198,1000.00,9000.00,10000.00,0.00,9000.00,0.27,1
19618,2198,1000.00,10000.00,11000.00,4959.53,5040.47,0.15,1
19619,2198,1000.00,11000.00,12000.00,5500.00,5500.00,0.03,1
19620,2198,1000.00,12000.00,13000.00,0.00,12000.00,0.21,1
19621,2198,1000.00,13000.00,14000.00,2117.94,10882.06,0.38,1
19622,2198,-1000.00,12000.00,13000.00,2964.11,11035.89,0.26,0
19623,2198,-1000.00,11000.00,12000.00,0.00,13000.00,0.38,0
19624,2198,-1000.00,10000.00,11000.00,0.00,7084.04,0.34,0
19625,2198,-1000.00,9000.00,10000.00,3628.28,7371.72,0.34,0
19626,2198,-1000.00,8000.00,9000.00,5000.00,5000.00,0.35,0
19627,2198,-1000.00,7000.00,8000.00,3977.87,5022.13,0.13,0
19628,2198,-1000.00,6000.00,7000.00,0.00,8000.00,0.08,0
19629,2198,-1000.00,5000.00,6000.00,415.22,4577.30,0.37,0
19630,2198,-1000.00,4000.00,5000.00,3540.74,2459.26,0.17,0
19631,2198,-1000.00,3000.00,4000.00,1583.93,3416.07,0.34,0
19632,2198,-1000.00,2000.00,3000.00,0.00,4000.00,0.23,0
19633,2198,-1000.00,1000.00,2000.00,273.13,2726.87,0.36,0
19634,2198,-1000.00,0.00,1000.00,796.46,1203.54,0.29,0
19635,2198,-21.26,-21.26,978.74,0.00,21.26,0.04,0
19636,2198,-1000.00,-1021.26,-21.26,141.34,0.00,0.09,0
19637,2199,-1000.00,-1000.00,0.00,0.00,1000.00,0.05,0
19638,2200,-1000.00,-1000.00,0.00,0.00,1000.00,0.05,0
19639,2201,-1000.00,-1000.00,0.00,500.00,500.00,0.06,0
19640,2202,-1000.00,-1000.00,0.00,0.00,1000.00,0.28,0
19641,2203,-1000.00,-1000.00,0.00,134.31,865.69,0.39,0
19642,2204,-1000.00,-1000.00,0.00,0.00,1000.00,0.22,0
19643,2205,-846.23,-846.23,153.77,846.23,0.00,0.00,0
19644,2205,1000.00,153.77,1153.77,0.00,126.20,0.33,1
19645,2205,0.00,153.77,1153.77,0.00,0.00,0.05,0
19646,2205,1000.00,1153.77,2153.77,0.00,1153.77,0.33,1
19647,2205,1000.00,2153.77,3153.77,0.00,393.42,0.02,1
19648,2205,1000.00,3153.77,4153.77,511.72,1530.28,0.30,1
19649,2205,1000.00,4153.77,5153.77,0.00,4153.77,0.07,1
19650,2205,1000.00,5153.77,6153.77,0.00,5153.77,0.20,1
19651,2205,1000.00,6153.77,7153.77,0.00,6153.77,0.18,1
19652,2205,1000.00,7153.77,8153.77,0.00,6431.49,0.42,1
19653,2205,1000.00,8153.77,9153.77,4076.88,4076.88,0.09,1
19654,2205,1000.00,9153.77,10153.77,2385.39,3037.62,0.22,1
19655,2205,1000.00,10153.77,11153.77,431.79,2003.03,0.18,1
19656,2205,1000.00,11153.77,12153.77,0.00,11153.77,0.20,1
19657,2205,0.00,11153.77,12153.77,0.00,0.00,0.03,0
19658,2205,1000.00,12153.77,13153.77,3992.96,8160.81,0.37,1
19659,2205,-1000.00,11153.77,12153.77,6602.05,1791.80,0.14,0
19660,2205,1000.00,12153.77,13153.77,0.00,7858.40,0.35,1
19661,2205,1000.00,13153.77,14153.77,4867.27,8286.50,0.30,1
19662,2205,1000.00,14153.77,15153.77,0.00,11496.28,0.36,1
19663,2205,-1000.00,13153.77,14153.77,10050.98,248.20,0.10,0
19664,2205,1000.00,14153.77,15153.77,0.00,14153.77,0.27,1
19665,2205,1000.00,15153.77,16153.77,0.00,12499.98,0.27,1
19666,2205,1000.00,16153.77,17153.77,8076.88,8076.88,0.14,1
19667,2205,1000.00,17153.77,18153.77,0.00,17153.77,0.10,1
19668,2205,1000.00,18153.77,19153.77,0.00,6747.52,0.16,1
19669,2205,1000.00,19153.77,20153.77,5315.40,12825.32,0.36,1
19670,2205,1000.00,20153.77,21153.77,1911.10,18242.67,0.35,1
19671,2205,-1000.00,19153.77,20153.77,11221.16,8140.95,0.18,0
19672,2205,1000.00,20153.77,21153.77,0.00,3152.70,0.15,1
19673,2205,1000.00,21153.77,22153.77,32.40,21121.36,0.39,1
19674,2205,1000.00,22153.77,23153.77,6042.76,16111.01,0.38,1
19675,2205,1000.00,23153.77,24153.77,0.00,2752.28,0.08,1
19676,2205,1000.00,24153.77,25153.77,6442.61,17711.16,0.10,1
19677,2205,1000.00,25153.77,26153.77,5979.46,19174.30,0.38,1
19678,2205,1000.00,26153.77,27153.77,12587.63,13566.14,0.20,1
19679,2205,1000.00,27153.77,28153.77,0.00,27153.77,0.06,1
19680,2205,-1000.00,26153.77,27153.77,14507.96,13645.81,0.33,0
19681,2205,1000.00,27153.77,28153.77,0.00,9237.97,0.24,1
19682,2205,-1000.00,26153.77,27153.77,17900.80,10252.96,0.07,0
19683,2205,1000.00,27153.77,28153.77,9058.07,18095.69,0.25,1
19684,2205,1000.00,28153.77,29153.77,7550.19,20603.58,0.42,1
19685,2205,1000.00,29153.77,30153.77,10804.73,18349.04,0.31,1
19686,2205,1000.00,30153.77,31153.77,0.00,30153.77,0.02,1
19687,2206,-765.44,-765.44,234.56,0.00,765.44,0.23,0
19688,2206,-1000.00,-1765.44,-765.44,59.40,0.00,0.07,0
19689,2207,-1000.00,-1000.00,0.00,325.70,674.30,0.28,0
19690,2208,-364.58,-364.58,635.42,0.00,364.58,0.22,0
19691,2208,-635.42,-1000.00,0.00,309.76,325.65,0.19,0
19692,2209,-839.16,-839.16,160.84,0.00,839.16,0.24,0
19693,2209,-160.84,-1000.00,0.00,80.42,80.42,0.01,0
19694,2210,-1000.00,-1000.00,0.00,210.09,676.66,0.36,0
19695,2211,1000.00,1000.00,2000.00,114.33,789.65,0.41,1
19696,2211,1000.00,2000.00,3000.00,0.00,1452.99,0.12,1
19697,2211,-1000.00,1000.00,2000.00,2222.14,777.86,0.10,0
19698,2211,1000.00,2000.00,3000.00,0.00,723.39,0.01,1
19699,2211,1000.00,3000.00,4000.00,70.79,2929.21,0.37,1
19700,2211,-883.11,2116.89,3116.89,883.11,0.00,0.09,0
19701,2211,-1000.00,1116.89,2116.89,2630.41,486.48,0.17,0
19702,2211,1000.00,2116.89,3116.89,354.48,1762.41,0.39,1
19703,2211,0.00,2116.89,3116.89,0.00,0.00,0.01,0
19704,2211,-1000.00,1116.89,2116.89,2098.46,1018.42,0.11,0
19705,2211,1000.00,2116.89,3116.89,0.00,2116.89,0.11,1
19706,2211,1000.00,3116.89,4116.89,0.00,3116.89,0.41,1
19707,2211,1000.00,4116.89,5116.89,2022.53,2094.36,0.43,1
19708,2211,1000.00,5116.89,6116.89,0.00,3964.68,0.12,1
19709,2211,1000.00,6116.89,7116.89,2546.41,3570.48,0.21,1
19710,2211,-1000.00,5116.89,6116.89,2041.71,0.00,0.08,0
19711,2211,-1000.00,4116.89,5116.89,4105.89,2011.00,0.02,0
19712,2211,1000.00,5116.89,6116.89,2558.44,2558.44,0.02,1
19713,2211,1000.00,6116.89,7116.89,0.00,6116.89,0.00,1
19714,2211,1000.00,7116.89,8116.89,0.00,6408.09,0.25,1
19715,2211,1000.00,8116.89,9116.89,3821.70,4295.19,0.13,1
19716,2211,1000.00,9116.89,10116.89,1987.17,7129.72,0.13,1
19717,2211,1000.00,10116.89,11116.89,0.00,8439.31,0.11,1
19718,2211,1000.00,11116.89,12116.89,0.00,2949.29,0.26,1
19719,2211,1000.00,12116.89,13116.89,0.00,12116.89,0.02,1
19720,2211,1000.00,13116.89,14116.89,2578.15,8966.86,0.37,1
19721,2211,1000.00,14116.89,15116.89,6604.56,7512.33,0.01,1
19722,2211,0.00,14116.89,15116.89,0.00,0.00,0.03,0
19723,2211,1000.00,15116.89,16116.89,3577.32,11539.57,0.16,1
19724,2211,1000.00,16116.89,17116.89,5204.15,9726.76,0.31,1
19725,2211,1000.00,17116.89,18116.89,0.00,3936.91,0.16,1
19726,2211,1000.00,18116.89,19116.89,0.00,6575.39,0.10,1
19727,2211,-1000.00,17116.89,18116.89,15941.25,0.00,0.01,0
19728,2211,1000.00,18116.89,19116.89,9058.44,9058.44,0.11,1
19729,2211,1000.00,19116.89,20116.89,2393.64,16723.25,0.16,1
19730,2211,-1000.00,18116.89,19116.89,10375.25,9741.64,0.14,0
19731,2211,1000.00,19116.89,20116.89,0.00,18816.05,0.29,1
19732,2211,-1000.00,18116.89,19116.89,5417.89,4753.31,0.18,0
19733,2211,-1000.00,17116.89,18116.89,11628.01,7488.88,0.28,0
19734,2211,1000.00,18116.89,19116.89,0.00,18116.89,0.27,1
19735,2211,1000.00,19116.89,20116.89,9558.44,9558.44,0.31,1
19736,2211,1000.00,20116.89,21116.89,0.00,605.42,0.08,1
19737,2211,1000.00,21116.89,22116.89,0.00,2601.44,0.15,1
19738,2212,1000.00,1000.00,2000.00,261.31,318.62,0.21,1
19739,2212,1000.00,2000.00,3000.00,0.00,2000.00,0.22,1
19740,2212,1000.00,3000.00,4000.00,0.00,2797.19,0.27,1
19741,2212,1000.00,4000.00,5000.00,0.00,3950.59,0.16,1
19742,2212,1000.00,5000.00,6000.00,0.00,2959.34,0.28,1
19743,2212,-1000.00,4000.00,5000.00,3283.17,2716.83,0.25,0
19744,2212,1000.00,5000.00,6000.00,2477.87,2522.13,0.08,1
19745,2212,1000.00,6000.00,7000.00,182.04,5048.18,0.43,1
19746,2212,1000.00,7000.00,8000.00,3462.90,3537.10,0.14,1
19747,2212,1000.00,8000.00,9000.00,0.00,8000.00,0.29,1
19748,2212,1000.00,9000.00,10000.00,683.61,8316.39,0.44,1
19749,2212,1000.00,10000.00,11000.00,3483.12,6516.88,0.05,1
19750,2212,1000.00,11000.00,12000.00,0.00,9750.21,0.39,1
19751,2212,-104.83,10895.17,11895.17,104.83,0.00,0.06,0
19752,2212,1000.00,11895.17,12895.17,0.00,1422.40,0.13,1
19753,2212,1000.00,12895.17,13895.17,0.00,3896.99,0.18,1
19754,2212,1000.00,13895.17,14895.17,4061.87,9833.30,0.38,1
19755,2212,1000.00,14895.17,15895.17,6656.66,8238.52,0.08,1
19756,2212,1000.00,15895.17,16895.17,4705.32,11189.86,0.18,1
19757,2212,1000.00,16895.17,17895.17,7584.31,9310.86,0.15,1
19758,2212,-1000.00,15895.17,16895.17,14180.76,3714.41,0.18,0
19759,2212,1000.00,16895.17,17895.17,8076.30,8818.87,0.05,1
19760,2212,1000.00,17895.17,18895.17,0.00,17895.17,0.16,1
19761,2212,1000.00,18895.17,19895.17,8006.62,10888.55,0.19,1
19762,2212,-1000.00,17895.17,18895.17,10208.66,9686.51,0.43,0
19763,2212,-1000.00,16895.17,17895.17,0.00,18895.17,0.38,0
19764,2212,-1000.00,15895.17,16895.17,3268.11,14627.06,0.29,0
19765,2212,-1000.00,14895.17,15895.17,8295.24,8599.93,0.11,0
19766,2212,-1000.00,13895.17,14895.17,1957.98,13937.19,0.23,0
19767,2212,-1000.00,12895.17,13895.17,0.00,12228.90,0.40,0
19768,2212,-1000.00,11895.17,12895.17,0.00,13895.17,0.43,0
19769,2212,-1000.00,10895.17,11895.17,0.00,3104.55,0.04,0
19770,2212,-1000.00,9895.17,10895.17,5947.59,5947.59,0.07,0
19771,2212,-1000.00,8895.17,9895.17,6070.17,4825.00,0.19,0
19772,2212,-1000.00,7895.17,8895.17,4947.59,4947.59,0.06,0
19773,2212,-1000.00,6895.17,7895.17,0.00,8112.06,0.24,0
19774,2212,-1000.00,5895.17,6895.17,2560.23,5334.95,0.26,0
19775,2212,0.00,5895.17,6895.17,0.00,0.00,0.05,0
19776,2212,-1000.00,4895.17,5895.17,0.00,6895.17,0.21,0
19777,2212,-1000.00,3895.17,4895.17,76.63,5818.55,0.41,0
19778,2212,-1000.00,2895.17,3895.17,2447.59,2447.59,0.02,0
19779,2212,-1000.00,1895.17,2895.17,811.28,3083.90,0.31,0
19780,2212,-1000.00,895.17,1895.17,0.00,2895.17,0.13,0
19781,2212,-1000.00,-104.83,895.17,410.93,1484.25,0.40,0
19782,2212,-359.20,-464.03,535.97,75.64,283.57,0.23,0
19783,2212,-535.97,-1000.00,0.00,0.00,535.97,0.32,0
19784,2213,-881.76,-881.76,118.24,430.91,450.84,0.22,0
19785,2213,-118.24,-1000.00,0.00,0.00,118.24,0.05,0
19786,2214,1000.00,1000.00,2000.00,0.00,584.69,0.16,1
19787,2214,-116.25,883.75,1883.75,116.25,0.00,0.01,0
19788,2214,1000.00,1883.75,2883.75,0.00,1710.72,0.43,1
19789,2214,1000.00,2883.75,3883.75,0.00,639.93,0.16,1
19790,2214,-1000.00,1883.75,2883.75,2460.43,1423.32,0.24,0
19791,2214,1000.00,2883.75,3883.75,1441.88,1441.88,0.02,1
19792,2214,1000.00,3883.75,4883.75,0.00,3883.75,0.23,1
19793,2214,1000.00,4883.75,5883.75,710.25,4173.50,0.29,1
19794,2214,1000.00,5883.75,6883.75,0.00,3074.44,0.23,1
19795,2214,1000.00,6883.75,7883.75,2497.13,4386.62,0.13,1
19796,2214,1000.00,7883.75,8883.75,3941.88,3941.88,0.07,1
19797,2214,1000.00,8883.75,9883.75,1244.96,7638.79,0.42,1
19798,2214,1000.00,9883.75,10883.75,320.60,9070.03,0.44,1
19799,2214,1000.00,10883.75,11883.75,0.00,3305.83,0.22,1
19800,2214,1000.00,11883.75,12883.75,4323.57,7560.18,0.09,1
19801,2214,1000.00,12883.75,13883.75,6441.88,6441.88,0.32,1
19802,2214,1000.00,13883.75,14883.75,0.00,13883.75,0.41,1
19803,2214,1000.00,14883.75,15883.75,5883.37,9000.38,0.29,1
19804,2214,1000.00,15883.75,16883.75,6873.55,9010.20,0.26,1
19805,2214,1000.00,16883.75,17883.75,8441.88,8441.88,0.29,1
19806,2214,1000.00,17883.75,18883.75,0.00,6171.67,0.21,1
19807,2214,1000.00,18883.75,19883.75,4553.98,14329.77,0.33,1
19808,2214,1000.00,19883.75,20883.75,9941.88,9941.88,0.16,1
19809,2214,1000.00,20883.75,21883.75,7291.30,13592.45,0.06,1
19810,2214,1000.00,21883.75,22883.75,4501.06,17382.69,0.32,1
19811,2214,1000.00,22883.75,23883.75,0.00,13417.87,0.16,1
19812,2214,1000.00,23883.75,24883.75,11941.88,11941.88,0.02,1
19813,2214,1000.00,24883.75,25883.75,10530.55,14353.20,0.21,1
19814,2214,1000.00,25883.75,26883.75,4007.94,17740.53,0.37,1
19815,2214,-1000.00,24883.75,25883.75,16173.15,10710.60,0.26,0
19816,2214,1000.00,25883.75,26883.75,0.00,21661.05,0.25,1
19817,2214,1000.00,26883.75,27883.75,13441.88,13441.88,0.09,1
19818,2214,1000.00,27883.75,28883.75,0.00,27883.75,0.27,1
19819,2214,1000.00,28883.75,29883.75,0.00,28883.75,0.24,1
19820,2214,-1000.00,27883.75,28883.75,15991.02,13892.73,0.20,0
19821,2214,1000.00,28883.75,29883.75,5537.65,19839.66,0.37,1
19822,2214,1000.00,29883.75,30883.75,11526.94,18356.82,0.26,1
19823,2214,-1000.00,28883.75,29883.75,8321.86,7642.83,0.18,0
19824,2214,1000.00,29883.75,30883.75,0.00,29883.75,0.34,1
19825,2214,1000.00,30883.75,31883.75,0.00,30883.75,0.04,1
19826,2214,1000.00,31883.75,32883.75,0.00,31883.75,0.08,1
19827,2214,1000.00,32883.75,33883.75,13385.36,19498.40,0.28,1
19828,2214,1000.00,33883.75,34883.75,0.00,33883.75,0.32,1
19829,2214,1000.00,34883.75,35883.75,17441.88,17441.88,0.08,1
19830,2214,1000.00,35883.75,36883.75,0.00,35883.75,0.18,1
19831,2214,1000.00,36883.75,37883.75,4813.90,32069.85,0.37,1
19832,2214,-1000.00,35883.75,36883.75,20372.43,17511.32,0.36,0
19833,2214,-1000.00,34883.75,35883.75,18441.88,18441.88,0.28,0
19834,2214,-1000.00,33883.75,34883.75,6594.35,2546.41,0.13,0
19835,2214,-1000.00,32883.75,33883.75,6783.08,18821.71,0.31,0
19836,2214,0.00,32883.75,33883.75,0.00,0.00,0.06,0
19837,2214,-1000.00,31883.75,32883.75,16150.84,17732.91,0.21,0
19838,2214,-1000.00,30883.75,31883.75,8555.64,16852.85,0.29,0
19839,2214,-1000.00,29883.75,30883.75,8469.27,10767.97,0.22,0
19840,2214,-1000.00,28883.75,29883.75,15441.88,15441.88,0.12,0
19841,2214,-1000.00,27883.75,28883.75,0.00,8526.11,0.15,0
19842,2214,-1000.00,26883.75,27883.75,6038.62,22845.13,0.36,0
19843,2214,-1000.00,25883.75,26883.75,15006.38,10021.79,0.17,0
19844,2214,-1000.00,24883.75,25883.75,1135.74,25748.01,0.40,0
19845,2214,-1000.00,23883.75,24883.75,6405.36,19478.39,0.38,0
19846,2214,-1000.00,22883.75,23883.75,0.00,1664.13,0.10,0
19847,2214,-1000.00,21883.75,22883.75,0.00,23883.75,0.04,0
19848,2214,-1000.00,20883.75,21883.75,5983.54,16900.21,0.19,0
19849,2214,-1000.00,19883.75,20883.75,12245.46,6638.81,0.15,0
19850,2214,-1000.00,18883.75,19883.75,0.00,20883.75,0.22,0
19851,2214,-1000.00,17883.75,18883.75,3066.91,16816.84,0.41,0
19852,2214,-1000.00,16883.75,17883.75,9267.85,9615.90,0.12,0
19853,2214,-1000.00,15883.75,16883.75,0.00,17791.01,0.06,0
19854,2214,-1000.00,14883.75,15883.75,2401.30,13594.57,0.41,0
19855,2214,-1000.00,13883.75,14883.75,4071.05,11103.22,0.28,0
19856,2214,-1000.00,12883.75,13883.75,6825.27,8058.48,0.24,0
19857,2214,-1000.00,11883.75,12883.75,4494.56,0.00,0.09,0
19858,2214,-1000.00,10883.75,11883.75,0.00,12883.75,0.18,0
19859,2214,0.00,10883.75,11883.75,0.00,0.00,0.02,0
19860,2214,-1000.00,9883.75,10883.75,0.00,11883.75,0.07,0
19861,2214,-1000.00,8883.75,9883.75,5441.88,5441.88,0.01,0
19862,2214,-1000.00,7883.75,8883.75,4532.89,5350.86,0.25,0
19863,2214,-1000.00,6883.75,7883.75,1330.00,5828.86,0.36,0
19864,2214,-1000.00,5883.75,6883.75,0.00,7883.75,0.26,0
19865,2214,-1000.00,4883.75,5883.75,2008.93,4874.82,0.28,0
19866,2214,-1000.00,3883.75,4883.75,2941.88,2941.88,0.02,0
19867,2214,-1000.00,2883.75,3883.75,3977.62,906.14,0.06,0
19868,2214,-1000.00,1883.75,2883.75,0.00,3883.75,0.16,0
19869,2214,-1000.00,883.75,1883.75,0.00,2883.75,0.08,0
19870,2214,-1000.00,-116.25,883.75,1775.53,0.00,0.02,0
19871,2214,-845.24,-961.49,38.51,0.00,845.24,0.43,0
19872,2214,-37.07,-998.56,1.44,0.00,37.07,0.08,0
19873,2214,-1.44,-1000.00,0.00,0.00,1.44,0.20,0
19874,2215,-581.57,-581.57,418.43,0.00,581.57,0.34,0
19875,2215,-418.43,-1000.00,0.00,57.28,361.16,0.36,0
19876,2215,-0.00,-1000.00,-0.00,0.00,0.00,0.02,0
19877,2216,-1000.00,-1000.00,0.00,0.00,905.78,0.39,0
19878,2217,-1000.00,-1000.00,0.00,535.97,464.03,0.10,0
19879,2218,-1000.00,-1000.00,0.00,368.30,631.70,0.26,0
19880,2219,-595.93,-595.93,404.07,595.93,0.00,0.05,0
19881,2219,1000.00,404.07,1404.07,0.00,79.23,0.15,1
19882,2219,-1000.00,-595.93,404.07,1225.18,178.89,0.01,0
19883,2219,1000.00,404.07,1404.07,0.00,404.07,0.20,1
19884,2219,-1000.00,-595.93,404.07,692.38,500.90,0.18,0
19885,2219,1000.00,404.07,1404.07,162.68,241.39,0.12,1
19886,2219,1000.00,1404.07,2404.07,406.59,997.48,0.34,1
19887,2219,1000.00,2404.07,3404.07,0.00,1956.75,0.39,1
19888,2219,1000.00,3404.07,4404.07,0.00,3404.07,0.34,1
19889,2219,1000.00,4404.07,5404.07,1926.91,2477.16,0.09,1
19890,2219,1000.00,5404.07,6404.07,971.00,4433.07,0.12,1
19891,2219,1000.00,6404.07,7404.07,0.00,3585.78,0.24,1
19892,2219,1000.00,7404.07,8404.07,3261.96,4142.11,0.44,1
19893,2219,1000.00,8404.07,9404.07,0.00,8404.07,0.02,1
19894,2219,1000.00,9404.07,10404.07,0.00,9404.07,0.20,1
19895,2219,1000.00,10404.07,11404.07,0.00,10404.07,0.04,1
19896,2219,1000.00,11404.07,12404.07,5671.79,5732.28,0.08,1
19897,2219,1000.00,12404.07,13404.07,0.00,12404.07,0.02,1
19898,2219,-1000.00,11404.07,12404.07,3471.32,1947.42,0.15,0
19899,2219,1000.00,12404.07,13404.07,0.00,10523.88,0.29,1
19900,2219,1000.00,13404.07,14404.07,4071.40,9332.67,0.31,1
19901,2219,-1000.00,12404.07,13404.07,8928.42,5475.65,0.31,0
19902,2219,1000.00,13404.07,14404.07,0.00,5533.97,0.28,1
19903,2219,-1000.00,12404.07,13404.07,7389.71,6451.80,0.20,0
19904,2219,1000.00,13404.07,14404.07,0.00,8121.94,0.22,1
19905,2219,1000.00,14404.07,15404.07,3106.99,11297.08,0.10,1
19906,2219,1000.00,15404.07,16404.07,0.00,14679.87,0.41,1
19907,2219,1000.00,16404.07,17404.07,8202.04,8202.04,0.09,1
19908,2219,1000.00,17404.07,18404.07,0.00,17404.07,0.02,1
19909,2219,1000.00,18404.07,19404.07,0.00,7550.72,0.27,1
19910,2219,1000.00,19404.07,20404.07,493.91,9760.62,0.31,1
19911,2219,1000.00,20404.07,21404.07,0.00,17595.30,0.37,1
19912,2219,1000.00,21404.07,22404.07,0.00,13754.64,0.30,1
19913,2219,1000.00,22404.07,23404.07,9568.20,12835.87,0.11,1
19914,2219,1000.00,23404.07,24404.07,0.00,23404.07,0.31,1
19915,2219,1000.00,24404.07,25404.07,0.00,7100.05,0.17,1
19916,2219,-1000.00,23404.07,24404.07,9273.69,0.00,0.01,0
19917,2219,1000.00,24404.07,25404.07,11703.55,12700.52,0.08,1
19918,2219,1000.00,25404.07,26404.07,12702.04,12702.04,0.05,1
19919,2219,1000.00,26404.07,27404.07,0.00,1090.95,0.08,1
19920,2219,1000.00,27404.07,28404.07,0.00,20680.27,0.34,1
19921,2219,1000.00,28404.07,29404.07,14202.04,14202.04,0.05,1
19922,2219,1000.00,29404.07,30404.07,7351.28,22052.79,0.35,1
19923,2219,1000.00,30404.07,31404.07,13889.14,16514.93,0.19,1
19924,2219,1000.00,31404.07,32404.07,3686.19,26979.42,0.42,1
19925,2219,-1000.00,30404.07,31404.07,3253.73,29150.34,0.44,0
19926,2219,-1000.00,29404.07,30404.07,0.00,24157.22,0.36,0
19927,2219,-1000.00,28404.07,29404.07,6763.06,10602.31,0.23,0
19928,2219,-1000.00,27404.07,28404.07,5088.94,24315.13,0.19,0
19929,2219,-1000.00,26404.07,27404.07,0.00,22750.81,0.30,0
19930,2219,-1000.00,25404.07,26404.07,0.00,27404.07,0.12,0
19931,2219,-1000.00,24404.07,25404.07,13106.53,8717.50,0.19,0
19932,2219,-1000.00,23404.07,24404.07,7039.80,18364.27,0.35,0
19933,2219,-1000.00,22404.07,23404.07,0.00,14297.30,0.31,0
19934,2219,-1000.00,21404.07,22404.07,0.00,23404.07,0.36,0
19935,2219,-1000.00,20404.07,21404.07,13624.58,8779.50,0.20,0
19936,2219,-1000.00,19404.07,20404.07,0.00,21404.07,0.36,0
19937,2219,-1000.00,18404.07,19404.07,0.00,17625.37,0.37,0
19938,2219,0.00,18404.07,19404.07,0.00,0.00,0.05,0
19939,2219,-1000.00,17404.07,18404.07,0.00,16652.50,0.35,0
19940,2219,-1000.00,16404.07,17404.07,0.00,18404.07,0.01,0
19941,2219,-1000.00,15404.07,16404.07,0.00,13837.12,0.33,0
19942,2219,-1000.00,14404.07,15404.07,9321.35,7082.72,0.40,0
19943,2219,-1000.00,13404.07,14404.07,0.00,11831.69,0.29,0
19944,2220,-1000.00,-1000.00,0.00,174.19,825.81,0.27,0
19945,2221,-1000.00,-1000.00,0.00,0.00,1000.00,0.17,0
19946,2222,-1000.00,-1000.00,0.00,176.86,823.14,0.00,0
19947,2223,1000.00,1000.00,2000.00,0.00,863.42,0.25,1
19948,2223,1000.00,2000.00,3000.00,0.00,1242.49,0.08,1
19949,2223,1000.00,3000.00,4000.00,1211.10,1788.90,0.28,1
19950,2223,1000.00,4000.00,5000.00,0.00,2755.68,0.37,1
19951,2223,1000.00,5000.00,6000.00,0.00,4670.25,0.41,1
19952,2223,1000.00,6000.00,7000.00,1061.44,4938.56,0.42,1
19953,2223,-1000.00,5000.00,6000.00,3745.71,3254.29,0.02,0
19954,2223,1000.00,6000.00,7000.00,0.00,6000.00,0.29,1
19955,2223,1000.00,7000.00,8000.00,21.46,6789.39,0.44,1
19956,2223,1000.00,8000.00,9000.00,756.21,7243.79,0.32,1
19957,2223,1000.00,9000.00,10000.00,0.00,9000.00,0.30,1
19958,2223,1000.00,10000.00,11000.00,0.00,10000.00,0.01,1
19959,2223,-1000.00,9000.00,10000.00,3735.55,7264.45,0.29,0
19960,2223,-1000.00,8000.00,9000.00,0.00,5947.30,0.28,0
19961,2223,-1000.00,7000.00,8000.00,0.00,5013.43,0.34,0
19962,2223,-1000.00,6000.00,7000.00,4000.63,3999.37,0.18,0
19963,2223,-1000.00,5000.00,6000.00,924.05,6075.95,0.42,0
19964,2223,-1000.00,4000.00,5000.00,2469.63,3530.37,0.28,0
19965,2223,-1000.00,3000.00,4000.00,0.00,1896.52,0.25,0
19966,2223,-1000.00,2000.00,3000.00,3132.22,582.19,0.07,0
19967,2223,-1000.00,1000.00,2000.00,0.00,1458.99,0.06,0
19968,2223,-1000.00,0.00,1000.00,1000.00,1000.00,0.03,0
19969,2223,-1000.00,-1000.00,0.00,15.66,984.34,0.37,0
19970,2224,-1000.00,-1000.00,0.00,420.33,579.67,0.27,0
19971,2225,0.00,0.00,1000.00,0.00,0.00,0.04,0
19972,2225,-1000.00,-1000.00,0.00,0.00,484.99,0.23,0
19973,2226,-1000.00,-1000.00,0.00,741.12,258.88,0.03,0
19974,2227,1000.00,1000.00,2000.00,558.31,441.69,0.18,1
19975,2227,-1000.00,0.00,1000.00,0.00,2000.00,0.29,0
19976,2227,-1000.00,-1000.00,0.00,449.07,550.93,0.18,0
19977,2228,-1000.00,-1000.00,0.00,648.53,351.47,0.08,0
19978,2228,0.00,-1000.00,0.00,0.00,0.00,0.32,1
19979,2228,0.00,-1000.00,0.00,0.00,0.00,0.38,1
19980,2228,0.00,-1000.00,0.00,0.00,0.00,0.31,1
19981,2228,0.00,-1000.00,0.00,0.00,0.00,0.27,1
19982,2228,0.02,-999.98,0.02,0.00,0.00,0.22,1
19983,2228,3.36,-996.62,3.38,0.00,0.02,0.32,1
19984,2228,685.81,-310.81,689.19,0.00,3.38,0.33,1
19985,2228,1000.00,689.19,1689.19,0.00,405.26,0.15,1
19986,2228,1000.00,1689.19,2689.19,210.79,1478.40,0.30,1
19987,2228,1000.00,2689.19,3689.19,0.00,2689.19,0.42,1
19988,2228,1000.00,3689.19,4689.19,0.00,2693.09,0.40,1
19989,2228,1000.00,4689.19,5689.19,1357.45,3331.74,0.18,1
19990,2228,1000.00,5689.19,6689.19,1016.10,4673.09,0.41,1
19991,2228,1000.00,6689.19,7689.19,0.00,6689.19,0.38,1
19992,2228,1000.00,7689.19,8689.19,0.00,7689.19,0.28,1
19993,2228,1000.00,8689.19,9689.19,0.00,8245.60,0.33,1
19994,2228,-1000.00,7689.19,8689.19,6495.25,3193.94,0.21,0
19995,2228,1000.00,8689.19,9689.19,0.00,8689.19,0.32,1
19996,2228,1000.00,9689.19,10689.19,4484.97,5204.22,0.15,1
19997,2228,-1000.00,8689.19,9689.19,6951.44,3737.75,0.30,0
19998,2228,1000.00,9689.19,10689.19,0.00,9689.19,0.17,1
19999,2228,1000.00,10689.19,11689.19,2975.75,7713.44,0.34,1
20000,2228,-1000.00,9689.19,10689.19,4484.87,7204.32,0.20,0
20001,2228,-1000.00,8689.19,9689.19,1249.49,9439.70,0.43,0
20002,2228,0.00,8689.19,9689.19,0.00,0.00,0.04,0
20003,2228,-1000.00,7689.19,8689.19,3215.21,6473.98,0.33,0
20004,2228,-1000.00,6689.19,7689.19,0.00,1446.01,0.16,0
20005,2228,-1000.00,5689.19,6689.19,2229.05,5460.14,0.36,0
20006,2228,-1000.00,4689.19,5689.19,1073.20,1679.12,0.20,0
20007,2228,-1000.00,3689.19,4689.19,0.00,3961.12,0.10,0
20008,2228,-1000.00,2689.19,3689.19,0.00,2340.55,0.29,0
20009,2228,-1000.00,1689.19,2689.19,0.00,3434.84,0.42,0
20010,2228,-1000.00,689.19,1689.19,1280.81,1408.38,0.06,0
20011,2228,-1000.00,-310.81,689.19,618.71,1070.48,0.16,0
20012,2228,-689.19,-1000.00,0.00,344.60,344.60,0.15,0
20013,2229,-488.73,-488.73,511.27,0.00,488.73,0.22,0
20014,2229,-511.27,-1000.00,0.00,0.00,511.27,0.25,0
20015,2230,1000.00,1000.00,2000.00,101.76,58.20,0.30,1
20016,2230,-1000.00,0.00,1000.00,0.00,2000.00,0.22,0
20017,2230,-262.25,-262.25,737.75,0.00,262.25,0.23,0
20018,2230,1000.00,737.75,1737.75,590.80,0.00,0.16,1
20019,2230,-1000.00,-262.25,737.75,868.87,868.87,0.40,0
20020,2230,-43.40,-305.65,694.35,0.00,43.40,0.33,0
20021,2230,-694.35,-1000.00,0.00,286.08,408.27,0.27,0
20022,2231,-1000.00,-1000.00,0.00,521.67,478.33,0.19,0
20023,2232,-263.09,-263.09,736.91,40.50,222.59,0.19,0
20024,2232,-1000.00,-1263.09,-263.09,107.12,0.00,0.07,0
20025,2233,-1000.00,-1000.00,0.00,381.24,618.76,0.06,0
20026,2234,1000.00,1000.00,2000.00,0.00,586.79,0.34,1
20027,2234,1000.00,2000.00,3000.00,0.00,564.01,0.16,1
20028,2234,1000.00,3000.00,4000.00,435.72,2564.28,0.33,1
20029,2234,-1000.00,2000.00,3000.00,2120.37,1879.63,0.17,0
20030,2234,1000.00,3000.00,4000.00,0.00,3000.00,0.20,1
20031,2234,1000.00,4000.00,5000.00,800.15,3199.85,0.11,1
20032,2234,1000.00,5000.00,6000.00,0.00,5000.00,0.21,1
20033,2234,1000.00,6000.00,7000.00,1382.97,4617.03,0.30,1
20034,2234,1000.00,7000.00,8000.00,1824.30,5175.70,0.28,1
20035,2234,1000.00,8000.00,9000.00,0.00,8000.00,0.06,1
20036,2234,1000.00,9000.00,10000.00,0.00,5470.65,0.34,1
20037,2234,1000.00,10000.00,11000.00,5000.00,5000.00,0.40,1
20038,2234,-1000.00,9000.00,10000.00,9326.10,1673.90,0.02,0
20039,2234,1000.00,10000.00,11000.00,0.00,5901.73,0.01,1
20040,2234,1000.00,11000.00,12000.00,0.00,7168.65,0.37,1
20041,2234,1000.00,12000.00,13000.00,2759.56,9240.44,0.39,1
20042,2234,-1000.00,11000.00,12000.00,6882.93,6117.07,0.20,0
20043,2234,1000.00,12000.00,13000.00,0.00,12000.00,0.17,1
20044,2234,1000.00,13000.00,14000.00,0.00,972.31,0.13,1
20045,2234,-1000.00,12000.00,13000.00,10975.84,3024.16,0.04,0
20046,2234,1000.00,13000.00,14000.00,0.00,13000.00,0.31,1
20047,2234,1000.00,14000.00,15000.00,0.00,7859.96,0.33,1
20048,2234,-1000.00,13000.00,14000.00,9557.45,5442.55,0.07,0
20049,2234,1000.00,14000.00,15000.00,0.00,14000.00,0.15,1
20050,2234,-1000.00,13000.00,14000.00,2590.32,1574.38,0.14,0
20051,2234,1000.00,14000.00,15000.00,0.00,12937.20,0.40,1
20052,2234,1000.00,15000.00,16000.00,5918.53,9081.47,0.27,1
20053,2234,1000.00,16000.00,17000.00,0.00,6185.08,0.08,1
20054,2234,1000.00,17000.00,18000.00,0.00,12276.62,0.15,1
20055,2234,1000.00,18000.00,19000.00,9000.00,9000.00,0.07,1
20056,2234,1000.00,19000.00,20000.00,3062.03,15937.97,0.32,1
20057,2234,-1000.00,18000.00,19000.00,20000.00,0.00,0.07,0
20058,2234,1000.00,19000.00,20000.00,2950.70,5555.72,0.21,1
20059,2234,1000.00,20000.00,21000.00,8080.90,11919.10,0.23,1
20060,2234,1000.00,21000.00,22000.00,7856.33,13143.67,0.22,1
20061,2234,1000.00,22000.00,23000.00,0.00,11479.04,0.31,1
20062,2234,1000.00,23000.00,24000.00,0.00,19222.13,0.37,1
20063,2234,-1000.00,22000.00,23000.00,11290.85,7054.97,0.16,0
20064,2234,1000.00,23000.00,24000.00,0.00,831.53,0.02,1
20065,2234,1000.00,24000.00,25000.00,6750.16,17249.84,0.38,1
20066,2234,1000.00,25000.00,26000.00,0.00,25000.00,0.44,1
20067,2235,1000.00,1000.00,2000.00,0.00,1000.00,0.09,1
20068,2235,1000.00,2000.00,3000.00,0.00,63.64,0.05,1
20069,2235,1000.00,3000.00,4000.00,508.35,2491.65,0.21,1
20070,2235,1000.00,4000.00,5000.00,1320.19,2679.81,0.27,1
20071,2235,1000.00,5000.00,6000.00,1613.84,3386.16,0.32,1
20072,2235,1000.00,6000.00,7000.00,1126.47,4873.53,0.22,1
20073,2235,-1000.00,5000.00,6000.00,3626.78,3373.22,0.15,0
20074,2235,1000.00,6000.00,7000.00,0.00,6000.00,0.37,1
20075,2235,1000.00,7000.00,8000.00,0.00,6637.32,0.08,1
20076,2235,1000.00,8000.00,9000.00,1016.52,6983.48,0.37,1
20077,2235,1000.00,9000.00,10000.00,1312.85,7687.15,0.42,1
20078,2235,1000.00,10000.00,11000.00,3586.61,6413.39,0.32,1
20079,2235,1000.00,11000.00,12000.00,0.00,10268.00,0.23,1
20080,2235,-160.19,10839.81,11839.81,160.19,0.00,0.09,0
20081,2235,1000.00,11839.81,12839.81,0.00,9204.54,0.33,1
20082,2235,1000.00,12839.81,13839.81,0.00,12839.81,0.30,1
20083,2235,0.00,12839.81,13839.81,0.00,0.00,0.06,0
20084,2235,1000.00,13839.81,14839.81,0.00,13142.84,0.43,1
20085,2235,1000.00,14839.81,15839.81,6571.55,8268.26,0.22,1
20086,2235,1000.00,15839.81,16839.81,2912.97,12926.84,0.15,1
20087,2235,1000.00,16839.81,17839.81,2801.75,14038.06,0.42,1
20088,2235,1000.00,17839.81,18839.81,3787.94,14051.86,0.22,1
20089,2235,-1000.00,16839.81,17839.81,11474.39,7365.42,0.31,0
20090,2235,-1000.00,15839.81,16839.81,0.00,17839.81,0.34,0
20091,2235,-1000.00,14839.81,15839.81,0.00,16839.81,0.40,0
20092,2235,-1000.00,13839.81,14839.81,0.00,15839.81,0.11,0
20093,2235,-1000.00,12839.81,13839.81,0.00,14839.81,0.32,0
20094,2235,-1000.00,11839.81,12839.81,0.00,13839.81,0.17,0
20095,2235,-1000.00,10839.81,11839.81,8383.25,4456.55,0.12,0
20096,2235,-1000.00,9839.81,10839.81,434.59,11405.22,0.25,0
20097,2235,-1000.00,8839.81,9839.81,2117.77,8722.03,0.07,0
20098,2235,-1000.00,7839.81,8839.81,0.00,9839.81,0.15,0
20099,2235,-1000.00,6839.81,7839.81,2612.11,6227.70,0.35,0
20100,2235,-1000.00,5839.81,6839.81,0.00,7468.08,0.44,0
20101,2235,-1000.00,4839.81,5839.81,0.00,6839.81,0.05,0
20102,2235,-1000.00,3839.81,4839.81,0.00,3660.40,0.37,0
20103,2235,-1000.00,2839.81,3839.81,0.00,4839.81,0.02,0
20104,2235,-1000.00,1839.81,2839.81,2523.25,729.25,0.10,0
20105,2235,1000.00,2839.81,3839.81,0.00,496.51,0.17,1
20106,2235,1000.00,3839.81,4839.81,1919.90,1919.90,0.37,1
20107,2235,1000.00,4839.81,5839.81,0.00,3483.06,0.04,1
20108,2235,1000.00,5839.81,6839.81,212.54,4902.50,0.43,1
20109,2235,1000.00,6839.81,7839.81,0.00,6488.73,0.17,1
20110,2235,0.00,6839.81,7839.81,0.00,0.00,0.03,0
20111,2235,1000.00,7839.81,8839.81,0.00,3379.12,0.19,1
20112,2235,1000.00,8839.81,9839.81,3438.61,5401.20,0.24,1
20113,2235,1000.00,9839.81,10839.81,0.00,9839.81,0.33,1
20114,2235,-1000.00,8839.81,9839.81,3034.52,0.00,0.06,0
20115,2235,1000.00,9839.81,10839.81,0.00,9758.71,0.42,1
20116,2235,1000.00,10839.81,11839.81,0.00,2617.36,0.19,1
20117,2235,1000.00,11839.81,12839.81,0.00,11839.81,0.06,1
20118,2235,1000.00,12839.81,13839.81,0.00,12477.04,0.22,1
20119,2235,1000.00,13839.81,14839.81,4754.64,9085.17,0.29,1
20120,2236,0.00,0.00,1000.00,0.00,0.00,0.03,0
20121,2236,-1000.00,-1000.00,0.00,901.96,98.04,0.03,0
20122,2237,-1000.00,-1000.00,0.00,0.00,881.79,0.35,0
20123,2238,-1000.00,-1000.00,0.00,0.00,406.93,0.11,0
20124,2239,-625.86,-625.86,374.14,255.33,370.52,0.26,0
20125,2239,-374.14,-1000.00,0.00,134.60,239.54,0.30,0
20126,2240,-1000.00,-1000.00,0.00,1.01,998.99,0.42,0
20127,2241,0.00,0.00,1000.00,0.00,0.00,0.05,0
20128,2241,-1000.00,-1000.00,0.00,134.62,865.38,0.17,0
20129,2242,-1000.00,-1000.00,0.00,0.00,1000.00,0.31,0
20130,2243,1000.00,1000.00,2000.00,138.06,493.52,0.30,1
20131,2243,1000.00,2000.00,3000.00,1000.00,1000.00,0.02,1
20132,2243,1000.00,3000.00,4000.00,0.00,3000.00,0.04,1
20133,2243,1000.00,4000.00,5000.00,0.00,1572.45,0.07,1
20134,2243,1000.00,5000.00,6000.00,0.00,4756.65,0.39,1
20135,2243,1000.00,6000.00,7000.00,1953.27,2959.81,0.27,1
20136,2243,1000.00,7000.00,8000.00,0.00,5759.01,0.42,1
20137,2243,-1000.00,6000.00,7000.00,2106.83,0.00,0.03,0
20138,2243,1000.00,7000.00,8000.00,749.95,6250.05,0.38,1
20139,2243,-1000.00,6000.00,7000.00,1654.46,0.00,0.10,0
20140,2243,1000.00,7000.00,8000.00,135.67,3175.69,0.29,1
20141,2243,1000.00,8000.00,9000.00,3439.64,4560.36,0.38,1
20142,2243,1000.00,9000.00,10000.00,0.00,9000.00,0.37,1
20143,2243,1000.00,10000.00,11000.00,0.00,10000.00,0.01,1
20144,2243,1000.00,11000.00,12000.00,0.00,9173.04,0.39,1
20145,2243,1000.00,12000.00,13000.00,5548.22,6451.78,0.25,1
20146,2243,1000.00,13000.00,14000.00,1773.34,11226.66,0.13,1
20147,2243,1000.00,14000.00,15000.00,0.00,14000.00,0.29,1
20148,2243,1000.00,15000.00,16000.00,0.00,5036.48,0.14,1
20149,2243,1000.00,16000.00,17000.00,0.00,14545.35,0.07,1
20150,2243,1000.00,17000.00,18000.00,0.00,12681.03,0.39,1
20151,2243,-1000.00,16000.00,17000.00,10313.15,7686.85,0.38,0
20152,2243,1000.00,17000.00,18000.00,0.00,16059.80,0.41,1
20153,2243,1000.00,18000.00,19000.00,9000.00,9000.00,0.02,1
20154,2243,1000.00,19000.00,20000.00,9500.00,9500.00,0.17,1
20155,2243,1000.00,20000.00,21000.00,0.00,20000.00,0.34,1
20156,2243,0.00,20000.00,21000.00,0.00,0.00,0.01,0
20157,2243,1000.00,21000.00,22000.00,5986.61,15013.39,0.35,1
20158,2243,1000.00,22000.00,23000.00,0.00,12368.92,0.18,1
20159,2243,1000.00,23000.00,24000.00,0.00,23000.00,0.27,1
20160,2243,1000.00,24000.00,25000.00,0.00,4670.49,0.18,1
20161,2243,1000.00,25000.00,26000.00,10631.08,14368.92,0.16,1
20162,2243,1000.00,26000.00,27000.00,8852.64,9870.83,0.25,1
20163,2243,1000.00,27000.00,28000.00,0.00,27000.00,0.23,1
20164,2243,1000.00,28000.00,29000.00,6064.61,16048.15,0.30,1
20165,2243,1000.00,29000.00,30000.00,0.00,29000.00,0.16,1
20166,2243,1000.00,30000.00,31000.00,0.00,30000.00,0.06,1
20167,2243,-1000.00,29000.00,30000.00,18371.92,0.00,0.06,0
20168,2243,1000.00,30000.00,31000.00,14690.44,15309.56,0.23,1
20169,2243,1000.00,31000.00,32000.00,0.00,31000.00,0.03,1
20170,2243,1000.00,32000.00,33000.00,10881.91,21118.09,0.31,1
20171,2244,-1000.00,-1000.00,0.00,506.13,493.87,0.06,0
20172,2245,-15.90,-15.90,984.10,0.00,15.90,0.07,0
20173,2245,-984.10,-1000.00,0.00,310.10,674.01,0.36,0
20174,2246,-1000.00,-1000.00,0.00,0.00,1000.00,0.19,0
20175,2247,-1000.00,-1000.00,0.00,0.00,1000.00,0.42,0
20176,2248,-1000.00,-1000.00,0.00,597.85,402.15,0.10,0
20177,2249,-1000.00,-1000.00,0.00,0.00,1000.00,0.11,0
20178,2250,-1000.00,-1000.00,0.00,0.00,773.77,0.18,0
20179,2251,-1000.00,-1000.00,0.00,552.46,447.54,0.17,0
20180,2252,-695.44,-695.44,304.56,458.77,236.67,0.15,0
20181,2252,-1000.00,-1695.44,-695.44,0.00,304.56,0.09,0
20182,2253,-1000.00,-1000.00,0.00,0.00,1000.00,0.04,0
20183,2254,-1000.00,-1000.00,0.00,0.00,1000.00,0.42,0
20184,2255,-21.46,-21.46,978.54,0.00,21.46,0.09,0
20185,2255,-18.67,-40.13,959.87,0.00,18.67,0.12,0
20186,2255,-959.87,-1000.00,0.00,419.99,539.88,0.19,0
20187,2256,-1000.00,-1000.00,0.00,0.00,1000.00,0.34,0
20188,2257,-1000.00,-1000.00,0.00,0.00,840.87,0.05,0
20189,2258,-1000.00,-1000.00,0.00,460.64,539.36,0.24,0
20190,2259,-1000.00,-1000.00,0.00,202.85,47.94,0.12,0
20191,2260,-1000.00,-1000.00,0.00,172.62,827.38,0.41,0
20192,2260,-0.00,-1000.00,0.00,0.00,0.00,0.27,0
20193,2260,-0.00,-1000.00,0.00,0.00,0.00,0.14,0
20194,2260,-0.00,-1000.00,0.00,0.00,0.00,0.00,0
20195,2260,-0.00,-1000.00,0.00,0.00,0.00,0.16,0
20196,2260,-0.00,-1000.00,0.00,0.00,0.00,0.08,0
20197,2261,1000.00,1000.00,2000.00,976.47,23.53,0.09,1
20198,2261,-1000.00,0.00,1000.00,0.00,1111.47,0.03,0
20199,2261,1000.00,1000.00,2000.00,784.20,215.80,0.07,1
20200,2261,-1000.00,0.00,1000.00,0.00,1367.34,0.27,0
20201,2261,-1000.00,-1000.00,0.00,105.90,894.10,0.41,0
20202,2262,-1000.00,-1000.00,0.00,0.00,923.81,0.38,0
20203,2263,-1000.00,-1000.00,0.00,0.00,1000.00,0.03,0
20204,2264,0.00,0.00,1000.00,0.00,0.00,0.06,0
20205,2264,-302.87,-302.87,697.13,0.00,302.87,0.10,0
20206,2264,-697.13,-1000.00,0.00,0.00,697.13,0.18,0
20207,2265,-452.23,-452.23,547.77,452.23,0.00,0.23,0
20208,2265,-1000.00,-1452.23,-452.23,69.95,477.82,0.29,0
20209,2266,-1000.00,-1000.00,0.00,419.65,580.35,0.21,0
20210,2267,-1000.00,-1000.00,0.00,595.54,404.46,0.08,0
20211,2268,0.00,0.00,1000.00,0.00,316.54,0.23,0
20212,2268,0.00,0.00,1000.00,0.00,1000.00,0.44,0
20213,2268,0.00,0.00,1000.00,0.00,867.44,0.03,0
20214,2268,0.00,0.00,1000.00,0.00,1000.00,0.33,0
20215,2268,0.00,0.00,1000.00,0.00,1000.00,0.42,0
20216,2268,0.00,0.00,1000.00,0.00,805.85,0.40,0
20217,2268,0.00,0.00,1000.00,126.18,873.82,0.36,0
20218,2268,0.00,0.00,1000.00,0.00,1000.00,0.25,0
20219,2268,0.00,0.00,1000.00,18.39,981.61,0.44,0
20220,2268,0.00,0.00,1000.00,0.00,364.39,0.10,0
20221,2268,0.00,0.00,1000.00,0.00,1000.00,0.14,0
20222,2268,0.00,0.00,1000.00,0.00,904.08,0.40,0
20223,2268,0.00,0.00,1000.00,0.00,1000.00,0.32,0
20224,2268,0.00,0.00,1000.00,256.73,743.27,0.37,0
20225,2268,-1000.00,-1000.00,0.00,500.95,499.05,0.24,0
20226,2269,-1000.00,-1000.00,0.00,221.95,778.05,0.37,0
20227,2270,-926.69,-926.69,73.31,0.00,926.69,0.11,0
20228,2270,-73.31,-1000.00,0.00,3.54,69.77,0.44,0
20229,2271,-1000.00,-1000.00,0.00,0.00,740.79,0.38,0
20230,2272,-300.08,-300.08,699.92,0.00,300.08,0.10,0
20231,2272,-584.20,-884.28,115.72,88.09,496.11,0.38,0
20232,2272,-115.72,-1000.00,0.00,0.00,115.72,0.11,0
20233,2273,1000.00,1000.00,2000.00,0.00,1000.00,0.14,1
20234,2273,1000.00,2000.00,3000.00,0.00,665.77,0.23,1
20235,2273,1000.00,3000.00,4000.00,0.00,2416.94,0.42,1
20236,2273,1000.00,4000.00,5000.00,0.00,4000.00,0.12,1
20237,2273,-1000.00,3000.00,4000.00,1462.80,0.00,0.00,0
20238,2273,-1000.00,2000.00,3000.00,2397.26,1602.74,0.13,0
20239,2273,1000.00,3000.00,4000.00,0.00,1294.44,0.27,1
20240,2273,1000.00,4000.00,5000.00,923.06,2896.89,0.39,1
20241,2273,1000.00,5000.00,6000.00,0.00,5000.00,0.36,1
20242,2273,1000.00,6000.00,7000.00,2682.32,3317.68,0.25,1
20243,2273,1000.00,7000.00,8000.00,2312.04,4687.96,0.12,1
20244,2273,1000.00,8000.00,9000.00,0.00,3712.11,0.27,1
20245,2273,1000.00,9000.00,10000.00,0.00,3549.46,0.23,1
20246,2273,1000.00,10000.00,11000.00,755.82,9244.18,0.44,1
20247,2273,-1000.00,9000.00,10000.00,8026.25,2973.75,0.03,0
20248,2273,1000.00,10000.00,11000.00,2596.06,7403.94,0.37,1
20249,2273,-1000.00,9000.00,10000.00,5935.36,5064.64,0.37,0
20250,2273,1000.00,10000.00,11000.00,4274.71,5725.29,0.27,1
20251,2273,1000.00,11000.00,12000.00,0.00,11000.00,0.31,1
20252,2273,1000.00,12000.00,13000.00,0.00,2842.28,0.03,1
20253,2273,1000.00,13000.00,14000.00,6500.00,6500.00,0.05,1
20254,2273,1000.00,14000.00,15000.00,6591.64,7408.36,0.17,1
20255,2273,1000.00,15000.00,16000.00,0.00,15000.00,0.32,1
20256,2273,1000.00,16000.00,17000.00,6356.46,9643.54,0.06,1
20257,2273,-1000.00,15000.00,16000.00,9225.18,7774.82,0.38,0
20258,2273,-1000.00,14000.00,15000.00,0.00,10430.94,0.26,0
20259,2273,-1000.00,13000.00,14000.00,0.00,15000.00,0.10,0
20260,2273,-1000.00,12000.00,13000.00,3240.08,10759.92,0.28,0
20261,2273,-1000.00,11000.00,12000.00,0.00,7200.09,0.14,0
20262,2273,-1000.00,10000.00,11000.00,0.00,12000.00,0.34,0
20263,2273,-1000.00,9000.00,10000.00,0.00,11000.00,0.06,0
20264,2273,-1000.00,8000.00,9000.00,622.75,9377.25,0.12,0
20265,2273,-1000.00,7000.00,8000.00,0.00,6863.71,0.37,0
20266,2273,-1000.00,6000.00,7000.00,2059.41,3877.10,0.28,0
20267,2273,-1000.00,5000.00,6000.00,0.00,7000.00,0.15,0
20268,2273,0.00,5000.00,6000.00,0.00,0.00,0.02,0
20269,2273,-1000.00,4000.00,5000.00,160.66,5839.34,0.44,0
20270,2273,-1000.00,3000.00,4000.00,2253.13,2746.87,0.22,0
20271,2273,-1000.00,2000.00,3000.00,1614.56,2385.44,0.29,0
20272,2273,0.00,2000.00,3000.00,0.00,0.00,0.06,0
20273,2273,-1000.00,1000.00,2000.00,1290.97,1709.03,0.27,0
20274,2274,-1000.00,-1000.00,0.00,0.00,406.61,0.41,0
20275,2275,-1000.00,-1000.00,0.00,130.67,869.33,0.33,0
20276,2276,-1000.00,-1000.00,0.00,652.91,347.09,0.12,0
20277,2277,-1000.00,-1000.00,0.00,0.00,991.57,0.09,0
20278,2278,-1000.00,-1000.00,0.00,320.36,679.64,0.14,0
20279,2279,-1000.00,-1000.00,0.00,0.00,1000.00,0.25,0
20280,2280,-751.51,-751.51,248.49,0.00,751.51,0.13,0
20281,2280,-195.61,-947.12,52.88,0.00,195.61,0.39,0
20282,2280,-38.30,-985.42,14.58,0.00,38.30,0.30,0
20283,2280,-14.58,-1000.00,0.00,1.50,13.08,0.14,0
20284,2281,-1000.00,-1000.00,0.00,42.42,957.58,0.17,0
20285,2282,-1000.00,-1000.00,0.00,82.76,917.24,0.31,0
20286,2283,-1000.00,-1000.00,0.00,0.00,811.14,0.26,0
20287,2284,-1000.00,-1000.00,0.00,0.00,722.13,0.40,0
20288,2285,-1000.00,-1000.00,0.00,389.10,610.90,0.24,0
20289,2286,-1000.00,-1000.00,0.00,774.60,225.40,0.07,0
20290,2287,-1000.00,-1000.00,0.00,348.08,651.92,0.27,0
20291,2288,-1000.00,-1000.00,0.00,572.79,427.21,0.17,0
20292,2289,-1000.00,-1000.00,0.00,0.00,1000.00,0.40,0
20293,2290,0.00,0.00,1000.00,0.00,0.00,0.40,0
20294,2290,-64.15,-64.15,935.85,0.00,64.15,0.13,0
20295,2290,1000.00,935.85,1935.85,213.29,0.00,0.21,1
20296,2290,0.00,935.85,1935.85,0.00,0.00,0.01,0
20297,2290,-1000.00,-64.15,935.85,0.00,1935.85,0.10,0
20298,2290,1000.00,935.85,1935.85,584.88,350.97,0.29,1
20299,2290,1000.00,1935.85,2935.85,179.90,143.05,0.29,1
20300,2290,0.00,1935.85,2935.85,0.00,0.00,0.04,0
20301,2290,-329.10,1606.75,2606.75,0.00,329.10,0.37,0
20302,2290,-1000.00,606.75,1606.75,1199.11,1407.64,0.06,0
20303,2290,1000.00,1606.75,2606.75,1291.98,314.77,0.07,1
20304,2290,-1000.00,606.75,1606.75,1303.38,1303.38,0.12,0
20305,2290,1000.00,1606.75,2606.75,600.53,0.00,0.05,1
20306,2290,0.00,1606.75,2606.75,0.00,0.00,0.32,0
20307,2290,1000.00,2606.75,3606.75,1339.03,0.00,0.22,1
20308,2290,-1000.00,1606.75,2606.75,737.86,2868.89,0.21,0
20309,2290,1000.00,2606.75,3606.75,1979.11,627.64,0.18,1
20310,2290,-1000.00,1606.75,2606.75,635.56,2971.19,0.23,0
20311,2290,-661.69,945.07,1945.07,0.00,661.69,0.41,0
20312,2290,1000.00,1945.07,2945.07,1945.07,0.00,0.03,1
20313,2290,1000.00,2945.07,3945.07,1866.98,1078.08,0.08,1
20314,2290,0.00,2945.07,3945.07,0.00,0.00,0.08,0
20315,2290,-1000.00,1945.07,2945.07,0.00,3463.36,0.41,0
20316,2290,-1000.00,945.07,1945.07,1202.13,0.00,0.12,0
20317,2290,-1000.00,-54.93,945.07,807.84,1137.23,0.27,0
20318,2290,-1000.00,-1054.93,-54.93,0.00,478.52,0.39,0
20319,2291,-1000.00,-1000.00,0.00,0.00,1000.00,0.34,0
20320,2292,-985.01,-985.01,14.99,470.92,514.10,0.28,0
20321,2292,-13.48,-998.49,1.51,0.00,13.48,0.34,0
20322,2292,-0.99,-999.48,0.52,0.18,0.81,0.36,0
20323,2292,-0.52,-1000.00,0.00,0.24,0.28,0.24,0
20324,2293,1000.00,1000.00,2000.00,74.50,925.50,0.44,1
20325,2293,-1000.00,0.00,1000.00,1370.41,629.59,0.09,0
20326,2293,1000.00,1000.00,2000.00,249.58,750.42,0.26,1
20327,2293,1000.00,2000.00,3000.00,0.00,2000.00,0.16,1
20328,2293,1000.00,3000.00,4000.00,383.52,2241.43,0.40,1
20329,2293,-1000.00,2000.00,3000.00,2329.66,1670.34,0.19,0
20330,2293,-1000.00,1000.00,2000.00,1258.88,1109.45,0.21,0
20331,2293,1000.00,2000.00,3000.00,0.00,1089.33,0.30,1
20332,2293,1000.00,3000.00,4000.00,3.69,1650.54,0.33,1
20333,2293,1000.00,4000.00,5000.00,2000.00,2000.00,0.07,1
20334,2293,1000.00,5000.00,6000.00,1382.14,3617.86,0.28,1
20335,2293,1000.00,6000.00,7000.00,0.00,5283.49,0.07,1
20336,2293,1000.00,7000.00,8000.00,0.00,2632.00,0.22,1
20337,2293,1000.00,8000.00,9000.00,0.00,5869.47,0.10,1
20338,2293,1000.00,9000.00,10000.00,2591.16,6408.84,0.40,1
20339,2293,1000.00,10000.00,11000.00,0.00,10000.00,0.02,1
20340,2293,1000.00,11000.00,12000.00,5489.50,5510.50,0.44,1
20341,2293,1000.00,12000.00,13000.00,4175.17,7824.83,0.32,1
20342,2293,-1000.00,11000.00,12000.00,9325.93,3674.07,0.17,0
20343,2293,-1000.00,10000.00,11000.00,4425.35,7574.65,0.09,0
20344,2293,-1000.00,9000.00,10000.00,0.00,10535.52,0.44,0
20345,2293,-1000.00,8000.00,9000.00,4345.70,5654.30,0.23,0
20346,2293,-1000.00,7000.00,8000.00,0.00,7417.61,0.42,0
20347,2293,-1000.00,6000.00,7000.00,958.71,7041.29,0.22,0
20348,2293,-1000.00,5000.00,6000.00,0.00,3631.09,0.17,0
20349,2293,-1000.00,4000.00,5000.00,0.00,6000.00,0.10,0
20350,2293,-1000.00,3000.00,4000.00,0.00,5000.00,0.21,0
20351,2293,-1000.00,2000.00,3000.00,0.00,2981.19,0.35,0
20352,2293,-1000.00,1000.00,2000.00,0.00,3000.00,0.24,0
20353,2293,-1000.00,0.00,1000.00,794.59,1205.41,0.24,0
20354,2293,-1000.00,-1000.00,0.00,173.29,826.71,0.03,0
20355,2294,-1000.00,-1000.00,0.00,290.10,709.90,0.20,0
20356,2295,-657.38,-657.38,342.62,0.00,657.38,0.27,0
20357,2295,-342.62,-1000.00,0.00,163.43,179.18,0.02,0
20358,2296,-667.80,-667.80,332.20,0.00,667.80,0.31,0
20359,2296,-332.20,-1000.00,0.00,122.15,210.05,0.24,0
20360,2297,-1000.00,-1000.00,0.00,0.00,1000.00,0.33,0
20361,2298,-677.09,-677.09,322.91,0.00,677.09,0.34,0
20362,2298,-322.91,-1000.00,0.00,0.00,322.91,0.23,0
20363,2299,-1000.00,-1000.00,0.00,0.00,1000.00,0.19,0
20364,2300,0.00,0.00,1000.00,0.00,0.00,0.01,0
20365,2300,-233.90,-233.90,766.10,0.00,233.90,0.20,0
20366,2300,-660.68,-894.58,105.42,36.55,624.12,0.42,0
20367,2300,-105.42,-1000.00,0.00,27.78,77.64,0.32,0
20368,2300,-0.00,-1000.00,0.00,0.00,0.00,0.08,0
20369,2301,1000.00,1000.00,2000.00,239.82,760.18,0.35,1
20370,2301,1000.00,2000.00,3000.00,271.83,1728.17,0.42,1
20371,2301,1000.00,3000.00,4000.00,0.00,3000.00,0.29,1
20372,2301,1000.00,4000.00,5000.00,0.00,3229.17,0.23,1
20373,2301,1000.00,5000.00,6000.00,0.00,2953.35,0.35,1
20374,2301,-1000.00,4000.00,5000.00,2972.60,941.03,0.12,0
20375,2301,1000.00,5000.00,6000.00,827.67,4172.33,0.42,1
20376,2301,1000.00,6000.00,7000.00,0.00,6000.00,0.17,1
20377,2301,1000.00,7000.00,8000.00,0.00,7000.00,0.21,1
20378,2301,1000.00,8000.00,9000.00,4000.00,4000.00,0.05,1
20379,2301,1000.00,9000.00,10000.00,0.00,9000.00,0.29,1
20380,2301,1000.00,10000.00,11000.00,2215.13,7784.87,0.35,1
20381,2301,1000.00,11000.00,12000.00,0.00,11000.00,0.39,1
20382,2301,1000.00,12000.00,13000.00,1594.77,6103.89,0.31,1
20383,2301,1000.00,13000.00,14000.00,3694.26,9305.74,0.13,1
20384,2301,1000.00,14000.00,15000.00,5717.68,8282.32,0.23,1
20385,2301,1000.00,15000.00,16000.00,7500.00,7500.00,0.23,1
20386,2301,-1000.00,14000.00,15000.00,5865.41,2193.77,0.13,0
20387,2301,1000.00,15000.00,16000.00,3750.43,11249.57,0.37,1
20388,2301,-1000.00,14000.00,15000.00,10974.20,5025.80,0.02,0
20389,2301,-1000.00,13000.00,14000.00,3303.21,11367.91,0.38,0
20390,2301,0.00,13000.00,14000.00,0.00,0.00,0.08,0
20391,2301,-1000.00,12000.00,13000.00,7948.75,4344.17,0.23,0
20392,2301,-1000.00,11000.00,12000.00,0.00,13000.00,0.22,0
20393,2301,-1000.00,10000.00,11000.00,0.00,12000.00,0.20,0
20394,2301,-1000.00,9000.00,10000.00,0.00,11000.00,0.36,0
20395,2301,-1000.00,8000.00,9000.00,0.00,10000.00,0.17,0
20396,2301,-1000.00,7000.00,8000.00,2999.07,6000.93,0.33,0
20397,2301,-1000.00,6000.00,7000.00,2487.26,5512.74,0.20,0
20398,2301,-1000.00,5000.00,6000.00,0.00,7000.00,0.03,0
20399,2301,-1000.00,4000.00,5000.00,0.00,6000.00,0.06,0
20400,2301,-1000.00,3000.00,4000.00,2454.81,2545.19,0.20,0
20401,2301,-1000.00,2000.00,3000.00,0.00,4000.00,0.02,0
20402,2301,-1000.00,1000.00,2000.00,903.79,2096.21,0.35,0
20403,2301,-1000.00,0.00,1000.00,1044.33,955.67,0.16,0
20404,2301,-1000.00,-1000.00,0.00,632.00,368.00,0.03,0
20405,2302,-1000.00,-1000.00,0.00,322.30,677.70,0.21,0
20406,2303,-1000.00,-1000.00,0.00,174.58,825.42,0.37,0
20407,2304,0.00,0.00,1000.00,0.00,0.00,0.12,0
20408,2304,-439.75,-439.75,560.25,0.00,439.75,0.41,0
20409,2304,-172.33,-612.08,387.92,0.00,172.33,0.13,0
20410,2304,-387.92,-1000.00,0.00,188.92,199.00,0.21,0
20411,2305,-1000.00,-1000.00,0.00,148.09,851.91,0.17,0
20412,2306,-1000.00,-1000.00,0.00,203.00,797.00,0.40,0
20413,2307,-1000.00,-1000.00,0.00,0.00,1000.00,0.36,0
20414,2308,1000.00,1000.00,2000.00,334.92,0.00,0.37,1
20415,2308,0.00,1000.00,2000.00,0.00,0.00,0.31,0
20416,2308,1000.00,2000.00,3000.00,1652.77,347.23,0.38,1
20417,2308,0.00,2000.00,3000.00,0.00,0.00,0.15,0
20418,2308,1000.00,3000.00,4000.00,106.84,0.00,0.21,1
20419,2308,-1000.00,2000.00,3000.00,1580.89,2419.11,0.15,0
20420,2308,1000.00,3000.00,4000.00,1656.81,1343.19,0.17,1
20421,2308,1000.00,4000.00,5000.00,2746.12,1253.88,0.26,1
20422,2308,1000.00,5000.00,6000.00,3181.61,1818.39,0.42,1
20423,2308,-1000.00,4000.00,5000.00,0.00,4146.14,0.22,0
20424,2308,1000.00,5000.00,6000.00,3994.40,1005.60,0.32,1
20425,2308,1000.00,6000.00,7000.00,4346.02,1653.98,0.13,1
20426,2308,1000.00,7000.00,8000.00,4256.57,2743.43,0.14,1
20427,2308,0.00,7000.00,8000.00,0.00,0.00,0.03,0
20428,2308,-1000.00,6000.00,7000.00,2869.54,5130.46,0.16,0
20429,2308,1000.00,7000.00,8000.00,7000.00,0.00,0.37,1
20430,2308,0.00,7000.00,8000.00,0.00,0.00,0.05,0
20431,2308,0.00,7000.00,8000.00,0.00,0.00,0.07,0
20432,2308,-1000.00,6000.00,7000.00,0.00,3482.27,0.31,0
20433,2308,1000.00,7000.00,8000.00,5533.45,0.00,0.41,1
20434,2308,1000.00,8000.00,9000.00,8000.00,0.00,0.35,1
20435,2308,1000.00,9000.00,10000.00,5174.20,0.00,0.28,1
20436,2308,1000.00,10000.00,11000.00,4052.40,0.00,0.35,1
20437,2308,-659.99,9340.01,10340.01,0.00,659.99,0.43,0
20438,2308,-1000.00,8340.01,9340.01,399.58,6250.67,0.08,0
20439,2308,-1000.00,7340.01,8340.01,6987.70,2352.31,0.14,0
20440,2308,0.00,7340.01,8340.01,0.00,0.00,0.13,0
20441,2308,-1000.00,6340.01,7340.01,5574.28,2765.73,0.06,0
20442,2308,-1000.00,5340.01,6340.01,5637.73,1702.28,0.38,0
20443,2308,-1000.00,4340.01,5340.01,5286.02,1053.99,0.32,0
20444,2308,-1000.00,3340.01,4340.01,5340.01,0.00,0.06,0
20445,2308,-1000.00,2340.01,3340.01,3264.53,1075.48,0.03,0
20446,2308,-1000.00,1340.01,2340.01,1639.05,1299.35,0.36,0
20447,2308,-1000.00,340.01,1340.01,1170.01,1170.01,0.01,0
20448,2308,-1000.00,-659.99,340.01,1340.01,0.00,0.38,0
20449,2308,-340.01,-1000.00,0.00,206.38,133.63,0.31,0
20450,2309,-1000.00,-1000.00,0.00,500.00,500.00,0.05,0
20451,2310,-1000.00,-1000.00,0.00,61.10,435.93,0.34,0
20452,2311,-1000.00,-1000.00,0.00,228.97,771.03,0.39,0
20453,2312,-1000.00,-1000.00,0.00,277.94,722.06,0.14,0
20454,2313,-1000.00,-1000.00,0.00,0.00,1000.00,0.19,0
20455,2314,-1000.00,-1000.00,0.00,0.00,1000.00,0.28,0
20456,2315,-1000.00,-1000.00,0.00,0.00,1000.00,0.11,0
20457,2316,-1000.00,-1000.00,0.00,0.00,1000.00,0.15,0
20458,2317,-1000.00,-1000.00,0.00,0.00,1000.00,0.01,0
20459,2318,-646.19,-646.19,353.81,184.73,461.46,0.28,0
20460,2318,-158.98,-805.17,194.83,0.00,158.98,0.22,0
20461,2318,-194.83,-1000.00,0.00,0.00,194.83,0.11,0
20462,2319,1000.00,1000.00,2000.00,0.00,1000.00,0.36,1
20463,2319,1000.00,2000.00,3000.00,220.17,1027.97,0.31,1
20464,2319,1000.00,3000.00,4000.00,285.70,2477.37,0.42,1
20465,2319,1000.00,4000.00,5000.00,0.00,788.41,0.18,1
20466,2319,1000.00,5000.00,6000.00,2390.31,2609.69,0.08,1
20467,2319,1000.00,6000.00,7000.00,611.02,5388.98,0.40,1
20468,2319,1000.00,7000.00,8000.00,0.00,7000.00,0.30,1
20469,2319,1000.00,8000.00,9000.00,0.00,4632.56,0.35,1
20470,2319,-1000.00,7000.00,8000.00,1268.91,849.93,0.14,0
20471,2319,1000.00,8000.00,9000.00,0.00,4924.11,0.33,1
20472,2319,1000.00,9000.00,10000.00,0.00,9000.00,0.22,1
20473,2319,1000.00,10000.00,11000.00,0.00,2075.23,0.14,1
20474,2319,1000.00,11000.00,12000.00,0.00,10139.84,0.42,1
20475,2319,1000.00,12000.00,13000.00,0.00,1939.64,0.13,1
20476,2319,1000.00,13000.00,14000.00,6250.98,6749.02,0.16,1
20477,2319,1000.00,14000.00,15000.00,5428.74,8571.26,0.14,1
20478,2319,1000.00,15000.00,16000.00,5299.98,9700.02,0.33,1
20479,2319,1000.00,16000.00,17000.00,5296.95,7073.22,0.25,1
20480,2319,1000.00,17000.00,18000.00,0.00,9316.72,0.06,1
20481,2319,-1000.00,16000.00,17000.00,3890.87,840.89,0.12,0
20482,2319,1000.00,17000.00,18000.00,53.10,16946.90,0.42,1
20483,2319,1000.00,18000.00,19000.00,6677.21,11322.79,0.27,1
20484,2319,1000.00,19000.00,20000.00,0.00,19000.00,0.14,1
20485,2319,1000.00,20000.00,21000.00,0.00,20000.00,0.14,1
20486,2319,-1000.00,19000.00,20000.00,0.00,9533.82,0.29,0
20487,2319,-1000.00,18000.00,19000.00,0.00,9486.43,0.12,0
20488,2319,-1000.00,17000.00,18000.00,9985.02,3964.78,0.13,0
20489,2319,-1000.00,16000.00,17000.00,0.00,18000.00,0.10,0
20490,2319,-1000.00,15000.00,16000.00,6701.41,10298.59,0.32,0
20491,2319,-1000.00,14000.00,15000.00,6516.91,9483.09,0.21,0
20492,2319,-1000.00,13000.00,14000.00,2959.66,12040.34,0.41,0
20493,2319,-1000.00,12000.00,13000.00,0.00,14000.00,0.13,0
20494,2319,-1000.00,11000.00,12000.00,5877.10,7122.90,0.25,0
20495,2319,-1000.00,10000.00,11000.00,4008.24,7991.76,0.30,0
20496,2319,-1000.00,9000.00,10000.00,0.00,11000.00,0.21,0
20497,2319,-1000.00,8000.00,9000.00,3340.08,6352.23,0.31,0
20498,2319,-1000.00,7000.00,8000.00,0.00,9000.00,0.05,0
20499,2319,-1000.00,6000.00,7000.00,2748.98,5251.02,0.33,0
20500,2319,-1000.00,5000.00,6000.00,3538.18,0.00,0.06,0
20501,2319,-1000.00,4000.00,5000.00,0.00,6000.00,0.15,0
20502,2319,-1000.00,3000.00,4000.00,0.00,5000.00,0.34,0
20503,2319,-1000.00,2000.00,3000.00,1195.45,2804.55,0.31,0
20504,2319,-1000.00,1000.00,2000.00,0.00,2280.51,0.32,0
20505,2319,-1000.00,0.00,1000.00,0.00,1188.43,0.11,0
20506,2319,-1000.00,-1000.00,0.00,0.00,1000.00,0.14,0
20507,2320,1000.00,1000.00,2000.00,0.00,1000.00,0.21,1
20508,2320,-114.32,885.68,1885.68,114.32,0.00,0.10,0
20509,2320,1000.00,1885.68,2885.68,145.54,1740.14,0.09,1
20510,2320,-814.24,1071.45,2071.45,697.82,116.42,0.11,0
20511,2320,1000.00,2071.45,3071.45,198.80,1872.64,0.17,1
20512,2320,1000.00,3071.45,4071.45,0.00,3055.92,0.44,1
20513,2320,1000.00,4071.45,5071.45,811.79,2708.03,0.37,1
20514,2320,-1000.00,3071.45,4071.45,2727.78,2343.66,0.13,0
20515,2320,1000.00,4071.45,5071.45,706.44,3365.01,0.39,1
20516,2320,1000.00,5071.45,6071.45,0.00,1615.14,0.18,1
20517,2320,1000.00,6071.45,7071.45,291.64,5408.45,0.43,1
20518,2320,1000.00,7071.45,8071.45,0.00,7071.45,0.04,1
20519,2320,1000.00,8071.45,9071.45,3464.18,4607.27,0.37,1
20520,2320,1000.00,9071.45,10071.45,1523.15,7548.29,0.10,1
20521,2320,1000.00,10071.45,11071.45,184.24,9887.21,0.04,1
20522,2320,1000.00,11071.45,12071.45,0.00,8971.16,0.34,1
20523,2320,1000.00,12071.45,13071.45,0.00,6349.74,0.30,1
20524,2320,1000.00,13071.45,14071.45,6535.72,6535.72,0.13,1
20525,2320,1000.00,14071.45,15071.45,0.00,2886.91,0.16,1
20526,2320,1000.00,15071.45,16071.45,6756.37,8315.07,0.31,1
20527,2320,1000.00,16071.45,17071.45,0.00,16071.45,0.17,1
20528,2320,-1000.00,15071.45,16071.45,10812.94,6258.51,0.06,0
20529,2320,1000.00,16071.45,17071.45,5066.02,11005.42,0.35,1
20530,2320,1000.00,17071.45,18071.45,3473.61,13597.84,0.41,1
20531,2320,1000.00,18071.45,19071.45,0.00,18071.45,0.43,1
20532,2320,1000.00,19071.45,20071.45,3422.90,15648.55,0.19,1
20533,2320,1000.00,20071.45,21071.45,10035.72,10035.72,0.01,1
20534,2320,1000.00,21071.45,22071.45,0.00,8399.18,0.10,1
20535,2320,1000.00,22071.45,23071.45,1175.29,20896.16,0.44,1
20536,2320,1000.00,23071.45,24071.45,3823.73,19247.72,0.38,1
20537,2320,1000.00,24071.45,25071.45,6612.73,11298.25,0.27,1
20538,2320,1000.00,25071.45,26071.45,7812.21,17259.24,0.00,1
20539,2320,1000.00,26071.45,27071.45,277.97,25793.47,0.28,1
20540,2320,1000.00,27071.45,28071.45,0.00,27071.45,0.22,1
20541,2320,1000.00,28071.45,29071.45,0.00,23637.21,0.22,1
20542,2320,1000.00,29071.45,30071.45,0.00,13538.11,0.05,1
20543,2320,1000.00,30071.45,31071.45,14522.52,15548.93,0.21,1
20544,2320,1000.00,31071.45,32071.45,15535.72,15535.72,0.27,1
20545,2321,-1000.00,-1000.00,0.00,471.24,528.76,0.26,0
20546,2321,0.00,-1000.00,0.00,0.00,0.00,0.14,1
20547,2321,-0.00,-1000.00,0.00,0.00,0.00,0.40,0
20548,2321,-0.00,-1000.00,0.00,0.00,0.00,0.18,0
20549,2322,1000.00,1000.00,2000.00,0.00,424.83,0.25,1
20550,2322,1000.00,2000.00,3000.00,715.89,1284.11,0.28,1
20551,2322,1000.00,3000.00,4000.00,676.48,1781.52,0.33,1
20552,2322,1000.00,4000.00,5000.00,0.00,4000.00,0.12,1
20553,2322,1000.00,5000.00,6000.00,2409.62,2590.38,0.26,1
20554,2322,1000.00,6000.00,7000.00,0.00,5514.74,0.25,1
20555,2322,1000.00,7000.00,8000.00,128.40,6871.60,0.13,1
20556,2322,1000.00,8000.00,9000.00,0.00,6311.94,0.29,1
20557,2322,1000.00,9000.00,10000.00,1747.85,7252.15,0.28,1
20558,2322,1000.00,10000.00,11000.00,2756.95,7243.05,0.37,1
20559,2322,-1000.00,9000.00,10000.00,6159.21,4840.79,0.01,0
20560,2322,0.00,9000.00,10000.00,0.00,0.00,0.05,0
20561,2322,1000.00,10000.00,11000.00,2834.71,7165.29,0.29,1
20562,2322,1000.00,11000.00,12000.00,4130.50,6869.50,0.26,1
20563,2322,1000.00,12000.00,13000.00,6000.00,6000.00,0.08,1
20564,2322,1000.00,13000.00,14000.00,2201.52,6609.59,0.31,1
20565,2322,1000.00,14000.00,15000.00,0.00,14000.00,0.26,1
20566,2322,1000.00,15000.00,16000.00,836.38,8620.14,0.34,1
20567,2322,1000.00,16000.00,17000.00,0.00,7835.84,0.30,1
20568,2322,1000.00,17000.00,18000.00,3847.66,9828.34,0.32,1
20569,2322,1000.00,18000.00,19000.00,9000.00,9000.00,0.27,1
20570,2322,-1000.00,17000.00,18000.00,15177.11,2970.33,0.07,0
20571,2322,1000.00,18000.00,19000.00,6767.91,11232.09,0.35,1
20572,2322,1000.00,19000.00,20000.00,5112.82,13887.18,0.38,1
20573,2322,1000.00,20000.00,21000.00,633.86,19366.14,0.39,1
20574,2322,1000.00,21000.00,22000.00,0.00,4806.95,0.16,1
20575,2322,1000.00,22000.00,23000.00,3056.83,18943.17,0.21,1
20576,2322,1000.00,23000.00,24000.00,8578.99,14421.01,0.31,1
20577,2322,-1000.00,22000.00,23000.00,14581.14,9418.86,0.11,0
20578,2322,1000.00,23000.00,24000.00,0.00,12927.18,0.05,1
20579,2322,1000.00,24000.00,25000.00,0.00,6159.40,0.13,1
20580,2322,1000.00,25000.00,26000.00,0.00,13165.73,0.29,1
20581,2322,1000.00,26000.00,27000.00,0.00,26000.00,0.29,1
20582,2322,1000.00,27000.00,28000.00,0.00,27000.00,0.05,1
20583,2322,1000.00,28000.00,29000.00,0.00,8661.13,0.23,1
20584,2322,1000.00,29000.00,30000.00,0.00,9351.73,0.12,1
20585,2322,1000.00,30000.00,31000.00,7539.86,22460.14,0.37,1
20586,2322,1000.00,31000.00,32000.00,0.00,31000.00,0.28,1
20587,2322,1000.00,32000.00,33000.00,3814.08,23966.59,0.40,1
20588,2322,-1000.00,31000.00,32000.00,23482.37,1924.37,0.10,0
20589,2322,1000.00,32000.00,33000.00,15137.86,16862.14,0.10,1
20590,2322,0.00,32000.00,33000.00,0.00,0.00,0.01,0
20591,2322,1000.00,33000.00,34000.00,0.00,25088.84,0.11,1
20592,2322,1000.00,34000.00,35000.00,5406.45,28593.55,0.42,1
20593,2322,1000.00,35000.00,36000.00,6216.75,28783.25,0.23,1
20594,2322,1000.00,36000.00,37000.00,8299.15,27700.85,0.20,1
20595,2322,1000.00,37000.00,38000.00,2375.62,34624.38,0.25,1
20596,2322,-1000.00,36000.00,37000.00,18811.16,19188.84,0.40,0
20597,2322,-1000.00,35000.00,36000.00,19287.99,17712.01,0.20,0
20598,2322,-1000.00,34000.00,35000.00,0.00,17798.60,0.28,0
20599,2322,-1000.00,33000.00,34000.00,0.00,35000.00,0.14,0
20600,2322,-1000.00,32000.00,33000.00,0.00,18032.72,0.32,0
20601,2322,-1000.00,31000.00,32000.00,0.00,14514.16,0.26,0
20602,2322,-1000.00,30000.00,31000.00,0.00,32000.00,0.26,0
20603,2322,-1000.00,29000.00,30000.00,0.00,16888.61,0.16,0
20604,2322,-1000.00,28000.00,29000.00,0.00,30000.00,0.09,0
20605,2322,-1000.00,27000.00,28000.00,5031.11,23968.89,0.16,0
20606,2322,-1000.00,26000.00,27000.00,1576.47,14634.34,0.32,0
20607,2322,-1000.00,25000.00,26000.00,0.00,27000.00,0.21,0
20608,2322,-1000.00,24000.00,25000.00,0.00,26000.00,0.27,0
20609,2322,0.00,24000.00,25000.00,0.00,0.00,0.01,0
20610,2322,-1000.00,23000.00,24000.00,996.46,24003.54,0.01,0
20611,2322,-1000.00,22000.00,23000.00,0.00,24000.00,0.25,0
20612,2322,-1000.00,21000.00,22000.00,0.00,23000.00,0.30,0
20613,2322,-1000.00,20000.00,21000.00,0.00,22000.00,0.23,0
20614,2322,-1000.00,19000.00,20000.00,0.00,21000.00,0.31,0
20615,2322,-1000.00,18000.00,19000.00,0.00,20000.00,0.43,0
20616,2323,-1000.00,-1000.00,0.00,419.71,580.29,0.11,0
20617,2324,1000.00,1000.00,2000.00,67.35,817.97,0.42,1
20618,2324,1000.00,2000.00,3000.00,0.00,2000.00,0.43,1
20619,2324,1000.00,3000.00,4000.00,1500.00,1500.00,0.06,1
20620,2324,1000.00,4000.00,5000.00,0.00,3147.38,0.35,1
20621,2324,1000.00,5000.00,6000.00,0.00,4519.89,0.03,1
20622,2324,1000.00,6000.00,7000.00,78.77,5921.23,0.05,1
20623,2324,1000.00,7000.00,8000.00,2835.09,3998.34,0.34,1
20624,2324,1000.00,8000.00,9000.00,1255.12,6744.88,0.20,1
20625,2324,1000.00,9000.00,10000.00,848.56,2151.36,0.20,1
20626,2324,-1000.00,8000.00,9000.00,5447.19,4552.81,0.17,0
20627,2324,1000.00,9000.00,10000.00,3326.55,5673.45,0.32,1
20628,2324,-1000.00,8000.00,9000.00,5587.43,4412.57,0.18,0
20629,2324,1000.00,9000.00,10000.00,3622.89,5377.11,0.33,1
20630,2324,1000.00,10000.00,11000.00,0.00,10000.00,0.20,1
20631,2324,1000.00,11000.00,12000.00,4124.68,6875.32,0.29,1
20632,2324,1000.00,12000.00,13000.00,0.00,12000.00,0.22,1
20633,2324,1000.00,13000.00,14000.00,0.00,13000.00,0.10,1
20634,2324,-1000.00,12000.00,13000.00,10025.55,0.00,0.04,0
20635,2324,-1000.00,11000.00,12000.00,2651.55,0.00,0.04,0
20636,2324,1000.00,12000.00,13000.00,0.00,6468.95,0.16,1
20637,2324,1000.00,13000.00,14000.00,1324.44,5260.68,0.27,1
20638,2324,1000.00,14000.00,15000.00,2971.95,11028.05,0.39,1
20639,2324,-1000.00,13000.00,14000.00,10379.57,0.00,0.08,0
20640,2324,-355.71,12644.29,13644.29,0.00,355.71,0.08,0
20641,2324,-1000.00,11644.29,12644.29,4706.86,8937.43,0.27,0
20642,2324,-1000.00,10644.29,11644.29,6322.14,6322.14,0.03,0
20643,2324,-1000.00,9644.29,10644.29,0.00,8544.92,0.37,0
20644,2324,-1000.00,8644.29,9644.29,0.00,9145.08,0.32,0
20645,2324,-1000.00,7644.29,8644.29,0.00,6415.49,0.20,0
20646,2324,-1000.00,6644.29,7644.29,0.00,8644.29,0.34,0
20647,2324,-1000.00,5644.29,6644.29,8.49,5787.69,0.41,0
20648,2324,-1000.00,4644.29,5644.29,0.00,5973.34,0.39,0
20649,2324,-1000.00,3644.29,4644.29,1630.82,4013.46,0.32,0
20650,2324,-1000.00,2644.29,3644.29,0.00,4644.29,0.38,0
20651,2324,-1000.00,1644.29,2644.29,2051.43,422.47,0.12,0
20652,2324,-1000.00,644.29,1644.29,0.00,2644.29,0.06,0
20653,2324,-1000.00,-355.71,644.29,822.14,822.14,0.00,0
20654,2324,-549.77,-905.48,94.52,0.00,549.77,0.19,0
20655,2324,-94.52,-1000.00,0.00,0.00,94.52,0.39,0
20656,2325,-1000.00,-1000.00,0.00,481.93,518.07,0.23,0
20657,2326,-873.30,-873.30,126.70,663.23,210.07,0.10,0
20658,2326,-1000.00,-1873.30,-873.30,27.36,99.34,0.40,0
20659,2327,-770.16,-770.16,229.84,284.21,485.96,0.27,0
20660,2327,-1000.00,-1770.16,-770.16,146.26,83.58,0.09,0
20661,2328,-435.52,-435.52,564.48,0.00,435.52,0.16,0
20662,2328,-564.48,-1000.00,-0.00,18.51,545.97,0.06,0
20663,2329,-1000.00,-1000.00,0.00,222.48,777.52,0.38,0
20664,2330,1000.00,1000.00,2000.00,220.53,779.47,0.34,1
20665,2330,1000.00,2000.00,3000.00,0.00,460.45,0.18,1
20666,2330,1000.00,3000.00,4000.00,0.00,3000.00,0.04,1
20667,2330,1000.00,4000.00,5000.00,0.00,2477.12,0.33,1
20668,2330,1000.00,5000.00,6000.00,964.87,3299.84,0.36,1
20669,2330,1000.00,6000.00,7000.00,0.00,3787.90,0.29,1
20670,2330,1000.00,7000.00,8000.00,2945.56,4054.44,0.17,1
20671,2330,-1000.00,6000.00,7000.00,5066.58,1941.12,0.11,0
20672,2330,1000.00,7000.00,8000.00,2098.58,4901.42,0.22,1
20673,2330,1000.00,8000.00,9000.00,518.40,7481.60,0.41,1
20674,2330,1000.00,9000.00,10000.00,2032.63,6967.37,0.31,1
20675,2330,1000.00,10000.00,11000.00,0.00,10000.00,0.13,1
20676,2330,1000.00,11000.00,12000.00,4351.16,6648.84,0.23,1
20677,2330,1000.00,12000.00,13000.00,0.00,12000.00,0.41,1
20678,2330,1000.00,13000.00,14000.00,0.00,13000.00,0.14,1
20679,2330,-1000.00,12000.00,13000.00,8490.17,5509.83,0.10,0
20680,2330,1000.00,13000.00,14000.00,5392.40,7335.75,0.27,1
20681,2330,-1000.00,12000.00,13000.00,7854.76,3363.77,0.13,0
20682,2330,1000.00,13000.00,14000.00,0.00,10345.56,0.37,1
20683,2330,1000.00,14000.00,15000.00,0.00,14000.00,0.39,1
20684,2330,1000.00,15000.00,16000.00,5095.44,9904.56,0.31,1
20685,2330,1000.00,16000.00,17000.00,8000.00,8000.00,0.01,1
20686,2330,1000.00,17000.00,18000.00,0.00,39.99,0.08,1
20687,2330,1000.00,18000.00,19000.00,0.00,13036.08,0.33,1
20688,2330,-1000.00,17000.00,18000.00,6870.96,12129.04,0.32,0
20689,2330,-1000.00,16000.00,17000.00,424.61,10218.26,0.35,0
20690,2330,-1000.00,15000.00,16000.00,0.00,9084.24,0.32,0
20691,2330,-1000.00,14000.00,15000.00,0.00,16000.00,0.20,0
20692,2330,-1000.00,13000.00,14000.00,0.00,11310.27,0.15,0
20693,2330,-1000.00,12000.00,13000.00,3548.26,5841.24,0.26,0
20694,2330,-1000.00,11000.00,12000.00,0.00,13000.00,0.23,0
20695,2330,-1000.00,10000.00,11000.00,6255.62,5744.38,0.41,0
20696,2330,0.00,10000.00,11000.00,0.00,0.00,0.06,0
20697,2330,-1000.00,9000.00,10000.00,3939.84,7060.16,0.28,0
20698,2330,-1000.00,8000.00,9000.00,1847.45,8152.55,0.41,0
20699,2330,-1000.00,7000.00,8000.00,2822.65,6177.35,0.33,0
20700,2330,-1000.00,6000.00,7000.00,0.00,2680.03,0.24,0
20701,2330,-1000.00,5000.00,6000.00,3500.00,3500.00,0.03,0
20702,2330,-1000.00,4000.00,5000.00,3526.08,2473.92,0.13,0
20703,2330,-1000.00,3000.00,4000.00,2400.22,2599.78,0.09,0
20704,2330,-1000.00,2000.00,3000.00,244.35,0.00,0.06,0
20705,2330,-1000.00,1000.00,2000.00,0.00,2558.57,0.02,0
20706,2330,-1000.00,0.00,1000.00,0.00,1042.30,0.04,0
20707,2330,-827.44,-827.44,172.56,0.00,827.44,0.34,0
20708,2330,-172.56,-1000.00,0.00,68.21,104.35,0.02,0
20709,2331,-1000.00,-1000.00,0.00,500.00,500.00,0.03,0
20710,2332,1000.00,1000.00,2000.00,399.11,600.89,0.05,1
20711,2332,1000.00,2000.00,3000.00,0.00,2000.00,0.41,1
20712,2332,1000.00,3000.00,4000.00,1043.34,1862.66,0.31,1
20713,2332,1000.00,4000.00,5000.00,0.00,4000.00,0.24,1
20714,2332,1000.00,5000.00,6000.00,1902.82,3097.18,0.30,1
20715,2332,1000.00,6000.00,7000.00,871.85,4910.41,0.41,1
20716,2332,1000.00,7000.00,8000.00,0.00,7000.00,0.20,1
20717,2332,-1000.00,6000.00,7000.00,6429.04,1570.96,0.20,0
20718,2332,1000.00,7000.00,8000.00,305.42,6694.58,0.29,1
20719,2332,1000.00,8000.00,9000.00,507.61,7492.39,0.40,1
20720,2332,1000.00,9000.00,10000.00,385.60,8614.40,0.41,1
20721,2332,1000.00,10000.00,11000.00,0.00,3098.34,0.23,1
20722,2332,1000.00,11000.00,12000.00,5500.00,5500.00,0.08,1
20723,2332,1000.00,12000.00,13000.00,5123.12,6876.88,0.22,1
20724,2332,1000.00,13000.00,14000.00,5194.17,7805.83,0.05,1
20725,2332,1000.00,14000.00,15000.00,0.00,13433.62,0.09,1
20726,2332,1000.00,15000.00,16000.00,5937.13,9062.87,0.18,1
20727,2332,1000.00,16000.00,17000.00,1515.36,14484.64,0.26,1
20728,2332,-1000.00,15000.00,16000.00,9268.05,7731.95,0.11,0
20729,2332,1000.00,16000.00,17000.00,0.00,3306.02,0.05,1
20730,2332,-1000.00,15000.00,16000.00,10428.04,6571.96,0.27,0
20731,2332,1000.00,16000.00,17000.00,5836.26,10163.74,0.27,1
20732,2332,1000.00,17000.00,18000.00,5928.93,11071.07,0.31,1
20733,2332,1000.00,18000.00,19000.00,7448.49,10551.51,0.29,1
20734,2332,1000.00,19000.00,20000.00,0.00,19000.00,0.03,1
20735,2332,0.00,19000.00,20000.00,0.00,0.00,0.05,0
20736,2332,1000.00,20000.00,21000.00,0.00,20000.00,0.26,1
20737,2332,1000.00,21000.00,22000.00,2867.49,8712.88,0.27,1
20738,2332,1000.00,22000.00,23000.00,0.00,22000.00,0.39,1
20739,2332,0.00,22000.00,23000.00,0.00,0.00,0.01,0
20740,2332,-1000.00,21000.00,22000.00,16220.37,6779.63,0.05,0
20741,2332,1000.00,22000.00,23000.00,0.00,22000.00,0.16,1
20742,2332,1000.00,23000.00,24000.00,11500.00,11500.00,0.12,1
20743,2332,1000.00,24000.00,25000.00,0.00,24000.00,0.11,1
20744,2332,-1000.00,23000.00,24000.00,19928.63,5071.37,0.13,0
20745,2332,1000.00,24000.00,25000.00,0.00,13293.01,0.08,1
20746,2332,1000.00,25000.00,26000.00,3387.25,21612.75,0.18,1
20747,2332,-1000.00,24000.00,25000.00,8405.32,0.00,0.01,0
20748,2332,-1000.00,23000.00,24000.00,17933.51,7066.49,0.06,0
20749,2332,1000.00,24000.00,25000.00,12000.00,12000.00,0.03,1
20750,2332,1000.00,25000.00,26000.00,7071.49,17928.51,0.38,1
20751,2332,1000.00,26000.00,27000.00,6406.86,19593.14,0.20,1
20752,2332,1000.00,27000.00,28000.00,12295.95,14704.05,0.24,1
20753,2332,1000.00,28000.00,29000.00,0.00,19569.80,0.39,1
20754,2332,1000.00,29000.00,30000.00,3499.71,13015.29,0.29,1
20755,2332,-1000.00,28000.00,29000.00,12556.81,4385.42,0.13,0
20756,2332,-1000.00,27000.00,28000.00,21263.42,3336.58,0.07,0
20757,2332,-1000.00,26000.00,27000.00,17535.19,10464.81,0.34,0
20758,2333,-671.30,-671.30,328.70,0.00,671.30,0.24,0
20759,2333,-141.31,-812.60,187.40,52.74,88.57,0.39,0
20760,2333,1000.00,187.40,1187.40,98.37,89.03,0.01,1
20761,2333,1000.00,1187.40,2187.40,832.81,354.59,0.16,1
20762,2333,-1000.00,187.40,1187.40,0.00,2187.40,0.02,0
20763,2333,-1000.00,-812.60,187.40,152.14,959.24,0.43,0
20764,2333,-187.40,-1000.00,0.00,42.96,144.44,0.38,0
20765,2334,-1000.00,-1000.00,0.00,0.00,1000.00,0.26,0
20766,2335,-1000.00,-1000.00,0.00,83.94,0.00,0.04,0
20767,2336,1000.00,1000.00,2000.00,447.91,552.09,0.17,1
20768,2336,1000.00,2000.00,3000.00,0.00,287.87,0.12,1
20769,2336,1000.00,3000.00,4000.00,1233.57,1766.43,0.20,1
20770,2336,1000.00,4000.00,5000.00,0.00,3990.49,0.39,1
20771,2336,-1000.00,3000.00,4000.00,3742.93,1257.07,0.06,0
20772,2336,1000.00,4000.00,5000.00,0.00,3922.06,0.39,1
20773,2336,1000.00,5000.00,6000.00,594.20,4405.80,0.43,1
20774,2336,1000.00,6000.00,7000.00,0.00,6000.00,0.08,1
20775,2336,1000.00,7000.00,8000.00,3500.00,3500.00,0.20,1
20776,2336,1000.00,8000.00,9000.00,209.90,4261.92,0.33,1
20777,2336,1000.00,9000.00,10000.00,3230.37,5769.63,0.31,1
20778,2336,1000.00,10000.00,11000.00,2047.67,7952.33,0.39,1
20779,2336,1000.00,11000.00,12000.00,0.00,11000.00,0.19,1
20780,2336,1000.00,12000.00,13000.00,2749.30,9250.70,0.38,1
20781,2336,1000.00,13000.00,14000.00,0.00,7521.66,0.26,1
20782,2336,1000.00,14000.00,15000.00,2755.86,11244.14,0.41,1
20783,2336,1000.00,15000.00,16000.00,0.00,15000.00,0.25,1
20784,2336,1000.00,16000.00,17000.00,8000.00,8000.00,0.06,1
20785,2336,-1000.00,15000.00,16000.00,8535.15,8464.85,0.22,0
20786,2336,1000.00,16000.00,17000.00,1156.04,14843.96,0.43,1
20787,2336,1000.00,17000.00,18000.00,0.00,10974.95,0.08,1
20788,2336,1000.00,18000.00,19000.00,653.60,12253.12,0.38,1
20789,2336,-1000.00,17000.00,18000.00,9500.00,9500.00,0.40,0
20790,2336,-1000.00,16000.00,17000.00,0.00,18000.00,0.36,0
20791,2336,-1000.00,15000.00,16000.00,0.00,17000.00,0.14,0
20792,2336,-1000.00,14000.00,15000.00,1440.20,14559.80,0.44,0
20793,2336,-1000.00,13000.00,14000.00,2304.97,3298.66,0.18,0
20794,2336,-1000.00,12000.00,13000.00,0.00,13410.23,0.02,0
20795,2336,-1000.00,11000.00,12000.00,0.00,6549.59,0.20,0
20796,2336,-1000.00,10000.00,11000.00,4255.64,3550.80,0.19,0
20797,2336,-1000.00,9000.00,10000.00,6157.01,4842.99,0.18,0
20798,2336,-1000.00,8000.00,9000.00,3777.46,2523.93,0.17,0
20799,2336,-1000.00,7000.00,8000.00,3601.40,5398.60,0.40,0
20800,2336,-1000.00,6000.00,7000.00,0.00,1010.49,0.15,0
20801,2336,-1000.00,5000.00,6000.00,0.00,7000.00,0.23,0
20802,2336,-1000.00,4000.00,5000.00,0.00,6000.00,0.33,0
20803,2336,-1000.00,3000.00,4000.00,0.00,5000.00,0.05,0
20804,2336,-1000.00,2000.00,3000.00,702.94,3297.06,0.08,0
20805,2336,-1000.00,1000.00,2000.00,1154.86,1845.14,0.29,0
20806,2336,-499.84,500.16,1500.16,0.00,499.84,0.20,0
20807,2336,-1000.00,-499.84,500.16,538.96,961.20,0.27,0
20808,2336,-500.16,-1000.00,0.00,122.20,377.96,0.24,0
20809,2336,-0.00,-1000.00,0.00,0.00,0.00,0.12,0
20810,2337,-1000.00,-1000.00,0.00,55.59,944.41,0.34,0
20811,2338,-594.35,-594.35,405.65,0.00,594.35,0.33,0
20812,2338,-405.65,-1000.00,0.00,192.29,213.36,0.14,0
20813,2339,-1000.00,-1000.00,0.00,0.00,703.76,0.03,0
20814,2340,1000.00,1000.00,2000.00,0.00,1000.00,0.25,1
20815,2340,1000.00,2000.00,3000.00,550.56,1449.44,0.33,1
20816,2340,1000.00,3000.00,4000.00,1456.33,1543.67,0.18,1
20817,2340,-1000.00,2000.00,3000.00,3612.65,387.35,0.00,0
20818,2340,1000.00,3000.00,4000.00,828.86,2171.14,0.44,1
20819,2340,1000.00,4000.00,5000.00,0.00,4000.00,0.05,1
20820,2340,1000.00,5000.00,6000.00,1587.45,3412.55,0.28,1
20821,2340,-1000.00,4000.00,5000.00,840.92,3747.17,0.35,0
20822,2340,-1000.00,3000.00,4000.00,1426.53,3573.47,0.19,0
20823,2340,0.00,3000.00,4000.00,0.00,0.00,0.22,0
20824,2340,-1000.00,2000.00,3000.00,946.55,868.06,0.41,0
20825,2340,-1000.00,1000.00,2000.00,1095.67,0.00,0.29,0
20826,2340,-1000.00,0.00,1000.00,0.00,1217.59,0.34,0
20827,2340,0.00,0.00,1000.00,0.00,0.00,0.05,0
20828,2340,-882.49,-882.49,117.51,627.93,254.56,0.41,0
20829,2340,0.00,-882.49,117.51,0.00,0.00,0.07,0
20830,2340,-117.51,-1000.00,0.00,95.33,22.19,0.11,0
20831,2341,-1000.00,-1000.00,0.00,89.09,910.91,0.19,0
20832,2342,-1000.00,-1000.00,0.00,355.10,644.90,0.30,0
20833,2343,-545.78,-545.78,454.22,40.79,504.99,0.31,0
20834,2343,-1000.00,-1545.78,-545.78,233.65,220.57,0.18,0
20835,2344,-611.30,-611.30,388.70,0.00,611.30,0.35,0
20836,2344,-1000.00,-1611.30,-611.30,246.60,142.11,0.00,0
20837,2345,-1000.00,-1000.00,0.00,680.30,247.76,0.11,0
20838,2346,0.00,0.00,1000.00,0.00,0.00,0.42,0
20839,2346,0.00,0.00,1000.00,0.00,0.00,0.39,0
20840,2346,-1000.00,-1000.00,0.00,332.52,667.48,0.30,0
20841,2347,1000.00,1000.00,2000.00,0.00,1000.00,0.25,1
20842,2347,1000.00,2000.00,3000.00,408.77,1591.23,0.19,1
20843,2347,1000.00,3000.00,4000.00,587.19,2412.81,0.41,1
20844,2347,1000.00,4000.00,5000.00,173.26,3826.74,0.10,1
20845,2347,1000.00,5000.00,6000.00,0.00,3671.82,0.40,1
20846,2347,1000.00,6000.00,7000.00,0.00,786.18,0.04,1
20847,2347,1000.00,7000.00,8000.00,0.00,7000.00,0.43,1
20848,2347,1000.00,8000.00,9000.00,0.00,8000.00,0.02,1
20849,2347,1000.00,9000.00,10000.00,0.00,9000.00,0.07,1
20850,2347,1000.00,10000.00,11000.00,5000.00,5000.00,0.04,1
20851,2347,1000.00,11000.00,12000.00,5500.00,5500.00,0.00,1
20852,2347,1000.00,12000.00,13000.00,0.00,5636.05,0.11,1
20853,2347,1000.00,13000.00,14000.00,0.00,369.81,0.12,1
20854,2347,1000.00,14000.00,15000.00,4248.95,9751.05,0.27,1
20855,2347,1000.00,15000.00,16000.00,0.00,15000.00,0.19,1
20856,2347,-1000.00,14000.00,15000.00,9927.68,6072.32,0.09,0
20857,2347,1000.00,15000.00,16000.00,0.00,14732.04,0.28,1
20858,2347,1000.00,16000.00,17000.00,6309.98,9690.02,0.07,1
20859,2347,1000.00,17000.00,18000.00,0.00,17000.00,0.33,1
20860,2347,1000.00,18000.00,19000.00,0.00,14345.18,0.20,1
20861,2347,-1000.00,17000.00,18000.00,13605.67,5394.33,0.08,0
20862,2347,1000.00,18000.00,19000.00,209.57,17790.43,0.44,1
20863,2347,-1000.00,17000.00,18000.00,15172.12,0.00,0.07,0
20864,2347,-1000.00,16000.00,17000.00,0.00,18000.00,0.42,0
20865,2347,-1000.00,15000.00,16000.00,4713.80,12286.20,0.21,0
20866,2347,-1000.00,14000.00,15000.00,4712.59,11287.41,0.41,0
20867,2347,-1000.00,13000.00,14000.00,2124.74,12875.26,0.08,0
20868,2347,-1000.00,12000.00,13000.00,3521.26,3337.58,0.18,0
20869,2347,-1000.00,11000.00,12000.00,0.00,10569.89,0.42,0
20870,2347,-1000.00,10000.00,11000.00,0.00,12000.00,0.26,0
20871,2347,-1000.00,9000.00,10000.00,0.00,11000.00,0.08,0
20872,2347,-1000.00,8000.00,9000.00,0.00,5564.28,0.22,0
20873,2347,-1000.00,7000.00,8000.00,1582.24,7214.04,0.40,0
20874,2347,-1000.00,6000.00,7000.00,0.00,8000.00,0.31,0
20875,2347,-1000.00,5000.00,6000.00,0.00,7000.00,0.21,0
20876,2347,-1000.00,4000.00,5000.00,369.74,4856.11,0.42,0
20877,2347,-1000.00,3000.00,4000.00,2789.10,2210.90,0.08,0
20878,2347,-1000.00,2000.00,3000.00,3565.82,434.18,0.03,0
20879,2347,-1000.00,1000.00,2000.00,3.37,2996.63,0.33,0
20880,2347,-1000.00,0.00,1000.00,1294.24,0.00,0.02,0
20881,2347,-1000.00,-1000.00,0.00,349.74,650.26,0.05,0
20882,2348,1000.00,1000.00,2000.00,271.52,728.48,0.27,1
20883,2348,1000.00,2000.00,3000.00,0.00,2000.00,0.14,1
20884,2348,-1000.00,1000.00,2000.00,1566.38,256.70,0.09,0
20885,2348,1000.00,2000.00,3000.00,0.00,2000.00,0.40,1
20886,2348,1000.00,3000.00,4000.00,0.00,3000.00,0.27,1
20887,2348,1000.00,4000.00,5000.00,0.00,2057.35,0.25,1
20888,2348,1000.00,5000.00,6000.00,478.66,3532.82,0.39,1
20889,2348,1000.00,6000.00,7000.00,222.54,3777.53,0.37,1
20890,2348,1000.00,7000.00,8000.00,0.00,2240.89,0.23,1
20891,2348,1000.00,8000.00,9000.00,0.00,6125.13,0.22,1
20892,2348,1000.00,9000.00,10000.00,0.00,8655.07,0.44,1
20893,2348,1000.00,10000.00,11000.00,1696.58,4833.86,0.30,1
20894,2348,1000.00,11000.00,12000.00,0.00,10414.23,0.37,1
20895,2348,1000.00,12000.00,13000.00,6000.00,6000.00,0.02,1
20896,2348,1000.00,13000.00,14000.00,0.00,13000.00,0.12,1
20897,2348,1000.00,14000.00,15000.00,0.00,12056.00,0.42,1
20898,2348,1000.00,15000.00,16000.00,0.00,11716.07,0.41,1
20899,2348,1000.00,16000.00,17000.00,0.00,15634.61,0.43,1
20900,2348,1000.00,17000.00,18000.00,5636.45,11363.55,0.33,1
20901,2348,1000.00,18000.00,19000.00,577.79,17422.21,0.40,1
20902,2348,1000.00,19000.00,20000.00,9500.00,9500.00,0.08,1
20903,2348,-1000.00,18000.00,19000.00,10539.56,9460.44,0.37,0
20904,2348,1000.00,19000.00,20000.00,0.00,19000.00,0.13,1
20905,2348,1000.00,20000.00,21000.00,6141.46,13858.54,0.22,1
20906,2348,-433.32,19566.68,20566.68,433.32,0.00,0.11,0
20907,2348,0.00,19566.68,20566.68,0.00,0.00,0.05,0
20908,2348,1000.00,20566.68,21566.68,7177.70,12045.68,0.29,1
20909,2348,1000.00,21566.68,22566.68,2535.41,14019.84,0.37,1
20910,2348,1000.00,22566.68,23566.68,10881.10,11685.58,0.18,1
20911,2348,1000.00,23566.68,24566.68,1848.44,21718.24,0.43,1
20912,2348,1000.00,24566.68,25566.68,0.00,24566.68,0.23,1
20913,2348,1000.00,25566.68,26566.68,0.00,25566.68,0.35,1
20914,2348,1000.00,26566.68,27566.68,9312.38,17254.30,0.05,1
20915,2348,-1000.00,25566.68,26566.68,14540.54,13026.14,0.18,0
20916,2348,1000.00,26566.68,27566.68,6300.51,20266.17,0.16,1
20917,2348,1000.00,27566.68,28566.68,13783.34,13783.34,0.06,1
20918,2348,-1000.00,26566.68,27566.68,2651.08,1497.95,0.13,0
20919,2348,-1000.00,25566.68,26566.68,27566.68,0.00,0.00,0
20920,2348,1000.00,26566.68,27566.68,10876.63,11687.49,0.23,1
20921,2348,1000.00,27566.68,28566.68,1370.65,26196.03,0.32,1
20922,2349,-1000.00,-1000.00,0.00,640.21,268.88,0.12,0
20923,2350,1000.00,1000.00,2000.00,157.91,842.09,0.27,1
20924,2350,1000.00,2000.00,3000.00,0.00,1610.78,0.36,1
20925,2350,1000.00,3000.00,4000.00,0.00,611.59,0.16,1
20926,2350,1000.00,4000.00,5000.00,0.00,4000.00,0.27,1
20927,2350,1000.00,5000.00,6000.00,951.61,4048.39,0.32,1
20928,2350,1000.00,6000.00,7000.00,1711.61,4288.39,0.37,1
20929,2350,1000.00,7000.00,8000.00,0.00,7000.00,0.24,1
20930,2350,1000.00,8000.00,9000.00,0.00,66.05,0.07,1
20931,2350,1000.00,9000.00,10000.00,0.00,6397.17,0.22,1
20932,2350,1000.00,10000.00,11000.00,4194.83,5805.17,0.39,1
20933,2350,1000.00,11000.00,12000.00,0.00,3470.02,0.15,1
20934,2350,-1000.00,10000.00,11000.00,6467.90,5532.10,0.31,0
20935,2350,-1000.00,9000.00,10000.00,5763.48,5236.52,0.21,0
20936,2350,1000.00,10000.00,11000.00,895.22,1848.31,0.18,1
20937,2350,1000.00,11000.00,12000.00,4686.39,6313.61,0.18,1
20938,2350,-1000.00,10000.00,11000.00,6388.90,5611.10,0.19,0
20939,2350,-1000.00,9000.00,10000.00,0.00,1441.05,0.15,0
20940,2350,-1000.00,8000.00,9000.00,2814.10,7185.90,0.35,0
20941,2350,-1000.00,7000.00,8000.00,0.00,9000.00,0.16,0
20942,2350,-1000.00,6000.00,7000.00,2013.04,5986.96,0.17,0
20943,2350,-1000.00,5000.00,6000.00,131.48,4242.65,0.36,0
20944,2350,-1000.00,4000.00,5000.00,729.95,5270.05,0.03,0
20945,2350,-1000.00,3000.00,4000.00,0.00,5000.00,0.39,0
20946,2350,-1000.00,2000.00,3000.00,832.34,3167.66,0.39,0
20947,2350,-1000.00,1000.00,2000.00,2599.36,349.93,0.05,0
20948,2350,-1000.00,0.00,1000.00,0.00,2000.00,0.01,0
20949,2350,-1000.00,-1000.00,0.00,241.82,758.18,0.35,0
20950,2351,1000.00,1000.00,2000.00,454.92,545.08,0.17,1
20951,2351,1000.00,2000.00,3000.00,197.33,1802.67,0.42,1
20952,2351,1000.00,3000.00,4000.00,558.08,2441.92,0.32,1
20953,2351,1000.00,4000.00,5000.00,0.00,3715.72,0.36,1
20954,2351,1000.00,5000.00,6000.00,0.00,5000.00,0.43,1
20955,2351,1000.00,6000.00,7000.00,2139.99,3860.01,0.35,1
20956,2351,1000.00,7000.00,8000.00,2443.66,4556.34,0.17,1
20957,2351,1000.00,8000.00,9000.00,0.00,8000.00,0.42,1
20958,2351,1000.00,9000.00,10000.00,2230.65,6769.35,0.38,1
20959,2351,0.00,9000.00,10000.00,0.00,0.00,0.07,0
20960,2351,1000.00,10000.00,11000.00,0.00,9151.97,0.11,1
20961,2351,1000.00,11000.00,12000.00,5500.00,5500.00,0.10,1
20962,2351,1000.00,12000.00,13000.00,0.00,10816.44,0.19,1
20963,2351,1000.00,13000.00,14000.00,0.00,4993.03,0.27,1
20964,2351,-1000.00,12000.00,13000.00,5018.09,0.00,0.06,0
20965,2351,1000.00,13000.00,14000.00,4589.04,8410.96,0.32,1
20966,2351,-1000.00,12000.00,13000.00,8050.94,5949.06,0.34,0
20967,2351,1000.00,13000.00,14000.00,6500.00,6500.00,0.01,1
20968,2351,1000.00,14000.00,15000.00,0.00,14000.00,0.32,1
20969,2351,1000.00,15000.00,16000.00,0.00,10272.17,0.30,1
20970,2351,1000.00,16000.00,17000.00,2527.75,12754.39,0.40,1
20971,2351,1000.00,17000.00,18000.00,0.00,17000.00,0.32,1
20972,2351,-1000.00,16000.00,17000.00,8346.71,9653.29,0.28,0
20973,2351,-1000.00,15000.00,16000.00,11141.46,5858.54,0.02,0
20974,2351,-1000.00,14000.00,15000.00,7877.38,8122.62,0.11,0
20975,2351,-1000.00,13000.00,14000.00,0.00,4461.52,0.22,0
20976,2351,-1000.00,12000.00,13000.00,0.00,3081.83,0.13,0
20977,2351,-1000.00,11000.00,12000.00,0.00,13000.00,0.00,0
20978,2351,-1000.00,10000.00,11000.00,3740.12,8259.88,0.29,0
20979,2351,-1000.00,9000.00,10000.00,8480.20,2519.80,0.14,0
20980,2351,-1000.00,8000.00,9000.00,0.00,3738.25,0.04,0
20981,2351,-1000.00,7000.00,8000.00,122.37,8877.63,0.28,0
20982,2351,-1000.00,6000.00,7000.00,2608.66,5391.34,0.26,0
20983,2351,-1000.00,5000.00,6000.00,3500.00,3500.00,0.07,0
20984,2351,-1000.00,4000.00,5000.00,616.31,5383.69,0.43,0
20985,2351,-1000.00,3000.00,4000.00,1425.42,3574.58,0.16,0
20986,2351,-1000.00,2000.00,3000.00,1884.37,1530.74,0.19,0
20987,2351,-1000.00,1000.00,2000.00,1293.95,1706.05,0.04,0
20988,2351,-1000.00,0.00,1000.00,1000.00,1000.00,0.05,0
20989,2351,-1000.00,-1000.00,0.00,159.10,840.90,0.23,0
20990,2352,-1000.00,-1000.00,0.00,114.19,885.81,0.41,0
20991,2353,-1000.00,-1000.00,0.00,315.18,112.56,0.13,0
20992,2354,-976.74,-976.74,23.26,289.44,687.29,0.34,0
20993,2354,-23.26,-1000.00,0.00,0.00,23.26,0.28,0
20994,2355,-1000.00,-1000.00,0.00,0.00,1000.00,0.31,0
20995,2356,0.00,0.00,1000.00,0.00,0.00,0.02,0
20996,2356,1000.00,1000.00,2000.00,144.06,855.94,0.23,1
20997,2356,1000.00,2000.00,3000.00,0.00,1834.84,0.00,1
20998,2356,1000.00,3000.00,4000.00,0.00,3000.00,0.11,1
20999,2356,1000.00,4000.00,5000.00,1809.40,2190.60,0.12,1
21000,2356,1000.00,5000.00,6000.00,0.00,5000.00,0.12,1
21001,2356,1000.00,6000.00,7000.00,0.00,6000.00,0.39,1
21002,2356,-1000.00,5000.00,6000.00,2066.07,0.00,0.01,0
21003,2356,1000.00,6000.00,7000.00,0.00,2867.94,0.28,1
21004,2356,1000.00,7000.00,8000.00,0.00,7000.00,0.05,1
21005,2356,1000.00,8000.00,9000.00,0.00,7579.49,0.18,1
21006,2356,1000.00,9000.00,10000.00,0.00,7619.58,0.43,1
21007,2356,1000.00,10000.00,11000.00,0.00,8416.30,0.42,1
21008,2356,1000.00,11000.00,12000.00,0.00,1921.32,0.12,1
21009,2356,1000.00,12000.00,13000.00,0.00,12000.00,0.34,1
21010,2356,1000.00,13000.00,14000.00,0.00,1215.56,0.11,1
21011,2356,1000.00,14000.00,15000.00,307.41,2768.96,0.18,1
21012,2356,-1000.00,13000.00,14000.00,9090.45,5909.55,0.18,0
21013,2356,-1000.00,12000.00,13000.00,5369.26,8630.74,0.07,0
21014,2356,-1000.00,11000.00,12000.00,6127.52,6872.48,0.21,0
21015,2356,-1000.00,10000.00,11000.00,0.00,12000.00,0.34,0
21016,2356,-1000.00,9000.00,10000.00,634.92,8833.65,0.38,0
21017,2356,-1000.00,8000.00,9000.00,0.00,5049.65,0.42,0
21018,2356,-1000.00,7000.00,8000.00,5636.56,3363.44,0.15,0
21019,2356,1000.00,8000.00,9000.00,0.00,8000.00,0.18,1
21020,2356,1000.00,9000.00,10000.00,3100.32,5899.68,0.33,1
21021,2356,1000.00,10000.00,11000.00,4772.82,5227.18,0.22,1
21022,2356,1000.00,11000.00,12000.00,1580.97,9419.03,0.41,1
21023,2356,1000.00,12000.00,13000.00,4496.53,7503.47,0.26,1
21024,2356,0.00,12000.00,13000.00,0.00,0.00,0.08,0
21025,2356,1000.00,13000.00,14000.00,6420.44,6579.56,0.22,1
21026,2356,1000.00,14000.00,15000.00,1386.69,10555.06,0.40,1
21027,2356,1000.00,15000.00,16000.00,7500.00,7500.00,0.06,1
21028,2356,1000.00,16000.00,17000.00,0.00,13584.50,0.07,1
21029,2356,1000.00,17000.00,18000.00,0.00,3446.75,0.18,1
21030,2356,1000.00,18000.00,19000.00,8538.16,9461.84,0.31,1
21031,2356,1000.00,19000.00,20000.00,0.00,19000.00,0.09,1
21032,2356,1000.00,20000.00,21000.00,8952.40,11047.60,0.09,1
21033,2356,1000.00,21000.00,22000.00,5372.33,15627.67,0.35,1
21034,2356,1000.00,22000.00,23000.00,8907.41,13092.59,0.32,1
21035,2356,1000.00,23000.00,24000.00,0.00,16680.42,0.38,1
21036,2356,1000.00,24000.00,25000.00,0.00,5185.36,0.14,1
21037,2356,-1000.00,23000.00,24000.00,16501.09,8498.91,0.32,0
21038,2356,1000.00,24000.00,25000.00,8823.93,15176.07,0.31,1
21039,2356,1000.00,25000.00,26000.00,9569.46,15430.54,0.33,1
21040,2356,1000.00,26000.00,27000.00,6884.46,19115.54,0.38,1
21041,2356,1000.00,27000.00,28000.00,0.00,27000.00,0.15,1
21042,2357,-1000.00,-1000.00,0.00,0.00,396.44,0.36,0
21043,2358,-960.54,-960.54,39.46,0.00,960.54,0.12,0
21044,2358,-18.91,-979.45,20.55,3.88,15.04,0.26,0
21045,2358,-1000.00,-1979.45,-979.45,10.40,10.15,0.37,0
21046,2359,-1000.00,-1000.00,0.00,0.00,1000.00,0.31,0
21047,2360,1000.00,1000.00,2000.00,628.44,0.00,0.08,1
21048,2360,1000.00,2000.00,3000.00,85.11,0.00,0.43,1
21049,2360,1000.00,3000.00,4000.00,2375.29,624.71,0.12,1
21050,2360,-842.40,2157.60,3157.60,0.00,842.40,0.31,0
21051,2360,-1000.00,1157.60,2157.60,1578.80,1578.80,0.10,0
21052,2360,-549.75,607.84,1607.84,0.00,549.75,0.40,0
21053,2360,1000.00,1607.84,2607.84,891.95,715.89,0.00,1
21054,2360,-636.27,971.58,1971.58,0.00,636.27,0.19,0
21055,2360,1000.00,1971.58,2971.58,1971.58,0.00,0.08,1
21056,2360,1000.00,2971.58,3971.58,1500.54,1471.03,0.00,1
21057,2360,1000.00,3971.58,4971.58,1488.38,0.00,0.26,1
21058,2360,1000.00,4971.58,5971.58,580.72,0.00,0.40,1
21059,2360,0.00,4971.58,5971.58,0.00,0.00,0.35,0
21060,2360,-1000.00,3971.58,4971.58,0.00,5971.58,0.05,0
21061,2360,-1000.00,2971.58,3971.58,1565.95,3405.63,0.10,0
21062,2360,1000.00,3971.58,4971.58,2698.48,1273.10,0.13,1
21063,2360,1000.00,4971.58,5971.58,3037.26,1235.26,0.34,1
21064,2360,1000.00,5971.58,6971.58,5971.58,0.00,0.31,1
21065,2360,1000.00,6971.58,7971.58,4434.85,517.73,0.31,1
21066,2360,1000.00,7971.58,8971.58,4561.34,0.00,0.18,1
21067,2360,-1000.00,6971.58,7971.58,8971.58,0.00,0.04,0
21068,2360,0.00,6971.58,7971.58,0.00,0.00,0.06,0
21069,2360,-1000.00,5971.58,6971.58,0.00,1605.75,0.09,0
21070,2360,-426.00,5545.58,6545.58,426.00,0.00,0.42,0
21071,2360,-1000.00,4545.58,5545.58,2671.61,3873.96,0.02,0
21072,2360,0.00,4545.58,5545.58,0.00,0.00,0.16,0
21073,2360,-1000.00,3545.58,4545.58,1825.24,3691.12,0.21,0
21074,2360,-1000.00,2545.58,3545.58,655.36,1383.34,0.38,0
21075,2360,-1000.00,1545.58,2545.58,2852.21,693.36,0.34,0
21076,2360,-257.34,1288.23,2288.23,249.81,7.53,0.37,0
21077,2360,-88.02,1200.22,2200.22,88.02,0.00,0.14,0
21078,2360,-311.45,888.76,1888.76,311.45,0.00,0.38,0
21079,2360,-1000.00,-111.24,888.76,1155.16,733.60,0.30,0
21080,2360,-1000.00,-1111.24,-111.24,0.00,50.24,0.44,0
21081,2361,-1000.00,-1000.00,0.00,73.91,926.09,0.13,0
21082,2361,-0.00,-1000.00,-0.00,0.00,0.00,0.16,0
21083,2362,-1000.00,-1000.00,0.00,494.81,505.19,0.20,0
21084,2363,-1000.00,-1000.00,0.00,451.48,548.52,0.21,0
21085,2364,-452.82,-452.82,547.18,153.88,298.94,0.22,0
21086,2364,-547.18,-1000.00,0.00,124.90,422.27,0.37,0
21087,2365,-504.19,-504.19,495.81,0.00,504.19,0.04,0
21088,2365,-485.13,-989.32,10.68,0.00,485.13,0.41,0
21089,2365,-5.72,-995.04,4.96,0.00,5.72,0.16,0
21090,2365,-3.95,-998.99,1.01,1.07,2.88,0.32,0
21091,2365,-1.01,-1000.00,0.00,0.39,0.62,0.27,0
21092,2366,1000.00,1000.00,2000.00,497.16,502.84,0.19,1
21093,2366,1000.00,2000.00,3000.00,609.00,1391.00,0.26,1
21094,2366,1000.00,3000.00,4000.00,656.73,2343.27,0.30,1
21095,2366,-1000.00,2000.00,3000.00,2584.65,82.11,0.07,0
21096,2366,-1000.00,1000.00,2000.00,3000.00,0.00,0.00,0
21097,2366,1000.00,2000.00,3000.00,197.17,252.24,0.15,1
21098,2366,1000.00,3000.00,4000.00,0.00,3000.00,0.25,1
21099,2366,1000.00,4000.00,5000.00,0.00,311.74,0.13,1
21100,2366,1000.00,5000.00,6000.00,1457.11,3542.89,0.26,1
21101,2366,1000.00,6000.00,7000.00,0.00,4993.02,0.36,1
21102,2366,1000.00,7000.00,8000.00,2724.34,4275.66,0.34,1
21103,2366,1000.00,8000.00,9000.00,3352.56,4647.44,0.20,1
21104,2366,-1000.00,7000.00,8000.00,4130.08,4869.92,0.16,0
21105,2366,-1000.00,6000.00,7000.00,0.00,5668.68,0.43,0
21106,2366,-1000.00,5000.00,6000.00,0.00,7000.00,0.19,0
21107,2366,-1000.00,4000.00,5000.00,3332.30,2667.70,0.30,0
21108,2366,-1000.00,3000.00,4000.00,0.00,5000.00,0.15,0
21109,2366,-1000.00,2000.00,3000.00,2000.00,2000.00,0.13,0
21110,2366,-1000.00,1000.00,2000.00,1056.93,1943.07,0.30,0
21111,2366,-1000.00,0.00,1000.00,0.00,207.05,0.37,0
21112,2366,-1000.00,-1000.00,0.00,824.20,175.80,0.19,0
21113,2367,-1000.00,-1000.00,0.00,57.85,523.31,0.44,0
21114,2368,-1000.00,-1000.00,0.00,390.06,609.94,0.26,0
21115,2369,-1000.00,-1000.00,0.00,358.23,0.00,0.00,0
21116,2370,-1000.00,-1000.00,0.00,235.92,764.08,0.39,0
21117,2371,1000.00,1000.00,2000.00,699.60,0.00,0.16,1
21118,2371,0.00,1000.00,2000.00,0.00,0.00,0.02,0
21119,2371,-1000.00,0.00,1000.00,0.00,1611.76,0.19,0
21120,2371,-843.26,-843.26,156.74,0.00,843.26,0.16,0
21121,2371,1000.00,156.74,1156.74,109.83,46.91,0.20,1
21122,2371,-429.36,-272.62,727.38,0.00,429.36,0.22,0
21123,2371,-332.98,-605.61,394.39,0.00,332.98,0.31,0
21124,2371,-394.39,-1000.00,0.00,157.28,237.11,0.39,0
21125,2372,-1000.00,-1000.00,0.00,161.02,170.69,0.41,0
21126,2373,-1000.00,-1000.00,0.00,0.00,881.58,0.43,0
21127,2374,-1000.00,-1000.00,0.00,7.87,992.13,0.30,0
21128,2375,-700.09,-700.09,299.91,0.00,700.09,0.19,0
21129,2375,-299.91,-1000.00,0.00,111.28,188.64,0.31,0
21130,2376,-1000.00,-1000.00,0.00,79.31,920.69,0.29,0
21131,2377,-1000.00,-1000.00,0.00,317.88,682.12,0.13,0
21132,2378,-1000.00,-1000.00,0.00,0.00,1000.00,0.39,0
21133,2379,-1000.00,-1000.00,0.00,0.00,1000.00,0.23,0
21134,2380,-1000.00,-1000.00,0.00,0.00,1000.00,0.31,0
21135,2381,1000.00,1000.00,2000.00,13.96,401.22,0.27,1
21136,2381,1000.00,2000.00,3000.00,935.94,1064.06,0.17,1
21137,2381,1000.00,3000.00,4000.00,0.00,512.48,0.09,1
21138,2381,1000.00,4000.00,5000.00,1566.92,2433.08,0.38,1
21139,2381,1000.00,5000.00,6000.00,0.00,5000.00,0.12,1
21140,2381,1000.00,6000.00,7000.00,0.00,6000.00,0.39,1
21141,2381,1000.00,7000.00,8000.00,1878.06,5121.94,0.38,1
21142,2381,1000.00,8000.00,9000.00,1275.27,5888.81,0.39,1
21143,2381,1000.00,9000.00,10000.00,4081.61,4918.39,0.22,1
21144,2381,1000.00,10000.00,11000.00,66.10,9933.90,0.06,1
21145,2381,-1000.00,9000.00,10000.00,7482.31,388.89,0.06,0
21146,2381,1000.00,10000.00,11000.00,4460.97,5539.03,0.17,1
21147,2381,-1000.00,9000.00,10000.00,3538.47,1395.94,0.13,0
21148,2381,1000.00,10000.00,11000.00,0.00,6874.68,0.05,1
21149,2381,1000.00,11000.00,12000.00,0.00,11000.00,0.28,1
21150,2381,1000.00,12000.00,13000.00,2084.20,2995.54,0.19,1
21151,2381,1000.00,13000.00,14000.00,0.00,7639.65,0.20,1
21152,2381,1000.00,14000.00,15000.00,490.87,11479.82,0.32,1
21153,2381,1000.00,15000.00,16000.00,0.00,15000.00,0.22,1
21154,2381,1000.00,16000.00,17000.00,0.00,16000.00,0.05,1
21155,2381,1000.00,17000.00,18000.00,2020.18,3248.71,0.18,1
21156,2381,-1000.00,16000.00,17000.00,9000.00,9000.00,0.17,0
21157,2381,-1000.00,15000.00,16000.00,5477.18,11522.82,0.30,0
21158,2381,-1000.00,14000.00,15000.00,3066.40,12856.17,0.40,0
21159,2381,-1000.00,13000.00,14000.00,4905.43,10094.57,0.22,0
21160,2381,-1000.00,12000.00,13000.00,399.17,13600.83,0.44,0
21161,2381,-1000.00,11000.00,12000.00,2294.86,6279.78,0.29,0
21162,2381,-1000.00,10000.00,11000.00,0.00,12000.00,0.33,0
21163,2381,-1000.00,9000.00,10000.00,0.00,11000.00,0.18,0
21164,2381,-1000.00,8000.00,9000.00,35.33,0.00,0.01,0
21165,2381,-1000.00,7000.00,8000.00,4839.08,4160.92,0.02,0
21166,2381,-1000.00,6000.00,7000.00,0.00,8000.00,0.12,0
21167,2381,-1000.00,5000.00,6000.00,1828.59,0.00,0.03,0
21168,2381,-1000.00,4000.00,5000.00,1035.63,2635.96,0.15,0
21169,2381,-1000.00,3000.00,4000.00,0.00,4217.28,0.36,0
21170,2381,-1000.00,2000.00,3000.00,0.00,4000.00,0.17,0
21171,2381,-1000.00,1000.00,2000.00,530.62,2469.38,0.21,0
21172,2381,-1000.00,0.00,1000.00,0.00,1912.57,0.27,0
21173,2381,-981.35,-981.35,18.65,0.00,981.35,0.44,0
21174,2381,-18.65,-1000.00,0.00,0.00,18.65,0.07,0
21175,2382,1000.00,1000.00,2000.00,115.13,183.41,0.17,1
21176,2382,-1000.00,0.00,1000.00,1289.83,710.17,0.13,0
21177,2382,1000.00,1000.00,2000.00,372.17,627.83,0.09,1
21178,2382,1000.00,2000.00,3000.00,99.76,1900.24,0.27,1
21179,2382,1000.00,3000.00,4000.00,1412.94,1587.06,0.23,1
21180,2382,1000.00,4000.00,5000.00,81.88,3816.38,0.44,1
21181,2382,1000.00,5000.00,6000.00,676.76,4323.24,0.23,1
21182,2382,1000.00,6000.00,7000.00,1027.45,4483.04,0.39,1
21183,2382,1000.00,7000.00,8000.00,0.00,7000.00,0.43,1
21184,2382,1000.00,8000.00,9000.00,3963.45,4036.55,0.21,1
21185,2382,1000.00,9000.00,10000.00,1690.55,4115.61,0.28,1
21186,2382,1000.00,10000.00,11000.00,3978.45,6021.55,0.29,1
21187,2382,1000.00,11000.00,12000.00,4899.44,6100.56,0.34,1
21188,2382,1000.00,12000.00,13000.00,4546.37,7453.63,0.18,1
21189,2382,1000.00,13000.00,14000.00,0.00,13000.00,0.12,1
21190,2382,1000.00,14000.00,15000.00,4483.72,9516.28,0.34,1
21191,2382,1000.00,15000.00,16000.00,0.00,15000.00,0.01,1
21192,2382,1000.00,16000.00,17000.00,7468.80,8531.20,0.15,1
21193,2382,1000.00,17000.00,18000.00,0.00,8539.99,0.31,1
21194,2382,1000.00,18000.00,19000.00,7289.22,10710.78,0.29,1
21195,2382,1000.00,19000.00,20000.00,9500.00,9500.00,0.11,1
21196,2382,1000.00,20000.00,21000.00,2986.32,17013.68,0.19,1
21197,2382,-1000.00,19000.00,20000.00,3465.20,0.00,0.06,0
21198,2382,1000.00,20000.00,21000.00,4841.17,15158.83,0.30,1
21199,2382,1000.00,21000.00,22000.00,0.00,15830.88,0.39,1
21200,2382,1000.00,22000.00,23000.00,4856.46,17143.54,0.40,1
21201,2382,1000.00,23000.00,24000.00,0.00,23000.00,0.10,1
21202,2382,1000.00,24000.00,25000.00,6831.95,17168.05,0.36,1
21203,2382,-1000.00,23000.00,24000.00,5629.52,0.00,0.03,0
21204,2382,1000.00,24000.00,25000.00,0.00,17622.78,0.24,1
21205,2382,1000.00,25000.00,26000.00,0.00,25000.00,0.21,1
21206,2382,1000.00,26000.00,27000.00,0.00,26000.00,0.29,1
21207,2382,1000.00,27000.00,28000.00,6268.28,20731.72,0.25,1
21208,2382,-1000.00,26000.00,27000.00,17364.32,10635.68,0.29,0
21209,2382,1000.00,27000.00,28000.00,0.00,23277.09,0.41,1
21210,2382,1000.00,28000.00,29000.00,0.00,14942.08,0.27,1
21211,2382,1000.00,29000.00,30000.00,0.00,29000.00,0.15,1
21212,2382,-1000.00,28000.00,29000.00,20648.79,4326.26,0.08,0
21213,2382,-1000.00,27000.00,28000.00,16365.81,12634.19,0.20,0
21214,2382,1000.00,28000.00,29000.00,4858.47,23141.53,0.13,1
21215,2382,1000.00,29000.00,30000.00,0.00,29000.00,0.15,1
21216,2383,-1000.00,-1000.00,0.00,0.00,1000.00,0.28,0
21217,2384,-1000.00,-1000.00,0.00,0.00,614.18,0.15,0
21218,2385,-1000.00,-1000.00,0.00,0.00,1000.00,0.15,0
21219,2386,1000.00,1000.00,2000.00,0.00,1000.00,0.05,1
21220,2386,1000.00,2000.00,3000.00,908.96,1091.04,0.16,1
21221,2386,1000.00,3000.00,4000.00,0.00,281.08,0.03,1
21222,2386,1000.00,4000.00,5000.00,247.71,1135.66,0.22,1
21223,2386,1000.00,5000.00,6000.00,0.00,5000.00,0.30,1
21224,2386,1000.00,6000.00,7000.00,1591.30,4408.70,0.36,1
21225,2386,1000.00,7000.00,8000.00,2424.13,4575.87,0.26,1
21226,2386,1000.00,8000.00,9000.00,0.00,6786.51,0.33,1
21227,2386,-1000.00,7000.00,8000.00,3216.83,2976.52,0.20,0
21228,2386,1000.00,8000.00,9000.00,0.00,8000.00,0.33,1
21229,2386,1000.00,9000.00,10000.00,788.28,1331.46,0.16,1
21230,2386,1000.00,10000.00,11000.00,0.00,2168.57,0.17,1
21231,2386,1000.00,11000.00,12000.00,0.00,2657.27,0.04,1
21232,2386,1000.00,12000.00,13000.00,6000.00,6000.00,0.05,1
21233,2386,-1000.00,11000.00,12000.00,5793.07,3641.16,0.16,0
21234,2386,1000.00,12000.00,13000.00,4388.57,7611.43,0.29,1
21235,2386,1000.00,13000.00,14000.00,4199.36,8800.64,0.23,1
21236,2386,1000.00,14000.00,15000.00,3066.02,10933.98,0.09,1
21237,2386,1000.00,15000.00,16000.00,5455.88,9544.12,0.24,1
21238,2386,1000.00,16000.00,17000.00,0.00,16000.00,0.35,1
21239,2386,1000.00,17000.00,18000.00,8500.00,8500.00,0.17,1
21240,2386,1000.00,18000.00,19000.00,4967.30,9213.02,0.29,1
21241,2386,1000.00,19000.00,20000.00,0.00,19000.00,0.39,1
21242,2386,1000.00,20000.00,21000.00,10000.00,10000.00,0.01,1
21243,2386,1000.00,21000.00,22000.00,8449.88,12550.12,0.27,1
21244,2386,1000.00,22000.00,23000.00,8509.93,13490.07,0.28,1
21245,2386,1000.00,23000.00,24000.00,10720.24,12279.76,0.18,1
21246,2386,1000.00,24000.00,25000.00,968.63,23031.37,0.43,1
21247,2386,1000.00,25000.00,26000.00,0.00,3105.05,0.11,1
21248,2386,1000.00,26000.00,27000.00,0.00,14973.75,0.33,1
21249,2386,1000.00,27000.00,28000.00,5146.25,21853.75,0.40,1
21250,2386,1000.00,28000.00,29000.00,7221.39,20778.61,0.35,1
21251,2386,-1000.00,27000.00,28000.00,22148.00,6852.00,0.04,0
21252,2386,1000.00,28000.00,29000.00,0.00,28000.00,0.29,1
21253,2386,1000.00,29000.00,30000.00,0.00,27803.11,0.18,1
21254,2386,1000.00,30000.00,31000.00,0.00,30000.00,0.17,1
21255,2386,1000.00,31000.00,32000.00,0.00,29863.52,0.41,1
21256,2386,1000.00,32000.00,33000.00,2574.58,29425.42,0.14,1
21257,2386,1000.00,33000.00,34000.00,11551.34,21448.66,0.32,1
21258,2386,1000.00,34000.00,35000.00,0.00,3416.16,0.14,1
21259,2386,-1000.00,33000.00,34000.00,13817.62,12650.47,0.20,0
21260,2386,1000.00,34000.00,35000.00,2624.88,6097.05,0.17,1
21261,2386,-1000.00,33000.00,34000.00,26300.33,8699.67,0.04,0
21262,2386,1000.00,34000.00,35000.00,12342.56,21657.44,0.34,1
21263,2387,-1000.00,-1000.00,0.00,447.60,552.40,0.09,0
21264,2387,-0.00,-1000.00,0.00,0.00,0.00,0.10,0
21265,2388,-616.12,-616.12,383.88,0.00,616.12,0.04,0
21266,2388,-383.88,-1000.00,0.00,0.00,383.88,0.21,0
21267,2389,-1000.00,-1000.00,0.00,0.00,867.32,0.15,0
21268,2390,-566.55,-566.55,433.45,69.59,496.96,0.41,0
21269,2390,1000.00,433.45,1433.45,279.94,107.79,0.19,1
21270,2390,-1000.00,-566.55,433.45,0.00,1034.27,0.39,0
21271,2390,-74.04,-640.60,359.40,0.00,74.04,0.10,0
21272,2390,-359.40,-1000.00,0.00,0.00,359.40,0.34,0
21273,2391,-1000.00,-1000.00,0.00,500.00,500.00,0.00,0
21274,2392,-1000.00,-1000.00,0.00,457.08,0.00,0.05,0
21275,2393,-1000.00,-1000.00,0.00,0.00,512.68,0.31,0
21276,2394,-1000.00,-1000.00,0.00,613.16,386.84,0.04,0
21277,2395,-1000.00,-1000.00,0.00,0.00,1000.00,0.32,0
21278,2396,-1000.00,-1000.00,0.00,202.08,797.92,0.16,0
21279,2397,-1000.00,-1000.00,0.00,0.00,1000.00,0.24,0
21280,2398,1000.00,1000.00,2000.00,0.00,578.62,0.35,1
21281,2398,1000.00,2000.00,3000.00,631.20,1368.80,0.24,1
21282,2398,1000.00,3000.00,4000.00,436.34,2563.66,0.33,1
21283,2398,1000.00,4000.00,5000.00,918.07,3081.93,0.36,1
21284,2398,1000.00,5000.00,6000.00,0.00,4151.81,0.24,1
21285,2398,1000.00,6000.00,7000.00,1988.38,4011.62,0.11,1
21286,2398,1000.00,7000.00,8000.00,0.00,2193.30,0.16,1
21287,2398,1000.00,8000.00,9000.00,3645.15,4354.85,0.25,1
21288,2398,-1000.00,7000.00,8000.00,6748.68,2251.32,0.08,0
21289,2398,1000.00,8000.00,9000.00,2547.83,3749.59,0.17,1
21290,2398,1000.00,9000.00,10000.00,4002.35,4997.65,0.07,1
21291,2398,1000.00,10000.00,11000.00,0.00,4516.27,0.16,1
21292,2398,1000.00,11000.00,12000.00,0.00,11000.00,0.21,1
21293,2398,-1000.00,10000.00,11000.00,6581.43,5418.57,0.09,0
21294,2398,1000.00,11000.00,12000.00,1346.60,9653.40,0.08,1
21295,2398,-1000.00,10000.00,11000.00,6548.91,0.00,0.01,0
21296,2398,-1000.00,9000.00,10000.00,5569.99,5430.01,0.20,0
21297,2398,1000.00,10000.00,11000.00,0.00,7596.80,0.41,1
21298,2398,1000.00,11000.00,12000.00,0.00,9888.86,0.39,1
21299,2398,1000.00,12000.00,13000.00,2709.03,9290.97,0.09,1
21300,2398,1000.00,13000.00,14000.00,0.00,13000.00,0.08,1
21301,2398,1000.00,14000.00,15000.00,7000.00,7000.00,0.04,1
21302,2398,1000.00,15000.00,16000.00,4061.20,8317.06,0.30,1
21303,2398,1000.00,16000.00,17000.00,0.00,16000.00,0.06,1
21304,2398,-1000.00,15000.00,16000.00,14578.36,2421.64,0.10,0
21305,2398,1000.00,16000.00,17000.00,7453.87,8546.13,0.22,1
21306,2398,1000.00,17000.00,18000.00,7067.14,9932.86,0.21,1
21307,2398,-1000.00,16000.00,17000.00,18000.00,0.00,0.00,0
21308,2398,-1000.00,15000.00,16000.00,8732.46,8267.54,0.20,0
21309,2398,1000.00,16000.00,17000.00,0.00,16000.00,0.12,1
21310,2398,1000.00,17000.00,18000.00,0.00,5916.87,0.19,1
21311,2398,1000.00,18000.00,19000.00,0.00,18000.00,0.22,1
21312,2398,1000.00,19000.00,20000.00,0.00,5252.02,0.14,1
21313,2398,1000.00,20000.00,21000.00,7305.61,12694.39,0.27,1
21314,2398,1000.00,21000.00,22000.00,3948.71,17051.29,0.01,1
21315,2398,1000.00,22000.00,23000.00,0.00,22000.00,0.44,1
21316,2398,1000.00,23000.00,24000.00,4882.97,18117.03,0.34,1
21317,2398,1000.00,24000.00,25000.00,8556.51,15443.49,0.29,1
21318,2398,1000.00,25000.00,26000.00,0.00,25000.00,0.35,1
21319,2398,1000.00,26000.00,27000.00,5325.41,20674.59,0.38,1
21320,2398,1000.00,27000.00,28000.00,0.00,18390.89,0.38,1
21321,2398,1000.00,28000.00,29000.00,0.00,28000.00,0.06,1
21322,2398,1000.00,29000.00,30000.00,11186.58,17813.42,0.36,1
21323,2398,1000.00,30000.00,31000.00,0.00,22831.67,0.11,1
21324,2398,1000.00,31000.00,32000.00,0.00,31000.00,0.24,1
21325,2398,-1000.00,30000.00,31000.00,20251.97,11281.12,0.14,0
21326,2398,1000.00,31000.00,32000.00,0.00,31000.00,0.33,1
21327,2398,1000.00,32000.00,33000.00,4048.39,4729.83,0.16,1
21328,2398,-1000.00,31000.00,32000.00,5008.16,2606.18,0.13,0
21329,2398,-1000.00,30000.00,31000.00,10477.82,21522.18,0.17,0
21330,2398,-1000.00,29000.00,30000.00,0.00,15604.26,0.16,0
21331,2398,-1000.00,28000.00,29000.00,9367.76,8281.31,0.19,0
21332,2398,-1000.00,27000.00,28000.00,562.07,28437.93,0.10,0
21333,2398,-1000.00,26000.00,27000.00,0.00,28000.00,0.20,0
21334,2398,-1000.00,25000.00,26000.00,0.00,14442.20,0.22,0
21335,2398,-1000.00,24000.00,25000.00,5264.55,20735.45,0.41,0
21336,2398,-1000.00,23000.00,24000.00,10499.09,14500.91,0.22,0
21337,2398,-1000.00,22000.00,23000.00,0.00,24000.00,0.23,0
21338,2398,-1000.00,21000.00,22000.00,0.00,23000.00,0.13,0
21339,2398,-1000.00,20000.00,21000.00,2112.80,19887.20,0.22,0
21340,2398,-1000.00,19000.00,20000.00,10504.39,10495.61,0.25,0
21341,2398,-1000.00,18000.00,19000.00,0.00,18870.47,0.42,0
21342,2398,-1000.00,17000.00,18000.00,7153.71,7623.35,0.22,0
21343,2398,-1000.00,16000.00,17000.00,6784.45,6666.46,0.21,0
21344,2398,-1000.00,15000.00,16000.00,0.00,17000.00,0.21,0
21345,2398,-1000.00,14000.00,15000.00,4524.83,11475.17,0.20,0
21346,2398,-1000.00,13000.00,14000.00,5976.62,9023.38,0.09,0
21347,2398,-1000.00,12000.00,13000.00,519.25,12762.18,0.44,0
21348,2398,-1000.00,11000.00,12000.00,0.00,11595.66,0.43,0
21349,2398,-1000.00,10000.00,11000.00,6000.00,6000.00,0.00,0
21350,2398,-1000.00,9000.00,10000.00,7172.15,0.00,0.04,0
21351,2399,-1000.00,-1000.00,0.00,270.84,729.16,0.27,0
21352,2400,-1000.00,-1000.00,0.00,666.21,333.79,0.10,0
21353,2401,0.00,0.00,1000.00,0.00,0.00,0.05,0
21354,2401,-1000.00,-1000.00,0.00,0.00,722.09,0.03,0
21355,2402,-1000.00,-1000.00,0.00,0.00,1000.00,0.43,0
21356,2403,1000.00,1000.00,2000.00,38.60,961.40,0.03,1
21357,2403,1000.00,2000.00,3000.00,711.76,1183.88,0.29,1
21358,2403,1000.00,3000.00,4000.00,1420.92,1579.08,0.00,1
21359,2403,1000.00,4000.00,5000.00,0.00,73.02,0.08,1
21360,2403,1000.00,5000.00,6000.00,2500.00,2500.00,0.05,1
21361,2403,-1000.00,4000.00,5000.00,4060.01,1939.99,0.07,0
21362,2403,1000.00,5000.00,6000.00,838.60,4161.40,0.17,1
21363,2403,1000.00,6000.00,7000.00,750.80,4498.06,0.40,1
21364,2403,1000.00,7000.00,8000.00,0.00,5080.90,0.20,1
21365,2403,1000.00,8000.00,9000.00,318.11,7681.89,0.12,1
21366,2403,1000.00,9000.00,10000.00,0.00,9000.00,0.36,1
21367,2403,1000.00,10000.00,11000.00,0.00,10000.00,0.07,1
21368,2403,1000.00,11000.00,12000.00,2341.16,8658.84,0.40,1
21369,2403,1000.00,12000.00,13000.00,0.00,8249.41,0.17,1
21370,2403,1000.00,13000.00,14000.00,0.00,13000.00,0.21,1
21371,2403,1000.00,14000.00,15000.00,0.00,14000.00,0.24,1
21372,2403,-1000.00,13000.00,14000.00,9066.67,5933.33,0.08,0
21373,2403,-1000.00,12000.00,13000.00,12424.46,0.00,0.02,0
21374,2403,1000.00,13000.00,14000.00,0.00,8054.59,0.35,1
21375,2403,1000.00,14000.00,15000.00,1925.06,12074.94,0.24,1
21376,2403,1000.00,15000.00,16000.00,7500.00,7500.00,0.06,1
21377,2403,1000.00,16000.00,17000.00,0.00,1000.65,0.01,1
21378,2403,1000.00,17000.00,18000.00,0.00,17000.00,0.43,1
21379,2403,1000.00,18000.00,19000.00,8915.00,9085.00,0.10,1
21380,2403,1000.00,19000.00,20000.00,0.00,19000.00,0.35,1
21381,2403,1000.00,20000.00,21000.00,0.00,13343.14,0.36,1
21382,2403,-1000.00,19000.00,20000.00,4150.76,2757.54,0.15,0
21383,2403,-1000.00,18000.00,19000.00,0.00,12247.89,0.23,0
21384,2403,-1000.00,17000.00,18000.00,4251.85,0.00,0.14,0
21385,2403,-1000.00,16000.00,17000.00,4797.64,0.00,0.22,0
21386,2403,-1000.00,15000.00,16000.00,10182.53,3266.59,0.26,0
21387,2403,-1000.00,14000.00,15000.00,16000.00,0.00,0.08,0
21388,2403,-1000.00,13000.00,14000.00,12174.37,2825.63,0.17,0
21389,2403,-1000.00,12000.00,13000.00,0.00,14000.00,0.32,0
21390,2403,-1000.00,11000.00,12000.00,0.00,5234.69,0.26,0
21391,2403,-1000.00,10000.00,11000.00,1095.31,10904.69,0.38,0
21392,2403,-1000.00,9000.00,10000.00,0.00,11000.00,0.27,0
21393,2403,-1000.00,8000.00,9000.00,0.00,7070.75,0.39,0
21394,2403,-1000.00,7000.00,8000.00,0.00,8869.15,0.24,0
21395,2403,-1000.00,6000.00,7000.00,0.00,8000.00,0.11,0
21396,2403,-1000.00,5000.00,6000.00,6071.82,0.00,0.00,0
21397,2403,-1000.00,4000.00,5000.00,2964.65,3035.35,0.11,0
21398,2403,-1000.00,3000.00,4000.00,0.00,3512.66,0.12,0
21399,2403,-1000.00,2000.00,3000.00,1213.93,0.00,0.05,0
21400,2403,-1000.00,1000.00,2000.00,136.34,2863.66,0.23,0
21401,2404,1000.00,1000.00,2000.00,0.00,668.90,0.38,1
21402,2404,1000.00,2000.00,3000.00,0.00,2000.00,0.05,1
21403,2404,0.00,2000.00,3000.00,0.00,0.00,0.08,0
21404,2404,1000.00,3000.00,4000.00,0.00,2913.61,0.44,1
21405,2404,1000.00,4000.00,5000.00,0.00,1534.08,0.09,1
21406,2404,-1000.00,3000.00,4000.00,2683.81,1495.09,0.15,0
21407,2404,-1000.00,2000.00,3000.00,0.00,3934.35,0.39,0
21408,2404,-1000.00,1000.00,2000.00,0.00,1991.60,0.37,0
21409,2404,-1000.00,0.00,1000.00,0.00,2000.00,0.08,0
21410,2404,-1000.00,-1000.00,0.00,0.00,1000.00,0.03,0
21411,2405,-1000.00,-1000.00,0.00,78.17,462.83,0.33,0
21412,2406,-1000.00,-1000.00,0.00,360.89,639.11,0.31,0
21413,2407,1000.00,1000.00,2000.00,96.99,903.01,0.38,1
21414,2407,1000.00,2000.00,3000.00,0.00,1606.63,0.29,1
21415,2407,-1000.00,1000.00,2000.00,2689.41,310.59,0.04,0
21416,2407,1000.00,2000.00,3000.00,245.85,1754.15,0.32,1
21417,2407,1000.00,3000.00,4000.00,0.00,3000.00,0.03,1
21418,2407,1000.00,4000.00,5000.00,0.00,4000.00,0.09,1
21419,2407,1000.00,5000.00,6000.00,1096.00,3904.00,0.36,1
21420,2407,1000.00,6000.00,7000.00,0.00,1693.63,0.03,1
21421,2407,-1000.00,5000.00,6000.00,3348.73,2767.63,0.19,0
21422,2407,1000.00,6000.00,7000.00,2937.26,3062.74,0.31,1
21423,2407,1000.00,7000.00,8000.00,0.00,4455.57,0.17,1
21424,2407,1000.00,8000.00,9000.00,3365.41,4634.59,0.17,1
21425,2407,-1000.00,7000.00,8000.00,4622.38,1536.34,0.12,0
21426,2407,-1000.00,6000.00,7000.00,1870.08,0.00,0.10,0
21427,2407,1000.00,7000.00,8000.00,1994.67,2924.85,0.26,1
21428,2407,1000.00,8000.00,9000.00,0.00,6605.06,0.28,1
21429,2407,-1000.00,7000.00,8000.00,6022.86,2977.14,0.15,0
21430,2407,1000.00,8000.00,9000.00,3044.43,4955.57,0.26,1
21431,2407,-1000.00,7000.00,8000.00,7441.19,0.00,0.00,0
21432,2407,-1000.00,6000.00,7000.00,4000.00,4000.00,0.31,0
21433,2407,-1000.00,5000.00,6000.00,0.00,7000.00,0.05,0
21434,2407,-1000.00,4000.00,5000.00,2865.44,3134.56,0.23,0
21435,2407,-1000.00,3000.00,4000.00,1062.43,3937.57,0.38,0
21436,2407,-1000.00,2000.00,3000.00,1691.56,2308.44,0.40,0
21437,2407,-1000.00,1000.00,2000.00,0.00,3000.00,0.25,0
21438,2407,-1000.00,0.00,1000.00,0.00,2000.00,0.39,0
21439,2407,-882.90,-882.90,117.10,0.00,882.90,0.05,0
21440,2407,-79.65,-962.55,37.45,0.00,79.65,0.36,0
21441,2407,-1000.00,-1962.55,-962.55,9.44,9.38,0.19,0
21442,2408,-614.35,-614.35,385.65,0.00,614.35,0.21,0
21443,2408,-385.65,-1000.00,0.00,0.00,385.65,0.00,0
21444,2409,-1000.00,-1000.00,0.00,0.00,1000.00,0.27,0
21445,2410,-1000.00,-1000.00,0.00,116.01,0.00,0.10,0
21446,2411,-1000.00,-1000.00,0.00,166.33,833.67,0.09,0
21447,2412,-750.73,-750.73,249.27,604.87,145.86,0.10,0
21448,2412,0.00,-750.73,249.27,0.00,0.00,0.03,0
21449,2412,-1000.00,-1750.73,-750.73,0.00,128.52,0.30,0
21450,2413,-1000.00,-1000.00,0.00,0.00,294.01,0.10,0
21451,2414,1000.00,1000.00,2000.00,0.00,1000.00,0.09,1
21452,2414,1000.00,2000.00,3000.00,579.47,1420.53,0.19,1
21453,2414,1000.00,3000.00,4000.00,0.00,2180.95,0.39,1
21454,2414,1000.00,4000.00,5000.00,668.90,3328.31,0.41,1
21455,2414,1000.00,5000.00,6000.00,2492.58,2507.42,0.06,1
21456,2414,1000.00,6000.00,7000.00,0.00,4704.08,0.36,1
21457,2414,1000.00,7000.00,8000.00,3500.00,3500.00,0.05,1
21458,2414,1000.00,8000.00,9000.00,0.00,8000.00,0.26,1
21459,2414,-1000.00,7000.00,8000.00,1731.39,1299.38,0.16,0
21460,2414,1000.00,8000.00,9000.00,2905.65,5094.35,0.31,1
21461,2414,1000.00,9000.00,10000.00,0.00,5190.37,0.31,1
21462,2414,-1000.00,8000.00,9000.00,7772.37,2227.63,0.15,0
21463,2414,1000.00,9000.00,10000.00,3783.18,5216.82,0.29,1
21464,2414,-1000.00,8000.00,9000.00,2683.65,2183.79,0.17,0
21465,2414,-1000.00,7000.00,8000.00,5736.81,3263.19,0.29,0
21466,2414,-1000.00,6000.00,7000.00,4000.00,4000.00,0.09,0
21467,2414,-1000.00,5000.00,6000.00,0.00,4855.69,0.37,0
21468,2414,-1000.00,4000.00,5000.00,1634.49,1679.17,0.19,0
21469,2414,-1000.00,3000.00,4000.00,0.00,5000.00,0.41,0
21470,2414,-1000.00,2000.00,3000.00,859.15,3140.85,0.34,0
21471,2414,-1000.00,1000.00,2000.00,1448.30,1551.70,0.05,0
21472,2414,-1000.00,0.00,1000.00,57.98,1942.02,0.31,0
21473,2414,-1000.00,-1000.00,0.00,0.00,1000.00,0.01,0
21474,2415,-1000.00,-1000.00,0.00,0.00,1000.00,0.19,0
21475,2416,-1000.00,-1000.00,0.00,663.82,336.18,0.08,0
21476,2417,1000.00,1000.00,2000.00,0.00,634.66,0.37,1
21477,2417,1000.00,2000.00,3000.00,125.65,1042.21,0.32,1
21478,2417,1000.00,3000.00,4000.00,0.00,3000.00,0.15,1
21479,2417,1000.00,4000.00,5000.00,1843.32,2156.68,0.29,1
21480,2417,1000.00,5000.00,6000.00,0.00,5000.00,0.21,1
21481,2417,-1000.00,4000.00,5000.00,1555.01,835.16,0.08,0
21482,2417,1000.00,5000.00,6000.00,2325.14,2674.86,0.06,1
21483,2417,1000.00,6000.00,7000.00,0.00,6000.00,0.05,1
21484,2417,1000.00,7000.00,8000.00,2890.01,4109.99,0.11,1
21485,2417,1000.00,8000.00,9000.00,4000.00,4000.00,0.03,1
21486,2417,1000.00,9000.00,10000.00,0.00,6666.14,0.13,1
21487,2417,-1000.00,8000.00,9000.00,6494.86,3505.14,0.05,0
21488,2417,1000.00,9000.00,10000.00,2248.47,6751.53,0.22,1
21489,2417,1000.00,10000.00,11000.00,1117.28,8882.72,0.43,1
21490,2417,1000.00,11000.00,12000.00,0.00,5461.82,0.10,1
21491,2417,1000.00,12000.00,13000.00,2903.06,9096.94,0.39,1
21492,2417,1000.00,13000.00,14000.00,5463.81,7536.19,0.21,1
21493,2417,1000.00,14000.00,15000.00,0.00,10990.39,0.32,1
21494,2417,-1000.00,13000.00,14000.00,7908.78,7091.22,0.42,0
21495,2417,1000.00,14000.00,15000.00,3429.33,10570.67,0.30,1
21496,2417,-1000.00,13000.00,14000.00,6086.79,4440.48,0.18,0
21497,2417,1000.00,14000.00,15000.00,3613.27,5486.99,0.24,1
21498,2417,1000.00,15000.00,16000.00,4278.17,10721.83,0.19,1
21499,2417,-1000.00,14000.00,15000.00,8240.83,0.00,0.00,0
21500,2417,1000.00,15000.00,16000.00,3053.27,11946.73,0.40,1
21501,2417,1000.00,16000.00,17000.00,2629.24,13370.76,0.10,1
21502,2417,1000.00,17000.00,18000.00,4681.78,12318.22,0.33,1
21503,2417,1000.00,18000.00,19000.00,0.00,18000.00,0.03,1
21504,2417,1000.00,19000.00,20000.00,0.00,19000.00,0.11,1
21505,2417,1000.00,20000.00,21000.00,0.00,6485.14,0.20,1
21506,2417,1000.00,21000.00,22000.00,10500.00,10500.00,0.39,1
21507,2417,1000.00,22000.00,23000.00,0.00,9734.32,0.20,1
21508,2418,1000.00,1000.00,2000.00,0.00,479.61,0.28,1
21509,2418,1000.00,2000.00,3000.00,737.52,1262.48,0.27,1
21510,2418,1000.00,3000.00,4000.00,0.00,3000.00,0.07,1
21511,2418,1000.00,4000.00,5000.00,0.00,1283.49,0.10,1
21512,2418,1000.00,5000.00,6000.00,0.00,5000.00,0.07,1
21513,2418,1000.00,6000.00,7000.00,0.00,6000.00,0.25,1
21514,2418,1000.00,7000.00,8000.00,0.00,6792.66,0.32,1
21515,2418,-1000.00,6000.00,7000.00,8000.00,0.00,0.00,0
21516,2418,1000.00,7000.00,8000.00,1334.19,5665.81,0.41,1
21517,2418,1000.00,8000.00,9000.00,0.00,3093.35,0.25,1
21518,2418,1000.00,9000.00,10000.00,2832.64,5544.81,0.34,1
21519,2418,1000.00,10000.00,11000.00,1189.58,8810.42,0.28,1
21520,2418,1000.00,11000.00,12000.00,0.00,11000.00,0.06,1
21521,2418,1000.00,12000.00,13000.00,0.00,3359.33,0.14,1
21522,2418,-1000.00,11000.00,12000.00,7481.81,5518.19,0.14,0
21523,2418,1000.00,12000.00,13000.00,0.00,5821.79,0.31,1
21524,2418,1000.00,13000.00,14000.00,0.00,13000.00,0.05,1
21525,2418,1000.00,14000.00,15000.00,4871.77,9128.23,0.22,1
21526,2418,1000.00,15000.00,16000.00,6621.61,8378.39,0.20,1
21527,2418,1000.00,16000.00,17000.00,3695.22,12304.78,0.37,1
21528,2418,-1000.00,15000.00,16000.00,13505.71,0.00,0.03,0
21529,2418,1000.00,16000.00,17000.00,8000.00,8000.00,0.03,1
21530,2418,1000.00,17000.00,18000.00,8381.49,8618.51,0.09,1
21531,2418,1000.00,18000.00,19000.00,0.00,18000.00,0.16,1
21532,2418,-1000.00,17000.00,18000.00,0.00,7509.78,0.13,0
21533,2418,-1000.00,16000.00,17000.00,4988.08,13011.92,0.33,0
21534,2418,0.00,16000.00,17000.00,0.00,0.00,0.02,0
21535,2418,-1000.00,15000.00,16000.00,0.00,11057.36,0.22,0
21536,2418,-1000.00,14000.00,15000.00,8000.00,8000.00,0.03,0
21537,2418,-1000.00,13000.00,14000.00,0.00,15000.00,0.16,0
21538,2418,-1000.00,12000.00,13000.00,0.00,14000.00,0.02,0
21539,2418,-1000.00,11000.00,12000.00,0.00,13000.00,0.26,0
21540,2418,-1000.00,10000.00,11000.00,0.00,9822.63,0.15,0
21541,2418,-1000.00,9000.00,10000.00,7090.76,3909.24,0.10,0
21542,2418,-1000.00,8000.00,9000.00,2301.98,7698.02,0.21,0
21543,2418,-1000.00,7000.00,8000.00,0.00,3495.97,0.19,0
21544,2418,-1000.00,6000.00,7000.00,0.00,8000.00,0.00,0
21545,2418,-1000.00,5000.00,6000.00,1753.65,5246.35,0.36,0
21546,2418,-1000.00,4000.00,5000.00,1385.62,4614.38,0.24,0
21547,2418,-919.64,3080.36,4080.36,0.00,919.64,0.11,0
21548,2418,-1000.00,2080.36,3080.36,1447.02,2633.34,0.32,0
21549,2418,-158.44,1921.91,2921.91,0.00,158.44,0.37,0
21550,2418,1000.00,2921.91,3921.91,2142.09,779.83,0.08,1
21551,2419,-263.78,-263.78,736.22,263.78,0.00,0.17,0
21552,2419,-542.32,-806.10,193.90,542.32,0.00,0.09,0
21553,2419,-42.54,-848.64,151.36,42.54,0.00,0.34,0
21554,2419,-70.50,-919.14,80.86,70.50,0.00,0.07,0
21555,2419,-10.34,-929.48,70.52,10.34,0.00,0.44,0
21556,2419,-47.46,-976.94,23.06,47.46,0.00,0.35,0
21557,2419,-1000.00,-1976.94,-976.94,0.00,12.42,0.11,0
21558,2420,-1000.00,-1000.00,0.00,0.00,966.92,0.16,0
21559,2421,1000.00,1000.00,2000.00,123.23,876.77,0.39,1
21560,2421,1000.00,2000.00,3000.00,887.05,1112.95,0.19,1
21561,2421,1000.00,3000.00,4000.00,1051.81,1948.19,0.02,1
21562,2421,1000.00,4000.00,5000.00,0.00,2834.02,0.31,1
21563,2421,-1000.00,3000.00,4000.00,2812.80,2187.20,0.17,0
21564,2421,1000.00,4000.00,5000.00,748.83,2600.58,0.20,1
21565,2421,1000.00,5000.00,6000.00,1220.99,3779.01,0.40,1
21566,2421,1000.00,6000.00,7000.00,1280.80,4719.20,0.39,1
21567,2421,1000.00,7000.00,8000.00,0.00,2758.00,0.17,1
21568,2421,-1000.00,6000.00,7000.00,5742.29,1407.28,0.12,0
21569,2421,1000.00,7000.00,8000.00,724.64,1017.85,0.16,1
21570,2421,1000.00,8000.00,9000.00,1661.84,4532.24,0.32,1
21571,2421,-1000.00,7000.00,8000.00,4098.45,0.00,0.10,0
21572,2421,1000.00,8000.00,9000.00,608.50,7391.50,0.32,1
21573,2421,1000.00,9000.00,10000.00,0.00,9000.00,0.41,1
21574,2421,1000.00,10000.00,11000.00,4437.86,5562.14,0.26,1
21575,2421,1000.00,11000.00,12000.00,4030.12,6969.88,0.31,1
21576,2421,-1000.00,10000.00,11000.00,6574.58,5425.42,0.40,0
21577,2421,-1000.00,9000.00,10000.00,7647.33,3352.67,0.02,0
21578,2421,1000.00,10000.00,11000.00,4957.54,5042.46,0.30,1
21579,2421,-1000.00,9000.00,10000.00,7219.87,3780.13,0.22,0
21580,2421,-1000.00,8000.00,9000.00,0.00,8263.52,0.39,0
21581,2421,-1000.00,7000.00,8000.00,0.00,6040.94,0.37,0
21582,2421,-1000.00,6000.00,7000.00,3849.04,4150.96,0.05,0
21583,2421,-1000.00,5000.00,6000.00,883.96,0.00,0.06,0
21584,2421,-1000.00,4000.00,5000.00,0.00,6000.00,0.06,0
21585,2421,0.00,4000.00,5000.00,0.00,0.00,0.03,0
21586,2421,-1000.00,3000.00,4000.00,2265.80,2734.20,0.35,0
21587,2421,-1000.00,2000.00,3000.00,791.10,3208.90,0.40,0
21588,2421,-1000.00,1000.00,2000.00,0.00,1754.43,0.35,0
21589,2421,-1000.00,0.00,1000.00,0.00,1846.66,0.16,0
21590,2421,-1000.00,-1000.00,0.00,55.73,944.27,0.42,0
21591,2421,-0.00,-1000.00,0.00,0.00,0.00,0.25,0
21592,2422,-1000.00,-1000.00,0.00,163.55,836.45,0.23,0
21593,2423,1000.00,1000.00,2000.00,0.00,417.92,0.23,1
21594,2423,-1000.00,0.00,1000.00,1616.33,383.67,0.01,0
21595,2423,1000.00,1000.00,2000.00,95.37,478.96,0.30,1
21596,2423,1000.00,2000.00,3000.00,0.00,1031.02,0.32,1
21597,2423,-1000.00,1000.00,2000.00,1871.34,1128.66,0.04,0
21598,2423,-1000.00,0.00,1000.00,1546.20,453.80,0.03,0
21599,2423,1000.00,1000.00,2000.00,126.12,794.31,0.41,1
21600,2423,1000.00,2000.00,3000.00,0.00,2000.00,0.37,1
21601,2423,1000.00,3000.00,4000.00,298.77,831.55,0.21,1
21602,2423,1000.00,4000.00,5000.00,218.42,3781.58,0.22,1
21603,2423,1000.00,5000.00,6000.00,0.00,5000.00,0.42,1
21604,2423,-1000.00,4000.00,5000.00,2655.33,0.00,0.09,0
21605,2423,0.00,4000.00,5000.00,0.00,0.00,0.11,0
21606,2423,1000.00,5000.00,6000.00,284.40,3318.43,0.38,1
21607,2423,1000.00,6000.00,7000.00,1021.53,4978.47,0.24,1
21608,2423,-1000.00,5000.00,6000.00,4064.74,2935.26,0.06,0
21609,2423,1000.00,6000.00,7000.00,0.00,2699.38,0.29,1
21610,2423,1000.00,7000.00,8000.00,0.00,711.91,0.09,1
21611,2423,1000.00,8000.00,9000.00,0.00,8000.00,0.16,1
21612,2423,1000.00,9000.00,10000.00,1361.23,7638.77,0.42,1
21613,2423,-1000.00,8000.00,9000.00,6418.08,3581.92,0.08,0
21614,2423,1000.00,9000.00,10000.00,3648.91,5351.09,0.38,1
21615,2423,0.00,9000.00,10000.00,0.00,0.00,0.02,0
21616,2423,1000.00,10000.00,11000.00,2640.82,7359.18,0.38,1
21617,2423,1000.00,11000.00,12000.00,0.00,11000.00,0.25,1
21618,2423,1000.00,12000.00,13000.00,1287.93,10712.07,0.43,1
21619,2423,1000.00,13000.00,14000.00,2108.55,10891.45,0.39,1
21620,2423,1000.00,14000.00,15000.00,0.00,14000.00,0.14,1
21621,2423,1000.00,15000.00,16000.00,350.56,14649.44,0.14,1
21622,2423,1000.00,16000.00,17000.00,6003.51,9996.49,0.29,1
21623,2423,1000.00,17000.00,18000.00,0.00,17000.00,0.13,1
21624,2423,1000.00,18000.00,19000.00,7745.76,10254.24,0.06,1
21625,2423,1000.00,19000.00,20000.00,5484.21,13515.79,0.43,1
21626,2423,1000.00,20000.00,21000.00,0.00,20000.00,0.03,1
21627,2423,1000.00,21000.00,22000.00,1560.19,13114.53,0.36,1
21628,2423,1000.00,22000.00,23000.00,0.00,22000.00,0.14,1
21629,2423,1000.00,23000.00,24000.00,0.00,20714.40,0.31,1
21630,2423,1000.00,24000.00,25000.00,0.00,16189.30,0.37,1
21631,2423,1000.00,25000.00,26000.00,0.00,14650.86,0.22,1
21632,2423,1000.00,26000.00,27000.00,5218.55,20781.45,0.39,1
21633,2423,-1000.00,25000.00,26000.00,13814.88,13185.12,0.23,0
21634,2423,1000.00,26000.00,27000.00,4992.46,21007.54,0.35,1
21635,2423,0.00,26000.00,27000.00,0.00,0.00,0.02,0
21636,2424,0.00,0.00,1000.00,0.00,0.00,0.05,0
21637,2424,-730.07,-730.07,269.93,0.00,730.07,0.25,0
21638,2424,-195.95,-926.02,73.98,0.00,195.95,0.31,0
21639,2424,-73.98,-1000.00,0.00,26.80,47.18,0.34,0
21640,2425,-772.06,-772.06,227.94,772.06,0.00,0.19,0
21641,2425,-182.15,-954.21,45.79,182.15,0.00,0.01,0
21642,2425,0.00,-954.21,45.79,0.00,0.00,0.15,0
21643,2425,-1000.00,-1954.21,-954.21,1.39,12.93,0.40,0
21644,2426,-237.54,-237.54,762.46,0.00,237.54,0.02,0
21645,2426,-1000.00,-1237.54,-237.54,352.18,228.90,0.17,0
21646,2427,1000.00,1000.00,2000.00,136.23,834.06,0.41,1
21647,2427,1000.00,2000.00,3000.00,0.00,1541.87,0.41,1
21648,2427,1000.00,3000.00,4000.00,1500.00,1500.00,0.18,1
21649,2427,1000.00,4000.00,5000.00,1463.31,2536.69,0.21,1
21650,2427,1000.00,5000.00,6000.00,0.00,5000.00,0.39,1
21651,2427,1000.00,6000.00,7000.00,0.00,1702.69,0.19,1
21652,2427,1000.00,7000.00,8000.00,2521.57,4478.43,0.14,1
21653,2427,-1000.00,6000.00,7000.00,5213.15,2786.85,0.21,0
21654,2427,1000.00,7000.00,8000.00,2924.41,4075.59,0.28,1
21655,2427,1000.00,8000.00,9000.00,3056.97,4943.03,0.29,1
21656,2427,1000.00,9000.00,10000.00,3506.89,5493.11,0.13,1
21657,2427,1000.00,10000.00,11000.00,0.00,2980.96,0.19,1
21658,2427,1000.00,11000.00,12000.00,3602.66,7397.34,0.05,1
21659,2427,1000.00,12000.00,13000.00,3219.21,8780.79,0.15,1
21660,2427,1000.00,13000.00,14000.00,6500.00,6500.00,0.11,1
21661,2427,1000.00,14000.00,15000.00,0.00,14000.00,0.13,1
21662,2427,1000.00,15000.00,16000.00,0.00,15000.00,0.34,1
21663,2427,1000.00,16000.00,17000.00,6944.20,9055.80,0.38,1
21664,2427,1000.00,17000.00,18000.00,0.00,2229.02,0.15,1
21665,2427,1000.00,18000.00,19000.00,0.00,18000.00,0.35,1
21666,2427,1000.00,19000.00,20000.00,0.00,6983.80,0.05,1
21667,2427,-1000.00,18000.00,19000.00,16390.81,0.00,0.09,0
21668,2427,1000.00,19000.00,20000.00,2243.47,16756.53,0.18,1
21669,2427,-1000.00,18000.00,19000.00,6691.14,0.00,0.01,0
21670,2427,1000.00,19000.00,20000.00,9500.00,9500.00,0.10,1
21671,2427,1000.00,20000.00,21000.00,9290.41,10709.59,0.11,1
21672,2427,1000.00,21000.00,22000.00,0.00,21000.00,0.39,1
21673,2427,1000.00,22000.00,23000.00,0.00,22000.00,0.28,1
21674,2427,1000.00,23000.00,24000.00,0.00,23000.00,0.01,1
21675,2427,-1000.00,22000.00,23000.00,6902.33,0.00,0.06,0
21676,2427,1000.00,23000.00,24000.00,7993.56,14438.09,0.36,1
21677,2427,1000.00,24000.00,25000.00,0.00,24000.00,0.27,1
21678,2427,1000.00,25000.00,26000.00,7412.23,13272.83,0.29,1
21679,2427,1000.00,26000.00,27000.00,0.00,26000.00,0.04,1
21680,2427,1000.00,27000.00,28000.00,0.00,27000.00,0.02,1
21681,2427,1000.00,28000.00,29000.00,12329.07,15670.93,0.28,1
21682,2427,1000.00,29000.00,30000.00,2563.37,20670.00,0.39,1
21683,2427,1000.00,30000.00,31000.00,8869.93,21130.07,0.15,1
21684,2427,0.00,30000.00,31000.00,0.00,0.00,0.04,0
21685,2427,1000.00,31000.00,32000.00,0.00,31000.00,0.32,1
21686,2427,1000.00,32000.00,33000.00,3550.91,6488.29,0.18,1
21687,2427,0.00,32000.00,33000.00,0.00,0.00,0.02,0
21688,2427,1000.00,33000.00,34000.00,14647.58,18352.42,0.24,1
21689,2427,1000.00,34000.00,35000.00,14417.63,19582.37,0.36,1
21690,2427,1000.00,35000.00,36000.00,5215.77,29784.23,0.40,1
21691,2428,1000.00,1000.00,2000.00,0.00,51.31,0.08,1
21692,2428,1000.00,2000.00,3000.00,15.01,1984.99,0.44,1
21693,2428,1000.00,3000.00,4000.00,1254.39,1745.61,0.27,1
21694,2428,1000.00,4000.00,5000.00,378.42,1438.28,0.25,1
21695,2428,1000.00,5000.00,6000.00,0.00,33.75,0.04,1
21696,2428,1000.00,6000.00,7000.00,0.00,6000.00,0.20,1
21697,2428,1000.00,7000.00,8000.00,0.00,7000.00,0.35,1
21698,2428,1000.00,8000.00,9000.00,3618.10,4381.90,0.23,1
21699,2428,1000.00,9000.00,10000.00,0.00,9000.00,0.20,1
21700,2428,-1000.00,8000.00,9000.00,5932.17,4067.83,0.13,0
21701,2428,1000.00,9000.00,10000.00,119.98,8880.02,0.44,1
21702,2428,1000.00,10000.00,11000.00,0.00,10000.00,0.16,1
21703,2428,1000.00,11000.00,12000.00,0.00,11000.00,0.06,1
21704,2428,1000.00,12000.00,13000.00,0.00,5220.47,0.22,1
21705,2428,1000.00,13000.00,14000.00,5846.84,7153.16,0.23,1
21706,2428,1000.00,14000.00,15000.00,2864.42,11135.58,0.41,1
21707,2428,1000.00,15000.00,16000.00,0.00,15000.00,0.30,1
21708,2428,1000.00,16000.00,17000.00,0.00,16000.00,0.41,1
21709,2428,1000.00,17000.00,18000.00,5434.20,11565.80,0.27,1
21710,2428,0.00,17000.00,18000.00,0.00,0.00,0.04,0
21711,2428,1000.00,18000.00,19000.00,3843.48,14156.52,0.36,1
21712,2428,1000.00,19000.00,20000.00,0.00,19000.00,0.17,1
21713,2428,1000.00,20000.00,21000.00,5086.97,14913.03,0.19,1
21714,2428,1000.00,21000.00,22000.00,4023.11,16976.89,0.44,1
21715,2428,1000.00,22000.00,23000.00,4354.20,17602.60,0.42,1
21716,2428,1000.00,23000.00,24000.00,0.00,15109.48,0.20,1
21717,2428,1000.00,24000.00,25000.00,0.00,24000.00,0.17,1
21718,2428,1000.00,25000.00,26000.00,12500.00,12500.00,0.22,1
21719,2428,1000.00,26000.00,27000.00,0.00,26000.00,0.08,1
21720,2428,1000.00,27000.00,28000.00,2919.84,13082.99,0.30,1
21721,2428,1000.00,28000.00,29000.00,10378.05,17621.95,0.10,1
21722,2428,1000.00,29000.00,30000.00,0.00,16463.86,0.30,1
21723,2428,1000.00,30000.00,31000.00,0.00,30000.00,0.40,1
21724,2428,1000.00,31000.00,32000.00,13430.30,17569.70,0.21,1
21725,2428,1000.00,32000.00,33000.00,0.00,24458.15,0.17,1
21726,2428,1000.00,33000.00,34000.00,0.00,33000.00,0.13,1
21727,2428,1000.00,34000.00,35000.00,0.00,34000.00,0.24,1
21728,2428,1000.00,35000.00,36000.00,16952.56,18047.44,0.10,1
21729,2428,1000.00,36000.00,37000.00,5277.32,30722.68,0.33,1
21730,2428,-1000.00,35000.00,36000.00,18234.15,17350.15,0.21,0
21731,2428,-1000.00,34000.00,35000.00,21315.06,14684.94,0.02,0
21732,2428,1000.00,35000.00,36000.00,17500.00,17500.00,0.08,1
21733,2428,1000.00,36000.00,37000.00,0.00,36000.00,0.22,1
21734,2428,1000.00,37000.00,38000.00,0.00,33788.95,0.09,1
21735,2428,1000.00,38000.00,39000.00,0.00,38000.00,0.40,1
21736,2428,1000.00,39000.00,40000.00,5942.03,33057.97,0.25,1
21737,2428,1000.00,40000.00,41000.00,233.53,39766.47,0.43,1
21738,2428,-1000.00,39000.00,40000.00,19049.39,21950.61,0.27,0
21739,2428,-1000.00,38000.00,39000.00,0.00,40000.00,0.03,0
21740,2428,-1000.00,37000.00,38000.00,0.00,22807.04,0.08,0
21741,2428,-1000.00,36000.00,37000.00,6556.05,30834.54,0.40,0
21742,2428,-1000.00,35000.00,36000.00,19019.18,17980.82,0.25,0
21743,2428,-1000.00,34000.00,35000.00,0.00,36000.00,0.02,0
21744,2428,-1000.00,33000.00,34000.00,3319.86,31680.14,0.43,0
21745,2428,-1000.00,32000.00,33000.00,6233.56,0.00,0.06,0
21746,2428,-1000.00,31000.00,32000.00,19660.90,13339.10,0.15,0
21747,2428,-1000.00,30000.00,31000.00,15474.72,16525.28,0.02,0
21748,2428,-1000.00,29000.00,30000.00,6885.24,24114.76,0.21,0
21749,2428,-1000.00,28000.00,29000.00,14717.03,15282.97,0.10,0
21750,2428,-1000.00,27000.00,28000.00,0.00,29000.00,0.13,0
21751,2428,-1000.00,26000.00,27000.00,7525.73,9173.91,0.21,0
21752,2428,-1000.00,25000.00,26000.00,8209.38,18790.62,0.35,0
21753,2428,-1000.00,24000.00,25000.00,13000.00,13000.00,0.04,0
21754,2428,-1000.00,23000.00,24000.00,4640.76,20359.24,0.35,0
21755,2428,-1000.00,22000.00,23000.00,8576.92,15423.08,0.29,0
21756,2428,-1000.00,21000.00,22000.00,4214.65,4783.69,0.18,0
21757,2428,-1000.00,20000.00,21000.00,446.53,21553.47,0.42,0
21758,2428,-1000.00,19000.00,20000.00,0.00,21000.00,0.32,0
21759,2429,1000.00,1000.00,2000.00,384.53,615.47,0.11,1
21760,2429,1000.00,2000.00,3000.00,0.00,1607.64,0.40,1
21761,2429,1000.00,3000.00,4000.00,0.00,813.19,0.05,1
21762,2429,1000.00,4000.00,5000.00,0.00,3362.21,0.25,1
21763,2429,1000.00,5000.00,6000.00,0.00,4733.93,0.43,1
21764,2429,1000.00,6000.00,7000.00,0.00,4477.88,0.22,1
21765,2429,1000.00,7000.00,8000.00,3121.92,3878.08,0.32,1
21766,2429,0.00,7000.00,8000.00,0.00,0.00,0.07,0
21767,2429,1000.00,8000.00,9000.00,0.00,321.81,0.11,1
21768,2429,1000.00,9000.00,10000.00,0.00,2713.65,0.22,1
21769,2429,-1000.00,8000.00,9000.00,5696.59,4303.41,0.13,0
21770,2429,1000.00,9000.00,10000.00,0.00,9000.00,0.14,1
21771,2429,1000.00,10000.00,11000.00,0.00,10000.00,0.11,1
21772,2429,1000.00,11000.00,12000.00,0.00,11000.00,0.02,1
21773,2429,1000.00,12000.00,13000.00,2728.02,9271.98,0.40,1
21774,2429,1000.00,13000.00,14000.00,1013.19,6250.57,0.30,1
21775,2429,-1000.00,12000.00,13000.00,10263.95,3543.18,0.10,0
21776,2429,1000.00,13000.00,14000.00,4301.87,8698.13,0.28,1
21777,2429,1000.00,14000.00,15000.00,1696.64,12303.36,0.44,1
21778,2429,-1000.00,13000.00,14000.00,0.00,4213.91,0.03,0
21779,2429,-1000.00,12000.00,13000.00,0.00,14000.00,0.17,0
21780,2429,-1000.00,11000.00,12000.00,0.00,13000.00,0.14,0
21781,2429,-1000.00,10000.00,11000.00,5067.42,6932.58,0.19,0
21782,2429,-1000.00,9000.00,10000.00,0.00,11000.00,0.03,0
21783,2429,-1000.00,8000.00,9000.00,0.00,10000.00,0.37,0
21784,2429,-1000.00,7000.00,8000.00,0.00,9000.00,0.26,0
21785,2429,-1000.00,6000.00,7000.00,2482.18,5517.82,0.26,0
21786,2429,-1000.00,5000.00,6000.00,3133.11,3866.89,0.22,0
21787,2429,-1000.00,4000.00,5000.00,0.00,6000.00,0.24,0
21788,2429,-1000.00,3000.00,4000.00,0.00,5000.00,0.18,0
21789,2429,-1000.00,2000.00,3000.00,0.00,4000.00,0.42,0
21790,2429,-1000.00,1000.00,2000.00,658.88,2341.12,0.41,0
21791,2429,-1000.00,0.00,1000.00,0.00,1874.54,0.44,0
21792,2429,-1000.00,-1000.00,0.00,0.00,1000.00,0.27,0
21793,2430,1000.00,1000.00,2000.00,478.32,521.68,0.17,1
21794,2430,1000.00,2000.00,3000.00,0.00,1078.38,0.32,1
21795,2430,1000.00,3000.00,4000.00,1284.70,1715.30,0.08,1
21796,2430,1000.00,4000.00,5000.00,2000.00,2000.00,0.03,1
21797,2430,1000.00,5000.00,6000.00,0.00,3821.00,0.22,1
21798,2430,1000.00,6000.00,7000.00,352.24,5647.76,0.37,1
21799,2430,1000.00,7000.00,8000.00,0.00,7000.00,0.24,1
21800,2430,1000.00,8000.00,9000.00,0.00,8000.00,0.26,1
21801,2430,-1000.00,7000.00,8000.00,2568.08,49.10,0.10,0
21802,2430,1000.00,8000.00,9000.00,0.00,4877.26,0.29,1
21803,2430,-1000.00,7000.00,8000.00,4848.13,4151.87,0.05,0
21804,2430,1000.00,8000.00,9000.00,0.00,8000.00,0.17,1
21805,2430,-1000.00,7000.00,8000.00,4699.48,4300.52,0.23,0
21806,2430,1000.00,8000.00,9000.00,0.00,8000.00,0.08,1
21807,2430,1000.00,9000.00,10000.00,0.00,9000.00,0.41,1
21808,2430,-1000.00,8000.00,9000.00,5030.36,4969.64,0.27,0
21809,2430,1000.00,9000.00,10000.00,0.00,9000.00,0.42,1
21810,2430,-1000.00,8000.00,9000.00,8277.91,1722.09,0.17,0
21811,2430,1000.00,9000.00,10000.00,3568.70,5431.30,0.15,1
21812,2430,1000.00,10000.00,11000.00,0.00,6563.60,0.27,1
21813,2430,1000.00,11000.00,12000.00,0.00,11000.00,0.19,1
21814,2430,1000.00,12000.00,13000.00,0.00,12000.00,0.38,1
21815,2430,-209.19,11790.81,12790.81,209.19,0.00,0.10,0
21816,2430,1000.00,12790.81,13790.81,0.00,11748.57,0.40,1
21817,2430,1000.00,13790.81,14790.81,0.00,13790.81,0.38,1
21818,2430,0.00,13790.81,14790.81,0.00,0.00,0.04,0
21819,2430,1000.00,14790.81,15790.81,1584.46,6876.04,0.30,1
21820,2430,1000.00,15790.81,16790.81,0.00,15790.81,0.04,1
21821,2430,1000.00,16790.81,17790.81,0.00,16790.81,0.21,1
21822,2430,1000.00,17790.81,18790.81,8895.41,8895.41,0.11,1
21823,2430,1000.00,18790.81,19790.81,5954.38,12836.44,0.25,1
21824,2430,-1000.00,17790.81,18790.81,14624.50,0.00,0.04,0
21825,2430,1000.00,18790.81,19790.81,0.00,18790.81,0.18,1
21826,2430,1000.00,19790.81,20790.81,5148.14,14642.67,0.38,1
21827,2430,1000.00,20790.81,21790.81,5087.60,15703.21,0.41,1
21828,2430,1000.00,21790.81,22790.81,0.00,21790.81,0.09,1
21829,2431,1000.00,1000.00,2000.00,101.53,898.47,0.24,1
21830,2431,1000.00,2000.00,3000.00,1000.00,1000.00,0.02,1
21831,2431,1000.00,3000.00,4000.00,0.00,2306.56,0.28,1
21832,2431,1000.00,4000.00,5000.00,749.10,2191.58,0.32,1
21833,2431,1000.00,5000.00,6000.00,898.54,3648.62,0.38,1
21834,2431,1000.00,6000.00,7000.00,0.00,3373.19,0.13,1
21835,2431,1000.00,7000.00,8000.00,2327.49,4672.51,0.38,1
21836,2431,1000.00,8000.00,9000.00,3444.77,4555.23,0.01,1
21837,2431,-1000.00,7000.00,8000.00,5252.94,3747.06,0.31,0
21838,2431,1000.00,8000.00,9000.00,0.00,8000.00,0.02,1
21839,2431,1000.00,9000.00,10000.00,0.00,9000.00,0.02,1
21840,2431,1000.00,10000.00,11000.00,1285.84,8014.64,0.41,1
21841,2431,1000.00,11000.00,12000.00,1284.86,5163.25,0.30,1
21842,2431,1000.00,12000.00,13000.00,0.00,9735.47,0.42,1
21843,2431,1000.00,13000.00,14000.00,0.00,13000.00,0.37,1
21844,2431,1000.00,14000.00,15000.00,0.00,14000.00,0.01,1
21845,2431,1000.00,15000.00,16000.00,0.00,15000.00,0.34,1
21846,2431,1000.00,16000.00,17000.00,0.00,16000.00,0.06,1
21847,2431,1000.00,17000.00,18000.00,0.00,17000.00,0.26,1
21848,2431,1000.00,18000.00,19000.00,0.00,16708.25,0.01,1
21849,2431,1000.00,19000.00,20000.00,0.00,19000.00,0.14,1
21850,2432,-1000.00,-1000.00,0.00,99.01,900.99,0.34,0
21851,2433,-1000.00,-1000.00,0.00,911.09,88.91,0.11,0
21852,2433,-0.00,-1000.00,0.00,0.00,0.00,0.36,0
21853,2433,-0.00,-1000.00,-0.00,0.00,0.00,0.22,0
21854,2434,-542.39,-542.39,457.61,0.00,542.39,0.33,0
21855,2434,-1000.00,-1542.39,-542.39,326.18,131.44,0.05,0
21856,2435,1000.00,1000.00,2000.00,0.00,1000.00,0.02,1
21857,2435,1000.00,2000.00,3000.00,784.21,1215.79,0.27,1
21858,2435,1000.00,3000.00,4000.00,1436.74,1563.26,0.19,1
21859,2435,-1000.00,2000.00,3000.00,2073.05,1524.90,0.18,0
21860,2435,1000.00,3000.00,4000.00,0.00,3000.00,0.04,1
21861,2435,1000.00,4000.00,5000.00,663.62,1696.73,0.27,1
21862,2435,1000.00,5000.00,6000.00,0.00,769.68,0.16,1
21863,2435,1000.00,6000.00,7000.00,2794.34,3205.66,0.04,1
21864,2435,1000.00,7000.00,8000.00,1774.22,5225.78,0.38,1
21865,2435,1000.00,8000.00,9000.00,4000.00,4000.00,0.11,1
21866,2435,-1000.00,7000.00,8000.00,7262.18,1737.82,0.02,0
21867,2435,1000.00,8000.00,9000.00,714.11,7285.89,0.21,1
21868,2435,1000.00,9000.00,10000.00,385.04,8614.96,0.09,1
21869,2435,1000.00,10000.00,11000.00,2121.36,7878.64,0.22,1
21870,2435,1000.00,11000.00,12000.00,3218.03,7781.97,0.09,1
21871,2435,1000.00,12000.00,13000.00,0.00,7572.08,0.37,1
21872,2435,1000.00,13000.00,14000.00,3475.08,9524.92,0.35,1
21873,2435,1000.00,14000.00,15000.00,4972.23,9027.77,0.17,1
21874,2435,1000.00,15000.00,16000.00,292.65,11636.08,0.41,1
21875,2435,1000.00,16000.00,17000.00,8000.00,8000.00,0.04,1
21876,2435,1000.00,17000.00,18000.00,7794.96,9205.04,0.30,1
21877,2435,-1000.00,16000.00,17000.00,18000.00,0.00,0.02,0
21878,2435,1000.00,17000.00,18000.00,0.00,17000.00,0.29,1
21879,2435,-1000.00,16000.00,17000.00,9602.39,8397.61,0.12,0
21880,2435,-1000.00,15000.00,16000.00,6085.84,10914.16,0.04,0
21881,2435,-1000.00,14000.00,15000.00,2709.10,13290.90,0.40,0
21882,2435,-1000.00,13000.00,14000.00,0.00,15000.00,0.11,0
21883,2435,-1000.00,12000.00,13000.00,0.00,14000.00,0.04,0
21884,2435,-1000.00,11000.00,12000.00,5521.65,7478.35,0.44,0
21885,2435,-1000.00,10000.00,11000.00,0.00,12000.00,0.25,0
21886,2435,-1000.00,9000.00,10000.00,5169.81,5830.19,0.12,0
21887,2435,-1000.00,8000.00,9000.00,0.00,6109.23,0.34,0
21888,2435,-1000.00,7000.00,8000.00,3145.29,5854.71,0.30,0
21889,2435,-1000.00,6000.00,7000.00,2396.04,5603.96,0.22,0
21890,2435,-1000.00,5000.00,6000.00,0.00,7000.00,0.06,0
21891,2435,-1000.00,4000.00,5000.00,2674.82,3325.18,0.22,0
21892,2435,-1000.00,3000.00,4000.00,0.00,2460.37,0.26,0
21893,2435,-1000.00,2000.00,3000.00,0.00,4000.00,0.29,0
21894,2435,-1000.00,1000.00,2000.00,656.08,2343.92,0.40,0
21895,2435,-1000.00,0.00,1000.00,0.00,1287.77,0.37,0
21896,2435,-416.82,-416.82,583.18,0.00,416.82,0.27,0
21897,2435,-583.18,-1000.00,0.00,291.59,291.59,0.03,0
21898,2436,-1000.00,-1000.00,0.00,468.04,531.96,0.15,0
21899,2437,-700.46,-700.46,299.54,0.00,700.46,0.33,0
21900,2437,-299.54,-1000.00,0.00,149.68,149.87,0.25,0
21901,2438,0.00,0.00,1000.00,0.00,0.00,0.08,0
21902,2438,-429.19,-429.19,570.81,429.19,0.00,0.04,0
21903,2438,-1000.00,-1429.19,-429.19,0.00,565.28,0.11,0
21904,2439,1000.00,1000.00,2000.00,598.31,215.45,0.26,1
21905,2439,0.00,1000.00,2000.00,0.00,0.00,0.15,0
21906,2439,1000.00,2000.00,3000.00,1002.80,133.97,0.31,1
21907,2439,-1000.00,1000.00,2000.00,0.00,2335.94,0.19,0
21908,2439,-963.43,36.57,1036.57,0.00,963.43,0.23,0
21909,2439,1000.00,1036.57,2036.57,522.24,514.33,0.16,1
21910,2439,1000.00,2036.57,3036.57,484.68,19.54,0.40,1
21911,2439,1000.00,3036.57,4036.57,3036.57,0.00,0.07,1
21912,2439,-1000.00,2036.57,3036.57,928.15,3108.41,0.18,0
21913,2439,0.00,2036.57,3036.57,0.00,0.00,0.24,0
21914,2439,1000.00,3036.57,4036.57,1795.63,1240.93,0.03,1
21915,2439,0.00,3036.57,4036.57,0.00,0.00,0.21,0
21916,2439,-1000.00,2036.57,3036.57,3161.93,0.00,0.19,0
21917,2439,-1000.00,1036.57,2036.57,0.00,1981.00,0.23,0
21918,2439,-1000.00,36.57,1036.57,926.22,1110.35,0.18,0
21919,2439,-1000.00,-963.43,36.57,0.00,1036.57,0.36,0
21920,2439,-36.57,-1000.00,0.00,0.00,36.57,0.23,0
21921,2440,-273.97,-273.97,726.03,195.08,78.88,0.13,0
21922,2440,0.00,-273.97,726.03,0.00,0.00,0.08,0
21923,2440,-726.03,-1000.00,0.00,506.82,219.21,0.08,0
21924,2441,-219.40,-219.40,780.60,0.00,219.40,0.42,0
21925,2441,-780.60,-1000.00,0.00,0.00,780.60,0.12,0
21926,2442,1000.00,1000.00,2000.00,500.00,500.00,0.08,1
21927,2442,1000.00,2000.00,3000.00,772.37,1227.63,0.22,1
21928,2442,1000.00,3000.00,4000.00,139.80,2312.77,0.37,1
21929,2442,1000.00,4000.00,5000.00,0.00,3229.47,0.41,1
21930,2442,1000.00,5000.00,6000.00,0.00,5000.00,0.10,1
21931,2442,1000.00,6000.00,7000.00,0.00,1616.34,0.09,1
21932,2442,1000.00,7000.00,8000.00,0.00,6606.60,0.34,1
21933,2442,1000.00,8000.00,9000.00,1933.43,6066.57,0.41,1
21934,2442,1000.00,9000.00,10000.00,3036.26,5963.74,0.28,1
21935,2442,1000.00,10000.00,11000.00,4113.67,5886.33,0.23,1
21936,2442,1000.00,11000.00,12000.00,5416.95,5583.05,0.06,1
21937,2442,1000.00,12000.00,13000.00,1162.68,10837.32,0.41,1
21938,2442,-1000.00,11000.00,12000.00,7742.05,5257.95,0.36,0
21939,2442,1000.00,12000.00,13000.00,6000.00,6000.00,0.10,1
21940,2442,1000.00,13000.00,14000.00,0.00,11842.05,0.44,1
21941,2442,1000.00,14000.00,15000.00,3850.68,6087.86,0.26,1
21942,2442,1000.00,15000.00,16000.00,5041.57,8613.02,0.30,1
21943,2442,1000.00,16000.00,17000.00,0.00,7074.02,0.26,1
21944,2442,1000.00,17000.00,18000.00,5027.50,11972.50,0.10,1
21945,2442,1000.00,18000.00,19000.00,5461.67,12538.33,0.17,1
21946,2442,1000.00,19000.00,20000.00,0.00,19000.00,0.32,1
21947,2442,1000.00,20000.00,21000.00,5095.53,14904.47,0.38,1
21948,2442,-1000.00,19000.00,20000.00,21000.00,0.00,0.02,0
21949,2442,-1000.00,18000.00,19000.00,4347.11,15652.89,0.37,0
21950,2442,-1000.00,17000.00,18000.00,0.00,19000.00,0.20,0
21951,2442,-1000.00,16000.00,17000.00,9000.00,9000.00,0.01,0
21952,2442,-1000.00,15000.00,16000.00,530.41,0.00,0.08,0
21953,2442,-1000.00,14000.00,15000.00,0.00,16000.00,0.18,0
21954,2442,-1000.00,13000.00,14000.00,5627.10,9372.90,0.17,0
21955,2442,-1000.00,12000.00,13000.00,0.00,11082.90,0.14,0
21956,2442,-1000.00,11000.00,12000.00,10873.65,2126.35,0.04,0
21957,2442,-189.93,10810.07,11810.07,0.00,189.93,0.11,0
21958,2442,-1000.00,9810.07,10810.07,5905.03,5905.03,0.05,0
21959,2442,-1000.00,8810.07,9810.07,948.40,6791.64,0.24,0
21960,2442,-1000.00,7810.07,8810.07,0.00,9810.07,0.03,0
21961,2442,-1000.00,6810.07,7810.07,1431.99,7378.08,0.32,0
21962,2442,-1000.00,5810.07,6810.07,0.00,3280.73,0.28,0
21963,2442,-1000.00,4810.07,5810.07,0.00,5370.08,0.28,0
21964,2442,-1000.00,3810.07,4810.07,0.00,3365.43,0.25,0
21965,2442,-1000.00,2810.07,3810.07,1179.69,3630.38,0.05,0
21966,2442,-1000.00,1810.07,2810.07,0.00,3810.07,0.21,0
21967,2442,-1000.00,810.07,1810.07,0.00,2810.07,0.42,0
21968,2442,-1000.00,-189.93,810.07,0.00,1810.07,0.08,0
21969,2442,-810.07,-1000.00,0.00,252.80,557.26,0.22,0
21970,2443,-693.09,-693.09,306.91,0.00,693.09,0.33,0
21971,2443,-306.91,-1000.00,0.00,0.00,306.91,0.26,0
21972,2444,-1000.00,-1000.00,0.00,192.10,0.00,0.08,0
21973,2445,-1000.00,-1000.00,0.00,0.00,1000.00,0.32,0
21974,2446,1000.00,1000.00,2000.00,397.75,521.64,0.27,1
21975,2446,1000.00,2000.00,3000.00,0.00,2000.00,0.30,1
21976,2446,1000.00,3000.00,4000.00,0.00,1656.73,0.17,1
21977,2446,1000.00,4000.00,5000.00,833.48,3166.52,0.16,1
21978,2446,1000.00,5000.00,6000.00,2500.00,2500.00,0.02,1
21979,2446,1000.00,6000.00,7000.00,0.00,6000.00,0.09,1
21980,2446,1000.00,7000.00,8000.00,3500.00,3500.00,0.23,1
21981,2446,1000.00,8000.00,9000.00,2753.67,5246.33,0.22,1
21982,2446,1000.00,9000.00,10000.00,0.00,216.66,0.07,1
21983,2446,0.00,9000.00,10000.00,0.00,0.00,0.01,0
21984,2446,0.00,9000.00,10000.00,0.00,0.00,0.08,0
21985,2446,1000.00,10000.00,11000.00,0.00,6475.87,0.42,1
21986,2446,-1000.00,9000.00,10000.00,4179.63,3073.42,0.14,0
21987,2446,1000.00,10000.00,11000.00,0.00,3842.52,0.15,1
21988,2446,1000.00,11000.00,12000.00,0.00,3177.01,0.38,1
21989,2446,1000.00,12000.00,13000.00,0.00,2027.25,0.07,1
21990,2446,-1000.00,11000.00,12000.00,8569.04,4430.96,0.38,0
21991,2446,1000.00,12000.00,13000.00,6000.00,6000.00,0.08,1
21992,2446,1000.00,13000.00,14000.00,0.00,2887.91,0.10,1
21993,2446,1000.00,14000.00,15000.00,0.00,14000.00,0.17,1
21994,2446,1000.00,15000.00,16000.00,2930.15,12069.85,0.17,1
21995,2446,0.00,15000.00,16000.00,0.00,0.00,0.01,0
21996,2446,1000.00,16000.00,17000.00,79.21,11313.72,0.43,1
21997,2446,1000.00,17000.00,18000.00,0.00,17000.00,0.12,1
21998,2446,-1000.00,16000.00,17000.00,15853.27,2146.73,0.12,0
21999,2446,1000.00,17000.00,18000.00,0.00,17000.00,0.18,1
22000,2446,1000.00,18000.00,19000.00,6665.12,11334.88,0.24,1
22001,2446,-1000.00,17000.00,18000.00,11945.34,7054.66,0.10,0
22002,2446,1000.00,18000.00,19000.00,6678.57,11321.43,0.06,1
22003,2446,1000.00,19000.00,20000.00,0.00,6299.76,0.20,1
22004,2446,1000.00,20000.00,21000.00,8535.63,11464.37,0.26,1
22005,2446,1000.00,21000.00,22000.00,2782.16,9961.63,0.30,1
22006,2446,-1000.00,20000.00,21000.00,11833.01,10166.99,0.09,0
22007,2446,1000.00,21000.00,22000.00,0.00,20404.23,0.07,1
22008,2446,0.00,21000.00,22000.00,0.00,0.00,0.04,0
22009,2446,1000.00,22000.00,23000.00,0.00,13288.28,0.29,1
22010,2446,1000.00,23000.00,24000.00,3902.61,19097.39,0.11,1
22011,2446,1000.00,24000.00,25000.00,0.00,24000.00,0.06,1
22012,2446,1000.00,25000.00,26000.00,10172.18,14827.82,0.20,1
22013,2446,1000.00,26000.00,27000.00,7917.04,18082.96,0.27,1
22014,2446,1000.00,27000.00,28000.00,9633.17,17366.83,0.17,1
22015,2446,1000.00,28000.00,29000.00,10593.20,17406.80,0.26,1
22016,2446,1000.00,29000.00,30000.00,12897.90,16102.10,0.17,1
22017,2447,-1000.00,-1000.00,0.00,0.00,1000.00,0.06,0
22018,2448,-946.56,-946.56,53.44,274.54,672.02,0.34,0
22019,2448,-51.74,-998.30,1.70,13.53,38.21,0.36,0
22020,2448,-1.70,-1000.00,0.00,0.00,1.70,0.19,0
22021,2449,-1000.00,-1000.00,0.00,339.01,660.99,0.18,0
22022,2450,1000.00,1000.00,2000.00,294.12,622.67,0.32,1
22023,2450,1000.00,2000.00,3000.00,642.30,885.76,0.25,1
22024,2450,1000.00,3000.00,4000.00,1500.00,1500.00,0.03,1
22025,2450,1000.00,4000.00,5000.00,0.00,2597.76,0.33,1
22026,2450,1000.00,5000.00,6000.00,2465.44,2534.56,0.06,1
22027,2450,1000.00,6000.00,7000.00,0.00,5678.52,0.14,1
22028,2450,-973.63,5026.37,6026.37,973.63,0.00,0.02,0
22029,2450,1000.00,6026.37,7026.37,0.00,6026.37,0.24,1
22030,2450,1000.00,7026.37,8026.37,3513.18,3513.18,0.18,1
22031,2450,1000.00,8026.37,9026.37,0.00,8026.37,0.30,1
22032,2450,1000.00,9026.37,10026.37,0.00,2182.32,0.06,1
22033,2450,1000.00,10026.37,11026.37,1665.20,6999.06,0.38,1
22034,2450,1000.00,11026.37,12026.37,0.00,8750.45,0.26,1
22035,2450,1000.00,12026.37,13026.37,6013.18,6013.18,0.03,1
22036,2450,1000.00,13026.37,14026.37,4833.92,8192.45,0.13,1
22037,2450,1000.00,14026.37,15026.37,0.00,14026.37,0.02,1
22038,2450,-1000.00,13026.37,14026.37,11871.06,2518.54,0.08,0
22039,2450,1000.00,14026.37,15026.37,3876.95,10149.42,0.28,1
22040,2450,1000.00,15026.37,16026.37,0.00,13532.75,0.11,1
22041,2450,1000.00,16026.37,17026.37,4688.12,11338.25,0.31,1
22042,2450,-1000.00,15026.37,16026.37,5571.30,0.00,0.06,0
22043,2450,1000.00,16026.37,17026.37,1862.70,14163.66,0.38,1
22044,2450,1000.00,17026.37,18026.37,0.00,1298.07,0.08,1
22045,2450,1000.00,18026.37,19026.37,0.00,14992.44,0.05,1
22046,2450,-1000.00,17026.37,18026.37,10133.83,8892.54,0.27,0
22047,2450,1000.00,18026.37,19026.37,6847.61,11178.76,0.16,1
22048,2450,1000.00,19026.37,20026.37,9296.98,9729.39,0.44,1
22049,2450,1000.00,20026.37,21026.37,0.00,14441.96,0.02,1
22050,2450,1000.00,21026.37,22026.37,0.00,9576.26,0.27,1
22051,2450,1000.00,22026.37,23026.37,3747.07,9882.59,0.28,1
22052,2450,1000.00,23026.37,24026.37,0.00,17734.18,0.40,1
22053,2450,-1000.00,22026.37,23026.37,14000.10,10026.27,0.38,0
22054,2450,1000.00,23026.37,24026.37,6456.23,10840.63,0.28,1
22055,2450,-1000.00,22026.37,23026.37,12061.44,11964.93,0.18,0
22056,2450,-1000.00,21026.37,22026.37,14589.24,8437.13,0.17,0
22057,2450,1000.00,22026.37,23026.37,3586.93,18439.44,0.05,1
22058,2450,-1000.00,21026.37,22026.37,0.00,16868.00,0.20,0
22059,2451,-1000.00,-1000.00,0.00,919.42,80.58,0.04,0
22060,2452,-753.84,-753.84,246.16,0.00,753.84,0.39,0
22061,2452,-246.16,-1000.00,0.00,5.61,240.55,0.40,0
22062,2453,-531.15,-531.15,468.85,0.00,531.15,0.04,0
22063,2453,-1000.00,-1531.15,-531.15,252.56,179.90,0.18,0
22064,2454,-1000.00,-1000.00,0.00,0.00,893.68,0.44,0
22065,2455,1000.00,1000.00,2000.00,298.91,701.09,0.11,1
22066,2455,1000.00,2000.00,3000.00,0.00,2000.00,0.36,1
22067,2455,1000.00,3000.00,4000.00,0.00,11.75,0.08,1
22068,2455,1000.00,4000.00,5000.00,0.00,1921.03,0.21,1
22069,2455,1000.00,5000.00,6000.00,637.01,4362.99,0.30,1
22070,2455,1000.00,6000.00,7000.00,0.00,4428.45,0.14,1
22071,2455,1000.00,7000.00,8000.00,0.00,711.05,0.14,1
22072,2455,1000.00,8000.00,9000.00,0.00,4910.24,0.14,1
22073,2455,1000.00,9000.00,10000.00,0.00,8733.24,0.31,1
22074,2455,1000.00,10000.00,11000.00,5000.00,5000.00,0.02,1
22075,2455,1000.00,11000.00,12000.00,4264.72,6735.28,0.29,1
22076,2455,1000.00,12000.00,13000.00,148.49,6125.88,0.32,1
22077,2455,1000.00,13000.00,14000.00,2562.37,10437.63,0.35,1
22078,2455,1000.00,14000.00,15000.00,4231.56,9768.44,0.24,1
22079,2455,1000.00,15000.00,16000.00,3907.77,8563.75,0.31,1
22080,2455,-1000.00,14000.00,15000.00,12276.93,0.00,0.02,0
22081,2455,1000.00,15000.00,16000.00,0.00,15000.00,0.29,1
22082,2455,0.00,15000.00,16000.00,0.00,0.00,0.02,0
22083,2455,1000.00,16000.00,17000.00,6947.06,9052.94,0.04,1
22084,2455,1000.00,17000.00,18000.00,0.00,17000.00,0.27,1
22085,2455,1000.00,18000.00,19000.00,0.00,18000.00,0.24,1
22086,2455,1000.00,19000.00,20000.00,0.00,19000.00,0.37,1
22087,2455,-1000.00,18000.00,19000.00,10000.00,10000.00,0.27,0
22088,2455,-1000.00,17000.00,18000.00,4760.97,14239.03,0.38,0
22089,2455,-1000.00,16000.00,17000.00,978.84,17021.16,0.44,0
22090,2455,-1000.00,15000.00,16000.00,1455.14,15544.86,0.26,0
22091,2455,-1000.00,14000.00,15000.00,5030.74,10969.26,0.33,0
22092,2455,-1000.00,13000.00,14000.00,2113.45,11407.66,0.40,0
22093,2455,-1000.00,12000.00,13000.00,4130.65,9869.35,0.28,0
22094,2455,-1000.00,11000.00,12000.00,3753.72,9246.28,0.35,0
22095,2455,-1000.00,10000.00,11000.00,0.00,12000.00,0.13,0
22096,2455,-1000.00,9000.00,10000.00,7127.02,3872.98,0.11,0
22097,2455,-1000.00,8000.00,9000.00,0.00,2140.14,0.08,0
22098,2455,-1000.00,7000.00,8000.00,3624.31,5375.69,0.21,0
22099,2455,-1000.00,6000.00,7000.00,0.00,8000.00,0.26,0
22100,2455,-1000.00,5000.00,6000.00,0.00,7000.00,0.30,0
22101,2455,-1000.00,4000.00,5000.00,0.00,6000.00,0.41,0
22102,2455,-1000.00,3000.00,4000.00,0.00,2955.19,0.20,0
22103,2455,-1000.00,2000.00,3000.00,0.00,4000.00,0.29,0
22104,2455,-1000.00,1000.00,2000.00,834.26,2165.74,0.26,0
22105,2455,0.00,1000.00,2000.00,0.00,0.00,0.01,0
22106,2455,-1000.00,0.00,1000.00,944.83,1055.17,0.04,0
22107,2455,-542.74,-542.74,457.26,0.00,542.74,0.11,0
22108,2455,-457.26,-1000.00,0.00,228.63,228.63,0.03,0
22109,2456,-1000.00,-1000.00,0.00,304.94,695.06,0.34,0
22110,2457,-1000.00,-1000.00,0.00,43.57,956.43,0.08,0
22111,2458,-1000.00,-1000.00,0.00,35.15,964.85,0.44,0
22112,2458,-0.00,-1000.00,0.00,0.00,0.00,0.37,0
22113,2459,-1000.00,-1000.00,0.00,0.00,1000.00,0.31,0
22114,2460,1000.00,1000.00,2000.00,407.64,592.36,0.18,1
22115,2460,1000.00,2000.00,3000.00,854.55,1145.45,0.27,1
22116,2460,1000.00,3000.00,4000.00,702.58,2297.42,0.40,1
22117,2460,1000.00,4000.00,5000.00,0.00,4000.00,0.41,1
22118,2460,1000.00,5000.00,6000.00,0.00,5000.00,0.28,1
22119,2460,1000.00,6000.00,7000.00,1283.94,4716.06,0.43,1
22120,2460,0.00,6000.00,7000.00,0.00,0.00,0.06,0
22121,2460,1000.00,7000.00,8000.00,0.00,3048.29,0.27,1
22122,2460,-1000.00,6000.00,7000.00,1753.99,0.00,0.01,0
22123,2460,1000.00,7000.00,8000.00,0.00,3627.31,0.17,1
22124,2460,1000.00,8000.00,9000.00,0.00,355.42,0.07,1
22125,2460,1000.00,9000.00,10000.00,1644.11,7355.89,0.42,1
22126,2460,1000.00,10000.00,11000.00,0.00,9332.21,0.04,1
22127,2460,1000.00,11000.00,12000.00,3942.33,7057.67,0.26,1
22128,2460,1000.00,12000.00,13000.00,0.00,310.91,0.03,1
22129,2460,1000.00,13000.00,14000.00,0.00,4494.42,0.24,1
22130,2460,1000.00,14000.00,15000.00,7000.00,7000.00,0.11,1
22131,2460,1000.00,15000.00,16000.00,0.00,14299.70,0.44,1
22132,2460,1000.00,16000.00,17000.00,8000.00,8000.00,0.22,1
22133,2460,1000.00,17000.00,18000.00,8500.00,8500.00,0.02,1
22134,2460,-1000.00,16000.00,17000.00,13720.43,2750.70,0.07,0
22135,2460,-1000.00,15000.00,16000.00,12871.45,4128.55,0.21,0
22136,2460,1000.00,16000.00,17000.00,0.00,16000.00,0.29,1
22137,2460,1000.00,17000.00,18000.00,0.00,15068.65,0.36,1
22138,2460,1000.00,18000.00,19000.00,0.00,17063.74,0.29,1
22139,2460,1000.00,19000.00,20000.00,0.00,5079.36,0.05,1
22140,2460,1000.00,20000.00,21000.00,0.00,16253.23,0.20,1
22141,2460,1000.00,21000.00,22000.00,0.00,14402.66,0.12,1
22142,2460,0.00,21000.00,22000.00,0.00,0.00,0.04,0
22143,2460,1000.00,22000.00,23000.00,0.00,19126.69,0.13,1
22144,2460,1000.00,23000.00,24000.00,0.00,23000.00,0.36,1
22145,2460,1000.00,24000.00,25000.00,0.00,16041.25,0.38,1
22146,2460,1000.00,25000.00,26000.00,0.00,16878.45,0.38,1
22147,2460,1000.00,26000.00,27000.00,0.00,26000.00,0.17,1
22148,2460,1000.00,27000.00,28000.00,13500.00,13500.00,0.07,1
22149,2460,1000.00,28000.00,29000.00,14000.00,14000.00,0.02,1
22150,2460,1000.00,29000.00,30000.00,13101.20,15898.80,0.10,1
22151,2460,-1000.00,28000.00,29000.00,30000.00,0.00,0.01,0
22152,2460,1000.00,29000.00,30000.00,0.00,7539.02,0.02,1
22153,2460,1000.00,30000.00,31000.00,12888.43,17111.57,0.20,1
22154,2460,1000.00,31000.00,32000.00,0.00,27040.85,0.06,1
22155,2461,-1000.00,-1000.00,0.00,0.00,1000.00,0.38,0
22156,2462,-1000.00,-1000.00,0.00,0.00,1000.00,0.32,0
22157,2463,1000.00,1000.00,2000.00,349.35,650.65,0.13,1
22158,2463,1000.00,2000.00,3000.00,567.01,1432.99,0.36,1
22159,2463,1000.00,3000.00,4000.00,0.00,2709.50,0.16,1
22160,2463,1000.00,4000.00,5000.00,245.17,3754.83,0.17,1
22161,2463,1000.00,5000.00,6000.00,0.00,2855.28,0.10,1
22162,2463,-1000.00,4000.00,5000.00,3942.91,2057.09,0.08,0
22163,2463,1000.00,5000.00,6000.00,2500.00,2500.00,0.09,1
22164,2463,1000.00,6000.00,7000.00,0.00,4683.09,0.37,1
22165,2463,1000.00,7000.00,8000.00,2593.28,4406.72,0.32,1
22166,2463,1000.00,8000.00,9000.00,2454.77,5545.23,0.24,1
22167,2463,-1000.00,7000.00,8000.00,5386.90,3613.10,0.14,0
22168,2463,1000.00,8000.00,9000.00,0.00,8000.00,0.38,1
22169,2463,-1000.00,7000.00,8000.00,2394.49,1689.86,0.17,0
22170,2463,1000.00,8000.00,9000.00,1001.63,6998.37,0.41,1
22171,2463,1000.00,9000.00,10000.00,2111.16,6888.84,0.35,1
22172,2463,1000.00,10000.00,11000.00,4378.52,5004.61,0.24,1
22173,2463,1000.00,11000.00,12000.00,0.00,11000.00,0.02,1
22174,2463,1000.00,12000.00,13000.00,0.00,12000.00,0.29,1
22175,2463,1000.00,13000.00,14000.00,2984.87,10015.13,0.36,1
22176,2463,1000.00,14000.00,15000.00,0.00,14000.00,0.37,1
22177,2463,1000.00,15000.00,16000.00,0.00,6177.96,0.28,1
22178,2463,-1000.00,14000.00,15000.00,9491.49,6508.51,0.37,0
22179,2463,1000.00,15000.00,16000.00,0.00,1478.50,0.07,1
22180,2463,1000.00,16000.00,17000.00,473.22,13515.08,0.43,1
22181,2463,-1000.00,15000.00,16000.00,8500.00,8500.00,0.11,0
22182,2463,-1000.00,14000.00,15000.00,0.00,3675.72,0.15,0
22183,2463,-1000.00,13000.00,14000.00,9949.49,5050.51,0.06,0
22184,2463,-1000.00,12000.00,13000.00,0.00,10494.90,0.26,0
22185,2463,-1000.00,11000.00,12000.00,6710.66,6289.34,0.09,0
22186,2463,-1000.00,10000.00,11000.00,0.00,12000.00,0.10,0
22187,2463,-1000.00,9000.00,10000.00,7555.94,3444.06,0.27,0
22188,2463,-1000.00,8000.00,9000.00,3116.93,6883.07,0.15,0
22189,2463,-1000.00,7000.00,8000.00,1345.47,7654.53,0.33,0
22190,2463,-1000.00,6000.00,7000.00,0.00,3488.44,0.29,0
22191,2463,-1000.00,5000.00,6000.00,1753.90,5246.10,0.19,0
22192,2463,-1000.00,4000.00,5000.00,1134.13,4217.32,0.38,0
22193,2463,-1000.00,3000.00,4000.00,0.00,5000.00,0.02,0
22194,2463,-1000.00,2000.00,3000.00,1699.06,2300.94,0.20,0
22195,2463,-1000.00,1000.00,2000.00,1477.75,1522.25,0.22,0
22196,2463,-1000.00,0.00,1000.00,979.98,1020.02,0.15,0
22197,2463,-869.46,-869.46,130.54,0.00,869.46,0.34,0
22198,2463,-130.54,-1000.00,0.00,65.27,65.27,0.41,0
22199,2464,1000.00,1000.00,2000.00,510.05,489.95,0.17,1
22200,2464,-1000.00,0.00,1000.00,713.72,1122.15,0.29,0
22201,2464,-1000.00,-1000.00,0.00,103.38,896.62,0.40,0
22202,2465,-726.59,-726.59,273.41,0.00,726.59,0.20,0
22203,2465,-273.41,-1000.00,0.00,0.00,273.41,0.23,0
22204,2466,-1000.00,-1000.00,0.00,626.43,373.57,0.08,0
22205,2467,-1000.00,-1000.00,0.00,333.05,666.95,0.22,0
22206,2468,-1000.00,-1000.00,0.00,590.04,245.01,0.13,0
22207,2469,-327.00,-327.00,673.00,0.00,327.00,0.23,0
22208,2469,-673.00,-1000.00,0.00,214.24,458.76,0.30,0
22209,2470,-727.34,-727.34,272.66,0.00,727.34,0.23,0
22210,2470,1000.00,272.66,1272.66,144.67,127.99,0.10,1
22211,2470,-1000.00,-727.34,272.66,380.63,892.02,0.13,0
22212,2470,-95.73,-823.08,176.92,0.00,95.73,0.18,0
22213,2470,1000.00,176.92,1176.92,121.51,55.41,0.10,1
22214,2470,-1000.00,-823.08,176.92,0.00,1100.54,0.10,0
22215,2470,-143.19,-966.27,33.73,37.12,106.07,0.36,0
22216,2470,-33.73,-1000.00,0.00,12.11,21.63,0.12,0
22217,2471,-1000.00,-1000.00,0.00,0.00,700.83,0.23,0
22218,2472,-1000.00,-1000.00,0.00,0.00,1000.00,0.42,0
22219,2473,1000.00,1000.00,2000.00,0.00,1000.00,0.37,1
22220,2473,1000.00,2000.00,3000.00,0.00,1815.82,0.24,1
22221,2473,1000.00,3000.00,4000.00,0.00,1913.65,0.19,1
22222,2473,1000.00,4000.00,5000.00,0.00,150.11,0.10,1
22223,2473,1000.00,5000.00,6000.00,1667.61,3332.39,0.29,1
22224,2473,1000.00,6000.00,7000.00,1636.06,4363.94,0.37,1
22225,2473,1000.00,7000.00,8000.00,3402.78,3597.22,0.43,1
22226,2473,0.00,7000.00,8000.00,0.00,0.00,0.08,0
22227,2473,1000.00,8000.00,9000.00,1459.44,5582.88,0.37,1
22228,2473,1000.00,9000.00,10000.00,3976.41,5023.59,0.05,1
22229,2473,1000.00,10000.00,11000.00,0.00,10000.00,0.20,1
22230,2473,1000.00,11000.00,12000.00,4044.53,6955.47,0.12,1
22231,2473,1000.00,12000.00,13000.00,4727.15,7272.85,0.29,1
22232,2473,-1000.00,11000.00,12000.00,13000.00,0.00,0.01,0
22233,2473,1000.00,12000.00,13000.00,0.00,3060.33,0.01,1
22234,2473,1000.00,13000.00,14000.00,6500.00,6500.00,0.06,1
22235,2473,1000.00,14000.00,15000.00,0.00,14000.00,0.34,1
22236,2473,1000.00,15000.00,16000.00,1897.04,13102.96,0.31,1
22237,2473,1000.00,16000.00,17000.00,0.00,16000.00,0.28,1
22238,2473,1000.00,17000.00,18000.00,5734.31,11265.69,0.44,1
22239,2473,1000.00,18000.00,19000.00,0.00,1470.98,0.04,1
22240,2473,-1000.00,17000.00,18000.00,9544.96,9455.04,0.39,0
22241,2473,1000.00,18000.00,19000.00,712.54,17287.46,0.37,1
22242,2473,1000.00,19000.00,20000.00,0.00,14472.91,0.41,1
22243,2473,1000.00,20000.00,21000.00,10000.00,10000.00,0.12,1
22244,2473,1000.00,21000.00,22000.00,0.00,21000.00,0.22,1
22245,2473,1000.00,22000.00,23000.00,7073.88,12049.45,0.29,1
22246,2473,-1000.00,21000.00,22000.00,3360.62,0.00,0.04,0
22247,2473,1000.00,22000.00,23000.00,11000.00,11000.00,0.28,1
22248,2473,1000.00,23000.00,24000.00,7044.90,15955.10,0.34,1
22249,2473,1000.00,24000.00,25000.00,11250.38,12749.62,0.16,1
22250,2473,1000.00,25000.00,26000.00,0.00,14636.19,0.27,1
22251,2473,1000.00,26000.00,27000.00,0.00,26000.00,0.10,1
22252,2473,1000.00,27000.00,28000.00,5552.78,21447.22,0.31,1
22253,2473,-1000.00,26000.00,27000.00,18782.57,9217.43,0.06,0
22254,2473,1000.00,27000.00,28000.00,0.00,27000.00,0.05,1
22255,2473,-1000.00,26000.00,27000.00,17175.52,10824.48,0.16,0
22256,2473,1000.00,27000.00,28000.00,7509.04,19490.96,0.36,1
22257,2473,1000.00,28000.00,29000.00,12767.25,15232.75,0.10,1
22258,2474,1000.00,1000.00,2000.00,298.99,529.76,0.29,1
22259,2474,1000.00,2000.00,3000.00,88.63,1242.40,0.36,1
22260,2474,1000.00,3000.00,4000.00,1008.83,1991.17,0.34,1
22261,2474,-1000.00,2000.00,3000.00,2199.35,0.00,0.05,0
22262,2474,1000.00,3000.00,4000.00,0.00,3000.00,0.08,1
22263,2474,1000.00,4000.00,5000.00,608.13,3391.87,0.42,1
22264,2474,1000.00,5000.00,6000.00,484.71,3765.26,0.40,1
22265,2474,1000.00,6000.00,7000.00,1747.95,4252.05,0.35,1
22266,2474,1000.00,7000.00,8000.00,2804.46,4195.54,0.35,1
22267,2474,1000.00,8000.00,9000.00,0.00,5437.85,0.28,1
22268,2474,1000.00,9000.00,10000.00,0.00,435.86,0.13,1
22269,2474,1000.00,10000.00,11000.00,2224.45,7775.55,0.39,1
22270,2474,1000.00,11000.00,12000.00,0.00,10712.22,0.32,1
22271,2474,1000.00,12000.00,13000.00,5635.09,6364.91,0.13,1
22272,2474,1000.00,13000.00,14000.00,5509.92,7490.08,0.27,1
22273,2474,1000.00,14000.00,15000.00,0.00,8084.11,0.25,1
22274,2474,-1000.00,13000.00,14000.00,7979.67,7020.33,0.05,0
22275,2474,1000.00,14000.00,15000.00,0.00,9726.32,0.29,1
22276,2474,1000.00,15000.00,16000.00,6274.96,8725.04,0.14,1
22277,2474,-1000.00,14000.00,15000.00,16000.00,0.00,0.02,0
22278,2474,1000.00,15000.00,16000.00,0.00,13399.47,0.42,1
22279,2474,1000.00,16000.00,17000.00,6211.95,9788.05,0.24,1
22280,2474,1000.00,17000.00,18000.00,4686.27,4969.90,0.21,1
22281,2474,1000.00,18000.00,19000.00,9000.00,9000.00,0.23,1
22282,2474,-1000.00,17000.00,18000.00,11445.59,7554.41,0.12,0
22283,2474,1000.00,18000.00,19000.00,6386.22,11613.78,0.29,1
22284,2474,1000.00,19000.00,20000.00,7487.46,11512.54,0.02,1
22285,2474,1000.00,20000.00,21000.00,4642.10,15357.90,0.41,1
22286,2474,-1000.00,19000.00,20000.00,6273.70,5493.92,0.18,0
22287,2474,1000.00,20000.00,21000.00,0.00,19945.84,0.39,1
22288,2474,-1000.00,19000.00,20000.00,10750.49,10249.51,0.19,0
22289,2474,1000.00,20000.00,21000.00,2982.90,17017.10,0.42,1
22290,2474,1000.00,21000.00,22000.00,0.00,21000.00,0.17,1
22291,2474,1000.00,22000.00,23000.00,0.00,14727.57,0.26,1
22292,2474,-1000.00,21000.00,22000.00,11775.95,11224.05,0.21,0
22293,2474,1000.00,22000.00,23000.00,32.84,12339.91,0.34,1
22294,2474,1000.00,23000.00,24000.00,0.00,23000.00,0.13,1
22295,2474,0.00,23000.00,24000.00,0.00,0.00,0.00,0
22296,2474,-1000.00,22000.00,23000.00,14075.03,9924.97,0.10,0
22297,2474,1000.00,23000.00,24000.00,5438.42,17561.58,0.39,1
22298,2474,1000.00,24000.00,25000.00,8243.15,15756.85,0.06,1
22299,2474,1000.00,25000.00,26000.00,12500.00,12500.00,0.21,1
22300,2474,1000.00,26000.00,27000.00,0.00,12647.45,0.23,1
22301,2474,1000.00,27000.00,28000.00,0.00,27000.00,0.06,1
22302,2474,1000.00,28000.00,29000.00,0.00,28000.00,0.02,1
22303,2474,-1000.00,27000.00,28000.00,15133.45,13866.55,0.12,0
22304,2474,1000.00,28000.00,29000.00,0.00,28000.00,0.02,1
22305,2475,-1000.00,-1000.00,0.00,0.00,853.70,0.40,0
22306,2476,-1000.00,-1000.00,0.00,0.00,555.36,0.05,0
22307,2477,-1000.00,-1000.00,0.00,424.55,575.45,0.23,0
22308,2478,1000.00,1000.00,2000.00,436.39,563.61,0.26,1
22309,2478,1000.00,2000.00,3000.00,350.37,1649.63,0.42,1
22310,2478,1000.00,3000.00,4000.00,0.00,865.43,0.17,1
22311,2478,1000.00,4000.00,5000.00,0.00,3606.51,0.42,1
22312,2478,1000.00,5000.00,6000.00,2474.42,2525.58,0.22,1
22313,2478,1000.00,6000.00,7000.00,0.00,4681.08,0.26,1
22314,2478,1000.00,7000.00,8000.00,3345.90,3654.10,0.43,1
22315,2478,1000.00,8000.00,9000.00,2025.59,5974.41,0.33,1
22316,2478,1000.00,9000.00,10000.00,0.00,9000.00,0.38,1
22317,2478,1000.00,10000.00,11000.00,3121.95,6878.05,0.32,1
22318,2478,-1000.00,9000.00,10000.00,7189.82,3810.18,0.00,0
22319,2478,1000.00,10000.00,11000.00,1707.81,7423.35,0.39,1
22320,2478,-1000.00,9000.00,10000.00,5736.00,2850.27,0.14,0
22321,2478,1000.00,10000.00,11000.00,1754.52,8245.48,0.41,1
22322,2478,1000.00,11000.00,12000.00,2126.40,8411.41,0.39,1
22323,2478,1000.00,12000.00,13000.00,0.00,12000.00,0.14,1
22324,2478,-1000.00,11000.00,12000.00,6578.84,6421.16,0.25,0
22325,2478,1000.00,12000.00,13000.00,3532.15,8467.85,0.19,1
22326,2478,-1000.00,11000.00,12000.00,0.00,13000.00,0.03,0
22327,2478,-1000.00,10000.00,11000.00,0.00,12000.00,0.35,0
22328,2478,-1000.00,9000.00,10000.00,0.00,11000.00,0.07,0
22329,2478,-1000.00,8000.00,9000.00,0.00,7922.78,0.36,0
22330,2478,-1000.00,7000.00,8000.00,0.00,9000.00,0.24,0
22331,2478,-1000.00,6000.00,7000.00,1241.81,6758.19,0.36,0
22332,2478,-1000.00,5000.00,6000.00,1025.81,5974.19,0.10,0
22333,2478,-1000.00,4000.00,5000.00,0.00,6000.00,0.38,0
22334,2478,-1000.00,3000.00,4000.00,0.00,5000.00,0.06,0
22335,2478,-1000.00,2000.00,3000.00,0.00,4000.00,0.11,0
22336,2478,-1000.00,1000.00,2000.00,398.93,2601.07,0.21,0
22337,2478,-1000.00,0.00,1000.00,1427.93,502.36,0.10,0
22338,2478,-781.49,-781.49,218.51,0.00,781.49,0.24,0
22339,2478,-218.51,-1000.00,0.00,42.71,175.80,0.40,0
22340,2479,-1000.00,-1000.00,0.00,0.00,1000.00,0.13,0
22341,2480,-954.29,-954.29,45.71,0.00,954.29,0.44,0
22342,2480,-21.14,-975.43,24.57,0.00,21.14,0.21,0
22343,2480,-13.68,-989.11,10.89,4.43,9.25,0.25,0
22344,2480,-891.07,-1880.18,-880.18,6.70,4.19,0.11,0
22345,2481,-1000.00,-1000.00,0.00,622.57,377.43,0.16,0
22346,2482,-1000.00,-1000.00,0.00,0.00,272.40,0.14,0
22347,2483,-1000.00,-1000.00,0.00,0.00,1000.00,0.19,0
22348,2484,-28.42,-28.42,971.58,28.42,0.00,0.07,0
22349,2484,-1000.00,-1028.42,-28.42,255.85,337.34,0.40,0
22350,2485,-946.92,-946.92,53.08,0.85,946.06,0.44,0
22351,2485,-53.08,-1000.00,0.00,0.00,53.08,0.18,0
22352,2486,1000.00,1000.00,2000.00,0.00,525.53,0.18,1
22353,2486,1000.00,2000.00,3000.00,5.27,1232.46,0.36,1
22354,2486,1000.00,3000.00,4000.00,0.00,3000.00,0.15,1
22355,2486,1000.00,4000.00,5000.00,1805.44,2194.56,0.25,1
22356,2486,-1000.00,3000.00,4000.00,2547.31,2452.69,0.32,0
22357,2486,1000.00,4000.00,5000.00,0.00,2856.55,0.39,1
22358,2486,1000.00,5000.00,6000.00,0.00,5000.00,0.37,1
22359,2486,1000.00,6000.00,7000.00,3000.00,3000.00,0.09,1
22360,2486,1000.00,7000.00,8000.00,0.00,1405.26,0.15,1
22361,2486,-220.01,6779.99,7779.99,220.01,0.00,0.07,0
22362,2486,1000.00,7779.99,8779.99,2121.34,5082.68,0.36,1
22363,2486,-1000.00,6779.99,7779.99,5184.87,3595.13,0.21,0
22364,2486,1000.00,7779.99,8779.99,729.75,7050.24,0.26,1
22365,2486,1000.00,8779.99,9779.99,4390.00,4390.00,0.06,1
22366,2486,1000.00,9779.99,10779.99,0.00,9779.99,0.26,1
22367,2486,1000.00,10779.99,11779.99,0.00,10779.99,0.03,1
22368,2486,1000.00,11779.99,12779.99,0.00,11779.99,0.39,1
22369,2486,1000.00,12779.99,13779.99,249.16,12530.83,0.41,1
22370,2486,1000.00,13779.99,14779.99,0.00,13779.99,0.11,1
22371,2486,1000.00,14779.99,15779.99,0.00,13074.59,0.08,1
22372,2486,1000.00,15779.99,16779.99,0.00,15779.99,0.01,1
22373,2486,1000.00,16779.99,17779.99,0.00,16779.99,0.39,1
22374,2486,1000.00,17779.99,18779.99,8890.00,8890.00,0.15,1
22375,2486,1000.00,18779.99,19779.99,0.00,18779.99,0.25,1
22376,2486,1000.00,19779.99,20779.99,0.00,18597.33,0.44,1
22377,2486,-1000.00,18779.99,19779.99,13378.23,7401.76,0.01,0
22378,2486,1000.00,19779.99,20779.99,9890.00,9890.00,0.02,1
22379,2486,1000.00,20779.99,21779.99,0.00,14717.45,0.35,1
22380,2486,1000.00,21779.99,22779.99,0.00,4758.23,0.04,1
22381,2486,1000.00,22779.99,23779.99,7865.00,14914.99,0.38,1
22382,2486,1000.00,23779.99,24779.99,0.00,23779.99,0.02,1
22383,2486,-1000.00,22779.99,23779.99,15692.78,5228.84,0.11,0
22384,2486,1000.00,23779.99,24779.99,11183.59,12596.40,0.35,1
22385,2486,1000.00,24779.99,25779.99,5685.41,15207.81,0.33,1
22386,2486,1000.00,25779.99,26779.99,0.00,25779.99,0.04,1
22387,2486,-1000.00,24779.99,25779.99,19945.24,6834.75,0.07,0
22388,2486,1000.00,25779.99,26779.99,0.00,19575.19,0.40,1
22389,2486,1000.00,26779.99,27779.99,1932.76,2591.61,0.14,1
22390,2486,1000.00,27779.99,28779.99,0.00,27779.99,0.42,1
22391,2486,1000.00,28779.99,29779.99,10720.41,15200.05,0.27,1
22392,2486,-1000.00,27779.99,28779.99,17869.15,11910.84,0.31,0
22393,2487,1000.00,1000.00,2000.00,22.43,471.42,0.30,1
22394,2487,1000.00,2000.00,3000.00,32.42,1147.17,0.34,1
22395,2487,1000.00,3000.00,4000.00,0.00,3000.00,0.08,1
22396,2487,1000.00,4000.00,5000.00,0.00,3783.58,0.29,1
22397,2487,1000.00,5000.00,6000.00,0.00,1451.77,0.21,1
22398,2487,1000.00,6000.00,7000.00,0.00,1990.22,0.15,1
22399,2487,1000.00,7000.00,8000.00,328.55,3226.18,0.29,1
22400,2487,1000.00,8000.00,9000.00,1783.10,6216.90,0.44,1
22401,2487,1000.00,9000.00,10000.00,0.00,8244.56,0.44,1
22402,2487,1000.00,10000.00,11000.00,3464.83,6535.17,0.32,1
22403,2487,1000.00,11000.00,12000.00,3998.83,7001.17,0.26,1
22404,2487,1000.00,12000.00,13000.00,3267.62,8732.38,0.34,1
22405,2487,1000.00,13000.00,14000.00,507.55,12492.45,0.21,1
22406,2487,-1000.00,12000.00,13000.00,1520.94,0.00,0.08,0
22407,2487,-1000.00,11000.00,12000.00,6735.21,6264.79,0.12,0
22408,2487,1000.00,12000.00,13000.00,4887.90,7112.10,0.28,1
22409,2487,1000.00,13000.00,14000.00,0.00,6931.24,0.03,1
22410,2487,1000.00,14000.00,15000.00,0.00,14000.00,0.35,1
22411,2487,1000.00,15000.00,16000.00,7168.06,7831.94,0.25,1
22412,2487,1000.00,16000.00,17000.00,0.00,15428.91,0.11,1
22413,2487,-1000.00,15000.00,16000.00,17000.00,0.00,0.00,0
22414,2487,1000.00,16000.00,17000.00,6469.16,9530.84,0.19,1
22415,2487,1000.00,17000.00,18000.00,7030.50,9969.50,0.37,1
22416,2487,-1000.00,16000.00,17000.00,10351.67,7648.33,0.05,0
22417,2487,1000.00,17000.00,18000.00,6080.19,10919.81,0.10,1
22418,2487,-1000.00,16000.00,17000.00,1737.62,1482.51,0.14,0
22419,2487,1000.00,17000.00,18000.00,0.00,17000.00,0.03,1
22420,2487,1000.00,18000.00,19000.00,0.00,18000.00,0.33,1
22421,2487,-1000.00,17000.00,18000.00,12580.80,6419.20,0.10,0
22422,2487,1000.00,18000.00,19000.00,0.00,18000.00,0.21,1
22423,2487,1000.00,19000.00,20000.00,0.00,19000.00,0.12,1
22424,2487,-1000.00,18000.00,19000.00,0.00,20000.00,0.10,0
22425,2487,-1000.00,17000.00,18000.00,5995.65,6167.18,0.22,0
22426,2487,0.00,17000.00,18000.00,0.00,0.00,0.02,0
22427,2487,-1000.00,16000.00,17000.00,9684.31,8315.69,0.30,0
22428,2487,-1000.00,15000.00,16000.00,0.00,17000.00,0.26,0
22429,2487,-1000.00,14000.00,15000.00,4756.97,11243.03,0.34,0
22430,2487,-1000.00,13000.00,14000.00,6878.16,8121.84,0.19,0
22431,2487,-1000.00,12000.00,13000.00,0.00,1189.88,0.20,0
22432,2487,-1000.00,11000.00,12000.00,1838.61,11161.39,0.01,0
22433,2487,-1000.00,10000.00,11000.00,0.00,76.03,0.16,0
22434,2488,-220.23,-220.23,779.77,119.31,100.91,0.14,0
22435,2488,1000.00,779.77,1779.77,47.21,566.14,0.40,1
22436,2488,1000.00,1779.77,2779.77,0.00,434.08,0.20,1
22437,2488,-1000.00,779.77,1779.77,1787.43,628.05,0.11,0
22438,2488,1000.00,1779.77,2779.77,599.70,1180.07,0.35,1
22439,2488,1000.00,2779.77,3779.77,0.00,2121.78,0.32,1
22440,2488,1000.00,3779.77,4779.77,458.93,3320.85,0.28,1
22441,2488,1000.00,4779.77,5779.77,1861.76,2391.58,0.26,1
22442,2488,1000.00,5779.77,6779.77,0.00,5205.34,0.41,1
22443,2488,1000.00,6779.77,7779.77,749.69,6030.08,0.39,1
22444,2488,1000.00,7779.77,8779.77,3708.48,4071.30,0.39,1
22445,2488,-1000.00,6779.77,7779.77,8779.77,0.00,0.01,0
22446,2488,1000.00,7779.77,8779.77,2654.33,5125.45,0.22,1
22447,2488,0.00,7779.77,8779.77,0.00,0.00,0.02,0
22448,2488,1000.00,8779.77,9779.77,1784.01,6995.77,0.39,1
22449,2488,-1000.00,7779.77,8779.77,7135.66,2644.12,0.02,0
22450,2488,1000.00,8779.77,9779.77,0.00,8779.77,0.42,1
22451,2488,1000.00,9779.77,10779.77,998.56,6924.27,0.39,1
22452,2488,1000.00,10779.77,11779.77,1728.49,9051.28,0.42,1
22453,2488,1000.00,11779.77,12779.77,0.00,11779.77,0.11,1
22454,2488,-1000.00,10779.77,11779.77,3196.33,9583.45,0.22,0
22455,2488,-1000.00,9779.77,10779.77,0.00,3447.88,0.20,0
22456,2488,-1000.00,8779.77,9779.77,0.00,6141.05,0.06,0
22457,2488,-1000.00,7779.77,8779.77,0.00,6533.91,0.17,0
22458,2488,-1000.00,6779.77,7779.77,0.00,8116.79,0.36,0
22459,2488,-1000.00,5779.77,6779.77,529.04,7250.74,0.33,0
22460,2488,-1000.00,4779.77,5779.77,1602.51,0.00,0.08,0
22461,2488,-1000.00,3779.77,4779.77,1524.09,2105.26,0.23,0
22462,2488,-1000.00,2779.77,3779.77,774.47,321.29,0.13,0
22463,2488,-1000.00,1779.77,2779.77,0.00,3779.77,0.10,0
22464,2488,-1000.00,779.77,1779.77,1829.39,950.39,0.23,0
22465,2488,-1000.00,-220.23,779.77,716.17,1063.60,0.29,0
22466,2488,-779.77,-1000.00,0.00,0.00,779.77,0.29,0
22467,2489,-154.29,-154.29,845.71,121.49,32.80,0.12,0
22468,2489,1000.00,845.71,1845.71,0.00,845.71,0.13,1
22469,2489,1000.00,1845.71,2845.71,592.50,1253.21,0.22,1
22470,2489,1000.00,2845.71,3845.71,1030.56,1815.16,0.31,1
22471,2489,1000.00,3845.71,4845.71,1165.40,2680.31,0.30,1
22472,2489,1000.00,4845.71,5845.71,0.00,4845.71,0.08,1
22473,2489,1000.00,5845.71,6845.71,0.00,5845.71,0.15,1
22474,2489,1000.00,6845.71,7845.71,0.00,5002.20,0.09,1
22475,2489,1000.00,7845.71,8845.71,1589.41,6256.30,0.40,1
22476,2489,1000.00,8845.71,9845.71,0.00,8845.71,0.10,1
22477,2489,1000.00,9845.71,10845.71,4922.86,4922.86,0.17,1
22478,2489,1000.00,10845.71,11845.71,0.00,4698.48,0.28,1
22479,2489,-1000.00,9845.71,10845.71,5224.54,2684.71,0.15,0
22480,2489,1000.00,10845.71,11845.71,0.00,10318.34,0.10,1
22481,2489,1000.00,11845.71,12845.71,4565.44,7280.27,0.26,1
22482,2489,1000.00,12845.71,13845.71,6422.86,6422.86,0.26,1
22483,2489,0.00,12845.71,13845.71,0.00,0.00,0.01,0
22484,2489,-1000.00,11845.71,12845.71,8246.89,0.00,0.04,0
22485,2489,1000.00,12845.71,13845.71,0.00,10163.66,0.40,1
22486,2489,1000.00,13845.71,14845.71,6922.86,6922.86,0.25,1
22487,2489,1000.00,14845.71,15845.71,0.00,10780.59,0.28,1
22488,2489,1000.00,15845.71,16845.71,561.16,15284.55,0.37,1
22489,2489,1000.00,16845.71,17845.71,0.00,16845.71,0.12,1
22490,2489,-1000.00,15845.71,16845.71,6925.76,0.00,0.06,0
22491,2489,-1000.00,14845.71,15845.71,11181.02,5664.70,0.19,0
22492,2489,1000.00,15845.71,16845.71,0.00,15845.71,0.33,1
22493,2489,1000.00,16845.71,17845.71,5778.46,11067.25,0.40,1
22494,2489,1000.00,17845.71,18845.71,8398.58,9447.13,0.23,1
22495,2489,-1000.00,16845.71,17845.71,12715.14,6130.58,0.05,0
22496,2489,1000.00,17845.71,18845.71,1605.74,13704.12,0.39,1
22497,2489,-1000.00,16845.71,17845.71,9749.47,9096.24,0.19,0
22498,2489,1000.00,17845.71,18845.71,0.00,17845.71,0.11,1
22499,2489,1000.00,18845.71,19845.71,1853.07,16992.64,0.44,1
22500,2489,1000.00,19845.71,20845.71,0.00,19845.71,0.10,1
22501,2489,1000.00,20845.71,21845.71,3619.07,17226.64,0.42,1
22502,2489,1000.00,21845.71,22845.71,0.00,17740.64,0.36,1
22503,2489,1000.00,22845.71,23845.71,566.43,22279.29,0.26,1
22504,2489,1000.00,23845.71,24845.71,0.00,23845.71,0.15,1
22505,2489,1000.00,24845.71,25845.71,0.00,24845.71,0.41,1
22506,2489,-1000.00,23845.71,24845.71,19940.75,0.00,0.02,0
22507,2489,1000.00,24845.71,25845.71,0.00,16440.02,0.26,1
22508,2489,1000.00,25845.71,26845.71,0.00,25610.58,0.26,1
22509,2489,-1000.00,24845.71,25845.71,18864.56,7981.15,0.04,0
22510,2489,1000.00,25845.71,26845.71,10655.01,15190.70,0.19,1
22511,2489,1000.00,26845.71,27845.71,13422.86,13422.86,0.02,1
22512,2489,1000.00,27845.71,28845.71,11004.29,16841.42,0.30,1
22513,2489,1000.00,28845.71,29845.71,10223.77,18621.94,0.23,1
22514,2489,-1000.00,27845.71,28845.71,18337.59,11508.12,0.34,0
22515,2489,-1000.00,26845.71,27845.71,0.00,22338.65,0.41,0
22516,2489,-1000.00,25845.71,26845.71,0.00,27845.71,0.14,0
22517,2489,-1000.00,24845.71,25845.71,0.00,26845.71,0.16,0
22518,2489,-1000.00,23845.71,24845.71,0.00,24638.59,0.32,0
22519,2489,-1000.00,22845.71,23845.71,13338.69,9185.42,0.17,0
22520,2489,-1000.00,21845.71,22845.71,9025.61,14820.10,0.31,0
22521,2489,-1000.00,20845.71,21845.71,12134.69,10711.02,0.41,0
22522,2489,-1000.00,19845.71,20845.71,8399.73,0.00,0.05,0
22523,2489,-1000.00,18845.71,19845.71,5727.60,15118.11,0.01,0
22524,2489,-1000.00,17845.71,18845.71,5063.51,14782.20,0.33,0
22525,2489,-1000.00,16845.71,17845.71,0.00,18845.71,0.07,0
22526,2489,-1000.00,15845.71,16845.71,0.00,17557.63,0.43,0
22527,2489,-1000.00,14845.71,15845.71,0.00,16845.71,0.43,0
22528,2489,-1000.00,13845.71,14845.71,0.00,15845.71,0.36,0
22529,2489,-1000.00,12845.71,13845.71,8776.81,5044.35,0.19,0
22530,2489,-1000.00,11845.71,12845.71,2490.69,11355.02,0.17,0
22531,2489,-1000.00,10845.71,11845.71,0.00,10016.23,0.20,0
22532,2489,-1000.00,9845.71,10845.71,1900.35,9945.36,0.39,0
22533,2489,-1000.00,8845.71,9845.71,6129.23,4716.49,0.03,0
22534,2489,-1000.00,7845.71,8845.71,0.00,9845.71,0.18,0
22535,2489,-1000.00,6845.71,7845.71,4527.04,4318.68,0.01,0
22536,2489,-1000.00,5845.71,6845.71,3970.60,3875.11,0.08,0
22537,2489,-1000.00,4845.71,5845.71,2457.17,4388.55,0.12,0
22538,2489,-1000.00,3845.71,4845.71,0.00,5845.71,0.16,0
22539,2489,-1000.00,2845.71,3845.71,0.00,4845.71,0.24,0
22540,2489,-1000.00,1845.71,2845.71,427.34,3418.37,0.37,0
22541,2489,-1000.00,845.71,1845.71,0.00,2845.71,0.36,0
22542,2489,-1000.00,-154.29,845.71,0.00,1845.71,0.01,0
22543,2489,-99.78,-254.07,745.93,0.00,99.78,0.09,0
22544,2489,-745.93,-1000.00,0.00,305.44,440.49,0.22,0
22545,2490,-226.90,-226.90,773.10,0.00,226.90,0.06,0
22546,2490,-773.10,-1000.00,0.00,311.52,461.59,0.24,0
22547,2491,0.00,0.00,1000.00,0.00,0.00,0.07,0
22548,2491,-1000.00,-1000.00,0.00,276.28,672.53,0.37,0
22549,2492,-1000.00,-1000.00,0.00,607.10,392.90,0.15,0
22550,2493,-1000.00,-1000.00,0.00,850.49,149.51,0.11,0
22551,2493,-0.00,-1000.00,-0.00,0.00,0.00,0.16,0
22552,2494,-1000.00,-1000.00,0.00,105.11,336.65,0.25,0
22553,2495,1000.00,1000.00,2000.00,500.00,500.00,0.04,1
22554,2495,1000.00,2000.00,3000.00,0.00,2000.00,0.19,1
22555,2495,1000.00,3000.00,4000.00,1093.95,1906.05,0.15,1
22556,2495,1000.00,4000.00,5000.00,1862.70,2137.30,0.41,1
22557,2495,1000.00,5000.00,6000.00,1732.75,3267.25,0.08,1
22558,2495,1000.00,6000.00,7000.00,0.00,6000.00,0.31,1
22559,2495,1000.00,7000.00,8000.00,1120.53,1707.37,0.19,1
22560,2495,1000.00,8000.00,9000.00,2123.90,5876.10,0.05,1
22561,2495,-1000.00,7000.00,8000.00,4968.90,4031.10,0.12,0
22562,2495,1000.00,8000.00,9000.00,0.00,8000.00,0.22,1
22563,2495,1000.00,9000.00,10000.00,0.00,9000.00,0.12,1
22564,2495,1000.00,10000.00,11000.00,0.00,10000.00,0.37,1
22565,2495,-1000.00,9000.00,10000.00,3532.96,0.00,0.08,0
22566,2495,1000.00,10000.00,11000.00,2393.09,7606.91,0.39,1
22567,2495,1000.00,11000.00,12000.00,0.00,4948.12,0.26,1
22568,2495,1000.00,12000.00,13000.00,250.17,11749.83,0.26,1
22569,2495,1000.00,13000.00,14000.00,0.00,13000.00,0.08,1
22570,2495,1000.00,14000.00,15000.00,0.00,14000.00,0.12,1
22571,2495,1000.00,15000.00,16000.00,0.00,15000.00,0.35,1
22572,2495,-1000.00,14000.00,15000.00,8185.38,7814.62,0.16,0
22573,2495,1000.00,15000.00,16000.00,2431.84,12568.16,0.27,1
22574,2495,1000.00,16000.00,17000.00,3762.89,12237.11,0.16,1
22575,2495,1000.00,17000.00,18000.00,1479.91,15520.09,0.42,1
22576,2495,1000.00,18000.00,19000.00,0.00,8415.82,0.23,1
22577,2495,1000.00,19000.00,20000.00,8664.00,10336.00,0.11,1
22578,2495,-1000.00,18000.00,19000.00,10312.02,9687.98,0.42,0
22579,2495,1000.00,19000.00,20000.00,0.00,19000.00,0.23,1
22580,2495,1000.00,20000.00,21000.00,0.00,20000.00,0.33,1
22581,2495,1000.00,21000.00,22000.00,0.00,21000.00,0.24,1
22582,2495,1000.00,22000.00,23000.00,0.00,12918.99,0.25,1
22583,2495,1000.00,23000.00,24000.00,4839.37,18160.63,0.27,1
22584,2495,1000.00,24000.00,25000.00,0.00,21372.13,0.41,1
22585,2495,1000.00,25000.00,26000.00,0.00,15855.98,0.36,1
22586,2495,1000.00,26000.00,27000.00,0.00,25813.98,0.38,1
22587,2495,1000.00,27000.00,28000.00,0.00,5056.77,0.15,1
22588,2495,-1000.00,26000.00,27000.00,8224.77,0.00,0.07,0
22589,2495,1000.00,27000.00,28000.00,13500.00,13500.00,0.04,1
22590,2495,1000.00,28000.00,29000.00,0.00,19588.55,0.39,1
22591,2495,1000.00,29000.00,30000.00,0.00,18247.16,0.36,1
22592,2495,1000.00,30000.00,31000.00,12280.83,17719.17,0.28,1
22593,2495,-1000.00,29000.00,30000.00,22667.04,8332.96,0.04,0
22594,2495,1000.00,30000.00,31000.00,12985.40,17014.60,0.18,1
22595,2495,1000.00,31000.00,32000.00,12710.50,18289.50,0.28,1
22596,2495,1000.00,32000.00,33000.00,0.00,32000.00,0.39,1
22597,2495,1000.00,33000.00,34000.00,4954.90,25934.21,0.40,1
22598,2495,1000.00,34000.00,35000.00,13692.83,20307.17,0.20,1
22599,2495,-1000.00,33000.00,34000.00,32646.57,0.00,0.03,0
22600,2495,1000.00,34000.00,35000.00,17000.00,17000.00,0.06,1
22601,2495,1000.00,35000.00,36000.00,10029.59,19233.91,0.30,1
22602,2495,1000.00,36000.00,37000.00,0.00,36000.00,0.38,1
22603,2495,1000.00,37000.00,38000.00,4744.56,32255.44,0.42,1
22604,2495,1000.00,38000.00,39000.00,12437.22,25562.78,0.31,1
22605,2495,1000.00,39000.00,40000.00,6464.67,32535.33,0.26,1
22606,2495,1000.00,40000.00,41000.00,0.00,40000.00,0.40,1
22607,2495,1000.00,41000.00,42000.00,11206.80,29793.20,0.28,1
22608,2495,1000.00,42000.00,43000.00,21000.00,21000.00,0.02,1
22609,2495,0.00,42000.00,43000.00,0.00,0.00,0.03,0
22610,2495,1000.00,43000.00,44000.00,18211.06,24788.94,0.27,1
22611,2495,1000.00,44000.00,45000.00,0.00,5883.45,0.12,1
22612,2495,1000.00,45000.00,46000.00,20105.26,24894.74,0.24,1
22613,2495,1000.00,46000.00,47000.00,7419.99,25381.60,0.32,1
22614,2495,1000.00,47000.00,48000.00,23027.59,23972.41,0.24,1
22615,2495,1000.00,48000.00,49000.00,1121.17,46878.83,0.32,1
22616,2495,1000.00,49000.00,50000.00,0.00,21355.93,0.23,1
22617,2495,1000.00,50000.00,51000.00,22456.18,27543.82,0.35,1
22618,2495,1000.00,51000.00,52000.00,8785.89,41938.74,0.41,1
22619,2495,-1000.00,50000.00,51000.00,25817.60,13072.73,0.16,0
22620,2495,1000.00,51000.00,52000.00,23763.02,27236.98,0.09,1
22621,2495,1000.00,52000.00,53000.00,0.00,5939.23,0.15,1
22622,2496,-130.46,-130.46,869.54,21.28,109.19,0.42,0
22623,2496,-869.54,-1000.00,0.00,360.99,508.55,0.31,0
22624,2497,-737.26,-737.26,262.74,223.10,514.17,0.30,0
22625,2497,-262.74,-1000.00,0.00,114.27,148.47,0.19,0
22626,2498,-1000.00,-1000.00,0.00,149.90,850.10,0.28,0
22627,2499,-1000.00,-1000.00,0.00,0.00,1000.00,0.24,0
22628,2500,-690.08,-690.08,309.92,0.00,690.08,0.10,0
22629,2500,-309.92,-1000.00,0.00,0.00,309.92,0.13,0
22630,2501,1000.00,1000.00,2000.00,0.00,1000.00,0.10,1
22631,2501,-241.37,758.63,1758.63,241.37,0.00,0.08,0
22632,2501,1000.00,1758.63,2758.63,0.00,407.85,0.19,1
22633,2501,1000.00,2758.63,3758.63,420.19,2338.43,0.23,1
22634,2501,1000.00,3758.63,4758.63,1290.63,1463.39,0.22,1
22635,2501,1000.00,4758.63,5758.63,0.00,4532.11,0.21,1
22636,2501,1000.00,5758.63,6758.63,1079.07,4679.55,0.39,1
22637,2501,1000.00,6758.63,7758.63,132.42,4724.92,0.39,1
22638,2501,1000.00,7758.63,8758.63,0.00,3605.90,0.15,1
22639,2501,1000.00,8758.63,9758.63,0.00,2861.69,0.23,1
22640,2501,1000.00,9758.63,10758.63,4131.80,5626.82,0.22,1
22641,2501,1000.00,10758.63,11758.63,0.00,10758.63,0.01,1
22642,2501,1000.00,11758.63,12758.63,0.00,7896.55,0.17,1
22643,2501,1000.00,12758.63,13758.63,5044.99,7713.63,0.18,1
22644,2501,1000.00,13758.63,14758.63,1433.58,3997.57,0.22,1
22645,2501,-1000.00,12758.63,13758.63,7583.42,7175.20,0.18,0
22646,2501,1000.00,13758.63,14758.63,0.00,13758.63,0.19,1
22647,2501,1000.00,14758.63,15758.63,0.00,14758.63,0.06,1
22648,2501,0.00,14758.63,15758.63,0.00,0.00,0.09,0
22649,2501,-1000.00,13758.63,14758.63,8191.51,7567.12,0.28,0
22650,2501,-1000.00,12758.63,13758.63,8967.74,5790.88,0.08,0
22651,2501,1000.00,13758.63,14758.63,0.00,13758.63,0.01,1
22652,2501,-1000.00,12758.63,13758.63,6849.37,6434.52,0.21,0
22653,2501,1000.00,13758.63,14758.63,0.00,13758.63,0.33,1
22654,2501,-1000.00,12758.63,13758.63,3793.69,9846.67,0.35,0
22655,2501,-1000.00,11758.63,12758.63,4326.68,9431.95,0.34,0
22656,2501,-1000.00,10758.63,11758.63,0.00,12758.63,0.25,0
22657,2501,-1000.00,9758.63,10758.63,0.00,4351.83,0.19,0
22658,2501,-1000.00,8758.63,9758.63,6274.18,4484.45,0.00,0
22659,2501,-1000.00,7758.63,8758.63,0.00,9758.63,0.16,0
22660,2501,-1000.00,6758.63,7758.63,2166.81,6591.81,0.39,0
22661,2501,-1000.00,5758.63,6758.63,0.00,4111.57,0.15,0
22662,2501,-1000.00,4758.63,5758.63,516.63,5420.35,0.42,0
22663,2501,-1000.00,3758.63,4758.63,2183.46,3575.17,0.24,0
22664,2501,-1000.00,2758.63,3758.63,0.00,4758.63,0.29,0
22665,2501,-1000.00,1758.63,2758.63,0.00,3758.63,0.26,0
22666,2501,0.00,1758.63,2758.63,0.00,0.00,0.02,0
22667,2501,-1000.00,758.63,1758.63,0.00,2758.63,0.33,0
22668,2501,-1000.00,-241.37,758.63,0.00,1284.69,0.11,0
22669,2501,-227.58,-468.95,531.05,0.00,227.58,0.18,0
22670,2501,-1000.00,-1468.95,-468.95,419.25,111.80,0.02,0
22671,2502,-1000.00,-1000.00,0.00,0.00,1000.00,0.18,0
22672,2503,-1000.00,-1000.00,0.00,305.49,694.51,0.34,0
22673,2504,-1000.00,-1000.00,0.00,158.83,841.17,0.35,0
22674,2505,-1000.00,-1000.00,0.00,629.34,370.66,0.17,0
22675,2506,1000.00,1000.00,2000.00,0.00,952.75,0.43,1
22676,2506,1000.00,2000.00,3000.00,338.81,1661.19,0.10,1
22677,2506,1000.00,3000.00,4000.00,1170.74,1829.26,0.07,1
22678,2506,1000.00,4000.00,5000.00,0.00,4000.00,0.27,1
22679,2506,1000.00,5000.00,6000.00,0.00,5000.00,0.40,1
22680,2506,1000.00,6000.00,7000.00,0.00,6000.00,0.10,1
22681,2506,1000.00,7000.00,8000.00,1580.37,5419.63,0.41,1
22682,2506,1000.00,8000.00,9000.00,3353.46,3875.37,0.24,1
22683,2506,1000.00,9000.00,10000.00,0.00,1689.94,0.08,1
22684,2506,1000.00,10000.00,11000.00,0.00,10000.00,0.42,1
22685,2506,-1000.00,9000.00,10000.00,6513.29,4486.71,0.05,0
22686,2506,1000.00,10000.00,11000.00,0.00,10000.00,0.27,1
22687,2506,1000.00,11000.00,12000.00,0.00,11000.00,0.01,1
22688,2506,1000.00,12000.00,13000.00,0.00,12000.00,0.42,1
22689,2506,1000.00,13000.00,14000.00,0.00,13000.00,0.06,1
22690,2506,-1000.00,12000.00,13000.00,10715.48,961.46,0.12,0
22691,2506,1000.00,13000.00,14000.00,6236.79,6763.21,0.12,1
22692,2506,1000.00,14000.00,15000.00,0.00,8685.33,0.16,1
22693,2506,1000.00,15000.00,16000.00,3982.01,11017.99,0.33,1
22694,2506,1000.00,16000.00,17000.00,0.00,13971.21,0.33,1
22695,2506,1000.00,17000.00,18000.00,0.00,10727.82,0.08,1
22696,2506,1000.00,18000.00,19000.00,7041.61,10958.39,0.13,1
22697,2506,1000.00,19000.00,20000.00,0.00,4067.31,0.18,1
22698,2506,-1000.00,18000.00,19000.00,16699.51,3300.49,0.05,0
22699,2506,-1000.00,17000.00,18000.00,0.00,12443.68,0.01,0
22700,2506,-1000.00,16000.00,17000.00,18000.00,0.00,0.05,0
22701,2506,0.00,16000.00,17000.00,0.00,0.00,0.17,0
22702,2506,0.00,16000.00,17000.00,0.00,0.00,0.10,0
22703,2506,-1000.00,15000.00,16000.00,0.00,5551.03,0.27,0
22704,2506,-1000.00,14000.00,15000.00,3452.77,0.00,0.32,0
22705,2506,-1000.00,13000.00,14000.00,0.00,10205.61,0.22,0
22706,2506,0.00,13000.00,14000.00,0.00,0.00,0.13,0
22707,2506,-1000.00,12000.00,13000.00,3683.15,10316.85,0.16,0
22708,2506,-1000.00,11000.00,12000.00,2753.59,2024.43,0.16,0
22709,2507,1000.00,1000.00,2000.00,0.00,534.68,0.04,1
22710,2507,1000.00,2000.00,3000.00,0.00,2000.00,0.21,1
22711,2507,0.00,2000.00,3000.00,0.00,0.00,0.04,0
22712,2507,-1000.00,1000.00,2000.00,2886.42,0.00,0.01,0
22713,2507,1000.00,2000.00,3000.00,322.97,1677.03,0.42,1
22714,2507,1000.00,3000.00,4000.00,0.00,3000.00,0.26,1
22715,2507,1000.00,4000.00,5000.00,0.00,4000.00,0.03,1
22716,2507,1000.00,5000.00,6000.00,51.63,4948.37,0.42,1
22717,2507,1000.00,6000.00,7000.00,2756.93,3243.07,0.36,1
22718,2507,-1000.00,5000.00,6000.00,5859.54,1140.46,0.06,0
22719,2507,1000.00,6000.00,7000.00,2708.39,3291.61,0.12,1
22720,2507,0.00,6000.00,7000.00,0.00,0.00,0.04,0
22721,2507,1000.00,7000.00,8000.00,0.00,7000.00,0.39,1
22722,2507,1000.00,8000.00,9000.00,0.00,1678.11,0.18,1
22723,2507,1000.00,9000.00,10000.00,696.31,1318.93,0.16,1
22724,2507,1000.00,10000.00,11000.00,0.00,10000.00,0.16,1
22725,2507,1000.00,11000.00,12000.00,977.47,10022.53,0.14,1
22726,2507,1000.00,12000.00,13000.00,3484.15,8515.85,0.16,1
22727,2507,1000.00,13000.00,14000.00,0.00,13000.00,0.11,1
22728,2507,1000.00,14000.00,15000.00,0.00,14000.00,0.01,1
22729,2507,1000.00,15000.00,16000.00,0.00,7599.75,0.16,1
22730,2507,-1000.00,14000.00,15000.00,8179.44,7820.56,0.02,0
22731,2507,-1000.00,13000.00,14000.00,12670.16,2329.84,0.05,0
22732,2507,-1000.00,12000.00,13000.00,0.00,14000.00,0.44,0
22733,2507,-1000.00,11000.00,12000.00,7463.55,5536.45,0.01,0
22734,2507,-1000.00,10000.00,11000.00,0.00,12000.00,0.29,0
22735,2507,-1000.00,9000.00,10000.00,2332.55,8667.45,0.08,0
22736,2507,-1000.00,8000.00,9000.00,0.00,10000.00,0.43,0
22737,2507,-1000.00,7000.00,8000.00,5215.17,1431.24,0.11,0
22738,2507,-1000.00,6000.00,7000.00,0.00,3772.68,0.23,0
22739,2507,-1000.00,5000.00,6000.00,2705.55,4294.45,0.26,0
22740,2507,-1000.00,4000.00,5000.00,0.00,3853.81,0.35,0
22741,2507,-1000.00,3000.00,4000.00,692.31,1605.34,0.23,0
22742,2507,-1000.00,2000.00,3000.00,637.83,3362.17,0.29,0
22743,2507,-1000.00,1000.00,2000.00,1156.44,1843.56,0.26,0
22744,2507,-1000.00,0.00,1000.00,339.21,1024.82,0.31,0
22745,2507,-1000.00,-1000.00,0.00,0.00,1000.00,0.19,0
22746,2508,-1000.00,-1000.00,0.00,321.66,678.34,0.34,0
22747,2509,1000.00,1000.00,2000.00,0.00,1000.00,0.23,1
22748,2509,-1000.00,0.00,1000.00,165.93,1757.28,0.43,0
22749,2509,-1000.00,-1000.00,0.00,0.00,1000.00,0.18,0
22750,2510,-1000.00,-1000.00,0.00,0.00,1000.00,0.24,0
22751,2511,-1000.00,-1000.00,0.00,571.27,428.73,0.12,0
22752,2512,1000.00,1000.00,2000.00,138.12,474.78,0.29,1
22753,2512,1000.00,2000.00,3000.00,34.70,1947.30,0.44,1
22754,2512,1000.00,3000.00,4000.00,0.00,2275.95,0.36,1
22755,2512,1000.00,4000.00,5000.00,0.00,4000.00,0.39,1
22756,2512,1000.00,5000.00,6000.00,1468.36,3531.64,0.27,1
22757,2512,1000.00,6000.00,7000.00,0.00,4644.64,0.11,1
22758,2512,1000.00,7000.00,8000.00,0.00,5689.53,0.28,1
22759,2512,1000.00,8000.00,9000.00,0.00,1837.29,0.19,1
22760,2512,-1000.00,7000.00,8000.00,5518.70,3481.30,0.11,0
22761,2512,1000.00,8000.00,9000.00,0.00,8000.00,0.04,1
22762,2512,1000.00,9000.00,10000.00,0.00,2531.13,0.21,1
22763,2512,0.00,9000.00,10000.00,0.00,0.00,0.09,0
22764,2512,-1000.00,8000.00,9000.00,7998.83,1044.95,0.06,0
22765,2512,0.00,8000.00,9000.00,0.00,0.00,0.05,0
22766,2512,1000.00,9000.00,10000.00,0.00,9000.00,0.14,1
22767,2512,1000.00,10000.00,11000.00,0.00,10000.00,0.01,1
22768,2512,1000.00,11000.00,12000.00,0.00,8292.01,0.24,1
22769,2512,1000.00,12000.00,13000.00,2141.21,9858.79,0.14,1
22770,2512,1000.00,13000.00,14000.00,6500.00,6500.00,0.03,1
22771,2512,1000.00,14000.00,15000.00,7000.00,7000.00,0.41,1
22772,2512,1000.00,15000.00,16000.00,0.00,980.18,0.12,1
22773,2512,1000.00,16000.00,17000.00,0.00,16000.00,0.16,1
22774,2512,-1000.00,15000.00,16000.00,8636.66,8363.34,0.32,0
22775,2512,-1000.00,14000.00,15000.00,9593.12,6406.88,0.33,0
22776,2512,-1000.00,13000.00,14000.00,2863.51,10743.27,0.38,0
22777,2512,-1000.00,12000.00,13000.00,0.00,7302.12,0.14,0
22778,2512,-1000.00,11000.00,12000.00,5856.89,7143.11,0.21,0
22779,2512,-1000.00,10000.00,11000.00,3821.20,8178.80,0.29,0
22780,2512,-1000.00,9000.00,10000.00,0.00,11000.00,0.09,0
22781,2512,-1000.00,8000.00,9000.00,0.00,10000.00,0.25,0
22782,2512,-1000.00,7000.00,8000.00,2963.32,5411.72,0.31,0
22783,2512,-1000.00,6000.00,7000.00,2103.92,5304.80,0.34,0
22784,2512,-1000.00,5000.00,6000.00,3500.00,3500.00,0.25,0
22785,2512,-1000.00,4000.00,5000.00,0.00,4070.14,0.34,0
22786,2512,-1000.00,3000.00,4000.00,2500.00,2500.00,0.09,0
22787,2512,-1000.00,2000.00,3000.00,0.00,4000.00,0.44,0
22788,2512,-1000.00,1000.00,2000.00,619.91,2380.09,0.38,0
22789,2512,-1000.00,0.00,1000.00,711.01,1288.99,0.13,0
22790,2512,-786.52,-786.52,213.48,0.00,786.52,0.21,0
22791,2512,-213.48,-1000.00,0.00,0.00,213.48,0.42,0
22792,2513,-755.56,-755.56,244.44,755.56,0.00,0.03,0
22793,2513,-1000.00,-1755.56,-755.56,0.00,188.24,0.24,0
22794,2514,-1000.00,-1000.00,0.00,369.70,630.30,0.13,0
22795,2515,-1000.00,-1000.00,0.00,0.00,1000.00,0.25,0
22796,2516,-1000.00,-1000.00,0.00,301.44,698.56,0.21,0
22797,2517,-1000.00,-1000.00,0.00,0.00,1000.00,0.31,0
22798,2518,-1000.00,-1000.00,0.00,41.09,958.91,0.37,0
22799,2519,1000.00,1000.00,2000.00,0.00,855.64,0.34,1
22800,2519,1000.00,2000.00,3000.00,480.58,1519.42,0.37,1
22801,2519,0.00,2000.00,3000.00,0.00,0.00,0.03,0
22802,2519,1000.00,3000.00,4000.00,0.00,3000.00,0.39,1
22803,2519,1000.00,4000.00,5000.00,0.00,2854.22,0.33,1
22804,2519,-1000.00,3000.00,4000.00,3529.96,0.00,0.02,0
22805,2519,1000.00,4000.00,5000.00,1519.10,2480.90,0.07,1
22806,2519,1000.00,5000.00,6000.00,0.00,5000.00,0.10,1
22807,2519,1000.00,6000.00,7000.00,1077.40,4116.06,0.37,1
22808,2519,1000.00,7000.00,8000.00,1012.05,5987.95,0.30,1
22809,2519,1000.00,8000.00,9000.00,1853.33,6146.67,0.29,1
22810,2519,-1000.00,7000.00,8000.00,5356.09,3643.91,0.18,0
22811,2519,1000.00,8000.00,9000.00,291.84,7708.16,0.18,1
22812,2519,1000.00,9000.00,10000.00,4068.41,4931.59,0.19,1
22813,2519,1000.00,10000.00,11000.00,0.00,10000.00,0.09,1
22814,2519,1000.00,11000.00,12000.00,0.00,8326.65,0.31,1
22815,2519,1000.00,12000.00,13000.00,1868.99,8100.16,0.37,1
22816,2519,-1000.00,11000.00,12000.00,6857.19,0.00,0.10,0
22817,2519,1000.00,12000.00,13000.00,0.00,2746.74,0.11,1
22818,2519,1000.00,13000.00,14000.00,0.00,11652.27,0.18,1
22819,2519,1000.00,14000.00,15000.00,6553.63,7446.37,0.12,1
22820,2519,1000.00,15000.00,16000.00,6970.50,8029.50,0.17,1
22821,2519,1000.00,16000.00,17000.00,8000.00,8000.00,0.20,1
22822,2519,1000.00,17000.00,18000.00,3203.77,7016.43,0.26,1
22823,2519,-1000.00,16000.00,17000.00,8433.13,8185.87,0.22,0
22824,2519,-1000.00,15000.00,16000.00,1206.26,1026.90,0.13,0
22825,2519,1000.00,16000.00,17000.00,5800.18,10199.82,0.17,1
22826,2519,1000.00,17000.00,18000.00,0.00,9597.29,0.04,1
22827,2519,1000.00,18000.00,19000.00,0.00,5266.97,0.18,1
22828,2519,1000.00,19000.00,20000.00,0.00,12072.84,0.11,1
22829,2519,1000.00,20000.00,21000.00,0.00,20000.00,0.42,1
22830,2519,1000.00,21000.00,22000.00,0.00,17211.76,0.27,1
22831,2519,1000.00,22000.00,23000.00,10988.19,11011.81,0.13,1
22832,2519,1000.00,23000.00,24000.00,0.00,17548.79,0.34,1
22833,2519,1000.00,24000.00,25000.00,0.00,15120.19,0.12,1
22834,2519,1000.00,25000.00,26000.00,4563.15,10546.02,0.27,1
22835,2519,1000.00,26000.00,27000.00,10316.83,15683.17,0.19,1
22836,2519,1000.00,27000.00,28000.00,0.00,27000.00,0.25,1
22837,2519,1000.00,28000.00,29000.00,13638.91,14361.09,0.13,1
22838,2519,-1000.00,27000.00,28000.00,14772.27,14227.73,0.10,0
22839,2519,1000.00,28000.00,29000.00,0.00,16387.77,0.16,1
22840,2519,1000.00,29000.00,30000.00,0.00,13594.84,0.20,1
22841,2519,1000.00,30000.00,31000.00,805.40,29194.60,0.23,1
22842,2519,1000.00,31000.00,32000.00,0.00,3294.37,0.10,1
22843,2519,1000.00,32000.00,33000.00,12570.81,19429.19,0.22,1
22844,2519,1000.00,33000.00,34000.00,0.00,33000.00,0.03,1
22845,2520,-1000.00,-1000.00,0.00,0.00,1000.00,0.35,0
22846,2521,-803.99,-803.99,196.01,101.99,701.99,0.39,0
22847,2521,-60.90,-864.89,135.11,0.00,60.90,0.05,0
22848,2521,-135.11,-1000.00,0.00,32.07,103.03,0.39,0
22849,2522,1000.00,1000.00,2000.00,146.62,853.38,0.41,1
22850,2522,-1000.00,0.00,1000.00,1242.30,184.94,0.08,0
22851,2522,1000.00,1000.00,2000.00,32.35,721.01,0.40,1
22852,2522,1000.00,2000.00,3000.00,0.00,2000.00,0.20,1
22853,2522,1000.00,3000.00,4000.00,288.55,2382.52,0.41,1
22854,2522,1000.00,4000.00,5000.00,904.60,3095.40,0.22,1
22855,2522,1000.00,5000.00,6000.00,1221.55,3778.45,0.31,1
22856,2522,1000.00,6000.00,7000.00,0.00,4878.37,0.41,1
22857,2522,1000.00,7000.00,8000.00,0.00,7000.00,0.44,1
22858,2522,1000.00,8000.00,9000.00,0.00,8000.00,0.14,1
22859,2522,1000.00,9000.00,10000.00,4500.00,4500.00,0.04,1
22860,2522,1000.00,10000.00,11000.00,0.00,5943.27,0.26,1
22861,2522,1000.00,11000.00,12000.00,0.00,10989.08,0.21,1
22862,2522,1000.00,12000.00,13000.00,0.00,12000.00,0.06,1
22863,2522,1000.00,13000.00,14000.00,5054.13,7945.87,0.26,1
22864,2522,1000.00,14000.00,15000.00,5033.48,8966.52,0.06,1
22865,2522,-1000.00,13000.00,14000.00,11556.36,3443.64,0.05,0
22866,2522,1000.00,14000.00,15000.00,0.00,13034.92,0.34,1
22867,2522,1000.00,15000.00,16000.00,0.00,7723.54,0.31,1
22868,2522,-1000.00,14000.00,15000.00,12385.37,3614.63,0.21,0
22869,2522,1000.00,15000.00,16000.00,6300.19,8699.81,0.15,1
22870,2522,-1000.00,14000.00,15000.00,6996.10,9003.90,0.34,0
22871,2522,-1000.00,13000.00,14000.00,1315.79,13684.21,0.12,0
22872,2522,-1000.00,12000.00,13000.00,0.00,14000.00,0.29,0
22873,2522,-1000.00,11000.00,12000.00,0.00,13000.00,0.22,0
22874,2522,-1000.00,10000.00,11000.00,5621.77,6378.23,0.23,0
22875,2522,-1000.00,9000.00,10000.00,0.00,11000.00,0.14,0
22876,2522,-1000.00,8000.00,9000.00,0.00,4978.07,0.16,0
22877,2522,-1000.00,7000.00,8000.00,0.00,9000.00,0.38,0
22878,2522,-1000.00,6000.00,7000.00,3372.84,4627.16,0.43,0
22879,2522,-1000.00,5000.00,6000.00,2053.74,3095.51,0.26,0
22880,2522,-1000.00,4000.00,5000.00,0.00,2659.42,0.06,0
22881,2522,-1000.00,3000.00,4000.00,2172.28,2741.22,0.26,0
22882,2522,-1000.00,2000.00,3000.00,0.00,4000.00,0.30,0
22883,2522,-1000.00,1000.00,2000.00,0.00,2964.02,0.24,0
22884,2522,-1000.00,0.00,1000.00,0.00,2000.00,0.07,0
22885,2522,-656.28,-656.28,343.72,0.00,656.28,0.37,0
22886,2522,1000.00,343.72,1343.72,0.00,221.03,0.35,1
22887,2522,1000.00,1343.72,2343.72,172.95,1170.77,0.43,1
22888,2522,1000.00,2343.72,3343.72,0.00,2229.67,0.42,1
22889,2522,1000.00,3343.72,4343.72,0.00,1493.58,0.29,1
22890,2522,1000.00,4343.72,5343.72,0.00,4145.91,0.44,1
22891,2522,1000.00,5343.72,6343.72,0.00,5343.72,0.35,1
22892,2522,1000.00,6343.72,7343.72,1647.47,3449.12,0.30,1
22893,2522,-742.98,5600.74,6600.74,742.98,0.00,0.02,0
22894,2522,1000.00,6600.74,7600.74,0.00,2267.38,0.24,1
22895,2522,1000.00,7600.74,8600.74,0.00,7600.74,0.34,1
22896,2522,1000.00,8600.74,9600.74,0.00,3712.16,0.22,1
22897,2522,1000.00,9600.74,10600.74,0.00,9600.74,0.22,1
22898,2522,1000.00,10600.74,11600.74,0.00,6404.41,0.26,1
22899,2522,1000.00,11600.74,12600.74,0.00,2603.18,0.19,1
22900,2522,1000.00,12600.74,13600.74,0.00,6436.99,0.12,1
22901,2522,1000.00,13600.74,14600.74,0.00,13600.74,0.20,1
22902,2522,1000.00,14600.74,15600.74,4465.06,10135.68,0.38,1
22903,2522,1000.00,15600.74,16600.74,0.00,14223.43,0.37,1
22904,2522,1000.00,16600.74,17600.74,0.00,16600.74,0.25,1
22905,2522,1000.00,17600.74,18600.74,0.00,14703.31,0.38,1
22906,2522,0.00,17600.74,18600.74,0.00,0.00,0.05,0
22907,2522,1000.00,18600.74,19600.74,8453.92,10146.83,0.13,1
22908,2523,1000.00,1000.00,2000.00,0.00,1000.00,0.25,1
22909,2523,1000.00,2000.00,3000.00,438.48,763.81,0.24,1
22910,2523,1000.00,3000.00,4000.00,0.00,1647.74,0.32,1
22911,2523,1000.00,4000.00,5000.00,464.02,3535.98,0.20,1
22912,2523,1000.00,5000.00,6000.00,2379.98,2620.02,0.25,1
22913,2523,1000.00,6000.00,7000.00,0.00,3723.21,0.08,1
22914,2523,1000.00,7000.00,8000.00,2637.37,4362.63,0.07,1
22915,2523,1000.00,8000.00,9000.00,2304.43,5695.57,0.34,1
22916,2523,1000.00,9000.00,10000.00,2610.41,6389.59,0.29,1
22917,2523,1000.00,10000.00,11000.00,170.20,9829.80,0.27,1
22918,2523,1000.00,11000.00,12000.00,5500.00,5500.00,0.15,1
22919,2523,1000.00,12000.00,13000.00,0.00,7745.22,0.35,1
22920,2523,1000.00,13000.00,14000.00,6500.00,6500.00,0.14,1
22921,2523,1000.00,14000.00,15000.00,910.03,12698.43,0.43,1
22922,2523,1000.00,15000.00,16000.00,4571.59,10428.41,0.18,1
22923,2523,1000.00,16000.00,17000.00,1580.83,2881.02,0.17,1
22924,2523,1000.00,17000.00,18000.00,0.00,17000.00,0.03,1
22925,2523,1000.00,18000.00,19000.00,8895.74,9104.26,0.24,1
22926,2523,1000.00,19000.00,20000.00,0.00,19000.00,0.31,1
22927,2523,-1000.00,18000.00,19000.00,10995.26,9004.74,0.39,0
22928,2523,1000.00,19000.00,20000.00,0.00,19000.00,0.02,1
22929,2523,-1000.00,18000.00,19000.00,15125.32,21.88,0.10,0
22930,2523,1000.00,19000.00,20000.00,0.00,19000.00,0.06,1
22931,2523,1000.00,20000.00,21000.00,0.00,20000.00,0.10,1
22932,2523,1000.00,21000.00,22000.00,2040.92,18959.08,0.44,1
22933,2523,1000.00,22000.00,23000.00,3968.29,18031.71,0.41,1
22934,2523,1000.00,23000.00,24000.00,0.00,23000.00,0.24,1
22935,2523,1000.00,24000.00,25000.00,4681.60,19318.40,0.12,1
22936,2523,-1000.00,23000.00,24000.00,12453.14,3952.00,0.12,0
22937,2523,1000.00,24000.00,25000.00,943.72,22856.73,0.44,1
22938,2523,-1000.00,23000.00,24000.00,18812.39,6187.61,0.23,0
22939,2523,-1000.00,22000.00,23000.00,14441.44,9558.56,0.13,0
22940,2523,1000.00,23000.00,24000.00,0.00,23000.00,0.42,1
22941,2523,1000.00,24000.00,25000.00,0.00,11943.19,0.31,1
22942,2523,1000.00,25000.00,26000.00,0.00,25000.00,0.34,1
22943,2523,1000.00,26000.00,27000.00,0.00,2026.17,0.04,1
22944,2523,1000.00,27000.00,28000.00,0.00,27000.00,0.43,1
22945,2523,1000.00,28000.00,29000.00,8440.44,19559.56,0.22,1
22946,2523,1000.00,29000.00,30000.00,0.00,29000.00,0.32,1
22947,2523,-1000.00,28000.00,29000.00,15839.16,14160.84,0.36,0
22948,2523,1000.00,29000.00,30000.00,13418.74,15581.26,0.39,1
22949,2523,1000.00,30000.00,31000.00,7666.95,22333.05,0.12,1
22950,2523,-1000.00,29000.00,30000.00,24825.24,6174.76,0.19,0
22951,2524,-1000.00,-1000.00,0.00,0.00,269.58,0.19,0
22952,2525,1000.00,1000.00,2000.00,36.57,729.87,0.40,1
22953,2525,-1000.00,0.00,1000.00,1888.87,0.00,0.02,0
22954,2525,1000.00,1000.00,2000.00,0.00,221.53,0.18,1
22955,2525,1000.00,2000.00,3000.00,0.00,1434.85,0.20,1
22956,2525,1000.00,3000.00,4000.00,0.00,3000.00,0.23,1
22957,2525,1000.00,4000.00,5000.00,0.00,4000.00,0.13,1
22958,2525,1000.00,5000.00,6000.00,851.81,4148.19,0.26,1
22959,2525,1000.00,6000.00,7000.00,2575.66,3424.34,0.20,1
22960,2525,1000.00,7000.00,8000.00,0.00,7000.00,0.15,1
22961,2525,1000.00,8000.00,9000.00,2883.96,5116.04,0.25,1
22962,2525,1000.00,9000.00,10000.00,2541.24,6458.76,0.16,1
22963,2525,1000.00,10000.00,11000.00,0.00,10000.00,0.22,1
22964,2525,-1000.00,9000.00,10000.00,6424.00,0.00,0.04,0
22965,2525,1000.00,10000.00,11000.00,0.00,6382.00,0.37,1
22966,2525,1000.00,11000.00,12000.00,4662.12,6337.88,0.38,1
22967,2525,1000.00,12000.00,13000.00,0.00,12000.00,0.41,1
22968,2525,1000.00,13000.00,14000.00,0.00,10894.68,0.08,1
22969,2525,1000.00,14000.00,15000.00,0.00,11842.96,0.41,1
22970,2525,1000.00,15000.00,16000.00,0.00,15000.00,0.24,1
22971,2525,-1000.00,14000.00,15000.00,0.00,5487.06,0.03,0
22972,2525,-1000.00,13000.00,14000.00,4778.20,10221.80,0.25,0
22973,2525,-1000.00,12000.00,13000.00,9881.77,4118.23,0.10,0
22974,2525,-1000.00,11000.00,12000.00,4503.63,8496.37,0.24,0
22975,2525,-1000.00,10000.00,11000.00,8306.65,3693.35,0.21,0
22976,2525,-1000.00,9000.00,10000.00,1839.50,9160.50,0.15,0
22977,2525,-1000.00,8000.00,9000.00,5000.00,5000.00,0.01,0
22978,2525,-1000.00,7000.00,8000.00,1800.51,7199.49,0.03,0
22979,2525,-1000.00,6000.00,7000.00,415.47,7584.53,0.41,0
22980,2525,-1000.00,5000.00,6000.00,3573.19,3426.81,0.19,0
22981,2525,-1000.00,4000.00,5000.00,0.00,4865.16,0.40,0
22982,2525,-1000.00,3000.00,4000.00,0.00,5000.00,0.22,0
22983,2525,-1000.00,2000.00,3000.00,0.00,3102.49,0.31,0
22984,2525,-1000.00,1000.00,2000.00,0.00,3000.00,0.02,0
22985,2525,-1000.00,0.00,1000.00,0.00,137.04,0.13,0
22986,2525,-1000.00,-1000.00,0.00,0.00,1000.00,0.26,0
22987,2526,-1000.00,-1000.00,0.00,740.44,259.56,0.07,0
22988,2527,-1000.00,-1000.00,0.00,263.05,736.95,0.15,0
22989,2528,-1000.00,-1000.00,0.00,0.00,1000.00,0.19,0
22990,2529,-1000.00,-1000.00,0.00,0.00,1000.00,0.29,0
22991,2530,-467.66,-467.66,532.34,0.00,467.66,0.30,0
22992,2530,-532.34,-1000.00,0.00,0.00,532.34,0.36,0
22993,2531,-963.83,-963.83,36.17,0.00,963.83,0.44,0
22994,2531,-31.26,-995.09,4.91,12.27,18.99,0.28,0
22995,2531,-4.91,-1000.00,0.00,1.76,3.15,0.19,0
22996,2532,-1000.00,-1000.00,0.00,125.97,874.03,0.43,0
22997,2533,1000.00,1000.00,2000.00,0.00,1000.00,0.17,1
22998,2533,1000.00,2000.00,3000.00,0.00,2000.00,0.28,1
22999,2533,1000.00,3000.00,4000.00,0.00,864.91,0.15,1
23000,2533,1000.00,4000.00,5000.00,0.00,4000.00,0.23,1
23001,2533,1000.00,5000.00,6000.00,1112.38,3887.62,0.40,1
23002,2533,1000.00,6000.00,7000.00,0.00,5147.74,0.27,1
23003,2533,1000.00,7000.00,8000.00,0.00,7000.00,0.36,1
23004,2533,1000.00,8000.00,9000.00,2106.83,5893.17,0.29,1
23005,2533,1000.00,9000.00,10000.00,0.00,6634.26,0.40,1
23006,2533,1000.00,10000.00,11000.00,0.00,914.96,0.13,1
23007,2533,1000.00,11000.00,12000.00,3137.33,4977.87,0.26,1
23008,2533,-1000.00,10000.00,11000.00,7883.08,4116.92,0.07,0
23009,2533,1000.00,11000.00,12000.00,3788.99,7211.01,0.16,1
23010,2533,1000.00,12000.00,13000.00,4847.58,7152.42,0.11,1
23011,2533,1000.00,13000.00,14000.00,0.00,13000.00,0.11,1
23012,2533,1000.00,14000.00,15000.00,2931.55,11068.45,0.21,1
23013,2533,1000.00,15000.00,16000.00,0.00,15000.00,0.35,1
23014,2533,1000.00,16000.00,17000.00,0.00,86.78,0.03,1
23015,2533,1000.00,17000.00,18000.00,0.00,17000.00,0.34,1
23016,2533,1000.00,18000.00,19000.00,590.37,17409.63,0.22,1
23017,2533,1000.00,19000.00,20000.00,9500.00,9500.00,0.21,1
23018,2533,-1000.00,18000.00,19000.00,15789.63,4210.37,0.18,0
23019,2533,1000.00,19000.00,20000.00,0.00,375.16,0.06,1
23020,2533,-1000.00,18000.00,19000.00,13342.60,6657.40,0.30,0
23021,2533,1000.00,19000.00,20000.00,0.00,5644.14,0.22,1
23022,2533,1000.00,20000.00,21000.00,0.00,20000.00,0.23,1
23023,2533,1000.00,21000.00,22000.00,0.00,20706.33,0.43,1
23024,2533,1000.00,22000.00,23000.00,0.00,11966.48,0.13,1
23025,2533,-1000.00,21000.00,22000.00,17040.40,5959.60,0.10,0
23026,2533,1000.00,22000.00,23000.00,8489.39,13510.61,0.06,1
23027,2533,1000.00,23000.00,24000.00,0.00,23000.00,0.37,1
23028,2533,1000.00,24000.00,25000.00,11922.04,12077.96,0.06,1
23029,2533,1000.00,25000.00,26000.00,12500.00,12500.00,0.19,1
23030,2533,1000.00,26000.00,27000.00,9386.58,16613.42,0.29,1
23031,2533,1000.00,27000.00,28000.00,0.00,17700.79,0.29,1
23032,2533,1000.00,28000.00,29000.00,0.00,28000.00,0.19,1
23033,2533,1000.00,29000.00,30000.00,398.36,23768.10,0.42,1
23034,2533,1000.00,30000.00,31000.00,0.00,18829.58,0.23,1
23035,2533,1000.00,31000.00,32000.00,0.00,19900.49,0.36,1
23036,2533,1000.00,32000.00,33000.00,0.00,20681.57,0.21,1
23037,2533,1000.00,33000.00,34000.00,16500.00,16500.00,0.25,1
23038,2533,1000.00,34000.00,35000.00,0.00,13611.49,0.16,1
23039,2533,1000.00,35000.00,36000.00,17500.00,17500.00,0.05,1
23040,2533,-1000.00,34000.00,35000.00,19102.93,16897.07,0.42,0
23041,2533,1000.00,35000.00,36000.00,0.00,14740.36,0.11,1
23042,2534,1000.00,1000.00,2000.00,407.57,592.43,0.23,1
23043,2534,1000.00,2000.00,3000.00,902.00,1098.00,0.23,1
23044,2534,1000.00,3000.00,4000.00,513.44,2486.56,0.42,1
23045,2534,0.00,3000.00,4000.00,0.00,0.00,0.04,0
23046,2534,1000.00,4000.00,5000.00,0.00,4000.00,0.26,1
23047,2534,1000.00,5000.00,6000.00,0.00,2386.18,0.26,1
23048,2534,1000.00,6000.00,7000.00,0.00,6000.00,0.16,1
23049,2534,1000.00,7000.00,8000.00,2602.61,4397.39,0.19,1
23050,2534,1000.00,8000.00,9000.00,0.00,5936.79,0.35,1
23051,2534,-1000.00,7000.00,8000.00,6061.87,2938.13,0.09,0
23052,2534,-1000.00,6000.00,7000.00,4960.59,3039.41,0.32,0
23053,2534,1000.00,7000.00,8000.00,0.00,1566.89,0.09,1
23054,2534,1000.00,8000.00,9000.00,0.00,8000.00,0.12,1
23055,2534,1000.00,9000.00,10000.00,0.00,9000.00,0.33,1
23056,2534,1000.00,10000.00,11000.00,4919.59,5080.41,0.16,1
23057,2534,-1000.00,9000.00,10000.00,6722.39,4277.61,0.23,0
23058,2534,-1000.00,8000.00,9000.00,5753.47,4246.53,0.32,0
23059,2534,1000.00,9000.00,10000.00,0.00,447.01,0.11,1
23060,2534,-1000.00,8000.00,9000.00,4308.70,5691.30,0.41,0
23061,2534,0.00,8000.00,9000.00,0.00,0.00,0.01,0
23062,2534,-1000.00,7000.00,8000.00,2121.57,6878.43,0.37,0
23063,2534,-1000.00,6000.00,7000.00,801.04,7198.96,0.32,0
23064,2534,-1000.00,5000.00,6000.00,3364.15,3635.85,0.15,0
23065,2534,-870.49,4129.51,5129.51,0.00,870.49,0.12,0
23066,2534,-1000.00,3129.51,4129.51,0.00,1763.14,0.22,0
23067,2534,-1000.00,2129.51,3129.51,1501.21,2113.72,0.27,0
23068,2534,-1000.00,1129.51,2129.51,0.00,1790.14,0.14,0
23069,2534,-1000.00,129.51,1129.51,1120.34,1009.17,0.19,0
23070,2534,-1000.00,-870.49,129.51,0.00,1129.51,0.24,0
23071,2534,-98.43,-968.92,31.08,0.00,98.43,0.33,0
23072,2534,-31.08,-1000.00,0.00,15.54,15.54,0.05,0
23073,2535,-1000.00,-1000.00,0.00,0.00,1000.00,0.29,0
23074,2536,-393.58,-393.58,606.42,151.17,242.41,0.40,0
23075,2536,-311.24,-704.82,295.18,0.00,311.24,0.41,0
23076,2536,1000.00,295.18,1295.18,19.89,0.00,0.06,1
23077,2536,1000.00,1295.18,2295.18,754.16,381.45,0.28,1
23078,2536,-1000.00,295.18,1295.18,115.73,1143.15,0.37,0
23079,2536,-1000.00,-704.82,295.18,0.00,1295.18,0.30,0
23080,2536,-295.18,-1000.00,0.00,0.00,295.18,0.32,0
23081,2537,-1000.00,-1000.00,0.00,367.32,632.68,0.27,0
23082,2538,-625.54,-625.54,374.46,0.00,625.54,0.33,0
23083,2538,-374.46,-1000.00,0.00,173.14,201.32,0.15,0
23084,2539,-1000.00,-1000.00,0.00,1000.00,0.00,0.00,0
23085,2540,-1000.00,-1000.00,0.00,547.33,452.67,0.12,0
23086,2541,-808.65,-808.65,191.35,109.73,698.92,0.39,0
23087,2541,-191.35,-1000.00,0.00,50.65,140.70,0.18,0
23088,2542,-1000.00,-1000.00,0.00,360.01,639.99,0.00,0
23089,2543,-1000.00,-1000.00,0.00,0.00,748.25,0.32,0
23090,2544,-944.84,-944.84,55.16,0.00,944.84,0.39,0
23091,2544,-55.16,-1000.00,0.00,19.70,35.46,0.29,0
23092,2545,-1000.00,-1000.00,0.00,333.57,666.43,0.33,0
23093,2546,-1000.00,-1000.00,0.00,337.69,662.31,0.19,0
23094,2547,-1000.00,-1000.00,0.00,7.05,952.35,0.44,0
23095,2548,-167.15,-167.15,832.85,0.00,167.15,0.23,0
23096,2548,-744.63,-911.79,88.21,132.78,611.85,0.43,0
23097,2548,1000.00,88.21,1088.21,56.56,31.66,0.15,1
23098,2548,-853.44,-765.23,234.77,0.00,853.44,0.01,0
23099,2548,-234.77,-1000.00,0.00,0.00,234.77,0.19,0
23100,2549,-1000.00,-1000.00,0.00,0.00,728.29,0.42,0
23101,2550,-1000.00,-1000.00,0.00,0.00,1000.00,0.07,0
23102,2551,-10.71,-10.71,989.29,0.00,10.71,0.18,0
23103,2551,-988.46,-999.18,0.82,0.00,988.46,0.34,0
23104,2551,166.78,-832.39,167.61,0.54,0.00,0.24,1
23105,2551,1000.00,167.61,1167.61,96.10,71.50,0.17,1
23106,2551,-690.68,-523.08,476.92,0.00,690.68,0.15,0
23107,2551,1000.00,476.92,1476.92,476.92,0.00,0.07,1
23108,2551,-113.69,363.23,1363.23,0.00,113.69,0.24,0
23109,2551,-1000.00,-636.77,363.23,180.97,1014.60,0.21,0
23110,2551,1000.00,363.23,1363.23,186.26,176.97,0.12,1
23111,2551,-1000.00,-636.77,363.23,224.41,1005.28,0.24,0
23112,2551,1000.00,363.23,1363.23,64.89,40.52,0.17,1
23113,2551,1000.00,1363.23,2363.23,829.40,0.00,0.21,1
23114,2551,0.00,1363.23,2363.23,0.00,0.00,0.40,0
23115,2551,1000.00,2363.23,3363.23,1424.01,939.22,0.25,1
23116,2551,1000.00,3363.23,4363.23,1320.05,1300.52,0.31,1
23117,2551,-253.81,3109.43,4109.43,0.00,253.81,0.43,0
23118,2551,0.00,3109.43,4109.43,0.00,0.00,0.13,0
23119,2551,-1000.00,2109.43,3109.43,0.00,1238.64,0.28,0
23120,2551,-1000.00,1109.43,2109.43,0.00,3109.43,0.00,0
23121,2551,-1000.00,109.43,1109.43,0.00,135.31,0.03,0
23122,2551,-1000.00,-890.57,109.43,409.91,699.52,0.20,0
23123,2551,0.00,-890.57,109.43,0.00,0.00,0.07,0
23124,2551,-1000.00,-1890.57,-890.57,0.00,57.03,0.44,0
23125,2552,1000.00,1000.00,2000.00,0.00,733.23,0.01,1
23126,2552,1000.00,2000.00,3000.00,0.00,1694.53,0.12,1
23127,2552,1000.00,3000.00,4000.00,0.00,1000.18,0.22,1
23128,2552,1000.00,4000.00,5000.00,1617.42,2382.58,0.39,1
23129,2552,-1000.00,3000.00,4000.00,1813.47,0.00,0.02,0
23130,2552,1000.00,4000.00,5000.00,840.54,3159.46,0.19,1
23131,2552,-1000.00,3000.00,4000.00,2744.91,2255.09,0.25,0
23132,2552,1000.00,4000.00,5000.00,1490.75,2185.66,0.27,1
23133,2552,1000.00,5000.00,6000.00,0.00,5000.00,0.35,1
23134,2552,1000.00,6000.00,7000.00,0.00,6000.00,0.25,1
23135,2552,1000.00,7000.00,8000.00,1638.50,5361.50,0.39,1
23136,2552,1000.00,8000.00,9000.00,0.00,5566.51,0.39,1
23137,2552,1000.00,9000.00,10000.00,0.00,2315.07,0.21,1
23138,2552,1000.00,10000.00,11000.00,0.00,8970.95,0.22,1
23139,2552,-1000.00,9000.00,10000.00,9142.06,1857.94,0.02,0
23140,2552,1000.00,10000.00,11000.00,0.00,10000.00,0.44,1
23141,2552,1000.00,11000.00,12000.00,0.00,4616.04,0.28,1
23142,2552,1000.00,12000.00,13000.00,0.00,8958.79,0.40,1
23143,2552,1000.00,13000.00,14000.00,0.00,13000.00,0.01,1
23144,2552,1000.00,14000.00,15000.00,4087.94,9912.06,0.38,1
23145,2552,1000.00,15000.00,16000.00,74.21,5463.51,0.24,1
23146,2552,1000.00,16000.00,17000.00,6673.35,9326.65,0.25,1
23147,2552,1000.00,17000.00,18000.00,0.00,17000.00,0.37,1
23148,2552,-1000.00,16000.00,17000.00,12467.34,1570.37,0.12,0
23149,2552,-1000.00,15000.00,16000.00,0.00,17000.00,0.03,0
23150,2552,-1000.00,14000.00,15000.00,0.00,11475.75,0.37,0
23151,2552,-1000.00,13000.00,14000.00,306.91,14617.93,0.44,0
23152,2552,-1000.00,12000.00,13000.00,3174.56,10825.44,0.13,0
23153,2552,-1000.00,11000.00,12000.00,5403.66,7596.34,0.16,0
23154,2552,-1000.00,10000.00,11000.00,6000.00,6000.00,0.05,0
23155,2552,-1000.00,9000.00,10000.00,7323.93,3676.07,0.07,0
23156,2552,-1000.00,8000.00,9000.00,0.00,10000.00,0.26,0
23157,2552,-1000.00,7000.00,8000.00,4493.11,4506.89,0.36,0
23158,2552,-1000.00,6000.00,7000.00,1465.52,6534.48,0.40,0
23159,2552,-1000.00,5000.00,6000.00,0.00,4924.65,0.21,0
23160,2552,-1000.00,4000.00,5000.00,0.00,5207.13,0.40,0
23161,2552,-1000.00,3000.00,4000.00,3268.21,1731.79,0.07,0
23162,2552,-1000.00,2000.00,3000.00,0.00,4000.00,0.14,0
23163,2552,-1000.00,1000.00,2000.00,444.58,2249.34,0.39,0
23164,2552,-1000.00,0.00,1000.00,0.00,2000.00,0.42,0
23165,2552,-1000.00,-1000.00,0.00,148.39,851.61,0.35,0
23166,2553,-687.41,-687.41,312.59,252.29,435.12,0.26,0
23167,2553,-312.59,-1000.00,0.00,26.30,286.29,0.43,0
23168,2554,1000.00,1000.00,2000.00,364.54,635.46,0.28,1
23169,2554,1000.00,2000.00,3000.00,179.60,1820.40,0.44,1
23170,2554,1000.00,3000.00,4000.00,0.00,3000.00,0.33,1
23171,2554,1000.00,4000.00,5000.00,0.00,4000.00,0.11,1
23172,2554,1000.00,5000.00,6000.00,1867.46,3132.54,0.26,1
23173,2554,1000.00,6000.00,7000.00,609.94,4923.12,0.42,1
23174,2554,1000.00,7000.00,8000.00,2591.48,4408.52,0.30,1
23175,2554,-1000.00,6000.00,7000.00,2996.62,2457.91,0.19,0
23176,2554,1000.00,7000.00,8000.00,0.00,3611.33,0.32,1
23177,2554,1000.00,8000.00,9000.00,480.77,990.71,0.15,1
23178,2554,1000.00,9000.00,10000.00,0.00,7677.62,0.12,1
23179,2554,1000.00,10000.00,11000.00,450.88,9549.12,0.28,1
23180,2554,1000.00,11000.00,12000.00,2375.33,7280.43,0.35,1
23181,2554,1000.00,12000.00,13000.00,2803.56,9196.44,0.21,1
23182,2554,1000.00,13000.00,14000.00,5081.67,7918.33,0.40,1
23183,2554,1000.00,14000.00,15000.00,2813.55,11186.45,0.29,1
23184,2554,1000.00,15000.00,16000.00,1879.38,13120.62,0.10,1
23185,2554,-1000.00,14000.00,15000.00,8234.65,113.88,0.08,0
23186,2554,-1000.00,13000.00,14000.00,0.00,6854.25,0.19,0
23187,2554,-1000.00,12000.00,13000.00,8575.92,5424.08,0.04,0
23188,2554,-1000.00,11000.00,12000.00,0.00,13000.00,0.29,0
23189,2554,-1000.00,10000.00,11000.00,6574.14,5425.86,0.32,0
23190,2554,-1000.00,9000.00,10000.00,0.00,9464.73,0.38,0
23191,2554,-1000.00,8000.00,9000.00,686.02,7541.33,0.40,0
23192,2554,-1000.00,7000.00,8000.00,0.00,9000.00,0.08,0
23193,2554,-1000.00,6000.00,7000.00,0.00,6301.01,0.41,0
23194,2554,-1000.00,5000.00,6000.00,0.00,6617.72,0.43,0
23195,2554,-1000.00,4000.00,5000.00,1074.94,4925.06,0.20,0
23196,2554,-1000.00,3000.00,4000.00,586.95,4413.05,0.41,0
23197,2554,-1000.00,2000.00,3000.00,2839.04,1160.96,0.10,0
23198,2554,-1000.00,1000.00,2000.00,0.00,3000.00,0.32,0
23199,2554,-1000.00,0.00,1000.00,918.60,484.58,0.15,0
23200,2554,-1000.00,-1000.00,0.00,202.33,0.00,0.08,0
23201,2555,-1000.00,-1000.00,0.00,0.00,1000.00,0.05,0
23202,2556,-961.22,-961.22,38.78,634.48,326.74,0.15,0
23203,2556,1000.00,38.78,1038.78,0.33,38.45,0.06,1
23204,2556,1000.00,1038.78,2038.78,277.27,761.51,0.38,1
23205,2556,1000.00,2038.78,3038.78,584.28,1454.50,0.34,1
23206,2556,-1000.00,1038.78,2038.78,1894.00,1144.78,0.00,0
23207,2556,-462.59,576.19,1576.19,406.72,55.87,0.11,0
23208,2556,0.00,576.19,1576.19,0.00,0.00,0.05,0
23209,2556,-1000.00,-423.81,576.19,819.02,530.13,0.17,0
23210,2556,1000.00,576.19,1576.19,15.83,389.63,0.38,1
23211,2556,-1000.00,-423.81,576.19,906.00,670.19,0.30,0
23212,2556,1000.00,576.19,1576.19,280.97,295.22,0.09,1
23213,2556,-1000.00,-423.81,576.19,1144.31,431.88,0.10,0
23214,2556,-576.19,-1000.00,0.00,312.72,263.47,0.17,0
23215,2557,0.00,0.00,1000.00,0.00,0.00,0.06,0
23216,2557,1000.00,1000.00,2000.00,29.55,970.45,0.42,1
23217,2557,1000.00,2000.00,3000.00,0.00,1371.40,0.19,1
23218,2557,1000.00,3000.00,4000.00,0.00,2014.59,0.03,1
23219,2557,1000.00,4000.00,5000.00,0.00,736.67,0.15,1
23220,2557,0.00,4000.00,5000.00,0.00,0.00,0.02,0
23221,2557,1000.00,5000.00,6000.00,0.00,4655.54,0.23,1
23222,2557,-1000.00,4000.00,5000.00,3104.49,2895.51,0.23,0
23223,2557,-1000.00,3000.00,4000.00,3033.44,0.00,0.04,0
23224,2557,1000.00,4000.00,5000.00,0.00,2505.21,0.09,1
23225,2557,1000.00,5000.00,6000.00,2168.85,2831.15,0.36,1
23226,2557,1000.00,6000.00,7000.00,0.00,6000.00,0.07,1
23227,2557,0.00,6000.00,7000.00,0.00,0.00,0.02,0
23228,2557,1000.00,7000.00,8000.00,219.29,6780.71,0.43,1
23229,2557,-1000.00,6000.00,7000.00,4139.60,3860.40,0.20,0
23230,2557,-1000.00,5000.00,6000.00,3643.22,3356.78,0.41,0
23231,2557,-1000.00,4000.00,5000.00,4841.02,0.00,0.03,0
23232,2557,1000.00,5000.00,6000.00,2310.69,2689.31,0.04,1
23233,2557,1000.00,6000.00,7000.00,0.00,5502.11,0.44,1
23234,2557,1000.00,7000.00,8000.00,139.69,6860.31,0.11,1
23235,2557,1000.00,8000.00,9000.00,4000.00,4000.00,0.26,1
23236,2557,1000.00,9000.00,10000.00,0.00,9000.00,0.14,1
23237,2557,1000.00,10000.00,11000.00,0.00,10000.00,0.21,1
23238,2557,1000.00,11000.00,12000.00,0.00,6978.63,0.07,1
23239,2557,1000.00,12000.00,13000.00,0.00,12000.00,0.39,1
23240,2557,1000.00,13000.00,14000.00,0.00,7445.02,0.34,1
23241,2557,1000.00,14000.00,15000.00,0.00,9169.04,0.37,1
23242,2557,1000.00,15000.00,16000.00,1360.21,11009.51,0.40,1
23243,2557,-1000.00,14000.00,15000.00,4269.32,3251.95,0.17,0
23244,2557,1000.00,15000.00,16000.00,0.00,8300.59,0.12,1
23245,2557,1000.00,16000.00,17000.00,0.00,10359.46,0.11,1
23246,2557,1000.00,17000.00,18000.00,0.00,17000.00,0.19,1
23247,2557,1000.00,18000.00,19000.00,0.00,15795.77,0.37,1
23248,2557,1000.00,19000.00,20000.00,0.00,17675.13,0.22,1
23249,2557,-82.01,18917.99,19917.99,82.01,0.00,0.03,0
23250,2557,1000.00,19917.99,20917.99,0.00,12284.12,0.35,1
23251,2557,1000.00,20917.99,21917.99,0.00,20917.99,0.27,1
23252,2557,1000.00,21917.99,22917.99,0.00,18185.81,0.33,1
23253,2557,1000.00,22917.99,23917.99,0.00,18926.13,0.21,1
23254,2557,1000.00,23917.99,24917.99,0.00,23917.99,0.30,1
23255,2557,1000.00,24917.99,25917.99,0.00,24917.99,0.22,1
23256,2557,1000.00,25917.99,26917.99,12959.00,12959.00,0.04,1
23257,2557,1000.00,26917.99,27917.99,0.00,13753.37,0.15,1
23258,2557,-1000.00,25917.99,26917.99,14665.04,13252.95,0.00,0
23259,2557,-1000.00,24917.99,25917.99,16489.20,0.00,0.09,0
23260,2557,-1000.00,23917.99,24917.99,1752.71,0.00,0.05,0
23261,2557,-1000.00,22917.99,23917.99,12016.76,12901.23,0.13,0
23262,2557,-1000.00,21917.99,22917.99,5188.63,18729.36,0.27,0
23263,2557,-1000.00,20917.99,21917.99,0.00,9440.72,0.22,0
23264,2557,-1000.00,19917.99,20917.99,10718.34,11199.65,0.23,0
23265,2557,-1000.00,18917.99,19917.99,3064.34,17853.66,0.44,0
23266,2557,-1000.00,17917.99,18917.99,0.00,15776.51,0.38,0
23267,2557,-1000.00,16917.99,17917.99,2624.39,16293.60,0.06,0
23268,2557,-1000.00,15917.99,16917.99,0.00,17917.99,0.44,0
23269,2557,-1000.00,14917.99,15917.99,0.00,9182.80,0.31,0
23270,2557,-1000.00,13917.99,14917.99,0.00,5479.59,0.24,0
23271,2557,-1000.00,12917.99,13917.99,0.00,11575.06,0.37,0
23272,2557,-1000.00,11917.99,12917.99,1291.33,12626.66,0.43,0
23273,2557,-1000.00,10917.99,11917.99,10857.67,0.00,0.02,0
23274,2557,-1000.00,9917.99,10917.99,2045.53,9872.46,0.06,0
23275,2557,-1000.00,8917.99,9917.99,3595.85,7322.14,0.11,0
23276,2557,-1000.00,7917.99,8917.99,759.97,6091.90,0.21,0
23277,2557,0.00,7917.99,8917.99,0.00,0.00,0.04,0
23278,2557,-1000.00,6917.99,7917.99,1454.88,5246.21,0.34,0
23279,2557,-1000.00,5917.99,6917.99,3212.82,2668.80,0.19,0
23280,2557,-1000.00,4917.99,5917.99,0.00,6917.99,0.22,0
23281,2557,-1000.00,3917.99,4917.99,0.00,1894.31,0.16,0
23282,2557,-1000.00,2917.99,3917.99,0.00,4140.75,0.43,0
23283,2558,-1000.00,-1000.00,0.00,446.13,553.87,0.18,0
23284,2559,1000.00,1000.00,2000.00,0.00,1000.00,0.12,1
23285,2559,-1000.00,0.00,1000.00,1433.42,566.58,0.11,0
23286,2559,1000.00,1000.00,2000.00,0.00,1000.00,0.16,1
23287,2559,1000.00,2000.00,3000.00,1000.00,1000.00,0.31,1
23288,2559,-1000.00,1000.00,2000.00,1666.03,1333.97,0.06,0
23289,2559,1000.00,2000.00,3000.00,97.91,1902.09,0.30,1
23290,2559,1000.00,3000.00,4000.00,0.00,3000.00,0.23,1
23291,2559,1000.00,4000.00,5000.00,37.16,3962.84,0.39,1
23292,2559,1000.00,5000.00,6000.00,0.00,5000.00,0.31,1
23293,2559,1000.00,6000.00,7000.00,2552.17,3447.83,0.10,1
23294,2559,1000.00,7000.00,8000.00,0.00,7000.00,0.23,1
23295,2559,1000.00,8000.00,9000.00,0.00,6897.83,0.09,1
23296,2559,1000.00,9000.00,10000.00,0.00,9000.00,0.37,1
23297,2559,1000.00,10000.00,11000.00,0.00,10000.00,0.10,1
23298,2559,1000.00,11000.00,12000.00,80.60,10919.40,0.44,1
23299,2559,-1000.00,10000.00,11000.00,3467.79,685.19,0.11,0
23300,2559,1000.00,11000.00,12000.00,5232.18,5767.82,0.05,1
23301,2559,1000.00,12000.00,13000.00,0.00,12000.00,0.38,1
23302,2559,1000.00,13000.00,14000.00,5228.45,7771.55,0.24,1
23303,2559,1000.00,14000.00,15000.00,7000.00,7000.00,0.01,1
23304,2559,1000.00,15000.00,16000.00,0.00,4069.57,0.08,1
23305,2559,1000.00,16000.00,17000.00,2977.75,13022.25,0.39,1
23306,2559,1000.00,17000.00,18000.00,0.00,17000.00,0.00,1
23307,2559,1000.00,18000.00,19000.00,2668.00,15332.00,0.34,1
23308,2559,-1000.00,17000.00,18000.00,10588.67,8411.33,0.31,0
23309,2559,-1000.00,16000.00,17000.00,4284.78,13715.22,0.33,0
23310,2559,-1000.00,15000.00,16000.00,0.00,17000.00,0.04,0
23311,2559,-1000.00,14000.00,15000.00,2164.66,13835.34,0.41,0
23312,2559,-1000.00,13000.00,14000.00,0.00,15000.00,0.13,0
23313,2559,-1000.00,12000.00,13000.00,5204.38,0.00,0.05,0
23314,2559,-1000.00,11000.00,12000.00,0.00,13000.00,0.33,0
23315,2559,-1000.00,10000.00,11000.00,2778.95,6090.33,0.30,0
23316,2559,-1000.00,9000.00,10000.00,0.00,11000.00,0.23,0
23317,2559,-1000.00,8000.00,9000.00,5016.79,4983.21,0.44,0
23318,2559,-1000.00,7000.00,8000.00,0.00,8322.51,0.43,0
23319,2559,-1000.00,6000.00,7000.00,1309.45,6690.55,0.16,0
23320,2559,-1000.00,5000.00,6000.00,5113.18,0.00,0.05,0
23321,2559,-1000.00,4000.00,5000.00,0.00,1584.92,0.21,0
23322,2559,-1000.00,3000.00,4000.00,1989.48,3010.52,0.19,0
23323,2559,-1000.00,2000.00,3000.00,78.87,3921.13,0.33,0
23324,2559,-1000.00,1000.00,2000.00,1988.89,1011.11,0.23,0
23325,2559,-1000.00,0.00,1000.00,210.06,1789.94,0.44,0
23326,2559,-1000.00,-1000.00,0.00,375.73,624.27,0.16,0
23327,2560,-1000.00,-1000.00,0.00,0.00,1000.00,0.09,0
23328,2561,1000.00,1000.00,2000.00,312.20,687.80,0.33,1
23329,2561,1000.00,2000.00,3000.00,552.98,1447.02,0.36,1
23330,2561,1000.00,3000.00,4000.00,1500.00,1500.00,0.04,1
23331,2561,1000.00,4000.00,5000.00,839.67,3160.33,0.40,1
23332,2561,1000.00,5000.00,6000.00,0.00,5000.00,0.24,1
23333,2561,1000.00,6000.00,7000.00,2627.92,3372.08,0.32,1
23334,2561,1000.00,7000.00,8000.00,0.00,7000.00,0.14,1
23335,2561,1000.00,8000.00,9000.00,1613.19,6386.81,0.27,1
23336,2561,1000.00,9000.00,10000.00,2577.80,6422.20,0.36,1
23337,2561,1000.00,10000.00,11000.00,0.00,10000.00,0.25,1
23338,2561,1000.00,11000.00,12000.00,5245.26,5754.74,0.12,1
23339,2561,1000.00,12000.00,13000.00,6000.00,6000.00,0.06,1
23340,2561,1000.00,13000.00,14000.00,0.00,13000.00,0.05,1
23341,2561,1000.00,14000.00,15000.00,3708.91,10291.09,0.32,1
23342,2561,-1000.00,13000.00,14000.00,4601.65,2661.50,0.16,0
23343,2561,1000.00,14000.00,15000.00,7000.00,7000.00,0.06,1
23344,2561,0.00,14000.00,15000.00,0.00,0.00,0.06,0
23345,2561,1000.00,15000.00,16000.00,0.00,15000.00,0.12,1
23346,2561,-1000.00,14000.00,15000.00,10204.97,5795.03,0.08,0
23347,2561,1000.00,15000.00,16000.00,7500.00,7500.00,0.01,1
23348,2561,-1000.00,14000.00,15000.00,12564.94,3435.06,0.20,0
23349,2561,1000.00,15000.00,16000.00,0.00,15000.00,0.31,1
23350,2561,1000.00,16000.00,17000.00,6102.21,9897.79,0.14,1
23351,2561,1000.00,17000.00,18000.00,3665.99,13334.01,0.38,1
23352,2561,-1000.00,16000.00,17000.00,7584.45,10415.55,0.30,0
23353,2561,-1000.00,15000.00,16000.00,0.00,17000.00,0.14,0
23354,2561,-1000.00,14000.00,15000.00,0.00,15473.23,0.13,0
23355,2561,-1000.00,13000.00,14000.00,0.00,14979.64,0.29,0
23356,2561,-1000.00,12000.00,13000.00,6662.65,7337.35,0.13,0
23357,2561,-1000.00,11000.00,12000.00,0.00,11048.09,0.35,0
23358,2561,-1000.00,10000.00,11000.00,2104.52,9895.48,0.35,0
23359,2561,-1000.00,9000.00,10000.00,1464.13,9535.87,0.36,0
23360,2561,-1000.00,8000.00,9000.00,0.00,10000.00,0.05,0
23361,2561,-1000.00,7000.00,8000.00,0.00,7995.20,0.34,0
23362,2561,-1000.00,6000.00,7000.00,2842.25,5157.75,0.35,0
23363,2561,-1000.00,5000.00,6000.00,2863.83,4136.17,0.43,0
23364,2561,-116.05,4883.95,5883.95,0.00,116.05,0.02,0
23365,2561,-1000.00,3883.95,4883.95,0.00,5883.95,0.41,0
23366,2561,-1000.00,2883.95,3883.95,1101.18,3682.19,0.38,0
23367,2561,-1000.00,1883.95,2883.95,0.00,2854.76,0.14,0
23368,2561,-1000.00,883.95,1883.95,0.00,2883.95,0.09,0
23369,2561,-1000.00,-116.05,883.95,826.04,1057.91,0.37,0
23370,2561,-883.95,-1000.00,0.00,425.77,458.18,0.20,0
23371,2562,1000.00,1000.00,2000.00,0.00,840.36,0.16,1
23372,2562,1000.00,2000.00,3000.00,480.95,1519.05,0.31,1
23373,2562,1000.00,3000.00,4000.00,642.49,2357.51,0.40,1
23374,2562,1000.00,4000.00,5000.00,0.00,4000.00,0.08,1
23375,2562,1000.00,5000.00,6000.00,2121.75,2878.25,0.10,1
23376,2562,1000.00,6000.00,7000.00,2392.06,3607.94,0.21,1
23377,2562,-1000.00,5000.00,6000.00,3866.80,3133.20,0.14,0
23378,2562,1000.00,6000.00,7000.00,2192.83,3807.17,0.31,1
23379,2562,1000.00,7000.00,8000.00,316.87,5647.48,0.42,1
23380,2562,1000.00,8000.00,9000.00,4000.00,4000.00,0.35,1
23381,2562,1000.00,9000.00,10000.00,0.00,9000.00,0.19,1
23382,2562,1000.00,10000.00,11000.00,1965.58,8034.42,0.23,1
23383,2562,1000.00,11000.00,12000.00,0.00,11000.00,0.16,1
23384,2562,1000.00,12000.00,13000.00,0.00,11659.97,0.44,1
23385,2562,-1000.00,11000.00,12000.00,13000.00,0.00,0.00,0
23386,2562,1000.00,12000.00,13000.00,5156.08,6843.92,0.24,1
23387,2562,-1000.00,11000.00,12000.00,7310.93,5689.07,0.40,0
23388,2562,1000.00,12000.00,13000.00,3242.43,8757.57,0.30,1
23389,2562,1000.00,13000.00,14000.00,3044.76,9955.24,0.41,1
23390,2562,1000.00,14000.00,15000.00,7000.00,7000.00,0.18,1
23391,2562,1000.00,15000.00,16000.00,554.30,14445.70,0.24,1
23392,2562,1000.00,16000.00,17000.00,7195.85,8804.15,0.17,1
23393,2562,1000.00,17000.00,18000.00,0.00,13485.96,0.30,1
23394,2562,1000.00,18000.00,19000.00,3600.92,14399.08,0.40,1
23395,2562,1000.00,19000.00,20000.00,294.77,18705.23,0.44,1
23396,2562,1000.00,20000.00,21000.00,5066.11,14933.89,0.27,1
23397,2562,1000.00,21000.00,22000.00,0.00,8898.73,0.15,1
23398,2562,1000.00,22000.00,23000.00,0.00,6498.23,0.22,1
23399,2562,1000.00,23000.00,24000.00,0.00,22555.37,0.34,1
23400,2562,1000.00,24000.00,25000.00,1523.37,8984.70,0.26,1
23401,2562,1000.00,25000.00,26000.00,0.00,25000.00,0.12,1
23402,2562,1000.00,26000.00,27000.00,6098.74,16385.93,0.18,1
23403,2562,1000.00,27000.00,28000.00,0.00,27000.00,0.08,1
23404,2562,1000.00,28000.00,29000.00,0.00,28000.00,0.03,1
23405,2562,1000.00,29000.00,30000.00,0.00,29000.00,0.24,1
23406,2562,0.00,29000.00,30000.00,0.00,0.00,0.04,0
23407,2562,1000.00,30000.00,31000.00,7316.72,15262.01,0.29,1
23408,2562,1000.00,31000.00,32000.00,15500.00,15500.00,0.25,1
23409,2563,-1000.00,-1000.00,0.00,500.00,500.00,0.00,0
23410,2564,1000.00,1000.00,2000.00,0.00,595.73,0.11,1
23411,2564,1000.00,2000.00,3000.00,0.00,2000.00,0.33,1
23412,2564,-326.04,1673.96,2673.96,326.04,0.00,0.09,0
23413,2564,1000.00,2673.96,3673.96,0.00,2198.55,0.31,1
23414,2564,1000.00,3673.96,4673.96,1303.37,2370.59,0.30,1
23415,2564,1000.00,4673.96,5673.96,2336.98,2336.98,0.31,1
23416,2564,1000.00,5673.96,6673.96,2297.01,3376.95,0.15,1
23417,2564,1000.00,6673.96,7673.96,0.00,6673.96,0.16,1
23418,2564,1000.00,7673.96,8673.96,0.00,7673.96,0.43,1
23419,2564,1000.00,8673.96,9673.96,0.00,8673.96,0.43,1
23420,2564,1000.00,9673.96,10673.96,0.00,331.67,0.12,1
23421,2564,-1000.00,8673.96,9673.96,5738.75,4935.20,0.17,0
23422,2564,1000.00,9673.96,10673.96,0.00,9673.96,0.11,1
23423,2564,1000.00,10673.96,11673.96,0.00,6834.40,0.27,1
23424,2564,1000.00,11673.96,12673.96,0.00,11673.96,0.14,1
23425,2564,-1000.00,10673.96,11673.96,7166.91,5507.04,0.21,0
23426,2564,1000.00,11673.96,12673.96,5836.98,5836.98,0.14,1
23427,2564,1000.00,12673.96,13673.96,0.00,9860.32,0.36,1
23428,2564,0.00,12673.96,13673.96,0.00,0.00,0.05,0
23429,2564,1000.00,13673.96,14673.96,0.00,13673.96,0.19,1
23430,2564,1000.00,14673.96,15673.96,0.00,14673.96,0.13,1
23431,2564,1000.00,15673.96,16673.96,0.00,15673.96,0.32,1
23432,2564,1000.00,16673.96,17673.96,0.00,16673.96,0.34,1
23433,2564,1000.00,17673.96,18673.96,4668.01,13005.94,0.19,1
23434,2564,-1000.00,16673.96,17673.96,9907.12,8766.84,0.15,0
23435,2564,-1000.00,15673.96,16673.96,7941.75,9732.21,0.22,0
23436,2564,-1000.00,14673.96,15673.96,5651.69,11022.27,0.18,0
23437,2564,-1000.00,13673.96,14673.96,5786.93,9887.03,0.13,0
23438,2564,-1000.00,12673.96,13673.96,11265.61,1980.86,0.07,0
23439,2564,-1000.00,11673.96,12673.96,6836.98,6836.98,0.39,0
23440,2564,-1000.00,10673.96,11673.96,0.00,12673.96,0.11,0
23441,2564,-1000.00,9673.96,10673.96,0.00,11673.96,0.10,0
23442,2564,-1000.00,8673.96,9673.96,0.00,10673.96,0.02,0
23443,2564,-1000.00,7673.96,8673.96,2328.17,0.00,0.04,0
23444,2564,-1000.00,6673.96,7673.96,0.00,8673.96,0.25,0
23445,2564,-1000.00,5673.96,6673.96,0.00,7230.96,0.07,0
23446,2564,-1000.00,4673.96,5673.96,1721.12,4952.84,0.36,0
23447,2564,-1000.00,3673.96,4673.96,0.00,3149.27,0.14,0
23448,2564,-1000.00,2673.96,3673.96,0.00,4673.96,0.39,0
23449,2564,-1000.00,1673.96,2673.96,0.00,2562.54,0.17,0
23450,2564,-1000.00,673.96,1673.96,643.17,915.01,0.23,0
23451,2564,-1000.00,-326.04,673.96,0.00,1229.15,0.41,0
23452,2564,-643.96,-970.00,30.00,0.00,643.96,0.27,0
23453,2564,-16.05,-986.05,13.95,0.21,15.84,0.33,0
23454,2564,-13.95,-1000.00,0.00,0.00,13.95,0.15,0
23455,2565,-943.90,-943.90,56.10,0.00,943.90,0.43,0
23456,2565,-52.65,-996.54,3.46,24.42,28.22,0.24,0
23457,2565,-3.46,-1000.00,0.00,0.00,3.46,0.11,0
23458,2566,-1000.00,-1000.00,0.00,0.00,635.40,0.43,0
23459,2567,-1000.00,-1000.00,0.00,50.17,569.15,0.34,0
23460,2568,0.00,0.00,1000.00,0.00,0.00,0.15,0
23461,2568,-1000.00,-1000.00,0.00,0.00,497.74,0.12,0
23462,2569,-1000.00,-1000.00,0.00,0.00,1000.00,0.36,0
23463,2570,1000.00,1000.00,2000.00,383.59,616.41,0.25,1
23464,2570,1000.00,2000.00,3000.00,0.00,1851.87,0.20,1
23465,2570,1000.00,3000.00,4000.00,1283.06,1716.94,0.18,1
23466,2570,1000.00,4000.00,5000.00,1559.62,2440.38,0.22,1
23467,2570,-1000.00,3000.00,4000.00,0.00,5000.00,0.42,0
23468,2570,-1000.00,2000.00,3000.00,145.69,3854.31,0.13,0
23469,2570,-1000.00,1000.00,2000.00,1620.34,785.08,0.14,0
23470,2570,-1000.00,0.00,1000.00,1197.07,802.93,0.09,0
23471,2570,-1000.00,-1000.00,0.00,0.00,933.87,0.44,0
23472,2571,-1000.00,-1000.00,0.00,369.01,630.99,0.19,0
23473,2571,-0.00,-1000.00,-0.00,0.00,0.00,0.18,0
23474,2572,1000.00,1000.00,2000.00,0.00,701.10,0.20,1
23475,2572,1000.00,2000.00,3000.00,0.00,2000.00,0.21,1
23476,2572,1000.00,3000.00,4000.00,0.00,1382.00,0.25,1
23477,2572,1000.00,4000.00,5000.00,0.00,4000.00,0.01,1
23478,2572,1000.00,5000.00,6000.00,76.83,4923.17,0.44,1
23479,2572,1000.00,6000.00,7000.00,2759.06,3240.94,0.18,1
23480,2572,-1000.00,5000.00,6000.00,7000.00,0.00,0.04,0
23481,2572,1000.00,6000.00,7000.00,88.70,5911.30,0.44,1
23482,2572,1000.00,7000.00,8000.00,0.00,3735.31,0.21,1
23483,2572,1000.00,8000.00,9000.00,0.00,8000.00,0.12,1
23484,2572,1000.00,9000.00,10000.00,1090.19,7909.81,0.44,1
23485,2572,1000.00,10000.00,11000.00,2316.55,7683.45,0.39,1
23486,2572,1000.00,11000.00,12000.00,3308.53,7691.47,0.28,1
23487,2572,1000.00,12000.00,13000.00,0.00,12000.00,0.17,1
23488,2572,1000.00,13000.00,14000.00,5579.69,7420.31,0.18,1
23489,2572,1000.00,14000.00,15000.00,0.00,14000.00,0.06,1
23490,2572,-1000.00,13000.00,14000.00,8333.93,6666.07,0.06,0
23491,2572,1000.00,14000.00,15000.00,5523.61,8476.39,0.30,1
23492,2572,1000.00,15000.00,16000.00,0.00,15000.00,0.10,1
23493,2572,1000.00,16000.00,17000.00,0.00,8336.45,0.29,1
23494,2572,-1000.00,15000.00,16000.00,9672.62,7327.38,0.18,0
23495,2572,-1000.00,14000.00,15000.00,1371.07,0.00,0.03,0
23496,2572,1000.00,15000.00,16000.00,7500.00,7500.00,0.32,1
23497,2572,1000.00,16000.00,17000.00,0.00,11503.00,0.21,1
23498,2572,1000.00,17000.00,18000.00,8316.37,8683.63,0.36,1
23499,2572,1000.00,18000.00,19000.00,0.00,11886.97,0.35,1
23500,2572,1000.00,19000.00,20000.00,8914.01,10085.99,0.13,1
23501,2572,1000.00,20000.00,21000.00,10000.00,10000.00,0.02,1
23502,2572,0.00,20000.00,21000.00,0.00,0.00,0.06,0
23503,2572,1000.00,21000.00,22000.00,10500.00,10500.00,0.01,1
23504,2572,1000.00,22000.00,23000.00,8632.51,13367.49,0.24,1
23505,2572,1000.00,23000.00,24000.00,0.00,23000.00,0.18,1
23506,2572,1000.00,24000.00,25000.00,0.00,12438.49,0.31,1
23507,2572,1000.00,25000.00,26000.00,1492.08,23507.92,0.40,1
23508,2572,1000.00,26000.00,27000.00,10743.38,15256.62,0.40,1
23509,2572,1000.00,27000.00,28000.00,0.00,27000.00,0.20,1
23510,2572,1000.00,28000.00,29000.00,11078.27,16921.73,0.14,1
23511,2572,1000.00,29000.00,30000.00,0.00,20255.45,0.18,1
23512,2572,1000.00,30000.00,31000.00,12871.51,17128.49,0.08,1
23513,2572,1000.00,31000.00,32000.00,0.00,31000.00,0.29,1
23514,2572,1000.00,32000.00,33000.00,12730.70,19269.30,0.29,1
23515,2572,1000.00,33000.00,34000.00,0.00,33000.00,0.21,1
23516,2572,1000.00,34000.00,35000.00,0.00,34000.00,0.05,1
23517,2572,1000.00,35000.00,36000.00,0.00,6896.44,0.02,1
23518,2572,1000.00,36000.00,37000.00,9811.52,26188.48,0.34,1
23519,2572,1000.00,37000.00,38000.00,0.00,6997.46,0.01,1
23520,2573,-1000.00,-1000.00,0.00,31.94,0.00,0.03,0
23521,2574,-1000.00,-1000.00,0.00,0.00,20.37,0.16,0
23522,2575,1000.00,1000.00,2000.00,322.34,182.10,0.25,1
23523,2575,0.00,1000.00,2000.00,0.00,0.00,0.15,0
23524,2575,-878.19,121.81,1121.81,0.00,878.19,0.14,0
23525,2575,1000.00,1121.81,2121.81,303.12,176.19,0.15,1
23526,2575,-1000.00,121.81,1121.81,0.00,2121.81,0.31,0
23527,2575,-1000.00,-878.19,121.81,560.90,560.90,0.23,0
23528,2575,-121.81,-1000.00,0.00,30.72,91.09,0.39,0
23529,2576,-1000.00,-1000.00,0.00,497.98,102.98,0.11,0
23530,2577,1000.00,1000.00,2000.00,0.00,1000.00,0.35,1
23531,2577,1000.00,2000.00,3000.00,0.00,1204.02,0.30,1
23532,2577,1000.00,3000.00,4000.00,0.00,1676.55,0.29,1
23533,2577,1000.00,4000.00,5000.00,0.00,4000.00,0.40,1
23534,2577,1000.00,5000.00,6000.00,1067.35,3932.65,0.07,1
23535,2577,1000.00,6000.00,7000.00,0.00,3008.96,0.02,1
23536,2577,1000.00,7000.00,8000.00,3500.00,3500.00,0.02,1
23537,2577,1000.00,8000.00,9000.00,250.68,7749.32,0.44,1
23538,2577,-1000.00,7000.00,8000.00,4809.95,4190.05,0.22,0
23539,2577,1000.00,8000.00,9000.00,3106.74,4893.26,0.30,1
23540,2577,0.00,8000.00,9000.00,0.00,0.00,0.05,0
23541,2577,-1000.00,7000.00,8000.00,4470.80,0.00,0.03,0
23542,2577,-1000.00,6000.00,7000.00,7954.49,0.00,0.03,0
23543,2577,1000.00,7000.00,8000.00,0.00,7000.00,0.26,1
23544,2577,-1000.00,6000.00,7000.00,4537.56,3462.44,0.12,0
23545,2577,-1000.00,5000.00,6000.00,3849.15,3150.85,0.29,0
23546,2577,-1000.00,4000.00,5000.00,1421.76,1987.01,0.11,0
23547,2577,-173.30,3826.70,4826.70,173.30,0.00,0.17,0
23548,2577,-1000.00,2826.70,3826.70,1806.01,3020.69,0.25,0
23549,2577,-1000.00,1826.70,2826.70,2971.63,855.07,0.09,0
23550,2577,-1000.00,826.70,1826.70,0.00,2826.70,0.14,0
23551,2577,-1000.00,-173.30,826.70,913.35,913.35,0.01,0
23552,2577,-1000.00,-1173.30,-173.30,0.00,826.70,0.18,0
23553,2578,-385.81,-385.81,614.19,0.00,385.81,0.23,0
23554,2578,-382.87,-768.68,231.32,0.00,382.87,0.36,0
23555,2578,-231.32,-1000.00,0.00,0.00,231.32,0.43,0
23556,2579,1000.00,1000.00,2000.00,0.00,1000.00,0.03,1
23557,2579,1000.00,2000.00,3000.00,44.61,1321.34,0.38,1
23558,2579,1000.00,3000.00,4000.00,0.00,2403.24,0.37,1
23559,2579,1000.00,4000.00,5000.00,1091.60,2908.40,0.36,1
23560,2579,1000.00,5000.00,6000.00,0.00,3143.28,0.30,1
23561,2579,1000.00,6000.00,7000.00,0.00,3965.63,0.02,1
23562,2579,1000.00,7000.00,8000.00,0.00,1614.53,0.07,1
23563,2579,1000.00,8000.00,9000.00,0.00,8000.00,0.34,1
23564,2579,1000.00,9000.00,10000.00,0.00,9000.00,0.35,1
23565,2579,1000.00,10000.00,11000.00,4019.95,5980.05,0.13,1
23566,2579,1000.00,11000.00,12000.00,0.00,11000.00,0.17,1
23567,2579,1000.00,12000.00,13000.00,3216.79,8783.21,0.32,1
23568,2579,0.00,12000.00,13000.00,0.00,0.00,0.09,0
23569,2579,1000.00,13000.00,14000.00,0.00,11242.15,0.43,1
23570,2579,1000.00,14000.00,15000.00,0.00,12139.91,0.22,1
23571,2579,1000.00,15000.00,16000.00,5524.78,9475.22,0.26,1
23572,2579,1000.00,16000.00,17000.00,0.00,16000.00,0.23,1
23573,2579,1000.00,17000.00,18000.00,0.00,13161.18,0.11,1
23574,2579,1000.00,18000.00,19000.00,0.00,18000.00,0.38,1
23575,2579,1000.00,19000.00,20000.00,7315.97,11684.03,0.20,1
23576,2579,1000.00,20000.00,21000.00,5202.37,14797.63,0.32,1
23577,2579,1000.00,21000.00,22000.00,10500.00,10500.00,0.40,1
23578,2579,1000.00,22000.00,23000.00,2783.95,19216.05,0.25,1
23579,2579,1000.00,23000.00,24000.00,0.00,23000.00,0.10,1
23580,2579,-1000.00,22000.00,23000.00,0.00,24000.00,0.37,0
23581,2579,-1000.00,21000.00,22000.00,0.00,18307.01,0.07,0
23582,2579,-1000.00,20000.00,21000.00,0.00,22000.00,0.10,0
23583,2579,-1000.00,19000.00,20000.00,0.00,14278.84,0.24,0
23584,2579,-1000.00,18000.00,19000.00,7556.84,3151.96,0.14,0
23585,2579,-1000.00,17000.00,18000.00,0.00,19000.00,0.32,0
23586,2579,-1000.00,16000.00,17000.00,0.00,18000.00,0.31,0
23587,2579,-1000.00,15000.00,16000.00,0.00,17000.00,0.35,0
23588,2579,-1000.00,14000.00,15000.00,0.00,8075.53,0.20,0
23589,2579,-1000.00,13000.00,14000.00,13901.40,0.00,0.02,0
23590,2579,-1000.00,12000.00,13000.00,6652.70,7347.30,0.10,0
23591,2579,-1000.00,11000.00,12000.00,0.00,13000.00,0.22,0
23592,2579,-1000.00,10000.00,11000.00,4672.86,7327.14,0.29,0
23593,2579,-1000.00,9000.00,10000.00,4811.24,6188.76,0.22,0
23594,2579,-1000.00,8000.00,9000.00,0.00,1961.28,0.11,0
23595,2579,-1000.00,7000.00,8000.00,0.00,9000.00,0.04,0
23596,2579,-1000.00,6000.00,7000.00,5743.86,2250.08,0.12,0
23597,2579,-1000.00,5000.00,6000.00,0.00,7000.00,0.04,0
23598,2579,-1000.00,4000.00,5000.00,1928.32,4071.68,0.34,0
23599,2579,-1000.00,3000.00,4000.00,2613.70,2386.30,0.17,0
23600,2579,-1000.00,2000.00,3000.00,0.00,2113.49,0.17,0
23601,2580,-876.07,-876.07,123.93,0.00,876.07,0.28,0
23602,2580,-123.93,-1000.00,0.00,16.45,107.48,0.24,0
23603,2581,1000.00,1000.00,2000.00,0.00,1000.00,0.12,1
23604,2581,1000.00,2000.00,3000.00,0.00,911.95,0.21,1
23605,2581,1000.00,3000.00,4000.00,0.00,3000.00,0.09,1
23606,2581,1000.00,4000.00,5000.00,172.50,3827.50,0.36,1
23607,2581,1000.00,5000.00,6000.00,0.00,3857.24,0.25,1
23608,2581,1000.00,6000.00,7000.00,0.00,3793.19,0.35,1
23609,2581,1000.00,7000.00,8000.00,0.00,7000.00,0.25,1
23610,2581,1000.00,8000.00,9000.00,0.00,8000.00,0.02,1
23611,2581,1000.00,9000.00,10000.00,0.00,7873.39,0.42,1
23612,2581,1000.00,10000.00,11000.00,1111.13,8888.87,0.42,1
23613,2581,1000.00,11000.00,12000.00,0.00,11000.00,0.04,1
23614,2581,1000.00,12000.00,13000.00,4302.35,7697.65,0.23,1
23615,2581,1000.00,13000.00,14000.00,5679.69,7320.31,0.38,1
23616,2581,1000.00,14000.00,15000.00,0.00,14000.00,0.35,1
23617,2581,1000.00,15000.00,16000.00,2369.58,12630.42,0.17,1
23618,2581,-1000.00,14000.00,15000.00,10053.19,5946.81,0.27,0
23619,2581,1000.00,15000.00,16000.00,371.00,14629.00,0.21,1
23620,2581,-1000.00,14000.00,15000.00,10244.07,5755.93,0.30,0
23621,2581,1000.00,15000.00,16000.00,7500.00,7500.00,0.02,1
23622,2581,1000.00,16000.00,17000.00,8000.00,8000.00,0.07,1
23623,2581,1000.00,17000.00,18000.00,413.50,16586.50,0.37,1
23624,2581,1000.00,18000.00,19000.00,520.62,12362.24,0.39,1
23625,2581,0.00,18000.00,19000.00,0.00,0.00,0.03,0
23626,2581,1000.00,19000.00,20000.00,3689.28,9262.30,0.29,1
23627,2581,1000.00,20000.00,21000.00,0.00,18802.38,0.39,1
23628,2581,1000.00,21000.00,22000.00,0.00,21000.00,0.28,1
23629,2581,-1000.00,20000.00,21000.00,3763.27,2303.69,0.14,0
23630,2581,1000.00,21000.00,22000.00,6622.34,14377.66,0.31,1
23631,2581,1000.00,22000.00,23000.00,0.00,22000.00,0.20,1
23632,2581,-1000.00,21000.00,22000.00,14612.15,8387.85,0.04,0
23633,2581,1000.00,22000.00,23000.00,0.00,10696.19,0.27,1
23634,2581,1000.00,23000.00,24000.00,2778.00,20222.00,0.43,1
23635,2581,0.00,23000.00,24000.00,0.00,0.00,0.06,0
23636,2581,1000.00,24000.00,25000.00,0.00,4505.46,0.04,1
23637,2581,-1000.00,23000.00,24000.00,13242.79,11757.21,0.35,0
23638,2581,1000.00,24000.00,25000.00,0.00,24000.00,0.22,1
23639,2581,1000.00,25000.00,26000.00,1900.72,2670.85,0.15,1
23640,2581,1000.00,26000.00,27000.00,0.00,21677.07,0.41,1
23641,2581,-1000.00,25000.00,26000.00,20706.82,6293.18,0.17,0
23642,2582,0.00,0.00,1000.00,0.00,0.00,0.30,0
23643,2582,-228.27,-228.27,771.73,228.27,0.00,0.30,0
23644,2582,-390.95,-619.22,380.78,250.21,140.74,0.21,0
23645,2582,-1000.00,-1619.22,-619.22,0.00,228.30,0.27,0
23646,2583,-1000.00,-1000.00,0.00,500.00,500.00,0.02,0
23647,2584,-521.11,-521.11,478.89,0.00,521.11,0.21,0
23648,2584,-1000.00,-1521.11,-521.11,286.34,192.55,0.17,0
23649,2585,-1000.00,-1000.00,0.00,290.16,683.74,0.36,0
23650,2586,-1000.00,-1000.00,0.00,375.54,624.46,0.25,0
23651,2587,-1000.00,-1000.00,0.00,143.04,856.96,0.22,0
23652,2588,-798.73,-798.73,201.27,0.00,798.73,0.18,0
23653,2588,-192.65,-991.38,8.62,0.00,192.65,0.32,0
23654,2588,-7.48,-998.86,1.14,0.00,7.48,0.29,0
23655,2588,38.67,-960.19,39.81,0.19,0.00,0.02,1
23656,2588,-36.74,-996.93,3.07,1.66,35.08,0.43,0
23657,2588,-3.07,-1000.00,0.00,0.00,3.07,0.27,0
23658,2589,-1000.00,-1000.00,0.00,0.00,290.16,0.21,0
23659,2590,-1000.00,-1000.00,0.00,0.00,464.38,0.29,0
23660,2591,-1000.00,-1000.00,0.00,268.98,731.02,0.35,0
23661,2592,1000.00,1000.00,2000.00,0.00,1000.00,0.13,1
23662,2592,1000.00,2000.00,3000.00,0.00,2000.00,0.07,1
23663,2592,1000.00,3000.00,4000.00,0.00,2108.48,0.37,1
23664,2592,1000.00,4000.00,5000.00,1279.50,2720.50,0.32,1
23665,2592,1000.00,5000.00,6000.00,0.00,4182.95,0.38,1
23666,2592,1000.00,6000.00,7000.00,0.00,3905.07,0.29,1
23667,2592,1000.00,7000.00,8000.00,0.00,7000.00,0.42,1
23668,2592,-1000.00,6000.00,7000.00,5831.97,2168.03,0.06,0
23669,2592,1000.00,7000.00,8000.00,1695.83,5304.17,0.35,1
23670,2592,1000.00,8000.00,9000.00,0.00,8000.00,0.35,1
23671,2592,1000.00,9000.00,10000.00,433.70,8566.30,0.38,1
23672,2592,1000.00,10000.00,11000.00,0.00,10000.00,0.06,1
23673,2592,-1000.00,9000.00,10000.00,5683.52,5316.48,0.43,0
23674,2592,1000.00,10000.00,11000.00,3416.46,6337.42,0.31,1
23675,2592,0.00,10000.00,11000.00,0.00,0.00,0.01,0
23676,2592,1000.00,11000.00,12000.00,1262.99,9737.01,0.39,1
23677,2592,1000.00,12000.00,13000.00,1918.91,10081.09,0.42,1
23678,2592,-1000.00,11000.00,12000.00,6917.93,6082.07,0.18,0
23679,2592,-1000.00,10000.00,11000.00,6762.97,5237.03,0.16,0
23680,2592,1000.00,11000.00,12000.00,0.00,11000.00,0.35,1
23681,2592,1000.00,12000.00,13000.00,0.00,12000.00,0.26,1
23682,2592,1000.00,13000.00,14000.00,3332.28,9667.72,0.19,1
23683,2592,1000.00,14000.00,15000.00,0.00,14000.00,0.18,1
23684,2592,1000.00,15000.00,16000.00,1350.48,13649.52,0.32,1
23685,2592,1000.00,16000.00,17000.00,0.00,2206.83,0.16,1
23686,2592,1000.00,17000.00,18000.00,0.00,17000.00,0.23,1
23687,2592,1000.00,18000.00,19000.00,9000.00,9000.00,0.02,1
23688,2592,1000.00,19000.00,20000.00,0.00,19000.00,0.36,1
23689,2592,-1000.00,18000.00,19000.00,9327.02,0.00,0.06,0
23690,2592,1000.00,19000.00,20000.00,2565.08,16434.92,0.37,1
23691,2592,1000.00,20000.00,21000.00,3207.95,16792.05,0.42,1
23692,2592,1000.00,21000.00,22000.00,0.00,1891.74,0.14,1
23693,2592,1000.00,22000.00,23000.00,8165.19,13834.81,0.10,1
23694,2592,1000.00,23000.00,24000.00,11500.00,11500.00,0.37,1
23695,2592,1000.00,24000.00,25000.00,0.00,24000.00,0.33,1
23696,2592,1000.00,25000.00,26000.00,0.00,14916.35,0.36,1
23697,2592,-1000.00,24000.00,25000.00,20886.49,5113.51,0.15,0
23698,2592,1000.00,25000.00,26000.00,3726.81,11196.69,0.28,1
23699,2592,1000.00,26000.00,27000.00,2020.55,19218.95,0.40,1
23700,2592,1000.00,27000.00,28000.00,638.11,26361.89,0.39,1
23701,2592,1000.00,28000.00,29000.00,9906.94,18093.06,0.22,1
23702,2592,-1000.00,27000.00,28000.00,16307.76,12692.24,0.32,0
23703,2592,1000.00,28000.00,29000.00,0.00,26774.54,0.37,1
23704,2592,1000.00,29000.00,30000.00,0.00,29000.00,0.36,1
23705,2592,-1000.00,28000.00,29000.00,5055.76,0.00,0.06,0
23706,2592,-1000.00,27000.00,28000.00,17864.74,3946.75,0.10,0
23707,2592,-1000.00,26000.00,27000.00,8191.35,19808.65,0.31,0
23708,2592,-1000.00,25000.00,26000.00,9214.10,14284.17,0.28,0
23709,2592,-1000.00,24000.00,25000.00,7285.91,460.65,0.11,0
23710,2592,-1000.00,23000.00,24000.00,5970.78,19029.22,0.30,0
23711,2592,-1000.00,22000.00,23000.00,8229.61,15770.39,0.29,0
23712,2592,-1000.00,21000.00,22000.00,6841.29,16158.71,0.37,0
23713,2592,-1000.00,20000.00,21000.00,0.00,19135.09,0.42,0
23714,2592,-1000.00,19000.00,20000.00,0.00,21000.00,0.03,0
23715,2592,-1000.00,18000.00,19000.00,11775.23,8224.77,0.04,0
23716,2592,-1000.00,17000.00,18000.00,9500.00,9500.00,0.03,0
23717,2592,-1000.00,16000.00,17000.00,9000.00,9000.00,0.01,0
23718,2592,-1000.00,15000.00,16000.00,5715.76,11284.24,0.31,0
23719,2592,-1000.00,14000.00,15000.00,0.00,12822.81,0.22,0
23720,2592,-1000.00,13000.00,14000.00,3711.95,11288.05,0.38,0
23721,2592,-1000.00,12000.00,13000.00,7000.00,7000.00,0.04,0
23722,2592,-1000.00,11000.00,12000.00,367.10,12632.90,0.20,0
23723,2592,-1000.00,10000.00,11000.00,5985.18,6014.82,0.38,0
23724,2592,-1000.00,9000.00,10000.00,377.96,10622.04,0.43,0
23725,2593,-700.92,-700.92,299.08,13.68,687.25,0.39,0
23726,2593,-299.08,-1000.00,0.00,62.05,237.03,0.38,0
23727,2594,-570.67,-570.67,429.33,0.00,570.67,0.22,0
23728,2594,-429.33,-1000.00,0.00,189.12,240.21,0.18,0
23729,2595,-1000.00,-1000.00,0.00,0.00,549.87,0.17,0
23730,2596,0.00,0.00,1000.00,0.00,0.00,0.07,0
23731,2596,-1000.00,-1000.00,0.00,178.07,821.93,0.02,0
23732,2597,1000.00,1000.00,2000.00,0.00,403.43,0.27,1
23733,2597,1000.00,2000.00,3000.00,0.00,297.07,0.16,1
23734,2597,1000.00,3000.00,4000.00,268.56,1623.79,0.33,1
23735,2597,1000.00,4000.00,5000.00,0.00,4000.00,0.36,1
23736,2597,1000.00,5000.00,6000.00,1630.50,3369.50,0.34,1
23737,2597,-1000.00,4000.00,5000.00,3649.92,2350.08,0.26,0
23738,2597,1000.00,5000.00,6000.00,0.00,1244.72,0.12,1
23739,2597,1000.00,6000.00,7000.00,1413.73,4586.27,0.38,1
23740,2597,0.00,6000.00,7000.00,0.00,0.00,0.00,0
23741,2597,1000.00,7000.00,8000.00,1921.28,5078.72,0.37,1
23742,2597,1000.00,8000.00,9000.00,0.00,4442.27,0.12,1
23743,2597,1000.00,9000.00,10000.00,2067.54,5878.60,0.35,1
23744,2597,1000.00,10000.00,11000.00,3768.60,6231.40,0.27,1
23745,2597,1000.00,11000.00,12000.00,0.00,4340.33,0.21,1
23746,2597,1000.00,12000.00,13000.00,3352.94,5018.33,0.25,1
23747,2597,1000.00,13000.00,14000.00,0.00,13000.00,0.41,1
23748,2597,-825.91,12174.09,13174.09,825.91,0.00,0.07,0
23749,2597,1000.00,13174.09,14174.09,5826.04,7348.05,0.12,1
23750,2597,1000.00,14174.09,15174.09,4702.70,9471.38,0.29,1
23751,2597,-1000.00,13174.09,14174.09,4679.12,0.00,0.02,0
23752,2597,-1000.00,12174.09,13174.09,7161.46,7012.62,0.17,0
23753,2597,-1000.00,11174.09,12174.09,11907.85,1266.24,0.11,0
23754,2597,1000.00,12174.09,13174.09,0.00,9385.89,0.33,1
23755,2597,-1000.00,11174.09,12174.09,6587.04,6587.04,0.39,0
23756,2597,-1000.00,10174.09,11174.09,2311.91,9862.17,0.27,0
23757,2597,-1000.00,9174.09,10174.09,0.00,11174.09,0.06,0
23758,2597,-1000.00,8174.09,9174.09,9102.34,1071.75,0.02,0
23759,2597,-1000.00,7174.09,8174.09,0.00,5594.51,0.02,0
23760,2597,-1000.00,6174.09,7174.09,0.00,5337.05,0.37,0
23761,2597,-1000.00,5174.09,6174.09,50.81,4663.18,0.37,0
23762,2597,-1000.00,4174.09,5174.09,2038.49,4135.60,0.21,0
23763,2597,-1000.00,3174.09,4174.09,237.25,4936.84,0.42,0
23764,2597,-1000.00,2174.09,3174.09,1236.49,2937.60,0.34,0
23765,2597,-1000.00,1174.09,2174.09,0.00,3174.09,0.05,0
23766,2597,-1000.00,174.09,1174.09,0.00,1729.56,0.27,0
23767,2597,-1000.00,-825.91,174.09,352.01,822.08,0.32,0
23768,2597,-125.66,-951.57,48.43,47.38,78.28,0.26,0
23769,2597,-47.12,-998.70,1.30,0.00,47.12,0.44,0
23770,2597,-1.30,-1000.00,0.00,0.40,0.91,0.14,0
23771,2598,-1000.00,-1000.00,0.00,339.95,660.05,0.09,0
23772,2598,-0.00,-1000.00,0.00,0.00,0.00,0.30,0
23773,2599,-1000.00,-1000.00,0.00,0.00,796.02,0.12,0
23774,2600,-223.83,-223.83,776.17,10.97,212.86,0.21,0
23775,2600,-686.22,-910.05,89.95,287.77,398.45,0.28,0
23776,2600,-65.08,-975.13,24.87,4.49,60.59,0.39,0
23777,2600,-24.87,-1000.00,0.00,0.00,24.87,0.32,0
23778,2601,-1000.00,-1000.00,0.00,0.00,602.22,0.11,0
23779,2602,-1000.00,-1000.00,0.00,0.00,1000.00,0.29,0
23780,2603,-895.51,-895.51,104.49,221.02,674.49,0.36,0
23781,2603,-104.49,-1000.00,0.00,15.23,89.26,0.38,0
23782,2604,-1000.00,-1000.00,0.00,0.00,1000.00,0.04,0
23783,2605,-1000.00,-1000.00,0.00,0.00,1000.00,0.23,0
23784,2606,-1000.00,-1000.00,0.00,0.00,281.94,0.02,0
23785,2607,-1000.00,-1000.00,0.00,0.00,1000.00,0.19,0
23786,2608,1000.00,1000.00,2000.00,0.00,532.52,0.12,1
23787,2608,1000.00,2000.00,3000.00,0.00,2000.00,0.04,1
23788,2608,1000.00,3000.00,4000.00,0.00,3000.00,0.14,1
23789,2608,1000.00,4000.00,5000.00,942.13,3057.87,0.29,1
23790,2608,1000.00,5000.00,6000.00,0.00,5000.00,0.17,1
23791,2608,1000.00,6000.00,7000.00,2602.07,3397.93,0.03,1
23792,2608,1000.00,7000.00,8000.00,0.00,7000.00,0.32,1
23793,2608,1000.00,8000.00,9000.00,928.55,7071.45,0.30,1
23794,2608,1000.00,9000.00,10000.00,0.00,9000.00,0.18,1
23795,2608,1000.00,10000.00,11000.00,3971.15,6028.85,0.43,1
23796,2608,1000.00,11000.00,12000.00,3528.53,7471.47,0.14,1
23797,2608,0.00,11000.00,12000.00,0.00,0.00,0.03,0
23798,2608,1000.00,12000.00,13000.00,3929.54,8070.46,0.43,1
23799,2608,1000.00,13000.00,14000.00,818.17,12181.83,0.43,1
23800,2608,1000.00,14000.00,15000.00,0.00,14000.00,0.06,1
23801,2608,1000.00,15000.00,16000.00,0.00,14936.71,0.42,1
23802,2608,1000.00,16000.00,17000.00,4938.34,11061.66,0.35,1
23803,2608,1000.00,17000.00,18000.00,0.00,17000.00,0.10,1
23804,2608,-1000.00,16000.00,17000.00,0.00,12654.53,0.38,0
23805,2608,-1000.00,15000.00,16000.00,0.00,17000.00,0.27,0
23806,2608,-1000.00,14000.00,15000.00,8000.00,8000.00,0.02,0
23807,2608,0.00,14000.00,15000.00,0.00,0.00,0.24,0
23808,2608,-1000.00,13000.00,14000.00,4396.37,10603.63,0.14,0
23809,2608,1000.00,14000.00,15000.00,7000.00,7000.00,0.08,1
23810,2608,1000.00,15000.00,16000.00,0.00,15000.00,0.21,1
23811,2608,1000.00,16000.00,17000.00,6865.42,9134.58,0.15,1
23812,2608,1000.00,17000.00,18000.00,5585.54,11414.46,0.07,1
23813,2608,1000.00,18000.00,19000.00,0.00,18000.00,0.15,1
23814,2608,1000.00,19000.00,20000.00,5875.39,13124.61,0.20,1
23815,2608,1000.00,20000.00,21000.00,0.00,15642.80,0.24,1
23816,2608,1000.00,21000.00,22000.00,4462.19,15859.65,0.38,1
23817,2608,1000.00,22000.00,23000.00,0.00,3061.85,0.10,1
23818,2608,-1000.00,21000.00,22000.00,5440.27,3013.36,0.15,0
23819,2608,1000.00,22000.00,23000.00,7093.41,14906.59,0.34,1
23820,2608,1000.00,23000.00,24000.00,0.00,13489.44,0.15,1
23821,2608,1000.00,24000.00,25000.00,11227.71,12772.29,0.37,1
23822,2608,1000.00,25000.00,26000.00,0.00,25000.00,0.10,1
23823,2608,1000.00,26000.00,27000.00,0.00,14076.17,0.33,1
23824,2608,1000.00,27000.00,28000.00,3885.88,4111.06,0.16,1
23825,2608,1000.00,28000.00,29000.00,14000.00,14000.00,0.22,1
23826,2608,1000.00,29000.00,30000.00,12109.16,16890.84,0.27,1
23827,2608,1000.00,30000.00,31000.00,0.00,29654.78,0.44,1
23828,2608,1000.00,31000.00,32000.00,14119.76,16880.24,0.39,1
23829,2608,1000.00,32000.00,33000.00,0.00,15482.29,0.24,1
23830,2608,1000.00,33000.00,34000.00,12903.74,20096.26,0.17,1
23831,2608,0.00,33000.00,34000.00,0.00,0.00,0.01,0
23832,2608,1000.00,34000.00,35000.00,0.00,14207.01,0.22,1
23833,2609,-1000.00,-1000.00,0.00,0.00,1000.00,0.00,0
23834,2610,-1000.00,-1000.00,0.00,549.09,450.91,0.24,0
23835,2611,-1000.00,-1000.00,0.00,0.00,1000.00,0.37,0
23836,2612,-1000.00,-1000.00,0.00,312.01,0.00,0.09,0
23837,2613,1000.00,1000.00,2000.00,0.00,1000.00,0.07,1
23838,2613,1000.00,2000.00,3000.00,453.22,1546.78,0.19,1
23839,2613,1000.00,3000.00,4000.00,0.00,2615.13,0.43,1
23840,2613,1000.00,4000.00,5000.00,0.00,4000.00,0.10,1
23841,2613,1000.00,5000.00,6000.00,1986.80,3013.20,0.25,1
23842,2613,1000.00,6000.00,7000.00,3000.00,3000.00,0.01,1
23843,2613,1000.00,7000.00,8000.00,89.21,6910.79,0.42,1
23844,2613,1000.00,8000.00,9000.00,0.00,7887.37,0.30,1
23845,2613,1000.00,9000.00,10000.00,107.41,8892.59,0.42,1
23846,2613,1000.00,10000.00,11000.00,3652.92,6347.08,0.23,1
23847,2613,1000.00,11000.00,12000.00,0.00,11000.00,0.14,1
23848,2613,1000.00,12000.00,13000.00,1307.45,10692.55,0.43,1
23849,2613,1000.00,13000.00,14000.00,4410.77,8589.23,0.33,1
23850,2613,1000.00,14000.00,15000.00,0.00,14000.00,0.36,1
23851,2613,-1000.00,13000.00,14000.00,10040.53,4959.47,0.11,0
23852,2613,1000.00,14000.00,15000.00,0.00,14000.00,0.01,1
23853,2613,1000.00,15000.00,16000.00,0.00,7521.02,0.27,1
23854,2613,1000.00,16000.00,17000.00,0.00,16000.00,0.00,1
23855,2613,1000.00,17000.00,18000.00,7146.56,8508.68,0.25,1
23856,2613,1000.00,18000.00,19000.00,0.00,18000.00,0.09,1
23857,2613,1000.00,19000.00,20000.00,1895.70,17104.30,0.39,1
23858,2613,1000.00,20000.00,21000.00,3850.02,14177.12,0.38,1
23859,2613,1000.00,21000.00,22000.00,2295.01,18704.99,0.44,1
23860,2613,1000.00,22000.00,23000.00,314.35,21685.65,0.35,1
23861,2613,-1000.00,21000.00,22000.00,11500.00,11500.00,0.07,0
23862,2613,-1000.00,20000.00,21000.00,16565.42,0.00,0.05,0
23863,2613,-1000.00,19000.00,20000.00,5068.84,15931.16,0.29,0
23864,2613,-1000.00,18000.00,19000.00,0.00,18602.78,0.34,0
23865,2613,-1000.00,17000.00,18000.00,12052.67,6947.33,0.07,0
23866,2613,-1000.00,16000.00,17000.00,0.00,18000.00,0.39,0
23867,2613,-1000.00,15000.00,16000.00,5921.26,11078.74,0.24,0
23868,2613,-1000.00,14000.00,15000.00,11143.44,4856.56,0.17,0
23869,2613,-1000.00,13000.00,14000.00,7500.00,7500.00,0.05,0
23870,2613,-1000.00,12000.00,13000.00,2114.44,11885.56,0.24,0
23871,2613,-1000.00,11000.00,12000.00,147.88,12852.12,0.17,0
23872,2613,-1000.00,10000.00,11000.00,0.00,3951.29,0.20,0
23873,2613,-1000.00,9000.00,10000.00,0.00,11000.00,0.25,0
23874,2613,-1000.00,8000.00,9000.00,1590.31,8409.69,0.22,0
23875,2613,-1000.00,7000.00,8000.00,0.00,9000.00,0.03,0
23876,2613,-1000.00,6000.00,7000.00,5146.41,2853.59,0.07,0
23877,2613,-1000.00,5000.00,6000.00,0.00,4823.77,0.10,0
23878,2613,-1000.00,4000.00,5000.00,3391.63,2608.37,0.08,0
23879,2613,-1000.00,3000.00,4000.00,2500.00,2500.00,0.06,0
23880,2613,-1000.00,2000.00,3000.00,93.90,3906.10,0.36,0
23881,2613,-1000.00,1000.00,2000.00,1261.60,1738.40,0.26,0
23882,2613,-1000.00,0.00,1000.00,265.82,1734.18,0.43,0
23883,2613,-1000.00,-1000.00,0.00,272.76,75.09,0.13,0
23884,2614,1000.00,1000.00,2000.00,574.31,0.00,0.16,1
23885,2614,-1000.00,0.00,1000.00,0.00,1512.19,0.11,0
23886,2614,-1000.00,-1000.00,0.00,102.02,897.98,0.04,0
23887,2615,-1000.00,-1000.00,0.00,146.70,853.30,0.08,0
23888,2616,-829.40,-829.40,170.60,27.77,801.62,0.42,0
23889,2616,-170.60,-1000.00,0.00,76.36,94.24,0.25,0
23890,2617,-795.10,-795.10,204.90,0.00,795.10,0.35,0
23891,2617,-35.17,-830.27,169.73,0.00,35.17,0.13,0
23892,2617,-169.73,-1000.00,0.00,24.84,144.89,0.42,0
23893,2618,-1000.00,-1000.00,0.00,486.76,513.24,0.25,0
23894,2619,-1000.00,-1000.00,0.00,454.00,546.00,0.20,0
23895,2620,1000.00,1000.00,2000.00,145.63,854.37,0.18,1
23896,2620,-1000.00,0.00,1000.00,939.15,888.71,0.24,0
23897,2620,1000.00,1000.00,2000.00,0.00,1000.00,0.09,1
23898,2620,1000.00,2000.00,3000.00,0.00,1886.23,0.34,1
23899,2620,-1000.00,1000.00,2000.00,1586.08,1413.92,0.10,0
23900,2620,1000.00,2000.00,3000.00,0.00,1161.22,0.24,1
23901,2620,1000.00,3000.00,4000.00,0.00,3000.00,0.07,1
23902,2620,1000.00,4000.00,5000.00,0.00,4000.00,0.19,1
23903,2620,1000.00,5000.00,6000.00,0.00,2431.58,0.31,1
23904,2620,1000.00,6000.00,7000.00,111.39,2579.54,0.28,1
23905,2620,-1000.00,5000.00,6000.00,5983.73,0.00,0.09,0
23906,2620,1000.00,6000.00,7000.00,1905.39,4094.61,0.20,1
23907,2620,-1000.00,5000.00,6000.00,5700.94,1299.06,0.19,0
23908,2620,1000.00,6000.00,7000.00,1604.84,4395.16,0.37,1
23909,2620,1000.00,7000.00,8000.00,1109.41,4968.07,0.38,1
23910,2620,1000.00,8000.00,9000.00,684.18,5870.23,0.40,1
23911,2620,1000.00,9000.00,10000.00,4500.00,4500.00,0.28,1
23912,2620,1000.00,10000.00,11000.00,0.00,9412.37,0.41,1
23913,2620,-1000.00,9000.00,10000.00,3583.08,7416.92,0.06,0
23914,2620,-1000.00,8000.00,9000.00,0.00,3994.45,0.27,0
23915,2620,-1000.00,7000.00,8000.00,0.00,2692.84,0.18,0
23916,2620,-1000.00,6000.00,7000.00,0.00,3162.98,0.26,0
23917,2620,-1000.00,5000.00,6000.00,3500.00,3500.00,0.11,0
23918,2620,-1000.00,4000.00,5000.00,3000.00,3000.00,0.05,0
23919,2620,-1000.00,3000.00,4000.00,506.19,4493.81,0.07,0
23920,2620,-1000.00,2000.00,3000.00,2335.26,1664.74,0.30,0
23921,2620,-1000.00,1000.00,2000.00,1269.99,1730.01,0.11,0
23922,2620,-1000.00,0.00,1000.00,1453.44,546.56,0.03,0
23923,2620,-1000.00,-1000.00,0.00,196.40,116.74,0.14,0
23924,2621,-1000.00,-1000.00,0.00,485.32,514.68,0.07,0
23925,2622,-1000.00,-1000.00,0.00,491.90,508.10,0.10,0
23926,2623,-1000.00,-1000.00,0.00,288.05,711.95,0.29,0
23927,2624,-1000.00,-1000.00,0.00,0.00,1000.00,0.30,0
23928,2625,1000.00,1000.00,2000.00,0.00,1000.00,0.13,1
23929,2625,1000.00,2000.00,3000.00,148.01,1851.99,0.42,1
23930,2625,1000.00,3000.00,4000.00,255.18,2744.82,0.44,1
23931,2625,1000.00,4000.00,5000.00,1917.66,2082.34,0.42,1
23932,2625,1000.00,5000.00,6000.00,514.28,4485.72,0.43,1
23933,2625,1000.00,6000.00,7000.00,0.00,6000.00,0.27,1
23934,2625,1000.00,7000.00,8000.00,3500.00,3500.00,0.10,1
23935,2625,-1000.00,6000.00,7000.00,5000.44,2999.56,0.13,0
23936,2625,1000.00,7000.00,8000.00,2801.62,4198.38,0.08,1
23937,2625,1000.00,8000.00,9000.00,3164.44,4835.56,0.17,1
23938,2625,-1000.00,7000.00,8000.00,5856.88,3143.12,0.11,0
23939,2625,1000.00,8000.00,9000.00,0.00,3042.63,0.25,1
23940,2625,1000.00,9000.00,10000.00,3625.32,5374.68,0.42,1
23941,2625,-1000.00,8000.00,9000.00,9524.36,475.64,0.03,0
23942,2625,1000.00,9000.00,10000.00,0.00,841.54,0.14,1
23943,2625,1000.00,10000.00,11000.00,1479.20,8520.80,0.42,1
23944,2625,1000.00,11000.00,12000.00,5126.03,5873.97,0.18,1
23945,2625,1000.00,12000.00,13000.00,488.98,11511.02,0.34,1
23946,2625,1000.00,13000.00,14000.00,448.24,2284.30,0.16,1
23947,2625,1000.00,14000.00,15000.00,6232.25,7482.08,0.27,1
23948,2625,1000.00,15000.00,16000.00,7500.00,7500.00,0.06,1
23949,2625,1000.00,16000.00,17000.00,0.00,16000.00,0.07,1
23950,2625,1000.00,17000.00,18000.00,2425.67,13696.01,0.41,1
23951,2625,1000.00,18000.00,19000.00,0.00,18000.00,0.21,1
23952,2625,1000.00,19000.00,20000.00,2468.58,11339.10,0.35,1
23953,2625,1000.00,20000.00,21000.00,0.00,20000.00,0.01,1
23954,2625,1000.00,21000.00,22000.00,1207.32,12737.74,0.36,1
23955,2625,1000.00,22000.00,23000.00,0.00,21391.11,0.10,1
23956,2625,1000.00,23000.00,24000.00,3948.35,19051.65,0.43,1
23957,2625,1000.00,24000.00,25000.00,4914.21,15016.10,0.34,1
23958,2625,1000.00,25000.00,26000.00,1872.78,23127.22,0.09,1
23959,2625,1000.00,26000.00,27000.00,3934.41,18886.17,0.39,1
23960,2625,1000.00,27000.00,28000.00,13500.00,13500.00,0.01,1
23961,2625,1000.00,28000.00,29000.00,13096.50,14903.50,0.25,1
23962,2625,1000.00,29000.00,30000.00,13816.34,15183.66,0.14,1
23963,2625,1000.00,30000.00,31000.00,14327.01,15672.99,0.14,1
23964,2625,1000.00,31000.00,32000.00,2285.96,28714.04,0.29,1
23965,2625,1000.00,32000.00,33000.00,6657.84,8359.97,0.20,1
23966,2625,1000.00,33000.00,34000.00,0.00,33000.00,0.22,1
23967,2625,1000.00,34000.00,35000.00,14449.90,19550.10,0.14,1
23968,2625,1000.00,35000.00,36000.00,0.00,22594.98,0.19,1
23969,2626,-105.86,-105.86,894.14,105.86,0.00,0.03,0
23970,2626,-1000.00,-1105.86,-105.86,445.87,448.28,0.06,0
23971,2627,1000.00,1000.00,2000.00,0.00,422.21,0.22,1
23972,2627,1000.00,2000.00,3000.00,883.13,1116.87,0.25,1
23973,2627,-1000.00,1000.00,2000.00,1987.70,1012.30,0.01,0
23974,2627,1000.00,2000.00,3000.00,132.67,1867.33,0.36,1
23975,2627,1000.00,3000.00,4000.00,0.00,1169.67,0.24,1
23976,2627,1000.00,4000.00,5000.00,800.31,3199.69,0.25,1
23977,2627,-1000.00,3000.00,4000.00,3526.01,1473.99,0.10,0
23978,2627,1000.00,4000.00,5000.00,206.56,3291.02,0.42,1
23979,2627,-1000.00,3000.00,4000.00,2166.58,1323.57,0.16,0
23980,2627,1000.00,4000.00,5000.00,0.00,2476.81,0.24,1
23981,2627,1000.00,5000.00,6000.00,0.00,5000.00,0.35,1
23982,2627,1000.00,6000.00,7000.00,2274.60,3725.40,0.37,1
23983,2627,1000.00,7000.00,8000.00,3265.20,3734.80,0.43,1
23984,2627,1000.00,8000.00,9000.00,3225.84,4774.16,0.23,1
23985,2627,1000.00,9000.00,10000.00,0.00,9000.00,0.32,1
23986,2627,1000.00,10000.00,11000.00,0.00,9947.56,0.17,1
23987,2627,1000.00,11000.00,12000.00,0.00,11000.00,0.05,1
23988,2627,1000.00,12000.00,13000.00,6000.00,6000.00,0.09,1
23989,2627,1000.00,13000.00,14000.00,2886.07,6251.16,0.29,1
23990,2627,-1000.00,12000.00,13000.00,7213.35,6786.65,0.09,0
23991,2627,1000.00,13000.00,14000.00,0.00,13000.00,0.38,1
23992,2627,1000.00,14000.00,15000.00,0.00,14000.00,0.13,1
23993,2627,-1000.00,13000.00,14000.00,7732.94,7267.06,0.10,0
23994,2627,-1000.00,12000.00,13000.00,2304.55,3522.67,0.21,0
23995,2627,-1000.00,11000.00,12000.00,3843.81,9156.19,0.26,0
23996,2627,-1000.00,10000.00,11000.00,0.00,6468.97,0.20,0
23997,2627,-1000.00,9000.00,10000.00,2967.73,8032.27,0.35,0
23998,2627,-1000.00,8000.00,9000.00,0.00,9366.71,0.43,0
23999,2627,-1000.00,7000.00,8000.00,306.35,0.00,0.03,0
24000,2627,-1000.00,6000.00,7000.00,3878.78,4121.22,0.34,0
24001,2627,-1000.00,5000.00,6000.00,0.00,6664.65,0.30,0
24002,2627,-1000.00,4000.00,5000.00,2257.68,3742.32,0.35,0
24003,2627,-1000.00,3000.00,4000.00,952.86,4047.14,0.39,0
24004,2627,-1000.00,2000.00,3000.00,0.00,1714.79,0.05,0
24005,2627,-1000.00,1000.00,2000.00,0.00,1384.18,0.16,0
24006,2627,-1000.00,0.00,1000.00,1158.75,841.25,0.10,0
24007,2627,-664.30,-664.30,335.70,0.00,664.30,0.33,0
24008,2627,-335.70,-1000.00,0.00,38.88,296.82,0.31,0
24009,2628,-1000.00,-1000.00,0.00,0.00,1000.00,0.35,0
24010,2629,1000.00,1000.00,2000.00,0.00,1000.00,0.09,1
24011,2629,1000.00,2000.00,3000.00,364.61,1635.39,0.10,1
24012,2629,1000.00,3000.00,4000.00,302.00,2698.00,0.04,1
24013,2629,1000.00,4000.00,5000.00,0.00,4000.00,0.35,1
24014,2629,1000.00,5000.00,6000.00,0.00,4936.45,0.17,1
24015,2629,1000.00,6000.00,7000.00,2864.36,3135.64,0.08,1
24016,2629,-1000.00,5000.00,6000.00,4775.75,2224.25,0.30,0
24017,2629,1000.00,6000.00,7000.00,1097.76,4902.24,0.29,1
24018,2629,1000.00,7000.00,8000.00,0.00,7000.00,0.19,1
24019,2629,1000.00,8000.00,9000.00,4000.00,4000.00,0.01,1
24020,2629,1000.00,9000.00,10000.00,282.35,8717.65,0.44,1
24021,2629,1000.00,10000.00,11000.00,0.00,10000.00,0.23,1
24022,2629,1000.00,11000.00,12000.00,4939.25,6060.75,0.19,1
24023,2629,1000.00,12000.00,13000.00,0.00,9532.36,0.42,1
24024,2629,1000.00,13000.00,14000.00,0.00,13000.00,0.20,1
24025,2629,1000.00,14000.00,15000.00,1835.77,12164.23,0.44,1
24026,2629,1000.00,15000.00,16000.00,689.03,14310.97,0.10,1
24027,2629,-1000.00,14000.00,15000.00,11953.82,4046.18,0.13,0
24028,2629,1000.00,15000.00,16000.00,3833.97,11166.03,0.38,1
24029,2629,1000.00,16000.00,17000.00,0.00,1509.48,0.14,1
24030,2629,1000.00,17000.00,18000.00,0.00,17000.00,0.31,1
24031,2629,1000.00,18000.00,19000.00,7895.65,10104.35,0.20,1
24032,2629,1000.00,19000.00,20000.00,0.00,19000.00,0.02,1
24033,2629,-1000.00,18000.00,19000.00,11736.68,8263.32,0.12,0
24034,2629,1000.00,19000.00,20000.00,0.00,17349.88,0.30,1
24035,2629,1000.00,20000.00,21000.00,6502.90,13497.10,0.15,1
24036,2629,1000.00,21000.00,22000.00,0.00,21000.00,0.03,1
24037,2629,1000.00,22000.00,23000.00,0.00,8714.23,0.06,1
24038,2629,1000.00,23000.00,24000.00,0.00,23000.00,0.14,1
24039,2629,-1000.00,22000.00,23000.00,13389.66,10610.34,0.21,0
24040,2629,-1000.00,21000.00,22000.00,22432.60,0.00,0.00,0
24041,2629,1000.00,22000.00,23000.00,0.00,13626.37,0.02,1
24042,2629,-1000.00,21000.00,22000.00,18179.12,4820.88,0.14,0
24043,2629,1000.00,22000.00,23000.00,0.00,9772.84,0.27,1
24044,2629,-1000.00,21000.00,22000.00,11742.45,11257.55,0.02,0
24045,2629,1000.00,22000.00,23000.00,0.00,22000.00,0.14,1
24046,2630,-1000.00,-1000.00,0.00,231.89,768.11,0.39,0
24047,2631,-1000.00,-1000.00,0.00,512.12,487.88,0.18,0
24048,2632,1000.00,1000.00,2000.00,600.10,399.90,0.09,1
24049,2632,-1000.00,0.00,1000.00,685.30,1314.70,0.22,0
24050,2632,-985.29,-985.29,14.71,0.00,985.29,0.36,0
24051,2632,-14.71,-1000.00,0.00,5.00,9.71,0.35,0
24052,2633,-1000.00,-1000.00,0.00,354.12,645.88,0.26,0
24053,2634,-1000.00,-1000.00,0.00,0.00,1000.00,0.07,0
24054,2635,-1000.00,-1000.00,0.00,378.23,621.77,0.26,0
24055,2636,-1000.00,-1000.00,0.00,239.65,264.28,0.38,0
24056,2637,1000.00,1000.00,2000.00,0.00,408.94,0.26,1
24057,2637,-1000.00,0.00,1000.00,1492.72,507.28,0.10,0
24058,2637,1000.00,1000.00,2000.00,0.00,1000.00,0.18,1
24059,2637,1000.00,2000.00,3000.00,0.00,1855.72,0.44,1
24060,2637,-1000.00,1000.00,2000.00,1512.47,1487.53,0.11,0
24061,2637,1000.00,2000.00,3000.00,0.00,576.69,0.15,1
24062,2637,1000.00,3000.00,4000.00,0.00,1789.40,0.15,1
24063,2637,1000.00,4000.00,5000.00,907.14,2949.10,0.37,1
24064,2637,1000.00,5000.00,6000.00,0.00,2938.74,0.34,1
24065,2637,1000.00,6000.00,7000.00,1944.55,4055.45,0.15,1
24066,2637,-1000.00,5000.00,6000.00,3318.96,1172.01,0.13,0
24067,2637,1000.00,6000.00,7000.00,0.00,5748.76,0.43,1
24068,2637,1000.00,7000.00,8000.00,0.00,7000.00,0.27,1
24069,2637,1000.00,8000.00,9000.00,0.00,5009.21,0.11,1
24070,2637,1000.00,9000.00,10000.00,0.00,9000.00,0.23,1
24071,2637,-1000.00,8000.00,9000.00,5979.48,0.00,0.05,0
24072,2637,1000.00,9000.00,10000.00,1152.83,7847.17,0.40,1
24073,2637,1000.00,10000.00,11000.00,0.00,8437.20,0.32,1
24074,2637,1000.00,11000.00,12000.00,2290.86,7093.16,0.36,1
24075,2637,1000.00,12000.00,13000.00,1593.42,10406.58,0.39,1
24076,2637,-1000.00,11000.00,12000.00,8280.74,4719.26,0.09,0
24077,2637,1000.00,12000.00,13000.00,0.00,8203.93,0.05,1
24078,2637,1000.00,13000.00,14000.00,0.00,5349.36,0.19,1
24079,2637,-1000.00,12000.00,13000.00,9134.15,4865.85,0.14,0
24080,2637,1000.00,13000.00,14000.00,3389.52,9610.48,0.24,1
24081,2637,1000.00,14000.00,15000.00,0.00,14000.00,0.15,1
24082,2637,-1000.00,13000.00,14000.00,7608.94,7391.06,0.21,0
24083,2637,1000.00,14000.00,15000.00,0.00,14000.00,0.33,1
24084,2637,1000.00,15000.00,16000.00,4033.51,6036.45,0.24,1
24085,2637,1000.00,16000.00,17000.00,6037.34,9962.66,0.26,1
24086,2637,1000.00,17000.00,18000.00,298.89,7145.74,0.28,1
24087,2637,1000.00,18000.00,19000.00,1272.94,16727.06,0.18,1
24088,2637,1000.00,19000.00,20000.00,0.00,15339.09,0.41,1
24089,2637,1000.00,20000.00,21000.00,0.00,15755.96,0.17,1
24090,2637,1000.00,21000.00,22000.00,9613.37,11386.63,0.16,1
24091,2637,-1000.00,20000.00,21000.00,4769.03,1181.26,0.12,0
24092,2637,1000.00,21000.00,22000.00,964.38,20035.62,0.19,1
24093,2637,1000.00,22000.00,23000.00,0.00,16918.88,0.36,1
24094,2637,1000.00,23000.00,24000.00,0.00,7271.06,0.06,1
24095,2637,-1000.00,22000.00,23000.00,12168.33,11831.67,0.20,0
24096,2637,1000.00,23000.00,24000.00,3759.00,19241.00,0.24,1
24097,2637,1000.00,24000.00,25000.00,0.00,24000.00,0.28,1
24098,2637,-1000.00,23000.00,24000.00,4391.73,3447.33,0.15,0
24099,2637,1000.00,24000.00,25000.00,6753.90,17246.10,0.28,1
24100,2637,1000.00,25000.00,26000.00,324.79,10195.63,0.27,1
24101,2637,-1000.00,24000.00,25000.00,15183.43,10816.57,0.10,0
24102,2637,1000.00,25000.00,26000.00,5025.04,13591.66,0.31,1
24103,2637,-1000.00,24000.00,25000.00,13000.00,13000.00,0.04,0
24104,2637,-1000.00,23000.00,24000.00,0.00,15792.45,0.20,0
24105,2637,-1000.00,22000.00,23000.00,3293.82,16014.50,0.38,0
24106,2637,-1000.00,21000.00,22000.00,11500.00,11500.00,0.06,0
24107,2637,-1000.00,20000.00,21000.00,0.00,22000.00,0.23,0
24108,2637,-1000.00,19000.00,20000.00,0.00,4124.53,0.11,0
24109,2637,-1000.00,18000.00,19000.00,8126.59,11873.41,0.28,0
24110,2637,-1000.00,17000.00,18000.00,0.00,19000.00,0.43,0
24111,2637,-1000.00,16000.00,17000.00,10044.30,7955.70,0.18,0
24112,2637,-699.56,15300.44,16300.44,0.00,699.56,0.11,0
24113,2637,-1000.00,14300.44,15300.44,0.00,16300.44,0.10,0
24114,2637,-1000.00,13300.44,14300.44,0.00,11530.48,0.30,0
24115,2637,-1000.00,12300.44,13300.44,0.00,14300.44,0.22,0
24116,2637,-1000.00,11300.44,12300.44,0.00,3120.74,0.21,0
24117,2637,-1000.00,10300.44,11300.44,1077.98,313.68,0.12,0
24118,2637,-1000.00,9300.44,10300.44,4134.15,7166.29,0.27,0
24119,2637,-1000.00,8300.44,9300.44,0.00,10300.44,0.07,0
24120,2637,-1000.00,7300.44,8300.44,1358.38,7942.06,0.34,0
24121,2637,-1000.00,6300.44,7300.44,5656.82,2643.62,0.24,0
24122,2637,-1000.00,5300.44,6300.44,0.00,7300.44,0.24,0
24123,2637,-1000.00,4300.44,5300.44,2822.64,3477.80,0.27,0
24124,2637,-1000.00,3300.44,4300.44,1580.47,3471.44,0.30,0
24125,2637,-1000.00,2300.44,3300.44,0.00,4300.44,0.21,0
24126,2638,-1000.00,-1000.00,0.00,500.00,500.00,0.07,0
24127,2639,-1000.00,-1000.00,0.00,0.00,464.29,0.06,0
24128,2640,-1000.00,-1000.00,0.00,90.45,909.55,0.44,0
24129,2641,-283.52,-283.52,716.48,0.00,283.52,0.19,0
24130,2641,-716.48,-1000.00,0.00,0.00,716.48,0.29,0
24131,2642,-1000.00,-1000.00,0.00,0.00,1000.00,0.38,0
24132,2643,-998.40,-998.40,1.60,0.00,998.40,0.32,0
24133,2643,-1.60,-1000.00,0.00,0.00,1.60,0.15,0
24134,2644,0.00,0.00,1000.00,0.00,0.00,0.13,0
24135,2644,-710.13,-710.13,289.87,0.00,710.13,0.35,0
24136,2644,-289.87,-1000.00,0.00,70.12,219.75,0.14,0
24137,2645,0.00,0.00,1000.00,0.00,0.00,0.16,0
24138,2645,-475.38,-475.38,524.62,475.38,0.00,0.24,0
24139,2645,0.00,-475.38,524.62,0.00,0.00,0.01,0
24140,2645,0.00,-475.38,524.62,0.00,0.00,0.28,0
24141,2645,-524.62,-1000.00,0.00,524.62,0.00,0.31,0
24142,2646,-1000.00,-1000.00,0.00,0.00,1000.00,0.24,0
24143,2647,0.00,0.00,1000.00,0.00,0.00,0.08,0
24144,2647,-1000.00,-1000.00,0.00,0.00,1000.00,0.22,0
24145,2648,-1000.00,-1000.00,0.00,0.00,1000.00,0.26,0
24146,2649,1000.00,1000.00,2000.00,0.00,974.61,0.37,1
24147,2649,1000.00,2000.00,3000.00,0.00,2000.00,0.29,1
24148,2649,1000.00,3000.00,4000.00,0.00,2810.63,0.41,1
24149,2649,1000.00,4000.00,5000.00,0.00,1026.71,0.20,1
24150,2649,1000.00,5000.00,6000.00,2018.62,2981.38,0.26,1
24151,2649,1000.00,6000.00,7000.00,3000.00,3000.00,0.07,1
24152,2649,-1000.00,5000.00,6000.00,3562.56,3437.44,0.08,0
24153,2649,1000.00,6000.00,7000.00,0.00,4898.82,0.23,1
24154,2649,1000.00,7000.00,8000.00,2854.50,4145.50,0.29,1
24155,2649,1000.00,8000.00,9000.00,1091.29,6908.71,0.23,1
24156,2649,1000.00,9000.00,10000.00,1838.11,7161.89,0.20,1
24157,2649,1000.00,10000.00,11000.00,5000.00,5000.00,0.06,1
24158,2649,1000.00,11000.00,12000.00,0.00,11000.00,0.41,1
24159,2649,1000.00,12000.00,13000.00,0.00,12000.00,0.14,1
24160,2649,1000.00,13000.00,14000.00,6066.60,6933.40,0.15,1
24161,2649,-1000.00,12000.00,13000.00,6213.04,3826.67,0.16,0
24162,2649,-1000.00,11000.00,12000.00,13000.00,0.00,0.03,0
24163,2649,1000.00,12000.00,13000.00,2895.61,9104.39,0.40,1
24164,2649,1000.00,13000.00,14000.00,0.00,9489.19,0.40,1
24165,2649,1000.00,14000.00,15000.00,1564.97,6273.31,0.28,1
24166,2649,1000.00,15000.00,16000.00,0.00,9800.60,0.33,1
24167,2649,-1000.00,14000.00,15000.00,9811.99,6188.01,0.30,0
24168,2649,1000.00,15000.00,16000.00,7500.00,7500.00,0.21,1
24169,2649,1000.00,16000.00,17000.00,0.00,8217.87,0.14,1
24170,2649,1000.00,17000.00,18000.00,3641.67,7588.59,0.26,1
24171,2649,1000.00,18000.00,19000.00,0.00,18000.00,0.20,1
24172,2649,1000.00,19000.00,20000.00,0.00,19000.00,0.08,1
24173,2649,1000.00,20000.00,21000.00,8022.23,11977.77,0.41,1
24174,2649,1000.00,21000.00,22000.00,7941.04,10038.95,0.25,1
24175,2649,1000.00,22000.00,23000.00,7681.76,14318.24,0.17,1
24176,2649,1000.00,23000.00,24000.00,0.00,9419.74,0.27,1
24177,2649,1000.00,24000.00,25000.00,4394.47,16108.08,0.36,1
24178,2649,1000.00,25000.00,26000.00,12500.00,12500.00,0.07,1
24179,2649,1000.00,26000.00,27000.00,0.00,26000.00,0.38,1
24180,2649,-1000.00,25000.00,26000.00,14296.18,12703.82,0.37,0
24181,2649,1000.00,26000.00,27000.00,12832.58,13167.42,0.09,1
24182,2649,1000.00,27000.00,28000.00,0.00,9765.02,0.18,1
24183,2649,1000.00,28000.00,29000.00,69.02,23633.16,0.43,1
24184,2649,1000.00,29000.00,30000.00,0.00,29000.00,0.39,1
24185,2649,1000.00,30000.00,31000.00,0.00,30000.00,0.31,1
24186,2649,-1000.00,29000.00,30000.00,16511.12,14488.88,0.11,0
24187,2649,1000.00,30000.00,31000.00,0.00,1310.38,0.12,1
24188,2649,1000.00,31000.00,32000.00,0.00,18108.60,0.22,1
24189,2649,1000.00,32000.00,33000.00,0.00,30330.23,0.05,1
24190,2649,1000.00,33000.00,34000.00,0.00,10888.69,0.02,1
24191,2649,-1000.00,32000.00,33000.00,19797.12,14202.88,0.11,0
24192,2650,-1000.00,-1000.00,0.00,228.98,771.02,0.39,0
24193,2651,-1000.00,-1000.00,0.00,0.00,1000.00,0.23,0
24194,2652,-1000.00,-1000.00,0.00,0.00,1000.00,0.21,0
24195,2653,-1000.00,-1000.00,0.00,260.12,739.88,0.35,0
24196,2654,-1000.00,-1000.00,0.00,182.07,817.93,0.16,0
24197,2654,-0.00,-1000.00,0.00,0.00,0.00,0.31,0
24198,2655,-925.96,-925.96,74.04,0.00,925.96,0.24,0
24199,2655,-63.63,-989.60,10.40,6.35,57.28,0.44,0
24200,2655,-7.85,-997.45,2.55,1.38,6.47,0.42,0
24201,2655,0.00,-997.45,2.55,0.00,0.00,0.18,0
24202,2655,-2.55,-1000.00,0.00,0.00,2.55,0.30,0
24203,2656,-3.23,-3.23,996.77,0.00,3.23,0.11,0
24204,2656,-996.77,-1000.00,0.00,0.00,996.77,0.29,0
24205,2657,-1000.00,-1000.00,0.00,181.45,621.82,0.36,0
24206,2658,1000.00,1000.00,2000.00,0.00,280.39,0.18,1
24207,2658,-1000.00,0.00,1000.00,1063.72,936.28,0.12,0
24208,2658,1000.00,1000.00,2000.00,0.00,408.17,0.10,1
24209,2658,-1000.00,0.00,1000.00,1062.95,937.05,0.00,0
24210,2658,1000.00,1000.00,2000.00,140.75,859.25,0.42,1
24211,2658,-1000.00,0.00,1000.00,1055.33,944.67,0.30,0
24212,2658,-463.27,-463.27,536.73,463.27,0.00,0.08,0
24213,2658,1000.00,536.73,1536.73,0.00,536.73,0.43,1
24214,2658,1000.00,1536.73,2536.73,0.00,1536.73,0.22,1
24215,2658,1000.00,2536.73,3536.73,0.00,1235.94,0.19,1
24216,2658,0.00,2536.73,3536.73,0.00,0.00,0.08,0
24217,2658,-1000.00,1536.73,2536.73,1855.32,1681.41,0.43,0
24218,2658,0.00,1536.73,2536.73,0.00,0.00,0.01,0
24219,2658,1000.00,2536.73,3536.73,0.00,2536.73,0.32,1
24220,2658,1000.00,3536.73,4536.73,824.40,2712.33,0.37,1
24221,2658,1000.00,4536.73,5536.73,0.00,4536.73,0.26,1
24222,2658,1000.00,5536.73,6536.73,2153.29,3383.44,0.32,1
24223,2658,1000.00,6536.73,7536.73,355.14,6181.60,0.43,1
24224,2658,1000.00,7536.73,8536.73,0.00,3136.52,0.28,1
24225,2658,1000.00,8536.73,9536.73,0.00,3300.85,0.26,1
24226,2658,1000.00,9536.73,10536.73,2343.96,7192.77,0.38,1
24227,2658,1000.00,10536.73,11536.73,0.00,10536.73,0.02,1
24228,2658,-1000.00,9536.73,10536.73,4105.35,7431.38,0.17,0
24229,2658,-1000.00,8536.73,9536.73,0.00,8623.58,0.17,0
24230,2658,-1000.00,7536.73,8536.73,1023.05,8513.69,0.36,0
24231,2658,-1000.00,6536.73,7536.73,0.00,8536.73,0.28,0
24232,2658,-1000.00,5536.73,6536.73,0.00,1499.84,0.15,0
24233,2658,-1000.00,4536.73,5536.73,1435.04,5101.69,0.22,0
24234,2658,-1000.00,3536.73,4536.73,1264.25,3977.25,0.37,0
24235,2658,-1000.00,2536.73,3536.73,2233.07,2303.66,0.25,0
24236,2658,-1000.00,1536.73,2536.73,1768.37,1768.37,0.01,0
24237,2658,-1000.00,536.73,1536.73,1372.63,1164.10,0.16,0
24238,2658,-1000.00,-463.27,536.73,55.03,1481.70,0.44,0
24239,2658,-536.73,-1000.00,0.00,268.37,268.37,0.11,0
24240,2659,-369.52,-369.52,630.48,0.00,369.52,0.08,0
24241,2659,-1000.00,-1369.52,-369.52,337.38,293.11,0.03,0
24242,2660,1000.00,1000.00,2000.00,419.16,580.84,0.21,1
24243,2660,1000.00,2000.00,3000.00,643.46,1238.98,0.32,1
24244,2660,1000.00,3000.00,4000.00,0.00,1159.72,0.26,1
24245,2660,1000.00,4000.00,5000.00,0.00,2321.79,0.33,1
24246,2660,1000.00,5000.00,6000.00,0.00,4423.67,0.42,1
24247,2660,1000.00,6000.00,7000.00,2221.32,3778.68,0.25,1
24248,2660,1000.00,7000.00,8000.00,0.00,7000.00,0.01,1
24249,2660,1000.00,8000.00,9000.00,0.00,7340.01,0.44,1
24250,2660,1000.00,9000.00,10000.00,4360.61,4639.39,0.09,1
24251,2660,1000.00,10000.00,11000.00,0.00,4533.90,0.26,1
24252,2660,1000.00,11000.00,12000.00,2131.53,8868.47,0.04,1
24253,2660,1000.00,12000.00,13000.00,5312.76,6687.24,0.21,1
24254,2660,1000.00,13000.00,14000.00,4954.30,8045.70,0.27,1
24255,2660,1000.00,14000.00,15000.00,5488.63,8511.37,0.23,1
24256,2660,1000.00,15000.00,16000.00,0.00,15000.00,0.27,1
24257,2660,1000.00,16000.00,17000.00,4711.46,11288.54,0.35,1
24258,2660,1000.00,17000.00,18000.00,8236.54,8762.84,0.23,1
24259,2660,1000.00,18000.00,19000.00,6023.44,8372.38,0.27,1
24260,2660,1000.00,19000.00,20000.00,7197.21,11802.79,0.09,1
24261,2660,-1000.00,18000.00,19000.00,15434.73,4565.27,0.16,0
24262,2660,1000.00,19000.00,20000.00,4651.03,14348.97,0.38,1
24263,2660,1000.00,20000.00,21000.00,5854.83,14145.17,0.20,1
24264,2660,1000.00,21000.00,22000.00,0.00,10261.66,0.21,1
24265,2660,1000.00,22000.00,23000.00,0.00,16630.38,0.39,1
24266,2660,1000.00,23000.00,24000.00,0.00,23000.00,0.12,1
24267,2660,-1000.00,22000.00,23000.00,20757.02,3242.98,0.03,0
24268,2660,1000.00,23000.00,24000.00,2891.52,10620.42,0.30,1
24269,2660,1000.00,24000.00,25000.00,0.00,17682.82,0.37,1
24270,2660,0.00,24000.00,25000.00,0.00,0.00,0.01,0
24271,2660,1000.00,25000.00,26000.00,8685.10,16314.90,0.33,1
24272,2660,1000.00,26000.00,27000.00,0.00,4985.04,0.08,1
24273,2660,1000.00,27000.00,28000.00,7261.57,19738.43,0.06,1
24274,2660,1000.00,28000.00,29000.00,8691.45,19308.55,0.33,1
24275,2660,1000.00,29000.00,30000.00,10770.25,18229.75,0.26,1
24276,2660,1000.00,30000.00,31000.00,0.00,17930.31,0.34,1
24277,2660,1000.00,31000.00,32000.00,5333.69,25666.31,0.41,1
24278,2660,1000.00,32000.00,33000.00,4328.26,26589.32,0.41,1
24279,2660,1000.00,33000.00,34000.00,0.00,23878.99,0.39,1
24280,2660,1000.00,34000.00,35000.00,0.00,17746.02,0.22,1
24281,2660,1000.00,35000.00,36000.00,17473.47,17526.53,0.06,1
24282,2660,1000.00,36000.00,37000.00,0.00,36000.00,0.43,1
24283,2661,-1000.00,-1000.00,0.00,0.00,1000.00,0.43,0
24284,2662,-316.27,-316.27,683.73,0.00,316.27,0.10,0
24285,2662,-683.73,-1000.00,0.00,9.99,673.75,0.41,0
24286,2662,-0.00,-1000.00,0.00,0.00,0.00,0.30,0
24287,2663,-1000.00,-1000.00,0.00,422.02,577.98,0.15,0
24288,2663,-0.00,-1000.00,0.00,0.00,0.00,0.35,0
24289,2663,-0.00,-1000.00,-0.00,0.00,0.00,0.11,0
24290,2664,-625.28,-625.28,374.72,0.00,625.28,0.30,0
24291,2664,-329.66,-954.94,45.06,0.00,329.66,0.24,0
24292,2664,-45.06,-1000.00,0.00,0.00,45.06,0.06,0
24293,2665,-1000.00,-1000.00,0.00,91.17,0.00,0.04,0
24294,2666,-1000.00,-1000.00,0.00,484.39,515.61,0.05,0
24295,2667,-818.88,-818.88,181.12,200.53,618.36,0.34,0
24296,2667,-99.02,-917.91,82.09,32.19,66.83,0.24,0
24297,2667,-81.53,-999.44,0.56,0.00,81.53,0.42,0
24298,2667,-0.56,-1000.00,0.00,0.17,0.39,0.32,0
24299,2668,-1000.00,-1000.00,0.00,0.00,1000.00,0.11,0
24300,2669,1000.00,1000.00,2000.00,0.00,617.94,0.26,1
24301,2669,1000.00,2000.00,3000.00,122.10,1877.90,0.18,1
24302,2669,1000.00,3000.00,4000.00,1398.78,1601.22,0.06,1
24303,2669,1000.00,4000.00,5000.00,1289.42,2710.58,0.20,1
24304,2669,1000.00,5000.00,6000.00,141.13,4514.83,0.44,1
24305,2669,1000.00,6000.00,7000.00,0.00,6000.00,0.34,1
24306,2669,1000.00,7000.00,8000.00,2323.88,4676.12,0.26,1
24307,2669,1000.00,8000.00,9000.00,4000.00,4000.00,0.40,1
24308,2669,1000.00,9000.00,10000.00,2459.40,6540.60,0.37,1
24309,2669,1000.00,10000.00,11000.00,0.00,10000.00,0.35,1
24310,2669,1000.00,11000.00,12000.00,0.00,11000.00,0.35,1
24311,2669,1000.00,12000.00,13000.00,2004.16,9755.32,0.41,1
24312,2669,1000.00,13000.00,14000.00,0.00,13000.00,0.22,1
24313,2669,1000.00,14000.00,15000.00,0.00,14000.00,0.08,1
24314,2669,1000.00,15000.00,16000.00,5969.86,9030.14,0.29,1
24315,2669,0.00,15000.00,16000.00,0.00,0.00,0.03,0
24316,2669,1000.00,16000.00,17000.00,0.00,12845.79,0.36,1
24317,2669,1000.00,17000.00,18000.00,0.00,17000.00,0.08,1
24318,2669,1000.00,18000.00,19000.00,1737.27,10755.81,0.35,1
24319,2669,-1000.00,17000.00,18000.00,2628.79,0.00,0.01,0
24320,2669,-1000.00,16000.00,17000.00,12031.92,5968.08,0.13,0
24321,2669,1000.00,17000.00,18000.00,7215.09,9784.91,0.24,1
24322,2669,1000.00,18000.00,19000.00,8649.30,9350.70,0.42,1
24323,2669,-1000.00,17000.00,18000.00,3809.98,0.00,0.10,0
24324,2669,-1000.00,16000.00,17000.00,9904.04,7555.94,0.28,0
24325,2669,-1000.00,15000.00,16000.00,1174.73,0.00,0.03,0
24326,2669,1000.00,16000.00,17000.00,6308.16,6983.83,0.23,1
24327,2669,1000.00,17000.00,18000.00,0.00,17000.00,0.26,1
24328,2669,1000.00,18000.00,19000.00,0.00,16045.16,0.15,1
24329,2669,1000.00,19000.00,20000.00,0.00,19000.00,0.03,1
24330,2669,0.00,19000.00,20000.00,0.00,0.00,0.06,0
24331,2669,1000.00,20000.00,21000.00,0.00,20000.00,0.35,1
24332,2669,1000.00,21000.00,22000.00,10500.00,10500.00,0.36,1
24333,2669,1000.00,22000.00,23000.00,0.00,8355.40,0.22,1
24334,2669,1000.00,23000.00,24000.00,8422.49,14577.51,0.17,1
24335,2669,1000.00,24000.00,25000.00,0.00,24000.00,0.34,1
24336,2669,1000.00,25000.00,26000.00,7536.28,17463.72,0.32,1
24337,2669,-1000.00,24000.00,25000.00,10854.77,8846.50,0.19,0
24338,2669,1000.00,25000.00,26000.00,2323.17,14247.84,0.34,1
24339,2669,1000.00,26000.00,27000.00,0.00,23435.32,0.41,1
24340,2669,1000.00,27000.00,28000.00,13500.00,13500.00,0.04,1
24341,2669,-1000.00,26000.00,27000.00,28000.00,0.00,0.04,0
24342,2669,1000.00,27000.00,28000.00,0.00,9075.52,0.19,1
24343,2669,1000.00,28000.00,29000.00,4434.78,23565.22,0.16,1
24344,2669,1000.00,29000.00,30000.00,0.00,25033.02,0.43,1
24345,2669,1000.00,30000.00,31000.00,0.00,24040.92,0.39,1
24346,2669,1000.00,31000.00,32000.00,4417.85,26582.15,0.06,1
24347,2669,1000.00,32000.00,33000.00,10882.16,21117.84,0.42,1
24348,2670,-1000.00,-1000.00,0.00,191.81,808.19,0.26,0
24349,2671,-1000.00,-1000.00,0.00,221.57,778.43,0.29,0
24350,2672,-1000.00,-1000.00,0.00,313.59,686.41,0.30,0
24351,2673,-1000.00,-1000.00,0.00,0.00,1000.00,0.15,0
24352,2674,-1000.00,-1000.00,0.00,0.00,1000.00,0.12,0
24353,2675,-851.54,-851.54,148.46,0.00,851.54,0.39,0
24354,2675,-1000.00,-1851.54,-851.54,77.14,71.32,0.15,0
24355,2676,-1000.00,-1000.00,0.00,684.74,315.26,0.13,0
24356,2677,-1000.00,-1000.00,0.00,490.22,509.78,0.24,0
24357,2678,-1000.00,-1000.00,0.00,0.00,1000.00,0.22,0
24358,2679,-1000.00,-1000.00,0.00,0.00,1000.00,0.34,0
24359,2680,-290.92,-290.92,709.08,290.92,0.00,0.07,0
24360,2680,1000.00,709.08,1709.08,0.00,709.08,0.14,1
24361,2680,1000.00,1709.08,2709.08,0.00,391.03,0.18,1
24362,2680,1000.00,2709.08,3709.08,0.00,1916.21,0.14,1
24363,2680,1000.00,3709.08,4709.08,1698.68,2010.40,0.22,1
24364,2680,-1000.00,2709.08,3709.08,3199.34,1509.74,0.04,0
24365,2680,1000.00,3709.08,4709.08,1643.71,2065.37,0.17,1
24366,2680,1000.00,4709.08,5709.08,0.00,4709.08,0.01,1
24367,2680,1000.00,5709.08,6709.08,0.00,5239.76,0.36,1
24368,2680,1000.00,6709.08,7709.08,0.00,4346.10,0.32,1
24369,2680,1000.00,7709.08,8709.08,0.00,7709.08,0.31,1
24370,2680,1000.00,8709.08,9709.08,3503.85,5205.23,0.18,1
24371,2680,0.00,8709.08,9709.08,0.00,0.00,0.04,0
24372,2680,1000.00,9709.08,10709.08,1570.95,8138.13,0.36,1
24373,2680,1000.00,10709.08,11709.08,1983.12,8725.96,0.15,1
24374,2680,1000.00,11709.08,12709.08,3433.79,8275.29,0.18,1
24375,2680,-1000.00,10709.08,11709.08,6667.33,6041.75,0.13,0
24376,2680,1000.00,11709.08,12709.08,0.00,11709.08,0.03,1
24377,2680,1000.00,12709.08,13709.08,0.00,7596.67,0.32,1
24378,2680,1000.00,13709.08,14709.08,6575.21,7133.87,0.23,1
24379,2680,1000.00,14709.08,15709.08,0.00,7757.30,0.32,1
24380,2680,1000.00,15709.08,16709.08,1928.44,9179.99,0.34,1
24381,2680,-1000.00,14709.08,15709.08,6808.95,9900.13,0.38,0
24382,2680,-1000.00,13709.08,14709.08,0.00,15709.08,0.06,0
24383,2680,-1000.00,12709.08,13709.08,0.00,12173.65,0.27,0
24384,2680,-1000.00,11709.08,12709.08,5788.91,7920.17,0.38,0
24385,2680,-456.18,11252.90,12252.90,0.00,456.18,0.12,0
24386,2680,-1000.00,10252.90,11252.90,0.00,4370.05,0.23,0
24387,2680,-1000.00,9252.90,10252.90,9602.42,1650.49,0.03,0
24388,2680,-1000.00,8252.90,9252.90,2472.86,3245.35,0.21,0
24389,2680,-1000.00,7252.90,8252.90,4918.75,4334.15,0.15,0
24390,2680,-1000.00,6252.90,7252.90,0.00,8252.90,0.09,0
24391,2680,-1000.00,5252.90,6252.90,2976.56,4276.34,0.19,0
24392,2680,-1000.00,4252.90,5252.90,0.00,2745.60,0.05,0
24393,2680,-1000.00,3252.90,4252.90,0.00,5252.90,0.17,0
24394,2680,-1000.00,2252.90,3252.90,0.00,4252.90,0.01,0
24395,2680,-1000.00,1252.90,2252.90,2777.13,475.77,0.05,0
24396,2680,0.00,1252.90,2252.90,0.00,0.00,0.03,0
24397,2680,-1000.00,252.90,1252.90,864.40,1388.51,0.10,0
24398,2680,-1000.00,-747.10,252.90,0.00,1015.86,0.33,0
24399,2680,-252.90,-1000.00,0.00,0.00,252.90,0.16,0
24400,2681,1000.00,1000.00,2000.00,558.72,441.28,0.10,1
24401,2681,-1000.00,0.00,1000.00,0.00,1156.57,0.29,0
24402,2681,-100.21,-100.21,899.79,0.00,100.21,0.10,0
24403,2681,-769.59,-869.79,130.21,0.00,769.59,0.33,0
24404,2681,-130.21,-1000.00,0.00,65.10,65.10,0.15,0
24405,2682,-553.29,-553.29,446.71,88.91,464.39,0.29,0
24406,2682,-446.71,-1000.00,0.00,0.00,446.71,0.34,0
24407,2683,1000.00,1000.00,2000.00,358.22,641.78,0.26,1
24408,2683,1000.00,2000.00,3000.00,0.00,2000.00,0.13,1
24409,2683,1000.00,3000.00,4000.00,0.00,3000.00,0.36,1
24410,2683,1000.00,4000.00,5000.00,2000.00,2000.00,0.04,1
24411,2683,1000.00,5000.00,6000.00,242.27,4757.73,0.44,1
24412,2683,1000.00,6000.00,7000.00,0.00,5429.87,0.37,1
24413,2683,1000.00,7000.00,8000.00,1655.21,5344.79,0.21,1
24414,2683,1000.00,8000.00,9000.00,3441.42,4558.58,0.13,1
24415,2683,1000.00,9000.00,10000.00,3827.17,5172.83,0.36,1
24416,2683,1000.00,10000.00,11000.00,299.54,9700.46,0.33,1
24417,2683,1000.00,11000.00,12000.00,609.66,10390.34,0.42,1
24418,2683,1000.00,12000.00,13000.00,5600.52,6399.48,0.24,1
24419,2683,1000.00,13000.00,14000.00,0.00,11873.65,0.43,1
24420,2683,1000.00,14000.00,15000.00,0.00,13885.10,0.09,1
24421,2683,1000.00,15000.00,16000.00,7500.00,7500.00,0.26,1
24422,2683,1000.00,16000.00,17000.00,12370.36,75.73,0.10,1
24423,2683,-1000.00,15000.00,16000.00,6922.03,10077.97,0.01,0
24424,2683,-1000.00,14000.00,15000.00,0.00,16000.00,0.36,0
24425,2683,-1000.00,13000.00,14000.00,0.00,6010.27,0.27,0
24426,2683,-1000.00,12000.00,13000.00,0.00,13225.93,0.43,0
24427,2683,-1000.00,11000.00,12000.00,0.00,13000.00,0.40,0
24428,2683,-1000.00,10000.00,11000.00,3222.57,8777.43,0.07,0
24429,2683,1000.00,11000.00,12000.00,3317.04,2857.69,0.18,1
24430,2683,-1000.00,10000.00,11000.00,0.00,9923.66,0.09,0
24431,2683,0.00,10000.00,11000.00,0.00,0.00,0.04,0
24432,2683,-1000.00,9000.00,10000.00,3118.87,7881.13,0.23,0
24433,2683,-1000.00,8000.00,9000.00,4053.84,5946.16,0.02,0
24434,2683,-1000.00,7000.00,8000.00,0.00,6037.71,0.18,0
24435,2683,-1000.00,6000.00,7000.00,0.00,8000.00,0.18,0
24436,2683,-1000.00,5000.00,6000.00,3500.00,3500.00,0.06,0
24437,2683,-1000.00,4000.00,5000.00,2641.91,3358.09,0.13,0
24438,2683,1000.00,5000.00,6000.00,1994.37,1987.64,0.21,1
24439,2683,-1000.00,4000.00,5000.00,301.41,5698.59,0.44,0
24440,2683,-1000.00,3000.00,4000.00,1066.18,3458.18,0.36,0
24441,2683,-1000.00,2000.00,3000.00,912.21,3087.79,0.39,0
24442,2683,-1000.00,1000.00,2000.00,292.13,2137.20,0.39,0
24443,2683,-1000.00,0.00,1000.00,0.00,2000.00,0.05,0
24444,2683,-1000.00,-1000.00,0.00,500.00,500.00,0.40,0
24445,2684,-1000.00,-1000.00,0.00,358.70,641.30,0.30,0
24446,2685,-1000.00,-1000.00,0.00,0.00,803.68,0.20,0
24447,2686,-1000.00,-1000.00,0.00,0.00,1000.00,0.06,0
24448,2687,1000.00,1000.00,2000.00,154.60,845.40,0.42,1
24449,2687,-1000.00,0.00,1000.00,1443.06,455.05,0.09,0
24450,2687,1000.00,1000.00,2000.00,500.00,500.00,0.16,1
24451,2687,1000.00,2000.00,3000.00,0.00,1335.40,0.26,1
24452,2687,1000.00,3000.00,4000.00,1110.75,1889.25,0.38,1
24453,2687,1000.00,4000.00,5000.00,417.77,3582.23,0.09,1
24454,2687,1000.00,5000.00,6000.00,0.00,5000.00,0.19,1
24455,2687,-1000.00,4000.00,5000.00,3500.51,2499.49,0.18,0
24456,2687,1000.00,5000.00,6000.00,2500.00,2500.00,0.05,1
24457,2687,-1000.00,4000.00,5000.00,3696.29,2303.71,0.14,0
24458,2687,1000.00,5000.00,6000.00,0.00,4322.02,0.43,1
24459,2687,1000.00,6000.00,7000.00,0.00,1637.94,0.20,1
24460,2687,1000.00,7000.00,8000.00,2794.86,4205.14,0.27,1
24461,2687,1000.00,8000.00,9000.00,0.00,1248.55,0.16,1
24462,2687,-1000.00,7000.00,8000.00,6619.89,2380.11,0.25,0
24463,2687,1000.00,8000.00,9000.00,4000.00,4000.00,0.13,1
24464,2687,1000.00,9000.00,10000.00,0.00,9000.00,0.36,1
24465,2687,1000.00,10000.00,11000.00,4948.21,5051.79,0.38,1
24466,2687,1000.00,11000.00,12000.00,0.00,4058.33,0.24,1
24467,2687,1000.00,12000.00,13000.00,0.00,12000.00,0.00,1
24468,2687,1000.00,13000.00,14000.00,1002.27,10569.01,0.42,1
24469,2687,1000.00,14000.00,15000.00,6585.69,7414.31,0.25,1
24470,2687,1000.00,15000.00,16000.00,0.00,15000.00,0.31,1
24471,2687,1000.00,16000.00,17000.00,0.00,16000.00,0.33,1
24472,2687,1000.00,17000.00,18000.00,0.00,12852.14,0.34,1
24473,2687,1000.00,18000.00,19000.00,0.00,11439.53,0.10,1
24474,2687,1000.00,19000.00,20000.00,0.00,19000.00,0.34,1
24475,2687,-1000.00,18000.00,19000.00,10395.36,9604.64,0.06,0
24476,2687,-1000.00,17000.00,18000.00,10775.91,7090.44,0.26,0
24477,2687,1000.00,18000.00,19000.00,9000.00,9000.00,0.10,1
24478,2687,-1000.00,17000.00,18000.00,11396.11,7603.89,0.09,0
24479,2687,1000.00,18000.00,19000.00,5061.29,12938.71,0.32,1
24480,2687,1000.00,19000.00,20000.00,0.00,14873.82,0.40,1
24481,2687,1000.00,20000.00,21000.00,0.00,20000.00,0.04,1
24482,2687,1000.00,21000.00,22000.00,6542.56,14457.44,0.30,1
24483,2687,-1000.00,20000.00,21000.00,13057.83,8942.17,0.30,0
24484,2687,-1000.00,19000.00,20000.00,18502.49,2497.51,0.09,0
24485,2687,1000.00,20000.00,21000.00,9571.98,10428.02,0.38,1
24486,2687,-1000.00,19000.00,20000.00,10342.99,0.00,0.05,0
24487,2687,1000.00,20000.00,21000.00,0.00,20000.00,0.04,1
24488,2687,1000.00,21000.00,22000.00,4107.32,16892.68,0.42,1
24489,2687,1000.00,22000.00,23000.00,0.00,22000.00,0.40,1
24490,2687,1000.00,23000.00,24000.00,0.00,23000.00,0.10,1
24491,2687,-1000.00,22000.00,23000.00,15494.49,8505.51,0.01,0
24492,2687,1000.00,23000.00,24000.00,0.00,14968.23,0.33,1
24493,2688,-1000.00,-1000.00,0.00,0.00,1000.00,0.29,0
24494,2689,-1000.00,-1000.00,0.00,1000.00,0.00,0.00,0
24495,2690,-1000.00,-1000.00,0.00,0.00,1000.00,0.25,0
24496,2691,-1000.00,-1000.00,0.00,229.48,770.52,0.35,0
24497,2692,-1000.00,-1000.00,0.00,0.00,1000.00,0.41,0
24498,2693,-1000.00,-1000.00,0.00,503.51,496.49,0.07,0
24499,2694,0.00,0.00,1000.00,0.00,0.00,0.09,0
24500,2694,0.00,0.00,1000.00,0.00,0.00,0.08,0
24501,2694,-1000.00,-1000.00,0.00,60.09,733.18,0.41,0
24502,2695,1000.00,1000.00,2000.00,0.00,901.45,0.33,1
24503,2695,-1000.00,0.00,1000.00,1484.04,515.96,0.07,0
24504,2695,-468.27,-468.27,531.73,430.90,37.37,0.09,0
24505,2695,1000.00,531.73,1531.73,0.00,531.73,0.40,1
24506,2695,1000.00,1531.73,2531.73,594.74,936.99,0.25,1
24507,2695,1000.00,2531.73,3531.73,727.48,1804.25,0.22,1
24508,2695,1000.00,3531.73,4531.73,0.00,3531.73,0.37,1
24509,2695,-1000.00,2531.73,3531.73,1640.33,807.38,0.14,0
24510,2695,-1000.00,1531.73,2531.73,2504.02,1027.70,0.10,0
24511,2695,-1000.00,531.73,1531.73,1383.86,1147.87,0.26,0
24512,2695,1000.00,1531.73,2531.73,0.00,1531.73,0.01,1
24513,2695,1000.00,2531.73,3531.73,570.94,925.23,0.22,1
24514,2695,-1000.00,1531.73,2531.73,2013.06,1518.67,0.34,0
24515,2695,-1000.00,531.73,1531.73,1060.73,1471.00,0.17,0
24516,2695,-1000.00,-468.27,531.73,602.43,929.30,0.30,0
24517,2695,-1000.00,-1468.27,-468.27,265.86,265.86,0.09,0
24518,2696,-1000.00,-1000.00,0.00,182.51,817.49,0.41,0
24519,2697,-329.52,-329.52,670.48,317.41,12.11,0.11,0
24520,2697,-1000.00,-1329.52,-329.52,0.00,670.48,0.09,0
24521,2698,0.00,0.00,1000.00,0.00,0.00,0.26,0
24522,2698,-456.05,-456.05,543.95,456.05,0.00,0.15,0
24523,2698,-1000.00,-1456.05,-456.05,269.50,274.45,0.12,0
24524,2699,-1000.00,-1000.00,0.00,256.61,743.39,0.21,0
24525,2700,1000.00,1000.00,2000.00,355.24,644.76,0.24,1
24526,2700,1000.00,2000.00,3000.00,0.00,2000.00,0.10,1
24527,2700,-1000.00,1000.00,2000.00,1632.65,1367.35,0.20,0
24528,2700,-1000.00,0.00,1000.00,991.51,741.41,0.18,0
24529,2700,1000.00,1000.00,2000.00,270.00,730.00,0.28,1
24530,2700,0.00,1000.00,2000.00,0.00,0.00,0.03,0
24531,2700,1000.00,2000.00,3000.00,0.00,2000.00,0.35,1
24532,2700,1000.00,3000.00,4000.00,0.00,3000.00,0.44,1
24533,2700,1000.00,4000.00,5000.00,1428.90,1653.38,0.23,1
24534,2700,1000.00,5000.00,6000.00,1093.46,3906.54,0.38,1
24535,2700,-1000.00,4000.00,5000.00,3556.77,2443.23,0.02,0
24536,2700,-1000.00,3000.00,4000.00,3602.22,1397.78,0.08,0
24537,2700,1000.00,4000.00,5000.00,0.00,4000.00,0.25,1
24538,2700,1000.00,5000.00,6000.00,807.61,4192.39,0.42,1
24539,2700,1000.00,6000.00,7000.00,0.00,6000.00,0.17,1
24540,2700,1000.00,7000.00,8000.00,1101.31,5898.69,0.20,1
24541,2700,-1000.00,6000.00,7000.00,1278.23,764.81,0.14,0
24542,2700,1000.00,7000.00,8000.00,0.00,7000.00,0.34,1
24543,2700,1000.00,8000.00,9000.00,1564.14,6435.86,0.26,1
24544,2700,1000.00,9000.00,10000.00,4500.00,4500.00,0.36,1
24545,2700,1000.00,10000.00,11000.00,678.57,9321.43,0.40,1
24546,2700,-1000.00,9000.00,10000.00,2482.57,865.17,0.13,0
24547,2700,1000.00,10000.00,11000.00,0.00,10000.00,0.17,1
24548,2700,1000.00,11000.00,12000.00,5167.78,5832.22,0.09,1
24549,2700,1000.00,12000.00,13000.00,0.00,12000.00,0.21,1
24550,2700,1000.00,13000.00,14000.00,323.70,12676.30,0.44,1
24551,2700,1000.00,14000.00,15000.00,607.90,5657.04,0.27,1
24552,2700,1000.00,15000.00,16000.00,2970.87,12029.13,0.40,1
24553,2700,1000.00,16000.00,17000.00,1986.23,14013.77,0.40,1
24554,2700,1000.00,17000.00,18000.00,6772.09,10227.91,0.11,1
24555,2700,1000.00,18000.00,19000.00,3329.06,3411.14,0.17,1
24556,2700,-1000.00,17000.00,18000.00,11715.34,6561.54,0.14,0
24557,2700,1000.00,18000.00,19000.00,5641.64,12358.36,0.28,1
24558,2700,1000.00,19000.00,20000.00,0.00,19000.00,0.35,1
24559,2700,1000.00,20000.00,21000.00,9000.54,10999.46,0.14,1
24560,2700,1000.00,21000.00,22000.00,865.11,14093.68,0.38,1
24561,2700,1000.00,22000.00,23000.00,0.00,10584.37,0.27,1
24562,2700,1000.00,23000.00,24000.00,0.00,23000.00,0.30,1
24563,2700,1000.00,24000.00,25000.00,0.00,24000.00,0.42,1
24564,2700,1000.00,25000.00,26000.00,0.00,25000.00,0.28,1
24565,2700,1000.00,26000.00,27000.00,0.00,26000.00,0.41,1
24566,2700,1000.00,27000.00,28000.00,0.00,27000.00,0.03,1
24567,2700,-1000.00,26000.00,27000.00,24803.45,1423.02,0.06,0
24568,2700,1000.00,27000.00,28000.00,4483.37,22516.63,0.42,1
24569,2700,1000.00,28000.00,29000.00,0.00,28000.00,0.41,1
24570,2700,1000.00,29000.00,30000.00,0.00,29000.00,0.29,1
24571,2700,1000.00,30000.00,31000.00,14851.23,15148.77,0.43,1
24572,2700,-1000.00,29000.00,30000.00,15500.00,15500.00,0.03,0
24573,2700,-1000.00,28000.00,29000.00,0.00,2968.72,0.02,0
24574,2700,-1000.00,27000.00,28000.00,9051.68,8352.20,0.19,0
24575,2700,-1000.00,26000.00,27000.00,13057.38,14942.62,0.20,0
24576,2700,-1000.00,25000.00,26000.00,11579.00,15421.00,0.13,0
24577,2700,-1000.00,24000.00,25000.00,0.00,26000.00,0.18,0
24578,2700,-1000.00,23000.00,24000.00,0.00,25000.00,0.04,0
24579,2700,-1000.00,22000.00,23000.00,11782.24,12217.76,0.27,0
24580,2700,-1000.00,21000.00,22000.00,11500.00,11500.00,0.03,0
24581,2700,-1000.00,20000.00,21000.00,0.00,22000.00,0.22,0
24582,2700,-1000.00,19000.00,20000.00,0.00,21000.00,0.06,0
24583,2700,-1000.00,18000.00,19000.00,3826.92,10206.98,0.30,0
24584,2700,-1000.00,17000.00,18000.00,0.00,7537.72,0.15,0
24585,2700,-1000.00,16000.00,17000.00,6929.30,11070.70,0.26,0
24586,2700,-1000.00,15000.00,16000.00,1509.67,15490.33,0.30,0
24587,2700,-1000.00,14000.00,15000.00,12293.48,3706.52,0.21,0
24588,2700,-1000.00,13000.00,14000.00,153.90,14846.10,0.38,0
24589,2700,-1000.00,12000.00,13000.00,3670.53,2293.93,0.16,0
24590,2700,-1000.00,11000.00,12000.00,6500.00,6500.00,0.04,0
24591,2700,-1000.00,10000.00,11000.00,0.00,1459.44,0.16,0
24592,2700,-1000.00,9000.00,10000.00,1921.16,9078.84,0.32,0
24593,2700,-1000.00,8000.00,9000.00,0.00,10000.00,0.19,0
24594,2700,-1000.00,7000.00,8000.00,4622.84,4377.16,0.32,0
24595,2700,-1000.00,6000.00,7000.00,4000.00,4000.00,0.02,0
24596,2700,-1000.00,5000.00,6000.00,2613.36,4386.64,0.31,0
24597,2700,-1000.00,4000.00,5000.00,2136.29,3863.71,0.24,0
24598,2700,-1000.00,3000.00,4000.00,0.00,3615.83,0.23,0
24599,2700,-1000.00,2000.00,3000.00,612.63,3387.37,0.25,0
24600,2700,-1000.00,1000.00,2000.00,915.10,2084.90,0.15,0
24601,2700,-1000.00,0.00,1000.00,714.71,1285.29,0.28,0
24602,2700,-1000.00,-1000.00,0.00,500.00,500.00,0.05,0
24603,2701,-1000.00,-1000.00,0.00,0.00,828.72,0.29,0
24604,2702,-1000.00,-1000.00,0.00,338.94,661.06,0.11,0
24605,2703,-193.47,-193.47,806.53,140.70,52.77,0.13,0
24606,2703,1000.00,806.53,1806.53,0.00,480.07,0.35,1
24607,2703,1000.00,1806.53,2806.53,0.00,1038.31,0.35,1
24608,2703,1000.00,2806.53,3806.53,1389.92,1416.60,0.22,1
24609,2703,1000.00,3806.53,4806.53,1043.03,2763.50,0.36,1
24610,2703,1000.00,4806.53,5806.53,2403.26,2403.26,0.09,1
24611,2703,-1000.00,3806.53,4806.53,2099.74,1243.32,0.16,0
24612,2703,-1000.00,2806.53,3806.53,2559.76,877.39,0.12,0
24613,2703,1000.00,3806.53,4806.53,941.55,2864.98,0.34,1
24614,2703,1000.00,4806.53,5806.53,0.00,4806.53,0.10,1
24615,2703,1000.00,5806.53,6806.53,0.00,5806.53,0.38,1
24616,2703,1000.00,6806.53,7806.53,0.00,6806.53,0.06,1
24617,2703,1000.00,7806.53,8806.53,0.00,4826.78,0.36,1
24618,2703,1000.00,8806.53,9806.53,4343.34,4463.19,0.09,1
24619,2703,1000.00,9806.53,10806.53,22.93,5809.91,0.36,1
24620,2703,1000.00,10806.53,11806.53,0.00,1081.84,0.12,1
24621,2703,1000.00,11806.53,12806.53,0.00,11806.53,0.09,1
24622,2703,1000.00,12806.53,13806.53,5562.11,7244.41,0.16,1
24623,2703,-1000.00,11806.53,12806.53,9149.06,4657.47,0.07,0
24624,2703,1000.00,12806.53,13806.53,6403.26,6403.26,0.04,1
24625,2703,1000.00,13806.53,14806.53,0.00,13806.53,0.13,1
24626,2703,1000.00,14806.53,15806.53,1911.61,12894.92,0.26,1
24627,2703,1000.00,15806.53,16806.53,7591.99,8214.53,0.35,1
24628,2703,-1000.00,14806.53,15806.53,3104.16,13702.37,0.12,0
24629,2703,-1000.00,13806.53,14806.53,0.00,15806.53,0.24,0
24630,2703,-1000.00,12806.53,13806.53,5158.80,9647.73,0.17,0
24631,2703,-1000.00,11806.53,12806.53,0.00,13806.53,0.26,0
24632,2703,-1000.00,10806.53,11806.53,3248.48,4307.06,0.22,0
24633,2703,0.00,10806.53,11806.53,0.00,0.00,0.05,0
24634,2703,-1000.00,9806.53,10806.53,0.00,4554.66,0.26,0
24635,2703,-1000.00,8806.53,9806.53,0.00,7952.42,0.30,0
24636,2703,-1000.00,7806.53,8806.53,0.00,9806.53,0.23,0
24637,2703,-1000.00,6806.53,7806.53,4811.02,3995.51,0.38,0
24638,2703,-1000.00,5806.53,6806.53,3098.62,2853.78,0.20,0
24639,2703,-1000.00,4806.53,5806.53,3403.26,3403.26,0.03,0
24640,2703,-1000.00,3806.53,4806.53,2898.49,2908.04,0.12,0
24641,2703,-1000.00,2806.53,3806.53,2403.26,2403.26,0.07,0
24642,2703,-1000.00,1806.53,2806.53,1691.45,2115.07,0.23,0
24643,2703,-1000.00,806.53,1806.53,0.00,2806.53,0.37,0
24644,2703,-1000.00,-193.47,806.53,435.11,1371.42,0.38,0
24645,2703,-612.93,-806.40,193.60,0.00,612.93,0.41,0
24646,2703,-193.60,-1000.00,0.00,83.75,109.85,0.39,0
24647,2704,-1000.00,-1000.00,0.00,0.00,850.65,0.34,0
24648,2705,-1000.00,-1000.00,0.00,0.00,1000.00,0.28,0
24649,2706,-1000.00,-1000.00,0.00,367.48,632.52,0.28,0
24650,2707,-1000.00,-1000.00,0.00,500.00,500.00,0.06,0
24651,2708,-1000.00,-1000.00,0.00,393.10,606.90,0.29,0
24652,2709,-832.47,-832.47,167.53,0.00,832.47,0.22,0
24653,2709,-154.15,-986.63,13.37,10.96,143.19,0.43,0
24654,2709,0.00,-986.63,13.37,0.00,0.00,0.04,0
24655,2709,-13.37,-1000.00,0.00,6.69,6.69,0.05,0
24656,2710,-1000.00,-1000.00,0.00,0.00,852.53,0.13,0
24657,2711,-1000.00,-1000.00,0.00,0.00,185.46,0.09,0
24658,2712,1000.00,1000.00,2000.00,0.00,106.11,0.13,1
24659,2712,1000.00,2000.00,3000.00,643.73,1356.27,0.34,1
24660,2712,1000.00,3000.00,4000.00,0.00,1935.45,0.37,1
24661,2712,1000.00,4000.00,5000.00,0.00,3838.74,0.25,1
24662,2712,1000.00,5000.00,6000.00,2214.86,2785.14,0.17,1
24663,2712,1000.00,6000.00,7000.00,1108.73,4891.27,0.22,1
24664,2712,1000.00,7000.00,8000.00,2491.26,2593.55,0.21,1
24665,2712,-1000.00,6000.00,7000.00,3127.24,0.00,0.08,0
24666,2712,1000.00,7000.00,8000.00,0.00,7000.00,0.15,1
24667,2712,0.00,7000.00,8000.00,0.00,0.00,0.09,0
24668,2712,1000.00,8000.00,9000.00,0.00,8000.00,0.30,1
24669,2712,1000.00,9000.00,10000.00,1965.81,7034.19,0.40,1
24670,2712,1000.00,10000.00,11000.00,3892.33,6107.67,0.21,1
24671,2712,1000.00,11000.00,12000.00,2865.39,8134.61,0.36,1
24672,2712,1000.00,12000.00,13000.00,0.00,12000.00,0.15,1
24673,2712,-1000.00,11000.00,12000.00,7097.33,5902.67,0.18,0
24674,2712,1000.00,12000.00,13000.00,0.00,10715.90,0.44,1
24675,2712,1000.00,13000.00,14000.00,6500.00,6500.00,0.19,1
24676,2712,1000.00,14000.00,15000.00,0.00,10260.33,0.23,1
24677,2712,-1000.00,13000.00,14000.00,5574.49,9425.51,0.24,0
24678,2712,-1000.00,12000.00,13000.00,5572.95,8427.05,0.29,0
24679,2712,-1000.00,11000.00,12000.00,3665.88,9334.12,0.22,0
24680,2712,-1000.00,10000.00,11000.00,0.00,11621.93,0.23,0
24681,2712,-1000.00,9000.00,10000.00,2394.79,8605.21,0.38,0
24682,2712,-1000.00,8000.00,9000.00,0.00,8642.87,0.43,0
24683,2712,-1000.00,7000.00,8000.00,0.00,6265.28,0.03,0
24684,2712,-1000.00,6000.00,7000.00,0.00,8000.00,0.38,0
24685,2712,-1000.00,5000.00,6000.00,0.00,1143.28,0.08,0
24686,2712,-1000.00,4000.00,5000.00,2656.07,3343.93,0.22,0
24687,2712,-1000.00,3000.00,4000.00,2571.93,2428.07,0.14,0
24688,2712,-1000.00,2000.00,3000.00,630.78,2990.66,0.39,0
24689,2712,-403.12,1596.88,2596.88,0.00,403.12,0.12,0
24690,2712,-1000.00,596.88,1596.88,0.00,1675.74,0.18,0
24691,2712,-1000.00,-403.12,596.88,0.00,1329.28,0.43,0
24692,2712,-290.09,-693.21,306.79,0.00,290.09,0.23,0
24693,2712,-58.60,-751.81,248.19,0.00,58.60,0.13,0
24694,2712,-154.39,-906.21,93.79,0.00,154.39,0.36,0
24695,2712,-42.25,-948.45,51.55,18.12,24.12,0.21,0
24696,2712,-51.55,-1000.00,0.00,19.15,32.39,0.26,0
24697,2712,-0.00,-1000.00,0.00,0.00,0.00,0.18,0
24698,2713,-1000.00,-1000.00,0.00,0.00,619.49,0.35,0
24699,2714,-334.99,-334.99,665.01,68.14,266.85,0.38,0
24700,2714,-497.82,-832.81,167.19,117.34,380.48,0.42,0
24701,2714,1000.00,167.19,1167.19,50.93,13.88,0.29,1
24702,2714,-44.45,122.74,1122.74,0.00,44.45,0.39,0
24703,2714,-1000.00,-877.26,122.74,0.00,1122.74,0.02,0
24704,2714,-122.74,-1000.00,0.00,57.36,65.38,0.30,0
24705,2715,-174.90,-174.90,825.10,71.85,103.05,0.14,0
24706,2715,-825.10,-1000.00,0.00,0.00,825.10,0.08,0
24707,2716,0.00,0.00,1000.00,0.00,0.00,0.11,0
24708,2716,1000.00,1000.00,2000.00,463.54,536.46,0.24,1
24709,2716,1000.00,2000.00,3000.00,952.85,1047.15,0.14,1
24710,2716,1000.00,3000.00,4000.00,1109.98,1890.02,0.12,1
24711,2716,1000.00,4000.00,5000.00,0.00,4000.00,0.25,1
24712,2716,-1000.00,3000.00,4000.00,4489.55,0.00,0.02,0
24713,2716,1000.00,4000.00,5000.00,0.00,4000.00,0.06,1
24714,2716,1000.00,5000.00,6000.00,1248.93,3110.59,0.33,1
24715,2716,1000.00,6000.00,7000.00,0.00,2592.68,0.22,1
24716,2716,1000.00,7000.00,8000.00,0.00,6920.32,0.12,1
24717,2716,-1000.00,6000.00,7000.00,4324.42,3675.58,0.11,0
24718,2716,-1000.00,5000.00,6000.00,3689.54,3310.46,0.09,0
24719,2716,1000.00,6000.00,7000.00,0.00,2652.47,0.02,1
24720,2716,1000.00,7000.00,8000.00,1875.16,5124.84,0.21,1
24721,2716,1000.00,8000.00,9000.00,3303.53,4696.47,0.28,1
24722,2716,1000.00,9000.00,10000.00,0.00,8395.76,0.11,1
24723,2716,1000.00,10000.00,11000.00,1658.74,5894.77,0.34,1
24724,2716,1000.00,11000.00,12000.00,3179.52,7820.48,0.35,1
24725,2716,1000.00,12000.00,13000.00,0.00,7206.56,0.35,1
24726,2716,1000.00,13000.00,14000.00,5796.16,7203.84,0.16,1
24727,2716,-1000.00,12000.00,13000.00,7245.62,2099.19,0.16,0
24728,2716,1000.00,13000.00,14000.00,2152.64,10847.36,0.39,1
24729,2716,1000.00,14000.00,15000.00,7000.00,7000.00,0.42,1
24730,2716,1000.00,15000.00,16000.00,7225.70,7774.30,0.15,1
24731,2716,1000.00,16000.00,17000.00,1855.45,7794.24,0.30,1
24732,2716,-1000.00,15000.00,16000.00,7364.40,6986.63,0.22,0
24733,2716,1000.00,16000.00,17000.00,6877.29,9122.71,0.04,1
24734,2716,1000.00,17000.00,18000.00,0.00,17000.00,0.25,1
24735,2716,-1000.00,16000.00,17000.00,7454.35,4264.77,0.18,0
24736,2716,1000.00,17000.00,18000.00,0.00,17000.00,0.32,1
24737,2716,1000.00,18000.00,19000.00,9000.00,9000.00,0.04,1
24738,2716,-1000.00,17000.00,18000.00,9741.12,0.00,0.03,0
24739,2716,1000.00,18000.00,19000.00,0.00,13767.58,0.27,1
24740,2716,1000.00,19000.00,20000.00,0.00,1439.09,0.10,1
24741,2716,1000.00,20000.00,21000.00,3381.56,16618.44,0.35,1
24742,2716,-1000.00,19000.00,20000.00,10416.66,0.00,0.07,0
24743,2716,1000.00,20000.00,21000.00,0.00,15990.99,0.42,1
24744,2716,1000.00,21000.00,22000.00,9734.35,11265.65,0.14,1
24745,2716,1000.00,22000.00,23000.00,0.00,22000.00,0.30,1
24746,2716,1000.00,23000.00,24000.00,11426.27,11573.73,0.41,1
24747,2716,1000.00,24000.00,25000.00,206.32,7887.52,0.24,1
24748,2716,1000.00,25000.00,26000.00,0.00,13421.28,0.30,1
24749,2716,1000.00,26000.00,27000.00,0.00,18677.35,0.36,1
24750,2716,-1000.00,25000.00,26000.00,17057.08,9942.92,0.02,0
24751,2716,1000.00,26000.00,27000.00,0.00,21553.45,0.43,1
24752,2716,1000.00,27000.00,28000.00,13500.00,13500.00,0.11,1
24753,2716,1000.00,28000.00,29000.00,0.00,18499.39,0.23,1
24754,2716,-1000.00,27000.00,28000.00,5351.39,0.00,0.02,0
24755,2716,-1000.00,26000.00,27000.00,0.00,28000.00,0.13,0
24756,2716,-1000.00,25000.00,26000.00,0.00,27000.00,0.08,0
24757,2716,-1000.00,24000.00,25000.00,0.00,24117.19,0.03,0
24758,2716,-1000.00,23000.00,24000.00,0.00,11827.28,0.29,0
24759,2716,-1000.00,22000.00,23000.00,2076.48,21923.52,0.43,0
24760,2716,-1000.00,21000.00,22000.00,0.00,23000.00,0.12,0
24761,2716,-1000.00,20000.00,21000.00,0.00,22000.00,0.36,0
24762,2716,-1000.00,19000.00,20000.00,0.00,21000.00,0.01,0
24763,2716,-1000.00,18000.00,19000.00,13830.17,6169.83,0.10,0
24764,2716,-1000.00,17000.00,18000.00,6995.51,12004.49,0.28,0
24765,2716,-1000.00,16000.00,17000.00,0.00,18000.00,0.07,0
24766,2716,-1000.00,15000.00,16000.00,5792.58,8110.24,0.26,0
24767,2716,-1000.00,14000.00,15000.00,0.00,16000.00,0.25,0
24768,2716,-1000.00,13000.00,14000.00,10214.39,4785.61,0.09,0
24769,2716,-1000.00,12000.00,13000.00,103.75,13896.25,0.05,0
24770,2716,-1000.00,11000.00,12000.00,6854.01,5894.33,0.20,0
24771,2716,-1000.00,10000.00,11000.00,3963.19,8036.81,0.31,0
24772,2716,-1000.00,9000.00,10000.00,6255.27,4744.73,0.02,0
24773,2716,0.00,9000.00,10000.00,0.00,0.00,0.02,0
24774,2717,-857.46,-857.46,142.54,0.00,857.46,0.32,0
24775,2717,0.00,-857.46,142.54,0.00,0.00,0.17,0
24776,2717,-142.54,-1000.00,0.00,54.27,88.27,0.12,0
24777,2718,-850.11,-850.11,149.89,56.03,794.09,0.42,0
24778,2718,-149.89,-1000.00,0.00,0.00,149.89,0.40,0
24779,2719,-1000.00,-1000.00,0.00,0.00,538.86,0.31,0
24780,2720,-1000.00,-1000.00,0.00,290.04,709.96,0.36,0
24781,2721,1000.00,1000.00,2000.00,0.00,630.40,0.04,1
24782,2721,1000.00,2000.00,3000.00,0.00,2000.00,0.38,1
24783,2721,1000.00,3000.00,4000.00,1360.26,1639.74,0.25,1
24784,2721,1000.00,4000.00,5000.00,690.28,3309.72,0.42,1
24785,2721,1000.00,5000.00,6000.00,281.97,4718.03,0.17,1
24786,2721,1000.00,6000.00,7000.00,0.00,6000.00,0.05,1
24787,2721,1000.00,7000.00,8000.00,447.70,6552.30,0.10,1
24788,2721,-1000.00,6000.00,7000.00,1196.31,6803.69,0.29,0
24789,2721,-1000.00,5000.00,6000.00,2996.95,0.00,0.31,0
24790,2721,-1000.00,4000.00,5000.00,0.00,159.79,0.41,0
24791,2721,-433.79,3566.21,4566.21,433.79,0.00,0.40,0
24792,2721,0.00,3566.21,4566.21,0.00,0.00,0.17,0
24793,2721,-1000.00,2566.21,3566.21,0.00,695.12,0.32,0
24794,2721,0.00,2566.21,3566.21,0.00,0.00,0.31,0
24795,2721,0.00,2566.21,3566.21,0.00,0.00,0.42,0
24796,2721,0.00,2566.21,3566.21,0.00,0.00,0.10,0
24797,2721,-1000.00,1566.21,2566.21,613.58,2939.03,0.18,0
24798,2721,-1000.00,566.21,1566.21,1851.95,0.00,0.17,0
24799,2721,0.00,566.21,1566.21,0.00,0.00,0.17,0
24800,2721,0.00,566.21,1566.21,0.00,0.00,0.09,0
24801,2721,-1000.00,-433.79,566.21,927.99,638.22,0.21,0
24802,2721,-566.21,-1000.00,0.00,365.68,200.53,0.18,0
24803,2722,-1000.00,-1000.00,0.00,0.00,1000.00,0.34,0
24804,2723,0.00,0.00,1000.00,0.00,0.00,0.01,0
24805,2723,-1000.00,-1000.00,0.00,0.00,1000.00,0.32,0
24806,2724,-1000.00,-1000.00,0.00,0.00,1000.00,0.10,0
24807,2725,-1000.00,-1000.00,0.00,0.00,1000.00,0.11,0
24808,2726,-105.73,-105.73,894.27,0.00,105.73,0.15,0
24809,2726,-894.27,-1000.00,0.00,435.05,459.22,0.11,0
24810,2727,-1000.00,-1000.00,0.00,419.25,580.75,0.26,0
24811,2728,0.00,0.00,1000.00,0.00,0.00,0.05,0
24812,2728,0.00,0.00,1000.00,0.00,0.00,0.05,0
24813,2728,-1000.00,-1000.00,0.00,84.66,915.34,0.05,0
24814,2729,1000.00,1000.00,2000.00,0.00,1000.00,0.21,1
24815,2729,-733.01,266.99,1266.99,682.76,50.25,0.10,0
24816,2729,1000.00,1266.99,2266.99,394.93,872.06,0.22,1
24817,2729,1000.00,2266.99,3266.99,104.43,2017.73,0.43,1
24818,2729,1000.00,3266.99,4266.99,1437.13,1829.86,0.20,1
24819,2729,1000.00,4266.99,5266.99,1221.79,3045.20,0.15,1
24820,2729,1000.00,5266.99,6266.99,0.00,2627.71,0.30,1
24821,2729,1000.00,6266.99,7266.99,0.00,5731.51,0.43,1
24822,2729,1000.00,7266.99,8266.99,0.00,2516.51,0.09,1
24823,2729,1000.00,8266.99,9266.99,2216.20,6050.79,0.20,1
24824,2729,1000.00,9266.99,10266.99,0.00,9266.99,0.13,1
24825,2729,1000.00,10266.99,11266.99,0.00,10266.99,0.39,1
24826,2729,1000.00,11266.99,12266.99,0.00,8710.13,0.38,1
24827,2729,1000.00,12266.99,13266.99,0.00,12266.99,0.44,1
24828,2729,1000.00,13266.99,14266.99,0.00,5139.01,0.25,1
24829,2729,-1000.00,12266.99,13266.99,14266.99,0.00,0.00,0
24830,2729,1000.00,13266.99,14266.99,881.99,4027.62,0.22,1
24831,2729,1000.00,14266.99,15266.99,4740.06,9526.93,0.40,1
24832,2729,1000.00,15266.99,16266.99,2882.64,12384.35,0.37,1
24833,2729,-1000.00,14266.99,15266.99,11962.58,2221.81,0.15,0
24834,2729,1000.00,15266.99,16266.99,0.00,15266.99,0.22,1
24835,2729,1000.00,16266.99,17266.99,5710.04,10556.95,0.32,1
24836,2729,-1000.00,15266.99,16266.99,8904.19,8362.80,0.44,0
24837,2729,-1000.00,14266.99,15266.99,0.00,16266.99,0.06,0
24838,2729,-1000.00,13266.99,14266.99,0.00,14696.77,0.42,0
24839,2729,-1000.00,12266.99,13266.99,4842.35,9424.64,0.27,0
24840,2729,-1000.00,11266.99,12266.99,4198.42,9068.57,0.35,0
24841,2729,-1000.00,10266.99,11266.99,4086.29,8180.70,0.15,0
24842,2729,-64.92,10202.07,11202.07,0.00,64.92,0.03,0
24843,2729,-1000.00,9202.07,10202.07,2424.68,8777.39,0.34,0
24844,2729,-1000.00,8202.07,9202.07,6202.32,1959.60,0.11,0
24845,2729,-1000.00,7202.07,8202.07,0.00,2355.05,0.14,0
24846,2729,-1000.00,6202.07,7202.07,0.00,7882.14,0.06,0
24847,2729,-1000.00,5202.07,6202.07,1992.71,5209.36,0.37,0
24848,2729,-1000.00,4202.07,5202.07,3753.77,2448.30,0.12,0
24849,2729,-1000.00,3202.07,4202.07,0.00,5202.07,0.26,0
24850,2729,-1000.00,2202.07,3202.07,0.00,4202.07,0.11,0
24851,2729,-1000.00,1202.07,2202.07,0.00,3202.07,0.08,0
24852,2729,-1000.00,202.07,1202.07,0.00,2191.48,0.34,0
24853,2729,-1000.00,-797.93,202.07,0.00,1202.07,0.35,0
24854,2729,-202.07,-1000.00,0.00,101.04,101.04,0.03,0
24855,2730,-1000.00,-1000.00,0.00,0.00,948.47,0.38,0
24856,2731,1000.00,1000.00,2000.00,611.67,388.33,0.05,1
24857,2731,-460.76,539.24,1539.24,0.00,460.76,0.24,0
24858,2731,-1000.00,-460.76,539.24,558.39,980.85,0.06,0
24859,2731,-445.03,-905.79,94.21,0.00,445.03,0.20,0
24860,2731,-59.09,-964.88,35.12,0.00,59.09,0.38,0
24861,2731,1000.00,35.12,1035.12,32.14,2.98,0.05,1
24862,2731,-1000.00,-964.88,35.12,204.63,830.48,0.23,0
24863,2731,1000.00,35.12,1035.12,22.71,12.41,0.04,1
24864,2731,1000.00,1035.12,2035.12,77.52,0.00,0.11,1
24865,2731,-1000.00,35.12,1035.12,399.52,1635.59,0.41,0
24866,2731,-521.37,-486.25,513.75,0.00,521.37,0.26,0
24867,2731,-513.75,-1000.00,0.00,0.00,513.75,0.03,0
24868,2732,-1000.00,-1000.00,0.00,0.00,1000.00,0.00,0
24869,2733,1000.00,1000.00,2000.00,0.00,1000.00,0.30,1
24870,2733,1000.00,2000.00,3000.00,0.00,1948.79,0.24,1
24871,2733,-1000.00,1000.00,2000.00,1602.25,1325.57,0.19,0
24872,2733,1000.00,2000.00,3000.00,934.48,1065.52,0.15,1
24873,2733,1000.00,3000.00,4000.00,0.00,1542.63,0.20,1
24874,2733,-1000.00,2000.00,3000.00,2172.16,1611.35,0.18,0
24875,2733,1000.00,3000.00,4000.00,0.00,2670.48,0.21,1
24876,2733,1000.00,4000.00,5000.00,1672.80,2327.20,0.30,1
24877,2733,1000.00,5000.00,6000.00,0.00,4159.92,0.37,1
24878,2733,1000.00,6000.00,7000.00,1519.52,4480.48,0.24,1
24879,2733,-1000.00,5000.00,6000.00,6594.77,0.00,0.04,0
24880,2733,-1000.00,4000.00,5000.00,1929.46,528.15,0.13,0
24881,2733,1000.00,5000.00,6000.00,0.00,2657.80,0.18,1
24882,2733,1000.00,6000.00,7000.00,1116.67,4883.33,0.39,1
24883,2733,1000.00,7000.00,8000.00,0.00,7000.00,0.08,1
24884,2733,1000.00,8000.00,9000.00,4000.00,4000.00,0.02,1
24885,2733,1000.00,9000.00,10000.00,3323.79,5676.21,0.23,1
24886,2733,1000.00,10000.00,11000.00,0.00,10000.00,0.23,1
24887,2733,1000.00,11000.00,12000.00,2459.23,2459.55,0.16,1
24888,2733,1000.00,12000.00,13000.00,2478.46,9521.54,0.22,1
24889,2733,1000.00,13000.00,14000.00,6500.00,6500.00,0.06,1
24890,2733,1000.00,14000.00,15000.00,0.00,7117.38,0.05,1
24891,2733,-1000.00,13000.00,14000.00,14229.00,771.00,0.12,0
24892,2733,1000.00,14000.00,15000.00,7000.00,7000.00,0.07,1
24893,2733,1000.00,15000.00,16000.00,4115.85,10884.15,0.36,1
24894,2733,1000.00,16000.00,17000.00,0.00,16000.00,0.23,1
24895,2733,1000.00,17000.00,18000.00,3312.80,13292.32,0.39,1
24896,2733,1000.00,18000.00,19000.00,0.00,18000.00,0.10,1
24897,2733,1000.00,19000.00,20000.00,9410.03,9589.97,0.42,1
24898,2733,1000.00,20000.00,21000.00,1508.62,8810.82,0.28,1
24899,2733,1000.00,21000.00,22000.00,910.57,20089.43,0.28,1
24900,2733,-1000.00,20000.00,21000.00,0.00,20215.18,0.21,0
24901,2733,-1000.00,19000.00,20000.00,0.00,15854.78,0.40,0
24902,2733,-1000.00,18000.00,19000.00,0.00,20000.00,0.20,0
24903,2733,-1000.00,17000.00,18000.00,7739.95,11260.05,0.32,0
24904,2733,-1000.00,16000.00,17000.00,0.00,2314.62,0.13,0
24905,2733,-1000.00,15000.00,16000.00,8505.20,8494.80,0.04,0
24906,2733,-1000.00,14000.00,15000.00,3236.10,12763.90,0.41,0
24907,2733,-1000.00,13000.00,14000.00,0.00,15000.00,0.27,0
24908,2733,-1000.00,12000.00,13000.00,0.00,7749.60,0.34,0
24909,2733,0.00,12000.00,13000.00,0.00,0.00,0.08,0
24910,2734,1000.00,1000.00,2000.00,368.49,631.51,0.32,1
24911,2734,1000.00,2000.00,3000.00,0.00,1194.17,0.36,1
24912,2734,1000.00,3000.00,4000.00,0.00,2463.01,0.43,1
24913,2734,1000.00,4000.00,5000.00,713.01,3286.99,0.04,1
24914,2734,1000.00,5000.00,6000.00,2263.40,2736.60,0.26,1
24915,2734,1000.00,6000.00,7000.00,1548.33,4451.67,0.34,1
24916,2734,-568.90,5431.10,6431.10,568.90,0.00,0.11,0
24917,2734,1000.00,6431.10,7431.10,2501.22,3929.88,0.01,1
24918,2734,1000.00,7431.10,8431.10,0.00,7431.10,0.28,1
24919,2734,1000.00,8431.10,9431.10,0.00,8431.10,0.27,1
24920,2734,1000.00,9431.10,10431.10,0.00,9431.10,0.23,1
24921,2734,-1000.00,8431.10,9431.10,4756.34,0.00,0.01,0
24922,2734,1000.00,9431.10,10431.10,1100.59,8330.52,0.35,1
24923,2734,1000.00,10431.10,11431.10,0.00,10431.10,0.28,1
24924,2734,1000.00,11431.10,12431.10,0.00,1765.96,0.16,1
24925,2734,-1000.00,10431.10,11431.10,6499.03,5932.07,0.08,0
24926,2734,1000.00,11431.10,12431.10,3158.93,8272.18,0.09,1
24927,2734,1000.00,12431.10,13431.10,0.00,12431.10,0.35,1
24928,2734,1000.00,13431.10,14431.10,4281.51,9149.59,0.10,1
24929,2734,-1000.00,12431.10,13431.10,9479.91,4951.19,0.16,0
24930,2734,1000.00,13431.10,14431.10,0.00,13431.10,0.03,1
24931,2734,1000.00,14431.10,15431.10,7215.55,7215.55,0.15,1
24932,2734,1000.00,15431.10,16431.10,0.00,4881.99,0.19,1
24933,2734,1000.00,16431.10,17431.10,7154.41,9276.69,0.11,1
24934,2734,1000.00,17431.10,18431.10,4969.35,12461.75,0.36,1
24935,2734,1000.00,18431.10,19431.10,6233.13,12197.97,0.03,1
24936,2734,1000.00,19431.10,20431.10,0.00,5410.41,0.11,1
24937,2734,1000.00,20431.10,21431.10,0.00,20431.10,0.03,1
24938,2734,1000.00,21431.10,22431.10,10715.55,10715.55,0.05,1
24939,2734,1000.00,22431.10,23431.10,9250.63,13180.47,0.28,1
24940,2734,1000.00,23431.10,24431.10,2685.52,20745.58,0.19,1
24941,2734,1000.00,24431.10,25431.10,0.00,24431.10,0.24,1
24942,2734,1000.00,25431.10,26431.10,0.00,22938.53,0.03,1
24943,2734,1000.00,26431.10,27431.10,0.00,26431.10,0.36,1
24944,2734,1000.00,27431.10,28431.10,3413.49,17970.56,0.39,1
24945,2734,1000.00,28431.10,29431.10,7131.41,21299.70,0.10,1
24946,2734,1000.00,29431.10,30431.10,14430.06,15001.05,0.18,1
24947,2734,1000.00,30431.10,31431.10,6107.60,24323.50,0.41,1
24948,2734,1000.00,31431.10,32431.10,0.00,16206.30,0.17,1
24949,2734,1000.00,32431.10,33431.10,0.00,28597.76,0.43,1
24950,2734,1000.00,33431.10,34431.10,14642.34,18788.76,0.23,1
24951,2734,1000.00,34431.10,35431.10,8677.24,25753.86,0.35,1
24952,2734,-1000.00,33431.10,34431.10,10497.92,8331.04,0.19,0
24953,2734,1000.00,34431.10,35431.10,16923.51,17507.59,0.11,1
24954,2734,1000.00,35431.10,36431.10,12540.07,22891.03,0.05,1
24955,2734,1000.00,36431.10,37431.10,17219.51,19211.59,0.32,1
24956,2734,1000.00,37431.10,38431.10,9027.66,28403.45,0.32,1
24957,2734,1000.00,38431.10,39431.10,1999.73,21549.63,0.34,1
24958,2734,1000.00,39431.10,40431.10,0.00,17241.19,0.26,1
24959,2734,1000.00,40431.10,41431.10,17197.25,23233.86,0.24,1
24960,2734,1000.00,41431.10,42431.10,14316.93,27114.18,0.28,1
24961,2734,1000.00,42431.10,43431.10,18100.79,24330.32,0.18,1
24962,2734,1000.00,43431.10,44431.10,0.00,43291.82,0.06,1
24963,2734,1000.00,44431.10,45431.10,20026.29,24404.81,0.22,1
24964,2734,1000.00,45431.10,46431.10,0.00,45431.10,0.24,1
24965,2734,1000.00,46431.10,47431.10,11980.81,34450.30,0.17,1
24966,2734,1000.00,47431.10,48431.10,7110.29,40320.82,0.09,1
24967,2734,1000.00,48431.10,49431.10,0.00,48431.10,0.22,1
24968,2734,1000.00,49431.10,50431.10,0.00,49431.10,0.19,1
24969,2734,1000.00,50431.10,51431.10,8135.74,42295.36,0.28,1
24970,2734,1000.00,51431.10,52431.10,0.00,51431.10,0.25,1
24971,2734,-1000.00,50431.10,51431.10,28664.97,0.00,0.03,0
24972,2734,1000.00,51431.10,52431.10,15532.23,31983.37,0.32,1
24973,2734,1000.00,52431.10,53431.10,0.00,45795.77,0.06,1
24974,2734,1000.00,53431.10,54431.10,20312.36,33118.74,0.26,1
24975,2734,1000.00,54431.10,55431.10,5396.81,33537.08,0.36,1
24976,2734,1000.00,55431.10,56431.10,0.00,19192.05,0.13,1
24977,2734,1000.00,56431.10,57431.10,6232.10,29191.30,0.32,1
24978,2734,1000.00,57431.10,58431.10,0.00,57431.10,0.31,1
24979,2735,-1000.00,-1000.00,0.00,295.97,704.03,0.35,0
24980,2736,-1000.00,-1000.00,0.00,4.62,995.38,0.39,0
24981,2737,1000.00,1000.00,2000.00,0.00,1000.00,0.09,1
24982,2737,1000.00,2000.00,3000.00,0.00,1445.66,0.40,1
24983,2737,1000.00,3000.00,4000.00,149.37,248.41,0.14,1
24984,2737,1000.00,4000.00,5000.00,0.00,3056.55,0.38,1
24985,2737,1000.00,5000.00,6000.00,1110.02,3889.98,0.39,1
24986,2737,1000.00,6000.00,7000.00,1408.70,4591.30,0.39,1
24987,2737,1000.00,7000.00,8000.00,155.02,4747.80,0.39,1
24988,2737,1000.00,8000.00,9000.00,2159.91,5840.09,0.31,1
24989,2737,-1000.00,7000.00,8000.00,3673.20,0.00,0.06,0
24990,2737,1000.00,8000.00,9000.00,1440.16,6559.84,0.16,1
24991,2737,1000.00,9000.00,10000.00,0.00,5757.15,0.37,1
24992,2737,1000.00,10000.00,11000.00,0.00,10000.00,0.04,1
24993,2737,1000.00,11000.00,12000.00,0.00,8126.62,0.18,1
24994,2737,1000.00,12000.00,13000.00,5784.36,6215.64,0.12,1
24995,2737,1000.00,13000.00,14000.00,0.00,13000.00,0.40,1
24996,2737,1000.00,14000.00,15000.00,0.00,14000.00,0.36,1
24997,2737,1000.00,15000.00,16000.00,0.00,15000.00,0.02,1
24998,2737,1000.00,16000.00,17000.00,0.00,10992.47,0.06,1
24999,2737,1000.00,17000.00,18000.00,6871.52,10128.48,0.28,1
25000,2737,0.00,17000.00,18000.00,0.00,0.00,0.10,0
25001,2737,1000.00,18000.00,19000.00,7189.83,10810.17,0.23,1
25002,2737,-1000.00,17000.00,18000.00,10170.93,8829.07,0.14,0
25003,2737,1000.00,18000.00,19000.00,0.00,18000.00,0.19,1
25004,2737,1000.00,19000.00,20000.00,824.93,18175.07,0.05,1
25005,2737,1000.00,20000.00,21000.00,2046.81,17953.19,0.43,1
25006,2737,1000.00,21000.00,22000.00,0.00,21000.00,0.41,1
25007,2737,1000.00,22000.00,23000.00,5506.53,16493.47,0.03,1
25008,2737,1000.00,23000.00,24000.00,0.00,1385.77,0.13,1
25009,2737,1000.00,24000.00,25000.00,0.00,10919.00,0.29,1
25010,2737,1000.00,25000.00,26000.00,0.00,11703.06,0.28,1
25011,2737,-1000.00,24000.00,25000.00,13676.39,12323.61,0.15,0
25012,2737,1000.00,25000.00,26000.00,8622.26,8678.16,0.21,1
25013,2737,1000.00,26000.00,27000.00,0.00,10934.39,0.15,1
25014,2737,1000.00,27000.00,28000.00,63.35,19837.31,0.10,1
25015,2737,1000.00,28000.00,29000.00,5077.40,22922.60,0.36,1
25016,2737,1000.00,29000.00,30000.00,2593.03,26406.97,0.23,1
25017,2737,1000.00,30000.00,31000.00,0.00,30000.00,0.30,1
25018,2737,1000.00,31000.00,32000.00,0.00,22740.19,0.06,1
25019,2737,1000.00,32000.00,33000.00,0.00,32000.00,0.25,1
25020,2737,1000.00,33000.00,34000.00,15859.10,17140.90,0.23,1
25021,2738,-251.84,-251.84,748.16,0.00,251.84,0.11,0
25022,2738,-597.23,-849.07,150.93,0.00,597.23,0.26,0
25023,2738,-92.06,-941.14,58.86,0.00,92.06,0.36,0
25024,2738,-27.23,-968.37,31.63,0.00,27.23,0.20,0
25025,2738,-31.63,-1000.00,0.00,0.00,31.63,0.28,0
25026,2739,-1000.00,-1000.00,0.00,596.04,214.14,0.11,0
25027,2740,-1000.00,-1000.00,0.00,0.00,1000.00,0.36,0
25028,2741,-1000.00,-1000.00,0.00,410.85,589.15,0.29,0
25029,2742,-1000.00,-1000.00,0.00,0.00,1000.00,0.36,0
25030,2743,1000.00,1000.00,2000.00,523.11,476.89,0.13,1
25031,2743,0.00,1000.00,2000.00,0.00,0.00,0.02,0
25032,2743,0.00,1000.00,2000.00,0.00,0.00,0.01,0
25033,2743,-974.31,25.69,1025.69,423.99,550.32,0.20,0
25034,2743,-1000.00,-974.31,25.69,458.83,566.86,0.18,0
25035,2743,-25.69,-1000.00,0.00,3.66,22.02,0.35,0
25036,2744,1000.00,1000.00,2000.00,129.24,870.76,0.43,1
25037,2744,1000.00,2000.00,3000.00,965.84,1034.16,0.04,1
25038,2744,1000.00,3000.00,4000.00,0.00,3000.00,0.35,1
25039,2744,1000.00,4000.00,5000.00,0.00,3161.53,0.26,1
25040,2744,1000.00,5000.00,6000.00,1729.66,3270.34,0.30,1
25041,2744,-1000.00,4000.00,5000.00,2733.85,2396.44,0.20,0
25042,2744,1000.00,5000.00,6000.00,0.00,5000.00,0.18,1
25043,2744,1000.00,6000.00,7000.00,990.52,5009.48,0.42,1
25044,2744,1000.00,7000.00,8000.00,0.00,5017.65,0.09,1
25045,2744,1000.00,8000.00,9000.00,3460.70,4539.30,0.35,1
25046,2744,1000.00,9000.00,10000.00,0.00,2928.04,0.12,1
25047,2744,-1000.00,8000.00,9000.00,6290.74,3709.26,0.19,0
25048,2744,1000.00,9000.00,10000.00,2068.56,5976.10,0.37,1
25049,2744,1000.00,10000.00,11000.00,1939.88,4069.38,0.26,1
25050,2744,1000.00,11000.00,12000.00,0.00,11000.00,0.36,1
25051,2744,1000.00,12000.00,13000.00,0.00,7327.83,0.25,1
25052,2744,1000.00,13000.00,14000.00,0.00,13000.00,0.01,1
25053,2744,1000.00,14000.00,15000.00,1854.51,12145.49,0.24,1
25054,2744,1000.00,15000.00,16000.00,0.00,10415.76,0.31,1
25055,2744,1000.00,16000.00,17000.00,0.00,14544.72,0.32,1
25056,2744,1000.00,17000.00,18000.00,5971.18,11028.82,0.33,1
25057,2744,1000.00,18000.00,19000.00,0.00,18000.00,0.04,1
25058,2744,1000.00,19000.00,20000.00,0.00,19000.00,0.28,1
25059,2744,1000.00,20000.00,21000.00,6689.71,13310.29,0.28,1
25060,2744,-1000.00,19000.00,20000.00,10329.09,10670.91,0.29,0
25061,2744,-1000.00,18000.00,19000.00,0.00,20000.00,0.40,0
25062,2744,-1000.00,17000.00,18000.00,11110.19,7889.81,0.02,0
25063,2744,-1000.00,16000.00,17000.00,0.00,18000.00,0.03,0
25064,2744,-1000.00,15000.00,16000.00,889.98,7427.89,0.28,0
25065,2744,0.00,15000.00,16000.00,0.00,0.00,0.07,0
25066,2744,-1000.00,14000.00,15000.00,0.00,16000.00,0.43,0
25067,2744,-1000.00,13000.00,14000.00,0.00,15000.00,0.22,0
25068,2744,-1000.00,12000.00,13000.00,0.00,8195.46,0.35,0
25069,2744,-1000.00,11000.00,12000.00,0.00,10577.84,0.42,0
25070,2744,-1000.00,10000.00,11000.00,3058.64,8941.36,0.24,0
25071,2744,-1000.00,9000.00,10000.00,3761.68,7238.32,0.43,0
25072,2744,-1000.00,8000.00,9000.00,935.21,6196.72,0.36,0
25073,2744,-1000.00,7000.00,8000.00,145.55,0.00,0.02,0
25074,2744,-1000.00,6000.00,7000.00,0.00,8000.00,0.30,0
25075,2744,-1000.00,5000.00,6000.00,409.16,6590.84,0.42,0
25076,2744,-1000.00,4000.00,5000.00,359.87,1162.64,0.18,0
25077,2744,-1000.00,3000.00,4000.00,0.00,5000.00,0.06,0
25078,2744,-1000.00,2000.00,3000.00,3255.77,744.23,0.14,0
25079,2744,-1000.00,1000.00,2000.00,0.00,1460.63,0.30,0
25080,2744,1000.00,2000.00,3000.00,0.00,1508.26,0.40,1
25081,2744,1000.00,3000.00,4000.00,358.73,2641.27,0.43,1
25082,2744,-1000.00,2000.00,3000.00,2639.10,0.00,0.02,0
25083,2744,1000.00,3000.00,4000.00,0.00,3000.00,0.13,1
25084,2744,1000.00,4000.00,5000.00,0.00,4000.00,0.39,1
25085,2744,1000.00,5000.00,6000.00,2500.00,2500.00,0.07,1
25086,2744,1000.00,6000.00,7000.00,1491.37,4508.63,0.01,1
25087,2744,-1000.00,5000.00,6000.00,4754.10,1225.80,0.09,0
25088,2744,-503.64,4496.36,5496.36,503.64,0.00,0.05,0
25089,2744,-1000.00,3496.36,4496.36,3733.81,1762.55,0.06,0
25090,2744,1000.00,4496.36,5496.36,1406.39,3089.98,0.18,1
25091,2744,1000.00,5496.36,6496.36,0.00,3025.17,0.16,1
25092,2744,1000.00,6496.36,7496.36,52.26,813.39,0.15,1
25093,2744,1000.00,7496.36,8496.36,0.00,6123.05,0.42,1
25094,2744,1000.00,8496.36,9496.36,0.00,5838.84,0.24,1
25095,2745,-742.58,-742.58,257.42,0.00,742.58,0.40,0
25096,2745,-22.18,-764.77,235.23,0.00,22.18,0.14,0
25097,2745,-235.23,-1000.00,0.00,77.54,157.70,0.27,0
25098,2746,1000.00,1000.00,2000.00,0.00,1000.00,0.04,1
25099,2746,1000.00,2000.00,3000.00,608.74,1239.34,0.33,1
25100,2746,1000.00,3000.00,4000.00,0.00,1815.90,0.19,1
25101,2746,1000.00,4000.00,5000.00,0.00,4000.00,0.07,1
25102,2746,1000.00,5000.00,6000.00,0.00,1051.36,0.19,1
25103,2746,1000.00,6000.00,7000.00,0.00,5167.28,0.38,1
25104,2746,1000.00,7000.00,8000.00,2627.34,4372.66,0.13,1
25105,2746,1000.00,8000.00,9000.00,0.00,4916.87,0.27,1
25106,2746,1000.00,9000.00,10000.00,1788.64,7211.36,0.35,1
25107,2746,1000.00,10000.00,11000.00,3883.39,6116.61,0.09,1
25108,2746,1000.00,11000.00,12000.00,0.00,10478.42,0.43,1
25109,2746,1000.00,12000.00,13000.00,2606.76,7529.69,0.36,1
25110,2746,1000.00,13000.00,14000.00,176.98,12823.02,0.25,1
25111,2746,1000.00,14000.00,15000.00,0.00,14000.00,0.05,1
25112,2746,1000.00,15000.00,16000.00,1334.77,3105.86,0.18,1
25113,2746,1000.00,16000.00,17000.00,0.00,6525.00,0.18,1
25114,2746,1000.00,17000.00,18000.00,0.00,17000.00,0.02,1
25115,2746,1000.00,18000.00,19000.00,7355.78,10644.22,0.28,1
25116,2746,1000.00,19000.00,20000.00,8752.53,10247.47,0.15,1
25117,2746,1000.00,20000.00,21000.00,0.00,20000.00,0.20,1
25118,2746,1000.00,21000.00,22000.00,0.00,21000.00,0.16,1
25119,2746,1000.00,22000.00,23000.00,11000.00,11000.00,0.30,1
25120,2746,1000.00,23000.00,24000.00,0.00,21122.03,0.21,1
25121,2746,1000.00,24000.00,25000.00,0.00,24000.00,0.11,1
25122,2746,1000.00,25000.00,26000.00,12500.00,12500.00,0.33,1
25123,2746,1000.00,26000.00,27000.00,0.00,16316.90,0.12,1
25124,2746,1000.00,27000.00,28000.00,6118.42,20881.58,0.40,1
25125,2746,1000.00,28000.00,29000.00,12111.00,15889.00,0.22,1
25126,2746,1000.00,29000.00,30000.00,10856.80,18143.20,0.11,1
25127,2746,1000.00,30000.00,31000.00,12118.84,17881.16,0.24,1
25128,2746,1000.00,31000.00,32000.00,6114.84,24885.16,0.15,1
25129,2746,-1000.00,30000.00,31000.00,4196.77,0.00,0.07,0
25130,2746,1000.00,31000.00,32000.00,0.00,31000.00,0.18,1
25131,2746,1000.00,32000.00,33000.00,1324.09,21681.71,0.38,1
25132,2746,1000.00,33000.00,34000.00,0.00,33000.00,0.29,1
25133,2746,1000.00,34000.00,35000.00,16342.18,17657.82,0.13,1
25134,2746,1000.00,35000.00,36000.00,0.00,26720.57,0.22,1
25135,2746,1000.00,36000.00,37000.00,6490.23,24831.52,0.37,1
25136,2746,1000.00,37000.00,38000.00,13956.19,23043.81,0.24,1
25137,2746,1000.00,38000.00,39000.00,0.00,38000.00,0.08,1
25138,2746,0.00,38000.00,39000.00,0.00,0.00,0.06,0
25139,2747,-1000.00,-1000.00,0.00,0.00,1000.00,0.23,0
25140,2748,-1000.00,-1000.00,0.00,352.56,217.92,0.18,0
25141,2749,-1000.00,-1000.00,0.00,0.00,798.98,0.03,0
25142,2750,-1000.00,-1000.00,0.00,311.15,688.85,0.18,0
25143,2751,1000.00,1000.00,2000.00,0.00,1000.00,0.23,1
25144,2751,1000.00,2000.00,3000.00,520.50,734.79,0.23,1
25145,2751,1000.00,3000.00,4000.00,0.00,2754.59,0.41,1
25146,2751,1000.00,4000.00,5000.00,1253.57,1683.80,0.25,1
25147,2751,1000.00,5000.00,6000.00,2152.04,2847.96,0.17,1
25148,2751,-1000.00,4000.00,5000.00,2989.34,0.00,0.06,0
25149,2751,-1000.00,3000.00,4000.00,552.62,4447.38,0.41,0
25150,2751,-1000.00,2000.00,3000.00,4000.00,0.00,0.02,0
25151,2751,-1000.00,1000.00,2000.00,0.00,2518.01,0.41,0
25152,2751,-1000.00,0.00,1000.00,0.00,866.39,0.25,0
25153,2751,-1000.00,-1000.00,0.00,24.07,794.02,0.42,0
25154,2752,-714.48,-714.48,285.52,0.00,714.48,0.26,0
25155,2752,-285.52,-1000.00,0.00,0.00,285.52,0.16,0
25156,2753,-564.14,-564.14,435.86,0.00,564.14,0.32,0
25157,2753,-435.86,-1000.00,0.00,217.93,217.93,0.03,0
25158,2754,1000.00,1000.00,2000.00,271.59,728.41,0.38,1
25159,2754,1000.00,2000.00,3000.00,0.00,2000.00,0.37,1
25160,2754,1000.00,3000.00,4000.00,536.11,2463.89,0.40,1
25161,2754,1000.00,4000.00,5000.00,0.00,669.22,0.13,1
25162,2754,0.00,4000.00,5000.00,0.00,0.00,0.01,0
25163,2754,1000.00,5000.00,6000.00,775.20,4224.80,0.40,1
25164,2754,-1000.00,4000.00,5000.00,4089.77,0.00,0.01,0
25165,2754,1000.00,5000.00,6000.00,192.04,742.87,0.16,1
25166,2754,1000.00,6000.00,7000.00,0.00,6000.00,0.38,1
25167,2754,1000.00,7000.00,8000.00,3500.00,3500.00,0.19,1
25168,2754,1000.00,8000.00,9000.00,0.00,8000.00,0.43,1
25169,2754,1000.00,9000.00,10000.00,4500.00,4500.00,0.17,1
25170,2754,1000.00,10000.00,11000.00,0.00,10000.00,0.44,1
25171,2754,0.00,10000.00,11000.00,0.00,0.00,0.02,0
25172,2754,1000.00,11000.00,12000.00,0.00,11000.00,0.37,1
25173,2754,1000.00,12000.00,13000.00,0.00,12000.00,0.34,1
25174,2754,1000.00,13000.00,14000.00,6500.00,6500.00,0.02,1
25175,2754,1000.00,14000.00,15000.00,4168.35,9831.65,0.31,1
25176,2754,1000.00,15000.00,16000.00,1127.97,13872.03,0.44,1
25177,2754,-1000.00,14000.00,15000.00,12028.87,3971.13,0.22,0
25178,2754,1000.00,15000.00,16000.00,0.00,15000.00,0.36,1
25179,2754,1000.00,16000.00,17000.00,3763.44,12236.56,0.39,1
25180,2754,-1000.00,15000.00,16000.00,10603.98,6396.02,0.13,0
25181,2754,1000.00,16000.00,17000.00,2273.62,13726.38,0.01,1
25182,2754,1000.00,17000.00,18000.00,6564.34,10435.66,0.26,1
25183,2754,1000.00,18000.00,19000.00,0.00,18000.00,0.09,1
25184,2754,1000.00,19000.00,20000.00,1042.83,17957.17,0.33,1
25185,2754,1000.00,20000.00,21000.00,4020.06,15979.94,0.41,1
25186,2754,1000.00,21000.00,22000.00,0.00,21000.00,0.06,1
25187,2754,1000.00,22000.00,23000.00,0.00,22000.00,0.12,1
25188,2754,1000.00,23000.00,24000.00,0.00,23000.00,0.42,1
25189,2754,1000.00,24000.00,25000.00,12000.00,12000.00,0.08,1
25190,2754,1000.00,25000.00,26000.00,5975.52,19024.48,0.15,1
25191,2754,1000.00,26000.00,27000.00,0.00,26000.00,0.11,1
25192,2754,1000.00,27000.00,28000.00,9178.85,17821.15,0.33,1
25193,2754,1000.00,28000.00,29000.00,0.00,7514.77,0.04,1
25194,2754,1000.00,29000.00,30000.00,0.00,29000.00,0.04,1
25195,2754,1000.00,30000.00,31000.00,13723.18,16276.82,0.44,1
25196,2755,1000.00,1000.00,2000.00,364.56,635.44,0.32,1
25197,2755,1000.00,2000.00,3000.00,0.00,1145.49,0.16,1
25198,2755,1000.00,3000.00,4000.00,0.00,2480.75,0.09,1
25199,2755,1000.00,4000.00,5000.00,0.00,3224.33,0.13,1
25200,2755,1000.00,5000.00,6000.00,0.00,4108.49,0.42,1
25201,2755,1000.00,6000.00,7000.00,684.96,5315.04,0.14,1
25202,2755,1000.00,7000.00,8000.00,0.00,7000.00,0.04,1
25203,2755,1000.00,8000.00,9000.00,0.00,8000.00,0.40,1
25204,2755,1000.00,9000.00,10000.00,0.00,9000.00,0.13,1
25205,2755,1000.00,10000.00,11000.00,5000.00,5000.00,0.05,1
25206,2755,1000.00,11000.00,12000.00,2781.50,8218.50,0.31,1
25207,2755,-1000.00,10000.00,11000.00,6477.24,5522.76,0.17,0
25208,2755,1000.00,11000.00,12000.00,0.00,11000.00,0.30,1
25209,2755,1000.00,12000.00,13000.00,3401.59,8598.41,0.36,1
25210,2755,1000.00,13000.00,14000.00,3126.27,9873.73,0.26,1
25211,2755,1000.00,14000.00,15000.00,2683.20,9660.78,0.37,1
25212,2755,1000.00,15000.00,16000.00,1974.13,13025.87,0.43,1
25213,2755,-1000.00,14000.00,15000.00,5126.88,10873.12,0.27,0
25214,2755,-1000.00,13000.00,14000.00,0.00,8183.10,0.33,0
25215,2755,-1000.00,12000.00,13000.00,7000.00,7000.00,0.00,0
25216,2755,0.00,12000.00,13000.00,0.00,0.00,0.09,0
25217,2755,-1000.00,11000.00,12000.00,6508.48,6491.52,0.44,0
25218,2755,-1000.00,10000.00,11000.00,4867.77,7132.23,0.23,0
25219,2755,-1000.00,9000.00,10000.00,5421.19,5578.81,0.09,0
25220,2755,-1000.00,8000.00,9000.00,4245.57,726.21,0.11,0
25221,2755,-1000.00,7000.00,8000.00,0.00,9000.00,0.36,0
25222,2755,-1000.00,6000.00,7000.00,1574.05,5448.63,0.36,0
25223,2755,-1000.00,5000.00,6000.00,0.00,1314.08,0.15,0
25224,2755,-1000.00,4000.00,5000.00,0.00,6000.00,0.38,0
25225,2755,-1000.00,3000.00,4000.00,1950.10,3049.90,0.22,0
25226,2755,-961.88,2038.12,3038.12,0.00,961.88,0.16,0
25227,2755,-1000.00,1038.12,2038.12,818.79,0.00,0.09,0
25228,2755,-1000.00,38.12,1038.12,638.91,714.53,0.22,0
25229,2755,-1000.00,-961.88,38.12,0.00,1038.12,0.26,0
25230,2755,-38.12,-1000.00,0.00,0.00,38.12,0.25,0
25231,2756,0.00,0.00,1000.00,0.00,0.00,0.01,0
25232,2756,-277.15,-277.15,722.85,144.03,133.12,0.15,0
25233,2756,-1000.00,-1277.15,-277.15,0.00,60.33,0.10,0
25234,2757,1000.00,1000.00,2000.00,0.00,1000.00,0.37,1
25235,2757,1000.00,2000.00,3000.00,456.15,1543.85,0.16,1
25236,2757,-757.52,1242.48,2242.48,757.52,0.00,0.08,0
25237,2757,1000.00,2242.48,3242.48,502.21,1740.28,0.19,1
25238,2757,1000.00,3242.48,4242.48,410.99,606.23,0.17,1
25239,2757,1000.00,4242.48,5242.48,0.00,4242.48,0.39,1
25240,2757,1000.00,5242.48,6242.48,0.00,5242.48,0.37,1
25241,2757,1000.00,6242.48,7242.48,1146.48,5096.01,0.41,1
25242,2757,-1000.00,5242.48,6242.48,5207.76,2034.72,0.03,0
25243,2757,-1000.00,4242.48,5242.48,6242.48,0.00,0.07,0
25244,2757,1000.00,5242.48,6242.48,1808.75,3433.73,0.29,1
25245,2757,1000.00,6242.48,7242.48,0.00,6224.50,0.25,1
25246,2757,1000.00,7242.48,8242.48,0.00,2342.08,0.01,1
25247,2757,1000.00,8242.48,9242.48,0.00,2743.61,0.25,1
25248,2757,1000.00,9242.48,10242.48,3880.43,5362.05,0.20,1
25249,2757,1000.00,10242.48,11242.48,0.00,8423.35,0.42,1
25250,2757,1000.00,11242.48,12242.48,2197.55,9044.93,0.41,1
25251,2757,-1000.00,10242.48,11242.48,7726.74,4515.75,0.03,0
25252,2757,1000.00,11242.48,12242.48,5123.20,6119.28,0.25,1
25253,2757,1000.00,12242.48,13242.48,0.00,12242.48,0.07,1
25254,2757,1000.00,13242.48,14242.48,5406.78,7835.71,0.25,1
25255,2757,1000.00,14242.48,15242.48,4895.31,9347.17,0.18,1
25256,2757,1000.00,15242.48,16242.48,4127.26,9100.42,0.32,1
25257,2757,1000.00,16242.48,17242.48,8121.24,8121.24,0.09,1
25258,2757,1000.00,17242.48,18242.48,6483.07,10759.41,0.29,1
25259,2757,-1000.00,16242.48,17242.48,6205.02,0.00,0.09,0
25260,2757,-1000.00,15242.48,16242.48,10547.54,0.00,0.05,0
25261,2757,1000.00,16242.48,17242.48,3574.52,12667.96,0.38,1
25262,2757,1000.00,17242.48,18242.48,0.00,16172.00,0.42,1
25263,2757,1000.00,18242.48,19242.48,0.00,7522.52,0.21,1
25264,2757,1000.00,19242.48,20242.48,0.00,19242.48,0.35,1
25265,2757,-1000.00,18242.48,19242.48,10287.32,4043.27,0.13,0
25266,2757,1000.00,19242.48,20242.48,6096.87,13145.61,0.11,1
25267,2757,-1000.00,18242.48,19242.48,15970.17,4272.31,0.20,0
25268,2757,1000.00,19242.48,20242.48,0.00,19242.48,0.42,1
25269,2757,1000.00,20242.48,21242.48,0.00,16011.63,0.25,1
25270,2757,1000.00,21242.48,22242.48,1990.97,19251.51,0.40,1
25271,2757,1000.00,22242.48,23242.48,0.00,12266.98,0.14,1
25272,2757,1000.00,23242.48,24242.48,8391.19,13920.11,0.30,1
25273,2757,-1000.00,22242.48,23242.48,2193.22,0.00,0.09,0
25274,2757,1000.00,23242.48,24242.48,0.00,23242.48,0.08,1
25275,2757,1000.00,24242.48,25242.48,0.00,24242.48,0.34,1
25276,2757,-1000.00,23242.48,24242.48,13378.03,11864.45,0.37,0
25277,2757,1000.00,24242.48,25242.48,0.00,24242.48,0.35,1
25278,2757,1000.00,25242.48,26242.48,0.00,25242.48,0.36,1
25279,2757,1000.00,26242.48,27242.48,0.00,26242.48,0.42,1
25280,2757,1000.00,27242.48,28242.48,591.38,24920.96,0.33,1
25281,2757,-1000.00,26242.48,27242.48,16958.08,11284.40,0.19,0
25282,2757,-1000.00,25242.48,26242.48,0.00,27242.48,0.32,0
25283,2757,-1000.00,24242.48,25242.48,3794.31,22448.17,0.42,0
25284,2757,-1000.00,23242.48,24242.48,0.00,25242.48,0.26,0
25285,2757,-1000.00,22242.48,23242.48,12121.24,12121.24,0.03,0
25286,2757,-1000.00,21242.48,22242.48,11621.24,11621.24,0.35,0
25287,2757,-1000.00,20242.48,21242.48,13943.35,8299.13,0.13,0
25288,2757,-1000.00,19242.48,20242.48,0.00,21242.48,0.37,0
25289,2757,-1000.00,18242.48,19242.48,3991.59,4614.66,0.18,0
25290,2757,-1000.00,17242.48,18242.48,8764.07,10478.42,0.18,0
25291,2757,-1000.00,16242.48,17242.48,1865.61,11258.50,0.36,0
25292,2757,-1000.00,15242.48,16242.48,0.00,17242.48,0.24,0
25293,2757,-1000.00,14242.48,15242.48,0.00,10303.90,0.33,0
25294,2757,-1000.00,13242.48,14242.48,7621.24,7621.24,0.39,0
25295,2757,-1000.00,12242.48,13242.48,2245.24,0.00,0.00,0
25296,2757,-1000.00,11242.48,12242.48,3664.96,9577.52,0.32,0
25297,2757,-1000.00,10242.48,11242.48,0.00,6931.77,0.06,0
25298,2757,-1000.00,9242.48,10242.48,0.00,11242.48,0.41,0
25299,2757,0.00,9242.48,10242.48,0.00,0.00,0.00,0
25300,2757,-1000.00,8242.48,9242.48,924.45,9318.03,0.42,0
25301,2757,-1000.00,7242.48,8242.48,0.00,9242.48,0.10,0
25302,2757,-1000.00,6242.48,7242.48,0.00,8242.48,0.38,0
25303,2757,-1000.00,5242.48,6242.48,916.70,3748.42,0.32,0
25304,2757,-1000.00,4242.48,5242.48,0.00,5621.46,0.29,0
25305,2758,0.00,0.00,1000.00,0.00,0.00,0.06,0
25306,2758,1000.00,1000.00,2000.00,0.00,796.38,0.33,1
25307,2758,1000.00,2000.00,3000.00,0.00,677.00,0.12,1
25308,2758,-1000.00,1000.00,2000.00,974.80,218.41,0.12,0
25309,2758,1000.00,2000.00,3000.00,0.00,689.26,0.26,1
25310,2758,-1000.00,1000.00,2000.00,1872.03,1127.97,0.05,0
25311,2758,-1000.00,0.00,1000.00,987.45,244.06,0.13,0
25312,2758,1000.00,1000.00,2000.00,47.67,627.89,0.37,1
25313,2758,1000.00,2000.00,3000.00,595.82,1404.18,0.31,1
25314,2758,1000.00,3000.00,4000.00,0.00,3000.00,0.24,1
25315,2758,1000.00,4000.00,5000.00,0.00,4000.00,0.27,1
25316,2758,1000.00,5000.00,6000.00,716.62,3261.17,0.37,1
25317,2758,1000.00,6000.00,7000.00,0.00,4080.97,0.33,1
25318,2758,1000.00,7000.00,8000.00,590.13,4677.01,0.38,1
25319,2758,-1000.00,6000.00,7000.00,4734.77,3265.23,0.37,0
25320,2758,-1000.00,5000.00,6000.00,3692.40,2690.95,0.20,0
25321,2758,1000.00,6000.00,7000.00,226.64,5773.36,0.29,1
25322,2758,1000.00,7000.00,8000.00,0.00,5125.64,0.32,1
25323,2758,-1000.00,6000.00,7000.00,4711.32,1046.67,0.10,0
25324,2758,-1000.00,5000.00,6000.00,0.00,7000.00,0.13,0
25325,2758,-1000.00,4000.00,5000.00,6000.00,0.00,0.01,0
25326,2758,-1000.00,3000.00,4000.00,2339.89,2660.11,0.12,0
25327,2758,-1000.00,2000.00,3000.00,0.00,3008.82,0.12,0
25328,2758,-1000.00,1000.00,2000.00,1500.00,1500.00,0.17,0
25329,2758,-1000.00,0.00,1000.00,0.00,2000.00,0.23,0
25330,2758,-1000.00,-1000.00,0.00,312.70,687.30,0.34,0
25331,2759,1000.00,1000.00,2000.00,0.00,457.14,0.21,1
25332,2759,1000.00,2000.00,3000.00,0.00,1657.02,0.42,1
25333,2759,1000.00,3000.00,4000.00,0.00,2762.65,0.43,1
25334,2759,1000.00,4000.00,5000.00,1064.87,2935.13,0.35,1
25335,2759,1000.00,5000.00,6000.00,2106.99,2893.01,0.19,1
25336,2759,1000.00,6000.00,7000.00,0.00,4581.73,0.31,1
25337,2759,1000.00,7000.00,8000.00,2372.07,4627.93,0.33,1
25338,2759,1000.00,8000.00,9000.00,0.00,8000.00,0.36,1
25339,2759,1000.00,9000.00,10000.00,4500.00,4500.00,0.07,1
25340,2759,1000.00,10000.00,11000.00,0.00,7616.10,0.39,1
25341,2759,1000.00,11000.00,12000.00,793.39,10206.61,0.43,1
25342,2759,1000.00,12000.00,13000.00,6000.00,6000.00,0.13,1
25343,2759,1000.00,13000.00,14000.00,3097.69,6373.95,0.30,1
25344,2759,1000.00,14000.00,15000.00,1530.98,6997.57,0.31,1
25345,2759,1000.00,15000.00,16000.00,7500.00,7500.00,0.27,1
25346,2759,1000.00,16000.00,17000.00,5449.36,10550.64,0.10,1
25347,2759,1000.00,17000.00,18000.00,4121.24,12878.76,0.33,1
25348,2759,1000.00,18000.00,19000.00,0.00,13897.13,0.11,1
25349,2759,1000.00,19000.00,20000.00,5155.46,13844.54,0.26,1
25350,2759,1000.00,20000.00,21000.00,7089.30,12910.70,0.19,1
25351,2759,1000.00,21000.00,22000.00,0.00,21000.00,0.24,1
25352,2759,-1000.00,20000.00,21000.00,13378.17,5369.51,0.16,0
25353,2759,1000.00,21000.00,22000.00,2453.07,18546.93,0.19,1
25354,2759,1000.00,22000.00,23000.00,9673.33,12326.67,0.26,1
25355,2759,1000.00,23000.00,24000.00,0.00,21269.51,0.28,1
25356,2759,1000.00,24000.00,25000.00,5806.93,18193.07,0.08,1
25357,2759,1000.00,25000.00,26000.00,0.00,14127.92,0.00,1
25358,2759,1000.00,26000.00,27000.00,8900.18,17099.82,0.14,1
25359,2759,-1000.00,25000.00,26000.00,19035.95,3716.09,0.08,0
25360,2759,-1000.00,24000.00,25000.00,9228.24,7677.58,0.19,0
25361,2759,1000.00,25000.00,26000.00,3685.77,21314.23,0.42,1
25362,2759,1000.00,26000.00,27000.00,6200.05,19799.95,0.42,1
25363,2759,1000.00,27000.00,28000.00,5912.97,21087.03,0.38,1
25364,2759,1000.00,28000.00,29000.00,12469.07,15530.93,0.00,1
25365,2759,1000.00,29000.00,30000.00,0.00,29000.00,0.19,1
25366,2759,1000.00,30000.00,31000.00,0.00,30000.00,0.15,1
25367,2759,1000.00,31000.00,32000.00,0.00,31000.00,0.33,1
25368,2759,1000.00,32000.00,33000.00,0.00,32000.00,0.06,1
25369,2759,1000.00,33000.00,34000.00,0.00,33000.00,0.33,1
25370,2759,1000.00,34000.00,35000.00,17000.00,17000.00,0.02,1
25371,2759,1000.00,35000.00,36000.00,17500.00,17500.00,0.40,1
25372,2759,1000.00,36000.00,37000.00,12302.24,23697.76,0.28,1
25373,2759,1000.00,37000.00,38000.00,9852.46,27147.54,0.25,1
25374,2760,1000.00,1000.00,2000.00,0.00,1000.00,0.08,1
25375,2760,1000.00,2000.00,3000.00,442.05,1557.95,0.20,1
25376,2760,1000.00,3000.00,4000.00,0.00,2379.49,0.38,1
25377,2760,1000.00,4000.00,5000.00,0.00,3915.75,0.07,1
25378,2760,1000.00,5000.00,6000.00,0.00,5000.00,0.07,1
25379,2760,-1000.00,4000.00,5000.00,3402.98,2597.02,0.17,0
25380,2760,1000.00,5000.00,6000.00,0.00,2713.60,0.30,1
25381,2760,1000.00,6000.00,7000.00,1905.47,4094.53,0.07,1
25382,2760,1000.00,7000.00,8000.00,0.00,7000.00,0.40,1
25383,2760,1000.00,8000.00,9000.00,0.00,8000.00,0.09,1
25384,2760,1000.00,9000.00,10000.00,0.00,9000.00,0.07,1
25385,2760,1000.00,10000.00,11000.00,0.00,7346.84,0.07,1
25386,2760,-324.87,9675.13,10675.13,324.87,0.00,0.02,0
25387,2760,1000.00,10675.13,11675.13,951.47,9359.38,0.43,1
25388,2760,1000.00,11675.13,12675.13,0.00,11228.45,0.39,1
25389,2760,1000.00,12675.13,13675.13,0.00,4078.70,0.20,1
25390,2760,1000.00,13675.13,14675.13,4772.92,8902.21,0.34,1
25391,2760,1000.00,14675.13,15675.13,0.00,14675.13,0.10,1
25392,2760,1000.00,15675.13,16675.13,0.00,9974.58,0.33,1
25393,2760,1000.00,16675.13,17675.13,0.00,16675.13,0.03,1
25394,2760,-1000.00,15675.13,16675.13,10980.73,6694.40,0.32,0
25395,2760,1000.00,16675.13,17675.13,4290.43,11705.00,0.36,1
25396,2760,1000.00,17675.13,18675.13,0.00,17675.13,0.22,1
25397,2760,1000.00,18675.13,19675.13,0.00,18675.13,0.01,1
25398,2760,1000.00,19675.13,20675.13,3877.17,15797.96,0.35,1
25399,2760,0.00,19675.13,20675.13,0.00,0.00,0.05,0
25400,2760,1000.00,20675.13,21675.13,2224.79,9032.16,0.28,1
25401,2760,-1000.00,19675.13,20675.13,21525.56,0.00,0.02,0
25402,2760,1000.00,20675.13,21675.13,10337.56,10337.56,0.05,1
25403,2760,1000.00,21675.13,22675.13,0.00,10880.16,0.22,1
25404,2760,0.00,21675.13,22675.13,0.00,0.00,0.03,0
25405,2760,1000.00,22675.13,23675.13,0.00,21028.64,0.24,1
25406,2760,1000.00,23675.13,24675.13,0.00,23675.13,0.13,1
25407,2760,1000.00,24675.13,25675.13,0.00,18246.94,0.38,1
25408,2760,1000.00,25675.13,26675.13,0.00,2537.15,0.14,1
25409,2760,1000.00,26675.13,27675.13,0.00,11062.37,0.20,1
25410,2760,1000.00,27675.13,28675.13,11868.61,15806.51,0.09,1
25411,2760,1000.00,28675.13,29675.13,6385.13,22290.00,0.42,1
25412,2760,1000.00,29675.13,30675.13,13020.40,16654.73,0.19,1
25413,2760,1000.00,30675.13,31675.13,1065.20,21481.90,0.39,1
25414,2760,1000.00,31675.13,32675.13,0.00,30037.30,0.44,1
25415,2760,-1000.00,30675.13,31675.13,26807.45,0.00,0.03,0
25416,2760,1000.00,31675.13,32675.13,3741.30,27933.83,0.36,1
25417,2760,0.00,31675.13,32675.13,0.00,0.00,0.01,0
25418,2761,-1000.00,-1000.00,0.00,0.00,1000.00,0.30,0
25419,2762,-1000.00,-1000.00,0.00,350.52,649.48,0.19,0
25420,2763,-1000.00,-1000.00,0.00,0.00,1000.00,0.13,0
25421,2764,1000.00,1000.00,2000.00,0.00,588.48,0.33,1
25422,2764,1000.00,2000.00,3000.00,267.57,1732.43,0.42,1
25423,2764,1000.00,3000.00,4000.00,0.00,3000.00,0.23,1
25424,2764,1000.00,4000.00,5000.00,331.05,3668.95,0.42,1
25425,2764,1000.00,5000.00,6000.00,1736.93,3263.07,0.42,1
25426,2764,1000.00,6000.00,7000.00,0.00,4759.57,0.21,1
25427,2764,1000.00,7000.00,8000.00,0.00,5657.15,0.31,1
25428,2764,1000.00,8000.00,9000.00,1560.65,6439.35,0.23,1
25429,2764,1000.00,9000.00,10000.00,1642.71,7357.29,0.17,1
25430,2764,1000.00,10000.00,11000.00,0.00,10000.00,0.01,1
25431,2764,1000.00,11000.00,12000.00,0.00,8067.18,0.35,1
25432,2764,1000.00,12000.00,13000.00,4740.67,7259.33,0.30,1
25433,2764,1000.00,13000.00,14000.00,327.15,12672.85,0.38,1
25434,2764,1000.00,14000.00,15000.00,57.57,13942.43,0.31,1
25435,2764,-1000.00,13000.00,14000.00,12326.02,2673.98,0.07,0
25436,2764,-1000.00,12000.00,13000.00,8415.02,5584.98,0.37,0
25437,2764,-998.66,11001.34,12001.34,998.66,0.00,0.05,0
25438,2764,1000.00,12001.34,13001.34,0.00,2741.21,0.14,1
25439,2764,1000.00,13001.34,14001.34,0.00,3437.26,0.19,1
25440,2764,1000.00,14001.34,15001.34,0.00,11117.33,0.41,1
25441,2764,1000.00,15001.34,16001.34,219.89,14781.45,0.30,1
25442,2764,1000.00,16001.34,17001.34,4874.40,11126.94,0.19,1
25443,2764,1000.00,17001.34,18001.34,5993.20,7409.04,0.16,1
25444,2764,1000.00,18001.34,19001.34,0.00,18001.34,0.19,1
25445,2764,1000.00,19001.34,20001.34,5518.96,13482.38,0.36,1
25446,2764,1000.00,20001.34,21001.34,6464.28,13537.06,0.30,1
25447,2764,-1000.00,19001.34,20001.34,8159.50,0.00,0.00,0
25448,2764,1000.00,20001.34,21001.34,0.00,20001.34,0.06,1
25449,2764,1000.00,21001.34,22001.34,0.00,21001.34,0.38,1
25450,2764,1000.00,22001.34,23001.34,1774.60,8127.38,0.15,1
25451,2764,1000.00,23001.34,24001.34,0.00,23001.34,0.14,1
25452,2764,-1000.00,22001.34,23001.34,9097.62,8328.27,0.20,0
25453,2764,1000.00,23001.34,24001.34,11500.67,11500.67,0.03,1
25454,2764,1000.00,24001.34,25001.34,8346.38,15654.97,0.01,1
25455,2764,1000.00,25001.34,26001.34,0.00,25001.34,0.43,1
25456,2764,1000.00,26001.34,27001.34,1232.60,24768.74,0.18,1
25457,2764,-1000.00,25001.34,26001.34,14277.09,12724.26,0.24,0
25458,2764,-1000.00,24001.34,25001.34,13152.20,12849.14,0.35,0
25459,2764,1000.00,25001.34,26001.34,0.00,23070.83,0.39,1
25460,2764,1000.00,26001.34,27001.34,13000.67,13000.67,0.03,1
25461,2764,1000.00,27001.34,28001.34,10639.44,16361.91,0.41,1
25462,2765,-1000.00,-1000.00,0.00,0.00,705.78,0.36,0
25463,2766,1000.00,1000.00,2000.00,0.00,1000.00,0.02,1
25464,2766,1000.00,2000.00,3000.00,994.54,1005.46,0.06,1
25465,2766,1000.00,3000.00,4000.00,0.00,3000.00,0.24,1
25466,2766,1000.00,4000.00,5000.00,1012.69,2987.31,0.04,1
25467,2766,1000.00,5000.00,6000.00,0.00,2373.32,0.08,1
25468,2766,1000.00,6000.00,7000.00,0.00,2795.61,0.24,1
25469,2766,1000.00,7000.00,8000.00,2002.52,4997.48,0.22,1
25470,2766,-1000.00,6000.00,7000.00,3780.10,1207.88,0.12,0
25471,2766,1000.00,7000.00,8000.00,0.00,7000.00,0.28,1
25472,2766,1000.00,8000.00,9000.00,0.00,8000.00,0.02,1
25473,2766,-1000.00,7000.00,8000.00,5633.28,3366.72,0.08,0
25474,2766,1000.00,8000.00,9000.00,0.00,6290.96,0.32,1
25475,2766,1000.00,9000.00,10000.00,0.00,4057.73,0.06,1
25476,2766,-1000.00,8000.00,9000.00,3901.44,2330.80,0.16,0
25477,2766,-1000.00,7000.00,8000.00,5208.84,3791.16,0.14,0
25478,2766,1000.00,8000.00,9000.00,1580.09,6419.91,0.40,1
25479,2766,1000.00,9000.00,10000.00,1742.92,7257.08,0.41,1
25480,2766,1000.00,10000.00,11000.00,0.00,7599.76,0.13,1
25481,2766,1000.00,11000.00,12000.00,0.00,11000.00,0.18,1
25482,2766,-1000.00,10000.00,11000.00,10191.95,1808.05,0.01,0
25483,2766,1000.00,11000.00,12000.00,0.00,9408.55,0.41,1
25484,2766,-1000.00,10000.00,11000.00,7145.80,4854.20,0.33,0
25485,2766,1000.00,11000.00,12000.00,2674.38,8325.62,0.12,1
25486,2766,1000.00,12000.00,13000.00,951.09,9653.39,0.42,1
25487,2766,-1000.00,11000.00,12000.00,11725.07,0.00,0.02,0
25488,2766,-1000.00,10000.00,11000.00,5573.41,6426.59,0.15,0
25489,2766,-1000.00,9000.00,10000.00,6434.05,4565.95,0.14,0
25490,2766,-1000.00,8000.00,9000.00,4585.57,5414.43,0.08,0
25491,2766,-1000.00,7000.00,8000.00,3017.30,5982.70,0.16,0
25492,2766,-1000.00,6000.00,7000.00,0.00,8000.00,0.14,0
25493,2766,-1000.00,5000.00,6000.00,3126.40,3873.60,0.42,0
25494,2766,-1000.00,4000.00,5000.00,0.00,4980.89,0.42,0
25495,2766,-1000.00,3000.00,4000.00,808.99,1456.84,0.21,0
25496,2766,-1000.00,2000.00,3000.00,754.21,581.61,0.15,0
25497,2766,-1000.00,1000.00,2000.00,1492.68,1507.32,0.05,0
25498,2766,-1000.00,0.00,1000.00,351.96,1648.04,0.40,0
25499,2766,-1000.00,-1000.00,0.00,500.44,355.95,0.18,0
25500,2767,-1000.00,-1000.00,0.00,0.00,899.37,0.39,0
25501,2768,0.00,0.00,1000.00,0.00,0.00,0.37,0
25502,2768,-936.26,-936.26,63.74,936.26,0.00,0.08,0
25503,2768,-1000.00,-1936.26,-936.26,0.00,63.74,0.04,0
25504,2769,-858.06,-858.06,141.94,114.24,743.82,0.40,0
25505,2769,-141.94,-1000.00,0.00,0.00,141.94,0.40,0
25506,2770,-1000.00,-1000.00,0.00,655.99,344.01,0.10,0
25507,2771,-1000.00,-1000.00,0.00,0.00,302.84,0.25,0
25508,2772,-1000.00,-1000.00,0.00,494.22,505.78,0.23,0
25509,2773,-1000.00,-1000.00,0.00,476.69,523.31,0.04,0
25510,2774,0.00,0.00,1000.00,0.00,0.00,0.19,0
25511,2774,-1000.00,-1000.00,0.00,0.00,892.83,0.36,0
25512,2775,-1000.00,-1000.00,0.00,0.00,1000.00,0.07,0
25513,2776,-54.42,-54.42,945.58,0.00,54.42,0.42,0
25514,2776,0.00,-54.42,945.58,0.00,0.00,0.16,0
25515,2776,-630.32,-684.74,315.26,0.00,630.32,0.25,0
25516,2776,-25.72,-710.46,289.54,0.00,25.72,0.33,0
25517,2776,1000.00,289.54,1289.54,184.71,0.00,0.17,1
25518,2776,1000.00,1289.54,2289.54,149.89,0.00,0.42,1
25519,2776,0.00,1289.54,2289.54,0.00,0.00,0.04,0
25520,2776,1000.00,2289.54,3289.54,920.91,0.00,0.13,1
25521,2776,1000.00,3289.54,4289.54,628.83,299.28,0.42,1
25522,2776,1000.00,4289.54,5289.54,27.26,0.00,0.12,1
25523,2776,-1000.00,3289.54,4289.54,0.00,5289.54,0.30,0
25524,2776,1000.00,4289.54,5289.54,3443.94,0.00,0.09,1
25525,2776,0.00,4289.54,5289.54,0.00,0.00,0.25,0
25526,2776,1000.00,5289.54,6289.54,3224.45,2065.09,0.20,1
25527,2776,1000.00,6289.54,7289.54,2418.65,2205.66,0.35,1
25528,2776,-1000.00,5289.54,6289.54,0.00,1151.00,0.44,0
25529,2776,-1000.00,4289.54,5289.54,0.00,4117.06,0.00,0
25530,2776,1000.00,5289.54,6289.54,3096.95,2192.59,0.09,1
25531,2776,1000.00,6289.54,7289.54,2313.38,317.65,0.36,1
25532,2776,1000.00,7289.54,8289.54,4437.26,2852.29,0.39,1
25533,2776,-1000.00,6289.54,7289.54,0.00,4688.21,0.16,0
25534,2776,1000.00,7289.54,8289.54,3644.92,2601.57,0.23,1
25535,2776,1000.00,8289.54,9289.54,4372.26,3917.28,0.40,1
25536,2776,1000.00,9289.54,10289.54,195.00,0.00,0.27,1
25537,2776,1000.00,10289.54,11289.54,1127.71,0.00,0.21,1
25538,2776,0.00,10289.54,11289.54,0.00,0.00,0.26,0
25539,2776,1000.00,11289.54,12289.54,6157.28,0.00,0.26,1
25540,2776,1000.00,12289.54,13289.54,12289.54,0.00,0.06,1
25541,2776,-1000.00,11289.54,12289.54,1182.23,3089.78,0.42,0
25542,2776,-1000.00,10289.54,11289.54,0.00,4077.15,0.35,0
25543,2776,-1000.00,9289.54,10289.54,0.00,10527.27,0.10,0
25544,2776,0.00,9289.54,10289.54,0.00,0.00,0.42,0
25545,2777,-1000.00,-1000.00,0.00,0.00,1000.00,0.42,0
25546,2778,-1000.00,-1000.00,0.00,302.25,697.75,0.33,0
25547,2779,-1000.00,-1000.00,0.00,0.00,1000.00,0.13,0
25548,2780,1000.00,1000.00,2000.00,429.84,570.16,0.20,1
25549,2780,1000.00,2000.00,3000.00,801.49,1198.51,0.18,1
25550,2780,-1000.00,1000.00,2000.00,2467.71,532.29,0.05,0
25551,2780,1000.00,2000.00,3000.00,329.97,1670.03,0.34,1
25552,2780,1000.00,3000.00,4000.00,943.05,2056.95,0.11,1
25553,2780,1000.00,4000.00,5000.00,0.00,4000.00,0.03,1
25554,2780,1000.00,5000.00,6000.00,0.00,5000.00,0.26,1
25555,2780,1000.00,6000.00,7000.00,0.00,6000.00,0.01,1
25556,2780,1000.00,7000.00,8000.00,889.34,6110.66,0.32,1
25557,2780,1000.00,8000.00,9000.00,3023.60,4382.57,0.27,1
25558,2780,1000.00,9000.00,10000.00,0.00,9000.00,0.20,1
25559,2780,1000.00,10000.00,11000.00,2507.80,7492.20,0.13,1
25560,2780,1000.00,11000.00,12000.00,1714.99,9285.01,0.06,1
25561,2780,1000.00,12000.00,13000.00,3884.36,8115.64,0.24,1
25562,2780,-1000.00,11000.00,12000.00,5207.45,2657.41,0.17,0
25563,2780,0.00,11000.00,12000.00,0.00,0.00,0.05,0
25564,2780,1000.00,12000.00,13000.00,0.00,12000.00,0.32,1
25565,2780,1000.00,13000.00,14000.00,4024.17,8975.83,0.33,1
25566,2780,1000.00,14000.00,15000.00,5365.65,8634.35,0.36,1
25567,2780,1000.00,15000.00,16000.00,0.00,1080.12,0.14,1
25568,2780,1000.00,16000.00,17000.00,0.00,16000.00,0.01,1
25569,2780,1000.00,17000.00,18000.00,0.00,5521.36,0.22,1
25570,2780,1000.00,18000.00,19000.00,4910.38,13089.62,0.11,1
25571,2780,-1000.00,17000.00,18000.00,9018.53,3855.48,0.13,0
25572,2780,1000.00,18000.00,19000.00,0.00,15428.33,0.40,1
25573,2780,1000.00,19000.00,20000.00,9456.57,9543.43,0.37,1
25574,2780,1000.00,20000.00,21000.00,1162.94,2165.14,0.15,1
25575,2780,1000.00,21000.00,22000.00,0.00,19315.62,0.12,1
25576,2780,1000.00,22000.00,23000.00,0.00,22000.00,0.15,1
25577,2780,-1000.00,21000.00,22000.00,11969.44,11030.56,0.11,0
25578,2780,1000.00,22000.00,23000.00,0.00,22000.00,0.01,1
25579,2780,1000.00,23000.00,24000.00,0.00,7528.09,0.21,1
25580,2781,-711.48,-711.48,288.52,0.00,711.48,0.34,0
25581,2781,-288.52,-1000.00,0.00,0.00,288.52,0.36,0
25582,2782,-47.16,-47.16,952.84,0.00,47.16,0.09,0
25583,2782,-952.84,-1000.00,0.00,0.00,952.84,0.31,0
25584,2783,-1000.00,-1000.00,0.00,469.27,530.73,0.15,0
25585,2784,1000.00,1000.00,2000.00,288.40,711.60,0.11,1
25586,2784,1000.00,2000.00,3000.00,567.80,1432.20,0.35,1
25587,2784,1000.00,3000.00,4000.00,722.50,2277.50,0.16,1
25588,2784,1000.00,4000.00,5000.00,1140.55,2859.45,0.37,1
25589,2784,1000.00,5000.00,6000.00,0.00,5000.00,0.35,1
25590,2784,-1000.00,4000.00,5000.00,3035.18,2964.82,0.44,0
25591,2784,-1000.00,3000.00,4000.00,4089.93,0.00,0.03,0
25592,2784,1000.00,4000.00,5000.00,0.00,3940.10,0.19,1
25593,2784,1000.00,5000.00,6000.00,0.00,4734.14,0.40,1
25594,2784,1000.00,6000.00,7000.00,0.00,6000.00,0.19,1
25595,2784,1000.00,7000.00,8000.00,0.00,5431.27,0.34,1
25596,2784,1000.00,8000.00,9000.00,0.00,4318.18,0.31,1
25597,2784,1000.00,9000.00,10000.00,3154.69,5845.31,0.13,1
25598,2784,1000.00,10000.00,11000.00,0.00,8870.03,0.43,1
25599,2784,-1000.00,9000.00,10000.00,5845.71,5154.29,0.05,0
25600,2784,1000.00,10000.00,11000.00,0.00,10000.00,0.25,1
25601,2784,-278.22,9721.78,10721.78,278.22,0.00,0.03,0
25602,2784,1000.00,10721.78,11721.78,0.00,6512.31,0.24,1
25603,2784,1000.00,11721.78,12721.78,2349.04,6975.32,0.34,1
25604,2784,1000.00,12721.78,13721.78,3407.10,9314.68,0.30,1
25605,2784,1000.00,13721.78,14721.78,4116.78,4910.28,0.22,1
25606,2784,1000.00,14721.78,15721.78,0.00,14721.78,0.03,1
25607,2784,1000.00,15721.78,16721.78,0.00,9590.45,0.35,1
25608,2784,1000.00,16721.78,17721.78,1364.75,15357.03,0.11,1
25609,2784,-1000.00,15721.78,16721.78,8860.89,8860.89,0.33,0
25610,2784,-1000.00,14721.78,15721.78,3840.19,8795.22,0.31,0
25611,2784,-1000.00,13721.78,14721.78,0.00,15487.12,0.28,0
25612,2784,-1000.00,12721.78,13721.78,2719.57,12002.21,0.15,0
25613,2784,-1000.00,11721.78,12721.78,0.00,13721.78,0.31,0
25614,2784,-1000.00,10721.78,11721.78,1186.16,9900.43,0.13,0
25615,2784,-1000.00,9721.78,10721.78,0.00,8987.18,0.34,0
25616,2784,-1000.00,8721.78,9721.78,4324.39,2005.62,0.14,0
25617,2784,-1000.00,7721.78,8721.78,0.00,6630.53,0.14,0
25618,2784,-1000.00,6721.78,7721.78,864.76,7857.03,0.40,0
25619,2784,-1000.00,5721.78,6721.78,0.00,5044.77,0.37,0
25620,2784,-1000.00,4721.78,5721.78,0.00,4378.87,0.10,0
25621,2784,-1000.00,3721.78,4721.78,691.46,4955.00,0.42,0
25622,2784,-80.66,3641.13,4641.13,0.00,80.66,0.11,0
25623,2784,-1000.00,2641.13,3641.13,0.00,3726.34,0.41,0
25624,2784,-355.28,2285.85,3285.85,0.00,355.28,0.08,0
25625,2784,0.00,2285.85,3285.85,0.00,0.00,0.02,0
25626,2784,-616.63,1669.21,2669.21,0.00,616.63,0.12,0
25627,2784,-1000.00,669.21,1669.21,932.14,1737.08,0.22,0
25628,2784,-1000.00,-330.79,669.21,508.87,1160.34,0.30,0
25629,2784,-669.21,-1000.00,0.00,334.61,334.61,0.05,0
25630,2785,-739.64,-739.64,260.36,37.19,702.45,0.44,0
25631,2785,1000.00,260.36,1260.36,175.65,0.00,0.04,1
25632,2785,-1000.00,-739.64,260.36,0.00,1260.36,0.27,0
25633,2785,1000.00,260.36,1260.36,81.13,45.09,0.30,1
25634,2785,-1000.00,-739.64,260.36,515.35,745.01,0.37,0
25635,2785,-62.36,-802.00,198.00,27.69,34.67,0.34,0
25636,2785,-198.00,-1000.00,0.00,86.97,111.03,0.25,0
25637,2786,-34.25,-34.25,965.75,0.00,34.25,0.13,0
25638,2786,-82.05,-116.29,883.71,0.00,82.05,0.05,0
25639,2786,-875.84,-992.13,7.87,0.00,875.84,0.43,0
25640,2786,-1.62,-993.75,6.25,0.00,1.62,0.08,0
25641,2786,-0.77,-994.52,5.48,0.00,0.77,0.14,0
25642,2786,-5.48,-1000.00,0.00,1.13,4.36,0.38,0
25643,2787,-889.33,-889.33,110.67,0.00,889.33,0.43,0
25644,2787,-55.33,-944.66,55.34,0.00,55.33,0.17,0
25645,2787,-55.34,-1000.00,0.00,0.00,55.34,0.21,0
25646,2788,1000.00,1000.00,2000.00,622.12,377.88,0.04,1
25647,2788,1000.00,2000.00,3000.00,1478.62,0.00,0.02,1
25648,2788,1000.00,3000.00,4000.00,2781.66,103.40,0.11,1
25649,2788,-77.87,2922.13,3922.13,0.00,77.87,0.17,0
25650,2788,-1000.00,1922.13,2922.13,1872.41,2049.71,0.13,0
25651,2788,-1000.00,922.13,1922.13,342.24,998.55,0.42,0
25652,2788,1000.00,1922.13,2922.13,762.33,0.00,0.31,1
25653,2788,-1000.00,922.13,1922.13,1461.06,1461.06,0.09,0
25654,2788,1000.00,1922.13,2922.13,661.00,639.42,0.32,1
25655,2788,1000.00,2922.13,3922.13,1040.51,0.00,0.17,1
25656,2788,-1000.00,1922.13,2922.13,1677.99,2244.14,0.09,0
25657,2788,-1000.00,922.13,1922.13,1461.06,1461.06,0.02,0
25658,2788,-1000.00,-77.87,922.13,474.95,1447.18,0.25,0
25659,2788,-922.13,-1000.00,0.00,116.25,805.87,0.10,0
25660,2788,-0.00,-1000.00,0.00,0.00,0.00,0.36,0
25661,2788,-0.00,-1000.00,0.00,0.00,0.00,0.41,0
25662,2788,0.00,-1000.00,0.00,0.00,0.00,0.08,1
25663,2788,-0.00,-1000.00,0.00,0.00,0.00,0.27,0
25664,2789,-1000.00,-1000.00,0.00,136.33,863.67,0.36,0
25665,2790,1000.00,1000.00,2000.00,360.55,639.45,0.00,1
25666,2790,1000.00,2000.00,3000.00,31.28,783.42,0.26,1
25667,2790,-1000.00,1000.00,2000.00,3000.00,0.00,0.00,0
25668,2790,1000.00,2000.00,3000.00,0.00,2000.00,0.07,1
25669,2790,1000.00,3000.00,4000.00,0.00,3000.00,0.15,1
25670,2790,1000.00,4000.00,5000.00,1465.27,2534.73,0.35,1
25671,2790,1000.00,5000.00,6000.00,0.00,4707.33,0.42,1
25672,2790,1000.00,6000.00,7000.00,2768.01,3231.99,0.24,1
25673,2790,1000.00,7000.00,8000.00,0.00,7000.00,0.23,1
25674,2790,1000.00,8000.00,9000.00,0.00,8000.00,0.12,1
25675,2790,1000.00,9000.00,10000.00,0.00,9000.00,0.06,1
25676,2790,1000.00,10000.00,11000.00,0.00,10000.00,0.18,1
25677,2790,-1000.00,9000.00,10000.00,6628.97,4371.03,0.16,0
25678,2790,1000.00,10000.00,11000.00,144.09,9855.91,0.12,1
25679,2790,1000.00,11000.00,12000.00,3723.85,7276.15,0.35,1
25680,2790,1000.00,12000.00,13000.00,0.00,10762.11,0.30,1
25681,2790,-1000.00,11000.00,12000.00,7657.80,5342.20,0.36,0
25682,2790,1000.00,12000.00,13000.00,0.00,12000.00,0.29,1
25683,2790,1000.00,13000.00,14000.00,6500.00,6500.00,0.20,1
25684,2790,-1000.00,12000.00,13000.00,5923.53,8076.47,0.30,0
25685,2790,-1000.00,11000.00,12000.00,80.94,12288.79,0.44,0
25686,2790,-1000.00,10000.00,11000.00,0.00,12000.00,0.23,0
25687,2790,-1000.00,9000.00,10000.00,1964.05,5710.48,0.31,0
25688,2790,-1000.00,8000.00,9000.00,2485.43,7514.57,0.31,0
25689,2790,-1000.00,7000.00,8000.00,4850.16,4149.84,0.12,0
25690,2790,-1000.00,6000.00,7000.00,2672.10,5327.90,0.29,0
25691,2790,-153.39,5846.61,6846.61,0.00,153.39,0.10,0
25692,2790,-1000.00,4846.61,5846.61,2212.36,4634.25,0.33,0
25693,2790,-1000.00,3846.61,4846.61,0.00,2106.14,0.25,0
25694,2790,-1000.00,2846.61,3846.61,0.00,4685.71,0.24,0
25695,2790,-1000.00,1846.61,2846.61,1741.14,2105.47,0.25,0
25696,2790,-1000.00,846.61,1846.61,241.27,2605.34,0.42,0
25697,2790,-824.19,22.42,1022.42,0.00,824.19,0.10,0
25698,2790,-543.35,-520.93,479.07,0.00,543.35,0.32,0
25699,2790,-404.28,-925.21,74.79,63.57,340.71,0.38,0
25700,2790,-74.79,-1000.00,0.00,0.00,74.79,0.29,0
25701,2791,-936.20,-936.20,63.80,0.00,936.20,0.14,0
25702,2791,-63.80,-1000.00,0.00,0.00,63.80,0.31,0
25703,2792,-390.80,-390.80,609.20,0.00,390.80,0.23,0
25704,2792,-12.82,-403.62,596.38,0.00,12.82,0.12,0
25705,2792,-596.38,-1000.00,0.00,140.90,455.48,0.07,0
25706,2793,-1000.00,-1000.00,0.00,0.00,1000.00,0.37,0
25707,2794,-220.29,-220.29,779.71,0.00,220.29,0.23,0
25708,2794,-256.56,-476.85,523.15,0.00,256.56,0.23,0
25709,2794,1000.00,523.15,1523.15,304.37,218.79,0.12,1
25710,2794,-1000.00,-476.85,523.15,680.87,842.28,0.19,0
25711,2794,1000.00,523.15,1523.15,300.45,222.70,0.10,1
25712,2794,-1000.00,-476.85,523.15,0.00,1523.15,0.03,0
25713,2794,1000.00,523.15,1523.15,123.89,0.00,0.01,1
25714,2794,-1000.00,-476.85,523.15,329.74,1193.42,0.34,0
25715,2794,-523.15,-1000.00,0.00,0.00,523.15,0.31,0
25716,2795,0.00,0.00,1000.00,0.00,0.00,0.01,0
25717,2795,-1000.00,-1000.00,0.00,0.00,1000.00,0.12,0
25718,2796,1000.00,1000.00,2000.00,0.00,902.70,0.36,1
25719,2796,1000.00,2000.00,3000.00,0.00,380.47,0.18,1
25720,2796,1000.00,3000.00,4000.00,0.00,1123.74,0.12,1
25721,2796,1000.00,4000.00,5000.00,57.86,2070.25,0.32,1
25722,2796,1000.00,5000.00,6000.00,0.00,5000.00,0.10,1
25723,2796,1000.00,6000.00,7000.00,2030.32,3969.68,0.25,1
25724,2796,1000.00,7000.00,8000.00,2582.86,4417.14,0.26,1
25725,2796,1000.00,8000.00,9000.00,0.00,5975.46,0.24,1
25726,2796,1000.00,9000.00,10000.00,0.00,4617.80,0.20,1
25727,2796,1000.00,10000.00,11000.00,207.82,9792.18,0.44,1
25728,2796,-1000.00,9000.00,10000.00,1252.66,0.00,0.06,0
25729,2796,1000.00,10000.00,11000.00,0.00,4768.03,0.20,1
25730,2796,1000.00,11000.00,12000.00,0.00,11000.00,0.26,1
25731,2796,1000.00,12000.00,13000.00,3736.62,8263.38,0.26,1
25732,2796,1000.00,13000.00,14000.00,0.00,13000.00,0.02,1
25733,2796,1000.00,14000.00,15000.00,0.00,8368.93,0.31,1
25734,2796,-1000.00,13000.00,14000.00,7979.34,7020.66,0.12,0
25735,2796,1000.00,14000.00,15000.00,3822.96,10177.04,0.23,1
25736,2796,-1000.00,13000.00,14000.00,3008.72,1052.14,0.13,0
25737,2796,1000.00,14000.00,15000.00,3929.52,10070.48,0.05,1
25738,2796,-1000.00,13000.00,14000.00,8329.64,6670.36,0.19,0
25739,2796,-1000.00,12000.00,13000.00,11305.41,0.00,0.03,0
25740,2796,-1000.00,11000.00,12000.00,6500.00,6500.00,0.16,0
25741,2796,-1000.00,10000.00,11000.00,2789.82,9210.18,0.39,0
25742,2796,-1000.00,9000.00,10000.00,3039.31,7960.69,0.12,0
25743,2796,-1000.00,8000.00,9000.00,3081.91,6918.09,0.16,0
25744,2796,-1000.00,7000.00,8000.00,0.00,9000.00,0.07,0
25745,2796,-1000.00,6000.00,7000.00,2046.05,4907.11,0.33,0
25746,2796,-1000.00,5000.00,6000.00,0.00,6168.62,0.41,0
25747,2796,-1000.00,4000.00,5000.00,2880.33,3119.67,0.09,0
25748,2796,-1000.00,3000.00,4000.00,542.57,0.00,0.00,0
25749,2796,-1000.00,2000.00,3000.00,0.00,4000.00,0.18,0
25750,2796,0.00,2000.00,3000.00,0.00,0.00,0.04,0
25751,2796,-1000.00,1000.00,2000.00,1621.39,1378.61,0.14,0
25752,2796,-1000.00,0.00,1000.00,1263.04,457.97,0.19,0
25753,2796,-1000.00,-1000.00,0.00,530.55,469.45,0.06,0
25754,2797,1000.00,1000.00,2000.00,0.00,288.97,0.16,1
25755,2797,1000.00,2000.00,3000.00,0.00,2000.00,0.29,1
25756,2797,-1000.00,1000.00,2000.00,1825.50,1174.50,0.03,0
25757,2797,1000.00,2000.00,3000.00,0.00,2000.00,0.27,1
25758,2797,1000.00,3000.00,4000.00,453.60,2546.40,0.42,1
25759,2797,1000.00,4000.00,5000.00,0.00,4000.00,0.21,1
25760,2797,1000.00,5000.00,6000.00,2457.57,2542.43,0.10,1
25761,2797,1000.00,6000.00,7000.00,712.83,5287.17,0.26,1
25762,2797,-1000.00,5000.00,6000.00,3974.40,3025.60,0.18,0
25763,2797,1000.00,6000.00,7000.00,933.59,5066.41,0.21,1
25764,2797,-1000.00,5000.00,6000.00,3927.28,3072.72,0.38,0
25765,2797,1000.00,6000.00,7000.00,0.00,3244.14,0.30,1
25766,2797,1000.00,7000.00,8000.00,678.84,6321.16,0.41,1
25767,2797,-1000.00,6000.00,7000.00,2923.66,0.00,0.03,0
25768,2797,1000.00,7000.00,8000.00,0.00,5139.66,0.36,1
25769,2797,1000.00,8000.00,9000.00,0.00,8000.00,0.25,1
25770,2797,1000.00,9000.00,10000.00,0.00,3364.11,0.19,1
25771,2797,1000.00,10000.00,11000.00,0.00,3995.04,0.25,1
25772,2797,1000.00,11000.00,12000.00,0.00,11000.00,0.03,1
25773,2797,1000.00,12000.00,13000.00,6000.00,6000.00,0.10,1
25774,2797,1000.00,13000.00,14000.00,0.00,3423.20,0.20,1
25775,2797,-1000.00,12000.00,13000.00,7000.00,7000.00,0.39,0
25776,2797,-1000.00,11000.00,12000.00,1026.02,11973.98,0.18,0
25777,2797,-1000.00,10000.00,11000.00,6000.00,6000.00,0.00,0
25778,2797,-1000.00,9000.00,10000.00,2666.91,8333.09,0.23,0
25779,2797,-1000.00,8000.00,9000.00,754.86,9245.14,0.25,0
25780,2797,-1000.00,7000.00,8000.00,0.00,7062.35,0.40,0
25781,2797,-1000.00,6000.00,7000.00,0.00,8000.00,0.24,0
25782,2797,-1000.00,5000.00,6000.00,2993.87,55.12,0.09,0
25783,2797,-1000.00,4000.00,5000.00,0.00,5789.33,0.13,0
25784,2797,-1000.00,3000.00,4000.00,2228.62,2771.38,0.26,0
25785,2797,-1000.00,2000.00,3000.00,2000.00,2000.00,0.03,0
25786,2797,0.00,2000.00,3000.00,0.00,0.00,0.09,0
25787,2797,-1000.00,1000.00,2000.00,0.00,3000.00,0.12,0
25788,2797,-1000.00,0.00,1000.00,201.23,1798.77,0.41,0
25789,2797,-1000.00,-1000.00,0.00,0.00,1000.00,0.23,0
25790,2798,-1000.00,-1000.00,0.00,0.00,1000.00,0.24,0
25791,2799,1000.00,1000.00,2000.00,504.72,495.28,0.18,1
25792,2799,1000.00,2000.00,3000.00,1189.07,810.93,0.02,1
25793,2799,-1000.00,1000.00,2000.00,0.00,2837.43,0.38,0
25794,2799,-1000.00,0.00,1000.00,669.86,1330.14,0.27,0
25795,2799,-165.18,-165.18,834.82,0.00,165.18,0.12,0
25796,2799,-834.82,-1000.00,0.00,180.22,654.61,0.41,0
25797,2800,-1000.00,-1000.00,0.00,0.00,1000.00,0.09,0
25798,2801,1000.00,1000.00,2000.00,500.00,500.00,0.02,1
25799,2801,-1000.00,0.00,1000.00,722.55,333.38,0.14,0
25800,2801,1000.00,1000.00,2000.00,304.49,695.51,0.34,1
25801,2801,1000.00,2000.00,3000.00,0.00,961.08,0.19,1
25802,2801,1000.00,3000.00,4000.00,1460.71,1539.29,0.13,1
25803,2801,-1000.00,2000.00,3000.00,3671.68,0.00,0.03,0
25804,2801,1000.00,3000.00,4000.00,476.75,2523.25,0.42,1
25805,2801,1000.00,4000.00,5000.00,453.90,3546.10,0.14,1
25806,2801,1000.00,5000.00,6000.00,0.00,3868.40,0.41,1
25807,2801,1000.00,6000.00,7000.00,0.00,6000.00,0.03,1
25808,2801,-1000.00,5000.00,6000.00,1413.67,0.00,0.06,0
25809,2801,-1000.00,4000.00,5000.00,4386.38,1380.64,0.09,0
25810,2801,1000.00,5000.00,6000.00,670.16,2996.16,0.35,1
25811,2801,1000.00,6000.00,7000.00,0.00,6000.00,0.22,1
25812,2801,1000.00,7000.00,8000.00,0.00,7000.00,0.02,1
25813,2801,1000.00,8000.00,9000.00,583.78,7416.22,0.20,1
25814,2801,-1000.00,7000.00,8000.00,5587.16,2183.71,0.20,0
25815,2801,1000.00,8000.00,9000.00,1977.38,6022.62,0.33,1
25816,2801,1000.00,9000.00,10000.00,0.00,9000.00,0.44,1
25817,2801,-1000.00,8000.00,9000.00,10000.00,0.00,0.00,0
25818,2801,-1000.00,7000.00,8000.00,5777.19,0.00,0.05,0
25819,2801,1000.00,8000.00,9000.00,0.00,8000.00,0.21,1
25820,2801,1000.00,9000.00,10000.00,4012.77,4987.23,0.11,1
25821,2801,1000.00,10000.00,11000.00,2554.11,7445.89,0.38,1
25822,2801,-1000.00,9000.00,10000.00,5500.00,5500.00,0.22,0
25823,2801,-1000.00,8000.00,9000.00,4169.36,5830.64,0.13,0
25824,2801,-1000.00,7000.00,8000.00,0.00,8839.56,0.02,0
25825,2801,-1000.00,6000.00,7000.00,3439.69,3910.54,0.24,0
25826,2801,-1000.00,5000.00,6000.00,1613.03,5386.97,0.34,0
25827,2801,-1000.00,4000.00,5000.00,0.00,5655.24,0.42,0
25828,2801,-1000.00,3000.00,4000.00,2883.02,0.00,0.04,0
25829,2801,-1000.00,2000.00,3000.00,0.00,1843.18,0.20,0
25830,2801,-1000.00,1000.00,2000.00,0.00,2331.32,0.41,0
25831,2801,-1000.00,0.00,1000.00,466.17,151.60,0.13,0
25832,2801,-1000.00,-1000.00,0.00,329.45,670.55,0.16,0
25833,2802,1000.00,1000.00,2000.00,468.06,531.94,0.18,1
25834,2802,-1000.00,0.00,1000.00,1222.47,777.53,0.12,0
25835,2802,1000.00,1000.00,2000.00,0.00,1000.00,0.34,1
25836,2802,1000.00,2000.00,3000.00,1000.00,1000.00,0.01,1
25837,2802,-1000.00,1000.00,2000.00,704.76,2295.24,0.29,0
25838,2802,-1000.00,0.00,1000.00,1000.00,1000.00,0.03,0
25839,2802,-1000.00,-1000.00,0.00,0.00,609.14,0.22,0
25840,2803,-1000.00,-1000.00,0.00,314.20,685.80,0.16,0
25841,2804,1000.00,1000.00,2000.00,81.10,594.04,0.35,1
25842,2804,-1000.00,0.00,1000.00,713.79,1225.50,0.30,0
25843,2804,-1000.00,-1000.00,0.00,0.00,1000.00,0.15,0
25844,2805,-1000.00,-1000.00,0.00,0.00,1000.00,0.33,0
25845,2806,-575.22,-575.22,424.78,142.65,432.58,0.43,0
25846,2806,-424.78,-1000.00,0.00,0.00,424.78,0.15,0
25847,2807,1000.00,1000.00,2000.00,0.00,852.03,0.41,1
25848,2807,1000.00,2000.00,3000.00,0.00,2000.00,0.09,1
25849,2807,1000.00,3000.00,4000.00,0.00,3000.00,0.31,1
25850,2807,1000.00,4000.00,5000.00,904.73,3020.60,0.38,1
25851,2807,1000.00,5000.00,6000.00,867.27,4132.73,0.41,1
25852,2807,1000.00,6000.00,7000.00,825.59,5174.41,0.42,1
25853,2807,1000.00,7000.00,8000.00,1723.06,5276.94,0.20,1
25854,2807,1000.00,8000.00,9000.00,767.42,7232.58,0.43,1
25855,2807,1000.00,9000.00,10000.00,0.00,5877.13,0.09,1
25856,2807,1000.00,10000.00,11000.00,3834.37,6165.63,0.25,1
25857,2807,1000.00,11000.00,12000.00,0.00,8897.29,0.34,1
25858,2807,1000.00,12000.00,13000.00,5681.03,6318.97,0.06,1
25859,2807,1000.00,13000.00,14000.00,0.00,13000.00,0.36,1
25860,2807,1000.00,14000.00,15000.00,0.00,14000.00,0.35,1
25861,2807,1000.00,15000.00,16000.00,0.00,15000.00,0.19,1
25862,2807,1000.00,16000.00,17000.00,0.00,16000.00,0.04,1
25863,2807,1000.00,17000.00,18000.00,0.00,17000.00,0.25,1
25864,2807,1000.00,18000.00,19000.00,0.00,18000.00,0.17,1
25865,2807,1000.00,19000.00,20000.00,0.00,19000.00,0.05,1
25866,2807,1000.00,20000.00,21000.00,8523.45,11476.55,0.34,1
25867,2807,1000.00,21000.00,22000.00,5684.25,15315.75,0.12,1
25868,2807,-1000.00,20000.00,21000.00,15647.00,6353.00,0.24,0
25869,2807,1000.00,21000.00,22000.00,0.00,21000.00,0.43,1
25870,2807,1000.00,22000.00,23000.00,2213.39,19786.61,0.24,1
25871,2807,-1000.00,21000.00,22000.00,5493.96,17173.40,0.37,0
25872,2807,-1000.00,20000.00,21000.00,0.00,22000.00,0.43,0
25873,2807,-1000.00,19000.00,20000.00,0.00,13292.08,0.34,0
25874,2807,-1000.00,18000.00,19000.00,609.35,19390.65,0.21,0
25875,2807,-1000.00,17000.00,18000.00,0.00,19000.00,0.42,0
25876,2807,-1000.00,16000.00,17000.00,0.00,11059.66,0.16,0
25877,2807,-1000.00,15000.00,16000.00,8500.00,8500.00,0.04,0
25878,2807,-1000.00,14000.00,15000.00,0.00,16000.00,0.20,0
25879,2807,-1000.00,13000.00,14000.00,0.00,15000.00,0.37,0
25880,2807,-1000.00,12000.00,13000.00,0.00,6517.21,0.21,0
25881,2807,-1000.00,11000.00,12000.00,0.00,13000.00,0.04,0
25882,2807,-1000.00,10000.00,11000.00,7885.03,2181.51,0.10,0
25883,2807,-1000.00,9000.00,10000.00,5510.60,5489.40,0.19,0
25884,2807,-511.71,8488.29,9488.29,0.00,511.71,0.08,0
25885,2807,-1000.00,7488.29,8488.29,0.00,5164.81,0.28,0
25886,2807,-1000.00,6488.29,7488.29,0.00,4759.33,0.31,0
25887,2807,-1000.00,5488.29,6488.29,3744.14,3744.14,0.18,0
25888,2807,-1000.00,4488.29,5488.29,0.00,2271.13,0.24,0
25889,2807,-1000.00,3488.29,4488.29,703.97,4784.32,0.40,0
25890,2807,-1000.00,2488.29,3488.29,2088.51,2282.83,0.24,0
25891,2807,-1000.00,1488.29,2488.29,433.84,3054.44,0.43,0
25892,2808,-1000.00,-1000.00,0.00,0.00,1000.00,0.09,0
25893,2809,-1000.00,-1000.00,0.00,615.77,0.00,0.10,0
25894,2810,1000.00,1000.00,2000.00,197.84,802.16,0.31,1
25895,2810,1000.00,2000.00,3000.00,898.46,1101.54,0.18,1
25896,2810,-1000.00,1000.00,2000.00,1196.94,375.32,0.13,0
25897,2810,1000.00,2000.00,3000.00,981.72,1018.28,0.16,1
25898,2810,1000.00,3000.00,4000.00,0.00,2052.12,0.23,1
25899,2810,1000.00,4000.00,5000.00,0.00,4000.00,0.09,1
25900,2810,1000.00,5000.00,6000.00,0.00,5000.00,0.12,1
25901,2810,1000.00,6000.00,7000.00,0.00,6000.00,0.04,1
25902,2810,1000.00,7000.00,8000.00,0.00,3915.49,0.08,1
25903,2810,-1000.00,6000.00,7000.00,5301.37,2698.63,0.05,0
25904,2810,1000.00,7000.00,8000.00,1569.80,3218.30,0.25,1
25905,2810,1000.00,8000.00,9000.00,558.61,7441.39,0.44,1
25906,2810,1000.00,9000.00,10000.00,0.00,9000.00,0.07,1
25907,2810,1000.00,10000.00,11000.00,4919.24,5080.76,0.18,1
25908,2810,1000.00,11000.00,12000.00,2959.21,8040.79,0.36,1
25909,2810,1000.00,12000.00,13000.00,4318.45,7681.55,0.13,1
25910,2810,1000.00,13000.00,14000.00,3561.79,9438.21,0.38,1
25911,2810,1000.00,14000.00,15000.00,0.00,9328.93,0.26,1
25912,2810,-1000.00,13000.00,14000.00,9909.01,5090.99,0.27,0
25913,2810,-1000.00,12000.00,13000.00,6078.16,7921.84,0.17,0
25914,2810,-1000.00,11000.00,12000.00,0.00,12627.26,0.38,0
25915,2810,-1000.00,10000.00,11000.00,675.99,10080.71,0.43,0
25916,2810,-1000.00,9000.00,10000.00,6804.59,4195.41,0.14,0
25917,2810,-1000.00,8000.00,9000.00,590.68,9409.32,0.13,0
25918,2810,-1000.00,7000.00,8000.00,718.27,8281.73,0.27,0
25919,2810,-1000.00,6000.00,7000.00,0.00,8000.00,0.25,0
25920,2810,-1000.00,5000.00,6000.00,0.00,7000.00,0.33,0
25921,2810,-1000.00,4000.00,5000.00,2005.05,3994.95,0.32,0
25922,2810,-866.65,3133.35,4133.35,0.00,866.65,0.07,0
25923,2810,-1000.00,2133.35,3133.35,0.00,4133.35,0.06,0
25924,2810,-1000.00,1133.35,2133.35,256.78,2876.57,0.44,0
25925,2810,-1000.00,133.35,1133.35,0.00,2133.35,0.33,0
25926,2810,-669.75,-536.40,463.60,0.00,669.75,0.23,0
25927,2810,-463.60,-1000.00,0.00,223.57,240.03,0.04,0
25928,2811,-1000.00,-1000.00,0.00,0.00,1000.00,0.25,0
25929,2812,-146.74,-146.74,853.26,0.00,146.74,0.16,0
25930,2812,-853.26,-1000.00,0.00,0.00,853.26,0.38,0
25931,2813,-1000.00,-1000.00,0.00,557.32,442.68,0.07,0
25932,2814,-1000.00,-1000.00,0.00,0.00,1000.00,0.15,0
25933,2815,-1000.00,-1000.00,0.00,317.63,682.37,0.34,0
25934,2816,1000.00,1000.00,2000.00,500.00,500.00,0.09,1
25935,2816,1000.00,2000.00,3000.00,852.53,1147.47,0.07,1
25936,2816,1000.00,3000.00,4000.00,1301.85,1698.15,0.09,1
25937,2816,1000.00,4000.00,5000.00,0.00,4000.00,0.16,1
25938,2816,1000.00,5000.00,6000.00,757.88,4242.12,0.32,1
25939,2816,1000.00,6000.00,7000.00,0.00,5216.39,0.26,1
25940,2816,1000.00,7000.00,8000.00,2439.23,2537.28,0.22,1
25941,2816,1000.00,8000.00,9000.00,1411.32,6588.68,0.41,1
25942,2816,1000.00,9000.00,10000.00,0.00,4714.07,0.32,1
25943,2816,0.00,9000.00,10000.00,0.00,0.00,0.03,0
25944,2816,-1000.00,8000.00,9000.00,7083.10,2916.90,0.11,0
25945,2816,1000.00,9000.00,10000.00,1762.40,7237.60,0.34,1
25946,2816,1000.00,10000.00,11000.00,0.00,8730.18,0.26,1
25947,2816,1000.00,11000.00,12000.00,1087.45,9912.55,0.01,1
25948,2816,1000.00,12000.00,13000.00,0.00,11939.95,0.38,1
25949,2816,1000.00,13000.00,14000.00,0.00,13000.00,0.42,1
25950,2816,1000.00,14000.00,15000.00,0.00,14000.00,0.13,1
25951,2816,1000.00,15000.00,16000.00,5171.18,9828.82,0.32,1
25952,2816,1000.00,16000.00,17000.00,0.00,15148.92,0.20,1
25953,2816,1000.00,17000.00,18000.00,5265.38,11734.62,0.15,1
25954,2816,1000.00,18000.00,19000.00,0.00,11144.44,0.09,1
25955,2816,1000.00,19000.00,20000.00,0.00,19000.00,0.23,1
25956,2816,1000.00,20000.00,21000.00,0.00,20000.00,0.19,1
25957,2816,1000.00,21000.00,22000.00,0.00,21000.00,0.20,1
25958,2816,-1000.00,20000.00,21000.00,12606.00,9394.00,0.30,0
25959,2816,1000.00,21000.00,22000.00,0.00,19639.65,0.43,1
25960,2816,1000.00,22000.00,23000.00,0.00,22000.00,0.21,1
25961,2816,-1000.00,21000.00,22000.00,13282.84,9717.16,0.22,0
25962,2816,1000.00,22000.00,23000.00,0.00,8114.75,0.25,1
25963,2816,1000.00,23000.00,24000.00,0.00,23000.00,0.28,1
25964,2816,-1000.00,22000.00,23000.00,12796.69,11203.31,0.07,0
25965,2816,1000.00,23000.00,24000.00,0.00,15005.98,0.11,1
25966,2816,1000.00,24000.00,25000.00,0.00,13292.92,0.28,1
25967,2816,1000.00,25000.00,26000.00,9006.50,15993.50,0.24,1
25968,2816,1000.00,26000.00,27000.00,0.00,20898.50,0.38,1
25969,2816,1000.00,27000.00,28000.00,0.00,27000.00,0.43,1
25970,2816,1000.00,28000.00,29000.00,0.00,28000.00,0.01,1
25971,2816,1000.00,29000.00,30000.00,13312.95,15687.05,0.25,1
25972,2816,1000.00,30000.00,31000.00,15000.00,15000.00,0.13,1
25973,2816,1000.00,31000.00,32000.00,0.00,31000.00,0.13,1
25974,2816,1000.00,32000.00,33000.00,0.00,22827.90,0.27,1
25975,2816,-1000.00,31000.00,32000.00,20539.09,12460.91,0.35,0
25976,2816,1000.00,32000.00,33000.00,10915.05,21084.95,0.25,1
25977,2816,-1000.00,31000.00,32000.00,18591.81,14408.19,0.26,0
25978,2816,1000.00,32000.00,33000.00,9941.95,22058.05,0.32,1
25979,2816,1000.00,33000.00,34000.00,0.00,30660.66,0.16,1
25980,2816,1000.00,34000.00,35000.00,0.00,34000.00,0.07,1
25981,2816,-1000.00,33000.00,34000.00,15531.61,19468.39,0.32,0
25982,2816,-1000.00,32000.00,33000.00,0.00,27758.28,0.33,0
25983,2816,-1000.00,31000.00,32000.00,0.00,25102.45,0.27,0
25984,2816,-1000.00,30000.00,31000.00,217.50,31782.50,0.01,0
25985,2816,-1000.00,29000.00,30000.00,25552.92,1446.81,0.12,0
25986,2816,-1000.00,28000.00,29000.00,0.00,30000.00,0.09,0
25987,2816,-1000.00,27000.00,28000.00,0.00,29000.00,0.22,0
25988,2816,-1000.00,26000.00,27000.00,0.00,17974.64,0.24,0
25989,2816,-1000.00,25000.00,26000.00,6567.24,20432.76,0.37,0
25990,2816,-1000.00,24000.00,25000.00,3012.73,22987.27,0.41,0
25991,2816,-1000.00,23000.00,24000.00,6640.93,18359.07,0.38,0
25992,2816,-1000.00,22000.00,23000.00,0.00,24000.00,0.36,0
25993,2816,-1000.00,21000.00,22000.00,10305.70,12694.30,0.25,0
25994,2816,-1000.00,20000.00,21000.00,8473.34,13526.66,0.26,0
25995,2816,-1000.00,19000.00,20000.00,65.74,20934.26,0.03,0
25996,2816,-1000.00,18000.00,19000.00,8354.61,11645.39,0.17,0
25997,2816,-1000.00,17000.00,18000.00,0.00,19000.00,0.43,0
25998,2816,-1000.00,16000.00,17000.00,725.75,7481.95,0.28,0
25999,2816,-1000.00,15000.00,16000.00,0.00,11460.49,0.36,0
26000,2816,-1000.00,14000.00,15000.00,0.00,16000.00,0.13,0
26001,2816,-1000.00,13000.00,14000.00,5487.60,9512.40,0.31,0
26002,2817,1000.00,1000.00,2000.00,0.00,1000.00,0.42,1
26003,2817,1000.00,2000.00,3000.00,384.69,1615.31,0.13,1
26004,2817,1000.00,3000.00,4000.00,0.00,3000.00,0.22,1
26005,2817,1000.00,4000.00,5000.00,1884.61,2115.39,0.22,1
26006,2817,1000.00,5000.00,6000.00,0.00,3319.21,0.06,1
26007,2817,1000.00,6000.00,7000.00,0.00,6000.00,0.07,1
26008,2817,-1000.00,5000.00,6000.00,2831.07,1276.22,0.14,0
26009,2817,-1000.00,4000.00,5000.00,3817.51,2182.49,0.01,0
26010,2817,1000.00,5000.00,6000.00,0.00,2937.24,0.33,1
26011,2817,1000.00,6000.00,7000.00,486.36,5513.64,0.09,1
26012,2817,1000.00,7000.00,8000.00,392.37,6607.63,0.09,1
26013,2817,1000.00,8000.00,9000.00,2284.26,5715.74,0.35,1
26014,2817,1000.00,9000.00,10000.00,2595.82,6404.18,0.36,1
26015,2817,-957.50,8042.50,9042.50,845.25,112.25,0.12,0
26016,2817,1000.00,9042.50,10042.50,0.00,9042.50,0.15,1
26017,2817,1000.00,10042.50,11042.50,1944.94,5963.79,0.34,1
26018,2817,1000.00,11042.50,12042.50,4838.13,6204.37,0.24,1
26019,2817,1000.00,12042.50,13042.50,0.00,9905.14,0.31,1
26020,2817,1000.00,13042.50,14042.50,0.00,13042.50,0.12,1
26021,2817,-1000.00,12042.50,13042.50,10467.08,0.00,0.06,0
26022,2817,1000.00,13042.50,14042.50,2923.75,10118.75,0.28,1
26023,2817,1000.00,14042.50,15042.50,0.00,14042.50,0.35,1
26024,2817,1000.00,15042.50,16042.50,0.00,8820.81,0.35,1
26025,2817,1000.00,16042.50,17042.50,0.00,16042.50,0.07,1
26026,2817,1000.00,17042.50,18042.50,8484.21,8558.29,0.38,1
26027,2817,0.00,17042.50,18042.50,0.00,0.00,0.01,0
26028,2817,1000.00,18042.50,19042.50,6958.45,11084.05,0.24,1
26029,2817,1000.00,19042.50,20042.50,2536.11,16506.40,0.10,1
26030,2817,1000.00,20042.50,21042.50,0.00,16499.01,0.12,1
26031,2817,1000.00,21042.50,22042.50,0.00,21042.50,0.43,1
26032,2817,1000.00,22042.50,23042.50,0.00,12792.09,0.05,1
26033,2817,1000.00,23042.50,24042.50,0.00,23042.50,0.05,1
26034,2817,1000.00,24042.50,25042.50,7367.90,16674.60,0.36,1
26035,2817,1000.00,25042.50,26042.50,0.00,25042.50,0.42,1
26036,2817,1000.00,26042.50,27042.50,8171.00,17871.50,0.03,1
26037,2817,1000.00,27042.50,28042.50,0.00,27042.50,0.27,1
26038,2817,-1000.00,26042.50,27042.50,14670.69,13371.81,0.16,0
26039,2818,-627.55,-627.55,372.45,0.00,627.55,0.28,0
26040,2818,-372.45,-1000.00,-0.00,93.35,279.10,0.06,0
26041,2819,-1000.00,-1000.00,0.00,0.00,1000.00,0.17,0
26042,2820,-1000.00,-1000.00,0.00,318.25,681.75,0.28,0
26043,2821,1000.00,1000.00,2000.00,384.94,615.06,0.29,1
26044,2821,1000.00,2000.00,3000.00,0.00,2000.00,0.41,1
26045,2821,0.00,2000.00,3000.00,0.00,0.00,0.04,0
26046,2821,1000.00,3000.00,4000.00,1130.21,1869.79,0.30,1
26047,2821,1000.00,4000.00,5000.00,1862.63,2137.37,0.08,1
26048,2821,1000.00,5000.00,6000.00,2022.15,2977.85,0.10,1
26049,2821,1000.00,6000.00,7000.00,705.31,5294.69,0.27,1
26050,2821,1000.00,7000.00,8000.00,0.00,7000.00,0.05,1
26051,2821,1000.00,8000.00,9000.00,0.00,5649.42,0.28,1
26052,2821,1000.00,9000.00,10000.00,0.00,2727.04,0.16,1
26053,2821,1000.00,10000.00,11000.00,2802.63,4150.40,0.25,1
26054,2821,1000.00,11000.00,12000.00,0.00,11000.00,0.19,1
26055,2821,1000.00,12000.00,13000.00,0.00,10947.01,0.31,1
26056,2821,1000.00,13000.00,14000.00,2108.37,10891.63,0.36,1
26057,2821,-1000.00,12000.00,13000.00,10443.60,0.00,0.05,0
26058,2821,1000.00,13000.00,14000.00,6440.57,6559.43,0.28,1
26059,2821,1000.00,14000.00,15000.00,0.00,11068.01,0.07,1
26060,2821,1000.00,15000.00,16000.00,0.00,15000.00,0.44,1
26061,2821,1000.00,16000.00,17000.00,2452.77,13547.23,0.27,1
26062,2821,1000.00,17000.00,18000.00,7253.60,9746.40,0.23,1
26063,2821,1000.00,18000.00,19000.00,6568.65,8365.01,0.29,1
26064,2821,-1000.00,17000.00,18000.00,16302.28,2697.72,0.16,0
26065,2821,1000.00,18000.00,19000.00,0.00,18000.00,0.12,1
26066,2821,1000.00,19000.00,20000.00,9500.00,9500.00,0.02,1
26067,2821,1000.00,20000.00,21000.00,10000.00,10000.00,0.35,1
26068,2821,1000.00,21000.00,22000.00,0.00,21000.00,0.06,1
26069,2821,1000.00,22000.00,23000.00,0.00,22000.00,0.08,1
26070,2821,1000.00,23000.00,24000.00,1177.26,21822.74,0.44,1
26071,2821,1000.00,24000.00,25000.00,12000.00,12000.00,0.19,1
26072,2821,1000.00,25000.00,26000.00,9398.65,15601.35,0.25,1
26073,2821,1000.00,26000.00,27000.00,0.00,26000.00,0.16,1
26074,2821,1000.00,27000.00,28000.00,0.00,11781.78,0.00,1
26075,2821,0.00,27000.00,28000.00,0.00,0.00,0.06,0
26076,2821,1000.00,28000.00,29000.00,0.00,5494.67,0.04,1
26077,2821,1000.00,29000.00,30000.00,0.00,29000.00,0.18,1
26078,2821,1000.00,30000.00,31000.00,0.00,3427.54,0.03,1
26079,2821,1000.00,31000.00,32000.00,0.00,23527.73,0.05,1
26080,2821,1000.00,32000.00,33000.00,0.00,32000.00,0.02,1
26081,2821,1000.00,33000.00,34000.00,0.00,33000.00,0.06,1
26082,2822,-1000.00,-1000.00,0.00,0.00,1000.00,0.08,0
26083,2823,-777.33,-777.33,222.67,171.73,605.60,0.40,0
26084,2823,0.00,-777.33,222.67,0.00,0.00,0.12,0
26085,2823,-222.67,-1000.00,0.00,109.08,113.59,0.20,0
26086,2824,1000.00,1000.00,2000.00,96.04,903.96,0.43,1
26087,2824,1000.00,2000.00,3000.00,0.00,995.17,0.28,1
26088,2824,1000.00,3000.00,4000.00,0.00,1602.59,0.28,1
26089,2824,1000.00,4000.00,5000.00,2000.00,2000.00,0.20,1
26090,2824,1000.00,5000.00,6000.00,0.00,5000.00,0.37,1
26091,2824,1000.00,6000.00,7000.00,0.00,3920.69,0.11,1
26092,2824,1000.00,7000.00,8000.00,0.00,7000.00,0.11,1
26093,2824,1000.00,8000.00,9000.00,2138.20,5861.80,0.32,1
26094,2824,1000.00,9000.00,10000.00,4250.92,4749.08,0.00,1
26095,2824,1000.00,10000.00,11000.00,0.00,10000.00,0.11,1
26096,2824,1000.00,11000.00,12000.00,0.00,7803.39,0.39,1
26097,2824,1000.00,12000.00,13000.00,0.00,12000.00,0.20,1
26098,2824,1000.00,13000.00,14000.00,3407.48,9592.52,0.37,1
26099,2824,1000.00,14000.00,15000.00,0.00,14000.00,0.24,1
26100,2824,1000.00,15000.00,16000.00,0.00,15000.00,0.14,1
26101,2824,1000.00,16000.00,17000.00,0.00,16000.00,0.15,1
26102,2824,1000.00,17000.00,18000.00,6402.92,10597.08,0.24,1
26103,2824,1000.00,18000.00,19000.00,5481.49,12518.51,0.35,1
26104,2824,1000.00,19000.00,20000.00,0.00,19000.00,0.29,1
26105,2824,-1000.00,18000.00,19000.00,8123.80,1471.24,0.11,0
26106,2824,1000.00,19000.00,20000.00,3845.76,15154.24,0.39,1
26107,2824,1000.00,20000.00,21000.00,10000.00,10000.00,0.42,1
26108,2824,1000.00,21000.00,22000.00,0.00,1676.89,0.13,1
26109,2824,-1000.00,20000.00,21000.00,11000.00,11000.00,0.08,0
26110,2824,-1000.00,19000.00,20000.00,9321.46,7457.42,0.19,0
26111,2824,-1000.00,18000.00,19000.00,0.00,20000.00,0.00,0
26112,2824,-1000.00,17000.00,18000.00,7495.54,11504.46,0.19,0
26113,2824,-1000.00,16000.00,17000.00,9000.00,9000.00,0.04,0
26114,2824,-1000.00,15000.00,16000.00,6606.50,10393.50,0.18,0
26115,2824,-1000.00,14000.00,15000.00,10481.69,5518.31,0.09,0
26116,2824,-1000.00,13000.00,14000.00,1695.99,0.00,0.03,0
26117,2824,-1000.00,12000.00,13000.00,0.00,7092.47,0.31,0
26118,2824,-1000.00,11000.00,12000.00,8094.50,4905.50,0.33,0
26119,2824,-1000.00,10000.00,11000.00,0.00,3801.47,0.20,0
26120,2824,-1000.00,9000.00,10000.00,1501.35,9498.65,0.43,0
26121,2824,-1000.00,8000.00,9000.00,3693.60,6306.40,0.06,0
26122,2824,-1000.00,7000.00,8000.00,3642.89,5357.11,0.16,0
26123,2824,-1000.00,6000.00,7000.00,2854.98,5145.02,0.24,0
26124,2824,-1000.00,5000.00,6000.00,59.14,6940.86,0.32,0
26125,2824,-1000.00,4000.00,5000.00,0.00,6000.00,0.19,0
26126,2824,-1000.00,3000.00,4000.00,669.77,4330.23,0.20,0
26127,2824,-1000.00,2000.00,3000.00,0.00,3480.24,0.41,0
26128,2824,-1000.00,1000.00,2000.00,0.00,3000.00,0.36,0
26129,2824,-1000.00,0.00,1000.00,0.00,1125.36,0.17,0
26130,2824,-498.88,-498.88,501.12,0.00,498.88,0.03,0
26131,2824,1000.00,501.12,1501.12,147.05,354.06,0.23,1
26132,2824,1000.00,1501.12,2501.12,2.37,1155.36,0.41,1
26133,2824,1000.00,2501.12,3501.12,0.00,1412.04,0.32,1
26134,2824,1000.00,3501.12,4501.12,0.00,3501.12,0.12,1
26135,2824,-1000.00,2501.12,3501.12,161.65,4339.46,0.22,0
26136,2824,-1000.00,1501.12,2501.12,0.00,3501.12,0.29,0
26137,2824,-1000.00,501.12,1501.12,0.00,2501.12,0.01,0
26138,2824,-1000.00,-498.88,501.12,750.56,750.56,0.08,0
26139,2824,-1000.00,-1498.88,-498.88,0.00,181.92,0.21,0
26140,2825,1000.00,1000.00,2000.00,0.00,844.70,0.41,1
26141,2825,1000.00,2000.00,3000.00,994.73,1005.27,0.23,1
26142,2825,1000.00,3000.00,4000.00,0.00,2004.47,0.09,1
26143,2825,1000.00,4000.00,5000.00,0.00,4000.00,0.27,1
26144,2825,1000.00,5000.00,6000.00,1074.23,3925.77,0.19,1
26145,2825,-1000.00,4000.00,5000.00,1724.25,0.00,0.10,0
26146,2825,1000.00,5000.00,6000.00,1156.46,2725.41,0.31,1
26147,2825,-1000.00,4000.00,5000.00,3095.81,2904.19,0.19,0
26148,2825,1000.00,5000.00,6000.00,0.00,511.57,0.13,1
26149,2825,1000.00,6000.00,7000.00,1114.21,4885.79,0.21,1
26150,2825,1000.00,7000.00,8000.00,7.64,6992.36,0.15,1
26151,2825,1000.00,8000.00,9000.00,3435.16,4546.76,0.27,1
26152,2825,-1000.00,7000.00,8000.00,4835.88,1025.79,0.10,0
26153,2825,1000.00,8000.00,9000.00,3376.67,3622.58,0.23,1
26154,2825,1000.00,9000.00,10000.00,4500.00,4500.00,0.30,1
26155,2825,1000.00,10000.00,11000.00,4090.21,5909.79,0.23,1
26156,2825,-1000.00,9000.00,10000.00,6033.71,4966.29,0.08,0
26157,2825,1000.00,10000.00,11000.00,0.00,8412.56,0.43,1
26158,2825,1000.00,11000.00,12000.00,0.00,8757.56,0.29,1
26159,2825,1000.00,12000.00,13000.00,0.00,12000.00,0.27,1
26160,2825,1000.00,13000.00,14000.00,5049.09,7950.91,0.34,1
26161,2825,1000.00,14000.00,15000.00,5836.81,8163.19,0.23,1
26162,2825,1000.00,15000.00,16000.00,0.00,15000.00,0.03,1
26163,2825,1000.00,16000.00,17000.00,5064.75,10935.25,0.31,1
26164,2825,-1000.00,15000.00,16000.00,0.00,10417.13,0.04,0
26165,2825,-1000.00,14000.00,15000.00,1943.77,14056.23,0.43,0
26166,2825,-1000.00,13000.00,14000.00,0.00,2322.14,0.03,0
26167,2825,-1000.00,12000.00,13000.00,6894.81,0.00,0.05,0
26168,2825,-1000.00,11000.00,12000.00,0.00,13000.00,0.00,0
26169,2825,-1000.00,10000.00,11000.00,0.00,12000.00,0.02,0
26170,2825,-1000.00,9000.00,10000.00,1518.31,9481.69,0.42,0
26171,2825,-1000.00,8000.00,9000.00,2159.65,7840.35,0.40,0
26172,2825,-1000.00,7000.00,8000.00,3369.78,5630.22,0.34,0
26173,2825,-1000.00,6000.00,7000.00,4000.00,4000.00,0.07,0
26174,2825,-1000.00,5000.00,6000.00,3589.10,3410.90,0.21,0
26175,2825,-1000.00,4000.00,5000.00,0.00,6000.00,0.28,0
26176,2825,-1000.00,3000.00,4000.00,422.98,4577.02,0.11,0
26177,2825,-1000.00,2000.00,3000.00,1885.58,188.24,0.10,0
26178,2825,-281.67,1718.33,2718.33,0.00,281.67,0.04,0
26179,2825,-1000.00,718.33,1718.33,1212.28,1506.05,0.16,0
26180,2825,1000.00,1718.33,2718.33,1142.91,0.00,0.01,1
26181,2825,-225.64,1492.69,2492.69,0.00,225.64,0.25,0
26182,2825,1000.00,2492.69,3492.69,1374.62,0.00,0.20,1
26183,2826,-1000.00,-1000.00,0.00,42.56,957.44,0.05,0
26184,2827,-992.40,-992.40,7.60,264.93,727.47,0.37,0
26185,2827,-7.30,-999.70,0.30,0.00,7.30,0.44,0
26186,2827,-0.30,-1000.00,0.00,0.00,0.30,0.15,0
26187,2828,-1000.00,-1000.00,0.00,296.28,703.72,0.34,0
26188,2829,-770.43,-770.43,229.57,0.00,770.43,0.14,0
26189,2829,-229.57,-1000.00,0.00,0.00,229.57,0.12,0
26190,2830,-1000.00,-1000.00,0.00,0.00,847.48,0.19,0
26191,2831,-293.08,-293.08,706.92,0.00,293.08,0.20,0
26192,2831,-706.92,-1000.00,0.00,257.31,449.62,0.32,0
26193,2832,-1000.00,-1000.00,0.00,85.21,914.79,0.39,0
26194,2832,-0.00,-1000.00,0.00,0.00,0.00,0.21,0
26195,2832,-0.00,-1000.00,0.00,0.00,0.00,0.44,0
26196,2832,-0.00,-1000.00,0.00,0.00,0.00,0.03,0
26197,2833,-834.57,-834.57,165.43,0.00,834.57,0.29,0
26198,2833,-165.43,-1000.00,0.00,0.00,165.43,0.23,0
26199,2834,-1000.00,-1000.00,0.00,107.01,691.90,0.40,0
26200,2835,1000.00,1000.00,2000.00,0.00,1000.00,0.30,1
26201,2835,1000.00,2000.00,3000.00,0.00,2000.00,0.42,1
26202,2835,1000.00,3000.00,4000.00,1247.82,1752.18,0.25,1
26203,2835,1000.00,4000.00,5000.00,1502.51,2497.49,0.35,1
26204,2835,1000.00,5000.00,6000.00,0.00,674.44,0.01,1
26205,2835,-1000.00,4000.00,5000.00,3326.58,2673.42,0.03,0
26206,2835,1000.00,5000.00,6000.00,1580.06,3419.94,0.34,1
26207,2835,1000.00,6000.00,7000.00,1009.94,4990.06,0.38,1
26208,2835,1000.00,7000.00,8000.00,3500.00,3500.00,0.10,1
26209,2835,-1000.00,6000.00,7000.00,4544.66,3455.34,0.06,0
26210,2835,1000.00,7000.00,8000.00,0.00,7000.00,0.05,1
26211,2835,-1000.00,6000.00,7000.00,7174.18,825.82,0.13,0
26212,2835,1000.00,7000.00,8000.00,965.67,4752.66,0.37,1
26213,2835,-1000.00,6000.00,7000.00,5257.77,2742.23,0.05,0
26214,2835,-1000.00,5000.00,6000.00,4169.48,2830.52,0.13,0
26215,2835,0.00,5000.00,6000.00,0.00,0.00,0.02,0
26216,2835,1000.00,6000.00,7000.00,0.00,6000.00,0.07,1
26217,2835,1000.00,7000.00,8000.00,0.00,7000.00,0.43,1
26218,2835,1000.00,8000.00,9000.00,0.00,8000.00,0.04,1
26219,2835,1000.00,9000.00,10000.00,0.00,9000.00,0.12,1
26220,2835,1000.00,10000.00,11000.00,0.00,7447.53,0.30,1
26221,2835,1000.00,11000.00,12000.00,0.00,11000.00,0.01,1
26222,2835,-1000.00,10000.00,11000.00,6982.64,5017.36,0.23,0
26223,2835,-1000.00,9000.00,10000.00,0.00,11000.00,0.39,0
26224,2835,-1000.00,8000.00,9000.00,5828.63,4171.37,0.14,0
26225,2835,-1000.00,7000.00,8000.00,0.00,9000.00,0.35,0
26226,2835,-1000.00,6000.00,7000.00,2464.68,5535.32,0.35,0
26227,2835,-1000.00,5000.00,6000.00,0.00,7000.00,0.28,0
26228,2835,-1000.00,4000.00,5000.00,1579.15,4420.85,0.30,0
26229,2835,-1000.00,3000.00,4000.00,0.00,5000.00,0.25,0
26230,2835,-1000.00,2000.00,3000.00,0.00,4000.00,0.11,0
26231,2835,-1000.00,1000.00,2000.00,1500.00,1500.00,0.00,0
26232,2835,-993.47,6.53,1006.53,0.00,993.47,0.14,0
26233,2835,-1000.00,-993.47,6.53,0.00,1006.53,0.22,0
26234,2835,-6.53,-1000.00,0.00,0.93,5.60,0.27,0
26235,2836,1000.00,1000.00,2000.00,0.00,186.55,0.13,1
26236,2836,1000.00,2000.00,3000.00,0.00,2000.00,0.30,1
26237,2836,1000.00,3000.00,4000.00,0.00,2181.45,0.34,1
26238,2836,1000.00,4000.00,5000.00,0.00,3423.43,0.41,1
26239,2836,-1000.00,3000.00,4000.00,3151.88,695.62,0.09,0
26240,2836,1000.00,4000.00,5000.00,2000.00,2000.00,0.30,1
26241,2836,1000.00,5000.00,6000.00,1475.94,3524.06,0.38,1
26242,2836,1000.00,6000.00,7000.00,0.00,548.73,0.13,1
26243,2836,1000.00,7000.00,8000.00,0.00,2328.91,0.16,1
26244,2836,-1000.00,6000.00,7000.00,8000.00,0.00,0.01,0
26245,2836,0.00,6000.00,7000.00,0.00,0.00,0.03,0
26246,2836,1000.00,7000.00,8000.00,936.82,6063.18,0.38,1
26247,2836,1000.00,8000.00,9000.00,0.00,8000.00,0.25,1
26248,2836,1000.00,9000.00,10000.00,3052.91,5947.09,0.32,1
26249,2836,1000.00,10000.00,11000.00,0.00,10000.00,0.26,1
26250,2836,1000.00,11000.00,12000.00,0.00,11000.00,0.07,1
26251,2836,1000.00,12000.00,13000.00,4315.60,7684.40,0.12,1
26252,2836,-1000.00,11000.00,12000.00,7748.26,5251.74,0.34,0
26253,2836,1000.00,12000.00,13000.00,0.00,12000.00,0.30,1
26254,2836,1000.00,13000.00,14000.00,4863.74,7613.84,0.25,1
26255,2836,-1000.00,12000.00,13000.00,7780.83,6219.17,0.27,0
26256,2836,-1000.00,11000.00,12000.00,2038.79,8389.49,0.37,0
26257,2836,-1000.00,10000.00,11000.00,8055.65,3944.35,0.08,0
26258,2836,-1000.00,9000.00,10000.00,2240.23,6385.36,0.33,0
26259,2836,-1000.00,8000.00,9000.00,1215.57,8784.43,0.36,0
26260,2836,-1000.00,7000.00,8000.00,4064.72,4935.28,0.07,0
26261,2836,-1000.00,6000.00,7000.00,0.00,6735.11,0.21,0
26262,2836,-1000.00,5000.00,6000.00,3015.36,3984.64,0.09,0
26263,2836,-1000.00,4000.00,5000.00,0.00,1195.99,0.19,0
26264,2836,0.00,4000.00,5000.00,0.00,0.00,0.07,0
26265,2836,-1000.00,3000.00,4000.00,1131.28,3868.72,0.33,0
26266,2836,-1000.00,2000.00,3000.00,0.00,4000.00,0.07,0
26267,2836,-1000.00,1000.00,2000.00,730.67,2269.33,0.33,0
26268,2836,-744.95,255.05,1255.05,0.00,744.95,0.23,0
26269,2836,-774.96,-519.91,480.09,0.00,774.96,0.34,0
26270,2836,-476.80,-996.71,3.29,134.44,342.36,0.35,0
26271,2836,-0.88,-997.59,2.41,0.00,0.88,0.16,0
26272,2836,-2.41,-1000.00,0.00,0.00,2.41,0.08,0
26273,2837,1000.00,1000.00,2000.00,286.46,713.54,0.35,1
26274,2837,1000.00,2000.00,3000.00,612.02,1387.30,0.34,1
26275,2837,1000.00,3000.00,4000.00,344.51,2655.49,0.43,1
26276,2837,1000.00,4000.00,5000.00,437.09,3562.91,0.31,1
26277,2837,1000.00,5000.00,6000.00,0.00,4519.43,0.33,1
26278,2837,1000.00,6000.00,7000.00,0.00,6000.00,0.35,1
26279,2837,-995.95,5004.05,6004.05,628.61,367.34,0.13,0
26280,2837,1000.00,6004.05,7004.05,189.72,5814.33,0.28,1
26281,2837,-1000.00,5004.05,6004.05,5251.29,1364.05,0.08,0
26282,2837,1000.00,6004.05,7004.05,0.00,190.44,0.07,1
26283,2837,-1000.00,5004.05,6004.05,3877.81,3126.24,0.17,0
26284,2837,-1000.00,4004.05,5004.05,4335.53,1668.52,0.03,0
26285,2837,1000.00,5004.05,6004.05,992.05,4012.00,0.38,1
26286,2837,1000.00,6004.05,7004.05,0.00,6004.05,0.32,1
26287,2837,1000.00,7004.05,8004.05,918.37,5759.31,0.41,1
26288,2837,1000.00,8004.05,9004.05,2832.71,5171.34,0.28,1
26289,2837,1000.00,9004.05,10004.05,2077.15,6926.90,0.39,1
26290,2837,1000.00,10004.05,11004.05,4451.47,5552.59,0.42,1
26291,2837,1000.00,11004.05,12004.05,3731.17,7272.88,0.28,1
26292,2837,1000.00,12004.05,13004.05,4061.07,7942.98,0.38,1
26293,2837,1000.00,13004.05,14004.05,4103.46,8900.60,0.42,1
26294,2837,1000.00,14004.05,15004.05,0.00,14004.05,0.34,1
26295,2837,1000.00,15004.05,16004.05,2978.31,12025.74,0.41,1
26296,2837,-1000.00,14004.05,15004.05,0.00,16004.05,0.02,0
26297,2837,-1000.00,13004.05,14004.05,0.00,15004.05,0.16,0
26298,2837,-1000.00,12004.05,13004.05,0.00,8027.66,0.33,0
26299,2837,-1000.00,11004.05,12004.05,9331.33,0.00,0.05,0
26300,2837,-1000.00,10004.05,11004.05,5405.41,6598.65,0.16,0
26301,2837,-1000.00,9004.05,10004.05,0.00,11004.05,0.21,0
26302,2837,-1000.00,8004.05,9004.05,1767.24,8236.82,0.26,0
26303,2837,-1000.00,7004.05,8004.05,5024.52,3979.53,0.18,0
26304,2837,-1000.00,6004.05,7004.05,0.00,7910.87,0.13,0
26305,2837,-1000.00,5004.05,6004.05,2376.48,4487.33,0.32,0
26306,2837,-1000.00,4004.05,5004.05,3597.11,2038.91,0.19,0
26307,2837,-1000.00,3004.05,4004.05,0.00,5004.05,0.35,0
26308,2837,-1000.00,2004.05,3004.05,736.80,3267.26,0.21,0
26309,2837,-1000.00,1004.05,2004.05,0.00,3004.05,0.31,0
26310,2837,-678.91,325.14,1325.14,0.00,678.91,0.02,0
26311,2837,-1000.00,-674.86,325.14,662.57,662.57,0.02,0
26312,2837,-1000.00,-1674.86,-674.86,206.68,118.46,0.01,0
26313,2838,0.00,0.00,1000.00,0.00,0.00,0.08,0
26314,2838,-1000.00,-1000.00,0.00,366.74,633.26,0.12,0
26315,2839,1000.00,1000.00,2000.00,500.00,500.00,0.07,1
26316,2839,1000.00,2000.00,3000.00,0.00,1606.09,0.42,1
26317,2839,1000.00,3000.00,4000.00,0.00,3000.00,0.38,1
26318,2839,-1000.00,2000.00,3000.00,2003.30,1996.70,0.28,0
26319,2839,1000.00,3000.00,4000.00,945.49,2054.51,0.32,1
26320,2839,1000.00,4000.00,5000.00,902.20,2524.81,0.34,1
26321,2839,-859.04,3140.96,4140.96,859.04,0.00,0.06,0
26322,2839,1000.00,4140.96,5140.96,637.61,3503.35,0.42,1
26323,2839,1000.00,5140.96,6140.96,0.00,4814.61,0.41,1
26324,2839,1000.00,6140.96,7140.96,869.61,5271.35,0.30,1
26325,2839,1000.00,7140.96,8140.96,1775.37,5365.59,0.38,1
26326,2839,1000.00,8140.96,9140.96,3017.32,5123.64,0.14,1
26327,2839,1000.00,9140.96,10140.96,0.00,9140.96,0.26,1
26328,2839,1000.00,10140.96,11140.96,0.00,10140.96,0.40,1
26329,2839,1000.00,11140.96,12140.96,1841.45,9299.51,0.37,1
26330,2839,1000.00,12140.96,13140.96,0.00,12140.96,0.04,1
26331,2839,1000.00,13140.96,14140.96,1279.63,11497.80,0.43,1
26332,2839,1000.00,14140.96,15140.96,0.00,12324.29,0.20,1
26333,2839,1000.00,15140.96,16140.96,0.00,8665.16,0.29,1
26334,2839,1000.00,16140.96,17140.96,3970.27,12170.69,0.32,1
26335,2839,1000.00,17140.96,18140.96,6812.20,10328.76,0.38,1
26336,2839,-1000.00,16140.96,17140.96,6773.26,11367.69,0.41,0
26337,2839,-1000.00,15140.96,16140.96,5079.27,12061.69,0.25,0
26338,2839,-1000.00,14140.96,15140.96,8530.41,7610.55,0.13,0
26339,2839,-1000.00,13140.96,14140.96,7112.43,8028.53,0.20,0
26340,2839,-1000.00,12140.96,13140.96,0.00,14140.96,0.09,0
26341,2839,-1000.00,11140.96,12140.96,9382.63,0.00,0.05,0
26342,2839,-1000.00,10140.96,11140.96,0.00,12140.96,0.10,0
26343,2839,-1000.00,9140.96,10140.96,7279.12,0.00,0.03,0
26344,2839,-1000.00,8140.96,9140.96,769.78,9371.17,0.39,0
26345,2839,-1000.00,7140.96,8140.96,1022.49,8118.47,0.32,0
26346,2839,-1000.00,6140.96,7140.96,239.67,6786.17,0.43,0
26347,2839,-1000.00,5140.96,6140.96,2114.98,5025.97,0.26,0
26348,2839,-1000.00,4140.96,5140.96,4362.20,1778.76,0.21,0
26349,2839,-1000.00,3140.96,4140.96,1124.77,4016.19,0.40,0
26350,2839,-1000.00,2140.96,3140.96,41.35,4099.61,0.28,0
26351,2839,-1000.00,1140.96,2140.96,1570.48,1570.48,0.28,0
26352,2839,-1000.00,140.96,1140.96,850.21,1290.74,0.20,0
26353,2839,-1000.00,-859.04,140.96,957.53,183.43,0.03,0
26354,2839,-140.96,-1000.00,0.00,50.75,90.21,0.21,0
26355,2840,-412.95,-412.95,587.05,0.00,412.95,0.27,0
26356,2840,-587.05,-1000.00,0.00,255.85,331.20,0.03,0
26357,2841,-1000.00,-1000.00,0.00,242.88,757.12,0.27,0
26358,2842,-222.63,-222.63,777.37,0.00,222.63,0.20,0
26359,2842,-1000.00,-1222.63,-222.63,402.57,257.38,0.17,0
26360,2843,-232.08,-232.08,767.92,192.57,39.51,0.13,0
26361,2843,-1000.00,-1232.08,-232.08,98.18,669.74,0.42,0
26362,2844,-713.00,-713.00,287.00,0.00,713.00,0.09,0
26363,2844,-166.67,-879.67,120.33,0.00,166.67,0.32,0
26364,2844,-120.33,-1000.00,0.00,45.94,74.39,0.30,0
26365,2844,-0.00,-1000.00,0.00,0.00,0.00,0.06,0
26366,2845,1000.00,1000.00,2000.00,93.83,579.51,0.34,1
26367,2845,1000.00,2000.00,3000.00,0.00,2000.00,0.28,1
26368,2845,1000.00,3000.00,4000.00,0.00,3000.00,0.29,1
26369,2845,1000.00,4000.00,5000.00,1863.72,2136.28,0.21,1
26370,2845,1000.00,5000.00,6000.00,1509.52,3490.48,0.32,1
26371,2845,1000.00,6000.00,7000.00,0.00,6000.00,0.28,1
26372,2845,1000.00,7000.00,8000.00,0.00,3026.26,0.22,1
26373,2845,1000.00,8000.00,9000.00,398.66,7601.34,0.39,1
26374,2845,1000.00,9000.00,10000.00,960.28,8039.72,0.37,1
26375,2845,1000.00,10000.00,11000.00,0.00,9385.05,0.28,1
26376,2845,1000.00,11000.00,12000.00,0.00,3877.47,0.22,1
26377,2845,1000.00,12000.00,13000.00,0.00,6866.08,0.25,1
26378,2845,1000.00,13000.00,14000.00,0.00,13000.00,0.32,1
26379,2845,1000.00,14000.00,15000.00,0.00,14000.00,0.06,1
26380,2845,1000.00,15000.00,16000.00,4317.82,10682.18,0.01,1
26381,2845,1000.00,16000.00,17000.00,0.00,16000.00,0.05,1
26382,2845,-1000.00,15000.00,16000.00,17000.00,0.00,0.00,0
26383,2845,1000.00,16000.00,17000.00,4210.82,11789.18,0.26,1
26384,2845,1000.00,17000.00,18000.00,0.00,10011.12,0.29,1
26385,2845,-1000.00,16000.00,17000.00,1518.63,5843.22,0.13,0
26386,2845,-1000.00,15000.00,16000.00,0.00,17000.00,0.20,0
26387,2845,-1000.00,14000.00,15000.00,0.00,13081.89,0.04,0
26388,2845,-1000.00,13000.00,14000.00,3888.71,11111.29,0.35,0
26389,2845,-1000.00,12000.00,13000.00,6827.41,7172.59,0.14,0
26390,2845,-1000.00,11000.00,12000.00,6500.00,6500.00,0.02,0
26391,2845,-1000.00,10000.00,11000.00,0.00,1198.94,0.15,0
26392,2845,-1000.00,9000.00,10000.00,0.00,9429.15,0.42,0
26393,2845,-1000.00,8000.00,9000.00,0.00,10000.00,0.14,0
26394,2845,-1000.00,7000.00,8000.00,3463.30,5536.70,0.24,0
26395,2845,-1000.00,6000.00,7000.00,1877.92,6122.08,0.39,0
26396,2845,-1000.00,5000.00,6000.00,0.00,7000.00,0.04,0
26397,2845,-225.31,4774.69,5774.69,0.00,225.31,0.06,0
26398,2845,-1000.00,3774.69,4774.69,0.00,5774.69,0.26,0
26399,2845,-1000.00,2774.69,3774.69,0.00,3316.35,0.39,0
26400,2845,-1000.00,1774.69,2774.69,0.00,1922.63,0.31,0
26401,2845,-1000.00,774.69,1774.69,0.00,2774.69,0.17,0
26402,2845,-1000.00,-225.31,774.69,627.56,1147.13,0.16,0
26403,2845,-151.92,-377.23,622.77,0.00,151.92,0.10,0
26404,2845,-540.42,-917.65,82.35,0.00,540.42,0.14,0
26405,2845,-82.35,-1000.00,0.00,4.20,78.15,0.19,0
26406,2846,-1000.00,-1000.00,0.00,0.00,1000.00,0.36,0
26407,2847,-626.29,-626.29,373.71,626.29,0.00,0.06,0
26408,2847,0.00,-626.29,373.71,89.41,284.29,0.39,0
26409,2847,0.00,-626.29,373.71,108.90,264.81,0.19,0
26410,2847,0.00,-626.29,373.71,86.56,287.15,0.30,0
26411,2847,0.00,-626.29,373.71,0.00,373.71,0.37,0
26412,2847,0.00,-626.29,373.71,48.88,324.83,0.03,0
26413,2847,0.00,-626.29,373.71,0.00,373.71,0.04,0
26414,2847,0.00,-626.29,373.71,0.00,171.25,0.20,0
26415,2847,0.00,-626.29,373.71,0.00,344.36,0.39,0
26416,2847,0.00,-626.29,373.71,44.82,328.88,0.43,0
26417,2847,0.00,-626.29,373.71,0.00,269.11,0.18,0
26418,2847,0.00,-626.29,373.71,0.00,0.00,0.01,0
26419,2847,-373.71,-1000.00,0.00,193.12,180.59,0.11,0
26420,2848,-1000.00,-1000.00,0.00,684.59,0.00,0.05,0
26421,2849,1000.00,1000.00,2000.00,113.69,886.31,0.10,1
26422,2849,1000.00,2000.00,3000.00,133.86,1320.20,0.38,1
26423,2849,1000.00,3000.00,4000.00,49.52,2950.48,0.08,1
26424,2849,1000.00,4000.00,5000.00,1371.34,2628.66,0.27,1
26425,2849,1000.00,5000.00,6000.00,0.00,5000.00,0.29,1
26426,2849,1000.00,6000.00,7000.00,1485.64,4514.36,0.16,1
26427,2849,1000.00,7000.00,8000.00,1375.94,5624.06,0.41,1
26428,2849,1000.00,8000.00,9000.00,0.00,4841.70,0.36,1
26429,2849,1000.00,9000.00,10000.00,0.00,8199.20,0.17,1
26430,2849,1000.00,10000.00,11000.00,0.00,10000.00,0.29,1
26431,2849,1000.00,11000.00,12000.00,3891.18,7108.82,0.27,1
26432,2849,1000.00,12000.00,13000.00,0.00,12000.00,0.06,1
26433,2849,1000.00,13000.00,14000.00,4366.99,8633.01,0.25,1
26434,2849,-1000.00,12000.00,13000.00,9137.81,4862.19,0.10,0
26435,2849,1000.00,13000.00,14000.00,4456.68,8543.32,0.42,1
26436,2849,1000.00,14000.00,15000.00,6503.72,7496.28,0.37,1
26437,2849,-1000.00,13000.00,14000.00,5949.95,9050.05,0.35,0
26438,2849,0.00,13000.00,14000.00,0.00,0.00,0.14,0
26439,2849,0.00,13000.00,14000.00,0.00,0.00,0.10,0
26440,2849,-1000.00,12000.00,13000.00,6884.62,7115.38,0.01,0
26441,2849,-1000.00,11000.00,12000.00,5797.03,7202.97,0.12,0
26442,2849,-1000.00,10000.00,11000.00,0.00,12000.00,0.21,0
26443,2849,-1000.00,9000.00,10000.00,1902.85,9097.15,0.06,0
26444,2849,-1000.00,8000.00,9000.00,0.00,4502.14,0.13,0
26445,2849,-1000.00,7000.00,8000.00,1782.81,7217.19,0.41,0
26446,2849,-1000.00,6000.00,7000.00,5948.64,2051.36,0.11,0
26447,2849,-1000.00,5000.00,6000.00,0.00,7000.00,0.07,0
26448,2849,-1000.00,4000.00,5000.00,3000.00,3000.00,0.05,0
26449,2849,-1000.00,3000.00,4000.00,4782.06,0.00,0.02,0
26450,2849,-1000.00,2000.00,3000.00,2069.85,732.80,0.12,0
26451,2849,-1000.00,1000.00,2000.00,0.00,3000.00,0.11,0
26452,2849,-1000.00,0.00,1000.00,702.07,1297.93,0.11,0
26453,2849,-1000.00,-1000.00,0.00,238.91,761.09,0.32,0
26454,2850,1000.00,1000.00,2000.00,0.00,571.77,0.34,1
26455,2850,1000.00,2000.00,3000.00,273.24,1693.86,0.42,1
26456,2850,-1000.00,1000.00,2000.00,1599.09,1400.91,0.08,0
26457,2850,1000.00,2000.00,3000.00,0.00,1852.50,0.31,1
26458,2850,1000.00,3000.00,4000.00,254.39,2574.57,0.43,1
26459,2850,1000.00,4000.00,5000.00,1723.75,2276.25,0.18,1
26460,2850,1000.00,5000.00,6000.00,2360.30,2639.70,0.22,1
26461,2850,1000.00,6000.00,7000.00,367.60,5632.40,0.25,1
26462,2850,1000.00,7000.00,8000.00,0.00,32.71,0.10,1
26463,2850,1000.00,8000.00,9000.00,0.00,8000.00,0.21,1
26464,2850,1000.00,9000.00,10000.00,556.92,2755.49,0.07,1
26465,2850,1000.00,10000.00,11000.00,462.14,9537.86,0.43,1
26466,2850,-1000.00,9000.00,10000.00,6124.47,4875.53,0.18,0
26467,2850,-1000.00,8000.00,9000.00,0.00,10000.00,0.26,0
26468,2850,-1000.00,7000.00,8000.00,9000.00,0.00,0.02,0
26469,2850,-1000.00,6000.00,7000.00,3840.63,4159.37,0.14,0
26470,2850,-1000.00,5000.00,6000.00,0.00,7000.00,0.40,0
26471,2850,-1000.00,4000.00,5000.00,3000.00,3000.00,0.13,0
26472,2850,-1000.00,3000.00,4000.00,2679.42,2320.58,0.09,0
26473,2850,-1000.00,2000.00,3000.00,370.93,2123.38,0.43,0
26474,2850,-1000.00,1000.00,2000.00,575.20,1768.79,0.14,0
26475,2850,0.00,1000.00,2000.00,0.00,0.00,0.03,0
26476,2850,-1000.00,0.00,1000.00,0.00,2000.00,0.13,0
26477,2850,-1000.00,-1000.00,0.00,343.88,656.12,0.27,0
26478,2851,-1000.00,-1000.00,0.00,1000.00,0.00,0.01,0
26479,2852,-822.76,-822.76,177.24,0.00,822.76,0.35,0
26480,2852,-1000.00,-1822.76,-822.76,117.42,59.82,0.12,0
26481,2853,-1000.00,-1000.00,0.00,0.00,1000.00,0.11,0
26482,2854,-1000.00,-1000.00,0.00,267.05,732.95,0.24,0
26483,2855,1000.00,1000.00,2000.00,495.35,504.65,0.11,1
26484,2855,1000.00,2000.00,3000.00,0.00,2000.00,0.36,1
26485,2855,1000.00,3000.00,4000.00,0.00,2046.22,0.36,1
26486,2855,1000.00,4000.00,5000.00,0.00,775.01,0.10,1
26487,2855,1000.00,5000.00,6000.00,1617.64,3382.36,0.21,1
26488,2855,1000.00,6000.00,7000.00,0.00,4734.36,0.34,1
26489,2855,1000.00,7000.00,8000.00,3469.64,3530.36,0.04,1
26490,2855,1000.00,8000.00,9000.00,0.00,8000.00,0.32,1
26491,2855,1000.00,9000.00,10000.00,1613.82,7386.18,0.26,1
26492,2855,1000.00,10000.00,11000.00,4330.28,5669.72,0.24,1
26493,2855,1000.00,11000.00,12000.00,0.00,2614.19,0.17,1
26494,2855,-1000.00,10000.00,11000.00,9782.63,2217.37,0.18,0
26495,2855,1000.00,11000.00,12000.00,0.00,2601.26,0.10,1
26496,2855,-1000.00,10000.00,11000.00,1727.12,0.00,0.04,0
26497,2855,1000.00,11000.00,12000.00,0.00,9990.07,0.28,1
26498,2855,-1000.00,10000.00,11000.00,4710.43,7289.57,0.15,0
26499,2855,-1000.00,9000.00,10000.00,4084.02,6915.98,0.14,0
26500,2855,-1000.00,8000.00,9000.00,0.00,10000.00,0.23,0
26501,2855,-1000.00,7000.00,8000.00,0.00,2996.85,0.23,0
26502,2855,-1000.00,6000.00,7000.00,4276.18,1898.59,0.15,0
26503,2855,-1000.00,5000.00,6000.00,831.23,6168.77,0.39,0
26504,2855,-1000.00,4000.00,5000.00,4718.37,1281.63,0.19,0
26505,2855,-1000.00,3000.00,4000.00,0.00,2834.26,0.26,0
26506,2855,-1000.00,2000.00,3000.00,0.00,4000.00,0.33,0
26507,2855,-1000.00,1000.00,2000.00,0.00,1932.70,0.14,0
26508,2855,-1000.00,0.00,1000.00,125.48,1728.83,0.43,0
26509,2855,-1000.00,-1000.00,0.00,458.99,541.01,0.21,0
26510,2856,-1000.00,-1000.00,0.00,341.08,658.92,0.14,0
26511,2857,-407.55,-407.55,592.45,0.00,407.55,0.27,0
26512,2857,-234.24,-641.79,358.21,0.00,234.24,0.25,0
26513,2857,-44.25,-686.05,313.95,0.00,44.25,0.14,0
26514,2857,-313.95,-1000.00,0.00,0.00,313.95,0.35,0
26515,2858,-1000.00,-1000.00,0.00,16.73,556.95,0.36,0
26516,2859,1000.00,1000.00,2000.00,149.85,386.18,0.26,1
26517,2859,-1000.00,0.00,1000.00,1152.31,518.41,0.13,0
26518,2859,-943.19,-943.19,56.81,529.55,413.64,0.19,0
26519,2859,1000.00,56.81,1056.81,0.00,56.81,0.38,1
26520,2859,1000.00,1056.81,2056.81,0.00,359.26,0.12,1
26521,2859,1000.00,2056.81,3056.81,555.26,1501.55,0.01,1
26522,2859,1000.00,3056.81,4056.81,0.00,3056.81,0.18,1
26523,2859,1000.00,4056.81,5056.81,0.00,3889.28,0.42,1
26524,2859,1000.00,5056.81,6056.81,237.09,1831.18,0.09,1
26525,2859,-1000.00,4056.81,5056.81,2820.42,1328.67,0.14,0
26526,2859,1000.00,5056.81,6056.81,0.00,4923.90,0.39,1
26527,2859,1000.00,6056.81,7056.81,0.00,6056.81,0.01,1
26528,2859,1000.00,7056.81,8056.81,0.00,7056.81,0.01,1
26529,2859,1000.00,8056.81,9056.81,0.00,8056.81,0.28,1
26530,2859,-1000.00,7056.81,8056.81,6259.73,0.00,0.01,0
26531,2859,1000.00,8056.81,9056.81,3663.63,4393.18,0.23,1
26532,2859,1000.00,9056.81,10056.81,0.00,9056.81,0.41,1
26533,2859,-1000.00,8056.81,9056.81,6834.84,3221.97,0.04,0
26534,2859,1000.00,9056.81,10056.81,2688.70,6368.11,0.32,1
26535,2859,1000.00,10056.81,11056.81,1833.10,8223.71,0.41,1
26536,2859,1000.00,11056.81,12056.81,0.00,11056.81,0.26,1
26537,2859,1000.00,12056.81,13056.81,3017.06,9039.75,0.38,1
26538,2859,-1000.00,11056.81,12056.81,6528.41,6528.41,0.12,0
26539,2859,-1000.00,10056.81,11056.81,6028.41,6028.41,0.09,0
26540,2859,-1000.00,9056.81,10056.81,0.00,9543.71,0.42,0
26541,2859,0.00,9056.81,10056.81,0.00,0.00,0.08,0
26542,2859,-1000.00,8056.81,9056.81,4824.76,5232.05,0.06,0
26543,2859,-1000.00,7056.81,8056.81,4528.41,4528.41,0.20,0
26544,2859,-1000.00,6056.81,7056.81,3848.25,4208.56,0.13,0
26545,2859,-1000.00,5056.81,6056.81,3506.95,3549.86,0.10,0
26546,2859,-1000.00,4056.81,5056.81,0.00,6056.81,0.06,0
26547,2859,-1000.00,3056.81,4056.81,644.45,2139.50,0.27,0
26548,2859,-1000.00,2056.81,3056.81,2930.65,1126.16,0.23,0
26549,2859,-1000.00,1056.81,2056.81,0.00,1806.36,0.29,0
26550,2859,-1000.00,56.81,1056.81,0.00,2056.81,0.19,0
26551,2859,-1000.00,-943.19,56.81,426.46,630.35,0.04,0
26552,2859,-1000.00,-1943.19,-943.19,36.37,20.44,0.03,0
26553,2860,-1000.00,-1000.00,0.00,917.66,82.34,0.02,0
26554,2861,1000.00,1000.00,2000.00,172.16,827.84,0.39,1
26555,2861,1000.00,2000.00,3000.00,115.97,1884.03,0.40,1
26556,2861,1000.00,3000.00,4000.00,0.00,3000.00,0.14,1
26557,2861,1000.00,4000.00,5000.00,136.03,3285.55,0.42,1
26558,2861,-1000.00,3000.00,4000.00,2351.87,1584.58,0.17,0
26559,2861,-1000.00,2000.00,3000.00,2154.41,1845.59,0.33,0
26560,2861,1000.00,3000.00,4000.00,1422.33,1577.67,0.12,1
26561,2861,1000.00,4000.00,5000.00,0.00,2147.12,0.13,1
26562,2861,-1000.00,3000.00,4000.00,2538.06,2461.94,0.14,0
26563,2861,-1000.00,2000.00,3000.00,1149.90,0.00,0.03,0
26564,2861,1000.00,3000.00,4000.00,1385.75,1614.25,0.12,1
26565,2861,1000.00,4000.00,5000.00,942.09,3057.91,0.39,1
26566,2861,1000.00,5000.00,6000.00,435.27,4564.73,0.24,1
26567,2861,1000.00,6000.00,7000.00,0.00,6000.00,0.12,1
26568,2861,1000.00,7000.00,8000.00,3500.00,3500.00,0.16,1
26569,2861,0.00,7000.00,8000.00,0.00,0.00,0.03,0
26570,2861,-1000.00,6000.00,7000.00,5414.10,2585.90,0.23,0
26571,2861,1000.00,7000.00,8000.00,0.00,7000.00,0.00,1
26572,2861,1000.00,8000.00,9000.00,2982.33,5017.67,0.10,1
26573,2861,1000.00,9000.00,10000.00,0.00,9000.00,0.34,1
26574,2861,1000.00,10000.00,11000.00,0.00,10000.00,0.18,1
26575,2861,1000.00,11000.00,12000.00,3386.79,7613.21,0.12,1
26576,2861,1000.00,12000.00,13000.00,1440.81,10559.19,0.42,1
26577,2861,1000.00,13000.00,14000.00,0.00,13000.00,0.29,1
26578,2861,1000.00,14000.00,15000.00,0.00,5714.08,0.02,1
26579,2861,1000.00,15000.00,16000.00,2605.53,12394.47,0.41,1
26580,2861,1000.00,16000.00,17000.00,0.00,6893.37,0.27,1
26581,2861,-1000.00,15000.00,16000.00,15621.66,0.00,0.00,0
26582,2861,1000.00,16000.00,17000.00,2721.10,13278.90,0.42,1
26583,2861,1000.00,17000.00,18000.00,0.00,17000.00,0.15,1
26584,2861,1000.00,18000.00,19000.00,0.00,18000.00,0.26,1
26585,2861,1000.00,19000.00,20000.00,0.00,10057.71,0.21,1
26586,2861,1000.00,20000.00,21000.00,8424.99,11575.01,0.06,1
26587,2861,1000.00,21000.00,22000.00,0.00,21000.00,0.12,1
26588,2861,-1000.00,20000.00,21000.00,15889.62,6110.38,0.08,0
26589,2861,-1000.00,19000.00,20000.00,11005.16,9994.84,0.28,0
26590,2861,1000.00,20000.00,21000.00,2368.91,17631.09,0.38,1
26591,2861,1000.00,21000.00,22000.00,0.00,16778.95,0.25,1
26592,2861,0.00,21000.00,22000.00,0.00,0.00,0.02,0
26593,2861,1000.00,22000.00,23000.00,9601.55,12398.45,0.33,1
26594,2861,1000.00,23000.00,24000.00,8708.74,14291.26,0.31,1
26595,2862,1000.00,1000.00,2000.00,358.36,641.64,0.03,1
26596,2862,1000.00,2000.00,3000.00,0.00,2000.00,0.39,1
26597,2862,1000.00,3000.00,4000.00,1002.91,1997.09,0.31,1
26598,2862,0.00,3000.00,4000.00,0.00,0.00,0.03,0
26599,2862,1000.00,4000.00,5000.00,0.00,1848.66,0.29,1
26600,2862,1000.00,5000.00,6000.00,0.00,3806.08,0.34,1
26601,2862,1000.00,6000.00,7000.00,1627.40,4372.60,0.36,1
26602,2862,1000.00,7000.00,8000.00,2966.50,4008.65,0.27,1
26603,2862,1000.00,8000.00,9000.00,0.00,8000.00,0.30,1
26604,2862,1000.00,9000.00,10000.00,0.00,9000.00,0.30,1
26605,2862,1000.00,10000.00,11000.00,0.00,8716.71,0.18,1
26606,2862,1000.00,11000.00,12000.00,3612.79,7387.21,0.29,1
26607,2862,1000.00,12000.00,13000.00,3350.79,8649.21,0.30,1
26608,2862,1000.00,13000.00,14000.00,0.00,474.36,0.11,1
26609,2862,1000.00,14000.00,15000.00,0.00,12734.00,0.42,1
26610,2862,1000.00,15000.00,16000.00,7500.00,7500.00,0.01,1
26611,2862,1000.00,16000.00,17000.00,0.00,16000.00,0.11,1
26612,2862,-1000.00,15000.00,16000.00,16707.05,292.95,0.07,0
26613,2862,1000.00,16000.00,17000.00,0.00,16000.00,0.28,1
26614,2862,-1000.00,15000.00,16000.00,9373.37,0.00,0.05,0
26615,2862,1000.00,16000.00,17000.00,7415.49,8584.51,0.15,1
26616,2862,1000.00,17000.00,18000.00,0.00,17000.00,0.14,1
26617,2862,1000.00,18000.00,19000.00,0.00,18000.00,0.33,1
26618,2862,1000.00,19000.00,20000.00,0.00,19000.00,0.21,1
26619,2862,1000.00,20000.00,21000.00,7978.04,12021.96,0.24,1
26620,2862,1000.00,21000.00,22000.00,0.00,4164.56,0.18,1
26621,2862,1000.00,22000.00,23000.00,0.00,22000.00,0.33,1
26622,2862,1000.00,23000.00,24000.00,2387.39,19646.59,0.42,1
26623,2862,1000.00,24000.00,25000.00,4754.58,19245.42,0.41,1
26624,2862,1000.00,25000.00,26000.00,12377.77,12622.23,0.12,1
26625,2862,1000.00,26000.00,27000.00,7278.45,14630.13,0.30,1
26626,2862,1000.00,27000.00,28000.00,10432.99,16567.01,0.24,1
26627,2862,1000.00,28000.00,29000.00,0.00,15064.47,0.22,1
26628,2862,1000.00,29000.00,30000.00,0.00,16551.32,0.34,1
26629,2862,-1000.00,28000.00,29000.00,30000.00,0.00,0.05,0
26630,2862,0.00,28000.00,29000.00,0.00,0.00,0.05,0
26631,2862,1000.00,29000.00,30000.00,11767.25,17232.75,0.20,1
26632,2862,1000.00,30000.00,31000.00,13915.34,16084.66,0.05,1
26633,2862,1000.00,31000.00,32000.00,9024.49,16980.29,0.31,1
26634,2863,-1000.00,-1000.00,0.00,128.57,521.17,0.32,0
26635,2864,-653.59,-653.59,346.41,337.77,315.82,0.24,0
26636,2864,-1000.00,-1653.59,-653.59,117.40,229.02,0.20,0
26637,2865,-972.37,-972.37,27.63,210.39,761.97,0.38,0
26638,2865,-27.63,-1000.00,0.00,0.00,27.63,0.15,0
26639,2866,-921.32,-921.32,78.68,921.32,0.00,0.02,0
26640,2866,-1000.00,-1921.32,-921.32,37.54,41.14,0.01,0
26641,2867,-1000.00,-1000.00,0.00,331.81,668.19,0.24,0
26642,2868,-1000.00,-1000.00,0.00,0.00,1000.00,0.33,0
26643,2869,-322.55,-322.55,677.45,25.03,297.52,0.22,0
26644,2869,-677.45,-1000.00,0.00,50.16,627.30,0.44,0
26645,2870,-591.10,-591.10,408.90,0.00,591.10,0.35,0
26646,2870,-330.88,-921.98,78.02,0.00,330.88,0.39,0
26647,2870,-78.02,-1000.00,0.00,17.11,60.91,0.39,0
26648,2871,1000.00,1000.00,2000.00,49.05,0.00,0.10,1
26649,2871,-1000.00,0.00,1000.00,0.00,1971.72,0.25,0
26650,2871,-1000.00,-1000.00,0.00,0.00,1000.00,0.20,0
26651,2872,-846.23,-846.23,153.77,646.88,199.35,0.10,0
26652,2872,1000.00,153.77,1153.77,0.00,153.77,0.43,1
26653,2872,1000.00,1153.77,2153.77,0.00,689.83,0.24,1
26654,2872,1000.00,2153.77,3153.77,0.00,550.19,0.14,1
26655,2872,1000.00,3153.77,4153.77,1221.67,1932.10,0.20,1
26656,2872,1000.00,4153.77,5153.77,1344.01,2809.76,0.32,1
26657,2872,1000.00,5153.77,6153.77,0.00,4629.63,0.26,1
26658,2872,1000.00,6153.77,7153.77,0.00,2987.39,0.25,1
26659,2872,-1000.00,5153.77,6153.77,3738.62,3415.15,0.34,0
26660,2872,-1000.00,4153.77,5153.77,2308.98,1890.99,0.19,0
26661,2872,1000.00,5153.77,6153.77,0.00,749.56,0.07,1
26662,2872,1000.00,6153.77,7153.77,1145.94,5007.83,0.40,1
26663,2872,1000.00,7153.77,8153.77,0.00,1316.08,0.18,1
26664,2872,1000.00,8153.77,9153.77,0.00,5891.54,0.22,1
26665,2872,1000.00,9153.77,10153.77,0.00,9153.77,0.16,1
26666,2872,1000.00,10153.77,11153.77,675.18,9478.59,0.43,1
26667,2872,-1000.00,9153.77,10153.77,6465.22,4688.55,0.17,0
26668,2872,1000.00,10153.77,11153.77,1378.33,7988.26,0.41,1
26669,2872,-1000.00,9153.77,10153.77,6103.08,5050.69,0.03,0
26670,2872,1000.00,10153.77,11153.77,4600.19,5553.58,0.43,1
26671,2872,1000.00,11153.77,12153.77,0.00,11153.77,0.29,1
26672,2873,-1000.00,-1000.00,0.00,233.17,766.83,0.37,0
26673,2874,-737.71,-737.71,262.29,43.34,694.37,0.39,0
26674,2874,-185.91,-923.62,76.38,0.00,185.91,0.33,0
26675,2874,1000.00,76.38,1076.38,54.68,21.70,0.10,1
26676,2874,-1000.00,-923.62,76.38,0.00,1076.38,0.29,0
26677,2874,-68.92,-992.54,7.46,0.00,68.92,0.30,0
26678,2874,-7.46,-1000.00,0.00,1.82,5.65,0.14,0
26679,2875,1000.00,1000.00,2000.00,421.53,578.47,0.16,1
26680,2875,1000.00,2000.00,3000.00,0.00,285.08,0.01,1
26681,2875,1000.00,3000.00,4000.00,0.00,3000.00,0.41,1
26682,2875,1000.00,4000.00,5000.00,165.46,3834.54,0.26,1
26683,2875,1000.00,5000.00,6000.00,0.00,5000.00,0.08,1
26684,2875,1000.00,6000.00,7000.00,0.00,6000.00,0.16,1
26685,2875,1000.00,7000.00,8000.00,0.00,7000.00,0.07,1
26686,2875,1000.00,8000.00,9000.00,0.00,6589.92,0.23,1
26687,2875,1000.00,9000.00,10000.00,0.00,1671.55,0.03,1
26688,2875,-1000.00,8000.00,9000.00,5567.60,4432.40,0.11,0
26689,2875,1000.00,9000.00,10000.00,0.00,9000.00,0.13,1
26690,2875,1000.00,10000.00,11000.00,0.00,10000.00,0.05,1
26691,2875,1000.00,11000.00,12000.00,0.00,6056.90,0.17,1
26692,2875,1000.00,12000.00,13000.00,0.00,12000.00,0.24,1
26693,2875,1000.00,13000.00,14000.00,0.00,13000.00,0.43,1
26694,2875,1000.00,14000.00,15000.00,0.00,4814.12,0.20,1
26695,2875,1000.00,15000.00,16000.00,6599.06,8400.94,0.14,1
26696,2875,1000.00,16000.00,17000.00,0.00,16000.00,0.17,1
26697,2875,-1000.00,15000.00,16000.00,10964.11,6035.89,0.10,0
26698,2875,1000.00,16000.00,17000.00,5796.30,10203.70,0.10,1
26699,2875,1000.00,17000.00,18000.00,926.92,3234.80,0.17,1
26700,2875,1000.00,18000.00,19000.00,9000.00,9000.00,0.28,1
26701,2875,1000.00,19000.00,20000.00,766.39,3055.34,0.17,1
26702,2875,1000.00,20000.00,21000.00,0.00,15147.52,0.32,1
26703,2875,1000.00,21000.00,22000.00,6274.97,14725.03,0.29,1
26704,2875,1000.00,22000.00,23000.00,3498.43,18501.57,0.19,1
26705,2875,-1000.00,21000.00,22000.00,8980.75,14019.25,0.22,0
26706,2875,-1000.00,20000.00,21000.00,15670.18,6329.82,0.15,0
26707,2875,-1000.00,19000.00,20000.00,7011.90,13988.10,0.08,0
26708,2875,-1000.00,18000.00,19000.00,10131.79,9868.21,0.14,0
26709,2875,0.00,18000.00,19000.00,0.00,0.00,0.32,0
26710,2875,0.00,18000.00,19000.00,0.00,0.00,0.29,0
26711,2875,-1000.00,17000.00,18000.00,0.00,5145.88,0.30,0
26712,2875,-1000.00,16000.00,17000.00,8265.64,9734.36,0.06,0
26713,2875,-1000.00,15000.00,16000.00,0.00,12936.46,0.16,0
26714,2875,-1000.00,14000.00,15000.00,4369.48,8629.31,0.30,0
26715,2875,-1000.00,13000.00,14000.00,0.00,2636.06,0.21,0
26716,2875,-1000.00,12000.00,13000.00,6407.17,7592.83,0.16,0
26717,2875,-1000.00,11000.00,12000.00,5338.23,5015.83,0.21,0
26718,2875,-1000.00,10000.00,11000.00,6230.39,5769.61,0.18,0
26719,2875,-1000.00,9000.00,10000.00,2448.49,8551.51,0.33,0
26720,2875,-1000.00,8000.00,9000.00,4272.54,5727.46,0.02,0
26721,2875,-1000.00,7000.00,8000.00,808.73,7638.34,0.43,0
26722,2875,-1000.00,6000.00,7000.00,3306.32,0.00,0.09,0
26723,2875,-1000.00,5000.00,6000.00,0.00,7000.00,0.32,0
26724,2876,-1000.00,-1000.00,0.00,474.41,459.82,0.22,0
26725,2877,-1000.00,-1000.00,0.00,433.69,566.31,0.08,0
26726,2878,-1000.00,-1000.00,0.00,108.66,891.34,0.42,0
26727,2879,-1000.00,-1000.00,0.00,0.00,1000.00,0.00,0
26728,2880,-1000.00,-1000.00,0.00,469.14,530.86,0.02,0
26729,2881,-1000.00,-1000.00,0.00,0.00,1000.00,0.02,0
26730,2882,-820.22,-820.22,179.78,8.08,812.14,0.42,0
26731,2882,-141.04,-961.26,38.74,0.00,141.04,0.39,0
26732,2882,-38.74,-1000.00,0.00,7.51,31.23,0.39,0
26733,2883,-1000.00,-1000.00,0.00,0.00,1000.00,0.31,0
26734,2884,0.00,0.00,1000.00,0.00,0.00,0.07,0
26735,2884,-1000.00,-1000.00,0.00,0.00,1000.00,0.14,0
26736,2885,-1000.00,-1000.00,0.00,532.95,467.05,0.18,0
26737,2886,-1000.00,-1000.00,0.00,0.00,626.30,0.38,0
26738,2887,-1000.00,-1000.00,0.00,0.00,220.82,0.19,0
26739,2888,-1000.00,-1000.00,0.00,214.13,785.87,0.10,0
26740,2889,-764.57,-764.57,235.43,0.00,764.57,0.41,0
26741,2889,-235.43,-1000.00,0.00,0.00,235.43,0.27,0
26742,2890,-803.79,-803.79,196.21,0.00,803.79,0.39,0
26743,2890,-196.21,-1000.00,0.00,60.62,135.59,0.35,0
26744,2891,0.00,0.00,1000.00,0.00,0.00,0.03,0
26745,2891,-1000.00,-1000.00,0.00,828.20,171.80,0.09,0
26746,2891,-0.00,-1000.00,-0.00,0.00,0.00,0.30,0
26747,2892,-1000.00,-1000.00,0.00,0.00,1000.00,0.13,0
26748,2893,1000.00,1000.00,2000.00,0.00,529.81,0.31,1
26749,2893,1000.00,2000.00,3000.00,0.00,2000.00,0.08,1
26750,2893,1000.00,3000.00,4000.00,0.00,3000.00,0.11,1
26751,2893,1000.00,4000.00,5000.00,0.00,4000.00,0.13,1
26752,2893,1000.00,5000.00,6000.00,2307.12,2692.88,0.11,1
26753,2893,1000.00,6000.00,7000.00,0.00,6000.00,0.02,1
26754,2893,1000.00,7000.00,8000.00,1536.11,2314.58,0.22,1
26755,2893,1000.00,8000.00,9000.00,0.00,6055.67,0.33,1
26756,2893,1000.00,9000.00,10000.00,3751.29,5248.71,0.43,1
26757,2893,1000.00,10000.00,11000.00,5000.00,5000.00,0.01,1
26758,2893,1000.00,11000.00,12000.00,5500.00,5500.00,0.01,1
26759,2893,1000.00,12000.00,13000.00,0.00,12000.00,0.27,1
26760,2893,1000.00,13000.00,14000.00,3136.69,9863.31,0.27,1
26761,2893,1000.00,14000.00,15000.00,1210.29,6692.26,0.30,1
26762,2893,-1000.00,13000.00,14000.00,8677.23,6322.77,0.17,0
26763,2893,1000.00,14000.00,15000.00,0.00,7403.12,0.20,1
26764,2893,-1000.00,13000.00,14000.00,4585.38,1354.65,0.07,0
26765,2893,1000.00,14000.00,15000.00,0.00,5668.82,0.10,1
26766,2893,1000.00,15000.00,16000.00,5503.37,9496.63,0.34,1
26767,2893,-1000.00,14000.00,15000.00,14494.28,1505.72,0.05,0
26768,2893,1000.00,15000.00,16000.00,5244.53,9755.47,0.31,1
26769,2893,1000.00,16000.00,17000.00,0.00,9753.16,0.33,1
26770,2893,-1000.00,15000.00,16000.00,8500.00,8500.00,0.12,0
26771,2893,-1000.00,14000.00,15000.00,589.04,13280.44,0.42,0
26772,2893,-1000.00,13000.00,14000.00,0.00,15000.00,0.08,0
26773,2893,-1000.00,12000.00,13000.00,0.00,14000.00,0.05,0
26774,2893,-1000.00,11000.00,12000.00,0.00,13000.00,0.38,0
26775,2893,-1000.00,10000.00,11000.00,0.00,12000.00,0.31,0
26776,2893,-1000.00,9000.00,10000.00,4096.37,6903.63,0.24,0
26777,2893,-1000.00,8000.00,9000.00,831.55,9168.45,0.44,0
26778,2893,-1000.00,7000.00,8000.00,350.77,8649.23,0.07,0
26779,2893,-1000.00,6000.00,7000.00,0.00,8000.00,0.09,0
26780,2893,-1000.00,5000.00,6000.00,0.00,7000.00,0.22,0
26781,2893,-1000.00,4000.00,5000.00,0.00,4987.36,0.08,0
26782,2893,-1000.00,3000.00,4000.00,0.00,5000.00,0.25,0
26783,2893,-1000.00,2000.00,3000.00,0.00,3156.27,0.40,0
26784,2893,-1000.00,1000.00,2000.00,0.00,3000.00,0.18,0
26785,2893,-1000.00,0.00,1000.00,477.16,1522.84,0.02,0
26786,2893,-1000.00,-1000.00,0.00,746.52,0.00,0.04,0
26787,2894,-1000.00,-1000.00,0.00,500.00,500.00,0.02,0
26788,2895,-459.36,-459.36,540.64,0.00,459.36,0.26,0
26789,2895,-540.64,-1000.00,0.00,0.00,540.64,0.07,0
26790,2896,-1000.00,-1000.00,0.00,0.00,1000.00,0.08,0
26791,2897,-113.71,-113.71,886.29,0.00,113.71,0.07,0
26792,2897,-1000.00,-1113.71,-113.71,540.94,345.35,0.09,0
26793,2898,-1000.00,-1000.00,0.00,391.37,608.63,0.28,0
26794,2899,1000.00,1000.00,2000.00,0.00,1000.00,0.11,1
26795,2899,1000.00,2000.00,3000.00,227.54,1772.46,0.39,1
26796,2899,1000.00,3000.00,4000.00,229.97,2770.03,0.43,1
26797,2899,1000.00,4000.00,5000.00,1395.40,2604.60,0.29,1
26798,2899,1000.00,5000.00,6000.00,671.21,4328.79,0.39,1
26799,2899,1000.00,6000.00,7000.00,0.00,5857.56,0.30,1
26800,2899,1000.00,7000.00,8000.00,0.00,364.17,0.10,1
26801,2899,1000.00,8000.00,9000.00,768.21,3147.57,0.27,1
26802,2899,1000.00,9000.00,10000.00,0.00,6018.40,0.32,1
26803,2899,1000.00,10000.00,11000.00,2932.59,7067.41,0.12,1
26804,2899,1000.00,11000.00,12000.00,5136.18,5863.82,0.10,1
26805,2899,-1000.00,10000.00,11000.00,9992.02,2007.98,0.13,0
26806,2899,1000.00,11000.00,12000.00,0.00,11000.00,0.14,1
26807,2899,1000.00,12000.00,13000.00,0.00,10666.35,0.43,1
26808,2899,1000.00,13000.00,14000.00,0.00,13000.00,0.11,1
26809,2899,1000.00,14000.00,15000.00,0.00,14000.00,0.26,1
26810,2899,1000.00,15000.00,16000.00,0.00,7880.09,0.32,1
26811,2899,1000.00,16000.00,17000.00,2446.13,10797.52,0.37,1
26812,2899,1000.00,17000.00,18000.00,0.00,17000.00,0.05,1
26813,2899,1000.00,18000.00,19000.00,0.00,9938.97,0.33,1
26814,2899,1000.00,19000.00,20000.00,9500.00,9500.00,0.02,1
26815,2899,1000.00,20000.00,21000.00,6847.42,13152.58,0.30,1
26816,2899,1000.00,21000.00,22000.00,258.59,20741.41,0.42,1
26817,2899,-1000.00,20000.00,21000.00,9221.70,623.28,0.09,0
26818,2899,-1000.00,19000.00,20000.00,12465.02,8534.98,0.22,0
26819,2899,-1000.00,18000.00,19000.00,0.00,17602.97,0.30,0
26820,2899,-1000.00,17000.00,18000.00,0.00,12897.14,0.14,0
26821,2899,-1000.00,16000.00,17000.00,0.00,14581.56,0.41,0
26822,2899,-1000.00,15000.00,16000.00,0.00,17000.00,0.34,0
26823,2899,-1000.00,14000.00,15000.00,0.00,3643.08,0.11,0
26824,2899,-1000.00,13000.00,14000.00,0.00,15000.00,0.17,0
26825,2899,-1000.00,12000.00,13000.00,0.00,6399.47,0.29,0
26826,2899,-1000.00,11000.00,12000.00,9846.62,3153.38,0.07,0
26827,2899,-1000.00,10000.00,11000.00,0.00,12000.00,0.29,0
26828,2899,-1000.00,9000.00,10000.00,4410.41,6589.59,0.13,0
26829,2899,-1000.00,8000.00,9000.00,4339.05,5660.95,0.07,0
26830,2899,-1000.00,7000.00,8000.00,4500.00,4500.00,0.08,0
26831,2899,-1000.00,6000.00,7000.00,2842.55,1147.92,0.13,0
26832,2899,-1000.00,5000.00,6000.00,568.53,6431.47,0.11,0
26833,2899,-1000.00,4000.00,5000.00,571.95,5428.05,0.43,0
26834,2899,-1000.00,3000.00,4000.00,0.00,5000.00,0.39,0
26835,2899,-974.01,2025.99,3025.99,18.76,955.25,0.16,0
26836,2899,-1000.00,1025.99,2025.99,0.00,3025.99,0.07,0
26837,2899,-705.35,320.64,1320.64,0.00,705.35,0.24,0
26838,2899,-1000.00,-679.36,320.64,633.40,687.24,0.04,0
26839,2899,-320.64,-1000.00,0.00,0.00,320.64,0.36,0
26840,2900,-1000.00,-1000.00,0.00,0.00,1000.00,0.36,0
26841,2901,-1000.00,-1000.00,0.00,440.76,559.24,0.17,0
26842,2902,1000.00,1000.00,2000.00,0.00,187.52,0.15,1
26843,2902,-743.64,256.36,1256.36,700.19,43.45,0.10,0
26844,2902,1000.00,1256.36,2256.36,0.00,627.16,0.24,1
26845,2902,-1000.00,256.36,1256.36,1873.70,382.66,0.06,0
26846,2902,-1000.00,-743.64,256.36,785.53,470.82,0.09,0
26847,2902,1000.00,256.36,1256.36,0.00,217.10,0.00,1
26848,2902,1000.00,1256.36,2256.36,0.00,1256.36,0.02,1
26849,2902,-1000.00,256.36,1256.36,1262.31,994.04,0.07,0
26850,2902,1000.00,1256.36,2256.36,0.00,1256.36,0.28,1
26851,2902,-379.70,876.66,1876.66,379.70,0.00,0.08,0
26852,2902,1000.00,1876.66,2876.66,528.32,1348.33,0.01,1
26853,2902,1000.00,2876.66,3876.66,0.00,2517.23,0.36,1
26854,2902,1000.00,3876.66,4876.66,1916.57,1960.09,0.37,1
26855,2902,1000.00,4876.66,5876.66,0.00,1431.69,0.22,1
26856,2902,1000.00,5876.66,6876.66,0.00,5763.16,0.15,1
26857,2902,1000.00,6876.66,7876.66,1000.06,4002.25,0.29,1
26858,2902,1000.00,7876.66,8876.66,0.00,7870.84,0.14,1
26859,2902,1000.00,8876.66,9876.66,0.00,8876.66,0.23,1
26860,2902,1000.00,9876.66,10876.66,4749.22,5127.44,0.12,1
26861,2902,-1000.00,8876.66,9876.66,6195.43,4681.23,0.06,0
26862,2902,-1000.00,7876.66,8876.66,5646.87,4229.79,0.27,0
26863,2902,1000.00,8876.66,9876.66,0.00,8876.66,0.25,1
26864,2902,1000.00,9876.66,10876.66,3618.74,6257.92,0.28,1
26865,2902,1000.00,10876.66,11876.66,0.00,1524.43,0.15,1
26866,2902,1000.00,11876.66,12876.66,2155.97,8212.31,0.37,1
26867,2902,1000.00,12876.66,13876.66,3009.01,7653.14,0.33,1
26868,2902,1000.00,13876.66,14876.66,0.00,13876.66,0.32,1
26869,2902,1000.00,14876.66,15876.66,4908.92,9967.74,0.31,1
26870,2902,0.00,14876.66,15876.66,0.00,0.00,0.01,0
26871,2902,1000.00,15876.66,16876.66,6586.24,9290.42,0.27,1
26872,2902,1000.00,16876.66,17876.66,0.00,14894.86,0.11,1
26873,2902,1000.00,17876.66,18876.66,0.00,17876.66,0.35,1
26874,2902,1000.00,18876.66,19876.66,0.00,18876.66,0.20,1
26875,2902,1000.00,19876.66,20876.66,6848.20,13028.46,0.18,1
26876,2902,1000.00,20876.66,21876.66,0.00,19039.06,0.39,1
26877,2902,1000.00,21876.66,22876.66,0.00,14513.21,0.06,1
26878,2902,0.00,21876.66,22876.66,0.00,0.00,0.02,0
26879,2902,1000.00,22876.66,23876.66,0.00,12253.46,0.32,1
26880,2902,1000.00,23876.66,24876.66,0.00,22301.21,0.08,1
26881,2902,1000.00,24876.66,25876.66,12438.33,12438.33,0.06,1
26882,2902,1000.00,25876.66,26876.66,0.00,25876.66,0.03,1
26883,2902,1000.00,26876.66,27876.66,0.00,26876.66,0.20,1
26884,2902,1000.00,27876.66,28876.66,8220.89,15618.14,0.30,1
26885,2902,-1000.00,26876.66,27876.66,14383.44,3977.09,0.11,0
26886,2902,-1000.00,25876.66,26876.66,13938.33,13938.33,0.00,0
26887,2902,-1000.00,24876.66,25876.66,0.00,6800.36,0.10,0
26888,2902,-1000.00,23876.66,24876.66,0.00,23524.25,0.07,0
26889,2902,-1000.00,22876.66,23876.66,6775.10,14232.30,0.22,0
26890,2902,-1000.00,21876.66,22876.66,2502.07,0.00,0.07,0
26891,2902,-1000.00,20876.66,21876.66,0.00,22876.66,0.05,0
26892,2902,-1000.00,19876.66,20876.66,10938.33,10938.33,0.09,0
26893,2902,-1000.00,18876.66,19876.66,9759.75,11116.90,0.11,0
26894,2902,-1000.00,17876.66,18876.66,9938.33,9938.33,0.06,0
26895,2902,-1000.00,16876.66,17876.66,0.00,18876.66,0.18,0
26896,2902,-1000.00,15876.66,16876.66,2568.52,11707.74,0.36,0
26897,2902,-1000.00,14876.66,15876.66,0.00,16876.66,0.03,0
26898,2902,-1000.00,13876.66,14876.66,5882.02,9994.64,0.26,0
26899,2902,-1000.00,12876.66,13876.66,0.00,12891.57,0.33,0
26900,2902,-1000.00,11876.66,12876.66,0.00,13876.66,0.38,0
26901,2902,-1000.00,10876.66,11876.66,7877.18,4999.48,0.20,0
26902,2902,-1000.00,9876.66,10876.66,0.00,10738.76,0.41,0
26903,2902,-1000.00,8876.66,9876.66,8237.86,2638.79,0.04,0
26904,2902,-1000.00,7876.66,8876.66,0.00,8876.25,0.37,0
26905,2902,-1000.00,6876.66,7876.66,2727.06,6149.60,0.34,0
26906,2902,-1000.00,5876.66,6876.66,3546.94,4329.72,0.17,0
26907,2902,-1000.00,4876.66,5876.66,0.00,6876.66,0.26,0
26908,2902,-1000.00,3876.66,4876.66,569.37,5307.29,0.42,0
26909,2902,-1000.00,2876.66,3876.66,1000.93,3875.73,0.40,0
26910,2903,-1000.00,-1000.00,0.00,535.36,464.64,0.16,0
26911,2904,-746.03,-746.03,253.97,0.00,746.03,0.40,0
26912,2904,-253.97,-1000.00,0.00,65.78,188.19,0.37,0
26913,2905,-1000.00,-1000.00,0.00,0.00,468.22,0.34,0
26914,2906,1000.00,1000.00,2000.00,519.66,0.00,0.03,1
26915,2906,1000.00,2000.00,3000.00,1205.11,794.89,0.10,1
26916,2906,-1000.00,1000.00,2000.00,62.71,2937.29,0.12,0
26917,2906,-1000.00,0.00,1000.00,0.00,2000.00,0.17,0
26918,2906,-1000.00,-1000.00,0.00,119.96,880.04,0.41,0
26919,2906,-0.00,-1000.00,0.00,0.00,0.00,0.08,0
26920,2907,1000.00,1000.00,2000.00,0.00,384.23,0.24,1
26921,2907,0.00,1000.00,2000.00,0.00,0.00,0.09,0
26922,2907,1000.00,2000.00,3000.00,0.00,1326.72,0.37,1
26923,2907,1000.00,3000.00,4000.00,1354.65,1645.35,0.13,1
26924,2907,1000.00,4000.00,5000.00,658.45,3341.55,0.29,1
26925,2907,1000.00,5000.00,6000.00,0.00,66.35,0.11,1
26926,2907,1000.00,6000.00,7000.00,749.86,5250.14,0.22,1
26927,2907,1000.00,7000.00,8000.00,0.00,7000.00,0.12,1
26928,2907,1000.00,8000.00,9000.00,1282.88,6717.12,0.13,1
26929,2907,-1000.00,7000.00,8000.00,2596.80,2292.88,0.18,0
26930,2907,1000.00,8000.00,9000.00,0.00,5796.11,0.33,1
26931,2907,1000.00,9000.00,10000.00,1011.89,7988.11,0.44,1
26932,2907,1000.00,10000.00,11000.00,0.00,9981.12,0.44,1
26933,2907,1000.00,11000.00,12000.00,5242.57,5757.43,0.14,1
26934,2907,-1000.00,10000.00,11000.00,7713.24,4286.76,0.33,0
26935,2907,1000.00,11000.00,12000.00,5500.00,5500.00,0.11,1
26936,2907,1000.00,12000.00,13000.00,0.00,12000.00,0.16,1
26937,2907,1000.00,13000.00,14000.00,0.00,534.78,0.08,1
26938,2907,1000.00,14000.00,15000.00,0.00,14000.00,0.05,1
26939,2907,1000.00,15000.00,16000.00,0.00,10058.58,0.32,1
26940,2907,-1.73,14998.27,15998.27,1.73,0.00,0.07,0
26941,2907,1000.00,15998.27,16998.27,4888.40,11109.87,0.03,1
26942,2907,1000.00,16998.27,17998.27,0.00,15860.71,0.31,1
26943,2907,1000.00,17998.27,18998.27,4567.03,13431.24,0.18,1
26944,2907,-1000.00,16998.27,17998.27,6085.53,12912.74,0.27,0
26945,2907,-1000.00,15998.27,16998.27,0.00,3903.26,0.21,0
26946,2907,-1000.00,14998.27,15998.27,1655.02,0.00,0.06,0
26947,2907,-1000.00,13998.27,14998.27,1607.80,2590.48,0.42,0
26948,2907,0.00,13998.27,14998.27,0.00,0.00,0.12,0
26949,2907,0.00,13998.27,14998.27,0.00,0.00,0.36,0
26950,2907,-1000.00,12998.27,13998.27,8149.08,5437.38,0.25,0
26951,2907,-1000.00,11998.27,12998.27,5356.01,4095.99,0.32,0
26952,2907,-1000.00,10998.27,11998.27,3157.65,9840.62,0.42,0
26953,2907,-1000.00,9998.27,10998.27,4489.58,3870.42,0.21,0
26954,2908,1000.00,1000.00,2000.00,546.60,0.00,0.27,1
26955,2908,-884.56,115.44,1115.44,133.00,751.56,0.38,0
26956,2908,1000.00,1115.44,2115.44,385.85,241.18,0.36,1
26957,2908,-930.46,184.98,1184.98,0.00,930.46,0.35,0
26958,2908,0.00,184.98,1184.98,0.00,0.00,0.13,0
26959,2908,-1000.00,-815.02,184.98,0.00,1184.98,0.00,0
26960,2908,1000.00,184.98,1184.98,44.35,0.00,0.37,1
26961,2908,1000.00,1184.98,2184.98,469.68,0.00,0.31,1
26962,2908,1000.00,2184.98,3184.98,52.24,0.00,0.44,1
26963,2908,0.00,2184.98,3184.98,0.00,0.00,0.02,0
26964,2908,1000.00,3184.98,4184.98,935.39,336.84,0.39,1
26965,2908,-1000.00,2184.98,3184.98,0.00,3601.21,0.09,0
26966,2908,0.00,2184.98,3184.98,0.00,0.00,0.25,0
26967,2908,1000.00,3184.98,4184.98,606.61,143.98,0.42,1
26968,2908,-1000.00,2184.98,3184.98,0.00,1618.73,0.36,0
26969,2908,-1000.00,1184.98,2184.98,639.78,1061.42,0.36,0
26970,2908,-20.23,1164.75,2164.75,0.00,20.23,0.41,0
26971,2908,1000.00,2164.75,3164.75,1513.25,0.00,0.20,1
26972,2908,1000.00,3164.75,4164.75,136.91,0.00,0.39,1
26973,2908,0.00,3164.75,4164.75,0.00,0.00,0.09,0
26974,2908,-1000.00,2164.75,3164.75,0.00,3068.39,0.19,0
26975,2908,-1000.00,1164.75,2164.75,1019.48,99.69,0.38,0
26976,2908,-1000.00,164.75,1164.75,0.00,911.91,0.29,0
26977,2908,-1000.00,-835.25,164.75,0.00,93.67,0.04,0
26978,2908,0.00,-835.25,164.75,0.00,0.00,0.08,0
26979,2908,0.00,-835.25,164.75,0.00,0.00,0.03,0
26980,2908,-1000.00,-1835.25,-835.25,0.00,92.68,0.15,0
26981,2909,-1000.00,-1000.00,0.00,500.71,499.29,0.07,0
26982,2910,1000.00,1000.00,2000.00,462.00,538.00,0.03,1
26983,2910,1000.00,2000.00,3000.00,7.52,1992.48,0.37,1
26984,2910,1000.00,3000.00,4000.00,1177.88,1822.12,0.22,1
26985,2910,1000.00,4000.00,5000.00,126.89,776.44,0.18,1
26986,2910,1000.00,5000.00,6000.00,962.33,3055.38,0.35,1
26987,2910,1000.00,6000.00,7000.00,1214.27,4785.73,0.33,1
26988,2910,1000.00,7000.00,8000.00,0.00,6433.62,0.44,1
26989,2910,1000.00,8000.00,9000.00,0.00,8000.00,0.04,1
26990,2910,1000.00,9000.00,10000.00,0.00,9000.00,0.15,1
26991,2910,-1000.00,8000.00,9000.00,4872.20,0.00,0.06,0
26992,2910,1000.00,9000.00,10000.00,4109.40,4890.60,0.20,1
26993,2910,1000.00,10000.00,11000.00,0.00,10000.00,0.16,1
26994,2910,1000.00,11000.00,12000.00,0.00,11000.00,0.40,1
26995,2910,1000.00,12000.00,13000.00,1506.87,10493.13,0.22,1
26996,2910,1000.00,13000.00,14000.00,0.00,13000.00,0.15,1
26997,2910,-1000.00,12000.00,13000.00,7353.75,6646.25,0.18,0
26998,2910,1000.00,13000.00,14000.00,0.00,13000.00,0.07,1
26999,2910,1000.00,14000.00,15000.00,43.12,13956.88,0.02,1
27000,2910,1000.00,15000.00,16000.00,0.00,15000.00,0.41,1
27001,2910,1000.00,16000.00,17000.00,2211.69,13788.31,0.42,1
27002,2910,1000.00,17000.00,18000.00,0.00,17000.00,0.41,1
27003,2910,1000.00,18000.00,19000.00,2539.73,15460.27,0.17,1
27004,2910,1000.00,19000.00,20000.00,4578.22,14421.78,0.20,1
27005,2910,-1000.00,18000.00,19000.00,12259.06,7740.94,0.30,0
27006,2910,1000.00,19000.00,20000.00,0.00,17824.36,0.44,1
27007,2910,1000.00,20000.00,21000.00,2203.88,14214.03,0.39,1
27008,2910,-1000.00,19000.00,20000.00,8359.35,3397.84,0.13,0
27009,2910,1000.00,20000.00,21000.00,6259.39,13740.61,0.19,1
27010,2910,-1000.00,19000.00,20000.00,11057.42,9942.58,0.02,0
27011,2910,-1000.00,18000.00,19000.00,15006.19,2628.83,0.07,0
27012,2910,-1000.00,17000.00,18000.00,10028.28,8971.72,0.31,0
27013,2910,-1000.00,16000.00,17000.00,9196.91,8803.09,0.20,0
27014,2910,-1000.00,15000.00,16000.00,10328.47,6671.53,0.37,0
27015,2910,1000.00,16000.00,17000.00,0.00,16000.00,0.24,1
27016,2910,1000.00,17000.00,18000.00,0.00,17000.00,0.35,1
27017,2910,1000.00,18000.00,19000.00,0.00,18000.00,0.12,1
27018,2910,1000.00,19000.00,20000.00,7707.89,11054.13,0.28,1
27019,2910,1000.00,20000.00,21000.00,2152.55,17847.45,0.33,1
27020,2910,1000.00,21000.00,22000.00,6237.39,7730.36,0.23,1
27021,2910,1000.00,22000.00,23000.00,0.00,14177.32,0.32,1
27022,2910,1000.00,23000.00,24000.00,9796.99,13203.01,0.08,1
27023,2910,1000.00,24000.00,25000.00,0.00,24000.00,0.09,1
27024,2910,1000.00,25000.00,26000.00,0.00,25000.00,0.22,1
27025,2910,1000.00,26000.00,27000.00,2934.12,23065.88,0.39,1
27026,2910,1000.00,27000.00,28000.00,2449.63,24550.37,0.41,1
27027,2911,1000.00,1000.00,2000.00,0.00,1000.00,0.17,1
27028,2911,1000.00,2000.00,3000.00,0.00,2000.00,0.06,1
27029,2911,1000.00,3000.00,4000.00,0.00,3000.00,0.17,1
27030,2911,1000.00,4000.00,5000.00,2000.00,2000.00,0.01,1
27031,2911,1000.00,5000.00,6000.00,0.00,4101.21,0.27,1
27032,2911,1000.00,6000.00,7000.00,0.00,4649.13,0.37,1
27033,2911,1000.00,7000.00,8000.00,3282.66,3717.34,0.09,1
27034,2911,-1000.00,6000.00,7000.00,4362.59,3637.41,0.19,0
27035,2911,1000.00,7000.00,8000.00,0.00,7000.00,0.03,1
27036,2911,1000.00,8000.00,9000.00,0.00,4638.56,0.28,1
27037,2911,1000.00,9000.00,10000.00,0.00,9000.00,0.11,1
27038,2911,1000.00,10000.00,11000.00,0.00,10000.00,0.25,1
27039,2911,1000.00,11000.00,12000.00,3364.36,7635.64,0.15,1
27040,2911,1000.00,12000.00,13000.00,3228.39,8771.61,0.19,1
27041,2911,-1000.00,11000.00,12000.00,1117.90,404.27,0.12,0
27042,2911,1000.00,12000.00,13000.00,1467.33,10532.67,0.26,1
27043,2911,1000.00,13000.00,14000.00,888.44,12111.56,0.42,1
27044,2911,1000.00,14000.00,15000.00,6864.03,7135.97,0.12,1
27045,2911,1000.00,15000.00,16000.00,2368.00,12632.00,0.34,1
27046,2911,-1000.00,14000.00,15000.00,10169.79,5830.21,0.30,0
27047,2911,-1000.00,13000.00,14000.00,1380.08,1069.43,0.13,0
27048,2911,1000.00,14000.00,15000.00,7000.00,7000.00,0.17,1
27049,2911,1000.00,15000.00,16000.00,7309.58,7690.42,0.11,1
27050,2911,1000.00,16000.00,17000.00,0.00,13843.64,0.10,1
27051,2911,1000.00,17000.00,18000.00,0.00,17000.00,0.37,1
27052,2911,1000.00,18000.00,19000.00,396.38,17603.62,0.42,1
27053,2911,1000.00,19000.00,20000.00,0.00,19000.00,0.19,1
27054,2911,-1000.00,18000.00,19000.00,2991.74,0.00,0.07,0
27055,2911,1000.00,19000.00,20000.00,0.00,19000.00,0.20,1
27056,2911,1000.00,20000.00,21000.00,10000.00,10000.00,0.09,1
27057,2911,1000.00,21000.00,22000.00,8462.08,12537.92,0.38,1
27058,2911,1000.00,22000.00,23000.00,1750.36,20249.64,0.24,1
27059,2911,1000.00,23000.00,24000.00,9364.59,13635.41,0.13,1
27060,2911,-1000.00,22000.00,23000.00,13682.19,10317.81,0.18,0
27061,2911,1000.00,23000.00,24000.00,0.00,6613.20,0.21,1
27062,2911,1000.00,24000.00,25000.00,2938.98,10943.19,0.30,1
27063,2911,1000.00,25000.00,26000.00,2067.43,22932.57,0.34,1
27064,2911,-1000.00,24000.00,25000.00,13073.46,12926.54,0.01,0
27065,2911,-1000.00,23000.00,24000.00,17442.22,0.00,0.03,0
27066,2911,1000.00,24000.00,25000.00,12000.00,12000.00,0.06,1
27067,2911,-1000.00,23000.00,24000.00,17587.66,7412.34,0.26,0
27068,2911,-1000.00,22000.00,23000.00,12115.47,11884.53,0.05,0
27069,2911,-1000.00,21000.00,22000.00,14237.41,8762.59,0.18,0
27070,2912,-1000.00,-1000.00,0.00,112.03,452.65,0.43,0
27071,2913,-1000.00,-1000.00,0.00,387.79,612.21,0.05,0
27072,2914,1000.00,1000.00,2000.00,0.00,261.39,0.22,1
27073,2914,1000.00,2000.00,3000.00,0.00,1356.05,0.33,1
27074,2914,1000.00,3000.00,4000.00,0.00,3000.00,0.35,1
27075,2914,1000.00,4000.00,5000.00,0.00,2549.05,0.35,1
27076,2914,1000.00,5000.00,6000.00,0.00,4805.00,0.39,1
27077,2914,1000.00,6000.00,7000.00,0.00,6000.00,0.23,1
27078,2914,1000.00,7000.00,8000.00,0.00,7000.00,0.11,1
27079,2914,1000.00,8000.00,9000.00,1913.03,6086.97,0.39,1
27080,2914,1000.00,9000.00,10000.00,0.00,5106.91,0.07,1
27081,2914,-1000.00,8000.00,9000.00,7626.01,0.00,0.07,0
27082,2914,1000.00,9000.00,10000.00,1321.08,7129.62,0.40,1
27083,2914,1000.00,10000.00,11000.00,4580.74,5419.26,0.14,1
27084,2914,1000.00,11000.00,12000.00,4048.18,6951.82,0.23,1
27085,2914,1000.00,12000.00,13000.00,0.00,12000.00,0.44,1
27086,2914,1000.00,13000.00,14000.00,0.00,13000.00,0.41,1
27087,2914,1000.00,14000.00,15000.00,2378.08,8069.30,0.34,1
27088,2914,1000.00,15000.00,16000.00,0.00,4174.12,0.07,1
27089,2914,1000.00,16000.00,17000.00,5979.48,10020.52,0.18,1
27090,2914,1000.00,17000.00,18000.00,7255.19,9744.81,0.27,1
27091,2914,1000.00,18000.00,19000.00,382.43,17617.57,0.30,1
27092,2914,1000.00,19000.00,20000.00,9498.70,9501.30,0.08,1
27093,2914,-1000.00,18000.00,19000.00,10000.00,10000.00,0.33,0
27094,2914,-1000.00,17000.00,18000.00,4103.19,14896.81,0.30,0
27095,2914,-1000.00,16000.00,17000.00,7618.35,10381.65,0.28,0
27096,2914,-1000.00,15000.00,16000.00,4889.68,12110.32,0.36,0
27097,2914,-1000.00,14000.00,15000.00,4780.43,11219.57,0.32,0
27098,2914,-1000.00,13000.00,14000.00,2708.61,12291.39,0.41,0
27099,2914,-1000.00,12000.00,13000.00,0.00,4882.01,0.25,0
27100,2914,-1000.00,11000.00,12000.00,0.00,13000.00,0.33,0
27101,2914,-1000.00,10000.00,11000.00,2949.25,9050.75,0.36,0
27102,2914,-1000.00,9000.00,10000.00,0.00,5367.31,0.18,0
27103,2914,-1000.00,8000.00,9000.00,0.00,10000.00,0.15,0
27104,2914,-1000.00,7000.00,8000.00,0.00,2055.76,0.11,0
27105,2914,-1000.00,6000.00,7000.00,0.00,8000.00,0.32,0
27106,2914,-1000.00,5000.00,6000.00,3446.19,3553.81,0.21,0
27107,2914,-1000.00,4000.00,5000.00,269.15,5730.85,0.42,0
27108,2914,-1000.00,3000.00,4000.00,0.00,5000.00,0.22,0
27109,2914,-1000.00,2000.00,3000.00,2755.53,529.90,0.08,0
27110,2914,-1000.00,1000.00,2000.00,0.00,3000.00,0.24,0
27111,2914,1000.00,2000.00,3000.00,627.12,1372.88,0.07,1
27112,2914,1000.00,3000.00,4000.00,1238.05,1761.95,0.13,1
27113,2914,-1000.00,2000.00,3000.00,3013.50,986.50,0.07,0
27114,2914,0.00,2000.00,3000.00,0.00,0.00,0.06,0
27115,2914,1000.00,3000.00,4000.00,444.06,2555.94,0.20,1
27116,2914,0.00,3000.00,4000.00,0.00,0.00,0.01,0
27117,2914,1000.00,4000.00,5000.00,0.00,4000.00,0.28,1
27118,2914,1000.00,5000.00,6000.00,0.00,929.33,0.06,1
27119,2914,1000.00,6000.00,7000.00,1008.71,4991.29,0.26,1
27120,2914,1000.00,7000.00,8000.00,0.00,7000.00,0.37,1
27121,2914,1000.00,8000.00,9000.00,0.00,8000.00,0.40,1
27122,2914,-1000.00,7000.00,8000.00,6005.76,2994.24,0.10,0
27123,2914,1000.00,8000.00,9000.00,788.87,7211.13,0.35,1
27124,2914,1000.00,9000.00,10000.00,0.00,7467.17,0.42,1
27125,2914,1000.00,10000.00,11000.00,0.00,10000.00,0.12,1
27126,2914,1000.00,11000.00,12000.00,1712.44,9287.56,0.18,1
27127,2914,1000.00,12000.00,13000.00,0.00,12000.00,0.15,1
27128,2914,-464.43,11535.57,12535.57,464.43,0.00,0.04,0
27129,2914,1000.00,12535.57,13535.57,0.00,3247.98,0.21,1
27130,2914,1000.00,13535.57,14535.57,0.00,13535.57,0.01,1
27131,2914,-1000.00,12535.57,13535.57,9575.01,4960.55,0.09,0
27132,2914,1000.00,13535.57,14535.57,2077.48,9546.58,0.38,1
27133,2915,1000.00,1000.00,2000.00,641.35,358.65,0.12,1
27134,2915,-1000.00,0.00,1000.00,0.00,1539.78,0.35,0
27135,2915,-1000.00,-1000.00,0.00,282.88,717.12,0.33,0
27136,2916,1000.00,1000.00,2000.00,400.64,567.01,0.29,1
27137,2916,-1000.00,0.00,1000.00,1267.21,732.79,0.07,0
27138,2916,1000.00,1000.00,2000.00,0.00,1000.00,0.07,1
27139,2916,1000.00,2000.00,3000.00,238.41,1649.96,0.17,1
27140,2916,1000.00,3000.00,4000.00,0.00,2685.75,0.35,1
27141,2916,-1000.00,2000.00,3000.00,2068.40,1931.60,0.20,0
27142,2916,1000.00,3000.00,4000.00,0.00,3000.00,0.38,1
27143,2916,1000.00,4000.00,5000.00,1528.36,2471.64,0.16,1
27144,2916,1000.00,5000.00,6000.00,0.00,4594.30,0.44,1
27145,2916,1000.00,6000.00,7000.00,821.17,4789.59,0.41,1
27146,2916,1000.00,7000.00,8000.00,0.00,6774.11,0.28,1
27147,2916,1000.00,8000.00,9000.00,3486.15,4513.85,0.26,1
27148,2916,1000.00,9000.00,10000.00,3746.23,4757.58,0.27,1
27149,2916,1000.00,10000.00,11000.00,0.00,10000.00,0.09,1
27150,2916,1000.00,11000.00,12000.00,2826.66,8173.34,0.27,1
27151,2916,1000.00,12000.00,13000.00,6000.00,6000.00,0.04,1
27152,2916,-1000.00,11000.00,12000.00,10820.82,0.00,0.04,0
27153,2916,1000.00,12000.00,13000.00,0.00,7663.39,0.08,1
27154,2916,1000.00,13000.00,14000.00,0.00,9126.70,0.38,1
27155,2916,-1000.00,12000.00,13000.00,7032.90,6967.10,0.22,0
27156,2916,1000.00,13000.00,14000.00,3136.99,9863.01,0.39,1
27157,2916,1000.00,14000.00,15000.00,6851.61,7148.39,0.10,1
27158,2916,1000.00,15000.00,16000.00,4344.94,10655.06,0.25,1
27159,2916,1000.00,16000.00,17000.00,0.00,16000.00,0.14,1
27160,2916,-1000.00,15000.00,16000.00,0.00,6261.75,0.08,0
27161,2916,-1000.00,14000.00,15000.00,4829.96,3273.87,0.16,0
27162,2916,-1000.00,13000.00,14000.00,3903.39,11096.61,0.23,0
27163,2916,-1000.00,12000.00,13000.00,8431.05,5568.95,0.14,0
27164,2916,-1000.00,11000.00,12000.00,0.00,8845.04,0.30,0
27165,2916,-1000.00,10000.00,11000.00,0.00,10716.30,0.43,0
27166,2916,-1000.00,9000.00,10000.00,0.00,11000.00,0.17,0
27167,2916,-1000.00,8000.00,9000.00,0.00,4737.23,0.13,0
27168,2916,-1000.00,7000.00,8000.00,0.00,9000.00,0.31,0
27169,2916,-1000.00,6000.00,7000.00,3679.79,4320.21,0.34,0
27170,2916,0.00,6000.00,7000.00,0.00,0.00,0.01,0
27171,2916,-1000.00,5000.00,6000.00,3762.37,3237.63,0.19,0
27172,2916,-1000.00,4000.00,5000.00,0.00,6000.00,0.30,0
27173,2916,-1000.00,3000.00,4000.00,0.00,4832.56,0.44,0
27174,2916,-1000.00,2000.00,3000.00,372.00,0.00,0.06,0
27175,2916,-1000.00,1000.00,2000.00,0.00,2479.24,0.40,0
27176,2916,-1000.00,0.00,1000.00,839.06,1160.94,0.18,0
27177,2916,-1000.00,-1000.00,0.00,0.00,1000.00,0.24,0
27178,2917,-1000.00,-1000.00,0.00,487.57,512.43,0.24,0
27179,2918,0.00,0.00,1000.00,0.00,0.00,0.08,0
27180,2918,-1000.00,-1000.00,0.00,0.00,1000.00,0.01,0
27181,2919,-690.34,-690.34,309.66,0.00,690.34,0.11,0
27182,2919,1000.00,309.66,1309.66,161.95,147.71,0.05,1
27183,2919,1000.00,1309.66,2309.66,1147.03,0.00,0.15,1
27184,2919,-165.05,1144.61,2144.61,0.00,165.05,0.01,0
27185,2919,-1000.00,144.61,1144.61,468.73,1675.88,0.37,0
27186,2919,-1000.00,-855.39,144.61,572.31,572.31,0.06,0
27187,2919,0.00,-855.39,144.61,0.00,0.00,0.25,0
27188,2919,-45.73,-901.12,98.88,0.00,45.73,0.19,0
27189,2919,-98.88,-1000.00,0.00,47.40,51.48,0.36,0
27190,2920,-1000.00,-1000.00,0.00,0.00,1000.00,0.29,0
27191,2921,-636.79,-636.79,363.21,106.43,530.36,0.32,0
27192,2921,-363.21,-1000.00,0.00,0.00,363.21,0.40,0
27193,2922,-1000.00,-1000.00,0.00,782.97,217.03,0.06,0
27194,2923,-755.26,-755.26,244.74,292.87,462.39,0.27,0
27195,2923,-74.09,-829.35,170.65,0.00,74.09,0.23,0
27196,2923,-170.65,-1000.00,0.00,0.00,170.65,0.02,0
27197,2924,-1000.00,-1000.00,0.00,0.00,188.38,0.12,0
27198,2925,-1000.00,-1000.00,0.00,0.00,1000.00,0.26,0
27199,2926,-1000.00,-1000.00,0.00,634.61,365.39,0.14,0
27200,2927,1000.00,1000.00,2000.00,0.00,1000.00,0.26,1
27201,2927,1000.00,2000.00,3000.00,0.00,1500.60,0.17,1
27202,2927,-1000.00,1000.00,2000.00,1749.75,1250.25,0.17,0
27203,2927,1000.00,2000.00,3000.00,0.00,2000.00,0.39,1
27204,2927,1000.00,3000.00,4000.00,0.00,2387.89,0.40,1
27205,2927,1000.00,4000.00,5000.00,1700.38,2299.62,0.23,1
27206,2927,1000.00,5000.00,6000.00,1702.98,3297.02,0.08,1
27207,2927,1000.00,6000.00,7000.00,0.00,6000.00,0.01,1
27208,2927,1000.00,7000.00,8000.00,0.00,7000.00,0.19,1
27209,2927,1000.00,8000.00,9000.00,0.00,3968.36,0.14,1
27210,2927,1000.00,9000.00,10000.00,0.00,9000.00,0.06,1
27211,2927,1000.00,10000.00,11000.00,3887.47,6112.53,0.19,1
27212,2927,1000.00,11000.00,12000.00,0.00,11000.00,0.34,1
27213,2927,1000.00,12000.00,13000.00,0.00,12000.00,0.13,1
27214,2927,1000.00,13000.00,14000.00,120.71,12879.29,0.41,1
27215,2927,0.00,13000.00,14000.00,0.00,0.00,0.04,0
27216,2927,1000.00,14000.00,15000.00,7000.00,7000.00,0.16,1
27217,2927,-1000.00,13000.00,14000.00,8173.23,6826.77,0.15,0
27218,2927,1000.00,14000.00,15000.00,2885.10,11114.90,0.39,1
27219,2927,-1000.00,13000.00,14000.00,7500.00,7500.00,0.08,0
27220,2927,-1000.00,12000.00,13000.00,6372.94,7627.06,0.09,0
27221,2927,-1000.00,11000.00,12000.00,3017.26,9982.74,0.39,0
27222,2927,-1000.00,10000.00,11000.00,0.00,12000.00,0.22,0
27223,2927,-1000.00,9000.00,10000.00,5500.00,5500.00,0.08,0
27224,2927,-1000.00,8000.00,9000.00,0.00,10000.00,0.13,0
27225,2927,-1000.00,7000.00,8000.00,0.00,9000.00,0.21,0
27226,2927,-1000.00,6000.00,7000.00,0.00,8000.00,0.32,0
27227,2927,-1000.00,5000.00,6000.00,1507.00,4266.46,0.34,0
27228,2927,-1000.00,4000.00,5000.00,0.00,4241.49,0.20,0
27229,2927,-1000.00,3000.00,4000.00,0.00,3631.48,0.40,0
27230,2927,-1000.00,2000.00,3000.00,0.00,4000.00,0.29,0
27231,2927,-1000.00,1000.00,2000.00,0.00,2578.24,0.36,0
27232,2927,-1000.00,0.00,1000.00,932.12,1067.88,0.19,0
27233,2927,-450.11,-450.11,549.89,203.57,246.54,0.19,0
27234,2927,-1000.00,-1450.11,-450.11,264.04,0.00,0.06,0
27235,2928,-837.34,-837.34,162.66,0.00,837.34,0.26,0
27236,2928,-121.63,-958.97,41.03,0.00,121.63,0.40,0
27237,2928,-34.56,-993.52,6.48,7.14,27.42,0.36,0
27238,2928,-123.03,-1116.55,-116.55,0.73,0.00,0.08,0
27239,2929,1000.00,1000.00,2000.00,0.00,669.50,0.34,1
27240,2929,-257.46,742.54,1742.54,257.46,0.00,0.09,0
27241,2929,1000.00,1742.54,2742.54,0.00,1742.54,0.30,1
27242,2929,1000.00,2742.54,3742.54,0.00,1903.27,0.38,1
27243,2929,1000.00,3742.54,4742.54,0.00,3742.54,0.27,1
27244,2929,1000.00,4742.54,5742.54,2014.52,2728.02,0.22,1
27245,2929,1000.00,5742.54,6742.54,0.00,5742.54,0.44,1
27246,2929,-1000.00,4742.54,5742.54,6742.54,0.00,0.03,0
27247,2929,1000.00,5742.54,6742.54,1986.65,3755.89,0.22,1
27248,2929,1000.00,6742.54,7742.54,0.00,6742.54,0.20,1
27249,2929,1000.00,7742.54,8742.54,2851.87,3801.65,0.26,1
27250,2929,1000.00,8742.54,9742.54,0.00,3337.59,0.11,1
27251,2929,1000.00,9742.54,10742.54,4871.27,4871.27,0.23,1
27252,2929,1000.00,10742.54,11742.54,0.00,8430.81,0.40,1
27253,2929,1000.00,11742.54,12742.54,3357.08,8385.46,0.35,1
27254,2929,1000.00,12742.54,13742.54,3412.64,9329.90,0.36,1
27255,2929,1000.00,13742.54,14742.54,2938.44,10804.10,0.15,1
27256,2929,-1000.00,12742.54,13742.54,11603.32,3139.22,0.15,0
27257,2929,1000.00,13742.54,14742.54,3266.05,10476.49,0.39,1
27258,2929,1000.00,14742.54,15742.54,1635.13,13107.41,0.12,1
27259,2929,1000.00,15742.54,16742.54,2196.31,13546.23,0.33,1
27260,2929,1000.00,16742.54,17742.54,0.00,16742.54,0.39,1
27261,2929,1000.00,17742.54,18742.54,5035.14,12707.40,0.31,1
27262,2929,1000.00,18742.54,19742.54,0.00,17130.59,0.39,1
27263,2929,1000.00,19742.54,20742.54,0.00,19742.54,0.08,1
27264,2929,1000.00,20742.54,21742.54,0.00,20742.54,0.35,1
27265,2929,-1000.00,19742.54,20742.54,12167.05,8505.57,0.17,0
27266,2929,1000.00,20742.54,21742.54,8331.80,12410.73,0.23,1
27267,2929,0.00,20742.54,21742.54,0.00,0.00,0.05,0
27268,2929,-1000.00,19742.54,20742.54,16996.21,0.00,0.02,0
27269,2929,1000.00,20742.54,21742.54,0.00,12246.74,0.32,1
27270,2929,1000.00,21742.54,22742.54,5468.08,16274.46,0.03,1
27271,2929,1000.00,22742.54,23742.54,9792.17,12950.37,0.13,1
27272,2929,1000.00,23742.54,24742.54,0.00,11453.01,0.30,1
27273,2929,1000.00,24742.54,25742.54,9580.37,15162.17,0.01,1
27274,2929,0.00,24742.54,25742.54,0.00,0.00,0.02,0
27275,2929,1000.00,25742.54,26742.54,0.00,25742.54,0.22,1
27276,2929,-1000.00,24742.54,25742.54,17688.81,9053.73,0.21,0
27277,2930,1000.00,1000.00,2000.00,593.54,406.46,0.13,1
27278,2930,-1000.00,0.00,1000.00,0.00,2000.00,0.29,0
27279,2930,-1000.00,-1000.00,0.00,65.52,934.48,0.35,0
27280,2931,1000.00,1000.00,2000.00,0.00,1000.00,0.44,1
27281,2931,1000.00,2000.00,3000.00,629.33,1370.67,0.18,1
27282,2931,1000.00,3000.00,4000.00,892.28,2107.72,0.02,1
27283,2931,1000.00,4000.00,5000.00,0.00,3387.42,0.43,1
27284,2931,1000.00,5000.00,6000.00,0.00,5000.00,0.24,1
27285,2931,1000.00,6000.00,7000.00,0.00,6000.00,0.28,1
27286,2931,-1000.00,5000.00,6000.00,4096.07,2090.63,0.22,0
27287,2931,1000.00,6000.00,7000.00,1538.69,1990.69,0.23,1
27288,2931,-24.46,5975.54,6975.54,24.46,0.00,0.02,0
27289,2931,1000.00,6975.54,7975.54,496.18,6479.36,0.32,1
27290,2931,1000.00,7975.54,8975.54,0.00,7975.54,0.05,1
27291,2931,1000.00,8975.54,9975.54,2272.60,6702.94,0.38,1
27292,2931,-1000.00,7975.54,8975.54,7659.55,2315.98,0.07,0
27293,2931,1000.00,8975.54,9975.54,2676.47,6299.07,0.26,1
27294,2931,1000.00,9975.54,10975.54,996.99,8155.49,0.42,1
27295,2931,1000.00,10975.54,11975.54,0.00,10975.54,0.15,1
27296,2931,1000.00,11975.54,12975.54,0.00,8623.32,0.13,1
27297,2931,-1000.00,10975.54,11975.54,3152.09,0.00,0.05,0
27298,2931,-1000.00,9975.54,10975.54,11975.54,0.00,0.04,0
27299,2931,-1000.00,8975.54,9975.54,4574.31,6358.57,0.27,0
27300,2931,-1000.00,7975.54,8975.54,5984.52,3991.02,0.09,0
27301,2931,-1000.00,6975.54,7975.54,1952.75,7022.79,0.40,0
27302,2931,-1000.00,5975.54,6975.54,0.00,7975.54,0.32,0
27303,2931,-1000.00,4975.54,5975.54,0.00,6975.54,0.40,0
27304,2931,-1000.00,3975.54,4975.54,2987.77,2987.77,0.07,0
27305,2931,-1000.00,2975.54,3975.54,1916.56,3058.98,0.07,0
27306,2931,-376.06,2599.48,3599.48,0.00,376.06,0.11,0
27307,2931,0.00,2599.48,3599.48,0.00,0.00,0.04,0
27308,2931,-1000.00,1599.48,2599.48,341.04,3258.44,0.40,0
27309,2931,-788.96,810.52,1810.52,0.00,788.96,0.18,0
27310,2931,-1000.00,-189.48,810.52,905.26,905.26,0.05,0
27311,2931,-810.52,-1000.00,0.00,0.00,810.52,0.24,0
27312,2932,1000.00,1000.00,2000.00,689.82,310.18,0.17,1
27313,2932,0.00,1000.00,2000.00,0.00,0.00,0.07,0
27314,2932,-820.61,179.39,1179.39,0.00,820.61,0.26,0
27315,2932,1000.00,1179.39,2179.39,853.50,325.89,0.39,1
27316,2932,-479.87,699.52,1699.52,0.00,479.87,0.11,0
27317,2932,-1000.00,-300.48,699.52,0.00,1294.85,0.38,0
27318,2932,-699.52,-1000.00,0.00,0.00,699.52,0.02,0
27319,2933,-1000.00,-1000.00,0.00,0.00,246.83,0.36,0
27320,2934,-459.50,-459.50,540.50,0.00,459.50,0.22,0
27321,2934,-540.50,-1000.00,0.00,0.00,540.50,0.04,0
27322,2935,-976.99,-976.99,23.01,465.45,511.55,0.24,0
27323,2935,-23.01,-1000.00,0.00,6.30,16.71,0.35,0
27324,2936,-960.75,-960.75,39.25,20.54,940.20,0.44,0
27325,2936,-39.25,-1000.00,0.00,3.59,35.66,0.43,0
27326,2937,-1000.00,-1000.00,0.00,468.11,531.89,0.21,0
27327,2938,-1000.00,-1000.00,0.00,0.00,1000.00,0.24,0
27328,2939,-560.30,-560.30,439.70,0.00,560.30,0.02,0
27329,2939,-299.88,-860.18,139.82,0.00,299.88,0.36,0
27330,2939,-139.82,-1000.00,0.00,0.00,139.82,0.40,0
27331,2940,-1000.00,-1000.00,0.00,224.63,775.37,0.32,0
27332,2941,-1000.00,-1000.00,0.00,566.34,433.66,0.15,0
27333,2942,-1000.00,-1000.00,0.00,475.34,524.66,0.18,0
27334,2943,-1000.00,-1000.00,0.00,479.42,520.58,0.14,0
27335,2944,-1000.00,-1000.00,0.00,257.41,742.59,0.37,0
27336,2945,1000.00,1000.00,2000.00,248.20,751.80,0.37,1
27337,2945,1000.00,2000.00,3000.00,147.30,505.76,0.25,1
27338,2945,1000.00,3000.00,4000.00,1005.69,1994.31,0.22,1
27339,2945,1000.00,4000.00,5000.00,0.00,4000.00,0.13,1
27340,2945,1000.00,5000.00,6000.00,301.73,4698.27,0.35,1
27341,2945,1000.00,6000.00,7000.00,2437.15,3562.85,0.02,1
27342,2945,-1000.00,5000.00,6000.00,5894.38,1105.62,0.15,0
27343,2945,1000.00,6000.00,7000.00,1488.55,4511.45,0.07,1
27344,2945,1000.00,7000.00,8000.00,3095.62,3904.38,0.10,1
27345,2945,1000.00,8000.00,9000.00,1325.12,3334.86,0.38,1
27346,2945,1000.00,9000.00,10000.00,0.00,2316.40,0.24,1
27347,2945,-1000.00,8000.00,9000.00,5301.00,4699.00,0.09,0
27348,2945,1000.00,9000.00,10000.00,1726.44,2488.81,0.10,1
27349,2945,1000.00,10000.00,11000.00,4698.19,5301.81,0.01,1
27350,2945,1000.00,11000.00,12000.00,0.00,1947.39,0.29,1
27351,2945,1000.00,12000.00,13000.00,0.00,6324.24,0.34,1
27352,2945,-1000.00,11000.00,12000.00,7497.83,4534.82,0.33,0
27353,2945,1000.00,12000.00,13000.00,6000.00,6000.00,0.16,1
27354,2945,1000.00,13000.00,14000.00,2627.32,4657.07,0.24,1
27355,2945,1000.00,14000.00,15000.00,0.00,14000.00,0.13,1
27356,2945,1000.00,15000.00,16000.00,0.00,15000.00,0.21,1
27357,2945,-1000.00,14000.00,15000.00,9423.87,6576.13,0.17,0
27358,2945,1000.00,15000.00,16000.00,0.00,10215.06,0.34,1
27359,2945,-1000.00,14000.00,15000.00,5628.08,3196.85,0.36,0
27360,2945,1000.00,15000.00,16000.00,3457.04,11542.96,0.19,1
27361,2945,1000.00,16000.00,17000.00,8000.00,8000.00,0.07,1
27362,2945,1000.00,17000.00,18000.00,0.00,17000.00,0.04,1
27363,2945,1000.00,18000.00,19000.00,6109.24,11890.76,0.32,1
27364,2945,1000.00,19000.00,20000.00,3789.28,15210.72,0.23,1
27365,2945,1000.00,20000.00,21000.00,0.00,11082.85,0.13,1
27366,2945,1000.00,21000.00,22000.00,0.00,21000.00,0.08,1
27367,2945,1000.00,22000.00,23000.00,0.00,22000.00,0.27,1
27368,2945,1000.00,23000.00,24000.00,11462.20,11537.80,0.15,1
27369,2945,1000.00,24000.00,25000.00,4398.63,19601.37,0.27,1
27370,2945,1000.00,25000.00,26000.00,2315.74,22684.26,0.43,1
27371,2945,1000.00,26000.00,27000.00,0.00,26000.00,0.34,1
27372,2945,1000.00,27000.00,28000.00,7693.76,19306.24,0.36,1
27373,2945,1000.00,28000.00,29000.00,8332.61,15172.61,0.29,1
27374,2945,1000.00,29000.00,30000.00,14500.00,14500.00,0.14,1
27375,2945,1000.00,30000.00,31000.00,0.00,22289.01,0.17,1
27376,2945,1000.00,31000.00,32000.00,11055.97,19944.03,0.25,1
27377,2945,1000.00,32000.00,33000.00,0.00,13560.68,0.24,1
27378,2945,1000.00,33000.00,34000.00,14788.53,18211.47,0.11,1
27379,2946,-535.06,-535.06,464.94,174.46,360.61,0.36,0
27380,2946,-464.94,-1000.00,0.00,193.37,271.57,0.11,0
27381,2947,-1000.00,-1000.00,0.00,0.00,1000.00,0.34,0
27382,2948,0.00,0.00,1000.00,0.00,0.00,0.03,0
27383,2948,-1000.00,-1000.00,0.00,589.77,410.23,0.17,0
27384,2949,1000.00,1000.00,2000.00,303.58,494.56,0.27,1
27385,2949,1000.00,2000.00,3000.00,582.96,1417.04,0.14,1
27386,2949,1000.00,3000.00,4000.00,0.00,3000.00,0.30,1
27387,2949,1000.00,4000.00,5000.00,0.00,4000.00,0.22,1
27388,2949,1000.00,5000.00,6000.00,0.00,5000.00,0.39,1
27389,2949,1000.00,6000.00,7000.00,3000.00,3000.00,0.04,1
27390,2949,-1000.00,5000.00,6000.00,4360.53,2639.47,0.13,0
27391,2949,1000.00,6000.00,7000.00,2269.61,3730.39,0.15,1
27392,2949,1000.00,7000.00,8000.00,2488.91,4511.09,0.27,1
27393,2949,1000.00,8000.00,9000.00,1299.84,6700.16,0.43,1
27394,2949,1000.00,9000.00,10000.00,0.00,9000.00,0.10,1
27395,2949,-1000.00,8000.00,9000.00,5446.58,4553.42,0.30,0
27396,2949,-1000.00,7000.00,8000.00,1355.85,0.00,0.02,0
27397,2949,1000.00,8000.00,9000.00,3225.79,4774.21,0.29,1
27398,2949,1000.00,9000.00,10000.00,0.00,9000.00,0.13,1
27399,2949,1000.00,10000.00,11000.00,1885.64,8114.36,0.40,1
27400,2949,1000.00,11000.00,12000.00,0.00,11000.00,0.00,1
27401,2949,-1000.00,10000.00,11000.00,7912.81,4087.19,0.20,0
27402,2949,0.00,10000.00,11000.00,0.00,0.00,0.01,0
27403,2949,-1000.00,9000.00,10000.00,6472.57,4527.43,0.14,0
27404,2949,-1000.00,8000.00,9000.00,8049.38,169.36,0.05,0
27405,2949,-1000.00,7000.00,8000.00,8058.12,941.88,0.09,0
27406,2949,-1000.00,6000.00,7000.00,5186.30,2808.19,0.21,0
27407,2949,1000.00,7000.00,8000.00,0.00,4218.01,0.34,1
27408,2949,1000.00,8000.00,9000.00,0.00,8000.00,0.26,1
27409,2949,1000.00,9000.00,10000.00,0.00,6292.57,0.37,1
27410,2949,1000.00,10000.00,11000.00,0.00,10000.00,0.10,1
27411,2949,1000.00,11000.00,12000.00,0.00,11000.00,0.42,1
27412,2949,1000.00,12000.00,13000.00,1528.51,10471.49,0.43,1
27413,2949,1000.00,13000.00,14000.00,0.00,10978.16,0.30,1
27414,2949,1000.00,14000.00,15000.00,0.00,5711.98,0.26,1
27415,2949,1000.00,15000.00,16000.00,4474.93,10525.07,0.39,1
27416,2949,1000.00,16000.00,17000.00,5613.14,10386.86,0.18,1
27417,2949,1000.00,17000.00,18000.00,0.00,16791.23,0.35,1
27418,2949,-1000.00,16000.00,17000.00,2331.92,481.66,0.12,0
27419,2949,1000.00,17000.00,18000.00,4625.75,12374.25,0.36,1
27420,2949,0.00,17000.00,18000.00,0.00,0.00,0.04,0
27421,2949,1000.00,18000.00,19000.00,0.00,3462.87,0.11,1
27422,2949,1000.00,19000.00,20000.00,7227.01,9007.69,0.25,1
27423,2949,1000.00,20000.00,21000.00,0.00,20000.00,0.08,1
27424,2949,1000.00,21000.00,22000.00,0.00,6723.69,0.23,1
27425,2949,1000.00,22000.00,23000.00,0.00,22000.00,0.21,1
27426,2949,1000.00,23000.00,24000.00,2751.01,17699.39,0.40,1
27427,2949,1000.00,24000.00,25000.00,12000.00,12000.00,0.00,1
27428,2949,1000.00,25000.00,26000.00,0.00,23519.22,0.31,1
27429,2949,1000.00,26000.00,27000.00,2096.14,23903.86,0.38,1
27430,2950,-1000.00,-1000.00,0.00,551.84,448.16,0.19,0
27431,2950,0.00,-1000.00,0.00,0.00,0.00,0.33,1
27432,2950,0.00,-1000.00,0.00,0.00,0.00,0.25,1
27433,2950,0.00,-1000.00,0.00,0.00,0.00,0.05,1
27434,2950,0.00,-1000.00,0.00,0.00,0.00,0.06,1
27435,2950,0.07,-999.93,0.07,0.00,0.00,0.04,1
27436,2950,21.18,-978.75,21.25,0.00,0.07,0.42,1
27437,2950,1000.00,21.25,1021.25,0.00,21.25,0.13,1
27438,2950,1000.00,1021.25,2021.25,0.00,1021.25,0.22,1
27439,2950,1000.00,2021.25,3021.25,0.00,1782.02,0.28,1
27440,2950,0.00,2021.25,3021.25,0.00,0.00,0.01,0
27441,2950,1000.00,3021.25,4021.25,1021.47,1999.78,0.31,1
27442,2950,1000.00,4021.25,5021.25,0.00,1688.40,0.06,1
27443,2950,1000.00,5021.25,6021.25,0.00,5021.25,0.01,1
27444,2950,1000.00,6021.25,7021.25,2314.15,3707.10,0.24,1
27445,2950,1000.00,7021.25,8021.25,3394.02,3627.23,0.23,1
27446,2950,1000.00,8021.25,9021.25,2100.19,5921.06,0.26,1
27447,2950,1000.00,9021.25,10021.25,4510.63,4510.63,0.05,1
27448,2950,1000.00,10021.25,11021.25,737.15,9284.10,0.35,1
27449,2950,1000.00,11021.25,12021.25,3866.67,7154.59,0.29,1
27450,2950,1000.00,12021.25,13021.25,1264.14,10757.11,0.40,1
27451,2950,-1000.00,11021.25,12021.25,6621.87,6399.38,0.07,0
27452,2950,1000.00,12021.25,13021.25,0.00,12021.25,0.04,1
27453,2950,1000.00,13021.25,14021.25,0.00,13021.25,0.21,1
27454,2950,-1000.00,12021.25,13021.25,0.00,14021.25,0.32,0
27455,2950,-1000.00,11021.25,12021.25,4476.40,8544.85,0.30,0
27456,2950,-1000.00,10021.25,11021.25,6010.63,6010.63,0.08,0
27457,2950,-1000.00,9021.25,10021.25,0.00,11021.25,0.22,0
27458,2950,-1000.00,8021.25,9021.25,4961.99,5059.26,0.05,0
27459,2950,-1000.00,7021.25,8021.25,0.00,9021.25,0.00,0
27460,2950,-1000.00,6021.25,7021.25,3897.84,4123.41,0.11,0
27461,2950,-1000.00,5021.25,6021.25,3510.63,3510.63,0.32,0
27462,2950,-1000.00,4021.25,5021.25,0.00,4694.94,0.40,0
27463,2950,-1000.00,3021.25,4021.25,3167.77,1853.48,0.08,0
27464,2950,-1000.00,2021.25,3021.25,1660.96,2360.30,0.27,0
27465,2950,-1000.00,1021.25,2021.25,1348.54,1672.71,0.25,0
27466,2950,-1000.00,21.25,1021.25,0.00,2021.25,0.35,0
27467,2950,-898.54,-877.29,122.71,0.00,898.54,0.23,0
27468,2950,-122.71,-1000.00,0.00,0.00,122.71,0.30,0
27469,2951,-1000.00,-1000.00,0.00,451.16,548.84,0.23,0
27470,2952,-490.57,-490.57,509.43,0.00,490.57,0.31,0
27471,2952,-509.43,-1000.00,0.00,0.00,509.43,0.03,0
27472,2953,-1000.00,-1000.00,0.00,181.69,818.31,0.23,0
27473,2953,-0.00,-1000.00,0.00,0.00,0.00,0.02,0
27474,2953,-0.00,-1000.00,0.00,0.00,0.00,0.30,0
27475,2953,-0.00,-1000.00,0.00,0.00,0.00,0.08,0
27476,2953,-0.00,-1000.00,0.00,0.00,0.00,0.26,0
27477,2953,-0.00,-1000.00,0.00,0.00,0.00,0.30,0
27478,2954,-502.57,-502.57,497.43,136.60,365.97,0.25,0
27479,2954,-497.43,-1000.00,0.00,0.00,497.43,0.33,0
27480,2955,-1000.00,-1000.00,0.00,422.59,577.41,0.17,0
27481,2956,-1000.00,-1000.00,0.00,494.82,505.18,0.02,0
27482,2957,-1000.00,-1000.00,0.00,489.47,379.48,0.19,0
27483,2958,1000.00,1000.00,2000.00,0.00,503.49,0.08,1
27484,2958,1000.00,2000.00,3000.00,0.00,1102.10,0.19,1
27485,2958,1000.00,3000.00,4000.00,0.00,3000.00,0.44,1
27486,2958,1000.00,4000.00,5000.00,0.00,4000.00,0.24,1
27487,2958,1000.00,5000.00,6000.00,1836.72,3163.28,0.31,1
27488,2958,-1000.00,4000.00,5000.00,2114.04,0.00,0.08,0
27489,2958,1000.00,5000.00,6000.00,2153.18,2210.97,0.23,1
27490,2958,1000.00,6000.00,7000.00,0.00,6000.00,0.18,1
27491,2958,1000.00,7000.00,8000.00,438.43,6561.57,0.27,1
27492,2958,-1000.00,6000.00,7000.00,3560.04,1568.85,0.14,0
27493,2958,1000.00,7000.00,8000.00,0.00,947.20,0.13,1
27494,2958,-1000.00,6000.00,7000.00,2006.87,0.00,0.05,0
27495,2958,1000.00,7000.00,8000.00,0.00,7000.00,0.07,1
27496,2958,1000.00,8000.00,9000.00,2444.58,5555.42,0.32,1
27497,2958,1000.00,9000.00,10000.00,3445.10,5554.90,0.17,1
27498,2958,0.00,9000.00,10000.00,0.00,0.00,0.03,0
27499,2958,1000.00,10000.00,11000.00,0.00,3414.54,0.07,1
27500,2958,1000.00,11000.00,12000.00,4791.88,6208.12,0.24,1
27501,2958,1000.00,12000.00,13000.00,0.00,11629.09,0.10,1
27502,2958,1000.00,13000.00,14000.00,5831.50,7168.50,0.42,1
27503,2958,1000.00,14000.00,15000.00,7000.00,7000.00,0.05,1
27504,2958,1000.00,15000.00,16000.00,4926.53,10073.47,0.32,1
27505,2958,1000.00,16000.00,17000.00,2154.27,13845.73,0.21,1
27506,2958,1000.00,17000.00,18000.00,8500.00,8500.00,0.06,1
27507,2958,1000.00,18000.00,19000.00,375.20,3537.08,0.18,1
27508,2958,1000.00,19000.00,20000.00,5974.70,13025.30,0.35,1
27509,2958,1000.00,20000.00,21000.00,5174.70,14825.30,0.27,1
27510,2958,1000.00,21000.00,22000.00,0.00,20891.67,0.04,1
27511,2958,1000.00,22000.00,23000.00,10552.25,11447.75,0.13,1
27512,2958,1000.00,23000.00,24000.00,3617.72,19382.28,0.41,1
27513,2958,1000.00,24000.00,25000.00,0.00,24000.00,0.19,1
27514,2958,1000.00,25000.00,26000.00,4552.81,10192.51,0.26,1
27515,2958,1000.00,26000.00,27000.00,0.00,12600.92,0.29,1
27516,2958,1000.00,27000.00,28000.00,1598.21,16563.32,0.36,1
27517,2958,1000.00,28000.00,29000.00,0.00,14151.59,0.30,1
27518,2958,1000.00,29000.00,30000.00,0.00,29000.00,0.29,1
27519,2958,1000.00,30000.00,31000.00,10314.66,19685.34,0.14,1
27520,2958,-1000.00,29000.00,30000.00,15888.98,15111.02,0.18,0
27521,2958,1000.00,30000.00,31000.00,0.00,30000.00,0.20,1
27522,2958,1000.00,31000.00,32000.00,4313.18,10066.51,0.23,1
27523,2958,1000.00,32000.00,33000.00,0.00,18548.63,0.06,1
27524,2958,1000.00,33000.00,34000.00,0.00,33000.00,0.11,1
27525,2958,1000.00,34000.00,35000.00,3382.00,30618.00,0.42,1
27526,2958,-1000.00,33000.00,34000.00,16516.43,0.00,0.09,0
27527,2958,1000.00,34000.00,35000.00,0.00,34000.00,0.28,1
27528,2958,1000.00,35000.00,36000.00,0.00,35000.00,0.36,1
27529,2958,1000.00,36000.00,37000.00,14623.14,21376.86,0.10,1
27530,2959,1000.00,1000.00,2000.00,506.34,493.66,0.02,1
27531,2959,-1000.00,0.00,1000.00,821.00,1179.00,0.16,0
27532,2959,-720.48,-720.48,279.52,0.00,720.48,0.29,0
27533,2959,1000.00,279.52,1279.52,142.41,137.11,0.14,1
27534,2959,-424.53,-145.01,854.99,0.00,424.53,0.41,0
27535,2959,-569.43,-714.45,285.55,0.00,569.43,0.39,0
27536,2959,-246.98,-961.43,38.57,0.00,246.98,0.29,0
27537,2959,-16.84,-978.27,21.73,0.00,16.84,0.25,0
27538,2959,-13.47,-991.74,8.26,0.00,13.47,0.39,0
27539,2959,1000.00,8.26,1008.26,8.26,0.00,0.00,1
27540,2959,-23.69,-15.42,984.58,0.00,23.69,0.07,0
27541,2959,-984.58,-1000.00,0.00,457.57,527.01,0.15,0
27542,2960,-1000.00,-1000.00,0.00,0.00,1000.00,0.38,0
27543,2961,-1000.00,-1000.00,0.00,0.00,1000.00,0.01,0
27544,2962,1000.00,1000.00,2000.00,546.67,453.33,0.07,1
27545,2962,-1000.00,0.00,1000.00,906.68,1093.32,0.15,0
27546,2962,-948.65,-948.65,51.35,0.00,948.65,0.36,0
27547,2962,-42.40,-991.05,8.95,10.98,31.42,0.34,0
27548,2962,-8.95,-1000.00,0.00,3.43,5.53,0.28,0
27549,2963,-432.62,-432.62,567.38,0.00,432.62,0.29,0
27550,2963,-567.38,-1000.00,0.00,201.89,365.49,0.24,0
27551,2964,-1000.00,-1000.00,0.00,603.38,396.62,0.13,0
27552,2965,-1000.00,-1000.00,0.00,349.59,650.41,0.22,0
27553,2966,-1000.00,-1000.00,0.00,265.53,734.47,0.37,0
27554,2966,-0.00,-1000.00,-0.00,0.00,0.00,0.00,0
27555,2967,-1000.00,-1000.00,0.00,0.00,976.94,0.41,0
27556,2968,-883.37,-883.37,116.63,0.00,883.37,0.38,0
27557,2968,-87.84,-971.21,28.79,6.33,81.51,0.39,0
27558,2968,-28.79,-1000.00,0.00,14.02,14.77,0.10,0
27559,2969,-1000.00,-1000.00,0.00,480.85,519.15,0.16,0
27560,2970,-1000.00,-1000.00,0.00,0.00,1000.00,0.04,0
27561,2971,-1000.00,-1000.00,0.00,150.15,849.85,0.39,0
27562,2972,-1000.00,-1000.00,0.00,500.00,500.00,0.03,0
27563,2973,-955.92,-955.92,44.08,0.00,955.92,0.20,0
27564,2973,1000.00,44.08,1044.08,27.97,16.11,0.18,1
27565,2973,1000.00,1044.08,2044.08,615.61,7.50,0.26,1
27566,2973,-1000.00,44.08,1044.08,355.19,1688.88,0.02,0
27567,2973,-110.73,-66.65,933.35,0.00,110.73,0.43,0
27568,2973,1000.00,933.35,1933.35,694.34,0.00,0.16,1
27569,2973,-1000.00,-66.65,933.35,170.19,999.27,0.39,0
27570,2973,1000.00,933.35,1933.35,127.19,98.50,0.31,1
27571,2973,1000.00,1933.35,2933.35,259.49,0.00,0.36,1
27572,2973,1000.00,2933.35,3933.35,543.67,306.04,0.41,1
27573,2973,1000.00,3933.35,4933.35,2629.01,681.82,0.30,1
27574,2973,-1000.00,2933.35,3933.35,0.00,4933.35,0.14,0
27575,2973,0.00,2933.35,3933.35,0.00,0.00,0.16,0
27576,2973,-1000.00,1933.35,2933.35,0.00,3933.35,0.13,0
27577,2973,1000.00,2933.35,3933.35,1777.30,1156.04,0.00,1
27578,2973,-1000.00,1933.35,2933.35,0.00,3933.35,0.32,0
27579,2973,1000.00,2933.35,3933.35,2933.35,0.00,0.02,1
27580,2973,1000.00,3933.35,4933.35,2724.84,516.96,0.23,1
27581,2973,-1000.00,2933.35,3933.35,0.00,3231.86,0.07,0
27582,2973,-1000.00,1933.35,2933.35,0.00,3933.35,0.32,0
27583,2973,-1000.00,933.35,1933.35,511.38,2421.96,0.42,0
27584,2973,-1000.00,-66.65,933.35,820.66,1112.69,0.03,0
27585,2973,-933.35,-1000.00,0.00,0.00,933.35,0.12,0
27586,2974,-1000.00,-1000.00,0.00,0.00,36.92,0.11,0
27587,2975,1000.00,1000.00,2000.00,0.00,1000.00,0.26,1
27588,2975,1000.00,2000.00,3000.00,0.00,2000.00,0.32,1
27589,2975,1000.00,3000.00,4000.00,1008.56,1991.44,0.27,1
27590,2975,1000.00,4000.00,5000.00,0.00,1526.30,0.12,1
27591,2975,1000.00,5000.00,6000.00,0.00,3752.32,0.41,1
27592,2975,1000.00,6000.00,7000.00,0.00,3693.61,0.36,1
27593,2975,-1000.00,5000.00,6000.00,4149.54,2850.46,0.27,0
27594,2975,1000.00,6000.00,7000.00,2659.17,3340.83,0.11,1
27595,2975,1000.00,7000.00,8000.00,642.20,6357.80,0.27,1
27596,2975,1000.00,8000.00,9000.00,0.00,8000.00,0.39,1
27597,2975,1000.00,9000.00,10000.00,626.89,7357.83,0.42,1
27598,2975,1000.00,10000.00,11000.00,0.00,10000.00,0.02,1
27599,2975,1000.00,11000.00,12000.00,0.00,1633.03,0.15,1
27600,2975,-1000.00,10000.00,11000.00,7202.08,3916.14,0.14,0
27601,2975,1000.00,11000.00,12000.00,0.00,9301.60,0.32,1
27602,2975,1000.00,12000.00,13000.00,179.54,11820.46,0.44,1
27603,2975,1000.00,13000.00,14000.00,2130.61,10869.39,0.42,1
27604,2975,1000.00,14000.00,15000.00,0.00,14000.00,0.31,1
27605,2975,0.00,14000.00,15000.00,0.00,0.00,0.00,0
27606,2975,1000.00,15000.00,16000.00,0.00,14149.69,0.24,1
27607,2975,1000.00,16000.00,17000.00,0.00,7347.72,0.10,1
27608,2975,0.00,16000.00,17000.00,0.00,0.00,0.01,0
27609,2975,-1000.00,15000.00,16000.00,11887.53,5112.47,0.28,0
27610,2975,-1000.00,14000.00,15000.00,0.00,15194.75,0.19,0
27611,2975,-1000.00,13000.00,14000.00,3818.84,7119.27,0.28,0
27612,2975,-1000.00,12000.00,13000.00,6117.84,7882.16,0.11,0
27613,2975,-1000.00,11000.00,12000.00,0.00,13000.00,0.35,0
27614,2975,-1000.00,10000.00,11000.00,3291.49,8708.51,0.34,0
27615,2975,-1000.00,9000.00,10000.00,984.18,3007.37,0.21,0
27616,2975,-1000.00,8000.00,9000.00,4150.54,5066.60,0.25,0
27617,2975,-1000.00,7000.00,8000.00,0.00,8933.57,0.31,0
27618,2975,-1000.00,6000.00,7000.00,0.00,8000.00,0.31,0
27619,2975,0.00,6000.00,7000.00,0.00,0.00,0.09,0
27620,2975,-1000.00,5000.00,6000.00,2974.29,4025.71,0.01,0
27621,2975,-1000.00,4000.00,5000.00,3440.75,2559.25,0.18,0
27622,2975,-1000.00,3000.00,4000.00,0.00,4958.98,0.20,0
27623,2975,-1000.00,2000.00,3000.00,0.00,2365.99,0.34,0
27624,2975,-1000.00,1000.00,2000.00,1229.24,1770.76,0.17,0
27625,2975,-45.44,954.56,1954.56,0.00,45.44,0.11,0
27626,2975,-1000.00,-45.44,954.56,1113.00,841.56,0.10,0
27627,2975,-954.56,-1000.00,0.00,477.28,477.28,0.08,0
27628,2976,-973.52,-973.52,26.48,0.00,973.52,0.44,0
27629,2976,-26.48,-1000.00,0.00,0.00,26.48,0.06,0
27630,2977,-1000.00,-1000.00,0.00,761.12,238.88,0.09,0
27631,2978,-1000.00,-1000.00,0.00,724.04,275.96,0.08,0
27632,2979,-1000.00,-1000.00,0.00,751.22,233.17,0.09,0
27633,2980,-780.73,-780.73,219.27,0.00,780.73,0.39,0
27634,2980,1000.00,219.27,1219.27,79.38,57.58,0.35,1
27635,2980,-708.75,-489.48,510.52,76.28,632.47,0.34,0
27636,2980,-510.52,-1000.00,0.00,122.75,387.78,0.32,0
27637,2981,-1000.00,-1000.00,0.00,0.00,1000.00,0.09,0
27638,2982,1000.00,1000.00,2000.00,10.48,479.19,0.31,1
27639,2982,1000.00,2000.00,3000.00,371.04,1628.96,0.41,1
27640,2982,1000.00,3000.00,4000.00,0.00,1480.60,0.28,1
27641,2982,-1000.00,2000.00,3000.00,2097.27,1902.73,0.16,0
27642,2982,1000.00,3000.00,4000.00,0.00,3000.00,0.09,1
27643,2982,1000.00,4000.00,5000.00,1808.76,2191.24,0.23,1
27644,2982,1000.00,5000.00,6000.00,22.80,3857.47,0.41,1
27645,2982,1000.00,6000.00,7000.00,0.00,4809.81,0.31,1
27646,2982,1000.00,7000.00,8000.00,0.00,7000.00,0.09,1
27647,2982,1000.00,8000.00,9000.00,3554.94,4445.06,0.38,1
27648,2982,1000.00,9000.00,10000.00,1064.13,3839.53,0.27,1
27649,2982,1000.00,10000.00,11000.00,5000.00,5000.00,0.02,1
27650,2982,1000.00,11000.00,12000.00,2146.23,5609.09,0.30,1
27651,2982,1000.00,12000.00,13000.00,3313.05,8686.95,0.02,1
27652,2982,-1000.00,11000.00,12000.00,4101.74,1233.46,0.13,0
27653,2982,1000.00,12000.00,13000.00,0.00,1634.63,0.14,1
27654,2982,1000.00,13000.00,14000.00,6500.00,6500.00,0.34,1
27655,2982,1000.00,14000.00,15000.00,0.00,8632.20,0.35,1
27656,2982,1000.00,15000.00,16000.00,2453.50,12546.50,0.24,1
27657,2982,-1000.00,14000.00,15000.00,12422.93,3294.04,0.17,0
27658,2982,0.00,14000.00,15000.00,0.00,0.00,0.03,0
27659,2982,-1000.00,13000.00,14000.00,9765.41,3960.45,0.12,0
27660,2982,1000.00,14000.00,15000.00,3508.10,10491.90,0.13,1
27661,2982,1000.00,15000.00,16000.00,0.00,7514.91,0.20,1
27662,2982,1000.00,16000.00,17000.00,0.00,4408.62,0.18,1
27663,2982,1000.00,17000.00,18000.00,6856.44,10143.56,0.38,1
27664,2982,1000.00,18000.00,19000.00,213.38,17786.62,0.36,1
27665,2982,1000.00,19000.00,20000.00,0.00,19000.00,0.39,1
27666,2982,1000.00,20000.00,21000.00,9126.61,10873.39,0.17,1
27667,2982,1000.00,21000.00,22000.00,0.00,21000.00,0.11,1
27668,2982,1000.00,22000.00,23000.00,9039.04,9880.79,0.23,1
27669,2982,1000.00,23000.00,24000.00,9817.53,13182.47,0.29,1
27670,2982,1000.00,24000.00,25000.00,0.00,15488.44,0.15,1
27671,2982,1000.00,25000.00,26000.00,0.00,25000.00,0.33,1
27672,2982,1000.00,26000.00,27000.00,8491.38,17508.62,0.30,1
27673,2982,1000.00,27000.00,28000.00,5425.91,21574.09,0.39,1
27674,2982,1000.00,28000.00,29000.00,11032.83,16967.17,0.08,1
27675,2982,1000.00,29000.00,30000.00,10926.54,18073.46,0.03,1
27676,2983,-1000.00,-1000.00,0.00,316.43,683.57,0.32,0
27677,2984,-1000.00,-1000.00,0.00,0.00,638.34,0.22,0
27678,2985,-1000.00,-1000.00,0.00,0.00,1000.00,0.42,0
27679,2986,-1000.00,-1000.00,0.00,500.00,500.00,0.00,0
27680,2987,-1000.00,-1000.00,0.00,187.49,0.00,0.05,0
27681,2988,-1000.00,-1000.00,0.00,0.00,1000.00,0.34,0
27682,2989,1000.00,1000.00,2000.00,0.00,1000.00,0.04,1
27683,2989,1000.00,2000.00,3000.00,0.00,1324.96,0.34,1
27684,2989,1000.00,3000.00,4000.00,0.00,3000.00,0.26,1
27685,2989,0.00,3000.00,4000.00,0.00,0.00,0.08,0
27686,2989,1000.00,4000.00,5000.00,649.90,1447.89,0.24,1
27687,2989,1000.00,5000.00,6000.00,0.00,2259.94,0.01,1
27688,2989,1000.00,6000.00,7000.00,0.00,3098.49,0.31,1
27689,2989,1000.00,7000.00,8000.00,0.00,7000.00,0.35,1
27690,2989,-1000.00,6000.00,7000.00,4638.38,546.33,0.08,0
27691,2989,1000.00,7000.00,8000.00,0.00,6468.58,0.23,1
27692,2989,1000.00,8000.00,9000.00,946.91,2139.88,0.21,1
27693,2989,1000.00,9000.00,10000.00,0.00,3994.27,0.28,1
27694,2989,1000.00,10000.00,11000.00,0.00,10000.00,0.14,1
27695,2989,1000.00,11000.00,12000.00,0.00,11000.00,0.33,1
27696,2989,1000.00,12000.00,13000.00,4093.90,7906.10,0.28,1
27697,2989,1000.00,13000.00,14000.00,946.27,11666.57,0.43,1
27698,2989,1000.00,14000.00,15000.00,5015.73,8984.27,0.25,1
27699,2989,1000.00,15000.00,16000.00,0.00,15000.00,0.12,1
27700,2989,1000.00,16000.00,17000.00,3713.13,12286.87,0.27,1
27701,2989,1000.00,17000.00,18000.00,7692.34,9307.66,0.39,1
27702,2989,1000.00,18000.00,19000.00,6192.41,11807.59,0.30,1
27703,2989,-1000.00,17000.00,18000.00,10737.99,2927.67,0.11,0
27704,2989,-1000.00,16000.00,17000.00,4715.44,0.00,0.10,0
27705,2989,-1000.00,15000.00,16000.00,0.00,12899.19,0.02,0
27706,2989,-1000.00,14000.00,15000.00,0.00,7391.75,0.01,0
27707,2989,-1000.00,13000.00,14000.00,0.00,5270.65,0.07,0
27708,2989,0.00,13000.00,14000.00,0.00,0.00,0.04,0
27709,2989,-1000.00,12000.00,13000.00,2151.23,11848.77,0.42,0
27710,2989,-1000.00,11000.00,12000.00,0.00,4098.16,0.20,0
27711,2989,-1000.00,10000.00,11000.00,919.25,11080.75,0.18,0
27712,2989,-1000.00,9000.00,10000.00,2114.54,8885.46,0.31,0
27713,2989,-1000.00,8000.00,9000.00,0.00,9277.37,0.08,0
27714,2989,-1000.00,7000.00,8000.00,4201.43,4798.57,0.38,0
27715,2989,-1000.00,6000.00,7000.00,3661.70,4338.30,0.08,0
27716,2989,-1000.00,5000.00,6000.00,767.73,1135.05,0.16,0
27717,2989,-1000.00,4000.00,5000.00,0.00,4619.40,0.41,0
27718,2989,-1000.00,3000.00,4000.00,0.00,4045.63,0.37,0
27719,2989,-280.85,2719.15,3719.15,117.23,163.62,0.12,0
27720,2989,-1000.00,1719.15,2719.15,0.00,3719.15,0.44,0
27721,2989,-1000.00,719.15,1719.15,0.00,2719.15,0.21,0
27722,2989,-1000.00,-280.85,719.15,859.58,859.58,0.03,0
27723,2989,-719.15,-1000.00,0.00,0.00,719.15,0.07,0
27724,2990,-412.83,-412.83,587.17,0.00,412.83,0.24,0
27725,2990,-541.59,-954.42,45.58,0.00,541.59,0.10,0
27726,2990,-45.58,-1000.00,0.00,20.68,24.89,0.20,0
27727,2991,1000.00,1000.00,2000.00,489.33,510.67,0.19,1
27728,2991,1000.00,2000.00,3000.00,887.76,1112.24,0.07,1
27729,2991,1000.00,3000.00,4000.00,0.00,3000.00,0.37,1
27730,2991,1000.00,4000.00,5000.00,176.72,3823.28,0.41,1
27731,2991,1000.00,5000.00,6000.00,0.00,4866.37,0.44,1
27732,2991,-1000.00,4000.00,5000.00,1793.51,0.00,0.07,0
27733,2991,1000.00,5000.00,6000.00,0.00,1528.51,0.22,1
27734,2991,1000.00,6000.00,7000.00,770.90,2061.74,0.24,1
27735,2991,1000.00,7000.00,8000.00,2149.19,4850.81,0.26,1
27736,2991,1000.00,8000.00,9000.00,2827.09,5172.91,0.32,1
27737,2991,1000.00,9000.00,10000.00,3042.46,3903.04,0.24,1
27738,2991,1000.00,10000.00,11000.00,0.00,10000.00,0.01,1
27739,2991,1000.00,11000.00,12000.00,3409.10,7590.90,0.20,1
27740,2991,1000.00,12000.00,13000.00,0.00,12000.00,0.20,1
27741,2991,1000.00,13000.00,14000.00,4522.04,8477.96,0.27,1
27742,2991,1000.00,14000.00,15000.00,0.00,14000.00,0.32,1
27743,2991,-1000.00,13000.00,14000.00,6625.56,5317.00,0.19,0
27744,2991,1000.00,14000.00,15000.00,0.00,14000.00,0.26,1
27745,2991,1000.00,15000.00,16000.00,0.00,9379.76,0.36,1
27746,2991,1000.00,16000.00,17000.00,5052.89,10947.11,0.26,1
27747,2991,1000.00,17000.00,18000.00,0.00,11587.88,0.26,1
27748,2991,1000.00,18000.00,19000.00,0.00,2009.34,0.08,1
27749,2991,1000.00,19000.00,20000.00,5145.33,13854.67,0.17,1
27750,2991,1000.00,20000.00,21000.00,7926.46,12073.54,0.22,1
27751,2991,1000.00,21000.00,22000.00,10500.00,10500.00,0.30,1
27752,2991,1000.00,22000.00,23000.00,0.00,18232.48,0.09,1
27753,2991,1000.00,23000.00,24000.00,6748.71,16251.29,0.36,1
27754,2991,1000.00,24000.00,25000.00,7331.46,16668.54,0.35,1
27755,2991,1000.00,25000.00,26000.00,8596.22,16403.78,0.26,1
27756,2991,1000.00,26000.00,27000.00,10982.18,15017.82,0.03,1
27757,2991,1000.00,27000.00,28000.00,0.00,12163.27,0.28,1
27758,2991,1000.00,28000.00,29000.00,0.00,10241.23,0.25,1
27759,2991,1000.00,29000.00,30000.00,8908.99,20091.01,0.11,1
27760,2991,-1000.00,28000.00,29000.00,23369.77,6630.23,0.19,0
27761,2991,1000.00,29000.00,30000.00,12154.32,16845.68,0.26,1
27762,2991,1000.00,30000.00,31000.00,0.00,30000.00,0.39,1
27763,2991,1000.00,31000.00,32000.00,14179.99,16820.01,0.32,1
27764,2991,1000.00,32000.00,33000.00,0.00,31327.43,0.21,1
27765,2991,1000.00,33000.00,34000.00,14034.51,18965.49,0.25,1
27766,2991,1000.00,34000.00,35000.00,0.00,30527.61,0.40,1
27767,2991,1000.00,35000.00,36000.00,0.00,35000.00,0.23,1
27768,2991,1000.00,36000.00,37000.00,0.00,24391.06,0.05,1
27769,2991,1000.00,37000.00,38000.00,0.00,37000.00,0.05,1
27770,2991,1000.00,38000.00,39000.00,0.00,38000.00,0.06,1
27771,2991,1000.00,39000.00,40000.00,7572.70,25585.81,0.35,1
27772,2991,1000.00,40000.00,41000.00,4905.55,13623.75,0.24,1
27773,2991,1000.00,41000.00,42000.00,7667.05,8582.23,0.13,1
27774,2991,1000.00,42000.00,43000.00,0.00,18944.85,0.29,1
27775,2991,-1000.00,41000.00,42000.00,0.00,30392.10,0.28,0
27776,2991,-1000.00,40000.00,41000.00,27029.27,0.00,0.04,0
27777,2991,-1000.00,39000.00,40000.00,13660.59,27339.41,0.13,0
27778,2991,-1000.00,38000.00,39000.00,0.00,18436.18,0.30,0
27779,2991,-1000.00,37000.00,38000.00,19500.00,19500.00,0.30,0
27780,2991,-1000.00,36000.00,37000.00,0.00,26437.19,0.33,0
27781,2991,0.00,36000.00,37000.00,0.00,0.00,0.05,0
27782,2991,-1000.00,35000.00,36000.00,0.00,37000.00,0.07,0
27783,2991,-1000.00,34000.00,35000.00,3683.66,32316.34,0.42,0
27784,2991,-1000.00,33000.00,34000.00,14336.72,0.00,0.05,0
27785,2991,-1000.00,32000.00,33000.00,19171.02,0.00,0.06,0
27786,2991,-1000.00,31000.00,32000.00,14021.31,18978.69,0.16,0
27787,2991,-1000.00,30000.00,31000.00,12320.59,19679.41,0.36,0
27788,2991,-1000.00,29000.00,30000.00,0.00,31000.00,0.12,0
27789,2991,-1000.00,28000.00,29000.00,749.25,17746.23,0.35,0
27790,2991,0.00,28000.00,29000.00,0.00,0.00,0.02,0
27791,2991,-1000.00,27000.00,28000.00,8971.59,20028.41,0.35,0
27792,2991,-1000.00,26000.00,27000.00,7347.69,1324.52,0.11,0
27793,2991,-1000.00,25000.00,26000.00,0.00,27000.00,0.28,0
27794,2991,-1000.00,24000.00,25000.00,0.00,20741.01,0.10,0
27795,2991,-1000.00,23000.00,24000.00,5939.72,19060.28,0.39,0
27796,2991,-1000.00,22000.00,23000.00,0.00,12190.34,0.32,0
27797,2991,-1000.00,21000.00,22000.00,8925.81,14074.19,0.24,0
27798,2992,1000.00,1000.00,2000.00,160.59,809.92,0.41,1
27799,2992,1000.00,2000.00,3000.00,0.00,1740.04,0.38,1
27800,2992,1000.00,3000.00,4000.00,591.34,1909.21,0.35,1
27801,2992,1000.00,4000.00,5000.00,0.00,3309.35,0.42,1
27802,2992,1000.00,5000.00,6000.00,1022.20,3977.80,0.33,1
27803,2992,1000.00,6000.00,7000.00,0.00,6000.00,0.01,1
27804,2992,1000.00,7000.00,8000.00,1400.20,5599.80,0.43,1
27805,2992,1000.00,8000.00,9000.00,4000.00,4000.00,0.03,1
27806,2992,1000.00,9000.00,10000.00,2174.30,6825.70,0.01,1
27807,2992,1000.00,10000.00,11000.00,0.00,5784.48,0.30,1
27808,2992,-1000.00,9000.00,10000.00,7071.98,3928.02,0.10,0
27809,2992,-1000.00,8000.00,9000.00,5686.04,4313.96,0.01,0
27810,2992,1000.00,9000.00,10000.00,0.00,4615.84,0.23,1
27811,2992,-1000.00,8000.00,9000.00,1638.54,496.41,0.24,0
27812,2992,1000.00,9000.00,10000.00,0.00,9000.00,0.13,1
27813,2992,1000.00,10000.00,11000.00,3603.78,6396.22,0.27,1
27814,2992,1000.00,11000.00,12000.00,0.00,2620.47,0.08,1
27815,2992,1000.00,12000.00,13000.00,0.00,12000.00,0.18,1
27816,2992,1000.00,13000.00,14000.00,5713.83,7286.17,0.15,1
27817,2992,1000.00,14000.00,15000.00,6808.41,7191.59,0.28,1
27818,2992,1000.00,15000.00,16000.00,6578.22,8421.78,0.25,1
27819,2993,-1000.00,-1000.00,0.00,0.00,1000.00,0.24,0
27820,2994,1000.00,1000.00,2000.00,0.00,976.05,0.23,1
27821,2994,1000.00,2000.00,3000.00,0.00,2000.00,0.22,1
27822,2994,1000.00,3000.00,4000.00,0.00,3000.00,0.35,1
27823,2994,1000.00,4000.00,5000.00,1382.95,2617.05,0.24,1
27824,2994,1000.00,5000.00,6000.00,228.34,4771.66,0.32,1
27825,2994,1000.00,6000.00,7000.00,93.01,5906.99,0.20,1
27826,2994,1000.00,7000.00,8000.00,30.97,6148.66,0.43,1
27827,2994,-1000.00,6000.00,7000.00,5618.50,2381.50,0.03,0
27828,2994,1000.00,7000.00,8000.00,0.00,7000.00,0.42,1
27829,2994,1000.00,8000.00,9000.00,2311.85,3321.27,0.24,1
27830,2994,1000.00,9000.00,10000.00,0.00,9000.00,0.09,1
27831,2994,-1000.00,8000.00,9000.00,9637.53,362.47,0.06,0
27832,2994,1000.00,9000.00,10000.00,0.00,9000.00,0.00,1
27833,2994,1000.00,10000.00,11000.00,759.69,9240.31,0.40,1
27834,2994,1000.00,11000.00,12000.00,0.00,11000.00,0.18,1
27835,2994,-1000.00,10000.00,11000.00,4984.64,0.00,0.01,0
27836,2994,1000.00,11000.00,12000.00,0.00,11000.00,0.41,1
27837,2994,1000.00,12000.00,13000.00,0.00,11419.75,0.01,1
27838,2994,1000.00,13000.00,14000.00,3187.09,9812.91,0.26,1
27839,2994,1000.00,14000.00,15000.00,6083.83,7916.17,0.26,1
27840,2994,1000.00,15000.00,16000.00,0.00,13509.07,0.43,1
27841,2994,1000.00,16000.00,17000.00,6111.44,9888.56,0.18,1
27842,2994,1000.00,17000.00,18000.00,1052.32,11082.21,0.37,1
27843,2994,1000.00,18000.00,19000.00,7858.04,10141.96,0.24,1
27844,2994,1000.00,19000.00,20000.00,0.00,19000.00,0.38,1
27845,2994,1000.00,20000.00,21000.00,8422.60,11577.40,0.33,1
27846,2994,1000.00,21000.00,22000.00,0.00,21000.00,0.35,1
27847,2994,1000.00,22000.00,23000.00,9749.37,12250.63,0.34,1
27848,2994,1000.00,23000.00,24000.00,763.48,15005.42,0.37,1
27849,2994,1000.00,24000.00,25000.00,0.00,15836.10,0.32,1
27850,2994,-1000.00,23000.00,24000.00,13502.21,0.00,0.05,0
27851,2994,-1000.00,22000.00,23000.00,17315.55,6684.45,0.16,0
27852,2994,1000.00,23000.00,24000.00,8635.78,14364.22,0.27,1
27853,2994,1000.00,24000.00,25000.00,0.00,24000.00,0.18,1
27854,2994,-1000.00,23000.00,24000.00,22393.11,2606.89,0.03,0
27855,2994,1000.00,24000.00,25000.00,0.00,23762.35,0.42,1
27856,2994,1000.00,25000.00,26000.00,11247.03,13752.97,0.25,1
27857,2994,1000.00,26000.00,27000.00,0.00,26000.00,0.09,1
27858,2994,1000.00,27000.00,28000.00,0.00,27000.00,0.09,1
27859,2994,1000.00,28000.00,29000.00,0.00,28000.00,0.15,1
27860,2994,1000.00,29000.00,30000.00,0.00,16921.53,0.01,1
27861,2994,1000.00,30000.00,31000.00,1074.56,19902.76,0.38,1
27862,2994,1000.00,31000.00,32000.00,0.00,31000.00,0.11,1
27863,2995,-527.02,-527.02,472.98,0.00,527.02,0.03,0
27864,2995,-393.71,-920.73,79.27,79.88,313.84,0.37,0
27865,2995,-79.27,-1000.00,0.00,31.14,48.12,0.24,0
27866,2996,1000.00,1000.00,2000.00,0.00,1000.00,0.24,1
27867,2996,1000.00,2000.00,3000.00,0.00,1391.50,0.39,1
27868,2996,1000.00,3000.00,4000.00,0.00,1499.84,0.31,1
27869,2996,1000.00,4000.00,5000.00,2000.00,2000.00,0.06,1
27870,2996,1000.00,5000.00,6000.00,0.00,5000.00,0.17,1
27871,2996,0.00,5000.00,6000.00,0.00,0.00,0.09,0
27872,2996,1000.00,6000.00,7000.00,1389.10,4610.90,0.38,1
27873,2996,1000.00,7000.00,8000.00,0.00,5662.29,0.21,1
27874,2996,1000.00,8000.00,9000.00,2149.08,5850.92,0.37,1
27875,2996,-1000.00,7000.00,8000.00,4862.41,4137.59,0.37,0
27876,2996,1000.00,8000.00,9000.00,0.00,8000.00,0.01,1
27877,2996,1000.00,9000.00,10000.00,0.00,897.54,0.06,1
27878,2996,1000.00,10000.00,11000.00,4493.30,5506.70,0.18,1
27879,2996,1000.00,11000.00,12000.00,443.71,10556.29,0.22,1
27880,2996,1000.00,12000.00,13000.00,4975.64,7024.36,0.16,1
27881,2996,1000.00,13000.00,14000.00,0.00,13000.00,0.17,1
27882,2996,1000.00,14000.00,15000.00,0.00,14000.00,0.25,1
27883,2996,0.00,14000.00,15000.00,0.00,0.00,0.02,0
27884,2996,0.00,14000.00,15000.00,0.00,0.00,0.06,0
27885,2996,1000.00,15000.00,16000.00,0.00,2138.87,0.16,1
27886,2996,1000.00,16000.00,17000.00,8000.00,8000.00,0.11,1
27887,2996,1000.00,17000.00,18000.00,3267.16,13732.84,0.40,1
27888,2996,1000.00,18000.00,19000.00,5107.54,12892.46,0.16,1
27889,2996,-1000.00,17000.00,18000.00,10529.71,8470.29,0.17,0
27890,2996,-1000.00,16000.00,17000.00,6038.16,11961.84,0.30,0
27891,2996,-1000.00,15000.00,16000.00,0.00,11323.09,0.34,0
27892,2996,-1000.00,14000.00,15000.00,0.00,15682.41,0.26,0
27893,2996,-1000.00,13000.00,14000.00,0.00,15000.00,0.26,0
27894,2996,-1000.00,12000.00,13000.00,7696.53,6303.47,0.13,0
27895,2996,-1000.00,11000.00,12000.00,0.00,13000.00,0.33,0
27896,2996,-1000.00,10000.00,11000.00,0.00,11861.30,0.39,0
27897,2996,-1000.00,9000.00,10000.00,4970.63,6029.37,0.14,0
27898,2996,-1000.00,8000.00,9000.00,297.22,4401.24,0.29,0
27899,2996,-1000.00,7000.00,8000.00,2914.79,6085.21,0.27,0
27900,2996,-1000.00,6000.00,7000.00,4000.00,4000.00,0.01,0
27901,2996,-1000.00,5000.00,6000.00,7000.00,0.00,0.01,0
27902,2996,-1000.00,4000.00,5000.00,0.00,5702.08,0.24,0
27903,2996,-1000.00,3000.00,4000.00,2260.07,2739.93,0.19,0
27904,2996,-1000.00,2000.00,3000.00,1625.07,2374.93,0.14,0
27905,2996,-1000.00,1000.00,2000.00,0.00,2064.38,0.33,0
27906,2996,-1000.00,0.00,1000.00,0.00,1413.87,0.39,0
27907,2996,-197.40,-197.40,802.60,0.00,197.40,0.18,0
27908,2996,-802.60,-1000.00,0.00,401.30,401.30,0.29,0
27909,2997,-1000.00,-1000.00,0.00,0.00,300.82,0.21,0
27910,2998,-1000.00,-1000.00,0.00,0.00,1000.00,0.05,0
27911,2999,-711.16,-711.16,288.84,29.69,681.47,0.38,0
27912,2999,-176.37,-887.54,112.46,0.00,176.37,0.33,0
27913,2999,-112.46,-1000.00,0.00,0.00,112.46,0.00,0
27914,3000,-1000.00,-1000.00,0.00,219.11,780.89,0.26,0
27915,3001,-1000.00,-1000.00,0.00,0.00,1000.00,0.22,0
27916,3002,-746.19,-746.19,253.81,746.19,0.00,0.15,0
27917,3002,0.00,-746.19,253.81,0.00,0.00,0.24,0
27918,3002,-1000.00,-1746.19,-746.19,53.08,200.74,0.34,0
27919,3003,-861.40,-861.40,138.60,513.58,347.82,0.20,0
27920,3003,-1000.00,-1861.40,-861.40,0.00,138.60,0.36,0
27921,3004,-1000.00,-1000.00,0.00,373.63,626.37,0.31,0
27922,3005,-1000.00,-1000.00,0.00,386.86,613.14,0.30,0
27923,3006,-398.23,-398.23,601.77,0.00,398.23,0.41,0
27924,3006,1000.00,601.77,1601.77,270.20,199.26,0.33,1
27925,3006,0.00,601.77,1601.77,0.00,0.00,0.20,0
27926,3006,-1000.00,-398.23,601.77,424.02,1177.75,0.36,0
27927,3006,0.00,-398.23,601.77,0.00,0.00,0.00,0
27928,3006,1000.00,601.77,1601.77,349.92,251.84,0.10,1
27929,3006,-951.45,-349.68,650.32,0.00,951.45,0.27,0
27930,3006,-441.68,-791.36,208.64,17.84,423.84,0.43,0
27931,3006,1000.00,208.64,1208.64,115.81,92.84,0.13,1
27932,3006,-1000.00,-791.36,208.64,0.00,1171.11,0.12,0
27933,3006,-77.58,-868.94,131.06,37.49,40.09,0.42,0
27934,3006,1000.00,131.06,1131.06,66.94,64.12,0.18,1
27935,3006,1000.00,1131.06,2131.06,276.05,256.64,0.18,1
27936,3006,1000.00,2131.06,3131.06,1302.51,724.01,0.14,1
27937,3006,-1000.00,1131.06,2131.06,1558.72,1572.34,0.06,0
27938,3006,-1000.00,131.06,1131.06,1065.53,1065.53,0.07,0
27939,3006,-1000.00,-868.94,131.06,0.00,1131.06,0.01,0
27940,3006,1000.00,131.06,1131.06,131.06,0.00,0.02,1
27941,3006,-1000.00,-868.94,131.06,0.00,1131.06,0.20,0
27942,3006,-1000.00,-1868.94,-868.94,54.11,0.00,0.15,0
27943,3007,-1000.00,-1000.00,0.00,0.00,1000.00,0.20,0
27944,3008,-1000.00,-1000.00,0.00,0.00,1000.00,0.01,0
27945,3009,-731.76,-731.76,268.24,89.73,642.03,0.37,0
27946,3009,-358.60,-1090.36,-90.36,1.72,0.00,0.03,0
27947,3010,-1000.00,-1000.00,0.00,0.00,1000.00,0.44,0
27948,3011,-677.92,-677.92,322.08,0.00,677.92,0.26,0
27949,3011,-235.16,-913.09,86.91,0.00,235.16,0.40,0
27950,3011,-19.93,-933.01,66.99,0.00,19.93,0.01,0
27951,3011,-56.92,-989.94,10.06,0.00,56.92,0.41,0
27952,3011,-10.06,-1000.00,-0.00,1.88,8.18,0.37,0
27953,3012,-1000.00,-1000.00,0.00,569.22,430.78,0.15,0
27954,3013,1000.00,1000.00,2000.00,0.00,1000.00,0.39,1
27955,3013,1000.00,2000.00,3000.00,0.00,2000.00,0.15,1
27956,3013,1000.00,3000.00,4000.00,0.00,585.90,0.12,1
27957,3013,1000.00,4000.00,5000.00,20.66,1130.04,0.22,1
27958,3013,1000.00,5000.00,6000.00,956.58,4043.42,0.19,1
27959,3013,-1000.00,4000.00,5000.00,3013.26,2986.74,0.21,0
27960,3013,1000.00,5000.00,6000.00,1570.25,3429.75,0.26,1
27961,3013,1000.00,6000.00,7000.00,0.00,3234.52,0.27,1
27962,3013,1000.00,7000.00,8000.00,0.00,5292.00,0.22,1
27963,3013,1000.00,8000.00,9000.00,0.00,8000.00,0.21,1
27964,3013,1000.00,9000.00,10000.00,0.00,5295.83,0.09,1
27965,3013,1000.00,10000.00,11000.00,1420.17,6002.86,0.31,1
27966,3013,-1000.00,9000.00,10000.00,5640.71,5359.29,0.43,0
27967,3013,-1000.00,8000.00,9000.00,7668.06,2331.94,0.04,0
27968,3013,1000.00,9000.00,10000.00,1781.26,7218.74,0.36,1
27969,3013,1000.00,10000.00,11000.00,5000.00,5000.00,0.01,1
27970,3013,1000.00,11000.00,12000.00,0.00,6257.71,0.12,1
27971,3013,1000.00,12000.00,13000.00,0.00,12000.00,0.02,1
27972,3013,1000.00,13000.00,14000.00,621.28,3719.08,0.23,1
27973,3013,1000.00,14000.00,15000.00,0.00,14000.00,0.03,1
27974,3013,-1000.00,13000.00,14000.00,9161.24,5838.76,0.14,0
27975,3013,1000.00,14000.00,15000.00,6770.80,7229.20,0.43,1
27976,3013,1000.00,15000.00,16000.00,3011.45,11988.55,0.41,1
27977,3013,1000.00,16000.00,17000.00,5923.22,10076.78,0.28,1
27978,3013,1000.00,17000.00,18000.00,0.00,14808.31,0.17,1
27979,3013,-1000.00,16000.00,17000.00,3419.17,869.75,0.12,0
27980,3013,1000.00,17000.00,18000.00,1747.76,15252.24,0.33,1
27981,3013,1000.00,18000.00,19000.00,2392.85,15607.15,0.21,1
27982,3013,1000.00,19000.00,20000.00,0.00,14561.64,0.36,1
27983,3013,1000.00,20000.00,21000.00,619.71,10696.46,0.33,1
27984,3013,-1000.00,19000.00,20000.00,8759.36,8162.44,0.21,0
27985,3013,1000.00,20000.00,21000.00,8278.60,11721.40,0.21,1
27986,3013,1000.00,21000.00,22000.00,0.00,7995.99,0.26,1
27987,3013,1000.00,22000.00,23000.00,0.00,22000.00,0.42,1
27988,3013,1000.00,23000.00,24000.00,0.00,19387.49,0.43,1
27989,3013,1000.00,24000.00,25000.00,0.00,22719.71,0.07,1
27990,3013,1000.00,25000.00,26000.00,2144.25,22855.75,0.32,1
27991,3013,1000.00,26000.00,27000.00,0.00,4622.35,0.11,1
27992,3013,1000.00,27000.00,28000.00,12586.49,14413.51,0.05,1
27993,3013,0.00,27000.00,28000.00,0.00,0.00,0.01,0
27994,3013,1000.00,28000.00,29000.00,0.00,21979.29,0.34,1
27995,3013,1000.00,29000.00,30000.00,6065.84,22934.16,0.22,1
27996,3013,1000.00,30000.00,31000.00,14235.44,15764.56,0.13,1
27997,3013,1000.00,31000.00,32000.00,0.00,5822.90,0.14,1
27998,3013,-1000.00,30000.00,31000.00,13777.94,0.00,0.01,0
27999,3013,-1000.00,29000.00,30000.00,0.00,23704.42,0.41,0
28000,3013,-1000.00,28000.00,29000.00,0.00,22272.71,0.40,0
28001,3013,0.00,28000.00,29000.00,0.00,0.00,0.06,0
28002,3013,-1000.00,27000.00,28000.00,0.00,8619.25,0.07,0
28003,3013,-1000.00,26000.00,27000.00,14864.30,13135.70,0.15,0
28004,3013,-1000.00,25000.00,26000.00,0.00,8392.04,0.23,0
28005,3013,-1000.00,24000.00,25000.00,0.00,26000.00,0.09,0
28006,3013,-1000.00,23000.00,24000.00,9705.62,15294.38,0.06,0
28007,3013,-1000.00,22000.00,23000.00,0.00,14882.57,0.16,0
28008,3013,-1000.00,21000.00,22000.00,1195.22,21804.78,0.28,0
28009,3013,-1000.00,20000.00,21000.00,7938.32,14061.68,0.33,0
28010,3013,-1000.00,19000.00,20000.00,8518.32,12481.68,0.44,0
28011,3013,-1000.00,18000.00,19000.00,0.00,20000.00,0.26,0
28012,3013,-1000.00,17000.00,18000.00,0.00,14889.68,0.12,0
28013,3013,-1000.00,16000.00,17000.00,6086.04,11913.96,0.30,0
28014,3013,-1000.00,15000.00,16000.00,2542.26,14457.74,0.42,0
28015,3013,-1000.00,14000.00,15000.00,0.00,14880.69,0.36,0
28016,3013,-1000.00,13000.00,14000.00,0.00,15000.00,0.14,0
28017,3013,-1000.00,12000.00,13000.00,2858.26,11141.74,0.39,0
28018,3014,1000.00,1000.00,2000.00,34.56,884.15,0.43,1
28019,3014,1000.00,2000.00,3000.00,0.00,2000.00,0.00,1
28020,3014,-1000.00,1000.00,2000.00,923.24,753.36,0.18,0
28021,3014,1000.00,2000.00,3000.00,0.00,697.54,0.13,1
28022,3014,1000.00,3000.00,4000.00,306.45,833.11,0.21,1
28023,3014,0.00,3000.00,4000.00,0.00,0.00,0.08,0
28024,3014,1000.00,4000.00,5000.00,0.00,4000.00,0.30,1
28025,3014,1000.00,5000.00,6000.00,1687.44,3312.56,0.33,1
28026,3014,1000.00,6000.00,7000.00,0.00,5093.76,0.26,1
28027,3014,1000.00,7000.00,8000.00,0.00,7000.00,0.10,1
28028,3014,1000.00,8000.00,9000.00,0.00,8000.00,0.39,1
28029,3014,1000.00,9000.00,10000.00,3461.68,5538.32,0.21,1
28030,3014,1000.00,10000.00,11000.00,2040.29,7959.71,0.18,1
28031,3014,1000.00,11000.00,12000.00,0.00,11000.00,0.17,1
28032,3014,0.00,11000.00,12000.00,0.00,0.00,0.04,0
28033,3014,0.00,11000.00,12000.00,0.00,0.00,0.06,0
28034,3014,1000.00,12000.00,13000.00,0.00,12000.00,0.33,1
28035,3014,1000.00,13000.00,14000.00,0.00,13000.00,0.01,1
28036,3014,1000.00,14000.00,15000.00,0.00,14000.00,0.41,1
28037,3014,-1000.00,13000.00,14000.00,14235.12,0.00,0.03,0
28038,3014,1000.00,14000.00,15000.00,2781.03,11218.97,0.20,1
28039,3014,1000.00,15000.00,16000.00,5734.70,9265.30,0.17,1
28040,3014,1000.00,16000.00,17000.00,0.00,16000.00,0.26,1
28041,3014,1000.00,17000.00,18000.00,0.00,8592.74,0.31,1
28042,3014,-1000.00,16000.00,17000.00,0.00,5051.57,0.21,0
28043,3014,-1000.00,15000.00,16000.00,10392.84,6607.16,0.06,0
28044,3014,-1000.00,14000.00,15000.00,0.00,16000.00,0.27,0
28045,3014,-1000.00,13000.00,14000.00,10126.50,4873.50,0.08,0
28046,3014,-1000.00,12000.00,13000.00,4190.24,9809.76,0.27,0
28047,3014,-1000.00,11000.00,12000.00,0.00,13000.00,0.13,0
28048,3014,-1000.00,10000.00,11000.00,0.00,12000.00,0.31,0
28049,3014,-1000.00,9000.00,10000.00,0.00,11000.00,0.09,0
28050,3014,-1000.00,8000.00,9000.00,2988.82,7011.18,0.33,0
28051,3014,-1000.00,7000.00,8000.00,520.66,5398.68,0.44,0
28052,3014,-1000.00,6000.00,7000.00,2610.88,5389.12,0.34,0
28053,3014,-1000.00,5000.00,6000.00,3803.57,3196.43,0.01,0
28054,3014,-1000.00,4000.00,5000.00,0.00,4452.90,0.44,0
28055,3014,0.00,4000.00,5000.00,0.00,0.00,0.25,0
28056,3014,-1000.00,3000.00,4000.00,367.28,4632.72,0.20,0
28057,3014,-1000.00,2000.00,3000.00,0.00,3836.15,0.39,0
28058,3014,-1000.00,1000.00,2000.00,0.00,259.31,0.31,0
28059,3014,-1000.00,0.00,1000.00,0.00,1472.45,0.37,0
28060,3014,-1000.00,-1000.00,0.00,0.00,1000.00,0.38,0
28061,3015,-1000.00,-1000.00,0.00,367.67,632.33,0.17,0
28062,3016,-1000.00,-1000.00,0.00,564.99,435.01,0.11,0
28063,3017,-1000.00,-1000.00,0.00,500.00,500.00,0.08,0
28064,3018,-958.29,-958.29,41.71,0.00,958.29,0.19,0
28065,3018,-5.08,-963.37,36.63,0.00,5.08,0.22,0
28066,3018,1000.00,36.63,1036.63,16.62,13.06,0.33,1
28067,3018,-133.73,-97.10,902.90,0.00,133.73,0.27,0
28068,3018,-687.35,-784.45,215.55,71.93,615.42,0.38,0
28069,3018,-123.56,-908.01,91.99,0.00,123.56,0.39,0
28070,3018,-72.53,-980.53,19.47,0.00,72.53,0.15,0
28071,3018,-2.91,-983.45,16.55,0.00,2.91,0.34,0
28072,3018,-10.66,-994.10,5.90,0.94,9.71,0.28,0
28073,3018,615.71,-378.39,621.61,2.21,0.00,0.19,1
28074,3018,1000.00,621.61,1621.61,400.39,0.00,0.24,1
28075,3018,-1000.00,-378.39,621.61,26.06,1595.55,0.02,0
28076,3018,1000.00,621.61,1621.61,393.72,0.00,0.25,1
28077,3018,-796.20,-174.60,825.40,39.15,757.06,0.36,0
28078,3018,1000.00,825.40,1825.40,137.68,0.00,0.04,1
28079,3018,0.00,825.40,1825.40,0.00,0.00,0.35,0
28080,3018,-508.82,316.58,1316.58,0.00,508.82,0.23,0
28081,3018,0.00,316.58,1316.58,0.00,0.00,0.31,0
28082,3018,-1000.00,-683.42,316.58,353.58,963.00,0.26,0
28083,3018,-316.58,-1000.00,0.00,0.00,316.58,0.26,0
28084,3019,-1000.00,-1000.00,0.00,0.00,1000.00,0.34,0
28085,3020,-1000.00,-1000.00,0.00,0.00,1000.00,0.39,0
28086,3021,-1000.00,-1000.00,0.00,0.00,1000.00,0.12,0
28087,3022,1000.00,1000.00,2000.00,493.07,506.93,0.22,1
28088,3022,1000.00,2000.00,3000.00,580.84,1419.16,0.30,1
28089,3022,1000.00,3000.00,4000.00,0.00,929.87,0.19,1
28090,3022,1000.00,4000.00,5000.00,921.54,3078.46,0.20,1
28091,3022,1000.00,5000.00,6000.00,0.00,5000.00,0.37,1
28092,3022,1000.00,6000.00,7000.00,2189.86,3810.14,0.29,1
28093,3022,1000.00,7000.00,8000.00,0.00,7000.00,0.08,1
28094,3022,1000.00,8000.00,9000.00,662.60,7337.40,0.39,1
28095,3022,1000.00,9000.00,10000.00,0.00,9000.00,0.09,1
28096,3022,1000.00,10000.00,11000.00,0.00,10000.00,0.06,1
28097,3022,1000.00,11000.00,12000.00,0.00,11000.00,0.34,1
28098,3022,1000.00,12000.00,13000.00,1868.33,10131.67,0.42,1
28099,3022,1000.00,13000.00,14000.00,4330.96,8669.04,0.33,1
28100,3022,1000.00,14000.00,15000.00,0.00,14000.00,0.31,1
28101,3022,1000.00,15000.00,16000.00,0.00,11956.10,0.13,1
28102,3022,1000.00,16000.00,17000.00,6641.35,9009.29,0.27,1
28103,3022,1000.00,17000.00,18000.00,2016.57,14983.43,0.24,1
28104,3022,1000.00,18000.00,19000.00,2083.00,3256.59,0.17,1
28105,3022,1000.00,19000.00,20000.00,0.00,19000.00,0.14,1
28106,3022,-1000.00,18000.00,19000.00,10000.00,10000.00,0.09,0
28107,3022,-1000.00,17000.00,18000.00,0.00,19000.00,0.16,0
28108,3022,-1000.00,16000.00,17000.00,425.86,17574.14,0.39,0
28109,3022,-1000.00,15000.00,16000.00,0.00,17000.00,0.35,0
28110,3022,-1000.00,14000.00,15000.00,0.00,2832.14,0.02,0
28111,3022,-1000.00,13000.00,14000.00,0.00,2294.56,0.11,0
28112,3022,-1000.00,12000.00,13000.00,6585.03,7414.97,0.12,0
28113,3022,-1000.00,11000.00,12000.00,0.00,12314.08,0.29,0
28114,3022,-1000.00,10000.00,11000.00,0.00,12000.00,0.38,0
28115,3022,-519.79,9480.21,10480.21,0.00,519.79,0.09,0
28116,3022,-1000.00,8480.21,9480.21,1396.65,9083.56,0.37,0
28117,3022,-1000.00,7480.21,8480.21,0.00,9480.21,0.04,0
28118,3022,-1000.00,6480.21,7480.21,0.00,7417.66,0.15,0
28119,3022,-1000.00,5480.21,6480.21,4288.62,604.63,0.09,0
28120,3022,-1000.00,4480.21,5480.21,0.00,5074.71,0.17,0
28121,3022,-1000.00,3480.21,4480.21,0.00,2922.98,0.29,0
28122,3022,-1000.00,2480.21,3480.21,0.00,2127.51,0.12,0
28123,3022,-1000.00,1480.21,2480.21,0.00,2175.12,0.37,0
28124,3022,-1000.00,480.21,1480.21,646.28,805.99,0.25,0
28125,3022,-1000.00,-519.79,480.21,0.00,1342.92,0.39,0
28126,3022,-478.01,-997.79,2.21,0.00,478.01,0.11,0
28127,3022,-1000.00,-1997.79,-997.79,0.26,0.00,0.10,0
28128,3023,1000.00,1000.00,2000.00,513.97,486.03,0.07,1
28129,3023,-1000.00,0.00,1000.00,147.84,1852.16,0.11,0
28130,3023,-1000.00,-1000.00,0.00,0.00,1000.00,0.19,0
28131,3024,-1000.00,-1000.00,0.00,399.63,600.37,0.14,0
28132,3025,0.00,0.00,1000.00,0.00,0.00,0.13,0
28133,3025,-1000.00,-1000.00,0.00,612.40,387.60,0.04,0
28134,3025,-0.00,-1000.00,0.00,0.00,0.00,0.20,0
28135,3026,-709.68,-709.68,290.32,0.00,709.68,0.14,0
28136,3026,-261.82,-971.50,28.50,107.01,154.82,0.29,0
28137,3026,-616.97,-1588.47,-588.47,3.74,0.16,0.12,0
28138,3027,0.00,0.00,1000.00,0.00,0.00,0.03,0
28139,3027,-59.17,-59.17,940.83,0.00,59.17,0.10,0
28140,3027,-940.83,-1000.00,0.00,241.41,699.43,0.25,0
28141,3028,-1000.00,-1000.00,0.00,0.00,791.91,0.40,0
28142,3029,-448.00,-448.00,552.00,145.44,302.56,0.22,0
28143,3029,-552.00,-1000.00,0.00,265.24,286.76,0.13,0
28144,3030,-1000.00,-1000.00,0.00,0.00,674.46,0.08,0
28145,3031,1000.00,1000.00,2000.00,250.65,188.80,0.39,1
28146,3031,-736.35,263.65,1263.65,117.32,619.03,0.40,0
28147,3031,-1000.00,-736.35,263.65,582.58,681.07,0.04,0
28148,3031,-263.65,-1000.00,0.00,44.13,219.52,0.11,0
28149,3032,1000.00,1000.00,2000.00,155.03,844.97,0.42,1
28150,3032,1000.00,2000.00,3000.00,197.89,1802.11,0.06,1
28151,3032,1000.00,3000.00,4000.00,984.30,2015.70,0.30,1
28152,3032,-418.07,2581.93,3581.93,418.07,0.00,0.11,0
28153,3032,1000.00,3581.93,4581.93,1458.33,2123.60,0.21,1
28154,3032,1000.00,4581.93,5581.93,1094.46,3487.47,0.36,1
28155,3032,1000.00,5581.93,6581.93,0.00,4768.27,0.11,1
28156,3032,1000.00,6581.93,7581.93,3290.97,3290.97,0.02,1
28157,3032,1000.00,7581.93,8581.93,3019.50,4562.43,0.29,1
28158,3032,-1000.00,6581.93,7581.93,4500.98,4080.95,0.35,0
28159,3032,1000.00,7581.93,8581.93,0.00,4171.34,0.26,1
28160,3032,1000.00,8581.93,9581.93,438.39,8143.54,0.33,1
28161,3032,1000.00,9581.93,10581.93,2682.56,6899.38,0.05,1
28162,3032,1000.00,10581.93,11581.93,0.00,10581.93,0.09,1
28163,3032,1000.00,11581.93,12581.93,0.00,8857.58,0.21,1
28164,3032,1000.00,12581.93,13581.93,1990.70,9919.90,0.40,1
28165,3032,1000.00,13581.93,14581.93,0.00,9449.72,0.36,1
28166,3032,1000.00,14581.93,15581.93,3492.79,11089.15,0.43,1
28167,3032,-1000.00,13581.93,14581.93,0.00,15581.93,0.34,0
28168,3032,-1000.00,12581.93,13581.93,2923.44,10082.44,0.38,0
28169,3032,-1000.00,11581.93,12581.93,2924.92,9807.40,0.37,0
28170,3032,-1000.00,10581.93,11581.93,0.00,12581.93,0.08,0
28171,3032,-1000.00,9581.93,10581.93,1890.68,2619.61,0.42,0
28172,3032,-1000.00,8581.93,9581.93,10581.93,0.00,0.18,0
28173,3032,0.00,8581.93,9581.93,0.00,0.00,0.05,0
28174,3032,1000.00,9581.93,10581.93,0.00,3809.80,0.14,1
28175,3032,1000.00,10581.93,11581.93,4485.11,5947.63,0.26,1
28176,3032,1000.00,11581.93,12581.93,1007.47,8729.79,0.40,1
28177,3032,1000.00,12581.93,13581.93,5288.19,7293.75,0.20,1
28178,3032,1000.00,13581.93,14581.93,0.00,13581.93,0.02,1
28179,3032,1000.00,14581.93,15581.93,0.00,2458.79,0.16,1
28180,3032,1000.00,15581.93,16581.93,0.00,15581.93,0.01,1
28181,3032,-1000.00,14581.93,15581.93,7916.53,7829.62,0.24,0
28182,3032,1000.00,15581.93,16581.93,3803.27,11778.66,0.36,1
28183,3032,1000.00,16581.93,17581.93,4855.43,11726.51,0.34,1
28184,3032,1000.00,17581.93,18581.93,5453.45,12128.49,0.24,1
28185,3032,1000.00,18581.93,19581.93,0.00,7061.62,0.19,1
28186,3032,1000.00,19581.93,20581.93,0.00,14225.22,0.05,1
28187,3032,1000.00,20581.93,21581.93,0.00,20581.93,0.39,1
28188,3032,1000.00,21581.93,22581.93,10022.63,11559.30,0.11,1
28189,3032,1000.00,22581.93,23581.93,0.00,1341.83,0.13,1
28190,3032,1000.00,23581.93,24581.93,0.00,23185.23,0.30,1
28191,3032,1000.00,24581.93,25581.93,12290.97,12290.97,0.18,1
28192,3032,-1000.00,23581.93,24581.93,13258.20,12323.74,0.20,0
28193,3032,1000.00,24581.93,25581.93,4310.92,20271.02,0.26,1
28194,3032,-1000.00,23581.93,24581.93,13415.88,12166.05,0.30,0
28195,3032,1000.00,24581.93,25581.93,0.00,21587.30,0.35,1
28196,3033,1000.00,1000.00,2000.00,0.00,870.87,0.42,1
28197,3033,-1000.00,0.00,1000.00,0.00,2000.00,0.26,0
28198,3033,-1000.00,-1000.00,0.00,508.29,491.71,0.21,0
28199,3034,-1000.00,-1000.00,0.00,386.43,411.91,0.29,0
28200,3035,-432.68,-432.68,567.32,0.00,432.68,0.20,0
28201,3035,-567.32,-1000.00,0.00,0.00,567.32,0.34,0
28202,3036,-1000.00,-1000.00,0.00,137.58,862.42,0.43,0
28203,3037,1000.00,1000.00,2000.00,0.00,1000.00,0.04,1
28204,3037,1000.00,2000.00,3000.00,323.98,1676.02,0.36,1
28205,3037,1000.00,3000.00,4000.00,530.74,2469.26,0.30,1
28206,3037,1000.00,4000.00,5000.00,0.00,4000.00,0.14,1
28207,3037,1000.00,5000.00,6000.00,2341.17,2658.83,0.25,1
28208,3037,1000.00,6000.00,7000.00,0.00,6000.00,0.23,1
28209,3037,-1000.00,5000.00,6000.00,3780.97,3219.03,0.19,0
28210,3037,1000.00,6000.00,7000.00,0.00,6000.00,0.06,1
28211,3037,1000.00,7000.00,8000.00,0.00,5200.80,0.22,1
28212,3037,1000.00,8000.00,9000.00,267.50,5589.20,0.39,1
28213,3037,1000.00,9000.00,10000.00,3837.70,5162.30,0.14,1
28214,3037,1000.00,10000.00,11000.00,2311.01,7688.99,0.39,1
28215,3037,-1000.00,9000.00,10000.00,5103.31,2770.06,0.15,0
28216,3037,1000.00,10000.00,11000.00,0.00,5618.13,0.28,1
28217,3037,1000.00,11000.00,12000.00,0.00,4282.56,0.27,1
28218,3037,1000.00,12000.00,13000.00,0.00,1884.21,0.08,1
28219,3037,1000.00,13000.00,14000.00,0.00,6877.23,0.32,1
28220,3037,1000.00,14000.00,15000.00,0.00,14000.00,0.20,1
28221,3037,1000.00,15000.00,16000.00,0.00,7490.92,0.13,1
28222,3037,1000.00,16000.00,17000.00,5956.40,10043.60,0.31,1
28223,3037,-96.26,15903.74,16903.74,96.26,0.00,0.04,0
28224,3037,1000.00,16903.74,17903.74,0.00,16903.74,0.14,1
28225,3037,1000.00,17903.74,18903.74,0.00,8389.10,0.06,1
28226,3037,-1000.00,16903.74,17903.74,3906.33,2418.92,0.15,0
28227,3037,1000.00,17903.74,18903.74,0.00,17903.74,0.42,1
28228,3037,0.00,17903.74,18903.74,0.00,0.00,0.01,0
28229,3037,1000.00,18903.74,19903.74,0.00,5776.14,0.19,1
28230,3037,1000.00,19903.74,20903.74,0.00,19903.74,0.28,1
28231,3037,1000.00,20903.74,21903.74,2147.07,7695.35,0.25,1
28232,3037,1000.00,21903.74,22903.74,10951.87,10951.87,0.06,1
28233,3037,1000.00,22903.74,23903.74,0.00,22903.74,0.33,1
28234,3037,-1000.00,21903.74,22903.74,15903.06,8000.68,0.09,0
28235,3037,1000.00,22903.74,23903.74,0.00,18545.68,0.26,1
28236,3037,1000.00,23903.74,24903.74,0.00,23903.74,0.37,1
28237,3037,1000.00,24903.74,25903.74,0.00,14687.01,0.36,1
28238,3037,0.00,24903.74,25903.74,0.00,0.00,0.08,0
28239,3037,1000.00,25903.74,26903.74,0.00,25903.74,0.19,1
28240,3037,1000.00,26903.74,27903.74,0.00,26903.74,0.32,1
28241,3037,1000.00,27903.74,28903.74,11913.28,15990.46,0.01,1
28242,3037,1000.00,28903.74,29903.74,4372.50,24531.24,0.11,1
28243,3037,1000.00,29903.74,30903.74,2911.99,13813.28,0.29,1
28244,3037,1000.00,30903.74,31903.74,14321.62,16582.12,0.10,1
28245,3037,1000.00,31903.74,32903.74,13993.75,17909.99,0.26,1
28246,3037,1000.00,32903.74,33903.74,0.00,32903.74,0.29,1
28247,3037,1000.00,33903.74,34903.74,0.00,33903.74,0.37,1
28248,3037,1000.00,34903.74,35903.74,10034.28,24869.46,0.29,1
28249,3037,1000.00,35903.74,36903.74,0.00,35903.74,0.23,1
28250,3037,-1000.00,34903.74,35903.74,0.00,20052.14,0.25,0
28251,3037,-1000.00,33903.74,34903.74,1913.70,14137.01,0.26,0
28252,3037,-1000.00,32903.74,33903.74,0.00,34903.74,0.16,0
28253,3037,-1000.00,31903.74,32903.74,2318.08,31585.66,0.28,0
28254,3037,-1000.00,30903.74,31903.74,0.00,14063.30,0.28,0
28255,3037,-1000.00,29903.74,30903.74,2268.42,29635.32,0.42,0
28256,3037,-1000.00,28903.74,29903.74,0.00,30903.74,0.26,0
28257,3037,-1000.00,27903.74,28903.74,2473.33,6688.37,0.19,0
28258,3037,-1000.00,26903.74,27903.74,0.00,27432.41,0.36,0
28259,3037,-1000.00,25903.74,26903.74,0.00,27903.74,0.39,0
28260,3037,-1000.00,24903.74,25903.74,0.00,26903.74,0.41,0
28261,3037,-1000.00,23903.74,24903.74,4246.08,21657.66,0.33,0
28262,3037,-1000.00,22903.74,23903.74,0.00,24903.74,0.21,0
28263,3037,-1000.00,21903.74,22903.74,0.00,20405.48,0.40,0
28264,3037,-1000.00,20903.74,21903.74,0.00,22903.74,0.33,0
28265,3037,-1000.00,19903.74,20903.74,0.00,16401.76,0.17,0
28266,3037,-1000.00,18903.74,19903.74,2142.52,0.00,0.09,0
28267,3037,-1000.00,17903.74,18903.74,4064.24,15839.50,0.30,0
28268,3037,-1000.00,16903.74,17903.74,427.79,12133.15,0.38,0
28269,3037,-1000.00,15903.74,16903.74,6657.15,11246.59,0.30,0
28270,3038,-1000.00,-1000.00,0.00,667.52,332.48,0.03,0
28271,3039,-1000.00,-1000.00,0.00,313.17,686.83,0.03,0
28272,3040,-1000.00,-1000.00,0.00,0.00,1000.00,0.25,0
28273,3041,-1000.00,-1000.00,0.00,0.00,1000.00,0.08,0
28274,3042,1000.00,1000.00,2000.00,0.00,1000.00,0.06,1
28275,3042,1000.00,2000.00,3000.00,0.00,1549.33,0.06,1
28276,3042,1000.00,3000.00,4000.00,456.76,2543.24,0.41,1
28277,3042,1000.00,4000.00,5000.00,0.00,4000.00,0.41,1
28278,3042,1000.00,5000.00,6000.00,0.00,2598.71,0.00,1
28279,3042,1000.00,6000.00,7000.00,0.00,4366.28,0.03,1
28280,3042,1000.00,7000.00,8000.00,319.20,6680.80,0.43,1
28281,3042,1000.00,8000.00,9000.00,806.98,7193.02,0.43,1
28282,3042,1000.00,9000.00,10000.00,0.00,2642.30,0.18,1
28283,3042,1000.00,10000.00,11000.00,2859.89,7140.11,0.43,1
28284,3042,1000.00,11000.00,12000.00,60.07,3243.01,0.22,1
28285,3042,1000.00,12000.00,13000.00,3755.41,8244.59,0.21,1
28286,3042,-1000.00,11000.00,12000.00,5197.59,7802.41,0.41,0
28287,3042,-1000.00,10000.00,11000.00,0.00,12000.00,0.32,0
28288,3042,-1000.00,9000.00,10000.00,6305.50,4694.50,0.18,0
28289,3042,-1000.00,8000.00,9000.00,7114.99,2885.01,0.07,0
28290,3042,-1000.00,7000.00,8000.00,4342.69,4657.31,0.25,0
28291,3042,-1000.00,6000.00,7000.00,0.00,7183.37,0.25,0
28292,3042,-1000.00,5000.00,6000.00,0.00,2999.75,0.27,0
28293,3042,-1000.00,4000.00,5000.00,1210.16,3485.28,0.40,0
28294,3042,-1000.00,3000.00,4000.00,0.00,4091.98,0.18,0
28295,3042,-1000.00,2000.00,3000.00,1814.13,0.00,0.01,0
28296,3042,-1000.00,1000.00,2000.00,779.33,1937.72,0.38,0
28297,3042,-1000.00,0.00,1000.00,954.32,1045.68,0.11,0
28298,3042,-1000.00,-1000.00,0.00,528.09,471.91,0.39,0
28299,3043,-1000.00,-1000.00,0.00,339.31,660.69,0.35,0
28300,3044,-1000.00,-1000.00,0.00,197.23,802.77,0.38,0
28301,3045,1000.00,1000.00,2000.00,0.00,187.51,0.01,1
28302,3045,1000.00,2000.00,3000.00,841.76,1158.24,0.18,1
28303,3045,1000.00,3000.00,4000.00,638.64,2361.36,0.38,1
28304,3045,1000.00,4000.00,5000.00,0.00,795.77,0.15,1
28305,3045,1000.00,5000.00,6000.00,0.00,3043.70,0.36,1
28306,3045,1000.00,6000.00,7000.00,0.00,6000.00,0.01,1
28307,3045,1000.00,7000.00,8000.00,3500.00,3500.00,0.04,1
28308,3045,1000.00,8000.00,9000.00,753.60,1030.97,0.16,1
28309,3045,1000.00,9000.00,10000.00,4008.41,4991.59,0.17,1
28310,3045,1000.00,10000.00,11000.00,0.00,10000.00,0.41,1
28311,3045,-1000.00,9000.00,10000.00,6808.43,4191.57,0.04,0
28312,3045,-1000.00,8000.00,9000.00,5022.52,4977.48,0.22,0
28313,3045,1000.00,9000.00,10000.00,0.00,7789.93,0.30,1
28314,3045,1000.00,10000.00,11000.00,4192.33,5807.67,0.11,1
28315,3045,1000.00,11000.00,12000.00,4166.61,6833.39,0.13,1
28316,3045,1000.00,12000.00,13000.00,2577.12,9422.88,0.28,1
28317,3045,-1000.00,11000.00,12000.00,9714.50,3285.50,0.02,0
28318,3045,1000.00,12000.00,13000.00,0.00,11953.28,0.44,1
28319,3045,1000.00,13000.00,14000.00,0.00,5053.14,0.26,1
28320,3045,1000.00,14000.00,15000.00,4124.20,7870.04,0.30,1
28321,3045,1000.00,15000.00,16000.00,6176.20,8823.80,0.28,1
28322,3045,1000.00,16000.00,17000.00,0.00,16000.00,0.19,1
28323,3045,1000.00,17000.00,18000.00,0.00,17000.00,0.19,1
28324,3045,1000.00,18000.00,19000.00,0.00,1583.09,0.12,1
28325,3045,-1000.00,17000.00,18000.00,9500.00,9500.00,0.04,0
28326,3045,-1000.00,16000.00,17000.00,0.00,8900.26,0.32,0
28327,3045,0.00,16000.00,17000.00,0.00,0.00,0.05,0
28328,3045,-1000.00,15000.00,16000.00,1217.53,15782.47,0.23,0
28329,3045,-1000.00,14000.00,15000.00,5632.60,8051.46,0.27,0
28330,3045,-1000.00,13000.00,14000.00,4022.62,10977.38,0.22,0
28331,3045,-1000.00,12000.00,13000.00,0.00,5892.64,0.27,0
28332,3045,-1000.00,11000.00,12000.00,7269.23,5730.77,0.39,0
28333,3045,-1000.00,10000.00,11000.00,359.80,11640.20,0.09,0
28334,3045,-1000.00,9000.00,10000.00,0.00,11000.00,0.11,0
28335,3045,-1000.00,8000.00,9000.00,0.00,10000.00,0.28,0
28336,3045,-1000.00,7000.00,8000.00,5116.64,3883.36,0.15,0
28337,3045,-1000.00,6000.00,7000.00,4000.00,4000.00,0.08,0
28338,3045,-1000.00,5000.00,6000.00,0.00,7000.00,0.28,0
28339,3045,-1000.00,4000.00,5000.00,0.00,6000.00,0.30,0
28340,3045,-1000.00,3000.00,4000.00,1224.87,0.00,0.08,0
28341,3045,-1000.00,2000.00,3000.00,0.00,4000.00,0.16,0
28342,3045,-1000.00,1000.00,2000.00,0.00,3000.00,0.21,0
28343,3045,-1000.00,0.00,1000.00,0.00,2000.00,0.27,0
28344,3045,-1000.00,-1000.00,0.00,231.44,768.56,0.40,0
28345,3046,-1000.00,-1000.00,0.00,218.04,781.96,0.36,0
28346,3047,1000.00,1000.00,2000.00,17.72,982.28,0.41,1
28347,3047,1000.00,2000.00,3000.00,963.85,1036.15,0.17,1
28348,3047,1000.00,3000.00,4000.00,0.00,3000.00,0.14,1
28349,3047,1000.00,4000.00,5000.00,0.00,4000.00,0.39,1
28350,3047,1000.00,5000.00,6000.00,814.50,4185.50,0.38,1
28351,3047,-1000.00,4000.00,5000.00,3229.16,1256.54,0.18,0
28352,3047,1000.00,5000.00,6000.00,2040.74,2959.26,0.05,1
28353,3047,1000.00,6000.00,7000.00,2292.81,3707.19,0.23,1
28354,3047,1000.00,7000.00,8000.00,0.00,5768.18,0.14,1
28355,3047,1000.00,8000.00,9000.00,0.00,7100.49,0.30,1
28356,3047,1000.00,9000.00,10000.00,0.00,7282.96,0.12,1
28357,3047,-1000.00,8000.00,9000.00,4790.39,4646.55,0.20,0
28358,3047,-1000.00,7000.00,8000.00,4887.13,4112.87,0.11,0
28359,3047,1000.00,8000.00,9000.00,3914.46,4085.54,0.19,1
28360,3047,1000.00,9000.00,10000.00,3658.95,5341.05,0.08,1
28361,3047,1000.00,10000.00,11000.00,3213.35,6786.65,0.34,1
28362,3047,1000.00,11000.00,12000.00,4192.64,6807.36,0.09,1
28363,3047,1000.00,12000.00,13000.00,551.79,11448.21,0.37,1
28364,3047,1000.00,13000.00,14000.00,0.00,13000.00,0.22,1
28365,3047,-1000.00,12000.00,13000.00,7161.47,5358.94,0.19,0
28366,3047,1000.00,13000.00,14000.00,0.00,9234.01,0.11,1
28367,3047,-1000.00,12000.00,13000.00,12601.02,1398.98,0.04,0
28368,3047,-1000.00,11000.00,12000.00,4105.47,8894.53,0.24,0
28369,3047,0.00,11000.00,12000.00,0.00,0.00,0.10,0
28370,3047,-1000.00,10000.00,11000.00,0.00,10424.35,0.18,0
28371,3047,-1000.00,9000.00,10000.00,0.00,11000.00,0.26,0
28372,3047,-1000.00,8000.00,9000.00,0.00,9391.56,0.42,0
28373,3047,-1000.00,7000.00,8000.00,3742.31,2828.58,0.18,0
28374,3047,-1000.00,6000.00,7000.00,3785.78,4214.22,0.24,0
28375,3047,-1000.00,5000.00,6000.00,3500.00,3500.00,0.02,0
28376,3047,-1000.00,4000.00,5000.00,0.00,5594.37,0.42,0
28377,3047,-1000.00,3000.00,4000.00,0.00,4542.26,0.35,0
28378,3047,-1000.00,2000.00,3000.00,0.00,3715.78,0.26,0
28379,3047,-1000.00,1000.00,2000.00,797.38,1344.48,0.28,0
28380,3047,-1000.00,0.00,1000.00,0.00,2000.00,0.10,0
28381,3047,-1000.00,-1000.00,0.00,0.00,1000.00,0.32,0
28382,3048,-1000.00,-1000.00,0.00,0.00,441.00,0.34,0
28383,3049,1000.00,1000.00,2000.00,500.00,500.00,0.06,1
28384,3049,1000.00,2000.00,3000.00,449.45,1550.55,0.25,1
28385,3049,1000.00,3000.00,4000.00,0.00,3000.00,0.42,1
28386,3049,1000.00,4000.00,5000.00,657.07,2718.95,0.37,1
28387,3049,1000.00,5000.00,6000.00,2500.00,2500.00,0.19,1
28388,3049,1000.00,6000.00,7000.00,1188.01,4811.99,0.40,1
28389,3049,1000.00,7000.00,8000.00,556.30,6443.70,0.12,1
28390,3049,-1000.00,6000.00,7000.00,5723.20,0.00,0.09,0
28391,3049,1000.00,7000.00,8000.00,1759.01,5240.99,0.37,1
28392,3049,1000.00,8000.00,9000.00,0.00,8000.00,0.30,1
28393,3049,1000.00,9000.00,10000.00,3721.87,5278.13,0.23,1
28394,3049,-1000.00,8000.00,9000.00,6063.09,3936.91,0.35,0
28395,3049,1000.00,9000.00,10000.00,0.00,9000.00,0.07,1
28396,3049,1000.00,10000.00,11000.00,0.00,10000.00,0.11,1
28397,3049,0.00,10000.00,11000.00,0.00,0.00,0.01,0
28398,3049,1000.00,11000.00,12000.00,5500.00,5500.00,0.33,1
28399,3049,1000.00,12000.00,13000.00,0.00,12000.00,0.00,1
28400,3049,1000.00,13000.00,14000.00,0.00,13000.00,0.28,1
28401,3049,1000.00,14000.00,15000.00,0.00,14000.00,0.14,1
28402,3049,1000.00,15000.00,16000.00,0.00,15000.00,0.11,1
28403,3049,1000.00,16000.00,17000.00,8000.00,8000.00,0.00,1
28404,3049,1000.00,17000.00,18000.00,0.00,11217.18,0.25,1
28405,3049,1000.00,18000.00,19000.00,9000.00,9000.00,0.05,1
28406,3049,1000.00,19000.00,20000.00,3292.24,15707.76,0.35,1
28407,3049,1000.00,20000.00,21000.00,0.00,12049.38,0.08,1
28408,3049,1000.00,21000.00,22000.00,7755.98,13244.02,0.30,1
28409,3049,-1000.00,20000.00,21000.00,16060.06,5939.94,0.07,0
28410,3049,1000.00,21000.00,22000.00,0.00,16290.78,0.39,1
28411,3049,-1000.00,20000.00,21000.00,11580.83,0.00,0.07,0
28412,3049,1000.00,21000.00,22000.00,6808.18,7836.70,0.23,1
28413,3049,1000.00,22000.00,23000.00,0.00,15088.80,0.21,1
28414,3049,1000.00,23000.00,24000.00,10739.28,12260.72,0.21,1
28415,3049,1000.00,24000.00,25000.00,9791.89,14208.11,0.14,1
28416,3049,0.00,24000.00,25000.00,0.00,0.00,0.07,0
28417,3049,1000.00,25000.00,26000.00,10996.51,14003.49,0.04,1
28418,3049,-1000.00,24000.00,25000.00,9345.00,0.00,0.07,0
28419,3049,1000.00,25000.00,26000.00,5149.98,10611.70,0.28,1
28420,3049,1000.00,26000.00,27000.00,0.00,11377.23,0.28,1
28421,3049,1000.00,27000.00,28000.00,3475.87,16655.00,0.35,1
28422,3049,0.00,27000.00,28000.00,0.00,0.00,0.03,0
28423,3049,1000.00,28000.00,29000.00,0.00,28000.00,0.26,1
28424,3050,-1000.00,-1000.00,0.00,390.88,609.12,0.03,0
28425,3051,-1000.00,-1000.00,0.00,693.79,306.21,0.07,0
28426,3052,-1000.00,-1000.00,0.00,451.23,548.77,0.18,0
28427,3053,1000.00,1000.00,2000.00,503.29,496.71,0.22,1
28428,3053,-1000.00,0.00,1000.00,0.00,1984.87,0.10,0
28429,3053,-1000.00,-1000.00,0.00,255.03,744.97,0.11,0
28430,3054,-537.45,-537.45,462.55,0.00,537.45,0.39,0
28431,3054,-325.56,-863.00,137.00,29.32,296.24,0.43,0
28432,3054,-137.00,-1000.00,0.00,68.50,68.50,0.10,0
28433,3055,-694.43,-694.43,305.57,0.00,694.43,0.34,0
28434,3055,-228.09,-922.52,77.48,0.00,228.09,0.39,0
28435,3055,-35.02,-957.54,42.46,0.00,35.02,0.28,0
28436,3055,-21.34,-978.88,21.12,0.00,21.34,0.08,0
28437,3055,-19.89,-998.77,1.23,8.87,11.02,0.25,0
28438,3055,-80.33,-1079.10,-79.10,0.70,0.53,0.06,0
28439,3056,-1000.00,-1000.00,0.00,656.68,343.32,0.13,0
28440,3057,-1000.00,-1000.00,0.00,0.00,1000.00,0.07,0
28441,3058,-1000.00,-1000.00,0.00,319.27,680.73,0.33,0
28442,3059,-1000.00,-1000.00,0.00,0.00,1000.00,0.10,0
28443,3060,-464.90,-464.90,535.10,0.00,464.90,0.36,0
28444,3060,-535.10,-1000.00,0.00,0.00,535.10,0.02,0
28445,3061,-1000.00,-1000.00,0.00,311.11,688.89,0.31,0
28446,3062,-1000.00,-1000.00,0.00,443.64,0.00,0.19,0
28447,3063,-1000.00,-1000.00,0.00,0.00,1000.00,0.16,0
28448,3064,-1000.00,-1000.00,0.00,493.18,506.82,0.09,0
28449,3065,1000.00,1000.00,2000.00,500.00,500.00,0.02,1
28450,3065,1000.00,2000.00,3000.00,0.00,1831.31,0.44,1
28451,3065,-83.70,1916.30,2916.30,82.58,1.11,0.11,0
28452,3065,1000.00,2916.30,3916.30,0.00,2916.30,0.09,1
28453,3065,1000.00,3916.30,4916.30,589.33,3275.14,0.41,1
28454,3065,1000.00,4916.30,5916.30,0.00,4916.30,0.15,1
28455,3065,1000.00,5916.30,6916.30,0.00,4143.87,0.35,1
28456,3065,1000.00,6916.30,7916.30,0.00,5306.86,0.19,1
28457,3065,-1000.00,5916.30,6916.30,3983.73,2847.17,0.18,0
28458,3065,1000.00,6916.30,7916.30,0.00,1479.14,0.18,1
28459,3065,1000.00,7916.30,8916.30,3585.51,4330.79,0.09,1
28460,3065,1000.00,8916.30,9916.30,1206.47,3906.13,0.28,1
28461,3065,1000.00,9916.30,10916.30,2748.30,7168.00,0.35,1
28462,3065,1000.00,10916.30,11916.30,4636.04,6280.27,0.21,1
28463,3065,1000.00,11916.30,12916.30,0.00,11916.30,0.37,1
28464,3065,1000.00,12916.30,13916.30,0.00,12916.30,0.26,1
28465,3065,1000.00,13916.30,14916.30,0.00,12278.31,0.10,1
28466,3065,1000.00,14916.30,15916.30,875.21,3275.75,0.19,1
28467,3065,1000.00,15916.30,16916.30,0.00,15916.30,0.19,1
28468,3065,-1000.00,14916.30,15916.30,7858.27,9058.04,0.42,0
28469,3065,-1000.00,13916.30,14916.30,0.00,4239.76,0.21,0
28470,3065,-1000.00,12916.30,13916.30,1736.57,13179.73,0.17,0
28471,3065,-1000.00,11916.30,12916.30,5934.54,5355.67,0.26,0
28472,3065,-1000.00,10916.30,11916.30,0.00,12916.30,0.05,0
28473,3065,-1000.00,9916.30,10916.30,0.00,11248.30,0.32,0
28474,3065,-1000.00,8916.30,9916.30,0.00,10916.30,0.01,0
28475,3065,-1000.00,7916.30,8916.30,965.42,8869.43,0.43,0
28476,3065,-1000.00,6916.30,7916.30,343.54,6663.13,0.40,0
28477,3065,-1000.00,5916.30,6916.30,0.00,6134.88,0.39,0
28478,3065,-1000.00,4916.30,5916.30,2354.96,4561.35,0.33,0
28479,3065,-1000.00,3916.30,4916.30,1185.61,4730.70,0.38,0
28480,3065,0.00,3916.30,4916.30,0.00,0.00,0.08,0
28481,3065,-1000.00,2916.30,3916.30,2458.15,2458.15,0.07,0
28482,3065,-1000.00,1916.30,2916.30,101.11,3269.00,0.43,0
28483,3065,-1000.00,916.30,1916.30,0.00,2916.30,0.38,0
28484,3065,-1000.00,-83.70,916.30,0.00,1066.17,0.25,0
28485,3065,-1000.00,-1083.70,-83.70,459.64,456.67,0.22,0
28486,3066,1000.00,1000.00,2000.00,0.00,348.98,0.19,1
28487,3066,-631.35,368.65,1368.65,318.55,312.80,0.16,0
28488,3066,1000.00,1368.65,2368.65,239.32,1129.32,0.34,1
28489,3066,1000.00,2368.65,3368.65,900.66,1048.62,0.24,1
28490,3066,1000.00,3368.65,4368.65,0.00,3368.65,0.04,1
28491,3066,1000.00,4368.65,5368.65,1296.62,3072.02,0.35,1
28492,3066,1000.00,5368.65,6368.65,2458.48,2910.16,0.01,1
28493,3066,1000.00,6368.65,7368.65,0.00,1600.33,0.11,1
28494,3066,-1000.00,5368.65,6368.65,6649.90,718.75,0.06,0
28495,3066,1000.00,6368.65,7368.65,2960.64,3408.00,0.15,1
28496,3066,1000.00,7368.65,8368.65,0.00,7368.65,0.07,1
28497,3066,1000.00,8368.65,9368.65,328.02,6592.45,0.41,1
28498,3066,1000.00,9368.65,10368.65,0.00,1118.04,0.03,1
28499,3066,1000.00,10368.65,11368.65,981.34,9387.31,0.40,1
28500,3066,-1000.00,9368.65,10368.65,5902.90,0.00,0.07,0
28501,3066,1000.00,10368.65,11368.65,3364.56,7004.09,0.30,1
28502,3066,1000.00,11368.65,12368.65,0.00,10183.20,0.43,1
28503,3066,1000.00,12368.65,13368.65,5229.39,7139.26,0.20,1
28504,3066,1000.00,13368.65,14368.65,0.00,13368.65,0.19,1
28505,3066,1000.00,14368.65,15368.65,0.00,14368.65,0.18,1
28506,3066,1000.00,15368.65,16368.65,3882.95,11485.69,0.39,1
28507,3066,1000.00,16368.65,17368.65,3255.93,13112.71,0.43,1
28508,3066,-1000.00,15368.65,16368.65,15943.10,1401.86,0.14,0
28509,3066,1000.00,16368.65,17368.65,3518.21,12850.44,0.40,1
28510,3066,1000.00,17368.65,18368.65,5852.91,11515.73,0.26,1
28511,3066,1000.00,18368.65,19368.65,0.00,7659.70,0.09,1
28512,3066,1000.00,19368.65,20368.65,7899.67,11468.98,0.20,1
28513,3066,1000.00,20368.65,21368.65,0.00,7249.06,0.20,1
28514,3066,1000.00,21368.65,22368.65,8969.73,12398.92,0.32,1
28515,3066,1000.00,22368.65,23368.65,0.00,22368.65,0.36,1
28516,3066,1000.00,23368.65,24368.65,0.00,23368.65,0.38,1
28517,3066,-1000.00,22368.65,23368.65,0.00,10521.75,0.09,0
28518,3066,-1000.00,21368.65,22368.65,21367.92,2000.73,0.06,0
28519,3066,-1000.00,20368.65,21368.65,0.00,22368.65,0.06,0
28520,3066,-1000.00,19368.65,20368.65,19517.24,0.00,0.03,0
28521,3066,-1000.00,18368.65,19368.65,0.00,9341.08,0.25,0
28522,3066,-1000.00,17368.65,18368.65,9526.81,9841.83,0.11,0
28523,3066,-1000.00,16368.65,17368.65,7494.83,10873.82,0.22,0
28524,3066,-1000.00,15368.65,16368.65,0.00,2878.54,0.43,0
28525,3066,0.00,15368.65,16368.65,0.00,0.00,0.12,0
28526,3066,-1000.00,14368.65,15368.65,2446.94,13921.71,0.12,0
28527,3067,-1000.00,-1000.00,0.00,776.86,0.00,0.08,0
28528,3068,1000.00,1000.00,2000.00,0.00,789.31,0.21,1
28529,3068,1000.00,2000.00,3000.00,0.00,2000.00,0.26,1
28530,3068,-1000.00,1000.00,2000.00,2121.03,878.97,0.15,0
28531,3068,1000.00,2000.00,3000.00,45.19,1954.81,0.44,1
28532,3068,1000.00,3000.00,4000.00,395.00,2605.00,0.25,1
28533,3068,1000.00,4000.00,5000.00,0.00,4000.00,0.16,1
28534,3068,1000.00,5000.00,6000.00,346.80,4653.20,0.44,1
28535,3068,1000.00,6000.00,7000.00,2584.63,3415.37,0.19,1
28536,3068,1000.00,7000.00,8000.00,1908.36,5091.64,0.02,1
28537,3068,-1000.00,6000.00,7000.00,4362.55,0.00,0.07,0
28538,3068,1000.00,7000.00,8000.00,3500.00,3500.00,0.03,1
28539,3068,1000.00,8000.00,9000.00,1886.16,6113.84,0.39,1
28540,3068,1000.00,9000.00,10000.00,3193.35,5806.65,0.29,1
28541,3068,1000.00,10000.00,11000.00,0.00,10000.00,0.24,1
28542,3068,1000.00,11000.00,12000.00,3238.94,7761.06,0.36,1
28543,3068,1000.00,12000.00,13000.00,0.00,11433.03,0.42,1
28544,3068,1000.00,13000.00,14000.00,0.00,4909.64,0.09,1
28545,3068,1000.00,14000.00,15000.00,0.00,14000.00,0.28,1
28546,3068,-1000.00,13000.00,14000.00,0.00,6799.74,0.06,0
28547,3068,-1000.00,12000.00,13000.00,3674.71,10325.29,0.25,0
28548,3068,-1000.00,11000.00,12000.00,4704.02,8295.98,0.08,0
28549,3068,-1000.00,10000.00,11000.00,4404.49,7595.51,0.28,0
28550,3068,-1000.00,9000.00,10000.00,7235.25,3764.75,0.04,0
28551,3068,-1000.00,8000.00,9000.00,0.00,6873.96,0.20,0
28552,3068,-1000.00,7000.00,8000.00,0.00,9000.00,0.28,0
28553,3068,-1000.00,6000.00,7000.00,0.00,8000.00,0.35,0
28554,3068,-1000.00,5000.00,6000.00,0.00,7000.00,0.14,0
28555,3068,-1000.00,4000.00,5000.00,0.00,1123.78,0.17,0
28556,3068,-1000.00,3000.00,4000.00,227.49,4772.51,0.36,0
28557,3068,-1000.00,2000.00,3000.00,0.00,4000.00,0.36,0
28558,3068,-1000.00,1000.00,2000.00,50.66,2311.56,0.42,0
28559,3068,-1000.00,0.00,1000.00,0.00,2000.00,0.39,0
28560,3068,-1000.00,-1000.00,0.00,303.01,696.99,0.32,0
28561,3069,-1000.00,-1000.00,0.00,580.49,419.51,0.04,0
28562,3070,-1000.00,-1000.00,0.00,95.54,904.46,0.41,0
28563,3071,1000.00,1000.00,2000.00,425.36,574.64,0.20,1
28564,3071,1000.00,2000.00,3000.00,680.40,1319.60,0.32,1
28565,3071,-616.14,1383.86,2383.86,616.14,0.00,0.08,0
28566,3071,-1000.00,383.86,1383.86,1238.02,1145.85,0.43,0
28567,3071,1000.00,1383.86,2383.86,0.00,1383.86,0.44,1
28568,3071,1000.00,2383.86,3383.86,0.00,2383.86,0.30,1
28569,3071,1000.00,3383.86,4383.86,0.00,3383.86,0.15,1
28570,3071,-1000.00,2383.86,3383.86,1817.56,0.00,0.03,0
28571,3071,1000.00,3383.86,4383.86,1691.93,1691.93,0.27,1
28572,3071,1000.00,4383.86,5383.86,0.00,4383.86,0.07,1
28573,3071,1000.00,5383.86,6383.86,702.92,4680.95,0.29,1
28574,3071,1000.00,6383.86,7383.86,2654.98,3728.88,0.42,1
28575,3071,1000.00,7383.86,8383.86,995.63,6388.23,0.14,1
28576,3071,-1000.00,6383.86,7383.86,4597.56,3786.30,0.08,0
28577,3071,1000.00,7383.86,8383.86,2136.10,5247.77,0.23,1
28578,3071,1000.00,8383.86,9383.86,0.00,8383.86,0.31,1
28579,3071,1000.00,9383.86,10383.86,0.00,9383.86,0.37,1
28580,3071,1000.00,10383.86,11383.86,2556.56,7827.30,0.39,1
28581,3071,1000.00,11383.86,12383.86,0.00,11383.86,0.37,1
28582,3071,1000.00,12383.86,13383.86,1810.89,10572.97,0.20,1
28583,3071,-1000.00,11383.86,12383.86,1166.03,0.00,0.10,0
28584,3071,1000.00,12383.86,13383.86,986.46,11397.40,0.15,1
28585,3071,-1000.00,11383.86,12383.86,5790.87,7592.99,0.20,0
28586,3071,-1000.00,10383.86,11383.86,0.00,12383.86,0.32,0
28587,3071,-1000.00,9383.86,10383.86,0.00,10224.26,0.23,0
28588,3071,-1000.00,8383.86,9383.86,0.00,10383.86,0.00,0
28589,3071,-1000.00,7383.86,8383.86,2415.81,6968.06,0.25,0
28590,3071,-1000.00,6383.86,7383.86,0.00,6368.45,0.39,0
28591,3071,-843.04,5540.83,6540.83,0.00,843.04,0.14,0
28592,3071,-1000.00,4540.83,5540.83,1820.04,4720.78,0.18,0
28593,3071,-732.74,3808.09,4808.09,0.00,732.74,0.10,0
28594,3071,-1000.00,2808.09,3808.09,2194.84,2613.25,0.13,0
28595,3071,-1000.00,1808.09,2808.09,0.00,3808.09,0.24,0
28596,3071,-560.77,1247.32,2247.32,0.00,560.77,0.07,0
28597,3071,-1000.00,247.32,1247.32,838.51,1408.82,0.43,0
28598,3071,-798.42,-551.09,448.91,0.00,798.42,0.28,0
28599,3071,-448.91,-1000.00,0.00,193.13,255.78,0.14,0
28600,3072,-1000.00,-1000.00,0.00,0.00,1000.00,0.37,0
28601,3073,1000.00,1000.00,2000.00,0.00,247.92,0.14,1
28602,3073,1000.00,2000.00,3000.00,0.00,2000.00,0.18,1
28603,3073,1000.00,3000.00,4000.00,1129.59,1870.41,0.13,1
28604,3073,1000.00,4000.00,5000.00,0.00,4000.00,0.29,1
28605,3073,1000.00,5000.00,6000.00,49.86,4560.52,0.44,1
28606,3073,1000.00,6000.00,7000.00,0.00,6000.00,0.19,1
28607,3073,1000.00,7000.00,8000.00,0.00,1836.50,0.02,1
28608,3073,1000.00,8000.00,9000.00,0.00,8000.00,0.32,1
28609,3073,1000.00,9000.00,10000.00,0.00,9000.00,0.03,1
28610,3073,1000.00,10000.00,11000.00,0.00,9590.03,0.37,1
28611,3073,1000.00,11000.00,12000.00,2855.20,7096.06,0.35,1
28612,3073,-1000.00,10000.00,11000.00,6127.13,0.00,0.06,0
28613,3073,1000.00,11000.00,12000.00,0.00,4215.42,0.13,1
28614,3073,1000.00,12000.00,13000.00,1829.83,10170.17,0.37,1
28615,3073,1000.00,13000.00,14000.00,0.00,9489.36,0.40,1
28616,3073,1000.00,14000.00,15000.00,0.00,3949.47,0.12,1
28617,3073,1000.00,15000.00,16000.00,0.00,13335.01,0.40,1
28618,3073,1000.00,16000.00,17000.00,7127.45,8872.55,0.41,1
28619,3073,1000.00,17000.00,18000.00,0.00,17000.00,0.15,1
28620,3073,1000.00,18000.00,19000.00,0.00,17969.52,0.10,1
28621,3073,1000.00,19000.00,20000.00,9500.00,9500.00,0.34,1
28622,3073,1000.00,20000.00,21000.00,2251.64,11791.88,0.33,1
28623,3073,0.00,20000.00,21000.00,0.00,0.00,0.07,0
28624,3073,-1000.00,19000.00,20000.00,1689.29,19310.71,0.16,0
28625,3073,-1000.00,18000.00,19000.00,98.83,19901.17,0.14,0
28626,3073,-1000.00,17000.00,18000.00,931.97,0.00,0.04,0
28627,3073,-1000.00,16000.00,17000.00,3691.41,14308.59,0.40,0
28628,3073,-1000.00,15000.00,16000.00,1361.60,15638.40,0.19,0
28629,3073,-1000.00,14000.00,15000.00,5483.78,6751.10,0.24,0
28630,3073,-1000.00,13000.00,14000.00,7500.00,7500.00,0.06,0
28631,3073,-1000.00,12000.00,13000.00,0.00,14000.00,0.14,0
28632,3073,-1000.00,11000.00,12000.00,0.00,13000.00,0.26,0
28633,3073,-1000.00,10000.00,11000.00,0.00,12000.00,0.23,0
28634,3073,-1000.00,9000.00,10000.00,1570.05,9429.95,0.15,0
28635,3073,-1000.00,8000.00,9000.00,2566.94,7433.06,0.37,0
28636,3073,-1000.00,7000.00,8000.00,7080.58,1919.42,0.18,0
28637,3073,-1000.00,6000.00,7000.00,0.00,5591.78,0.30,0
28638,3073,-1000.00,5000.00,6000.00,3697.49,3302.51,0.08,0
28639,3073,-1000.00,4000.00,5000.00,809.06,5190.94,0.31,0
28640,3073,-1000.00,3000.00,4000.00,1271.23,3728.77,0.38,0
28641,3073,-1000.00,2000.00,3000.00,0.00,4000.00,0.19,0
28642,3073,-1000.00,1000.00,2000.00,400.75,1827.98,0.35,0
28643,3073,-1000.00,0.00,1000.00,0.00,2000.00,0.44,0
28644,3073,-1000.00,-1000.00,0.00,422.43,577.57,0.27,0
28645,3074,1000.00,1000.00,2000.00,522.22,42.41,0.08,1
28646,3074,-1000.00,0.00,1000.00,803.77,1196.23,0.08,0
28647,3074,1000.00,1000.00,2000.00,664.68,278.12,0.22,1
28648,3074,-1000.00,0.00,1000.00,620.22,1379.78,0.33,0
28649,3074,1000.00,1000.00,2000.00,355.71,6.09,0.15,1
28650,3074,1000.00,2000.00,3000.00,1430.76,569.24,0.20,1
28651,3074,-1000.00,1000.00,2000.00,10.87,2989.13,0.11,0
28652,3074,-1000.00,0.00,1000.00,805.20,1151.80,0.30,0
28653,3074,-1000.00,-1000.00,0.00,451.20,548.80,0.20,0
28654,3075,-1000.00,-1000.00,0.00,555.47,444.53,0.01,0
28655,3076,0.00,0.00,1000.00,0.00,0.00,0.19,0
28656,3076,-968.05,-968.05,31.95,0.00,968.05,0.33,0
28657,3076,1000.00,31.95,1031.95,27.11,0.00,0.07,1
28658,3076,-1000.00,-968.05,31.95,0.00,1013.73,0.34,0
28659,3076,-31.95,-1000.00,0.00,0.00,31.95,0.07,0
28660,3077,-1000.00,-1000.00,0.00,570.85,429.15,0.13,0
28661,3078,-1000.00,-1000.00,0.00,0.00,1000.00,0.14,0
28662,3079,-830.14,-830.14,169.86,0.00,830.14,0.30,0
28663,3079,-112.19,-942.33,57.67,0.00,112.19,0.43,0
28664,3079,1000.00,57.67,1057.67,25.88,10.23,0.31,1
28665,3079,1000.00,1057.67,2057.67,290.75,0.00,0.06,1
28666,3079,1000.00,2057.67,3057.67,992.55,672.39,0.28,1
28667,3079,1000.00,3057.67,4057.67,1540.45,132.85,0.12,1
28668,3079,1000.00,4057.67,5057.67,708.23,0.00,0.18,1
28669,3079,1000.00,5057.67,6057.67,2668.41,2389.26,0.07,1
28670,3079,-119.53,4938.14,5938.14,0.00,119.53,0.44,0
28671,3079,1000.00,5938.14,6938.14,783.88,580.13,0.14,1
28672,3079,1000.00,6938.14,7938.14,3314.86,2462.29,0.18,1
28673,3079,-1000.00,5938.14,6938.14,0.00,7938.14,0.28,0
28674,3079,-1000.00,4938.14,5938.14,3469.07,3469.07,0.04,0
28675,3079,1000.00,5938.14,6938.14,718.76,0.00,0.14,1
28676,3079,-1000.00,4938.14,5938.14,0.00,6938.14,0.39,0
28677,3079,1000.00,5938.14,6938.14,5938.14,0.00,0.01,1
28678,3079,-51.94,5886.20,6886.20,0.00,51.94,0.25,0
28679,3079,-1000.00,4886.20,5886.20,3443.10,3443.10,0.00,0
28680,3079,-1000.00,3886.20,4886.20,614.87,5271.32,0.20,0
28681,3079,-1000.00,2886.20,3886.20,1241.00,0.00,0.31,0
28682,3079,-1000.00,1886.20,2886.20,1739.18,2147.01,0.26,0
28683,3079,-1000.00,886.20,1886.20,340.59,2145.38,0.43,0
28684,3079,-1000.00,-113.80,886.20,0.00,1886.20,0.19,0
28685,3079,-1000.00,-1113.80,-113.80,0.00,886.20,0.05,0
28686,3080,-701.92,-701.92,298.08,0.00,701.92,0.37,0
28687,3080,-298.08,-1000.00,0.00,0.00,298.08,0.36,0
28688,3081,-1000.00,-1000.00,0.00,226.79,0.00,0.09,0
28689,3082,-1000.00,-1000.00,0.00,0.00,465.12,0.12,0
28690,3083,-1000.00,-1000.00,0.00,136.81,863.19,0.42,0
28691,3084,-1000.00,-1000.00,0.00,0.00,1000.00,0.18,0
28692,3085,-1000.00,-1000.00,0.00,0.00,1000.00,0.23,0
28693,3086,-1000.00,-1000.00,0.00,0.00,406.19,0.23,0
28694,3087,-1000.00,-1000.00,0.00,547.80,452.20,0.08,0
28695,3088,1000.00,1000.00,2000.00,63.39,936.61,0.40,1
28696,3088,1000.00,2000.00,3000.00,939.04,1060.96,0.15,1
28697,3088,1000.00,3000.00,4000.00,0.00,1951.90,0.28,1
28698,3088,1000.00,4000.00,5000.00,816.35,3183.65,0.29,1
28699,3088,1000.00,5000.00,6000.00,0.00,495.42,0.07,1
28700,3088,1000.00,6000.00,7000.00,3000.00,3000.00,0.23,1
28701,3088,1000.00,7000.00,8000.00,0.00,7000.00,0.28,1
28702,3088,1000.00,8000.00,9000.00,0.00,8000.00,0.34,1
28703,3088,1000.00,9000.00,10000.00,4274.74,4725.26,0.13,1
28704,3088,1000.00,10000.00,11000.00,0.00,2377.17,0.16,1
28705,3088,1000.00,11000.00,12000.00,2446.88,7430.56,0.36,1
28706,3088,1000.00,12000.00,13000.00,3496.24,8503.76,0.27,1
28707,3088,1000.00,13000.00,14000.00,1393.76,11606.24,0.43,1
28708,3088,1000.00,14000.00,15000.00,6663.45,7336.55,0.16,1
28709,3088,1000.00,15000.00,16000.00,0.00,15000.00,0.34,1
28710,3088,-1000.00,14000.00,15000.00,4187.71,0.00,0.04,0
28711,3088,1000.00,15000.00,16000.00,4879.85,10120.15,0.32,1
28712,3088,1000.00,16000.00,17000.00,2607.51,13188.39,0.42,1
28713,3088,1000.00,17000.00,18000.00,0.00,17000.00,0.26,1
28714,3088,1000.00,18000.00,19000.00,0.00,18000.00,0.37,1
28715,3088,-1000.00,17000.00,18000.00,2623.79,0.00,0.02,0
28716,3088,1000.00,18000.00,19000.00,6771.11,11228.89,0.14,1
28717,3088,1000.00,19000.00,20000.00,0.00,14115.17,0.40,1
28718,3088,1000.00,20000.00,21000.00,9443.72,10556.28,0.13,1
28719,3088,-1000.00,19000.00,20000.00,14411.24,6070.76,0.22,0
28720,3088,-1000.00,18000.00,19000.00,0.00,14820.25,0.41,0
28721,3088,-1000.00,17000.00,18000.00,0.00,12076.87,0.19,0
28722,3088,-3.60,16996.40,17996.40,0.00,3.60,0.18,0
28723,3088,-1000.00,15996.40,16996.40,0.00,12132.49,0.37,0
28724,3088,-1000.00,14996.40,15996.40,8498.20,8498.20,0.24,0
28725,3088,-1000.00,13996.40,14996.40,0.00,14120.60,0.18,0
28726,3088,-1000.00,12996.40,13996.40,0.00,14996.40,0.08,0
28727,3088,-1000.00,11996.40,12996.40,0.00,13996.40,0.02,0
28728,3088,-1000.00,10996.40,11996.40,0.00,11651.35,0.39,0
28729,3088,-1000.00,9996.40,10996.40,0.00,1616.07,0.03,0
28730,3088,-1000.00,8996.40,9996.40,5376.68,5619.72,0.37,0
28731,3088,-1000.00,7996.40,8996.40,445.94,5823.40,0.35,0
28732,3088,-1000.00,6996.40,7996.40,0.00,8996.40,0.16,0
28733,3088,-1000.00,5996.40,6996.40,6547.65,1448.75,0.04,0
28734,3088,-1000.00,4996.40,5996.40,0.00,6996.40,0.08,0
28735,3088,-921.98,4074.42,5074.42,0.00,921.98,0.15,0
28736,3088,-1000.00,3074.42,4074.42,107.90,4966.52,0.29,0
28737,3088,-746.80,2327.62,3327.62,0.00,746.80,0.10,0
28738,3088,0.00,2327.62,3327.62,0.00,0.00,0.01,0
28739,3088,-1000.00,1327.62,2327.62,0.00,3327.62,0.27,0
28740,3088,-1000.00,327.62,1327.62,94.46,2233.17,0.44,0
28741,3088,-1000.00,-672.38,327.62,0.00,1327.62,0.34,0
28742,3088,-327.62,-1000.00,0.00,0.00,327.62,0.05,0
28743,3089,-1000.00,-1000.00,0.00,668.70,331.30,0.11,0
28744,3090,-1000.00,-1000.00,0.00,0.00,1000.00,0.30,0
28745,3091,-1000.00,-1000.00,0.00,576.04,423.96,0.07,0
28746,3092,1000.00,1000.00,2000.00,0.00,757.69,0.35,1
28747,3092,-1000.00,0.00,1000.00,1151.91,0.00,0.06,0
28748,3092,1000.00,1000.00,2000.00,0.00,1000.00,0.43,1
28749,3092,1000.00,2000.00,3000.00,0.00,2000.00,0.11,1
28750,3092,1000.00,3000.00,4000.00,0.00,884.60,0.21,1
28751,3092,1000.00,4000.00,5000.00,0.00,4000.00,0.44,1
28752,3092,1000.00,5000.00,6000.00,0.00,5000.00,0.15,1
28753,3092,1000.00,6000.00,7000.00,1860.45,4139.55,0.35,1
28754,3092,-1000.00,5000.00,6000.00,2491.47,586.85,0.13,0
28755,3092,1000.00,6000.00,7000.00,1210.20,4789.80,0.40,1
28756,3092,1000.00,7000.00,8000.00,0.00,7000.00,0.13,1
28757,3092,1000.00,8000.00,9000.00,0.00,6618.53,0.20,1
28758,3092,1000.00,9000.00,10000.00,0.00,5293.79,0.33,1
28759,3092,1000.00,10000.00,11000.00,2520.44,7479.56,0.05,1
28760,3092,1000.00,11000.00,12000.00,0.00,11000.00,0.26,1
28761,3092,1000.00,12000.00,13000.00,3290.97,7448.31,0.34,1
28762,3092,1000.00,13000.00,14000.00,0.00,13000.00,0.32,1
28763,3092,1000.00,14000.00,15000.00,2767.29,11232.71,0.29,1
28764,3092,1000.00,15000.00,16000.00,0.00,10576.99,0.27,1
28765,3092,1000.00,16000.00,17000.00,5446.91,10553.09,0.05,1
28766,3092,1000.00,17000.00,18000.00,0.00,17000.00,0.25,1
28767,3092,-1000.00,16000.00,17000.00,9338.03,8661.97,0.33,0
28768,3092,1000.00,17000.00,18000.00,5329.99,11670.01,0.25,1
28769,3092,1000.00,18000.00,19000.00,9000.00,9000.00,0.20,1
28770,3092,1000.00,19000.00,20000.00,1536.90,17463.10,0.42,1
28771,3092,-1000.00,18000.00,19000.00,17751.24,2248.76,0.03,0
28772,3092,-1000.00,17000.00,18000.00,1420.46,0.00,0.01,0
28773,3092,1000.00,18000.00,19000.00,5159.67,12840.33,0.35,1
28774,3092,1000.00,19000.00,20000.00,0.00,16266.83,0.27,1
28775,3092,1000.00,20000.00,21000.00,0.00,5812.83,0.11,1
28776,3092,-1000.00,19000.00,20000.00,11129.66,9870.34,0.04,0
28777,3092,1000.00,20000.00,21000.00,0.00,20000.00,0.33,1
28778,3092,1000.00,21000.00,22000.00,7548.53,13451.47,0.17,1
28779,3092,1000.00,22000.00,23000.00,11000.00,11000.00,0.05,1
28780,3092,1000.00,23000.00,24000.00,0.00,23000.00,0.36,1
28781,3092,1000.00,24000.00,25000.00,0.00,24000.00,0.33,1
28782,3092,1000.00,25000.00,26000.00,4141.20,20858.80,0.37,1
28783,3092,-1000.00,24000.00,25000.00,11733.87,3351.79,0.12,0
28784,3092,1000.00,25000.00,26000.00,0.00,10759.17,0.28,1
28785,3092,1000.00,26000.00,27000.00,3471.15,13997.65,0.32,1
28786,3093,1000.00,1000.00,2000.00,604.20,395.80,0.14,1
28787,3093,-1000.00,0.00,1000.00,983.07,1016.93,0.12,0
28788,3093,-817.24,-817.24,182.76,0.00,817.24,0.33,0
28789,3093,0.00,-817.24,182.76,0.00,0.00,0.28,0
28790,3093,-182.76,-1000.00,0.00,91.38,91.38,0.03,0
28791,3094,1000.00,1000.00,2000.00,0.00,1000.00,0.37,1
28792,3094,1000.00,2000.00,3000.00,0.00,2000.00,0.32,1
28793,3094,1000.00,3000.00,4000.00,0.00,3000.00,0.06,1
28794,3094,1000.00,4000.00,5000.00,0.00,4000.00,0.36,1
28795,3094,-1000.00,3000.00,4000.00,1234.80,3765.20,0.39,0
28796,3094,-1000.00,2000.00,3000.00,0.00,4000.00,0.32,0
28797,3094,-1000.00,1000.00,2000.00,1000.27,1999.73,0.31,0
28798,3094,-1000.00,0.00,1000.00,0.00,2000.00,0.09,0
28799,3094,-51.41,-51.41,948.59,51.41,0.00,0.07,0
28800,3094,-1000.00,-1051.41,-51.41,258.81,689.79,0.13,0
28801,3095,-1000.00,-1000.00,0.00,1.05,998.95,0.40,0
28802,3096,-1000.00,-1000.00,0.00,747.66,252.34,0.05,0
28803,3097,-1000.00,-1000.00,0.00,0.00,1000.00,0.06,0
28804,3098,-1000.00,-1000.00,0.00,319.41,680.59,0.16,0
28805,3099,-1000.00,-1000.00,0.00,296.64,703.36,0.29,0
28806,3100,0.00,0.00,1000.00,0.00,0.00,0.03,0
28807,3100,-1000.00,-1000.00,0.00,277.09,722.91,0.31,0
28808,3101,-1000.00,-1000.00,0.00,0.00,1000.00,0.23,0
28809,3102,0.00,0.00,1000.00,0.00,0.00,0.11,0
28810,3102,-1000.00,-1000.00,0.00,349.93,650.07,0.07,0
28811,3103,-901.77,-901.77,98.23,0.00,901.77,0.44,0
28812,3103,-98.23,-1000.00,0.00,7.03,91.21,0.44,0
28813,3104,-1000.00,-1000.00,0.00,893.05,106.95,0.04,0
28814,3105,-1000.00,-1000.00,0.00,120.59,479.58,0.30,0
28815,3106,-1000.00,-1000.00,0.00,482.09,517.91,0.09,0
28816,3107,-1000.00,-1000.00,0.00,0.00,1000.00,0.35,0
28817,3108,1000.00,1000.00,2000.00,811.68,0.00,0.17,1
28818,3108,0.00,1000.00,2000.00,0.00,0.00,0.31,0
28819,3108,-1000.00,0.00,1000.00,498.35,606.84,0.36,0
28820,3108,1000.00,1000.00,2000.00,384.92,153.54,0.35,1
28821,3108,0.00,1000.00,2000.00,0.00,0.00,0.34,0
28822,3108,0.00,1000.00,2000.00,0.00,0.00,0.20,0
28823,3108,1000.00,2000.00,3000.00,45.03,0.00,0.20,1
28824,3108,1000.00,3000.00,4000.00,1862.46,1137.54,0.18,1
28825,3108,-836.24,2163.76,3163.76,0.00,836.24,0.33,0
28826,3108,-1000.00,1163.76,2163.76,507.98,1453.69,0.32,0
28827,3108,1000.00,2163.76,3163.76,1154.77,1008.99,0.01,1
28828,3108,0.00,2163.76,3163.76,0.00,0.00,0.25,0
28829,3108,1000.00,3163.76,4163.76,1099.59,0.00,0.34,1
28830,3108,1000.00,4163.76,5163.76,1553.36,449.51,0.36,1
28831,3108,-1000.00,3163.76,4163.76,0.00,1566.52,0.28,0
28832,3108,1000.00,4163.76,5163.76,630.16,0.00,0.44,1
28833,3108,-1000.00,3163.76,4163.76,0.00,5163.76,0.02,0
28834,3108,0.00,3163.76,4163.76,0.00,0.00,0.03,0
28835,3108,1000.00,4163.76,5163.76,2336.94,0.00,0.25,1
28836,3108,-977.23,3186.53,4186.53,0.00,977.23,0.32,0
28837,3108,-1000.00,2186.53,3186.53,216.67,3969.86,0.02,0
28838,3108,-1000.00,1186.53,2186.53,0.00,3186.53,0.01,0
28839,3108,1000.00,2186.53,3186.53,2186.53,0.00,0.00,1
28840,3108,1000.00,3186.53,4186.53,2169.14,1017.40,0.07,1
28841,3108,0.00,3186.53,4186.53,0.00,0.00,0.28,0
28842,3108,-1000.00,2186.53,3186.53,2011.02,2175.52,0.11,0
28843,3108,-1000.00,1186.53,2186.53,247.16,2939.37,0.10,0
28844,3108,-1000.00,186.53,1186.53,1393.41,570.75,0.23,0
28845,3108,-1000.00,-813.47,186.53,0.00,1186.53,0.03,0
28846,3108,-5.30,-818.77,181.23,5.30,0.00,0.41,0
28847,3108,-1000.00,-1818.77,-818.77,0.00,9.54,0.40,0
28848,3109,-693.83,-693.83,306.17,693.83,0.00,0.00,0
28849,3109,1000.00,306.17,1306.17,0.00,268.48,0.40,1
28850,3109,1000.00,1306.17,2306.17,595.59,710.59,0.38,1
28851,3109,1000.00,2306.17,3306.17,0.00,1121.35,0.29,1
28852,3109,1000.00,3306.17,4306.17,0.00,3069.33,0.15,1
28853,3109,1000.00,4306.17,5306.17,0.00,4306.17,0.31,1
28854,3109,1000.00,5306.17,6306.17,0.00,4855.49,0.05,1
28855,3109,1000.00,6306.17,7306.17,1548.78,4757.39,0.38,1
28856,3109,1000.00,7306.17,8306.17,3233.83,4072.35,0.26,1
28857,3109,1000.00,8306.17,9306.17,0.00,8306.17,0.23,1
28858,3109,-1000.00,7306.17,8306.17,5916.16,3390.01,0.13,0
28859,3109,1000.00,8306.17,9306.17,0.00,8306.17,0.28,1
28860,3109,1000.00,9306.17,10306.17,0.00,9306.17,0.16,1
28861,3109,1000.00,10306.17,11306.17,3950.60,6355.58,0.14,1
28862,3109,1000.00,11306.17,12306.17,5197.32,6108.85,0.42,1
28863,3109,-1000.00,10306.17,11306.17,7519.16,4787.02,0.04,0
28864,3109,-1000.00,9306.17,10306.17,5653.09,5653.09,0.23,0
28865,3109,-1000.00,8306.17,9306.17,0.00,2821.92,0.36,0
28866,3109,-1000.00,7306.17,8306.17,3339.70,1050.59,0.26,0
28867,3109,-1000.00,6306.17,7306.17,0.00,6673.91,0.04,0
28868,3109,-1000.00,5306.17,6306.17,20.35,7285.83,0.26,0
28869,3109,-1000.00,4306.17,5306.17,0.00,6306.17,0.05,0
28870,3109,-1000.00,3306.17,4306.17,0.00,5306.17,0.04,0
28871,3109,-1000.00,2306.17,3306.17,0.00,2318.40,0.35,0
28872,3109,-1000.00,1306.17,2306.17,0.00,3306.17,0.30,0
28873,3109,-1000.00,306.17,1306.17,214.34,2091.84,0.22,0
28874,3109,-1000.00,-693.83,306.17,0.00,263.77,0.12,0
28875,3109,-306.17,-1000.00,0.00,280.71,25.46,0.01,0
28876,3110,-1000.00,-1000.00,0.00,0.00,1000.00,0.10,0
28877,3111,-808.29,-808.29,191.71,0.00,808.29,0.40,0
28878,3111,-191.71,-1000.00,0.00,0.00,191.71,0.28,0
28879,3112,1000.00,1000.00,2000.00,404.32,595.68,0.23,1
28880,3112,1000.00,2000.00,3000.00,569.30,1430.70,0.24,1
28881,3112,1000.00,3000.00,4000.00,0.00,3000.00,0.37,1
28882,3112,1000.00,4000.00,5000.00,965.85,3034.15,0.39,1
28883,3112,1000.00,5000.00,6000.00,0.00,3724.23,0.40,1
28884,3112,-1000.00,4000.00,5000.00,3267.51,2732.49,0.19,0
28885,3112,1000.00,5000.00,6000.00,0.00,5000.00,0.32,1
28886,3112,1000.00,6000.00,7000.00,0.00,6000.00,0.14,1
28887,3112,1000.00,7000.00,8000.00,3443.10,3556.90,0.42,1
28888,3112,1000.00,8000.00,9000.00,2908.86,5091.14,0.25,1
28889,3112,1000.00,9000.00,10000.00,0.00,9000.00,0.30,1
28890,3112,1000.00,10000.00,11000.00,0.00,10000.00,0.14,1
28891,3112,1000.00,11000.00,12000.00,3245.67,7754.33,0.24,1
28892,3112,1000.00,12000.00,13000.00,0.00,7808.86,0.36,1
28893,3112,-1000.00,11000.00,12000.00,7582.87,5417.13,0.33,0
28894,3112,1000.00,12000.00,13000.00,5464.44,6535.56,0.15,1
28895,3112,-1000.00,11000.00,12000.00,11084.52,1915.48,0.17,0
28896,3112,1000.00,12000.00,13000.00,0.00,11944.24,0.30,1
28897,3112,1000.00,13000.00,14000.00,0.00,3051.41,0.14,1
28898,3112,1000.00,14000.00,15000.00,0.00,10337.53,0.31,1
28899,3112,1000.00,15000.00,16000.00,0.00,8597.03,0.16,1
28900,3112,1000.00,16000.00,17000.00,0.00,16000.00,0.34,1
28901,3112,-1000.00,15000.00,16000.00,7192.87,9807.13,0.36,0
28902,3112,-1000.00,14000.00,15000.00,0.00,14969.31,0.40,0
28903,3112,-1000.00,13000.00,14000.00,0.00,15000.00,0.02,0
28904,3112,-1000.00,12000.00,13000.00,5190.32,8809.68,0.31,0
28905,3112,-1000.00,11000.00,12000.00,0.00,13000.00,0.12,0
28906,3112,-1000.00,10000.00,11000.00,0.00,12000.00,0.29,0
28907,3112,-1000.00,9000.00,10000.00,0.00,5836.70,0.32,0
28908,3112,-1000.00,8000.00,9000.00,4776.11,5223.89,0.22,0
28909,3112,-1000.00,7000.00,8000.00,0.00,6712.09,0.40,0
28910,3112,-1000.00,6000.00,7000.00,1064.24,6935.76,0.09,0
28911,3112,-1000.00,5000.00,6000.00,3201.22,3798.78,0.17,0
28912,3112,-1000.00,4000.00,5000.00,1552.08,4447.92,0.01,0
28913,3112,-1000.00,3000.00,4000.00,0.00,5000.00,0.11,0
28914,3112,-1000.00,2000.00,3000.00,0.00,4000.00,0.23,0
28915,3112,-1000.00,1000.00,2000.00,0.00,1582.55,0.22,0
28916,3112,-1000.00,0.00,1000.00,591.41,1408.59,0.35,0
28917,3112,-763.86,-763.86,236.14,0.00,763.86,0.38,0
28918,3112,-236.14,-1000.00,0.00,0.00,236.14,0.02,0
28919,3113,-1000.00,-1000.00,0.00,560.01,318.03,0.15,0
28920,3114,-1000.00,-1000.00,0.00,190.12,809.88,0.31,0
28921,3115,1000.00,1000.00,2000.00,691.68,179.64,0.16,1
28922,3115,-1000.00,0.00,1000.00,860.87,1139.13,0.17,0
28923,3115,0.00,0.00,1000.00,0.00,0.00,0.02,0
28924,3115,-843.60,-843.60,156.40,0.00,843.60,0.28,0
28925,3115,-156.40,-1000.00,0.00,78.20,78.20,0.24,0
28926,3116,-1000.00,-1000.00,0.00,0.00,424.88,0.26,0
28927,3117,1000.00,1000.00,2000.00,0.00,1000.00,0.14,1
28928,3117,1000.00,2000.00,3000.00,641.05,1358.95,0.24,1
28929,3117,1000.00,3000.00,4000.00,0.00,1379.46,0.07,1
28930,3117,1000.00,4000.00,5000.00,1431.62,2568.38,0.09,1
28931,3117,1000.00,5000.00,6000.00,2500.00,2500.00,0.04,1
28932,3117,-608.85,4391.15,5391.15,608.85,0.00,0.04,0
28933,3117,1000.00,5391.15,6391.15,0.00,5391.15,0.07,1
28934,3117,1000.00,6391.15,7391.15,3195.58,3195.58,0.10,1
28935,3117,1000.00,7391.15,8391.15,0.00,7391.15,0.08,1
28936,3117,-1000.00,6391.15,7391.15,4513.81,3877.35,0.15,0
28937,3117,1000.00,7391.15,8391.15,2208.28,5098.96,0.34,1
28938,3117,-1000.00,6391.15,7391.15,7409.23,981.93,0.12,0
28939,3117,1000.00,7391.15,8391.15,1534.91,5856.25,0.18,1
28940,3117,1000.00,8391.15,9391.15,1721.74,5545.82,0.36,1
28941,3117,-1000.00,7391.15,8391.15,4804.15,4587.00,0.44,0
28942,3117,1000.00,8391.15,9391.15,0.00,8391.15,0.34,1
28943,3117,1000.00,9391.15,10391.15,206.45,8536.26,0.42,1
28944,3117,1000.00,10391.15,11391.15,0.00,5432.52,0.04,1
28945,3117,1000.00,11391.15,12391.15,5695.58,5695.58,0.08,1
28946,3117,-1000.00,10391.15,11391.15,5171.03,0.00,0.05,0
28947,3117,1000.00,11391.15,12391.15,5163.02,6228.14,0.38,1
28948,3117,0.00,11391.15,12391.15,0.00,0.00,0.00,0
28949,3117,1000.00,12391.15,13391.15,0.00,833.81,0.13,1
28950,3117,1000.00,13391.15,14391.15,0.00,13391.15,0.34,1
28951,3117,-1000.00,12391.15,13391.15,7195.58,7195.58,0.03,0
28952,3117,-1000.00,11391.15,12391.15,0.00,11027.77,0.41,0
28953,3117,-1000.00,10391.15,11391.15,4006.39,8384.77,0.24,0
28954,3117,-1000.00,9391.15,10391.15,0.00,11391.15,0.29,0
28955,3117,-1000.00,8391.15,9391.15,4916.44,5474.72,0.03,0
28956,3117,-1000.00,7391.15,8391.15,0.00,7278.31,0.37,0
28957,3117,-1000.00,6391.15,7391.15,0.00,8254.34,0.40,0
28958,3117,-1000.00,5391.15,6391.15,0.00,7391.15,0.29,0
28959,3117,-1000.00,4391.15,5391.15,235.10,6156.06,0.38,0
28960,3117,-1000.00,3391.15,4391.15,0.00,5391.15,0.21,0
28961,3117,-1000.00,2391.15,3391.15,1096.61,3294.55,0.39,0
28962,3117,-1000.00,1391.15,2391.15,1630.05,1761.10,0.13,0
28963,3117,-1000.00,391.15,1391.15,0.00,2391.15,0.40,0
28964,3117,-594.46,-203.31,796.69,0.00,594.46,0.25,0
28965,3117,-796.69,-1000.00,0.00,205.11,591.59,0.31,0
28966,3118,1000.00,1000.00,2000.00,0.00,954.08,0.14,1
28967,3118,1000.00,2000.00,3000.00,20.80,1979.20,0.37,1
28968,3118,1000.00,3000.00,4000.00,1500.00,1500.00,0.04,1
28969,3118,1000.00,4000.00,5000.00,1180.45,2099.14,0.29,1
28970,3118,1000.00,5000.00,6000.00,0.00,2135.35,0.25,1
28971,3118,1000.00,6000.00,7000.00,0.00,4967.85,0.26,1
28972,3118,1000.00,7000.00,8000.00,0.00,6253.34,0.23,1
28973,3118,1000.00,8000.00,9000.00,0.00,8000.00,0.11,1
28974,3118,1000.00,9000.00,10000.00,0.00,7840.37,0.19,1
28975,3118,1000.00,10000.00,11000.00,1362.75,5313.98,0.32,1
28976,3118,1000.00,11000.00,12000.00,3666.10,7333.90,0.30,1
28977,3118,1000.00,12000.00,13000.00,1020.44,10979.56,0.16,1
28978,3118,1000.00,13000.00,14000.00,2695.70,10304.30,0.22,1
28979,3118,1000.00,14000.00,15000.00,2764.21,11127.08,0.40,1
28980,3118,1000.00,15000.00,16000.00,0.00,15000.00,0.25,1
28981,3118,1000.00,16000.00,17000.00,1265.64,7067.91,0.29,1
28982,3118,1000.00,17000.00,18000.00,4242.51,7315.51,0.24,1
28983,3118,1000.00,18000.00,19000.00,2131.53,12410.68,0.38,1
28984,3118,1000.00,19000.00,20000.00,0.00,19000.00,0.21,1
28985,3118,-1000.00,18000.00,19000.00,16885.48,3114.52,0.04,0
28986,3118,1000.00,19000.00,20000.00,9500.00,9500.00,0.03,1
28987,3118,1000.00,20000.00,21000.00,0.00,20000.00,0.34,1
28988,3118,1000.00,21000.00,22000.00,0.00,21000.00,0.24,1
28989,3118,1000.00,22000.00,23000.00,11000.00,11000.00,0.04,1
28990,3118,1000.00,23000.00,24000.00,6577.73,16422.27,0.01,1
28991,3118,1000.00,24000.00,25000.00,0.00,24000.00,0.33,1
28992,3118,1000.00,25000.00,26000.00,12121.48,12878.52,0.20,1
28993,3118,1000.00,26000.00,27000.00,0.00,2262.07,0.14,1
28994,3118,1000.00,27000.00,28000.00,9908.07,17091.93,0.19,1
28995,3118,1000.00,28000.00,29000.00,12701.76,15298.24,0.11,1
28996,3118,1000.00,29000.00,30000.00,0.00,29000.00,0.05,1
28997,3118,1000.00,30000.00,31000.00,0.00,14632.76,0.06,1
28998,3118,1000.00,31000.00,32000.00,0.00,14052.42,0.22,1
28999,3118,1000.00,32000.00,33000.00,0.00,5301.35,0.15,1
29000,3118,1000.00,33000.00,34000.00,0.00,33000.00,0.37,1
29001,3118,1000.00,34000.00,35000.00,14740.79,19259.21,0.07,1
29002,3118,1000.00,35000.00,36000.00,0.00,35000.00,0.08,1
29003,3118,1000.00,36000.00,37000.00,0.00,36000.00,0.33,1
29004,3118,1000.00,37000.00,38000.00,0.00,37000.00,0.02,1
29005,3118,1000.00,38000.00,39000.00,1260.69,25918.12,0.38,1
29006,3118,-1000.00,37000.00,38000.00,20882.46,18117.54,0.09,0
29007,3118,1000.00,38000.00,39000.00,14817.88,23182.12,0.16,1
29008,3118,1000.00,39000.00,40000.00,0.00,34154.26,0.36,1
29009,3118,1000.00,40000.00,41000.00,19008.43,20991.57,0.11,1
29010,3119,1000.00,1000.00,2000.00,424.41,575.59,0.26,1
29011,3119,-1000.00,0.00,1000.00,1402.53,597.47,0.03,0
29012,3119,1000.00,1000.00,2000.00,366.03,633.97,0.31,1
29013,3119,1000.00,2000.00,3000.00,308.56,1691.44,0.40,1
29014,3119,1000.00,3000.00,4000.00,635.64,1548.31,0.31,1
29015,3119,-1000.00,2000.00,3000.00,2734.13,1265.87,0.08,0
29016,3119,1000.00,3000.00,4000.00,0.00,1742.88,0.31,1
29017,3119,-1000.00,2000.00,3000.00,2202.89,1797.11,0.06,0
29018,3119,1000.00,3000.00,4000.00,1447.23,1552.77,0.17,1
29019,3119,1000.00,4000.00,5000.00,177.28,3605.38,0.44,1
29020,3119,1000.00,5000.00,6000.00,1719.51,3280.49,0.34,1
29021,3119,1000.00,6000.00,7000.00,232.51,5767.49,0.44,1
29022,3119,-1000.00,5000.00,6000.00,2795.70,520.50,0.12,0
29023,3119,1000.00,6000.00,7000.00,2557.45,3442.55,0.19,1
29024,3119,1000.00,7000.00,8000.00,1461.74,5538.26,0.32,1
29025,3119,1000.00,8000.00,9000.00,0.00,8000.00,0.22,1
29026,3119,1000.00,9000.00,10000.00,2891.34,6108.66,0.32,1
29027,3119,-1000.00,8000.00,9000.00,6731.34,3268.66,0.23,0
29028,3119,1000.00,9000.00,10000.00,0.00,9000.00,0.27,1
29029,3119,1000.00,10000.00,11000.00,5000.00,5000.00,0.37,1
29030,3119,1000.00,11000.00,12000.00,237.54,10762.46,0.40,1
29031,3119,-1000.00,10000.00,11000.00,9817.59,2182.41,0.17,0
29032,3119,1000.00,11000.00,12000.00,0.00,4929.71,0.25,1
29033,3119,1000.00,12000.00,13000.00,0.00,12000.00,0.12,1
29034,3119,1000.00,13000.00,14000.00,2047.45,10952.55,0.31,1
29035,3119,-1000.00,12000.00,13000.00,10244.78,0.00,0.05,0
29036,3119,-1000.00,11000.00,12000.00,991.16,106.78,0.11,0
29037,3119,1000.00,12000.00,13000.00,1435.91,9153.34,0.40,1
29038,3119,1000.00,13000.00,14000.00,0.00,2710.30,0.18,1
29039,3119,-1000.00,12000.00,13000.00,7628.08,1925.73,0.10,0
29040,3119,1000.00,13000.00,14000.00,6500.00,6500.00,0.30,1
29041,3119,1000.00,14000.00,15000.00,0.00,14000.00,0.33,1
29042,3119,1000.00,15000.00,16000.00,5393.62,9606.38,0.07,1
29043,3119,1000.00,16000.00,17000.00,3871.05,12128.95,0.28,1
29044,3119,1000.00,17000.00,18000.00,3759.74,13240.26,0.22,1
29045,3119,1000.00,18000.00,19000.00,5287.12,12712.88,0.35,1
29046,3119,1000.00,19000.00,20000.00,9360.60,9639.40,0.12,1
29047,3119,1000.00,20000.00,21000.00,137.28,10545.75,0.33,1
29048,3119,1000.00,21000.00,22000.00,6545.29,14454.71,0.28,1
29049,3119,0.00,21000.00,22000.00,0.00,0.00,0.02,0
29050,3119,1000.00,22000.00,23000.00,8191.29,13808.71,0.38,1
29051,3119,-1000.00,21000.00,22000.00,4619.38,0.00,0.03,0
29052,3119,1000.00,22000.00,23000.00,8247.26,13752.74,0.29,1
29053,3120,1000.00,1000.00,2000.00,395.60,604.40,0.22,1
29054,3120,-580.36,419.64,1419.64,342.63,237.73,0.14,0
29055,3120,1000.00,1419.64,2419.64,0.00,1419.64,0.24,1
29056,3120,1000.00,2419.64,3419.64,0.00,565.96,0.17,1
29057,3120,-457.11,1962.53,2962.53,457.11,0.00,0.04,0
29058,3120,-1000.00,962.53,1962.53,1985.28,977.25,0.08,0
29059,3120,1000.00,1962.53,2962.53,863.39,1099.14,0.20,1
29060,3120,1000.00,2962.53,3962.53,0.00,2962.53,0.40,1
29061,3120,1000.00,3962.53,4962.53,1552.23,2410.30,0.30,1
29062,3120,1000.00,4962.53,5962.53,2481.27,2481.27,0.10,1
29063,3120,1000.00,5962.53,6962.53,0.00,5962.53,0.31,1
29064,3120,1000.00,6962.53,7962.53,0.00,6962.53,0.01,1
29065,3120,1000.00,7962.53,8962.53,2460.90,5501.63,0.35,1
29066,3120,1000.00,8962.53,9962.53,2936.22,6026.31,0.34,1
29067,3120,-1000.00,7962.53,8962.53,6418.14,3544.39,0.08,0
29068,3120,1000.00,8962.53,9962.53,4936.72,4025.81,0.42,1
29069,3120,-1000.00,7962.53,8962.53,0.00,8028.38,0.21,0
29070,3120,-1000.00,6962.53,7962.53,0.00,8962.53,0.33,0
29071,3120,-1000.00,5962.53,6962.53,3736.63,4225.90,0.23,0
29072,3120,-1000.00,4962.53,5962.53,2147.20,4637.05,0.33,0
29073,3120,-1000.00,3962.53,4962.53,0.07,5240.67,0.43,0
29074,3120,-1000.00,2962.53,3962.53,2010.52,2952.02,0.03,0
29075,3120,-1000.00,1962.53,2962.53,0.00,1647.98,0.28,0
29076,3120,-1000.00,962.53,1962.53,1481.27,1481.27,0.01,0
29077,3120,-1000.00,-37.47,962.53,302.73,1659.80,0.30,0
29078,3120,-962.53,-1000.00,0.00,0.00,962.53,0.13,0
29079,3121,-1000.00,-1000.00,0.00,240.55,759.45,0.15,0
29080,3122,-570.64,-570.64,429.36,570.64,0.00,0.01,0
29081,3122,-1000.00,-1570.64,-570.64,0.00,330.00,0.23,0
29082,3123,1000.00,1000.00,2000.00,0.00,1000.00,0.04,1
29083,3123,1000.00,2000.00,3000.00,0.00,1467.92,0.39,1
29084,3123,1000.00,3000.00,4000.00,1485.75,1514.25,0.11,1
29085,3123,1000.00,4000.00,5000.00,0.00,4000.00,0.04,1
29086,3123,0.00,4000.00,5000.00,0.00,0.00,0.04,0
29087,3123,-1000.00,3000.00,4000.00,2689.38,1680.19,0.16,0
29088,3123,1000.00,4000.00,5000.00,2000.00,2000.00,0.05,1
29089,3123,1000.00,5000.00,6000.00,1444.74,3555.26,0.10,1
29090,3123,1000.00,6000.00,7000.00,553.45,3216.78,0.32,1
29091,3123,1000.00,7000.00,8000.00,3500.00,3500.00,0.01,1
29092,3123,-1000.00,6000.00,7000.00,7498.18,0.00,0.01,0
29093,3123,-1000.00,5000.00,6000.00,7000.00,0.00,0.06,0
29094,3123,1000.00,6000.00,7000.00,2715.46,3284.54,0.25,1
29095,3123,1000.00,7000.00,8000.00,213.61,1587.39,0.19,1
29096,3123,1000.00,8000.00,9000.00,0.00,3934.15,0.29,1
29097,3123,1000.00,9000.00,10000.00,0.00,9000.00,0.25,1
29098,3123,1000.00,10000.00,11000.00,5000.00,5000.00,0.12,1
29099,3123,1000.00,11000.00,12000.00,0.00,11000.00,0.17,1
29100,3123,1000.00,12000.00,13000.00,0.00,2495.63,0.08,1
29101,3123,1000.00,13000.00,14000.00,0.00,8488.87,0.04,1
29102,3123,1000.00,14000.00,15000.00,396.24,10936.50,0.41,1
29103,3123,-1000.00,13000.00,14000.00,9804.81,979.62,0.12,0
29104,3123,-1000.00,12000.00,13000.00,9082.86,4917.14,0.29,0
29105,3123,1000.00,13000.00,14000.00,2508.27,10491.73,0.35,1
29106,3123,-1000.00,12000.00,13000.00,5520.00,0.00,0.01,0
29107,3123,1000.00,13000.00,14000.00,0.00,13000.00,0.01,1
29108,3123,1000.00,14000.00,15000.00,6478.95,7521.05,0.16,1
29109,3123,-1000.00,13000.00,14000.00,10674.42,1912.70,0.15,0
29110,3123,1000.00,14000.00,15000.00,0.00,6695.87,0.21,1
29111,3123,1000.00,15000.00,16000.00,7469.54,7493.00,0.22,1
29112,3123,1000.00,16000.00,17000.00,3317.31,12682.69,0.15,1
29113,3123,1000.00,17000.00,18000.00,0.00,17000.00,0.29,1
29114,3123,1000.00,18000.00,19000.00,0.00,18000.00,0.41,1
29115,3123,1000.00,19000.00,20000.00,0.00,18447.61,0.41,1
29116,3123,1000.00,20000.00,21000.00,9243.63,10756.37,0.25,1
29117,3123,-1000.00,19000.00,20000.00,11830.25,5650.27,0.14,0
29118,3123,1000.00,20000.00,21000.00,5952.96,14047.04,0.36,1
29119,3123,1000.00,21000.00,22000.00,0.00,14868.92,0.39,1
29120,3123,-1000.00,20000.00,21000.00,19818.51,0.00,0.01,0
29121,3123,1000.00,21000.00,22000.00,0.00,11199.98,0.31,1
29122,3123,1000.00,22000.00,23000.00,0.00,22000.00,0.15,1
29123,3123,1000.00,23000.00,24000.00,0.00,16226.08,0.31,1
29124,3123,1000.00,24000.00,25000.00,11642.29,12357.71,0.13,1
29125,3123,-1000.00,23000.00,24000.00,6188.44,0.00,0.03,0
29126,3123,1000.00,24000.00,25000.00,2931.62,21068.38,0.04,1
29127,3123,1000.00,25000.00,26000.00,0.00,13092.24,0.30,1
29128,3124,-1000.00,-1000.00,0.00,324.13,675.87,0.26,0
29129,3125,-1000.00,-1000.00,0.00,0.00,1000.00,0.12,0
29130,3126,-433.00,-433.00,567.00,433.00,0.00,0.09,0
29131,3126,-1000.00,-1433.00,-433.00,0.00,7.45,0.39,0
29132,3127,-1000.00,-1000.00,0.00,499.94,500.06,0.06,0
29133,3128,-887.49,-887.49,112.51,0.00,887.49,0.43,0
29134,3128,-1000.00,-1887.49,-887.49,80.36,0.00,0.03,0
29135,3129,1000.00,1000.00,2000.00,311.05,688.95,0.32,1
29136,3129,1000.00,2000.00,3000.00,0.00,1474.00,0.40,1
29137,3129,1000.00,3000.00,4000.00,5.61,2381.34,0.42,1
29138,3129,1000.00,4000.00,5000.00,1781.18,2218.82,0.24,1
29139,3129,-1000.00,3000.00,4000.00,2163.06,0.00,0.04,0
29140,3129,0.00,3000.00,4000.00,0.00,0.00,0.06,0
29141,3129,1000.00,4000.00,5000.00,0.00,3061.80,0.36,1
29142,3129,1000.00,5000.00,6000.00,0.00,5000.00,0.19,1
29143,3129,1000.00,6000.00,7000.00,1211.22,4788.78,0.38,1
29144,3129,1000.00,7000.00,8000.00,3054.12,3945.88,0.22,1
29145,3129,1000.00,8000.00,9000.00,0.00,8000.00,0.12,1
29146,3129,1000.00,9000.00,10000.00,2164.24,6835.76,0.31,1
29147,3129,-1000.00,8000.00,9000.00,5273.65,4726.35,0.29,0
29148,3129,1000.00,9000.00,10000.00,199.79,8800.21,0.10,1
29149,3129,-1000.00,8000.00,9000.00,5200.80,4799.20,0.41,0
29150,3129,-1000.00,7000.00,8000.00,9000.00,0.00,0.01,0
29151,3129,-1000.00,6000.00,7000.00,4099.68,3900.32,0.26,0
29152,3129,1000.00,7000.00,8000.00,0.00,7000.00,0.25,1
29153,3129,1000.00,8000.00,9000.00,0.00,8000.00,0.41,1
29154,3129,-1000.00,7000.00,8000.00,0.00,9000.00,0.14,0
29155,3129,-1000.00,6000.00,7000.00,5306.05,2693.95,0.31,0
29156,3129,-1000.00,5000.00,6000.00,3500.00,3500.00,0.07,0
29157,3129,-1000.00,4000.00,5000.00,0.00,6000.00,0.31,0
29158,3129,-1000.00,3000.00,4000.00,989.23,3047.73,0.38,0
29159,3129,-1000.00,2000.00,3000.00,0.00,1333.75,0.14,0
29160,3129,-1000.00,1000.00,2000.00,0.00,1789.91,0.32,0
29161,3129,-1000.00,0.00,1000.00,821.64,1178.36,0.29,0
29162,3129,-175.16,-175.16,824.84,175.16,0.00,0.18,0
29163,3129,-1000.00,-1175.16,-175.16,101.93,722.91,0.41,0
29164,3130,-694.49,-694.49,305.51,0.00,694.49,0.01,0
29165,3130,-223.72,-918.21,81.79,0.00,223.72,0.26,0
29166,3130,-81.79,-1000.00,0.00,0.00,81.79,0.13,0
29167,3131,-1000.00,-1000.00,0.00,140.75,859.25,0.14,0
29168,3132,1000.00,1000.00,2000.00,0.00,1000.00,0.09,1
29169,3132,1000.00,2000.00,3000.00,0.00,2000.00,0.02,1
29170,3132,1000.00,3000.00,4000.00,0.00,3000.00,0.05,1
29171,3132,1000.00,4000.00,5000.00,0.00,3229.65,0.42,1
29172,3132,1000.00,5000.00,6000.00,1216.52,3783.48,0.27,1
29173,3132,1000.00,6000.00,7000.00,0.00,6000.00,0.34,1
29174,3132,1000.00,7000.00,8000.00,1365.58,4316.12,0.35,1
29175,3132,-1000.00,6000.00,7000.00,4462.26,3537.74,0.10,0
29176,3132,1000.00,7000.00,8000.00,0.00,7000.00,0.03,1
29177,3132,1000.00,8000.00,9000.00,747.65,7252.35,0.40,1
29178,3132,1000.00,9000.00,10000.00,4500.00,4500.00,0.02,1
29179,3132,1000.00,10000.00,11000.00,0.00,10000.00,0.33,1
29180,3132,1000.00,11000.00,12000.00,0.00,9221.27,0.43,1
29181,3132,1000.00,12000.00,13000.00,0.00,12000.00,0.36,1
29182,3132,1000.00,13000.00,14000.00,0.00,6177.28,0.27,1
29183,3132,1000.00,14000.00,15000.00,2381.32,11618.68,0.03,1
29184,3132,1000.00,15000.00,16000.00,0.00,15000.00,0.05,1
29185,3132,1000.00,16000.00,17000.00,0.00,16000.00,0.04,1
29186,3132,1000.00,17000.00,18000.00,0.00,17000.00,0.18,1
29187,3132,1000.00,18000.00,19000.00,3244.33,14755.67,0.18,1
29188,3132,1000.00,19000.00,20000.00,3714.61,15285.39,0.02,1
29189,3132,1000.00,20000.00,21000.00,0.00,10944.06,0.22,1
29190,3132,1000.00,21000.00,22000.00,8413.15,12586.85,0.19,1
29191,3132,1000.00,22000.00,23000.00,0.00,22000.00,0.27,1
29192,3132,1000.00,23000.00,24000.00,11500.00,11500.00,0.18,1
29193,3132,1000.00,24000.00,25000.00,0.00,7879.92,0.16,1
29194,3132,1000.00,25000.00,26000.00,0.00,4631.14,0.17,1
29195,3132,1000.00,26000.00,27000.00,9613.66,16386.34,0.26,1
29196,3132,1000.00,27000.00,28000.00,0.00,27000.00,0.32,1
29197,3132,1000.00,28000.00,29000.00,0.00,28000.00,0.42,1
29198,3132,1000.00,29000.00,30000.00,0.00,29000.00,0.43,1
29199,3132,1000.00,30000.00,31000.00,0.00,26531.52,0.43,1
29200,3132,-1000.00,29000.00,30000.00,15891.04,15108.96,0.11,0
29201,3132,1000.00,30000.00,31000.00,15000.00,15000.00,0.11,1
29202,3132,1000.00,31000.00,32000.00,0.00,31000.00,0.13,1
29203,3132,1000.00,32000.00,33000.00,0.00,32000.00,0.40,1
29204,3132,1000.00,33000.00,34000.00,9279.09,23720.91,0.37,1
29205,3132,1000.00,34000.00,35000.00,3641.68,30358.32,0.38,1
29206,3132,1000.00,35000.00,36000.00,0.00,27423.66,0.03,1
29207,3132,1000.00,36000.00,37000.00,8251.50,20530.21,0.32,1
29208,3132,-1000.00,35000.00,36000.00,22001.00,14999.00,0.12,0
29209,3132,-1000.00,34000.00,35000.00,27964.84,8035.16,0.10,0
29210,3132,-1000.00,33000.00,34000.00,19928.50,13085.59,0.16,0
29211,3132,1000.00,34000.00,35000.00,15796.22,16207.24,0.25,1
29212,3132,1000.00,35000.00,36000.00,17500.00,17500.00,0.02,1
29213,3132,1000.00,36000.00,37000.00,0.00,32388.74,0.21,1
29214,3132,1000.00,37000.00,38000.00,0.00,19513.83,0.24,1
29215,3132,-1000.00,36000.00,37000.00,13436.04,24563.96,0.33,0
29216,3132,-1000.00,35000.00,36000.00,12304.31,24695.69,0.21,0
29217,3132,-1000.00,34000.00,35000.00,13906.92,22093.08,0.25,0
29218,3132,-1000.00,33000.00,34000.00,0.00,35000.00,0.05,0
29219,3132,-1000.00,32000.00,33000.00,17338.65,16661.35,0.23,0
29220,3132,-1000.00,31000.00,32000.00,5146.32,20214.55,0.35,0
29221,3132,-1000.00,30000.00,31000.00,0.00,32000.00,0.22,0
29222,3132,-1000.00,29000.00,30000.00,10864.93,9984.69,0.20,0
29223,3132,-1000.00,28000.00,29000.00,0.00,18028.35,0.34,0
29224,3132,-1000.00,27000.00,28000.00,0.00,15331.15,0.30,0
29225,3132,-1000.00,26000.00,27000.00,0.00,28000.00,0.05,0
29226,3132,-1000.00,25000.00,26000.00,0.00,16567.44,0.32,0
29227,3132,-1000.00,24000.00,25000.00,3397.41,22602.59,0.40,0
29228,3132,-1000.00,23000.00,24000.00,0.00,25000.00,0.44,0
29229,3132,-1000.00,22000.00,23000.00,7215.85,12260.06,0.28,0
29230,3132,-1000.00,21000.00,22000.00,9859.70,13140.30,0.06,0
29231,3132,-1000.00,20000.00,21000.00,0.00,13468.69,0.32,0
29232,3132,-1000.00,19000.00,20000.00,0.00,21000.00,0.43,0
29233,3132,-1000.00,18000.00,19000.00,5434.00,14566.00,0.26,0
29234,3132,-1000.00,17000.00,18000.00,0.00,19000.00,0.24,0
29235,3132,-1000.00,16000.00,17000.00,0.00,18000.00,0.43,0
29236,3133,0.00,0.00,1000.00,0.00,0.00,0.02,0
29237,3133,1000.00,1000.00,2000.00,278.50,721.50,0.37,1
29238,3133,1000.00,2000.00,3000.00,107.61,1892.39,0.28,1
29239,3133,1000.00,3000.00,4000.00,1500.00,1500.00,0.01,1
29240,3133,1000.00,4000.00,5000.00,0.00,2591.23,0.01,1
29241,3133,0.00,4000.00,5000.00,0.00,0.00,0.04,0
29242,3133,1000.00,5000.00,6000.00,1179.50,3820.50,0.39,1
29243,3133,1000.00,6000.00,7000.00,0.00,5956.56,0.41,1
29244,3133,-1000.00,5000.00,6000.00,4532.91,2467.09,0.11,0
29245,3133,1000.00,6000.00,7000.00,2435.16,2481.98,0.22,1
29246,3133,1000.00,7000.00,8000.00,0.00,3615.46,0.13,1
29247,3133,-1000.00,6000.00,7000.00,4277.64,2608.52,0.16,0
29248,3133,1000.00,7000.00,8000.00,133.02,6028.66,0.43,1
29249,3133,1000.00,8000.00,9000.00,2896.05,3717.38,0.25,1
29250,3133,1000.00,9000.00,10000.00,2721.44,6278.56,0.35,1
29251,3133,1000.00,10000.00,11000.00,2307.02,7692.98,0.39,1
29252,3133,1000.00,11000.00,12000.00,0.00,4304.75,0.17,1
29253,3133,1000.00,12000.00,13000.00,2385.92,9614.08,0.40,1
29254,3133,1000.00,13000.00,14000.00,1609.71,11390.29,0.42,1
29255,3133,-1000.00,12000.00,13000.00,13842.61,0.00,0.04,0
29256,3133,1000.00,13000.00,14000.00,0.00,13000.00,0.26,1
29257,3133,-1000.00,12000.00,13000.00,4184.50,9815.50,0.21,0
29258,3133,-1000.00,11000.00,12000.00,3679.53,9320.47,0.14,0
29259,3133,-1000.00,10000.00,11000.00,57.47,8077.87,0.38,0
29260,3133,0.00,10000.00,11000.00,0.00,0.00,0.06,0
29261,3133,-1000.00,9000.00,10000.00,5023.62,5976.38,0.13,0
29262,3133,-1000.00,8000.00,9000.00,1686.08,6303.89,0.35,0
29263,3133,-1000.00,7000.00,8000.00,2970.27,6029.73,0.28,0
29264,3133,-1000.00,6000.00,7000.00,0.00,4296.56,0.13,0
29265,3133,-1000.00,5000.00,6000.00,0.00,7000.00,0.01,0
29266,3133,-1000.00,4000.00,5000.00,1764.70,4235.30,0.03,0
29267,3133,-1000.00,3000.00,4000.00,0.00,3932.86,0.27,0
29268,3133,-1000.00,2000.00,3000.00,2031.19,1968.81,0.20,0
29269,3133,-1000.00,1000.00,2000.00,0.00,3000.00,0.20,0
29270,3133,-1000.00,0.00,1000.00,726.09,579.26,0.19,0
29271,3133,-811.06,-811.06,188.94,0.00,811.06,0.42,0
29272,3133,-126.90,-937.96,62.04,0.00,126.90,0.38,0
29273,3133,1000.00,62.04,1062.04,0.00,62.04,0.29,1
29274,3133,1000.00,1062.04,2062.04,250.06,811.98,0.37,1
29275,3133,1000.00,2062.04,3062.04,176.40,1103.31,0.32,1
29276,3133,1000.00,3062.04,4062.04,1244.27,1817.77,0.28,1
29277,3133,-1000.00,2062.04,3062.04,2651.78,1410.26,0.05,0
29278,3133,1000.00,3062.04,4062.04,1426.50,1635.53,0.15,1
29279,3133,1000.00,4062.04,5062.04,0.00,1406.69,0.25,1
29280,3133,1000.00,5062.04,6062.04,0.00,5062.04,0.25,1
29281,3133,1000.00,6062.04,7062.04,2473.69,3588.35,0.26,1
29282,3133,1000.00,7062.04,8062.04,0.00,7062.04,0.14,1
29283,3133,1000.00,8062.04,9062.04,0.00,8062.04,0.01,1
29284,3133,1000.00,9062.04,10062.04,0.00,9062.04,0.25,1
29285,3133,1000.00,10062.04,11062.04,4410.18,5651.86,0.19,1
29286,3133,1000.00,11062.04,12062.04,5118.63,5943.41,0.16,1
29287,3133,1000.00,12062.04,13062.04,5098.53,6963.51,0.27,1
29288,3133,1000.00,13062.04,14062.04,801.96,12260.08,0.42,1
29289,3133,1000.00,14062.04,15062.04,0.00,10593.97,0.07,1
29290,3133,-1000.00,13062.04,14062.04,7991.04,7071.00,0.33,0
29291,3133,1000.00,14062.04,15062.04,5071.37,8990.67,0.11,1
29292,3133,1000.00,15062.04,16062.04,0.00,15062.04,0.33,1
29293,3133,1000.00,16062.04,17062.04,0.00,4026.08,0.19,1
29294,3133,-1000.00,15062.04,16062.04,8585.16,8476.88,0.15,0
29295,3134,-470.96,-470.96,529.04,0.00,470.96,0.20,0
29296,3134,-450.93,-921.89,78.11,0.00,450.93,0.15,0
29297,3134,0.00,-921.89,78.11,0.00,0.00,0.38,0
29298,3134,-57.98,-979.87,20.13,0.00,57.98,0.20,0
29299,3134,-20.13,-1000.00,0.00,0.00,20.13,0.01,0
29300,3135,-1000.00,-1000.00,0.00,0.00,1000.00,0.18,0
29301,3136,1000.00,1000.00,2000.00,313.73,538.51,0.29,1
29302,3136,1000.00,2000.00,3000.00,875.32,879.45,0.22,1
29303,3136,1000.00,3000.00,4000.00,0.00,2072.84,0.36,1
29304,3136,1000.00,4000.00,5000.00,0.00,488.23,0.11,1
29305,3136,1000.00,5000.00,6000.00,647.22,4352.78,0.02,1
29306,3136,1000.00,6000.00,7000.00,1504.00,4496.00,0.38,1
29307,3136,0.00,6000.00,7000.00,0.00,0.00,0.01,0
29308,3136,-1000.00,5000.00,6000.00,4677.90,2322.10,0.04,0
29309,3136,1000.00,6000.00,7000.00,0.00,6000.00,0.09,1
29310,3136,1000.00,7000.00,8000.00,2589.26,4225.33,0.35,1
29311,3136,1000.00,8000.00,9000.00,0.00,8000.00,0.18,1
29312,3136,1000.00,9000.00,10000.00,0.00,9000.00,0.28,1
29313,3136,1000.00,10000.00,11000.00,5000.00,5000.00,0.04,1
29314,3136,1000.00,11000.00,12000.00,0.00,4787.14,0.27,1
29315,3136,1000.00,12000.00,13000.00,0.00,5141.19,0.28,1
29316,3136,1000.00,13000.00,14000.00,6216.44,6783.56,0.24,1
29317,3136,1000.00,14000.00,15000.00,4769.57,9230.43,0.33,1
29318,3136,1000.00,15000.00,16000.00,0.00,15000.00,0.27,1
29319,3136,1000.00,16000.00,17000.00,0.00,16000.00,0.43,1
29320,3136,1000.00,17000.00,18000.00,0.00,9484.86,0.18,1
29321,3136,1000.00,18000.00,19000.00,3019.54,14980.46,0.37,1
29322,3136,-1000.00,17000.00,18000.00,13003.41,5996.59,0.26,0
29323,3136,-1000.00,16000.00,17000.00,8575.16,9424.84,0.08,0
29324,3136,-1000.00,15000.00,16000.00,5391.78,11608.22,0.23,0
29325,3136,-1000.00,14000.00,15000.00,5732.94,10267.06,0.18,0
29326,3136,-1000.00,13000.00,14000.00,3529.42,11470.58,0.32,0
29327,3136,-1000.00,12000.00,13000.00,6487.53,7512.47,0.13,0
29328,3136,-1000.00,11000.00,12000.00,2572.53,10427.47,0.23,0
29329,3136,-1000.00,10000.00,11000.00,0.00,12000.00,0.33,0
29330,3136,0.00,10000.00,11000.00,0.00,0.00,0.00,0
29331,3136,-1000.00,9000.00,10000.00,4455.06,6544.94,0.28,0
29332,3136,-1000.00,8000.00,9000.00,0.00,10000.00,0.37,0
29333,3136,-1000.00,7000.00,8000.00,0.00,9000.00,0.06,0
29334,3136,-1000.00,6000.00,7000.00,0.00,8000.00,0.27,0
29335,3136,-1000.00,5000.00,6000.00,0.00,7000.00,0.11,0
29336,3136,-1000.00,4000.00,5000.00,0.00,2359.09,0.18,0
29337,3136,-1000.00,3000.00,4000.00,0.00,5000.00,0.40,0
29338,3136,-1000.00,2000.00,3000.00,0.00,1465.15,0.23,0
29339,3136,-1000.00,1000.00,2000.00,0.00,3000.00,0.02,0
29340,3136,1000.00,2000.00,3000.00,665.86,1334.14,0.02,1
29341,3136,1000.00,3000.00,4000.00,93.01,2906.99,0.41,1
29342,3136,-1000.00,2000.00,3000.00,2363.87,528.78,0.10,0
29343,3136,1000.00,3000.00,4000.00,0.00,2100.42,0.38,1
29344,3136,1000.00,4000.00,5000.00,0.00,963.36,0.20,1
29345,3136,1000.00,5000.00,6000.00,1212.06,3198.99,0.34,1
29346,3136,1000.00,6000.00,7000.00,1560.95,4439.05,0.35,1
29347,3136,1000.00,7000.00,8000.00,0.00,7000.00,0.33,1
29348,3136,0.00,7000.00,8000.00,0.00,0.00,0.02,0
29349,3136,-1000.00,6000.00,7000.00,1574.83,901.10,0.14,0
29350,3136,1000.00,7000.00,8000.00,972.17,6027.83,0.05,1
29351,3136,1000.00,8000.00,9000.00,0.00,8000.00,0.29,1
29352,3136,1000.00,9000.00,10000.00,0.00,2124.09,0.00,1
29353,3136,1000.00,10000.00,11000.00,2500.85,7499.15,0.25,1
29354,3136,1000.00,11000.00,12000.00,4411.97,6588.03,0.29,1
29355,3136,-1000.00,10000.00,11000.00,11033.77,966.23,0.07,0
29356,3136,1000.00,11000.00,12000.00,196.17,3954.23,0.25,1
29357,3136,1000.00,12000.00,13000.00,0.00,10433.41,0.42,1
29358,3136,1000.00,13000.00,14000.00,0.00,7643.19,0.32,1
29359,3136,1000.00,14000.00,15000.00,6895.72,7104.28,0.42,1
29360,3136,0.00,14000.00,15000.00,0.00,0.00,0.02,0
29361,3136,1000.00,15000.00,16000.00,0.00,9154.40,0.30,1
29362,3137,-822.14,-822.14,177.86,0.00,822.14,0.29,0
29363,3137,-177.86,-1000.00,0.00,48.31,129.55,0.37,0
29364,3138,-1000.00,-1000.00,0.00,0.00,1000.00,0.30,0
29365,3139,-1000.00,-1000.00,0.00,302.71,522.04,0.28,0
29366,3140,-352.02,-352.02,647.98,0.00,352.02,0.11,0
29367,3140,-282.95,-634.97,365.03,0.00,282.95,0.27,0
29368,3140,-300.69,-935.66,64.34,0.00,300.69,0.09,0
29369,3140,-1000.00,-1935.66,-935.66,37.69,26.65,0.08,0
29370,3141,-637.62,-637.62,362.38,0.00,637.62,0.16,0
29371,3141,-362.38,-1000.00,0.00,151.46,210.92,0.27,0
29372,3142,-1000.00,-1000.00,0.00,350.45,649.55,0.07,0
29373,3143,-1000.00,-1000.00,0.00,0.00,164.57,0.01,0
29374,3144,1000.00,1000.00,2000.00,0.00,206.47,0.06,1
29375,3144,1000.00,2000.00,3000.00,785.47,1214.53,0.16,1
29376,3144,1000.00,3000.00,4000.00,0.00,1021.93,0.04,1
29377,3144,1000.00,4000.00,5000.00,1528.95,2471.05,0.07,1
29378,3144,1000.00,5000.00,6000.00,0.00,2037.28,0.26,1
29379,3144,1000.00,6000.00,7000.00,2060.58,3939.42,0.10,1
29380,3144,1000.00,7000.00,8000.00,0.00,7000.00,0.16,1
29381,3144,1000.00,8000.00,9000.00,0.00,8000.00,0.19,1
29382,3144,1000.00,9000.00,10000.00,0.00,6728.93,0.03,1
29383,3144,1000.00,10000.00,11000.00,3411.86,6588.14,0.21,1
29384,3144,1000.00,11000.00,12000.00,4358.46,6641.54,0.11,1
29385,3144,1000.00,12000.00,13000.00,0.00,10282.08,0.38,1
29386,3144,-1000.00,11000.00,12000.00,7151.85,5848.15,0.41,0
29387,3144,1000.00,12000.00,13000.00,0.00,12000.00,0.01,1
29388,3144,1000.00,13000.00,14000.00,0.00,13000.00,0.06,1
29389,3144,1000.00,14000.00,15000.00,0.00,14000.00,0.39,1
29390,3144,1000.00,15000.00,16000.00,6161.37,8838.63,0.22,1
29391,3144,1000.00,16000.00,17000.00,8000.00,8000.00,0.26,1
29392,3144,1000.00,17000.00,18000.00,0.00,17000.00,0.18,1
29393,3144,1000.00,18000.00,19000.00,0.00,12859.80,0.28,1
29394,3144,1000.00,19000.00,20000.00,0.00,19000.00,0.13,1
29395,3144,1000.00,20000.00,21000.00,120.81,17027.07,0.43,1
29396,3144,1000.00,21000.00,22000.00,0.00,21000.00,0.10,1
29397,3144,1000.00,22000.00,23000.00,0.00,22000.00,0.07,1
29398,3144,1000.00,23000.00,24000.00,0.00,23000.00,0.29,1
29399,3144,1000.00,24000.00,25000.00,9190.86,14809.14,0.29,1
29400,3144,1000.00,25000.00,26000.00,0.00,25000.00,0.29,1
29401,3144,1000.00,26000.00,27000.00,0.00,2649.63,0.10,1
29402,3144,1000.00,27000.00,28000.00,0.00,27000.00,0.17,1
29403,3144,1000.00,28000.00,29000.00,0.00,11083.24,0.26,1
29404,3144,1000.00,29000.00,30000.00,122.04,13227.33,0.29,1
29405,3144,1000.00,30000.00,31000.00,2679.99,23085.24,0.41,1
29406,3144,0.00,30000.00,31000.00,0.00,0.00,0.02,0
29407,3144,1000.00,31000.00,32000.00,0.00,31000.00,0.23,1
29408,3144,1000.00,32000.00,33000.00,0.00,24643.18,0.38,1
29409,3144,-1000.00,31000.00,32000.00,18396.99,14603.01,0.13,0
29410,3144,-1000.00,30000.00,31000.00,20178.07,7234.05,0.11,0
29411,3144,1000.00,31000.00,32000.00,10872.35,20127.65,0.16,1
29412,3145,-1000.00,-1000.00,0.00,0.00,1000.00,0.08,0
29413,3146,-968.52,-968.52,31.48,14.13,954.39,0.44,0
29414,3146,-31.48,-1000.00,0.00,0.00,31.48,0.11,0
29415,3147,-1000.00,-1000.00,0.00,0.00,41.52,0.44,0
29416,3148,-1000.00,-1000.00,0.00,0.00,402.28,0.00,0
29417,3149,-755.92,-755.92,244.08,626.20,129.72,0.09,0
29418,3149,1000.00,244.08,1244.08,106.17,137.91,0.19,1
29419,3149,1000.00,1244.08,2244.08,0.00,36.06,0.11,1
29420,3149,1000.00,2244.08,3244.08,0.00,2244.08,0.08,1
29421,3149,1000.00,3244.08,4244.08,0.00,3244.08,0.32,1
29422,3149,-1000.00,2244.08,3244.08,2491.36,1368.95,0.15,0
29423,3149,1000.00,3244.08,4244.08,477.76,2766.32,0.42,1
29424,3149,1000.00,4244.08,5244.08,848.01,3396.06,0.22,1
29425,3149,1000.00,5244.08,6244.08,696.77,4547.31,0.15,1
29426,3149,1000.00,6244.08,7244.08,0.00,6244.08,0.16,1
29427,3149,1000.00,7244.08,8244.08,3065.04,4179.04,0.05,1
29428,3149,1000.00,8244.08,9244.08,2651.65,5592.43,0.31,1
29429,3149,1000.00,9244.08,10244.08,0.00,9244.08,0.13,1
29430,3149,-1000.00,8244.08,9244.08,6991.44,3252.64,0.06,0
29431,3149,1000.00,9244.08,10244.08,0.00,9244.08,0.28,1
29432,3149,1000.00,10244.08,11244.08,0.00,4239.44,0.27,1
29433,3149,-1000.00,9244.08,10244.08,6594.16,4649.92,0.01,0
29434,3149,1000.00,10244.08,11244.08,5083.09,5160.99,0.22,1
29435,3149,1000.00,11244.08,12244.08,4863.60,6380.48,0.09,1
29436,3149,1000.00,12244.08,13244.08,0.00,5717.30,0.24,1
29437,3149,1000.00,13244.08,14244.08,0.00,11503.89,0.14,1
29438,3149,1000.00,14244.08,15244.08,4590.02,9654.06,0.21,1
29439,3149,1000.00,15244.08,16244.08,4645.92,10598.16,0.16,1
29440,3149,-1000.00,14244.08,15244.08,9659.72,6584.36,0.16,0
29441,3149,1000.00,15244.08,16244.08,0.00,8547.64,0.34,1
29442,3149,1000.00,16244.08,17244.08,0.00,2342.34,0.09,1
29443,3149,1000.00,17244.08,18244.08,3772.65,13471.43,0.35,1
29444,3149,-1000.00,16244.08,17244.08,15152.02,0.00,0.04,0
29445,3149,1000.00,17244.08,18244.08,4706.59,12537.49,0.19,1
29446,3149,0.00,17244.08,18244.08,0.00,0.00,0.05,0
29447,3149,1000.00,18244.08,19244.08,7846.20,10397.87,0.21,1
29448,3149,1000.00,19244.08,20244.08,6327.27,12916.81,0.26,1
29449,3149,-1000.00,18244.08,19244.08,12725.92,6661.18,0.20,0
29450,3149,1000.00,19244.08,20244.08,3836.35,15407.73,0.35,1
29451,3149,1000.00,20244.08,21244.08,1544.60,18699.48,0.38,1
29452,3149,1000.00,21244.08,22244.08,0.00,21244.08,0.20,1
29453,3149,1000.00,22244.08,23244.08,7056.67,15187.41,0.02,1
29454,3149,1000.00,23244.08,24244.08,0.00,8531.65,0.22,1
29455,3149,1000.00,24244.08,25244.08,0.00,5095.35,0.04,1
29456,3149,1000.00,25244.08,26244.08,4704.79,20539.29,0.37,1
29457,3149,1000.00,26244.08,27244.08,5098.62,21145.45,0.03,1
29458,3149,1000.00,27244.08,28244.08,4982.16,22261.92,0.33,1
29459,3149,-1000.00,26244.08,27244.08,12714.89,12403.45,0.22,0
29460,3149,1000.00,27244.08,28244.08,0.00,27244.08,0.11,1
29461,3149,1000.00,28244.08,29244.08,14122.04,14122.04,0.20,1
29462,3150,-1000.00,-1000.00,0.00,0.00,1000.00,0.20,0
29463,3151,1000.00,1000.00,2000.00,0.00,201.13,0.17,1
29464,3151,1000.00,2000.00,3000.00,936.33,1063.67,0.05,1
29465,3151,1000.00,3000.00,4000.00,18.67,2981.33,0.40,1
29466,3151,1000.00,4000.00,5000.00,0.00,4000.00,0.39,1
29467,3151,1000.00,5000.00,6000.00,0.00,5000.00,0.21,1
29468,3151,1000.00,6000.00,7000.00,0.00,6000.00,0.30,1
29469,3151,1000.00,7000.00,8000.00,0.00,962.84,0.07,1
29470,3151,1000.00,8000.00,9000.00,0.00,1046.66,0.08,1
29471,3151,-1000.00,7000.00,8000.00,1112.82,316.58,0.12,0
29472,3151,1000.00,8000.00,9000.00,2030.25,5826.46,0.37,1
29473,3151,1000.00,9000.00,10000.00,0.00,9000.00,0.05,1
29474,3151,1000.00,10000.00,11000.00,0.00,9429.08,0.41,1
29475,3151,1000.00,11000.00,12000.00,0.00,2871.00,0.09,1
29476,3151,1000.00,12000.00,13000.00,0.00,12000.00,0.03,1
29477,3151,1000.00,13000.00,14000.00,766.52,12233.48,0.42,1
29478,3151,1000.00,14000.00,15000.00,2770.54,11229.46,0.33,1
29479,3151,1000.00,15000.00,16000.00,4277.36,10722.64,0.32,1
29480,3151,0.00,15000.00,16000.00,0.00,0.00,0.03,0
29481,3151,1000.00,16000.00,17000.00,5562.23,10437.77,0.15,1
29482,3151,1000.00,17000.00,18000.00,8500.00,8500.00,0.40,1
29483,3151,-1000.00,16000.00,17000.00,12894.37,5105.63,0.22,0
29484,3151,-1000.00,15000.00,16000.00,8500.00,8500.00,0.18,0
29485,3151,-1000.00,14000.00,15000.00,0.00,16000.00,0.30,0
29486,3151,-1000.00,13000.00,14000.00,0.00,15000.00,0.44,0
29487,3151,-1000.00,12000.00,13000.00,4519.45,9480.55,0.25,0
29488,3151,-1000.00,11000.00,12000.00,0.00,8907.38,0.28,0
29489,3151,0.00,11000.00,12000.00,0.00,0.00,0.03,0
29490,3151,-1000.00,10000.00,11000.00,0.00,7536.09,0.33,0
29491,3151,-1000.00,9000.00,10000.00,2913.93,8086.07,0.32,0
29492,3151,-1000.00,8000.00,9000.00,2502.48,7497.52,0.37,0
29493,3151,-1000.00,7000.00,8000.00,2507.53,188.70,0.11,0
29494,3151,-1000.00,6000.00,7000.00,0.00,6310.53,0.41,0
29495,3151,-1000.00,5000.00,6000.00,949.67,6006.71,0.42,0
29496,3151,-1000.00,4000.00,5000.00,2861.69,466.09,0.13,0
29497,3151,-1000.00,3000.00,4000.00,0.00,5000.00,0.12,0
29498,3151,-1000.00,2000.00,3000.00,2497.59,1502.41,0.06,0
29499,3151,-1000.00,1000.00,2000.00,1500.00,1500.00,0.09,0
29500,3151,-1000.00,0.00,1000.00,581.84,1418.16,0.20,0
29501,3151,-1000.00,-1000.00,0.00,0.00,1000.00,0.28,0
29502,3152,-1000.00,-1000.00,0.00,0.00,1000.00,0.09,0
29503,3153,-1000.00,-1000.00,0.00,552.68,447.32,0.06,0
29504,3154,-264.99,-264.99,735.01,0.00,264.99,0.05,0
29505,3154,-735.01,-1000.00,0.00,367.51,367.51,0.03,0
29506,3155,0.00,0.00,1000.00,0.00,0.00,0.29,0
29507,3155,-1000.00,-1000.00,0.00,383.26,616.74,0.26,0
29508,3156,1000.00,1000.00,2000.00,0.00,9.38,0.12,1
29509,3156,-1000.00,0.00,1000.00,2000.00,0.00,0.02,0
29510,3156,1000.00,1000.00,2000.00,211.87,788.13,0.18,1
29511,3156,-1000.00,0.00,1000.00,1199.23,800.77,0.20,0
29512,3156,1000.00,1000.00,2000.00,500.00,500.00,0.02,1
29513,3156,1000.00,2000.00,3000.00,0.00,2000.00,0.10,1
29514,3156,-1000.00,1000.00,2000.00,1636.01,1363.99,0.12,0
29515,3156,1000.00,2000.00,3000.00,491.91,1508.09,0.39,1
29516,3156,1000.00,3000.00,4000.00,0.00,2110.66,0.30,1
29517,3156,1000.00,4000.00,5000.00,1839.52,2160.48,0.25,1
29518,3156,1000.00,5000.00,6000.00,0.00,5000.00,0.19,1
29519,3156,1000.00,6000.00,7000.00,1682.69,4317.31,0.10,1
29520,3156,1000.00,7000.00,8000.00,1316.19,5683.81,0.38,1
29521,3156,-1000.00,6000.00,7000.00,1333.68,572.04,0.13,0
29522,3156,-1000.00,5000.00,6000.00,2907.10,1408.31,0.14,0
29523,3156,1000.00,6000.00,7000.00,1238.83,4761.17,0.38,1
29524,3156,-1000.00,5000.00,6000.00,3776.73,3223.27,0.34,0
29525,3156,1000.00,6000.00,7000.00,920.54,5079.46,0.14,1
29526,3156,1000.00,7000.00,8000.00,2774.42,4225.58,0.29,1
29527,3156,1000.00,8000.00,9000.00,2526.57,5473.43,0.18,1
29528,3156,1000.00,9000.00,10000.00,1461.40,7538.60,0.39,1
29529,3156,1000.00,10000.00,11000.00,0.00,10000.00,0.23,1
29530,3156,1000.00,11000.00,12000.00,0.00,7875.06,0.15,1
29531,3156,1000.00,12000.00,13000.00,0.00,10062.16,0.32,1
29532,3156,-1000.00,11000.00,12000.00,8144.73,4855.27,0.27,0
29533,3156,-1000.00,10000.00,11000.00,0.00,12000.00,0.25,0
29534,3156,-1000.00,9000.00,10000.00,0.00,9788.53,0.43,0
29535,3156,-1000.00,8000.00,9000.00,0.00,10000.00,0.05,0
29536,3156,-1000.00,7000.00,8000.00,4473.35,4526.65,0.13,0
29537,3156,-1000.00,6000.00,7000.00,577.55,7422.45,0.36,0
29538,3156,-1000.00,5000.00,6000.00,0.00,1929.75,0.17,0
29539,3156,-1000.00,4000.00,5000.00,1481.75,0.00,0.08,0
29540,3156,-1000.00,3000.00,4000.00,0.00,5000.00,0.30,0
29541,3156,-1000.00,2000.00,3000.00,0.00,1080.83,0.00,0
29542,3156,-1000.00,1000.00,2000.00,859.76,2140.24,0.02,0
29543,3156,-1000.00,0.00,1000.00,924.36,1075.64,0.15,0
29544,3156,-1000.00,-1000.00,0.00,0.00,1000.00,0.23,0
29545,3157,1000.00,1000.00,2000.00,296.29,703.71,0.32,1
29546,3157,1000.00,2000.00,3000.00,189.77,815.50,0.27,1
29547,3157,0.00,2000.00,3000.00,0.00,0.00,0.02,0
29548,3157,1000.00,3000.00,4000.00,0.00,2848.77,0.12,1
29549,3157,1000.00,4000.00,5000.00,1549.69,1752.77,0.23,1
29550,3157,0.00,4000.00,5000.00,0.00,0.00,0.04,0
29551,3157,-1000.00,3000.00,4000.00,2951.54,2048.46,0.02,0
29552,3157,1000.00,4000.00,5000.00,0.00,4000.00,0.05,1
29553,3157,1000.00,5000.00,6000.00,1375.28,3624.72,0.37,1
29554,3157,1000.00,6000.00,7000.00,2949.56,3050.44,0.12,1
29555,3157,1000.00,7000.00,8000.00,1386.41,5613.59,0.27,1
29556,3157,1000.00,8000.00,9000.00,0.00,8000.00,0.00,1
29557,3157,1000.00,9000.00,10000.00,844.29,8155.71,0.19,1
29558,3157,0.00,9000.00,10000.00,0.00,0.00,0.01,0
29559,3157,0.00,9000.00,10000.00,0.00,0.00,0.05,0
29560,3157,1000.00,10000.00,11000.00,3186.82,6767.16,0.33,1
29561,3157,1000.00,11000.00,12000.00,1526.29,9292.70,0.42,1
29562,3157,1000.00,12000.00,13000.00,4322.62,7677.38,0.38,1
29563,3157,1000.00,13000.00,14000.00,0.00,13000.00,0.08,1
29564,3157,1000.00,14000.00,15000.00,2009.02,11990.98,0.38,1
29565,3157,1000.00,15000.00,16000.00,0.00,11604.12,0.16,1
29566,3157,1000.00,16000.00,17000.00,8000.00,8000.00,0.09,1
29567,3157,1000.00,17000.00,18000.00,0.00,16374.07,0.24,1
29568,3157,-1000.00,16000.00,17000.00,10518.25,0.00,0.04,0
29569,3157,-1000.00,15000.00,16000.00,0.00,7886.83,0.23,0
29570,3157,-1000.00,14000.00,15000.00,3185.40,12814.60,0.24,0
29571,3157,-1000.00,13000.00,14000.00,0.00,15000.00,0.15,0
29572,3157,-1000.00,12000.00,13000.00,4685.72,9314.28,0.33,0
29573,3157,-1000.00,11000.00,12000.00,2354.22,10645.78,0.41,0
29574,3157,-1000.00,10000.00,11000.00,7715.84,4284.16,0.11,0
29575,3157,-1000.00,9000.00,10000.00,4794.76,6205.24,0.22,0
29576,3157,-1000.00,8000.00,9000.00,3222.17,6777.83,0.04,0
29577,3157,-1000.00,7000.00,8000.00,0.00,7844.72,0.36,0
29578,3157,-1000.00,6000.00,7000.00,0.00,7309.74,0.21,0
29579,3157,-1000.00,5000.00,6000.00,602.38,5414.21,0.41,0
29580,3157,-1000.00,4000.00,5000.00,2324.95,0.00,0.07,0
29581,3157,-1000.00,3000.00,4000.00,2579.13,2420.87,0.17,0
29582,3157,-1000.00,2000.00,3000.00,0.00,3205.41,0.26,0
29583,3157,-1000.00,1000.00,2000.00,0.00,3000.00,0.35,0
29584,3157,-1000.00,0.00,1000.00,0.00,2000.00,0.40,0
29585,3157,-1000.00,-1000.00,0.00,500.00,500.00,0.15,0
29586,3158,1000.00,1000.00,2000.00,0.00,188.80,0.12,1
29587,3158,-1000.00,0.00,1000.00,1011.52,988.48,0.21,0
29588,3158,1000.00,1000.00,2000.00,213.82,786.18,0.40,1
29589,3158,1000.00,2000.00,3000.00,441.14,1558.86,0.07,1
29590,3158,1000.00,3000.00,4000.00,0.00,3000.00,0.39,1
29591,3158,1000.00,4000.00,5000.00,0.00,4000.00,0.08,1
29592,3158,1000.00,5000.00,6000.00,934.58,4065.42,0.42,1
29593,3158,-1000.00,4000.00,5000.00,3016.03,0.00,0.00,0
29594,3158,1000.00,5000.00,6000.00,1943.04,3056.96,0.30,1
29595,3158,1000.00,6000.00,7000.00,0.00,6000.00,0.31,1
29596,3158,-1000.00,5000.00,6000.00,4015.90,2984.10,0.34,0
29597,3158,1000.00,6000.00,7000.00,3000.00,3000.00,0.14,1
29598,3158,1000.00,7000.00,8000.00,2503.88,4496.12,0.18,1
29599,3158,1000.00,8000.00,9000.00,0.00,7332.42,0.28,1
29600,3158,1000.00,9000.00,10000.00,0.00,2057.17,0.12,1
29601,3158,-1000.00,8000.00,9000.00,4528.94,5471.06,0.38,0
29602,3158,-1000.00,7000.00,8000.00,6772.98,2227.02,0.05,0
29603,3158,-1000.00,6000.00,7000.00,2357.71,5642.29,0.32,0
29604,3158,-1000.00,5000.00,6000.00,3342.35,3657.65,0.14,0
29605,3158,-1000.00,4000.00,5000.00,1703.14,4296.86,0.03,0
29606,3158,-1000.00,3000.00,4000.00,2198.58,1501.75,0.17,0
29607,3158,-1000.00,2000.00,3000.00,2223.00,1777.00,0.40,0
29608,3158,-1000.00,1000.00,2000.00,292.87,2707.13,0.16,0
29609,3158,-1000.00,0.00,1000.00,0.00,1253.90,0.36,0
29610,3158,-1000.00,-1000.00,0.00,310.35,689.65,0.25,0
29611,3159,-695.95,-695.95,304.05,493.08,202.87,0.30,0
29612,3159,0.00,-695.95,304.05,0.00,0.00,0.39,0
29613,3159,-5.01,-700.95,299.05,5.01,0.00,0.23,0
29614,3159,-1000.00,-1700.95,-700.95,40.61,126.22,0.34,0
29615,3160,-621.61,-621.61,378.39,0.00,621.61,0.26,0
29616,3160,-378.39,-1000.00,0.00,0.00,378.39,0.26,0
29617,3161,0.00,0.00,1000.00,0.00,0.00,0.03,0
29618,3161,-1000.00,-1000.00,0.00,0.00,1000.00,0.22,0
29619,3162,-1000.00,-1000.00,0.00,0.00,1000.00,0.43,0
29620,3163,-1000.00,-1000.00,0.00,442.26,557.74,0.18,0
29621,3164,-1000.00,-1000.00,0.00,0.00,1000.00,0.14,0
29622,3165,-1000.00,-1000.00,0.00,0.00,51.73,0.14,0
29623,3166,1000.00,1000.00,2000.00,0.00,638.32,0.23,1
29624,3166,1000.00,2000.00,3000.00,541.13,1458.87,0.29,1
29625,3166,1000.00,3000.00,4000.00,0.00,3000.00,0.19,1
29626,3166,1000.00,4000.00,5000.00,1263.07,2736.93,0.04,1
29627,3166,1000.00,5000.00,6000.00,0.00,3858.53,0.33,1
29628,3166,1000.00,6000.00,7000.00,0.00,459.20,0.09,1
29629,3166,1000.00,7000.00,8000.00,0.00,7000.00,0.05,1
29630,3166,1000.00,8000.00,9000.00,0.00,8000.00,0.26,1
29631,3166,-1000.00,7000.00,8000.00,5743.03,1160.94,0.10,0
29632,3166,1000.00,8000.00,9000.00,0.00,8000.00,0.06,1
29633,3166,-1000.00,7000.00,8000.00,9000.00,0.00,0.00,0
29634,3166,-1000.00,6000.00,7000.00,7792.50,0.00,0.03,0
29635,3166,1000.00,7000.00,8000.00,0.00,2265.21,0.19,1
29636,3166,1000.00,8000.00,9000.00,0.00,7442.21,0.22,1
29637,3166,1000.00,9000.00,10000.00,0.00,9000.00,0.34,1
29638,3166,1000.00,10000.00,11000.00,0.00,10000.00,0.10,1
29639,3166,-1000.00,9000.00,10000.00,5548.23,5451.77,0.12,0
29640,3166,-577.76,8422.24,9422.24,577.76,0.00,0.01,0
29641,3166,1000.00,9422.24,10422.24,3765.47,5656.77,0.19,1
29642,3166,1000.00,10422.24,11422.24,1997.65,3262.36,0.09,1
29643,3166,-1000.00,9422.24,10422.24,9488.51,1933.73,0.15,0
29644,3166,-1000.00,8422.24,9422.24,5524.92,4897.32,0.14,0
29645,3166,1000.00,9422.24,10422.24,3349.53,6072.71,0.31,1
29646,3166,1000.00,10422.24,11422.24,1247.54,9174.70,0.28,1
29647,3166,1000.00,11422.24,12422.24,5589.59,5832.65,0.12,1
29648,3166,1000.00,12422.24,13422.24,2239.93,10182.31,0.33,1
29649,3166,1000.00,13422.24,14422.24,0.00,7558.65,0.14,1
29650,3166,1000.00,14422.24,15422.24,4124.89,10297.35,0.36,1
29651,3166,1000.00,15422.24,16422.24,0.00,15422.24,0.10,1
29652,3166,1000.00,16422.24,17422.24,0.00,16422.24,0.07,1
29653,3166,1000.00,17422.24,18422.24,0.00,11316.24,0.20,1
29654,3166,1000.00,18422.24,19422.24,3258.19,15164.04,0.29,1
29655,3166,-1000.00,17422.24,18422.24,12035.26,7386.97,0.11,0
29656,3166,1000.00,18422.24,19422.24,0.00,14835.03,0.36,1
29657,3166,1000.00,19422.24,20422.24,3184.22,16238.02,0.13,1
29658,3166,1000.00,20422.24,21422.24,0.00,20422.24,0.00,1
29659,3166,-1000.00,19422.24,20422.24,8660.28,12761.96,0.23,0
29660,3167,-605.74,-605.74,394.26,0.00,605.74,0.35,0
29661,3167,-239.23,-844.97,155.03,0.00,239.23,0.36,0
29662,3167,-1000.00,-1844.97,-844.97,79.79,57.77,0.18,0
29663,3168,-1000.00,-1000.00,0.00,412.91,587.09,0.16,0
29664,3169,-1000.00,-1000.00,0.00,346.49,180.79,0.15,0
29665,3170,-1000.00,-1000.00,0.00,0.00,1000.00,0.02,0
29666,3171,-1000.00,-1000.00,0.00,417.03,582.97,0.21,0
29667,3172,-1000.00,-1000.00,0.00,184.18,815.82,0.41,0
29668,3173,1000.00,1000.00,2000.00,0.00,1000.00,0.28,1
29669,3173,1000.00,2000.00,3000.00,0.00,1344.00,0.38,1
29670,3173,1000.00,3000.00,4000.00,0.00,3000.00,0.19,1
29671,3173,1000.00,4000.00,5000.00,1692.43,2307.57,0.27,1
29672,3173,1000.00,5000.00,6000.00,0.00,5000.00,0.38,1
29673,3173,1000.00,6000.00,7000.00,3000.00,3000.00,0.04,1
29674,3173,1000.00,7000.00,8000.00,0.00,5104.32,0.33,1
29675,3173,1000.00,8000.00,9000.00,4000.00,4000.00,0.04,1
29676,3173,1000.00,9000.00,10000.00,0.00,9000.00,0.19,1
29677,3173,1000.00,10000.00,11000.00,0.00,10000.00,0.23,1
29678,3173,1000.00,11000.00,12000.00,5500.00,5500.00,0.01,1
29679,3173,1000.00,12000.00,13000.00,0.00,12000.00,0.32,1
29680,3173,1000.00,13000.00,14000.00,0.00,13000.00,0.38,1
29681,3173,1000.00,14000.00,15000.00,0.00,14000.00,0.27,1
29682,3173,1000.00,15000.00,16000.00,2643.84,9894.23,0.36,1
29683,3173,-1000.00,14000.00,15000.00,8433.05,7566.95,0.31,0
29684,3173,1000.00,15000.00,16000.00,6768.20,8231.80,0.37,1
29685,3173,1000.00,16000.00,17000.00,1673.37,14326.63,0.17,1
29686,3173,1000.00,17000.00,18000.00,7392.00,9608.00,0.26,1
29687,3173,1000.00,18000.00,19000.00,1665.78,15849.36,0.43,1
29688,3173,1000.00,19000.00,20000.00,0.00,19000.00,0.23,1
29689,3173,1000.00,20000.00,21000.00,0.00,20000.00,0.32,1
29690,3173,-1000.00,19000.00,20000.00,12237.98,0.00,0.01,0
29691,3173,1000.00,20000.00,21000.00,9119.62,10880.38,0.40,1
29692,3173,-1000.00,19000.00,20000.00,0.00,10073.30,0.30,0
29693,3173,-1000.00,18000.00,19000.00,0.00,13382.03,0.30,0
29694,3173,-1000.00,17000.00,18000.00,9133.63,9866.37,0.12,0
29695,3173,-1000.00,16000.00,17000.00,526.57,17473.43,0.23,0
29696,3173,-1000.00,15000.00,16000.00,0.00,10046.46,0.08,0
29697,3173,-1000.00,14000.00,15000.00,0.00,1441.42,0.13,0
29698,3173,-1000.00,13000.00,14000.00,4023.50,6596.97,0.26,0
29699,3173,-1000.00,12000.00,13000.00,3969.66,10030.34,0.07,0
29700,3173,-1000.00,11000.00,12000.00,8716.90,0.00,0.04,0
29701,3173,-1000.00,10000.00,11000.00,3261.96,6119.40,0.31,0
29702,3173,-1000.00,9000.00,10000.00,0.00,1380.67,0.15,0
29703,3173,-1000.00,8000.00,9000.00,0.00,10000.00,0.20,0
29704,3173,-1000.00,7000.00,8000.00,3917.43,5082.57,0.18,0
29705,3173,-1000.00,6000.00,7000.00,2564.40,5435.60,0.34,0
29706,3173,-1000.00,5000.00,6000.00,3147.78,3852.22,0.25,0
29707,3173,-1000.00,4000.00,5000.00,0.00,6000.00,0.42,0
29708,3173,-1000.00,3000.00,4000.00,1601.17,3398.83,0.26,0
29709,3173,-1000.00,2000.00,3000.00,1773.60,1533.95,0.20,0
29710,3173,-1000.00,1000.00,2000.00,0.00,2892.17,0.43,0
29711,3173,-1000.00,0.00,1000.00,576.30,1423.70,0.14,0
29712,3173,-962.13,-962.13,37.87,0.00,962.13,0.38,0
29713,3173,-29.16,-991.30,8.70,0.00,29.16,0.18,0
29714,3173,-8.70,-1000.00,0.00,0.00,8.70,0.23,0
29715,3174,0.00,0.00,1000.00,0.00,0.00,0.25,0
29716,3174,1000.00,1000.00,2000.00,348.98,0.00,0.37,1
29717,3174,1000.00,2000.00,3000.00,485.03,0.00,0.39,1
29718,3174,1000.00,3000.00,4000.00,3000.00,0.00,0.08,1
29719,3174,1000.00,4000.00,5000.00,2855.50,0.00,0.12,1
29720,3174,-878.82,3121.18,4121.18,0.00,878.82,0.36,0
29721,3174,0.00,3121.18,4121.18,0.00,0.00,0.35,0
29722,3174,-1000.00,2121.18,3121.18,0.00,1600.78,0.17,0
29723,3174,-872.14,1249.04,2249.04,0.00,872.14,0.27,0
29724,3174,1000.00,2249.04,3249.04,895.57,0.00,0.35,1
29725,3174,-1000.00,1249.04,2249.04,0.00,1238.70,0.29,0
29726,3174,1000.00,2249.04,3249.04,1311.41,14.70,0.28,1
29727,3174,0.00,2249.04,3249.04,0.00,0.00,0.41,0
29728,3174,1000.00,3249.04,4249.04,1674.58,1574.46,0.17,1
29729,3174,-1000.00,2249.04,3249.04,2025.01,2224.03,0.16,0
29730,3174,-768.78,1480.26,2480.26,0.00,768.78,0.35,0
29731,3174,-1000.00,480.26,1480.26,0.00,1166.21,0.22,0
29732,3174,0.00,480.26,1480.26,0.00,0.00,0.12,0
29733,3174,-1000.00,-519.74,480.26,347.56,1132.70,0.15,0
29734,3174,1000.00,480.26,1480.26,265.24,177.84,0.28,1
29735,3174,1000.00,1480.26,2480.26,1456.18,0.00,0.11,1
29736,3174,-277.53,1202.72,2202.72,0.00,277.53,0.36,0
29737,3174,-1000.00,202.72,1202.72,0.00,1055.75,0.04,0
29738,3174,0.00,202.72,1202.72,0.00,0.00,0.32,0
29739,3174,-759.40,-556.68,443.32,0.00,759.40,0.17,0
29740,3174,0.00,-556.68,443.32,0.00,0.00,0.21,0
29741,3174,0.00,-556.68,443.32,0.00,0.00,0.32,0
29742,3174,1000.00,443.32,1443.32,108.80,0.00,0.23,1
29743,3174,0.00,443.32,1443.32,0.00,0.00,0.10,0
29744,3174,-236.49,206.83,1206.83,0.00,236.49,0.27,0
29745,3174,-1000.00,-793.17,206.83,0.00,1115.44,0.13,0
29746,3174,-22.60,-815.77,184.23,0.00,22.60,0.43,0
29747,3175,-1000.00,-1000.00,0.00,692.21,307.79,0.09,0
29748,3176,-1000.00,-1000.00,0.00,433.09,394.85,0.21,0
29749,3177,-1000.00,-1000.00,0.00,0.00,1000.00,0.38,0
29750,3178,-580.35,-580.35,419.65,0.00,580.35,0.36,0
29751,3178,-26.19,-606.54,393.46,0.00,26.19,0.12,0
29752,3178,-172.13,-778.67,221.33,0.00,172.13,0.15,0
29753,3178,-38.99,-817.66,182.34,0.00,38.99,0.14,0
29754,3178,-182.34,-1000.00,0.00,50.25,132.09,0.11,0
29755,3179,-514.79,-514.79,485.21,0.00,514.79,0.23,0
29756,3179,-485.21,-1000.00,0.00,207.37,277.84,0.20,0
29757,3180,-1000.00,-1000.00,0.00,0.31,332.39,0.44,0
29758,3181,0.00,0.00,1000.00,68.85,931.15,0.23,0
29759,3181,0.00,0.00,1000.00,0.00,464.42,0.29,0
29760,3181,0.00,0.00,1000.00,198.03,555.53,0.32,0
29761,3181,0.00,0.00,1000.00,0.00,0.00,0.08,0
29762,3181,0.00,0.00,1000.00,66.29,933.71,0.28,0
29763,3181,0.00,0.00,1000.00,474.88,525.12,0.24,0
29764,3181,0.00,0.00,1000.00,0.00,821.56,0.36,0
29765,3181,0.00,0.00,1000.00,0.00,1000.00,0.13,0
29766,3181,0.00,0.00,1000.00,489.31,510.69,0.08,0
29767,3181,0.00,0.00,1000.00,66.27,933.73,0.35,0
29768,3181,0.00,0.00,1000.00,314.05,685.95,0.30,0
29769,3181,0.00,0.00,1000.00,389.49,610.51,0.23,0
29770,3181,0.00,0.00,1000.00,221.99,778.01,0.10,0
29771,3181,0.00,0.00,1000.00,0.00,1000.00,0.06,0
29772,3181,0.00,0.00,1000.00,0.00,1000.00,0.20,0
29773,3181,0.00,0.00,1000.00,26.59,330.64,0.24,0
29774,3181,-801.36,-801.36,198.64,480.91,320.45,0.17,0
29775,3181,0.00,-801.36,198.64,0.00,189.06,0.12,0
29776,3181,-198.64,-1000.00,0.00,112.58,86.06,0.27,0
29777,3182,-131.10,-131.10,868.90,0.00,131.10,0.14,0
29778,3182,-868.90,-1000.00,0.00,0.00,868.90,0.23,0
29779,3183,1000.00,1000.00,2000.00,0.00,1000.00,0.41,1
29780,3183,1000.00,2000.00,3000.00,455.48,1544.52,0.34,1
29781,3183,1000.00,3000.00,4000.00,713.31,2286.69,0.17,1
29782,3183,1000.00,4000.00,5000.00,709.91,3290.09,0.36,1
29783,3183,1000.00,5000.00,6000.00,0.00,5000.00,0.23,1
29784,3183,1000.00,6000.00,7000.00,0.00,6000.00,0.07,1
29785,3183,1000.00,7000.00,8000.00,3232.51,3767.49,0.18,1
29786,3183,1000.00,8000.00,9000.00,0.00,8000.00,0.20,1
29787,3183,1000.00,9000.00,10000.00,1922.78,7077.22,0.17,1
29788,3183,1000.00,10000.00,11000.00,2873.88,6127.66,0.32,1
29789,3183,-1000.00,9000.00,10000.00,5761.96,5238.04,0.11,0
29790,3183,1000.00,10000.00,11000.00,3444.04,6555.96,0.13,1
29791,3183,1000.00,11000.00,12000.00,853.24,9483.24,0.43,1
29792,3183,1000.00,12000.00,13000.00,1877.12,6310.45,0.31,1
29793,3183,1000.00,13000.00,14000.00,4232.60,8767.40,0.24,1
29794,3183,-1000.00,12000.00,13000.00,3426.57,0.00,0.04,0
29795,3183,1000.00,13000.00,14000.00,3750.53,9249.47,0.42,1
29796,3183,1000.00,14000.00,15000.00,0.00,14000.00,0.21,1
29797,3183,-1000.00,13000.00,14000.00,8434.34,6565.66,0.09,0
29798,3183,1000.00,14000.00,15000.00,0.00,14000.00,0.42,1
29799,3183,1000.00,15000.00,16000.00,0.00,15000.00,0.30,1
29800,3183,1000.00,16000.00,17000.00,7915.31,8084.69,0.11,1
29801,3183,-1000.00,15000.00,16000.00,0.00,17000.00,0.03,0
29802,3183,-1000.00,14000.00,15000.00,3691.83,12308.17,0.35,0
29803,3183,-1000.00,13000.00,14000.00,4199.20,9324.36,0.33,0
29804,3183,-1000.00,12000.00,13000.00,0.00,13516.24,0.29,0
29805,3183,-1000.00,11000.00,12000.00,0.00,13000.00,0.40,0
29806,3183,-1000.00,10000.00,11000.00,0.00,6986.02,0.15,0
29807,3183,-1000.00,9000.00,10000.00,0.00,11000.00,0.42,0
29808,3183,-1000.00,8000.00,9000.00,0.00,10000.00,0.14,0
29809,3183,-1000.00,7000.00,8000.00,0.00,4401.06,0.26,0
29810,3183,-1000.00,6000.00,7000.00,1037.17,5655.23,0.38,0
29811,3183,-1000.00,5000.00,6000.00,0.00,7000.00,0.31,0
29812,3183,-1000.00,4000.00,5000.00,0.00,3853.93,0.37,0
29813,3183,-1000.00,3000.00,4000.00,365.56,4625.08,0.44,0
29814,3183,-1000.00,2000.00,3000.00,0.00,4000.00,0.20,0
29815,3183,-1000.00,1000.00,2000.00,648.71,2351.29,0.32,0
29816,3183,0.00,1000.00,2000.00,0.00,0.00,0.06,0
29817,3183,-1000.00,0.00,1000.00,122.31,1877.69,0.27,0
29818,3183,-1000.00,-1000.00,0.00,623.25,376.75,0.13,0
29819,3184,-1000.00,-1000.00,0.00,0.00,1000.00,0.36,0
29820,3185,-226.84,-226.84,773.16,0.00,226.84,0.14,0
29821,3185,-773.16,-1000.00,-0.00,159.10,614.06,0.40,0
29822,3186,-406.59,-406.59,593.41,85.67,320.91,0.39,0
29823,3186,1000.00,593.41,1593.41,89.67,52.72,0.43,1
29824,3186,-1000.00,-406.59,593.41,0.00,1593.41,0.18,0
29825,3186,1000.00,593.41,1593.41,379.65,0.00,0.11,1
29826,3186,-1000.00,-406.59,593.41,0.00,1593.41,0.17,0
29827,3186,-593.41,-1000.00,0.00,0.00,593.41,0.11,0
29828,3187,-1000.00,-1000.00,0.00,240.68,759.32,0.31,0
29829,3188,1000.00,1000.00,2000.00,0.00,1000.00,0.30,1
29830,3188,-1000.00,0.00,1000.00,1453.25,0.00,0.04,0
29831,3188,1000.00,1000.00,2000.00,309.78,545.24,0.29,1
29832,3188,1000.00,2000.00,3000.00,0.00,2000.00,0.19,1
29833,3188,1000.00,3000.00,4000.00,1178.30,1821.70,0.30,1
29834,3188,1000.00,4000.00,5000.00,0.00,4000.00,0.18,1
29835,3188,1000.00,5000.00,6000.00,0.00,4236.21,0.20,1
29836,3188,1000.00,6000.00,7000.00,0.00,900.71,0.25,1
29837,3188,1000.00,7000.00,8000.00,0.00,7000.00,0.30,1
29838,3188,1000.00,8000.00,9000.00,0.00,3201.80,0.10,1
29839,3188,1000.00,9000.00,10000.00,3656.63,5343.37,0.05,1
29840,3188,1000.00,10000.00,11000.00,0.00,6268.19,0.06,1
29841,3188,-1000.00,9000.00,10000.00,6810.68,4189.32,0.42,0
29842,3188,1000.00,10000.00,11000.00,2479.25,7520.75,0.38,1
29843,3188,1000.00,11000.00,12000.00,0.00,8148.29,0.23,1
29844,3188,-1000.00,10000.00,11000.00,6595.93,5404.07,0.20,0
29845,3188,1000.00,11000.00,12000.00,896.63,5020.74,0.39,1
29846,3188,1000.00,12000.00,13000.00,4020.50,7979.50,0.22,1
29847,3188,1000.00,13000.00,14000.00,0.00,13000.00,0.43,1
29848,3188,1000.00,14000.00,15000.00,0.00,8807.47,0.26,1
29849,3188,1000.00,15000.00,16000.00,0.00,6619.65,0.12,1
29850,3188,1000.00,16000.00,17000.00,0.00,16000.00,0.15,1
29851,3188,1000.00,17000.00,18000.00,0.00,6965.80,0.34,1
29852,3188,1000.00,18000.00,19000.00,0.00,11098.21,0.39,1
29853,3188,1000.00,19000.00,20000.00,9500.00,9500.00,0.31,1
29854,3188,1000.00,20000.00,21000.00,0.00,12967.26,0.22,1
29855,3188,1000.00,21000.00,22000.00,0.00,21000.00,0.16,1
29856,3188,1000.00,22000.00,23000.00,0.00,10852.21,0.21,1
29857,3188,1000.00,23000.00,24000.00,0.00,23000.00,0.09,1
29858,3188,1000.00,24000.00,25000.00,0.00,24000.00,0.40,1
29859,3188,1000.00,25000.00,26000.00,3693.14,21306.86,0.13,1
29860,3188,1000.00,26000.00,27000.00,0.00,2810.49,0.14,1
29861,3188,1000.00,27000.00,28000.00,3914.68,23085.32,0.43,1
29862,3188,1000.00,28000.00,29000.00,12691.89,15308.11,0.16,1
29863,3188,1000.00,29000.00,30000.00,0.00,22799.12,0.00,1
29864,3188,-1000.00,28000.00,29000.00,17846.46,0.00,0.05,0
29865,3188,1000.00,29000.00,30000.00,0.00,29000.00,0.20,1
29866,3188,1000.00,30000.00,31000.00,0.00,26616.59,0.15,1
29867,3188,1000.00,31000.00,32000.00,15500.00,15500.00,0.38,1
29868,3188,1000.00,32000.00,33000.00,8293.54,23706.46,0.16,1
29869,3188,1000.00,33000.00,34000.00,16500.00,16500.00,0.40,1
29870,3188,1000.00,34000.00,35000.00,0.00,34000.00,0.08,1
29871,3188,1000.00,35000.00,36000.00,0.00,35000.00,0.25,1
29872,3189,1000.00,1000.00,2000.00,0.00,189.03,0.14,1
29873,3189,1000.00,2000.00,3000.00,702.44,1297.56,0.19,1
29874,3189,1000.00,3000.00,4000.00,470.44,1784.76,0.34,1
29875,3189,1000.00,4000.00,5000.00,441.53,3558.47,0.15,1
29876,3189,-1000.00,3000.00,4000.00,2117.88,1472.33,0.22,0
29877,3189,1000.00,4000.00,5000.00,0.00,3830.13,0.41,1
29878,3189,1000.00,5000.00,6000.00,0.00,5000.00,0.12,1
29879,3189,-1000.00,4000.00,5000.00,3083.79,2916.21,0.38,0
29880,3189,1000.00,5000.00,6000.00,539.46,4460.54,0.22,1
29881,3189,1000.00,6000.00,7000.00,3000.00,3000.00,0.02,1
29882,3189,1000.00,7000.00,8000.00,2194.58,4805.42,0.30,1
29883,3189,1000.00,8000.00,9000.00,3970.66,4029.34,0.07,1
29884,3189,-1000.00,7000.00,8000.00,6729.40,1107.92,0.14,0
29885,3189,1000.00,8000.00,9000.00,0.00,4574.83,0.25,1
29886,3189,1000.00,9000.00,10000.00,0.00,9000.00,0.40,1
29887,3189,1000.00,10000.00,11000.00,3338.52,6661.48,0.43,1
29888,3189,-1000.00,9000.00,10000.00,8432.86,2567.14,0.00,0
29889,3189,1000.00,10000.00,11000.00,0.00,10000.00,0.09,1
29890,3189,1000.00,11000.00,12000.00,0.00,9893.83,0.04,1
29891,3189,1000.00,12000.00,13000.00,6000.00,6000.00,0.16,1
29892,3189,1000.00,13000.00,14000.00,4876.45,8123.55,0.06,1
29893,3189,1000.00,14000.00,15000.00,0.00,11496.09,0.42,1
29894,3189,1000.00,15000.00,16000.00,6512.51,8487.49,0.22,1
29895,3189,0.00,15000.00,16000.00,0.00,0.00,0.02,0
29896,3189,-1000.00,14000.00,15000.00,9198.43,5266.67,0.15,0
29897,3189,1000.00,15000.00,16000.00,0.00,15000.00,0.07,1
29898,3189,1000.00,16000.00,17000.00,1585.57,14414.43,0.42,1
29899,3189,1000.00,17000.00,18000.00,2889.26,14110.74,0.42,1
29900,3189,1000.00,18000.00,19000.00,0.00,18000.00,0.32,1
29901,3189,1000.00,19000.00,20000.00,0.00,19000.00,0.37,1
29902,3189,-1000.00,18000.00,19000.00,10812.32,9187.68,0.20,0
29903,3189,1000.00,19000.00,20000.00,0.00,3125.08,0.17,1
29904,3189,1000.00,20000.00,21000.00,0.00,20000.00,0.20,1
29905,3189,1000.00,21000.00,22000.00,622.73,20377.27,0.44,1
29906,3189,1000.00,22000.00,23000.00,7337.99,14662.01,0.21,1
29907,3189,1000.00,23000.00,24000.00,2579.07,12665.92,0.33,1
29908,3189,1000.00,24000.00,25000.00,5722.79,18277.21,0.24,1
29909,3189,1000.00,25000.00,26000.00,6022.88,18977.12,0.39,1
29910,3189,1000.00,26000.00,27000.00,13000.00,13000.00,0.15,1
29911,3189,1000.00,27000.00,28000.00,8945.34,18054.66,0.32,1
29912,3189,1000.00,28000.00,29000.00,959.17,21167.94,0.41,1
29913,3189,1000.00,29000.00,30000.00,0.00,29000.00,0.00,1
29914,3189,1000.00,30000.00,31000.00,0.00,30000.00,0.24,1
29915,3189,1000.00,31000.00,32000.00,0.00,31000.00,0.36,1
29916,3189,-1000.00,30000.00,31000.00,5640.11,26359.89,0.18,0
29917,3189,-1000.00,29000.00,30000.00,3579.16,12613.38,0.27,0
29918,3189,-1000.00,28000.00,29000.00,19325.44,10674.56,0.06,0
29919,3189,-1000.00,27000.00,28000.00,13746.84,15253.16,0.23,0
29920,3189,-1000.00,26000.00,27000.00,15608.06,12391.94,0.16,0
29921,3189,-1000.00,25000.00,26000.00,1574.39,12901.50,0.30,0
29922,3189,-1000.00,24000.00,25000.00,20365.29,5634.71,0.01,0
29923,3189,-1000.00,23000.00,24000.00,0.00,16621.03,0.28,0
29924,3189,-1000.00,22000.00,23000.00,0.00,18231.44,0.35,0
29925,3189,-1000.00,21000.00,22000.00,0.00,18518.96,0.40,0
29926,3189,-1000.00,20000.00,21000.00,0.00,5305.20,0.13,0
29927,3189,-1000.00,19000.00,20000.00,0.00,21000.00,0.39,0
29928,3189,-1000.00,18000.00,19000.00,0.00,5979.57,0.17,0
29929,3189,-1000.00,17000.00,18000.00,0.00,19000.00,0.23,0
29930,3189,-1000.00,16000.00,17000.00,14421.44,3578.56,0.08,0
29931,3189,-1000.00,15000.00,16000.00,0.00,8071.94,0.17,0
29932,3189,-1000.00,14000.00,15000.00,0.00,16000.00,0.02,0
29933,3189,-1000.00,13000.00,14000.00,6232.50,8767.50,0.31,0
29934,3189,-1000.00,12000.00,13000.00,5085.61,8914.39,0.11,0
29935,3189,-1000.00,11000.00,12000.00,0.00,10721.15,0.12,0
29936,3189,-1000.00,10000.00,11000.00,0.00,10745.16,0.15,0
29937,3189,-1000.00,9000.00,10000.00,833.03,4868.65,0.29,0
29938,3189,-1000.00,8000.00,9000.00,0.00,10000.00,0.24,0
29939,3189,-1000.00,7000.00,8000.00,0.00,9000.00,0.33,0
29940,3190,0.00,0.00,1000.00,0.00,0.00,0.02,0
29941,3190,-1000.00,-1000.00,0.00,565.07,434.93,0.15,0
29942,3191,1000.00,1000.00,2000.00,113.01,886.99,0.39,1
29943,3191,1000.00,2000.00,3000.00,876.28,1123.72,0.10,1
29944,3191,1000.00,3000.00,4000.00,396.18,2603.82,0.16,1
29945,3191,1000.00,4000.00,5000.00,1153.38,2846.62,0.34,1
29946,3191,1000.00,5000.00,6000.00,0.00,5000.00,0.02,1
29947,3191,1000.00,6000.00,7000.00,0.00,2893.26,0.23,1
29948,3191,1000.00,7000.00,8000.00,3500.00,3500.00,0.08,1
29949,3191,1000.00,8000.00,9000.00,1559.55,6440.45,0.34,1
29950,3191,1000.00,9000.00,10000.00,0.00,1602.07,0.08,1
29951,3191,-1000.00,8000.00,9000.00,6654.78,3345.22,0.05,0
29952,3191,1000.00,9000.00,10000.00,778.96,8221.04,0.42,1
29953,3191,1000.00,10000.00,11000.00,2125.28,7874.72,0.03,1
29954,3191,1000.00,11000.00,12000.00,4544.83,6455.17,0.24,1
29955,3191,1000.00,12000.00,13000.00,0.00,3142.93,0.10,1
29956,3191,-1000.00,11000.00,12000.00,6960.02,6039.98,0.07,0
29957,3191,1000.00,12000.00,13000.00,0.00,12000.00,0.12,1
29958,3191,1000.00,13000.00,14000.00,0.00,7547.30,0.18,1
29959,3191,1000.00,14000.00,15000.00,2490.59,11509.41,0.32,1
29960,3191,1000.00,15000.00,16000.00,0.00,15000.00,0.37,1
29961,3191,1000.00,16000.00,17000.00,0.00,16000.00,0.44,1
29962,3191,-1000.00,15000.00,16000.00,11310.77,5689.23,0.16,0
29963,3191,-1000.00,14000.00,15000.00,6155.43,7651.43,0.25,0
29964,3191,-1000.00,13000.00,14000.00,0.00,11110.42,0.40,0
29965,3191,-1000.00,12000.00,13000.00,0.00,7406.31,0.20,0
29966,3191,-1000.00,11000.00,12000.00,4889.22,8110.78,0.31,0
29967,3191,-1000.00,10000.00,11000.00,0.00,12000.00,0.19,0
29968,3191,-1000.00,9000.00,10000.00,1758.06,0.00,0.04,0
29969,3191,-1000.00,8000.00,9000.00,1200.97,3733.78,0.25,0
29970,3191,-1000.00,7000.00,8000.00,0.00,6824.84,0.32,0
29971,3191,-1000.00,6000.00,7000.00,0.00,8000.00,0.08,0
29972,3191,-1000.00,5000.00,6000.00,3387.72,3612.28,0.42,0
29973,3191,-1000.00,4000.00,5000.00,0.00,4136.21,0.37,0
29974,3191,-1000.00,3000.00,4000.00,85.38,4604.57,0.44,0
29975,3191,-1000.00,2000.00,3000.00,271.06,3728.94,0.44,0
29976,3191,-1000.00,1000.00,2000.00,0.00,3000.00,0.18,0
29977,3191,-1000.00,0.00,1000.00,0.00,2000.00,0.19,0
29978,3191,-1000.00,-1000.00,0.00,524.26,475.74,0.18,0
29979,3192,-1000.00,-1000.00,0.00,35.45,284.87,0.24,0
29980,3193,-731.82,-731.82,268.18,327.32,404.51,0.23,0
29981,3193,-268.18,-1000.00,0.00,43.31,224.86,0.42,0
29982,3194,-1000.00,-1000.00,0.00,312.47,687.53,0.29,0
29983,3195,-1000.00,-1000.00,0.00,0.00,550.78,0.23,0
29984,3196,-1000.00,-1000.00,0.00,529.04,470.96,0.20,0
29985,3197,-1000.00,-1000.00,0.00,0.00,1000.00,0.10,0
29986,3198,-1000.00,-1000.00,0.00,0.00,1000.00,0.19,0
29987,3199,0.00,0.00,1000.00,0.00,0.00,0.07,0
29988,3199,-220.36,-220.36,779.64,0.00,220.36,0.12,0
29989,3199,-529.19,-749.55,250.45,128.01,401.17,0.14,0
29990,3199,-250.45,-1000.00,0.00,34.28,216.17,0.32,0
29991,3200,-770.08,-770.08,229.92,0.00,770.08,0.23,0
29992,3200,-229.92,-1000.00,0.00,43.10,186.81,0.41,0
29993,3201,1000.00,1000.00,2000.00,57.25,338.26,0.24,1
29994,3201,1000.00,2000.00,3000.00,720.55,1279.45,0.29,1
29995,3201,1000.00,3000.00,4000.00,136.68,2863.32,0.44,1
29996,3201,0.00,3000.00,4000.00,0.00,0.00,0.02,0
29997,3201,1000.00,4000.00,5000.00,1872.82,2127.18,0.24,1
29998,3201,1000.00,5000.00,6000.00,2500.00,2500.00,0.18,1
29999,3201,-1000.00,4000.00,5000.00,3317.00,2683.00,0.22,0
30000,3201,1000.00,5000.00,6000.00,0.00,4011.00,0.05,1
30001,3201,1000.00,6000.00,7000.00,2942.27,3057.73,0.18,1
30002,3201,-1000.00,5000.00,6000.00,3540.72,3450.50,0.22,0
30003,3201,1000.00,6000.00,7000.00,0.00,3621.78,0.13,1
30004,3201,1000.00,7000.00,8000.00,0.00,7000.00,0.08,1
30005,3201,1000.00,8000.00,9000.00,3552.71,4447.29,0.09,1
30006,3201,1000.00,9000.00,10000.00,0.00,9000.00,0.08,1
30007,3201,1000.00,10000.00,11000.00,0.00,10000.00,0.25,1
30008,3201,1000.00,11000.00,12000.00,0.00,10935.37,0.40,1
30009,3201,1000.00,12000.00,13000.00,4830.06,7169.94,0.21,1
30010,3201,-1000.00,11000.00,12000.00,7542.83,5457.17,0.39,0
30011,3201,0.00,11000.00,12000.00,0.00,0.00,0.05,0
30012,3201,1000.00,12000.00,13000.00,0.00,6854.59,0.04,1
30013,3201,-1000.00,11000.00,12000.00,1325.49,11674.51,0.28,0
30014,3201,-1000.00,10000.00,11000.00,2246.64,9753.36,0.41,0
30015,3201,-1000.00,9000.00,10000.00,2359.89,8640.11,0.25,0
30016,3201,-1000.00,8000.00,9000.00,1853.32,8146.68,0.41,0
30017,3201,-1000.00,7000.00,8000.00,0.00,9000.00,0.23,0
30018,3201,-1000.00,6000.00,7000.00,0.00,4155.60,0.31,0
30019,3201,-812.01,5187.99,6187.99,0.00,812.01,0.15,0
30020,3201,-1000.00,4187.99,5187.99,2161.47,4026.52,0.40,0
30021,3201,-1000.00,3187.99,4187.99,0.00,5187.99,0.44,0
30022,3201,-1000.00,2187.99,3187.99,0.00,4187.99,0.24,0
30023,3201,-1000.00,1187.99,2187.99,1007.46,2180.53,0.31,0
30024,3201,-1000.00,187.99,1187.99,903.64,1276.09,0.28,0
30025,3201,-1000.00,-812.01,187.99,603.92,584.07,0.02,0
30026,3201,-187.99,-1000.00,0.00,23.63,164.36,0.40,0
30027,3202,1000.00,1000.00,2000.00,385.78,44.12,0.36,1
30028,3202,1000.00,2000.00,3000.00,813.34,0.00,0.33,1
30029,3202,1000.00,3000.00,4000.00,1874.02,0.00,0.08,1
30030,3202,-1000.00,2000.00,3000.00,0.00,1891.22,0.33,0
30031,3202,-1000.00,1000.00,2000.00,1495.27,1504.73,0.15,0
30032,3202,1000.00,2000.00,3000.00,43.02,0.00,0.25,1
30033,3202,0.00,2000.00,3000.00,0.00,0.00,0.34,0
30034,3202,1000.00,3000.00,4000.00,2751.94,0.00,0.12,1
30035,3202,0.00,3000.00,4000.00,0.00,0.00,0.41,0
30036,3202,1000.00,4000.00,5000.00,429.91,343.33,0.43,1
30037,3202,0.00,4000.00,5000.00,0.00,0.00,0.05,0
30038,3202,-395.04,3604.96,4604.96,0.00,395.04,0.43,0
30039,3202,1000.00,4604.96,5604.96,3997.69,0.00,0.03,1
30040,3202,1000.00,5604.96,6604.96,2540.65,588.65,0.33,1
30041,3202,0.00,5604.96,6604.96,0.00,0.00,0.42,0
30042,3202,1000.00,6604.96,7604.96,2626.11,0.00,0.34,1
30043,3202,0.00,6604.96,7604.96,0.00,0.00,0.41,0
30044,3202,-1000.00,5604.96,6604.96,0.00,2401.34,0.02,0
30045,3202,1000.00,6604.96,7604.96,5658.84,946.12,0.01,1
30046,3202,1000.00,7604.96,8604.96,5161.01,0.00,0.23,1
30047,3202,0.00,7604.96,8604.96,0.00,0.00,0.17,0
30048,3202,-1000.00,6604.96,7604.96,0.00,122.81,0.29,0
30049,3202,-325.14,6279.82,7279.82,325.14,0.00,0.44,0
30050,3202,-1000.00,5279.82,6279.82,1195.93,0.00,0.38,0
30051,3202,-1000.00,4279.82,5279.82,972.01,1440.68,0.40,0
30052,3202,-1000.00,3279.82,4279.82,0.00,2389.08,0.29,0
30053,3202,0.00,3279.82,4279.82,0.00,0.00,0.33,0
30054,3202,-1000.00,2279.82,3279.82,0.00,3511.13,0.17,0
30055,3202,-1000.00,1279.82,2279.82,0.00,3279.82,0.01,0
30056,3202,-1000.00,279.82,1279.82,1141.30,1006.66,0.24,0
30057,3202,-1000.00,-720.18,279.82,0.00,1279.82,0.03,0
30058,3202,-263.86,-984.04,15.96,263.86,0.00,0.12,0
30059,3202,-1000.00,-1984.04,-984.04,4.73,8.09,0.31,0
30060,3203,1000.00,1000.00,2000.00,0.00,1000.00,0.40,1
30061,3203,-1000.00,0.00,1000.00,1026.67,245.34,0.11,0
30062,3203,1000.00,1000.00,2000.00,0.00,1000.00,0.21,1
30063,3203,-1000.00,0.00,1000.00,1496.59,0.00,0.05,0
30064,3203,1000.00,1000.00,2000.00,352.97,647.03,0.22,1
30065,3203,1000.00,2000.00,3000.00,286.09,1713.91,0.36,1
30066,3203,-1000.00,1000.00,2000.00,2550.42,449.58,0.01,0
30067,3203,1000.00,2000.00,3000.00,0.00,1321.51,0.38,1
30068,3203,-1000.00,1000.00,2000.00,2509.30,490.70,0.15,0
30069,3203,1000.00,2000.00,3000.00,414.06,996.65,0.29,1
30070,3203,1000.00,3000.00,4000.00,0.00,1464.74,0.28,1
30071,3203,1000.00,4000.00,5000.00,1562.59,2437.41,0.42,1
30072,3203,1000.00,5000.00,6000.00,0.00,5000.00,0.27,1
30073,3203,1000.00,6000.00,7000.00,0.00,4219.46,0.09,1
30074,3203,1000.00,7000.00,8000.00,1489.15,3979.64,0.32,1
30075,3203,1000.00,8000.00,9000.00,1415.90,6584.10,0.18,1
30076,3203,1000.00,9000.00,10000.00,0.00,289.01,0.07,1
30077,3203,1000.00,10000.00,11000.00,0.00,10000.00,0.16,1
30078,3203,1000.00,11000.00,12000.00,0.00,11000.00,0.22,1
30079,3203,1000.00,12000.00,13000.00,0.00,12000.00,0.15,1
30080,3203,0.00,12000.00,13000.00,0.00,0.00,0.00,0
30081,3203,1000.00,13000.00,14000.00,0.00,13000.00,0.34,1
30082,3203,-1000.00,12000.00,13000.00,7000.00,7000.00,0.05,0
30083,3203,-1000.00,11000.00,12000.00,0.00,7003.92,0.32,0
30084,3203,-1000.00,10000.00,11000.00,0.00,4640.57,0.07,0
30085,3203,-1000.00,9000.00,10000.00,0.00,9221.43,0.36,0
30086,3203,-1000.00,8000.00,9000.00,0.00,10000.00,0.03,0
30087,3203,-1000.00,7000.00,8000.00,4500.00,4500.00,0.15,0
30088,3203,-1000.00,6000.00,7000.00,0.00,8000.00,0.33,0
30089,3203,-1000.00,5000.00,6000.00,0.00,3730.40,0.12,0
30090,3203,-1000.00,4000.00,5000.00,0.00,6000.00,0.23,0
30091,3203,-1000.00,3000.00,4000.00,0.00,4400.07,0.36,0
30092,3203,-1000.00,2000.00,3000.00,1348.16,2651.84,0.11,0
30093,3203,-1000.00,1000.00,2000.00,975.31,2024.69,0.26,0
30094,3203,-1000.00,0.00,1000.00,1029.94,970.06,0.19,0
30095,3203,-1000.00,-1000.00,0.00,0.00,1000.00,0.37,0
30096,3204,-447.00,-447.00,553.00,447.00,0.00,0.30,0
30097,3204,-553.00,-1000.00,0.00,311.40,241.61,0.06,0
30098,3205,1000.00,1000.00,2000.00,0.00,383.41,0.22,1
30099,3205,1000.00,2000.00,3000.00,369.48,1630.52,0.41,1
30100,3205,1000.00,3000.00,4000.00,582.20,2417.80,0.40,1
30101,3205,1000.00,4000.00,5000.00,468.02,3531.98,0.41,1
30102,3205,1000.00,5000.00,6000.00,2187.21,2812.79,0.32,1
30103,3205,1000.00,6000.00,7000.00,0.00,4239.26,0.27,1
30104,3205,1000.00,7000.00,8000.00,0.00,3713.68,0.22,1
30105,3205,1000.00,8000.00,9000.00,1305.16,6694.84,0.07,1
30106,3205,1000.00,9000.00,10000.00,2003.49,6996.51,0.26,1
30107,3205,1000.00,10000.00,11000.00,0.00,1499.65,0.13,1
30108,3205,1000.00,11000.00,12000.00,1985.87,8387.97,0.39,1
30109,3205,1000.00,12000.00,13000.00,5380.86,6619.14,0.18,1
30110,3205,-1000.00,11000.00,12000.00,7342.88,5657.12,0.13,0
30111,3205,1000.00,12000.00,13000.00,0.00,4552.78,0.04,1
30112,3205,1000.00,13000.00,14000.00,2935.90,10064.10,0.39,1
30113,3205,1000.00,14000.00,15000.00,0.00,14000.00,0.30,1
30114,3205,1000.00,15000.00,16000.00,4652.06,10347.94,0.33,1
30115,3205,1000.00,16000.00,17000.00,5794.15,10205.85,0.04,1
30116,3205,-1000.00,15000.00,16000.00,3885.24,1033.76,0.12,0
30117,3205,1000.00,16000.00,17000.00,8000.00,8000.00,0.32,1
30118,3205,1000.00,17000.00,18000.00,0.00,17000.00,0.24,1
30119,3205,1000.00,18000.00,19000.00,7754.86,10245.14,0.22,1
30120,3205,-1000.00,17000.00,18000.00,5740.67,7101.29,0.13,0
30121,3205,-1000.00,16000.00,17000.00,0.00,6855.02,0.25,0
30122,3205,-1000.00,15000.00,16000.00,0.00,8071.97,0.28,0
30123,3205,-1000.00,14000.00,15000.00,9765.52,0.00,0.06,0
30124,3205,-1000.00,13000.00,14000.00,1652.21,12132.37,0.42,0
30125,3205,-1000.00,12000.00,13000.00,5100.28,8899.72,0.32,0
30126,3205,-1000.00,11000.00,12000.00,0.00,13000.00,0.24,0
30127,3205,-1000.00,10000.00,11000.00,9454.39,2545.61,0.00,0
30128,3205,-1000.00,9000.00,10000.00,0.00,3286.66,0.16,0
30129,3205,-1000.00,8000.00,9000.00,4391.56,5608.44,0.08,0
30130,3205,-1000.00,7000.00,8000.00,0.00,9000.00,0.07,0
30131,3205,-1000.00,6000.00,7000.00,2416.89,1924.44,0.17,0
30132,3205,-1000.00,5000.00,6000.00,1119.72,5880.28,0.42,0
30133,3205,-1000.00,4000.00,5000.00,2387.23,3612.77,0.12,0
30134,3205,-1000.00,3000.00,4000.00,3121.37,1878.63,0.07,0
30135,3205,-1000.00,2000.00,3000.00,0.00,4000.00,0.34,0
30136,3205,-1000.00,1000.00,2000.00,0.00,3000.00,0.02,0
30137,3205,-1000.00,0.00,1000.00,0.00,2000.00,0.43,0
30138,3205,-1000.00,-1000.00,0.00,55.15,944.85,0.30,0
30139,3206,-1000.00,-1000.00,0.00,434.72,329.45,0.18,0
30140,3207,-1000.00,-1000.00,0.00,0.00,1000.00,0.04,0
30141,3208,-695.25,-695.25,304.75,0.00,695.25,0.38,0
30142,3208,-304.75,-1000.00,0.00,123.65,181.10,0.19,0
30143,3209,-1000.00,-1000.00,0.00,0.00,1000.00,0.19,0
30144,3210,-1000.00,-1000.00,0.00,263.32,736.68,0.29,0
30145,3211,-1000.00,-1000.00,0.00,0.00,1000.00,0.28,0
30146,3212,-753.55,-753.55,246.45,244.90,508.65,0.29,0
30147,3212,-126.66,-880.21,119.79,0.00,126.66,0.31,0
30148,3212,-119.79,-1000.00,0.00,55.64,64.15,0.06,0
30149,3213,-1000.00,-1000.00,0.00,55.51,944.49,0.38,0
30150,3214,-508.20,-508.20,491.80,29.08,479.12,0.32,0
30151,3214,-293.53,-801.73,198.27,0.00,293.53,0.36,0
30152,3214,-198.27,-1000.00,0.00,0.00,198.27,0.01,0
30153,3215,-697.08,-697.08,302.92,116.19,580.89,0.36,0
30154,3215,1000.00,302.92,1302.92,160.09,142.83,0.16,1
30155,3215,-1000.00,-697.08,302.92,0.00,1302.92,0.05,0
30156,3215,1000.00,302.92,1302.92,177.78,125.15,0.03,1
30157,3215,-992.70,-689.78,310.22,0.00,992.70,0.33,0
30158,3215,1000.00,310.22,1310.22,161.74,0.00,0.24,1
30159,3215,0.00,310.22,1310.22,0.00,0.00,0.06,0
30160,3215,1000.00,1310.22,2310.22,999.04,311.18,0.08,1
30161,3215,-1000.00,310.22,1310.22,0.00,1819.33,0.03,0
30162,3215,-1000.00,-689.78,310.22,417.00,893.22,0.04,0
30163,3215,-166.44,-856.22,143.78,0.00,166.44,0.02,0
30164,3215,0.00,-856.22,143.78,0.00,0.00,0.01,0
30165,3215,0.00,-856.22,143.78,0.00,0.00,0.10,0
30166,3215,1000.00,143.78,1143.78,101.98,41.80,0.10,1
30167,3215,1000.00,1143.78,2143.78,300.50,0.00,0.19,1
30168,3215,-1000.00,143.78,1143.78,698.36,1230.65,0.34,0
30169,3215,-1000.00,-856.22,143.78,425.52,718.26,0.29,0
30170,3215,-143.78,-1000.00,0.00,71.35,72.43,0.07,0
30171,3216,-174.62,-174.62,825.38,0.00,174.62,0.10,0
30172,3216,-64.42,-239.04,760.96,0.00,64.42,0.13,0
30173,3216,-760.96,-1000.00,-0.00,217.27,543.69,0.36,0
30174,3217,-1000.00,-1000.00,0.00,343.22,656.78,0.32,0
30175,3218,-1000.00,-1000.00,0.00,302.19,497.51,0.27,0
30176,3219,-1000.00,-1000.00,0.00,116.00,163.62,0.17,0
30177,3220,-1000.00,-1000.00,0.00,477.49,522.51,0.24,0
30178,3221,-1000.00,-1000.00,0.00,356.28,643.72,0.12,0
30179,3222,-1000.00,-1000.00,0.00,812.27,187.73,0.14,0
30180,3223,-1000.00,-1000.00,0.00,211.84,244.84,0.19,0
30181,3224,1000.00,1000.00,2000.00,0.00,1000.00,0.23,1
30182,3224,1000.00,2000.00,3000.00,186.45,1813.55,0.39,1
30183,3224,-1000.00,1000.00,2000.00,1258.58,0.00,0.00,0
30184,3224,1000.00,2000.00,3000.00,0.00,2000.00,0.16,1
30185,3224,1000.00,3000.00,4000.00,0.00,2404.72,0.41,1
30186,3224,1000.00,4000.00,5000.00,0.00,2921.48,0.16,1
30187,3224,1000.00,5000.00,6000.00,0.00,5000.00,0.17,1
30188,3224,0.00,5000.00,6000.00,0.00,0.00,0.01,0
30189,3224,-1000.00,4000.00,5000.00,3528.87,2471.13,0.13,0
30190,3224,1000.00,5000.00,6000.00,1132.78,3867.22,0.23,1
30191,3224,0.00,5000.00,6000.00,0.00,0.00,0.01,0
30192,3224,1000.00,6000.00,7000.00,0.00,6000.00,0.38,1
30193,3224,1000.00,7000.00,8000.00,3500.00,3500.00,0.00,1
30194,3224,1000.00,8000.00,9000.00,4000.00,4000.00,0.03,1
30195,3224,1000.00,9000.00,10000.00,3514.52,5485.48,0.25,1
30196,3224,1000.00,10000.00,11000.00,0.00,10000.00,0.21,1
30197,3224,1000.00,11000.00,12000.00,0.00,11000.00,0.13,1
30198,3224,1000.00,12000.00,13000.00,0.00,12000.00,0.05,1
30199,3224,-1000.00,11000.00,12000.00,7406.41,5593.59,0.15,0
30200,3224,1000.00,12000.00,13000.00,0.00,8501.01,0.21,1
30201,3224,1000.00,13000.00,14000.00,4713.87,8286.13,0.16,1
30202,3224,1000.00,14000.00,15000.00,4791.35,9208.65,0.40,1
30203,3224,1000.00,15000.00,16000.00,0.00,7149.33,0.15,1
30204,3224,1000.00,16000.00,17000.00,4053.38,11946.62,0.07,1
30205,3224,-1000.00,15000.00,16000.00,8818.92,8181.08,0.42,0
30206,3224,1000.00,16000.00,17000.00,1095.03,14904.97,0.29,1
30207,3224,1000.00,17000.00,18000.00,0.00,17000.00,0.38,1
30208,3224,1000.00,18000.00,19000.00,8632.40,9367.60,0.15,1
30209,3224,1000.00,19000.00,20000.00,4846.64,14153.36,0.20,1
30210,3224,-1000.00,18000.00,19000.00,5128.55,4777.10,0.18,0
30211,3224,1000.00,19000.00,20000.00,1872.41,15860.81,0.42,1
30212,3224,1000.00,20000.00,21000.00,520.20,19479.80,0.44,1
30213,3224,-1000.00,19000.00,20000.00,18574.84,2425.16,0.06,0
30214,3224,1000.00,20000.00,21000.00,1610.48,18389.52,0.13,1
30215,3224,1000.00,21000.00,22000.00,0.00,21000.00,0.01,1
30216,3224,1000.00,22000.00,23000.00,10162.92,11837.08,0.20,1
30217,3224,1000.00,23000.00,24000.00,0.00,20821.00,0.22,1
30218,3224,1000.00,24000.00,25000.00,0.00,24000.00,0.42,1
30219,3224,1000.00,25000.00,26000.00,256.47,24743.53,0.36,1
30220,3224,1000.00,26000.00,27000.00,0.00,12017.68,0.02,1
30221,3224,1000.00,27000.00,28000.00,5064.60,21935.40,0.40,1
30222,3225,-1000.00,-1000.00,0.00,410.20,589.80,0.28,0
30223,3226,1000.00,1000.00,2000.00,0.00,1000.00,0.19,1
30224,3226,1000.00,2000.00,3000.00,0.00,2000.00,0.24,1
30225,3226,1000.00,3000.00,4000.00,1251.66,1748.34,0.14,1
30226,3226,-1000.00,2000.00,3000.00,1914.65,0.00,0.00,0
30227,3226,1000.00,3000.00,4000.00,0.00,1277.69,0.26,1
30228,3226,1000.00,4000.00,5000.00,1692.58,2307.42,0.39,1
30229,3226,1000.00,5000.00,6000.00,2463.59,2536.41,0.00,1
30230,3226,1000.00,6000.00,7000.00,0.00,2903.87,0.24,1
30231,3226,-1000.00,5000.00,6000.00,4330.36,2669.64,0.33,0
30232,3226,1000.00,6000.00,7000.00,0.00,5125.55,0.43,1
30233,3226,-1000.00,5000.00,6000.00,3741.19,3258.81,0.11,0
30234,3226,1000.00,6000.00,7000.00,0.00,6000.00,0.23,1
30235,3226,1000.00,7000.00,8000.00,0.00,5919.23,0.02,1
30236,3226,1000.00,8000.00,9000.00,2721.52,5278.48,0.24,1
30237,3226,1000.00,9000.00,10000.00,1504.19,7495.81,0.06,1
30238,3226,-1000.00,8000.00,9000.00,4939.25,2525.96,0.15,0
30239,3226,1000.00,9000.00,10000.00,4500.00,4500.00,0.04,1
30240,3226,1000.00,10000.00,11000.00,148.57,9851.43,0.30,1
30241,3226,1000.00,11000.00,12000.00,3555.59,7444.41,0.30,1
30242,3226,1000.00,12000.00,13000.00,5034.59,6965.41,0.22,1
30243,3226,1000.00,13000.00,14000.00,0.00,13000.00,0.28,1
30244,3226,1000.00,14000.00,15000.00,5400.90,7151.64,0.28,1
30245,3226,0.00,14000.00,15000.00,0.00,0.00,0.02,0
30246,3226,1000.00,15000.00,16000.00,0.00,15000.00,0.04,1
30247,3226,1000.00,16000.00,17000.00,0.00,16000.00,0.08,1
30248,3226,1000.00,17000.00,18000.00,0.00,17000.00,0.10,1
30249,3226,1000.00,18000.00,19000.00,0.00,18000.00,0.30,1
30250,3226,1000.00,19000.00,20000.00,9500.00,9500.00,0.00,1
30251,3226,1000.00,20000.00,21000.00,9600.79,10399.21,0.23,1
30252,3226,1000.00,21000.00,22000.00,2610.26,11192.55,0.32,1
30253,3226,1000.00,22000.00,23000.00,0.00,22000.00,0.24,1
30254,3226,-1000.00,21000.00,22000.00,13201.03,9798.97,0.13,0
30255,3226,1000.00,22000.00,23000.00,8187.21,13812.79,0.29,1
30256,3226,1000.00,23000.00,24000.00,10648.47,12351.53,0.19,1
30257,3226,1000.00,24000.00,25000.00,12000.00,12000.00,0.38,1
30258,3226,1000.00,25000.00,26000.00,0.00,21655.56,0.40,1
30259,3226,1000.00,26000.00,27000.00,12552.20,13447.80,0.13,1
30260,3226,1000.00,27000.00,28000.00,10220.68,16779.32,0.39,1
30261,3226,1000.00,28000.00,29000.00,14000.00,14000.00,0.05,1
30262,3226,-1000.00,27000.00,28000.00,15656.64,13343.36,0.10,0
30263,3226,1000.00,28000.00,29000.00,0.00,26275.76,0.44,1
30264,3227,1000.00,1000.00,2000.00,0.00,1000.00,0.36,1
30265,3227,0.00,1000.00,2000.00,0.00,0.00,0.06,0
30266,3227,1000.00,2000.00,3000.00,501.78,1498.22,0.28,1
30267,3227,1000.00,3000.00,4000.00,1500.00,1500.00,0.03,1
30268,3227,1000.00,4000.00,5000.00,0.00,4000.00,0.29,1
30269,3227,-1000.00,3000.00,4000.00,2728.12,2271.88,0.18,0
30270,3227,-1000.00,2000.00,3000.00,2103.66,0.00,0.03,0
30271,3227,1000.00,3000.00,4000.00,0.00,2859.44,0.44,1
30272,3227,1000.00,4000.00,5000.00,415.22,3584.78,0.35,1
30273,3227,1000.00,5000.00,6000.00,0.00,3298.46,0.03,1
30274,3227,1000.00,6000.00,7000.00,0.00,6000.00,0.29,1
30275,3227,1000.00,7000.00,8000.00,3247.78,3752.22,0.02,1
30276,3227,1000.00,8000.00,9000.00,3770.07,4229.93,0.09,1
30277,3227,1000.00,9000.00,10000.00,0.00,6244.39,0.22,1
30278,3227,1000.00,10000.00,11000.00,1122.64,8877.36,0.38,1
30279,3227,1000.00,11000.00,12000.00,0.00,6826.39,0.11,1
30280,3227,1000.00,12000.00,13000.00,0.00,6121.47,0.26,1
30281,3227,-1000.00,11000.00,12000.00,7254.88,5745.12,0.28,0
30282,3227,-1000.00,10000.00,11000.00,11956.83,0.00,0.02,0
30283,3227,1000.00,11000.00,12000.00,2719.24,8280.76,0.22,1
30284,3227,1000.00,12000.00,13000.00,0.00,12000.00,0.24,1
30285,3227,1000.00,13000.00,14000.00,205.39,10373.58,0.42,1
30286,3227,1000.00,14000.00,15000.00,0.00,13890.45,0.41,1
30287,3227,1000.00,15000.00,16000.00,5111.81,9888.19,0.04,1
30288,3227,1000.00,16000.00,17000.00,0.00,15838.04,0.31,1
30289,3227,1000.00,17000.00,18000.00,593.93,8456.43,0.31,1
30290,3227,-1000.00,16000.00,17000.00,9310.78,8689.22,0.15,0
30291,3227,1000.00,17000.00,18000.00,0.00,17000.00,0.10,1
30292,3227,1000.00,18000.00,19000.00,0.00,18000.00,0.09,1
30293,3227,1000.00,19000.00,20000.00,9327.16,9672.84,0.44,1
30294,3227,1000.00,20000.00,21000.00,4584.99,15415.01,0.29,1
30295,3227,-1000.00,19000.00,20000.00,11148.29,0.00,0.08,0
30296,3227,1000.00,20000.00,21000.00,0.00,15619.11,0.40,1
30297,3227,1000.00,21000.00,22000.00,0.00,21000.00,0.35,1
30298,3227,-1000.00,20000.00,21000.00,13412.12,4205.88,0.11,0
30299,3227,1000.00,21000.00,22000.00,4545.74,13747.63,0.35,1
30300,3227,1000.00,22000.00,23000.00,4872.53,17127.47,0.40,1
30301,3227,1000.00,23000.00,24000.00,0.00,9504.70,0.24,1
30302,3227,1000.00,24000.00,25000.00,0.00,24000.00,0.20,1
30303,3227,-1000.00,23000.00,24000.00,15079.35,9920.65,0.08,0
30304,3227,1000.00,24000.00,25000.00,0.00,12070.90,0.31,1
30305,3228,-1000.00,-1000.00,0.00,411.00,589.00,0.03,0
30306,3229,-198.17,-198.17,801.83,0.00,198.17,0.12,0
30307,3229,-801.83,-1000.00,0.00,0.00,801.83,0.18,0
30308,3230,-1000.00,-1000.00,0.00,0.00,808.19,0.05,0
30309,3231,-1000.00,-1000.00,0.00,0.00,1000.00,0.33,0
30310,3232,-1000.00,-1000.00,0.00,0.00,1000.00,0.40,0
30311,3233,1000.00,1000.00,2000.00,0.00,887.14,0.30,1
30312,3233,1000.00,2000.00,3000.00,494.85,1505.15,0.27,1
30313,3233,-1000.00,1000.00,2000.00,3000.00,0.00,0.00,0
30314,3233,1000.00,2000.00,3000.00,41.28,1585.39,0.43,1
30315,3233,1000.00,3000.00,4000.00,140.68,2859.32,0.35,1
30316,3233,1000.00,4000.00,5000.00,1544.16,2455.84,0.31,1
30317,3233,1000.00,5000.00,6000.00,0.00,4010.94,0.36,1
30318,3233,-131.53,4868.47,5868.47,131.53,0.00,0.10,0
30319,3233,1000.00,5868.47,6868.47,0.00,606.74,0.06,1
30320,3233,1000.00,6868.47,7868.47,0.00,6868.47,0.38,1
30321,3233,1000.00,7868.47,8868.47,3799.09,4069.38,0.15,1
30322,3233,1000.00,8868.47,9868.47,2039.44,6829.03,0.38,1
30323,3233,-1000.00,7868.47,8868.47,6066.50,1176.74,0.09,0
30324,3233,1000.00,8868.47,9868.47,1240.84,2636.84,0.22,1
30325,3233,1000.00,9868.47,10868.47,4267.04,5601.43,0.28,1
30326,3233,1000.00,10868.47,11868.47,4314.79,6553.68,0.28,1
30327,3233,1000.00,11868.47,12868.47,1851.67,10016.80,0.31,1
30328,3233,1000.00,12868.47,13868.47,0.00,12868.47,0.18,1
30329,3233,1000.00,13868.47,14868.47,4403.07,9465.40,0.07,1
30330,3233,1000.00,14868.47,15868.47,0.00,14868.47,0.20,1
30331,3233,1000.00,15868.47,16868.47,3363.71,12504.75,0.39,1
30332,3233,1000.00,16868.47,17868.47,0.00,16868.47,0.14,1
30333,3233,-1000.00,15868.47,16868.47,9446.16,8422.31,0.19,0
30334,3233,1000.00,16868.47,17868.47,0.00,6989.68,0.25,1
30335,3233,-1000.00,15868.47,16868.47,0.00,11797.17,0.37,0
30336,3233,-1000.00,14868.47,15868.47,8434.23,8434.23,0.07,0
30337,3233,-1000.00,13868.47,14868.47,372.17,9881.94,0.36,0
30338,3233,-1000.00,12868.47,13868.47,4788.15,6495.39,0.25,0
30339,3233,-1000.00,11868.47,12868.47,0.00,5880.45,0.21,0
30340,3233,-1000.00,10868.47,11868.47,7442.51,5425.96,0.18,0
30341,3233,-1000.00,9868.47,10868.47,0.00,11868.47,0.29,0
30342,3233,-1000.00,8868.47,9868.47,3681.78,6641.33,0.32,0
30343,3233,-1000.00,7868.47,8868.47,4934.23,4934.23,0.07,0
30344,3233,-1000.00,6868.47,7868.47,0.00,8868.47,0.42,0
30345,3233,-1000.00,5868.47,6868.47,3239.63,3040.45,0.22,0
30346,3233,-1000.00,4868.47,5868.47,0.00,6868.47,0.09,0
30347,3233,-1000.00,3868.47,4868.47,2211.96,3656.51,0.18,0
30348,3233,0.00,3868.47,4868.47,0.00,0.00,0.04,0
30349,3233,0.00,3868.47,4868.47,0.00,0.00,0.26,0
30350,3233,-1000.00,2868.47,3868.47,0.00,4868.47,0.34,0
30351,3233,-1000.00,1868.47,2868.47,496.17,1948.67,0.41,0
30352,3233,0.00,1868.47,2868.47,0.00,0.00,0.24,0
30353,3233,1000.00,2868.47,3868.47,637.77,95.72,0.41,1
30354,3234,0.00,0.00,1000.00,0.00,0.00,0.01,0
30355,3234,-362.63,-362.63,637.37,0.00,362.63,0.22,0
30356,3234,-637.37,-1000.00,0.00,264.31,373.06,0.19,0
30357,3235,-950.52,-950.52,49.48,624.68,325.84,0.14,0
30358,3235,1000.00,49.48,1049.48,0.00,22.22,0.29,1
30359,3235,1000.00,1049.48,2049.48,0.00,874.94,0.33,1
30360,3235,1000.00,2049.48,3049.48,313.18,1092.68,0.32,1
30361,3235,1000.00,3049.48,4049.48,1465.11,1584.37,0.08,1
30362,3235,1000.00,4049.48,5049.48,1914.33,2135.15,0.14,1
30363,3235,1000.00,5049.48,6049.48,2417.90,2631.58,0.15,1
30364,3235,1000.00,6049.48,7049.48,0.00,5241.88,0.16,1
30365,3235,-1000.00,5049.48,6049.48,4231.40,2818.08,0.06,0
30366,3235,1000.00,6049.48,7049.48,1298.49,3774.03,0.35,1
30367,3235,1000.00,7049.48,8049.48,3524.74,3524.74,0.08,1
30368,3235,-1000.00,6049.48,7049.48,4489.50,3559.98,0.42,0
30369,3235,-1000.00,5049.48,6049.48,2927.15,2232.72,0.18,0
30370,3235,1000.00,6049.48,7049.48,0.00,6049.48,0.17,1
30371,3235,-1000.00,5049.48,6049.48,2116.61,0.00,0.09,0
30372,3235,1000.00,6049.48,7049.48,0.00,6049.48,0.35,1
30373,3235,-1000.00,5049.48,6049.48,4777.59,2271.89,0.09,0
30374,3235,1000.00,6049.48,7049.48,0.00,6049.48,0.07,1
30375,3235,1000.00,7049.48,8049.48,0.00,7049.48,0.25,1
30376,3235,-1000.00,6049.48,7049.48,7986.69,0.00,0.03,0
30377,3235,1000.00,7049.48,8049.48,2635.31,4414.17,0.27,1
30378,3235,1000.00,8049.48,9049.48,4024.74,4024.74,0.21,1
30379,3235,-1000.00,7049.48,8049.48,7255.69,1793.79,0.10,0
30380,3235,-1000.00,6049.48,7049.48,4979.36,0.00,0.04,0
30381,3235,1000.00,7049.48,8049.48,0.00,7049.48,0.05,1
30382,3235,-1000.00,6049.48,7049.48,4141.38,3908.10,0.19,0
30383,3235,1000.00,7049.48,8049.48,0.00,4520.68,0.00,1
30384,3235,1000.00,8049.48,9049.48,3877.95,4171.53,0.15,1
30385,3235,1000.00,9049.48,10049.48,0.00,8360.45,0.33,1
30386,3235,1000.00,10049.48,11049.48,4303.75,5745.73,0.35,1
30387,3235,1000.00,11049.48,12049.48,0.00,2515.44,0.19,1
30388,3235,1000.00,12049.48,13049.48,4441.54,7607.94,0.35,1
30389,3235,1000.00,13049.48,14049.48,0.00,13049.48,0.16,1
30390,3235,1000.00,14049.48,15049.48,0.00,14049.48,0.17,1
30391,3235,1000.00,15049.48,16049.48,7524.74,7524.74,0.03,1
30392,3235,-1000.00,14049.48,15049.48,8237.43,7812.05,0.12,0
30393,3235,1000.00,15049.48,16049.48,1659.11,13390.37,0.31,1
30394,3235,1000.00,16049.48,17049.48,0.00,11731.73,0.26,1
30395,3235,1000.00,17049.48,18049.48,6813.90,10235.58,0.24,1
30396,3235,1000.00,18049.48,19049.48,0.00,10588.38,0.12,1
30397,3235,-929.98,17119.50,18119.50,929.98,0.00,0.07,0
30398,3235,1000.00,18119.50,19119.50,0.00,17664.65,0.44,1
30399,3235,1000.00,19119.50,20119.50,0.00,19119.50,0.08,1
30400,3235,-1000.00,18119.50,19119.50,10216.59,9902.90,0.15,0
30401,3235,1000.00,19119.50,20119.50,6015.20,8524.67,0.25,1
30402,3235,1000.00,20119.50,21119.50,6349.12,13770.38,0.22,1
30403,3236,-1000.00,-1000.00,0.00,279.54,720.46,0.18,0
30404,3237,-1000.00,-1000.00,0.00,1000.00,0.00,0.00,0
30405,3238,-1000.00,-1000.00,0.00,0.00,1000.00,0.15,0
30406,3239,-1000.00,-1000.00,0.00,344.10,655.90,0.24,0
30407,3240,-1000.00,-1000.00,0.00,317.20,682.80,0.34,0
30408,3241,1000.00,1000.00,2000.00,178.93,821.07,0.40,1
30409,3241,1000.00,2000.00,3000.00,417.29,1582.71,0.33,1
30410,3241,-1000.00,1000.00,2000.00,772.73,246.82,0.13,0
30411,3241,1000.00,2000.00,3000.00,853.24,1146.76,0.23,1
30412,3241,1000.00,3000.00,4000.00,0.00,1864.37,0.11,1
30413,3241,1000.00,4000.00,5000.00,0.00,2683.65,0.31,1
30414,3241,1000.00,5000.00,6000.00,1824.39,3175.61,0.23,1
30415,3241,1000.00,6000.00,7000.00,1359.60,4640.40,0.39,1
30416,3241,1000.00,7000.00,8000.00,0.00,5780.91,0.37,1
30417,3241,1000.00,8000.00,9000.00,735.22,7264.78,0.43,1
30418,3241,1000.00,9000.00,10000.00,3743.80,5256.20,0.04,1
30419,3241,1000.00,10000.00,11000.00,0.00,6154.74,0.25,1
30420,3241,-1000.00,9000.00,10000.00,7686.19,3313.81,0.08,0
30421,3241,1000.00,10000.00,11000.00,1417.75,2299.65,0.19,1
30422,3241,1000.00,11000.00,12000.00,0.00,11000.00,0.25,1
30423,3241,1000.00,12000.00,13000.00,4347.17,7383.18,0.30,1
30424,3241,-1000.00,11000.00,12000.00,8372.06,897.48,0.13,0
30425,3241,-1000.00,10000.00,11000.00,2646.73,2305.07,0.17,0
30426,3241,1000.00,11000.00,12000.00,0.00,6753.53,0.25,1
30427,3241,1000.00,12000.00,13000.00,3164.31,8835.69,0.25,1
30428,3241,1000.00,13000.00,14000.00,0.00,13000.00,0.12,1
30429,3241,1000.00,14000.00,15000.00,0.00,11514.50,0.14,1
30430,3241,1000.00,15000.00,16000.00,0.00,15000.00,0.35,1
30431,3241,1000.00,16000.00,17000.00,1267.23,14732.77,0.40,1
30432,3241,-1000.00,15000.00,16000.00,8500.00,8500.00,0.09,0
30433,3241,-1000.00,14000.00,15000.00,5597.22,10402.78,0.11,0
30434,3241,-1000.00,13000.00,14000.00,3072.39,11927.61,0.41,0
30435,3241,-1000.00,12000.00,13000.00,2714.56,11285.44,0.31,0
30436,3241,-1000.00,11000.00,12000.00,0.00,13000.00,0.38,0
30437,3241,-1000.00,10000.00,11000.00,0.00,11636.24,0.19,0
30438,3241,-1000.00,9000.00,10000.00,7494.47,3505.53,0.12,0
30439,3241,-1000.00,8000.00,9000.00,3648.25,6351.75,0.29,0
30440,3241,-1000.00,7000.00,8000.00,0.00,9000.00,0.34,0
30441,3241,-1000.00,6000.00,7000.00,0.00,8000.00,0.36,0
30442,3241,-1000.00,5000.00,6000.00,981.00,6019.00,0.43,0
30443,3241,-1000.00,4000.00,5000.00,2742.79,3257.21,0.07,0
30444,3241,-1000.00,3000.00,4000.00,0.00,5000.00,0.28,0
30445,3241,-1000.00,2000.00,3000.00,47.28,3952.72,0.25,0
30446,3241,-1000.00,1000.00,2000.00,1400.53,1599.47,0.21,0
30447,3241,-1000.00,0.00,1000.00,453.98,783.71,0.25,0
30448,3241,-1000.00,-1000.00,0.00,39.10,960.90,0.39,0
30449,3242,1000.00,1000.00,2000.00,513.51,486.49,0.22,1
30450,3242,-1000.00,0.00,1000.00,344.46,1427.06,0.41,0
30451,3242,1000.00,1000.00,2000.00,514.56,485.44,0.21,1
30452,3242,-1000.00,0.00,1000.00,0.00,2000.00,0.35,0
30453,3242,-804.63,-804.63,195.37,0.00,804.63,0.37,0
30454,3242,-64.55,-869.18,130.82,29.02,35.53,0.20,0
30455,3242,-66.45,-935.63,64.37,0.00,66.45,0.14,0
30456,3242,0.00,-935.63,64.37,0.00,0.00,0.07,0
30457,3242,-64.37,-1000.00,0.00,26.30,38.08,0.18,0
30458,3243,-1000.00,-1000.00,0.00,113.50,649.13,0.43,0
30459,3244,-1000.00,-1000.00,0.00,255.85,744.15,0.19,0
30460,3245,1000.00,1000.00,2000.00,15.58,486.07,0.31,1
30461,3245,1000.00,2000.00,3000.00,722.55,1277.45,0.05,1
30462,3245,1000.00,3000.00,4000.00,0.00,2429.62,0.40,1
30463,3245,1000.00,4000.00,5000.00,1584.53,2415.47,0.37,1
30464,3245,1000.00,5000.00,6000.00,0.00,5000.00,0.11,1
30465,3245,1000.00,6000.00,7000.00,2385.76,3614.24,0.35,1
30466,3245,1000.00,7000.00,8000.00,2066.54,4933.46,0.32,1
30467,3245,1000.00,8000.00,9000.00,3673.43,4326.57,0.16,1
30468,3245,1000.00,9000.00,10000.00,0.00,9000.00,0.31,1
30469,3245,1000.00,10000.00,11000.00,2002.73,7757.92,0.39,1
30470,3245,1000.00,11000.00,12000.00,2890.18,7422.96,0.35,1
30471,3245,1000.00,12000.00,13000.00,1032.61,10967.39,0.44,1
30472,3245,1000.00,13000.00,14000.00,4333.44,8666.56,0.31,1
30473,3245,1000.00,14000.00,15000.00,3746.81,10253.19,0.23,1
30474,3245,1000.00,15000.00,16000.00,2269.49,9374.09,0.35,1
30475,3245,1000.00,16000.00,17000.00,6849.76,9150.24,0.01,1
30476,3245,1000.00,17000.00,18000.00,0.00,6799.15,0.26,1
30477,3245,1000.00,18000.00,19000.00,1566.19,16433.81,0.42,1
30478,3245,0.00,18000.00,19000.00,0.00,0.00,0.05,0
30479,3245,1000.00,19000.00,20000.00,1452.12,6684.23,0.24,1
30480,3245,1000.00,20000.00,21000.00,9411.66,10588.34,0.38,1
30481,3245,1000.00,21000.00,22000.00,7066.13,13933.87,0.27,1
30482,3245,1000.00,22000.00,23000.00,0.00,12794.81,0.21,1
30483,3245,-1000.00,21000.00,22000.00,8555.41,14444.59,0.11,0
30484,3245,-1000.00,20000.00,21000.00,0.00,19193.61,0.32,0
30485,3245,-1000.00,19000.00,20000.00,884.74,20115.26,0.44,0
30486,3245,-1000.00,18000.00,19000.00,0.00,20000.00,0.05,0
30487,3245,-1000.00,17000.00,18000.00,9276.17,9723.83,0.19,0
30488,3245,-1000.00,16000.00,17000.00,0.00,18000.00,0.27,0
30489,3245,-1000.00,15000.00,16000.00,2970.04,11411.95,0.36,0
30490,3245,-1000.00,14000.00,15000.00,1544.94,14455.06,0.41,0
30491,3245,-1000.00,13000.00,14000.00,5743.42,9256.58,0.12,0
30492,3245,-1000.00,12000.00,13000.00,5535.94,8464.06,0.33,0
30493,3245,-1000.00,11000.00,12000.00,0.00,13000.00,0.29,0
30494,3245,-1000.00,10000.00,11000.00,1942.12,10057.88,0.12,0
30495,3245,-1000.00,9000.00,10000.00,5708.95,5291.05,0.21,0
30496,3245,-1000.00,8000.00,9000.00,0.00,6477.34,0.34,0
30497,3245,-1000.00,7000.00,8000.00,4316.76,4683.24,0.10,0
30498,3245,-1000.00,6000.00,7000.00,4054.48,3945.52,0.16,0
30499,3245,-1000.00,5000.00,6000.00,685.81,6314.19,0.27,0
30500,3245,-1000.00,4000.00,5000.00,1358.86,4641.14,0.33,0
30501,3245,-1000.00,3000.00,4000.00,0.00,5000.00,0.25,0
30502,3245,-1000.00,2000.00,3000.00,0.00,4000.00,0.03,0
30503,3245,-1000.00,1000.00,2000.00,325.34,2674.66,0.17,0
30504,3245,-1000.00,0.00,1000.00,582.15,0.00,0.09,0
30505,3245,-1000.00,-1000.00,0.00,547.15,452.85,0.19,0
30506,3246,-1000.00,-1000.00,0.00,223.75,776.25,0.18,0
30507,3247,-1000.00,-1000.00,0.00,0.00,1000.00,0.24,0
30508,3248,-432.11,-432.11,567.89,0.00,432.11,0.04,0
30509,3248,-567.89,-1000.00,0.00,0.00,567.89,0.21,0
30510,3249,-722.55,-722.55,277.45,0.00,722.55,0.05,0
30511,3249,-277.45,-1000.00,0.00,0.00,277.45,0.11,0
30512,3250,-117.30,-117.30,882.70,0.00,117.30,0.26,0
30513,3250,0.00,-117.30,882.70,0.00,0.00,0.01,0
30514,3250,-882.70,-1000.00,0.00,226.61,656.09,0.37,0
30515,3251,-1000.00,-1000.00,0.00,0.00,713.48,0.23,0
30516,3252,-1000.00,-1000.00,0.00,216.87,783.13,0.39,0
30517,3253,-800.12,-800.12,199.88,0.00,800.12,0.23,0
30518,3253,-151.22,-951.34,48.66,0.00,151.22,0.26,0
30519,3253,-13.05,-964.39,35.61,0.00,13.05,0.09,0
30520,3253,-35.61,-1000.00,0.00,17.80,17.80,0.06,0
30521,3254,1000.00,1000.00,2000.00,0.00,1000.00,0.38,1
30522,3254,1000.00,2000.00,3000.00,0.00,2000.00,0.39,1
30523,3254,1000.00,3000.00,4000.00,1053.47,1946.53,0.29,1
30524,3254,1000.00,4000.00,5000.00,2000.00,2000.00,0.00,1
30525,3254,-1000.00,3000.00,4000.00,4923.73,0.00,0.02,0
30526,3254,1000.00,4000.00,5000.00,1813.85,2186.15,0.24,1
30527,3254,-1000.00,3000.00,4000.00,3424.24,0.00,0.07,0
30528,3254,1000.00,4000.00,5000.00,1871.41,2128.59,0.15,1
30529,3254,1000.00,5000.00,6000.00,1806.44,3193.56,0.05,1
30530,3254,1000.00,6000.00,7000.00,0.00,3493.10,0.11,1
30531,3254,1000.00,7000.00,8000.00,2492.18,4507.82,0.29,1
30532,3254,0.00,7000.00,8000.00,0.00,0.00,0.04,0
30533,3254,1000.00,8000.00,9000.00,0.00,8000.00,0.25,1
30534,3254,-1000.00,7000.00,8000.00,4583.11,4416.89,0.03,0
30535,3254,-1000.00,6000.00,7000.00,2902.73,0.00,0.04,0
30536,3254,1000.00,7000.00,8000.00,0.00,7000.00,0.09,1
30537,3254,1000.00,8000.00,9000.00,1720.68,4359.91,0.31,1
30538,3254,1000.00,9000.00,10000.00,4189.88,4810.12,0.36,1
30539,3254,1000.00,10000.00,11000.00,0.00,10000.00,0.20,1
30540,3254,1000.00,11000.00,12000.00,3473.45,7526.55,0.32,1
30541,3254,1000.00,12000.00,13000.00,4569.28,7430.72,0.26,1
30542,3254,1000.00,13000.00,14000.00,4626.27,8373.73,0.31,1
30543,3254,1000.00,14000.00,15000.00,0.00,11979.79,0.13,1
30544,3254,1000.00,15000.00,16000.00,0.00,15000.00,0.39,1
30545,3254,1000.00,16000.00,17000.00,0.00,16000.00,0.24,1
30546,3254,1000.00,17000.00,18000.00,0.00,13643.59,0.25,1
30547,3254,1000.00,18000.00,19000.00,0.00,18000.00,0.15,1
30548,3254,1000.00,19000.00,20000.00,0.00,19000.00,0.09,1
30549,3254,1000.00,20000.00,21000.00,3190.22,16809.78,0.42,1
30550,3254,1000.00,21000.00,22000.00,10500.00,10500.00,0.26,1
30551,3254,1000.00,22000.00,23000.00,11000.00,11000.00,0.01,1
30552,3254,1000.00,23000.00,24000.00,11054.90,11945.10,0.30,1
30553,3254,-1000.00,22000.00,23000.00,15676.43,8323.57,0.30,0
30554,3254,1000.00,23000.00,24000.00,3480.23,19519.77,0.41,1
30555,3254,1000.00,24000.00,25000.00,0.00,6118.78,0.20,1
30556,3254,1000.00,25000.00,26000.00,12500.00,12500.00,0.18,1
30557,3255,1000.00,1000.00,2000.00,0.00,1000.00,0.29,1
30558,3255,1000.00,2000.00,3000.00,0.00,2000.00,0.19,1
30559,3255,1000.00,3000.00,4000.00,0.00,3000.00,0.01,1
30560,3255,1000.00,4000.00,5000.00,0.00,1445.58,0.20,1
30561,3255,1000.00,5000.00,6000.00,1935.49,3064.51,0.25,1
30562,3255,1000.00,6000.00,7000.00,991.33,5008.67,0.04,1
30563,3255,1000.00,7000.00,8000.00,0.00,7000.00,0.00,1
30564,3255,1000.00,8000.00,9000.00,0.00,8000.00,0.25,1
30565,3255,0.00,8000.00,9000.00,0.00,0.00,0.03,0
30566,3255,1000.00,9000.00,10000.00,0.00,9000.00,0.12,1
30567,3255,1000.00,10000.00,11000.00,0.00,9549.59,0.43,1
30568,3255,1000.00,11000.00,12000.00,5500.00,5500.00,0.02,1
30569,3255,1000.00,12000.00,13000.00,5715.72,6284.28,0.27,1
30570,3255,1000.00,13000.00,14000.00,0.00,13000.00,0.09,1
30571,3255,1000.00,14000.00,15000.00,0.00,14000.00,0.15,1
30572,3255,1000.00,15000.00,16000.00,3477.29,11522.71,0.36,1
30573,3255,1000.00,16000.00,17000.00,0.00,16000.00,0.22,1
30574,3255,1000.00,17000.00,18000.00,0.00,15275.07,0.12,1
30575,3255,1000.00,18000.00,19000.00,9000.00,9000.00,0.00,1
30576,3255,1000.00,19000.00,20000.00,0.00,3507.78,0.14,1
30577,3255,1000.00,20000.00,21000.00,0.00,20000.00,0.44,1
30578,3255,1000.00,21000.00,22000.00,0.00,16009.46,0.41,1
30579,3255,-1000.00,20000.00,21000.00,11000.00,11000.00,0.37,0
30580,3255,-1000.00,19000.00,20000.00,0.00,20498.61,0.44,0
30581,3255,-1000.00,18000.00,19000.00,5486.70,14513.30,0.10,0
30582,3255,-1000.00,17000.00,18000.00,0.00,4526.40,0.18,0
30583,3255,-1000.00,16000.00,17000.00,0.00,16474.75,0.15,0
30584,3255,-1000.00,15000.00,16000.00,223.49,16776.51,0.02,0
30585,3255,0.00,15000.00,16000.00,0.00,0.00,0.02,0
30586,3255,-1000.00,14000.00,15000.00,0.00,16000.00,0.02,0
30587,3255,-1000.00,13000.00,14000.00,0.00,10879.70,0.21,0
30588,3255,-1000.00,12000.00,13000.00,510.97,13489.03,0.16,0
30589,3255,-1000.00,11000.00,12000.00,7181.68,5818.32,0.17,0
30590,3255,-1000.00,10000.00,11000.00,12000.00,0.00,0.02,0
30591,3255,-1000.00,9000.00,10000.00,0.00,9114.80,0.32,0
30592,3255,-1000.00,8000.00,9000.00,2229.56,7770.44,0.18,0
30593,3255,-1000.00,7000.00,8000.00,0.00,9000.00,0.09,0
30594,3255,-1000.00,6000.00,7000.00,0.00,8000.00,0.35,0
30595,3255,-1000.00,5000.00,6000.00,0.00,5479.97,0.24,0
30596,3255,-1000.00,4000.00,5000.00,2295.87,3704.13,0.21,0
30597,3255,-1000.00,3000.00,4000.00,0.00,5000.00,0.28,0
30598,3255,-1000.00,2000.00,3000.00,662.54,3337.46,0.32,0
30599,3255,-1000.00,1000.00,2000.00,535.76,2464.24,0.39,0
30600,3255,-1000.00,0.00,1000.00,830.73,595.47,0.18,0
30601,3255,-1000.00,-1000.00,0.00,393.67,0.00,0.09,0
30602,3256,-514.92,-514.92,485.08,0.00,514.92,0.30,0
30603,3256,-485.08,-1000.00,0.00,0.00,485.08,0.13,0
30604,3257,1000.00,1000.00,2000.00,80.74,919.26,0.43,1
30605,3257,1000.00,2000.00,3000.00,0.00,971.67,0.20,1
30606,3257,1000.00,3000.00,4000.00,1500.00,1500.00,0.22,1
30607,3257,-355.78,2644.22,3644.22,179.05,176.73,0.05,0
30608,3257,1000.00,3644.22,4644.22,1718.93,1925.30,0.17,1
30609,3257,1000.00,4644.22,5644.22,1071.24,3572.99,0.39,1
30610,3257,1000.00,5644.22,6644.22,0.00,595.16,0.05,1
30611,3257,-1000.00,4644.22,5644.22,3081.36,1230.12,0.12,0
30612,3257,-1000.00,3644.22,4644.22,5644.22,0.00,0.02,0
30613,3257,-1000.00,2644.22,3644.22,1255.59,752.21,0.15,0
30614,3257,-1000.00,1644.22,2644.22,1250.87,0.00,0.04,0
30615,3257,1000.00,2644.22,3644.22,0.00,2644.22,0.15,1
30616,3257,1000.00,3644.22,4644.22,428.20,1536.87,0.27,1
30617,3257,1000.00,4644.22,5644.22,382.17,4262.05,0.43,1
30618,3257,1000.00,5644.22,6644.22,2790.18,2854.04,0.17,1
30619,3257,1000.00,6644.22,7644.22,3046.79,3597.43,0.42,1
30620,3257,1000.00,7644.22,8644.22,3199.66,4444.56,0.16,1
30621,3257,1000.00,8644.22,9644.22,4169.16,4475.06,0.26,1
30622,3257,1000.00,9644.22,10644.22,3666.75,5977.48,0.25,1
30623,3257,1000.00,10644.22,11644.22,0.00,9207.52,0.36,1
30624,3257,1000.00,11644.22,12644.22,2683.98,6769.38,0.32,1
30625,3257,1000.00,12644.22,13644.22,6322.11,6322.11,0.32,1
30626,3257,1000.00,13644.22,14644.22,4997.89,8646.33,0.27,1
30627,3257,1000.00,14644.22,15644.22,1230.17,13414.05,0.38,1
30628,3257,1000.00,15644.22,16644.22,4030.36,11613.86,0.38,1
30629,3257,1000.00,16644.22,17644.22,6679.07,9965.15,0.27,1
30630,3257,-1000.00,15644.22,16644.22,11096.15,6548.07,0.10,0
30631,3257,1000.00,16644.22,17644.22,3478.47,13165.75,0.26,1
30632,3257,-1000.00,15644.22,16644.22,10903.68,6740.55,0.11,0
30633,3257,-1000.00,14644.22,15644.22,4548.54,620.19,0.12,0
30634,3257,1000.00,15644.22,16644.22,7822.11,7822.11,0.40,1
30635,3257,1000.00,16644.22,17644.22,0.00,12382.38,0.34,1
30636,3257,1000.00,17644.22,18644.22,0.00,16055.73,0.44,1
30637,3257,1000.00,18644.22,19644.22,0.00,11685.67,0.26,1
30638,3257,1000.00,19644.22,20644.22,0.00,10249.92,0.22,1
30639,3257,1000.00,20644.22,21644.22,5642.53,15001.69,0.23,1
30640,3257,-1000.00,19644.22,20644.22,10371.14,3667.34,0.12,0
30641,3257,1000.00,20644.22,21644.22,10322.11,10322.11,0.03,1
30642,3257,1000.00,21644.22,22644.22,8151.90,13492.32,0.01,1
30643,3257,1000.00,22644.22,23644.22,0.00,332.46,0.11,1
30644,3257,1000.00,23644.22,24644.22,11822.11,11822.11,0.02,1
30645,3257,1000.00,24644.22,25644.22,11448.54,13195.68,0.18,1
30646,3257,-1000.00,23644.22,24644.22,22848.07,2796.16,0.03,0
30647,3257,-1000.00,22644.22,23644.22,24644.22,0.00,0.03,0
30648,3257,1000.00,23644.22,24644.22,0.00,23644.22,0.43,1
30649,3258,-1000.00,-1000.00,0.00,0.00,508.38,0.26,0
30650,3259,-686.38,-686.38,313.62,686.38,0.00,0.14,0
30651,3259,-37.68,-724.06,275.94,37.68,0.00,0.21,0
30652,3259,-1000.00,-1724.06,-724.06,17.32,157.84,0.44,0
30653,3260,-1000.00,-1000.00,0.00,657.64,342.36,0.04,0
30654,3261,-1000.00,-1000.00,0.00,450.09,549.91,0.05,0
30655,3262,-683.17,-683.17,316.83,0.00,683.17,0.33,0
30656,3262,-159.94,-843.11,156.89,0.00,159.94,0.26,0
30657,3262,-156.89,-1000.00,0.00,7.37,149.52,0.44,0
30658,3263,1000.00,1000.00,2000.00,0.00,981.55,0.36,1
30659,3263,1000.00,2000.00,3000.00,657.01,1342.99,0.18,1
30660,3263,1000.00,3000.00,4000.00,0.00,1593.36,0.30,1
30661,3263,1000.00,4000.00,5000.00,1866.04,2133.96,0.15,1
30662,3263,1000.00,5000.00,6000.00,655.32,4344.68,0.12,1
30663,3263,1000.00,6000.00,7000.00,0.00,6000.00,0.42,1
30664,3263,1000.00,7000.00,8000.00,0.00,5859.07,0.25,1
30665,3263,1000.00,8000.00,9000.00,0.00,8000.00,0.03,1
30666,3263,1000.00,9000.00,10000.00,0.00,1476.06,0.01,1
30667,3263,1000.00,10000.00,11000.00,4777.84,5222.16,0.13,1
30668,3263,1000.00,11000.00,12000.00,0.00,8924.50,0.42,1
30669,3263,1000.00,12000.00,13000.00,0.00,12000.00,0.43,1
30670,3263,1000.00,13000.00,14000.00,5574.85,7425.15,0.21,1
30671,3263,-1000.00,12000.00,13000.00,10978.79,2721.86,0.08,0
30672,3263,1000.00,13000.00,14000.00,0.00,13000.00,0.44,1
30673,3263,1000.00,14000.00,15000.00,0.00,14000.00,0.14,1
30674,3263,1000.00,15000.00,16000.00,4477.93,7831.02,0.29,1
30675,3263,1000.00,16000.00,17000.00,0.00,16000.00,0.28,1
30676,3263,1000.00,17000.00,18000.00,4274.13,12725.87,0.38,1
30677,3263,1000.00,18000.00,19000.00,932.70,17067.30,0.38,1
30678,3263,-1000.00,17000.00,18000.00,13204.01,5795.99,0.23,0
30679,3263,1000.00,18000.00,19000.00,6208.17,11791.83,0.27,1
30680,3263,-1000.00,17000.00,18000.00,13288.83,5711.17,0.15,0
30681,3263,1000.00,18000.00,19000.00,0.00,18000.00,0.43,1
30682,3263,-1000.00,17000.00,18000.00,7571.66,6769.22,0.16,0
30683,3263,1000.00,18000.00,19000.00,0.00,17763.98,0.37,1
30684,3263,1000.00,19000.00,20000.00,0.00,14345.73,0.39,1
30685,3263,1000.00,20000.00,21000.00,9983.82,10016.18,0.17,1
30686,3263,1000.00,21000.00,22000.00,0.00,15599.85,0.30,1
30687,3263,1000.00,22000.00,23000.00,8814.00,13186.00,0.29,1
30688,3263,1000.00,23000.00,24000.00,4124.48,18875.52,0.41,1
30689,3263,1000.00,24000.00,25000.00,0.00,6677.90,0.19,1
30690,3263,-1000.00,23000.00,24000.00,13323.55,11676.45,0.28,0
30691,3263,1000.00,24000.00,25000.00,0.00,11313.87,0.30,1
30692,3263,1000.00,25000.00,26000.00,0.00,17477.82,0.29,1
30693,3263,1000.00,26000.00,27000.00,0.00,26000.00,0.00,1
30694,3263,-1000.00,25000.00,26000.00,16782.42,0.00,0.03,0
30695,3263,1000.00,26000.00,27000.00,1164.67,24835.33,0.36,1
30696,3263,-1000.00,25000.00,26000.00,27000.00,0.00,0.02,0
30697,3263,1000.00,26000.00,27000.00,0.00,21803.27,0.04,1
30698,3263,1000.00,27000.00,28000.00,0.00,27000.00,0.22,1
30699,3263,1000.00,28000.00,29000.00,8271.99,19728.01,0.36,1
30700,3263,-1000.00,27000.00,28000.00,12933.58,0.00,0.02,0
30701,3263,1000.00,28000.00,29000.00,0.00,18897.95,0.38,1
30702,3263,-1000.00,27000.00,28000.00,9969.01,0.00,0.00,0
30703,3263,1000.00,28000.00,29000.00,0.00,28000.00,0.33,1
30704,3263,1000.00,29000.00,30000.00,0.00,29000.00,0.15,1
30705,3263,1000.00,30000.00,31000.00,0.00,26123.47,0.33,1
30706,3264,-1000.00,-1000.00,0.00,500.00,500.00,0.00,0
30707,3265,-918.82,-918.82,81.18,219.80,699.02,0.36,0
30708,3265,-15.95,-934.77,65.23,0.00,15.95,0.09,0
30709,3265,-1000.00,-1934.77,-934.77,39.41,25.82,0.33,0
30710,3266,-1000.00,-1000.00,0.00,220.75,779.25,0.16,0
30711,3267,1000.00,1000.00,2000.00,0.00,1000.00,0.42,1
30712,3267,-1000.00,0.00,1000.00,2000.00,0.00,0.00,0
30713,3267,1000.00,1000.00,2000.00,0.00,617.86,0.13,1
30714,3267,1000.00,2000.00,3000.00,739.40,1260.60,0.27,1
30715,3267,1000.00,3000.00,4000.00,1500.00,1500.00,0.02,1
30716,3267,-1000.00,2000.00,3000.00,2472.16,1527.84,0.13,0
30717,3267,-1000.00,1000.00,2000.00,1621.11,941.47,0.15,0
30718,3267,-1000.00,0.00,1000.00,0.00,1172.15,0.34,0
30719,3267,-671.47,-671.47,328.53,671.47,0.00,0.22,0
30720,3267,-1000.00,-1671.47,-671.47,0.00,328.53,0.06,0
30721,3268,-1000.00,-1000.00,0.00,363.95,636.05,0.35,0
30722,3269,-898.37,-898.37,101.63,0.00,898.37,0.06,0
30723,3269,-101.63,-1000.00,0.00,46.52,55.11,0.08,0
30724,3270,-1000.00,-1000.00,0.00,0.00,1000.00,0.08,0
30725,3271,-462.97,-462.97,537.03,0.00,462.97,0.07,0
30726,3271,1000.00,537.03,1537.03,316.97,220.06,0.16,1
30727,3271,0.00,537.03,1537.03,0.00,0.00,0.06,0
30728,3271,-1000.00,-462.97,537.03,499.29,1037.74,0.35,0
30729,3271,1000.00,537.03,1537.03,321.82,215.21,0.18,1
30730,3271,-1000.00,-462.97,537.03,153.03,1384.00,0.26,0
30731,3271,-537.03,-1000.00,0.00,0.00,537.03,0.12,0
30732,3272,-1000.00,-1000.00,0.00,279.30,720.70,0.26,0
30733,3273,1000.00,1000.00,2000.00,389.74,0.00,0.23,1
30734,3273,-1000.00,0.00,1000.00,0.00,2000.00,0.18,0
30735,3273,-245.10,-245.10,754.90,0.00,245.10,0.40,0
30736,3273,1000.00,754.90,1754.90,469.01,0.00,0.14,1
30737,3273,-1000.00,-245.10,754.90,0.00,1754.90,0.09,0
30738,3273,1000.00,754.90,1754.90,44.29,0.00,0.40,1
30739,3273,-1000.00,-245.10,754.90,0.00,1754.90,0.04,0
30740,3273,-82.17,-327.27,672.73,0.00,82.17,0.09,0
30741,3273,-410.23,-737.50,262.50,0.00,410.23,0.26,0
30742,3273,1000.00,262.50,1262.50,77.77,0.00,0.37,1
30743,3273,-1000.00,-737.50,262.50,333.21,929.29,0.38,0
30744,3273,-262.50,-1000.00,0.00,0.00,262.50,0.22,0
30745,3274,0.00,0.00,1000.00,0.00,0.00,0.01,0
30746,3274,1000.00,1000.00,2000.00,0.00,441.94,0.15,1
30747,3274,1000.00,2000.00,3000.00,0.00,2000.00,0.30,1
30748,3274,1000.00,3000.00,4000.00,0.00,3000.00,0.34,1
30749,3274,1000.00,4000.00,5000.00,2000.00,2000.00,0.04,1
30750,3274,1000.00,5000.00,6000.00,1154.71,3845.29,0.25,1
30751,3274,1000.00,6000.00,7000.00,0.00,6000.00,0.03,1
30752,3274,1000.00,7000.00,8000.00,0.00,7000.00,0.31,1
30753,3274,1000.00,8000.00,9000.00,2502.28,5497.72,0.35,1
30754,3274,1000.00,9000.00,10000.00,2602.90,6119.38,0.34,1
30755,3274,1000.00,10000.00,11000.00,3231.28,6768.72,0.35,1
30756,3274,1000.00,11000.00,12000.00,2123.91,8876.09,0.41,1
30757,3274,1000.00,12000.00,13000.00,4227.58,7772.42,0.17,1
30758,3274,1000.00,13000.00,14000.00,4604.75,8395.25,0.29,1
30759,3274,1000.00,14000.00,15000.00,0.00,14000.00,0.00,1
30760,3274,1000.00,15000.00,16000.00,3607.43,11392.57,0.23,1
30761,3274,1000.00,16000.00,17000.00,5801.32,10198.68,0.28,1
30762,3274,-1000.00,15000.00,16000.00,7819.32,9180.68,0.36,0
30763,3274,-1000.00,14000.00,15000.00,8000.00,8000.00,0.07,0
30764,3274,-1000.00,13000.00,14000.00,8516.07,0.00,0.05,0
30765,3274,-1000.00,12000.00,13000.00,0.00,14000.00,0.20,0
30766,3274,-1000.00,11000.00,12000.00,6500.00,6500.00,0.14,0
30767,3274,-1000.00,10000.00,11000.00,0.00,3100.96,0.20,0
30768,3274,-1000.00,9000.00,10000.00,4939.26,0.00,0.01,0
30769,3274,-1000.00,8000.00,9000.00,1426.75,8573.25,0.38,0
30770,3274,-1000.00,7000.00,8000.00,0.00,9000.00,0.32,0
30771,3274,-1000.00,6000.00,7000.00,0.00,8000.00,0.32,0
30772,3274,-1000.00,5000.00,6000.00,2814.12,4185.88,0.29,0
30773,3274,-1000.00,4000.00,5000.00,3000.00,3000.00,0.01,0
30774,3274,-1000.00,3000.00,4000.00,0.00,4010.85,0.38,0
30775,3274,-1000.00,2000.00,3000.00,0.00,1898.59,0.26,0
30776,3274,-1000.00,1000.00,2000.00,1365.65,1634.35,0.17,0
30777,3274,0.00,1000.00,2000.00,0.00,0.00,0.01,0
30778,3274,-1000.00,0.00,1000.00,977.33,1022.67,0.23,0
30779,3274,-1000.00,-1000.00,0.00,487.35,512.65,0.22,0
30780,3275,-1000.00,-1000.00,0.00,0.00,1000.00,0.32,0
30781,3276,-619.04,-619.04,380.96,0.00,619.04,0.30,0
30782,3276,0.00,-619.04,380.96,0.00,0.00,0.32,0
30783,3276,-121.84,-740.88,259.12,0.00,121.84,0.21,0
30784,3276,-259.12,-1000.00,0.00,81.46,177.66,0.15,0
30785,3277,-1000.00,-1000.00,0.00,329.43,543.61,0.33,0
30786,3278,1000.00,1000.00,2000.00,197.06,802.94,0.17,1
30787,3278,1000.00,2000.00,3000.00,879.83,1120.17,0.23,1
30788,3278,1000.00,3000.00,4000.00,0.00,3000.00,0.01,1
30789,3278,1000.00,4000.00,5000.00,0.00,2096.38,0.20,1
30790,3278,1000.00,5000.00,6000.00,0.00,141.17,0.08,1
30791,3278,1000.00,6000.00,7000.00,0.00,1074.99,0.15,1
30792,3278,1000.00,7000.00,8000.00,2054.60,4945.40,0.33,1
30793,3278,1000.00,8000.00,9000.00,0.00,8000.00,0.30,1
30794,3278,1000.00,9000.00,10000.00,2574.46,6425.54,0.25,1
30795,3278,1000.00,10000.00,11000.00,0.00,8632.13,0.42,1
30796,3278,1000.00,11000.00,12000.00,5500.00,5500.00,0.01,1
30797,3278,1000.00,12000.00,13000.00,3472.82,8527.18,0.36,1
30798,3278,1000.00,13000.00,14000.00,6500.00,6500.00,0.06,1
30799,3278,1000.00,14000.00,15000.00,0.00,9306.01,0.31,1
30800,3278,1000.00,15000.00,16000.00,6549.90,8450.10,0.10,1
30801,3278,1000.00,16000.00,17000.00,7122.37,8877.63,0.16,1
30802,3278,-1000.00,15000.00,16000.00,3586.53,0.00,0.09,0
30803,3278,1000.00,16000.00,17000.00,0.00,16000.00,0.13,1
30804,3278,1000.00,17000.00,18000.00,8500.00,8500.00,0.16,1
30805,3278,1000.00,18000.00,19000.00,4350.58,11219.55,0.34,1
30806,3278,1000.00,19000.00,20000.00,0.00,6748.33,0.16,1
30807,3278,1000.00,20000.00,21000.00,8260.65,11739.35,0.28,1
30808,3278,1000.00,21000.00,22000.00,5463.97,15536.03,0.27,1
30809,3278,1000.00,22000.00,23000.00,10818.67,11181.33,0.10,1
30810,3278,1000.00,23000.00,24000.00,732.05,2875.74,0.15,1
30811,3278,1000.00,24000.00,25000.00,7000.33,16999.67,0.40,1
30812,3278,-1000.00,23000.00,24000.00,13374.61,11625.39,0.12,0
30813,3278,0.00,23000.00,24000.00,0.00,0.00,0.01,0
30814,3278,1000.00,24000.00,25000.00,3504.74,12379.81,0.31,1
30815,3278,1000.00,25000.00,26000.00,0.00,25000.00,0.28,1
30816,3278,1000.00,26000.00,27000.00,13000.00,13000.00,0.15,1
30817,3278,1000.00,27000.00,28000.00,0.00,27000.00,0.11,1
30818,3279,-1000.00,-1000.00,0.00,150.90,849.10,0.27,0
30819,3280,-775.85,-775.85,224.15,0.00,775.85,0.41,0
30820,3280,-224.15,-1000.00,0.00,9.76,214.38,0.09,0
30821,3281,-1000.00,-1000.00,0.00,0.00,1000.00,0.32,0
30822,3282,-1000.00,-1000.00,0.00,0.00,1000.00,0.06,0
30823,3283,-1000.00,-1000.00,0.00,0.00,1000.00,0.22,0
30824,3284,1000.00,1000.00,2000.00,500.00,500.00,0.01,1
30825,3284,1000.00,2000.00,3000.00,1000.00,1000.00,0.10,1
30826,3284,1000.00,3000.00,4000.00,0.00,3000.00,0.23,1
30827,3284,1000.00,4000.00,5000.00,0.00,4000.00,0.42,1
30828,3284,1000.00,5000.00,6000.00,0.00,4598.58,0.19,1
30829,3284,1000.00,6000.00,7000.00,1885.33,4114.67,0.21,1
30830,3284,1000.00,7000.00,8000.00,0.00,6609.05,0.43,1
30831,3284,1000.00,8000.00,9000.00,2898.45,5101.55,0.03,1
30832,3284,1000.00,9000.00,10000.00,0.00,9000.00,0.00,1
30833,3284,1000.00,10000.00,11000.00,0.00,10000.00,0.24,1
30834,3284,-1000.00,9000.00,10000.00,5435.07,0.00,0.02,0
30835,3284,1000.00,10000.00,11000.00,0.00,10000.00,0.37,1
30836,3284,1000.00,11000.00,12000.00,0.00,2893.54,0.03,1
30837,3284,1000.00,12000.00,13000.00,0.00,12000.00,0.39,1
30838,3284,1000.00,13000.00,14000.00,910.22,4733.81,0.25,1
30839,3284,1000.00,14000.00,15000.00,6132.02,7867.98,0.06,1
30840,3284,1000.00,15000.00,16000.00,0.00,15000.00,0.39,1
30841,3284,-1000.00,14000.00,15000.00,8137.25,7862.75,0.40,0
30842,3284,1000.00,15000.00,16000.00,5474.25,9525.75,0.25,1
30843,3284,1000.00,16000.00,17000.00,3414.53,12585.47,0.20,1
30844,3284,1000.00,17000.00,18000.00,0.00,3751.19,0.03,1
30845,3284,1000.00,18000.00,19000.00,0.00,18000.00,0.38,1
30846,3284,1000.00,19000.00,20000.00,1087.01,9432.47,0.31,1
30847,3284,-1000.00,18000.00,19000.00,11685.62,8314.38,0.15,0
30848,3284,1000.00,19000.00,20000.00,6711.95,12288.05,0.32,1
30849,3284,1000.00,20000.00,21000.00,3437.48,7616.47,0.25,1
30850,3284,1000.00,21000.00,22000.00,0.00,21000.00,0.29,1
30851,3284,-1000.00,20000.00,21000.00,9694.38,0.00,0.05,0
30852,3284,1000.00,21000.00,22000.00,0.00,21000.00,0.37,1
30853,3284,1000.00,22000.00,23000.00,0.00,13599.63,0.07,1
30854,3284,1000.00,23000.00,24000.00,7893.85,15106.15,0.09,1
30855,3284,1000.00,24000.00,25000.00,0.00,14060.72,0.09,1
30856,3284,1000.00,25000.00,26000.00,0.00,25000.00,0.04,1
30857,3284,1000.00,26000.00,27000.00,10891.27,15108.73,0.29,1
30858,3284,-1000.00,25000.00,26000.00,14768.79,12231.21,0.26,0
30859,3284,1000.00,26000.00,27000.00,0.00,24500.36,0.36,1
30860,3284,1000.00,27000.00,28000.00,0.00,25763.57,0.42,1
30861,3284,1000.00,28000.00,29000.00,0.00,28000.00,0.32,1
30862,3284,1000.00,29000.00,30000.00,14170.92,14829.08,0.14,1
30863,3285,-1000.00,-1000.00,0.00,0.00,1000.00,0.40,0
30864,3286,-1000.00,-1000.00,0.00,103.64,896.36,0.42,0
30865,3287,-1000.00,-1000.00,0.00,0.00,1000.00,0.26,0
30866,3288,-843.08,-843.08,156.92,0.00,843.08,0.40,0
30867,3288,-139.99,-983.07,16.93,22.69,117.30,0.39,0
30868,3288,-16.93,-1000.00,0.00,3.22,13.71,0.35,0
30869,3289,0.00,0.00,1000.00,0.00,0.00,0.25,0
30870,3289,-1000.00,-1000.00,0.00,113.81,375.43,0.43,0
30871,3290,-1000.00,-1000.00,0.00,326.87,673.13,0.17,0
30872,3291,1000.00,1000.00,2000.00,500.00,500.00,0.02,1
30873,3291,1000.00,2000.00,3000.00,0.00,2000.00,0.18,1
30874,3291,1000.00,3000.00,4000.00,1084.06,1915.94,0.31,1
30875,3291,1000.00,4000.00,5000.00,1041.21,2958.79,0.33,1
30876,3291,-1000.00,3000.00,4000.00,3367.48,853.04,0.09,0
30877,3291,1000.00,4000.00,5000.00,82.36,2031.34,0.32,1
30878,3291,1000.00,5000.00,6000.00,1666.47,3333.53,0.42,1
30879,3291,1000.00,6000.00,7000.00,0.00,6000.00,0.03,1
30880,3291,1000.00,7000.00,8000.00,0.00,7000.00,0.44,1
30881,3291,1000.00,8000.00,9000.00,4000.00,4000.00,0.27,1
30882,3291,1000.00,9000.00,10000.00,1997.27,7002.73,0.14,1
30883,3291,1000.00,10000.00,11000.00,0.00,10000.00,0.15,1
30884,3291,1000.00,11000.00,12000.00,850.90,9479.60,0.43,1
30885,3291,1000.00,12000.00,13000.00,0.00,12000.00,0.13,1
30886,3291,1000.00,13000.00,14000.00,0.00,7119.58,0.32,1
30887,3291,1000.00,14000.00,15000.00,3902.68,10097.32,0.24,1
30888,3291,1000.00,15000.00,16000.00,0.00,8086.19,0.14,1
30889,3291,1000.00,16000.00,17000.00,5577.39,6484.29,0.23,1
30890,3291,-1000.00,15000.00,16000.00,3303.30,9154.92,0.13,0
30891,3291,-1000.00,14000.00,15000.00,5233.83,0.00,0.05,0
30892,3291,-1000.00,13000.00,14000.00,0.00,5122.59,0.27,0
30893,3291,-1000.00,12000.00,13000.00,0.00,13700.51,0.20,0
30894,3291,-1000.00,11000.00,12000.00,11647.20,0.00,0.00,0
30895,3291,-1000.00,10000.00,11000.00,5540.88,6459.12,0.16,0
30896,3291,-1000.00,9000.00,10000.00,2012.03,8987.97,0.30,0
30897,3291,-1000.00,8000.00,9000.00,0.00,10000.00,0.27,0
30898,3291,-1000.00,7000.00,8000.00,6732.54,2267.46,0.01,0
30899,3291,-1000.00,6000.00,7000.00,0.00,7475.83,0.42,0
30900,3291,-1000.00,5000.00,6000.00,0.00,7000.00,0.40,0
30901,3291,-1000.00,4000.00,5000.00,1761.84,4238.16,0.36,0
30902,3291,-1000.00,3000.00,4000.00,0.00,2288.79,0.22,0
30903,3291,-1000.00,2000.00,3000.00,955.24,3044.76,0.05,0
30904,3291,-1000.00,1000.00,2000.00,0.00,1392.06,0.28,0
30905,3291,0.00,1000.00,2000.00,0.00,0.00,0.01,0
30906,3291,-1000.00,0.00,1000.00,0.00,2000.00,0.31,0
30907,3291,-1000.00,-1000.00,0.00,122.57,877.43,0.42,0
30908,3292,-961.43,-961.43,38.57,0.00,961.43,0.22,0
30909,3292,0.00,-961.43,38.57,0.00,0.00,0.07,0
30910,3292,-38.57,-1000.00,0.00,13.75,24.81,0.28,0
30911,3293,1000.00,1000.00,2000.00,0.00,127.04,0.15,1
30912,3293,1000.00,2000.00,3000.00,20.51,1946.42,0.44,1
30913,3293,1000.00,3000.00,4000.00,0.00,1852.41,0.24,1
30914,3293,1000.00,4000.00,5000.00,0.00,4000.00,0.02,1
30915,3293,1000.00,5000.00,6000.00,0.00,5000.00,0.05,1
30916,3293,1000.00,6000.00,7000.00,0.00,3425.24,0.18,1
30917,3293,1000.00,7000.00,8000.00,3499.50,3500.50,0.09,1
30918,3293,1000.00,8000.00,9000.00,1270.67,6195.99,0.40,1
30919,3293,1000.00,9000.00,10000.00,0.00,7695.09,0.26,1
30920,3293,1000.00,10000.00,11000.00,1806.55,8193.45,0.40,1
30921,3293,1000.00,11000.00,12000.00,4616.79,6383.21,0.25,1
30922,3293,1000.00,12000.00,13000.00,0.00,8239.89,0.18,1
30923,3293,1000.00,13000.00,14000.00,0.00,13000.00,0.05,1
30924,3293,1000.00,14000.00,15000.00,0.00,4271.16,0.21,1
30925,3293,1000.00,15000.00,16000.00,1240.54,11238.56,0.41,1
30926,3293,-1000.00,14000.00,15000.00,9988.93,6011.07,0.33,0
30927,3293,1000.00,15000.00,16000.00,5806.82,9193.18,0.25,1
30928,3293,1000.00,16000.00,17000.00,1031.15,2772.25,0.17,1
30929,3293,1000.00,17000.00,18000.00,5094.00,11906.00,0.35,1
30930,3293,1000.00,18000.00,19000.00,3672.81,14327.19,0.39,1
30931,3293,1000.00,19000.00,20000.00,0.00,15243.91,0.22,1
30932,3293,1000.00,20000.00,21000.00,5943.27,14056.73,0.27,1
30933,3293,1000.00,21000.00,22000.00,0.00,21000.00,0.35,1
30934,3293,1000.00,22000.00,23000.00,0.00,21124.27,0.41,1
30935,3293,-1000.00,21000.00,22000.00,10488.33,9318.13,0.21,0
30936,3293,1000.00,22000.00,23000.00,7341.15,14658.85,0.10,1
30937,3293,1000.00,23000.00,24000.00,0.00,23000.00,0.01,1
30938,3293,-1000.00,22000.00,23000.00,11790.50,6922.58,0.16,0
30939,3293,1000.00,23000.00,24000.00,0.00,11486.06,0.30,1
30940,3293,1000.00,24000.00,25000.00,0.00,24000.00,0.05,1
30941,3293,1000.00,25000.00,26000.00,0.00,20154.59,0.38,1
30942,3293,1000.00,26000.00,27000.00,11447.98,14552.02,0.17,1
30943,3293,1000.00,27000.00,28000.00,0.00,27000.00,0.37,1
30944,3293,1000.00,28000.00,29000.00,0.00,28000.00,0.16,1
30945,3293,1000.00,29000.00,30000.00,8522.81,20477.19,0.36,1
30946,3293,1000.00,30000.00,31000.00,0.00,17162.33,0.16,1
30947,3293,1000.00,31000.00,32000.00,0.00,23085.44,0.27,1
30948,3293,1000.00,32000.00,33000.00,9718.14,22281.86,0.28,1
30949,3293,1000.00,33000.00,34000.00,0.00,33000.00,0.08,1
30950,3293,1000.00,34000.00,35000.00,0.00,11282.36,0.06,1
30951,3293,1000.00,35000.00,36000.00,0.00,21644.98,0.32,1
30952,3293,1000.00,36000.00,37000.00,7138.52,28861.48,0.38,1
30953,3293,1000.00,37000.00,38000.00,5323.41,31676.59,0.42,1
30954,3293,1000.00,38000.00,39000.00,6675.15,31324.85,0.41,1
30955,3293,1000.00,39000.00,40000.00,0.00,39000.00,0.06,1
30956,3293,1000.00,40000.00,41000.00,13848.44,26151.56,0.24,1
30957,3293,1000.00,41000.00,42000.00,15712.74,25287.26,0.37,1
30958,3293,-1000.00,40000.00,41000.00,21000.00,21000.00,0.34,0
30959,3293,-1000.00,39000.00,40000.00,0.00,5739.21,0.16,0
30960,3293,-1000.00,38000.00,39000.00,27761.38,12238.62,0.07,0
30961,3293,-1000.00,37000.00,38000.00,25996.43,11092.07,0.12,0
30962,3293,-1000.00,36000.00,37000.00,16247.27,21752.73,0.09,0
30963,3293,-1000.00,35000.00,36000.00,0.00,31937.86,0.24,0
30964,3293,-1000.00,34000.00,35000.00,0.00,16312.69,0.28,0
30965,3293,-1000.00,33000.00,34000.00,0.00,28296.31,0.08,0
30966,3293,-1000.00,32000.00,33000.00,5986.05,28013.95,0.42,0
30967,3293,-1000.00,31000.00,32000.00,16868.42,16131.58,0.15,0
30968,3293,-1000.00,30000.00,31000.00,18931.98,13068.02,0.00,0
30969,3293,-1000.00,29000.00,30000.00,0.00,31000.00,0.23,0
30970,3293,-1000.00,28000.00,29000.00,0.00,11474.18,0.17,0
30971,3293,-1000.00,27000.00,28000.00,9358.85,10120.80,0.22,0
30972,3293,-1000.00,26000.00,27000.00,76.12,26494.28,0.44,0
30973,3293,-1000.00,25000.00,26000.00,27000.00,0.00,0.00,0
30974,3293,-1000.00,24000.00,25000.00,13000.00,13000.00,0.06,0
30975,3293,-1000.00,23000.00,24000.00,10624.63,14375.37,0.12,0
30976,3293,-1000.00,22000.00,23000.00,0.00,24000.00,0.03,0
30977,3293,-1000.00,21000.00,22000.00,2708.61,20291.39,0.26,0
30978,3293,-1000.00,20000.00,21000.00,0.00,7830.08,0.25,0
30979,3293,-1000.00,19000.00,20000.00,0.00,21000.00,0.02,0
30980,3293,-1000.00,18000.00,19000.00,0.00,20000.00,0.33,0
30981,3293,-1000.00,17000.00,18000.00,9336.53,9663.47,0.12,0
30982,3293,-1000.00,16000.00,17000.00,886.08,17113.92,0.35,0
30983,3293,-451.99,15548.01,16548.01,0.00,451.99,0.13,0
30984,3293,-1000.00,14548.01,15548.01,6143.25,10404.76,0.14,0
30985,3293,-1000.00,13548.01,14548.01,7388.87,8159.13,0.13,0
30986,3293,0.00,13548.01,14548.01,0.00,0.00,0.10,0
30987,3293,-1000.00,12548.01,13548.01,1687.84,12860.17,0.23,0
30988,3293,-1000.00,11548.01,12548.01,0.00,7063.38,0.28,0
30989,3293,-1000.00,10548.01,11548.01,6274.00,6274.00,0.05,0
30990,3293,-1000.00,9548.01,10548.01,1646.34,9180.64,0.41,0
30991,3293,-1000.00,8548.01,9548.01,0.00,10548.01,0.07,0
30992,3293,-1000.00,7548.01,8548.01,2307.51,1446.60,0.15,0
30993,3293,-1000.00,6548.01,7548.01,2330.27,6217.74,0.36,0
30994,3293,-1000.00,5548.01,6548.01,0.00,5838.48,0.33,0
30995,3293,-1000.00,4548.01,5548.01,0.00,6548.01,0.01,0
30996,3293,-1000.00,3548.01,4548.01,843.53,4704.48,0.28,0
30997,3293,-1000.00,2548.01,3548.01,1050.28,3497.73,0.27,0
30998,3293,0.00,2548.01,3548.01,0.00,0.00,0.04,0
30999,3293,-1000.00,1548.01,2548.01,0.00,3548.01,0.22,0
31000,3293,-1000.00,548.01,1548.01,0.00,2548.01,0.22,0
31001,3293,-1000.00,-451.99,548.01,805.86,742.15,0.09,0
31002,3293,-1000.00,-1451.99,-451.99,278.72,269.29,0.19,0
31003,3294,1000.00,1000.00,2000.00,0.00,1000.00,0.26,1
31004,3294,1000.00,2000.00,3000.00,266.11,1250.44,0.36,1
31005,3294,1000.00,3000.00,4000.00,1310.01,1689.99,0.12,1
31006,3294,1000.00,4000.00,5000.00,0.00,3523.59,0.41,1
31007,3294,1000.00,5000.00,6000.00,0.00,5000.00,0.38,1
31008,3294,1000.00,6000.00,7000.00,2067.98,3932.02,0.32,1
31009,3294,1000.00,7000.00,8000.00,0.00,4931.70,0.30,1
31010,3294,1000.00,8000.00,9000.00,1572.64,6427.36,0.41,1
31011,3294,1000.00,9000.00,10000.00,458.48,8541.52,0.39,1
31012,3294,1000.00,10000.00,11000.00,0.00,10000.00,0.01,1
31013,3294,1000.00,11000.00,12000.00,0.00,11000.00,0.09,1
31014,3294,1000.00,12000.00,13000.00,0.00,12000.00,0.37,1
31015,3294,1000.00,13000.00,14000.00,2913.66,10086.34,0.11,1
31016,3294,1000.00,14000.00,15000.00,1201.55,7658.00,0.33,1
31017,3294,1000.00,15000.00,16000.00,0.00,15000.00,0.29,1
31018,3294,1000.00,16000.00,17000.00,6001.42,9998.58,0.27,1
31019,3294,1000.00,17000.00,18000.00,0.00,17000.00,0.41,1
31020,3294,1000.00,18000.00,19000.00,3207.90,6466.49,0.24,1
31021,3294,1000.00,19000.00,20000.00,9080.97,9919.03,0.14,1
31022,3294,1000.00,20000.00,21000.00,6858.35,13141.65,0.31,1
31023,3294,1000.00,21000.00,22000.00,0.00,21000.00,0.20,1
31024,3294,1000.00,22000.00,23000.00,0.00,22000.00,0.17,1
31025,3294,-1000.00,21000.00,22000.00,15724.02,7275.98,0.06,0
31026,3294,1000.00,22000.00,23000.00,0.00,22000.00,0.08,1
31027,3294,1000.00,23000.00,24000.00,0.00,23000.00,0.36,1
31028,3294,1000.00,24000.00,25000.00,0.00,24000.00,0.10,1
31029,3294,1000.00,25000.00,26000.00,0.00,12397.24,0.22,1
31030,3294,1000.00,26000.00,27000.00,0.00,26000.00,0.35,1
31031,3294,1000.00,27000.00,28000.00,6509.21,20490.79,0.11,1
31032,3294,1000.00,28000.00,29000.00,0.00,28000.00,0.29,1
31033,3294,1000.00,29000.00,30000.00,6494.35,22505.65,0.39,1
31034,3294,1000.00,30000.00,31000.00,1942.53,22371.52,0.40,1
31035,3294,1000.00,31000.00,32000.00,11140.38,11389.92,0.21,1
31036,3294,1000.00,32000.00,33000.00,16000.00,16000.00,0.08,1
31037,3294,1000.00,33000.00,34000.00,0.00,31158.80,0.43,1
31038,3294,1000.00,34000.00,35000.00,0.00,20045.14,0.14,1
31039,3294,0.00,34000.00,35000.00,0.00,0.00,0.06,0
31040,3294,1000.00,35000.00,36000.00,0.00,28779.91,0.14,1
31041,3294,1000.00,36000.00,37000.00,11756.92,24243.08,0.34,1
31042,3294,1000.00,37000.00,38000.00,202.15,36797.85,0.37,1
31043,3294,1000.00,38000.00,39000.00,18219.41,19780.59,0.11,1
31044,3294,1000.00,39000.00,40000.00,0.00,39000.00,0.21,1
31045,3294,1000.00,40000.00,41000.00,0.00,14266.16,0.25,1
31046,3294,-1000.00,39000.00,40000.00,26676.03,11807.98,0.12,0
31047,3294,0.00,39000.00,40000.00,0.00,0.00,0.01,0
31048,3294,1000.00,40000.00,41000.00,17146.63,22853.37,0.27,1
31049,3294,1000.00,41000.00,42000.00,14704.12,26295.88,0.24,1
31050,3294,-1000.00,40000.00,41000.00,21000.00,21000.00,0.02,0
31051,3294,-1000.00,39000.00,40000.00,0.00,41000.00,0.09,0
31052,3294,-1000.00,38000.00,39000.00,0.00,40000.00,0.30,0
31053,3294,-1000.00,37000.00,38000.00,12804.13,14775.76,0.22,0
31054,3294,-1000.00,36000.00,37000.00,0.00,29013.26,0.40,0
31055,3294,-1000.00,35000.00,36000.00,0.00,37000.00,0.13,0
31056,3294,-1000.00,34000.00,35000.00,0.00,36000.00,0.32,0
31057,3294,-1000.00,33000.00,34000.00,0.00,35000.00,0.03,0
31058,3294,-1000.00,32000.00,33000.00,14357.05,19642.95,0.17,0
31059,3294,-1000.00,31000.00,32000.00,0.00,8970.32,0.12,0
31060,3294,-1000.00,30000.00,31000.00,14708.78,17291.22,0.10,0
31061,3294,-1000.00,29000.00,30000.00,13626.85,17373.15,0.16,0
31062,3294,-1000.00,28000.00,29000.00,0.00,8423.75,0.15,0
31063,3294,-1000.00,27000.00,28000.00,11019.79,17980.21,0.20,0
31064,3294,-1000.00,26000.00,27000.00,12400.31,15599.69,0.24,0
31065,3294,0.00,26000.00,27000.00,0.00,0.00,0.04,0
31066,3294,-1000.00,25000.00,26000.00,4325.88,0.00,0.06,0
31067,3294,-1000.00,24000.00,25000.00,4912.85,21087.15,0.41,0
31068,3294,-1000.00,23000.00,24000.00,0.00,16276.10,0.30,0
31069,3294,-1000.00,22000.00,23000.00,10552.62,13447.38,0.23,0
31070,3294,-1000.00,21000.00,22000.00,7648.87,15351.13,0.33,0
31071,3294,-1000.00,20000.00,21000.00,3006.32,18993.68,0.22,0
31072,3294,-1000.00,19000.00,20000.00,2378.37,18621.63,0.41,0
31073,3295,-1000.00,-1000.00,0.00,0.00,1000.00,0.23,0
31074,3296,1000.00,1000.00,2000.00,275.17,724.83,0.16,1
31075,3296,1000.00,2000.00,3000.00,82.17,1498.79,0.40,1
31076,3296,1000.00,3000.00,4000.00,848.73,2151.27,0.09,1
31077,3296,1000.00,4000.00,5000.00,0.00,2915.89,0.35,1
31078,3296,1000.00,5000.00,6000.00,1733.67,3266.33,0.30,1
31079,3296,1000.00,6000.00,7000.00,1001.41,4274.52,0.38,1
31080,3296,1000.00,7000.00,8000.00,573.63,4398.69,0.36,1
31081,3296,1000.00,8000.00,9000.00,15.40,7984.60,0.44,1
31082,3296,1000.00,9000.00,10000.00,0.00,9000.00,0.44,1
31083,3296,1000.00,10000.00,11000.00,0.00,10000.00,0.17,1
31084,3296,-1000.00,9000.00,10000.00,9132.11,1867.89,0.18,0
31085,3296,1000.00,10000.00,11000.00,3005.87,6994.13,0.25,1
31086,3296,-1000.00,9000.00,10000.00,0.00,4471.30,0.17,0
31087,3296,-1000.00,8000.00,9000.00,3319.82,6680.18,0.17,0
31088,3296,-1000.00,7000.00,8000.00,1244.73,7755.27,0.43,0
31089,3296,-1000.00,6000.00,7000.00,4000.00,4000.00,0.03,0
31090,3296,-1000.00,5000.00,6000.00,4188.08,2811.92,0.14,0
31091,3296,-1000.00,4000.00,5000.00,1308.60,4575.13,0.44,0
31092,3296,-1000.00,3000.00,4000.00,289.60,4710.40,0.44,0
31093,3296,-1000.00,2000.00,3000.00,276.26,3243.10,0.34,0
31094,3296,-1000.00,1000.00,2000.00,1482.37,1517.63,0.33,0
31095,3296,-1000.00,0.00,1000.00,520.50,587.00,0.12,0
31096,3296,0.00,0.00,1000.00,0.00,0.00,0.16,0
31097,3296,-889.39,-889.39,110.61,0.00,889.39,0.33,0
31098,3296,0.00,-889.39,110.61,0.00,0.00,0.18,0
31099,3296,-110.61,-1000.00,0.00,0.00,110.61,0.23,0
31100,3297,1000.00,1000.00,2000.00,297.88,592.81,0.31,1
31101,3297,1000.00,2000.00,3000.00,0.00,1333.45,0.30,1
31102,3297,1000.00,3000.00,4000.00,0.00,1929.48,0.14,1
31103,3297,-1000.00,2000.00,3000.00,2482.94,1517.06,0.06,0
31104,3297,1000.00,3000.00,4000.00,0.00,3000.00,0.24,1
31105,3297,1000.00,4000.00,5000.00,848.33,3151.67,0.31,1
31106,3297,1000.00,5000.00,6000.00,1407.35,3592.65,0.15,1
31107,3297,1000.00,6000.00,7000.00,1949.37,3658.86,0.31,1
31108,3297,1000.00,7000.00,8000.00,0.00,7000.00,0.16,1
31109,3297,1000.00,8000.00,9000.00,1314.40,6685.60,0.13,1
31110,3297,1000.00,9000.00,10000.00,0.00,9000.00,0.08,1
31111,3297,1000.00,10000.00,11000.00,0.00,9454.36,0.43,1
31112,3297,1000.00,11000.00,12000.00,5500.00,5500.00,0.04,1
31113,3297,1000.00,12000.00,13000.00,0.00,88.95,0.11,1
31114,3297,1000.00,13000.00,14000.00,0.00,4748.47,0.23,1
31115,3297,1000.00,14000.00,15000.00,0.00,8895.96,0.36,1
31116,3297,1000.00,15000.00,16000.00,5023.48,9976.52,0.06,1
31117,3297,1000.00,16000.00,17000.00,0.00,16000.00,0.20,1
31118,3297,1000.00,17000.00,18000.00,0.00,11423.83,0.37,1
31119,3297,-1000.00,16000.00,17000.00,9142.58,8857.42,0.14,0
31120,3297,1000.00,17000.00,18000.00,8500.00,8500.00,0.10,1
31121,3297,1000.00,18000.00,19000.00,3783.00,14217.00,0.19,1
31122,3297,1000.00,19000.00,20000.00,0.00,14895.57,0.39,1
31123,3297,1000.00,20000.00,21000.00,0.00,8768.76,0.22,1
31124,3297,-1000.00,19000.00,20000.00,8467.38,0.00,0.06,0
31125,3297,1000.00,20000.00,21000.00,0.00,20000.00,0.23,1
31126,3297,-1000.00,19000.00,20000.00,582.09,20417.91,0.36,0
31127,3297,-1000.00,18000.00,19000.00,0.00,14434.54,0.14,0
31128,3297,-1000.00,17000.00,18000.00,0.00,3335.73,0.39,0
31129,3297,-1000.00,16000.00,17000.00,0.00,2181.32,0.04,0
31130,3297,0.00,16000.00,17000.00,0.00,0.00,0.02,0
31131,3297,-1000.00,15000.00,16000.00,6880.55,6248.99,0.29,0
31132,3297,-1000.00,14000.00,15000.00,0.00,2423.33,0.33,0
31133,3297,-1000.00,13000.00,14000.00,0.00,15000.00,0.09,0
31134,3297,-1000.00,12000.00,13000.00,6122.36,3061.44,0.15,0
31135,3297,-1000.00,11000.00,12000.00,6862.00,6138.00,0.08,0
31136,3297,-1000.00,10000.00,11000.00,6000.00,6000.00,0.01,0
31137,3297,-1000.00,9000.00,10000.00,0.00,6765.97,0.39,0
31138,3297,-1000.00,8000.00,9000.00,0.00,10000.00,0.13,0
31139,3297,-1000.00,7000.00,8000.00,0.00,6203.33,0.38,0
31140,3297,-1000.00,6000.00,7000.00,0.00,8000.00,0.04,0
31141,3297,-1000.00,5000.00,6000.00,0.00,7000.00,0.09,0
31142,3297,-1000.00,4000.00,5000.00,1994.70,4005.30,0.35,0
31143,3297,0.00,4000.00,5000.00,0.00,0.00,0.29,0
31144,3297,-171.88,3828.12,4828.12,171.88,0.00,0.08,0
31145,3298,-1000.00,-1000.00,0.00,0.00,1000.00,0.15,0
31146,3299,0.00,0.00,1000.00,0.00,0.00,0.13,0
31147,3299,-888.79,-888.79,111.21,61.17,827.62,0.39,0
31148,3299,1000.00,111.21,1111.21,86.95,0.00,0.06,1
31149,3299,-1000.00,-888.79,111.21,223.74,887.47,0.22,0
31150,3299,-33.48,-922.27,77.73,0.00,33.48,0.33,0
31151,3299,-51.75,-974.02,25.98,0.00,51.75,0.08,0
31152,3299,0.00,-974.02,25.98,0.00,0.00,0.30,0
31153,3299,-25.98,-1000.00,0.00,12.99,12.99,0.01,0
31154,3300,-1000.00,-1000.00,0.00,181.15,818.85,0.17,0
31155,3301,1000.00,1000.00,2000.00,791.54,208.46,0.01,1
31156,3301,-1000.00,0.00,1000.00,0.00,1199.36,0.40,0
31157,3301,-923.30,-923.30,76.70,0.00,923.30,0.13,0
31158,3301,-14.33,-937.63,62.37,0.00,14.33,0.06,0
31159,3301,-52.11,-989.74,10.26,7.39,44.72,0.40,0
31160,3301,0.00,-989.74,10.26,0.00,0.00,0.26,0
31161,3301,257.94,-731.81,268.19,0.84,0.00,0.42,1
31162,3301,-177.54,-909.34,90.66,0.00,177.54,0.25,0
31163,3301,0.00,-909.34,90.66,0.00,0.00,0.05,0
31164,3301,910.29,0.95,1000.95,2.96,0.00,0.33,1
31165,3301,1000.00,1000.95,2000.95,1000.95,0.00,0.03,1
31166,3301,0.00,1000.95,2000.95,0.00,0.00,0.22,0
31167,3301,-636.96,363.99,1363.99,0.00,636.96,0.41,0
31168,3301,1000.00,1363.99,2363.99,627.86,0.00,0.27,1
31169,3301,-105.34,1258.64,2258.64,0.00,105.34,0.26,0
31170,3301,-1000.00,258.64,1258.64,792.85,1465.79,0.13,0
31171,3301,-1000.00,-741.36,258.64,0.00,91.38,0.21,0
31172,3301,-1000.00,-1741.36,-741.36,0.00,72.33,0.38,0
31173,3302,-1000.00,-1000.00,0.00,578.86,421.14,0.03,0
31174,3303,-1000.00,-1000.00,0.00,526.45,473.55,0.14,0
31175,3304,-1000.00,-1000.00,0.00,487.88,512.12,0.25,0
31176,3305,-1000.00,-1000.00,0.00,0.00,1000.00,0.10,0
31177,3306,1000.00,1000.00,2000.00,0.00,1000.00,0.04,1
31178,3306,1000.00,2000.00,3000.00,0.00,573.75,0.12,1
31179,3306,1000.00,3000.00,4000.00,0.00,2045.72,0.27,1
31180,3306,1000.00,4000.00,5000.00,2000.00,2000.00,0.09,1
31181,3306,-1000.00,3000.00,4000.00,2345.88,0.00,0.02,0
31182,3306,1000.00,4000.00,5000.00,1672.45,2327.55,0.28,1
31183,3306,1000.00,5000.00,6000.00,2500.00,2500.00,0.05,1
31184,3306,1000.00,6000.00,7000.00,0.00,5690.71,0.41,1
31185,3306,1000.00,7000.00,8000.00,3090.19,3909.81,0.19,1
31186,3306,-1000.00,6000.00,7000.00,1859.04,0.00,0.02,0
31187,3306,1000.00,7000.00,8000.00,0.00,7000.00,0.26,1
31188,3306,1000.00,8000.00,9000.00,0.00,5775.36,0.32,1
31189,3306,1000.00,9000.00,10000.00,2410.35,6589.65,0.26,1
31190,3306,1000.00,10000.00,11000.00,0.00,2422.85,0.16,1
31191,3306,1000.00,11000.00,12000.00,1822.05,9177.95,0.42,1
31192,3306,1000.00,12000.00,13000.00,542.38,11457.62,0.44,1
31193,3306,1000.00,13000.00,14000.00,0.00,13000.00,0.25,1
31194,3306,1000.00,14000.00,15000.00,4068.42,9931.58,0.36,1
31195,3306,1000.00,15000.00,16000.00,0.00,14065.41,0.14,1
31196,3306,-1000.00,14000.00,15000.00,7089.02,1713.78,0.11,0
31197,3306,1000.00,15000.00,16000.00,2553.92,9366.18,0.35,1
31198,3306,1000.00,16000.00,17000.00,6095.67,9904.33,0.31,1
31199,3306,1000.00,17000.00,18000.00,5236.35,11763.65,0.27,1
31200,3306,1000.00,18000.00,19000.00,2327.63,15672.37,0.27,1
31201,3306,1000.00,19000.00,20000.00,7944.51,11055.49,0.30,1
31202,3306,1000.00,20000.00,21000.00,0.00,5810.89,0.21,1
31203,3306,1000.00,21000.00,22000.00,0.00,21000.00,0.23,1
31204,3306,1000.00,22000.00,23000.00,0.00,22000.00,0.25,1
31205,3306,-1000.00,21000.00,22000.00,14683.09,0.00,0.03,0
31206,3306,1000.00,22000.00,23000.00,0.00,22000.00,0.16,1
31207,3306,1000.00,23000.00,24000.00,0.00,23000.00,0.04,1
31208,3306,1000.00,24000.00,25000.00,7203.53,8639.19,0.22,1
31209,3306,1000.00,25000.00,26000.00,1160.56,13356.70,0.33,1
31210,3306,1000.00,26000.00,27000.00,1133.32,24866.68,0.33,1
31211,3306,1000.00,27000.00,28000.00,0.00,4631.49,0.11,1
31212,3306,1000.00,28000.00,29000.00,0.00,28000.00,0.42,1
31213,3306,1000.00,29000.00,30000.00,0.00,28315.18,0.44,1
31214,3306,1000.00,30000.00,31000.00,0.00,18630.12,0.36,1
31215,3306,1000.00,31000.00,32000.00,0.00,31000.00,0.36,1
31216,3306,-1000.00,30000.00,31000.00,17053.48,0.00,0.10,0
31217,3306,1000.00,31000.00,32000.00,0.00,22868.87,0.40,1
31218,3307,-1000.00,-1000.00,0.00,0.00,1000.00,0.37,0
31219,3308,-1000.00,-1000.00,0.00,0.00,1000.00,0.34,0
31220,3309,-1000.00,-1000.00,0.00,165.34,834.66,0.36,0
31221,3310,-885.59,-885.59,114.41,0.00,885.59,0.34,0
31222,3310,-114.41,-1000.00,0.00,45.71,68.70,0.04,0
31223,3311,-613.21,-613.21,386.79,0.00,613.21,0.04,0
31224,3311,-153.04,-766.26,233.74,0.00,153.04,0.35,0
31225,3311,1000.00,233.74,1233.74,144.60,89.14,0.19,1
31226,3311,-1000.00,-766.26,233.74,0.00,1125.25,0.28,0
31227,3311,1000.00,233.74,1233.74,73.48,36.78,0.35,1
31228,3311,0.00,233.74,1233.74,0.00,0.00,0.08,0
31229,3311,1000.00,1233.74,2233.74,781.05,452.70,0.23,1
31230,3311,1000.00,2233.74,3233.74,213.85,0.00,0.37,1
31231,3311,-1000.00,1233.74,2233.74,192.74,1709.84,0.35,0
31232,3311,-1000.00,233.74,1233.74,117.78,1771.06,0.37,0
31233,3311,-1000.00,-766.26,233.74,275.86,957.88,0.36,0
31234,3311,-233.74,-1000.00,0.00,107.68,126.06,0.13,0
31235,3312,-1000.00,-1000.00,0.00,0.00,513.72,0.05,0
31236,3313,-1000.00,-1000.00,0.00,0.00,1000.00,0.07,0
31237,3314,-942.47,-942.47,57.53,0.00,942.47,0.42,0
31238,3314,-57.53,-1000.00,0.00,11.44,46.09,0.40,0
31239,3315,-1000.00,-1000.00,0.00,206.29,793.71,0.24,0
31240,3316,1000.00,1000.00,2000.00,361.39,638.61,0.05,1
31241,3316,1000.00,2000.00,3000.00,0.00,2000.00,0.09,1
31242,3316,1000.00,3000.00,4000.00,0.00,3000.00,0.40,1
31243,3316,1000.00,4000.00,5000.00,2000.00,2000.00,0.01,1
31244,3316,1000.00,5000.00,6000.00,0.00,3776.93,0.28,1
31245,3316,1000.00,6000.00,7000.00,636.99,1775.52,0.22,1
31246,3316,-1000.00,5000.00,6000.00,2271.72,850.26,0.13,0
31247,3316,1000.00,6000.00,7000.00,1616.12,3365.02,0.31,1
31248,3316,1000.00,7000.00,8000.00,0.00,6158.58,0.43,1
31249,3316,1000.00,8000.00,9000.00,1273.88,6726.12,0.09,1
31250,3316,-1000.00,7000.00,8000.00,4965.81,4034.19,0.15,0
31251,3316,1000.00,8000.00,9000.00,3918.60,4081.40,0.12,1
31252,3316,1000.00,9000.00,10000.00,4002.80,4997.20,0.24,1
31253,3316,1000.00,10000.00,11000.00,0.00,10000.00,0.40,1
31254,3316,1000.00,11000.00,12000.00,0.00,7342.98,0.31,1
31255,3316,-443.93,10556.07,11556.07,443.93,0.00,0.05,0
31256,3316,1000.00,11556.07,12556.07,4586.61,6969.47,0.24,1
31257,3316,-1000.00,10556.07,11556.07,10830.61,0.00,0.09,0
31258,3316,1000.00,11556.07,12556.07,0.00,11556.07,0.00,1
31259,3316,1000.00,12556.07,13556.07,2414.89,10141.18,0.32,1
31260,3316,-1000.00,11556.07,12556.07,13556.07,0.00,0.06,0
31261,3316,-1000.00,10556.07,11556.07,6367.20,6188.88,0.16,0
31262,3316,1000.00,11556.07,12556.07,0.00,2771.35,0.09,1
31263,3316,-1000.00,10556.07,11556.07,396.43,12159.64,0.17,0
31264,3316,-1000.00,9556.07,10556.07,2716.45,5882.84,0.29,0
31265,3316,-1000.00,8556.07,9556.07,421.18,10134.90,0.29,0
31266,3316,-1000.00,7556.07,8556.07,0.00,9556.07,0.42,0
31267,3316,-1000.00,6556.07,7556.07,4278.04,4278.04,0.01,0
31268,3316,-1000.00,5556.07,6556.07,3064.52,4491.56,0.13,0
31269,3316,-1000.00,4556.07,5556.07,0.00,6556.07,0.24,0
31270,3316,-1000.00,3556.07,4556.07,0.00,5556.07,0.33,0
31271,3316,-1000.00,2556.07,3556.07,0.00,1231.60,0.18,0
31272,3316,-1000.00,1556.07,2556.07,0.00,3556.07,0.22,0
31273,3316,-1000.00,556.07,1556.07,1278.04,1278.04,0.26,0
31274,3316,-681.15,-125.07,874.93,0.00,681.15,0.10,0
31275,3316,-622.73,-747.80,252.20,45.22,577.51,0.38,0
31276,3316,-225.32,-973.12,26.88,0.00,225.32,0.01,0
31277,3316,-26.88,-1000.00,0.00,0.00,26.88,0.20,0
31278,3317,-902.49,-902.49,97.51,0.00,902.49,0.15,0
31279,3317,-15.86,-918.35,81.65,0.00,15.86,0.16,0
31280,3317,-81.65,-1000.00,0.00,30.34,51.31,0.26,0
31281,3318,-1000.00,-1000.00,0.00,376.52,623.48,0.15,0
31282,3319,-1000.00,-1000.00,0.00,0.00,1000.00,0.37,0
31283,3320,-1000.00,-1000.00,0.00,642.99,357.01,0.01,0
31284,3321,1000.00,1000.00,2000.00,279.68,0.00,0.09,1
31285,3321,0.00,1000.00,2000.00,0.00,0.00,0.07,0
31286,3321,1000.00,2000.00,3000.00,2000.00,0.00,0.08,1
31287,3321,-444.81,1555.19,2555.19,0.00,444.81,0.41,0
31288,3321,1000.00,2555.19,3555.19,1876.55,0.00,0.10,1
31289,3321,1000.00,3555.19,4555.19,3105.53,449.66,0.15,1
31290,3321,-1000.00,2555.19,3555.19,0.00,1837.38,0.35,0
31291,3321,-1000.00,1555.19,2555.19,1576.77,1978.42,0.30,0
31292,3321,-1000.00,555.19,1555.19,0.00,2053.90,0.40,0
31293,3321,-810.84,-255.65,744.35,0.00,810.84,0.32,0
31294,3321,-744.35,-1000.00,0.00,274.70,469.65,0.20,0
31295,3322,-384.01,-384.01,615.99,0.00,384.01,0.24,0
31296,3322,-615.99,-1000.00,0.00,249.26,366.73,0.21,0
31297,3323,-1000.00,-1000.00,0.00,519.55,480.45,0.20,0
31298,3324,1000.00,1000.00,2000.00,330.07,669.93,0.32,1
31299,3324,1000.00,2000.00,3000.00,709.40,1290.60,0.29,1
31300,3324,1000.00,3000.00,4000.00,0.00,3000.00,0.43,1
31301,3324,0.00,3000.00,4000.00,0.00,0.00,0.06,0
31302,3324,1000.00,4000.00,5000.00,0.00,4000.00,0.22,1
31303,3324,1000.00,5000.00,6000.00,1837.78,3162.22,0.01,1
31304,3324,1000.00,6000.00,7000.00,0.00,6000.00,0.19,1
31305,3324,1000.00,7000.00,8000.00,1509.70,5490.30,0.15,1
31306,3324,1000.00,8000.00,9000.00,0.00,6209.46,0.31,1
31307,3324,1000.00,9000.00,10000.00,3043.60,3501.07,0.22,1
31308,3324,1000.00,10000.00,11000.00,0.00,10000.00,0.19,1
31309,3324,1000.00,11000.00,12000.00,2846.84,8153.16,0.38,1
31310,3324,1000.00,12000.00,13000.00,0.00,12000.00,0.36,1
31311,3324,1000.00,13000.00,14000.00,0.00,13000.00,0.35,1
31312,3324,1000.00,14000.00,15000.00,6229.31,7770.69,0.10,1
31313,3324,1000.00,15000.00,16000.00,4144.62,10855.38,0.28,1
31314,3324,1000.00,16000.00,17000.00,0.00,10186.38,0.19,1
31315,3324,1000.00,17000.00,18000.00,0.00,17000.00,0.30,1
31316,3324,1000.00,18000.00,19000.00,8449.22,9550.78,0.19,1
31317,3324,1000.00,19000.00,20000.00,0.00,18370.69,0.08,1
31318,3324,0.00,19000.00,20000.00,0.00,0.00,0.01,0
31319,3324,0.00,19000.00,20000.00,0.00,0.00,0.02,0
31320,3324,1000.00,20000.00,21000.00,0.00,11441.94,0.31,1
31321,3324,1000.00,21000.00,22000.00,5145.81,15854.19,0.36,1
31322,3324,-1000.00,20000.00,21000.00,7784.30,14215.70,0.34,0
31323,3324,-1000.00,19000.00,20000.00,0.00,21000.00,0.23,0
31324,3324,-1000.00,18000.00,19000.00,3742.36,16257.64,0.34,0
31325,3324,-1000.00,17000.00,18000.00,12918.86,6081.14,0.00,0
31326,3324,-1000.00,16000.00,17000.00,0.00,18000.00,0.36,0
31327,3324,-1000.00,15000.00,16000.00,0.00,17000.00,0.04,0
31328,3324,-1000.00,14000.00,15000.00,0.00,16000.00,0.40,0
31329,3324,-1000.00,13000.00,14000.00,0.00,8584.05,0.33,0
31330,3324,-1000.00,12000.00,13000.00,1028.06,9109.87,0.37,0
31331,3324,-1000.00,11000.00,12000.00,0.00,7824.08,0.35,0
31332,3324,-1000.00,10000.00,11000.00,3775.00,8225.00,0.32,0
31333,3324,-1000.00,9000.00,10000.00,4828.50,3520.36,0.18,0
31334,3324,-1000.00,8000.00,9000.00,124.47,9875.53,0.39,0
31335,3324,-1000.00,7000.00,8000.00,4500.00,4500.00,0.01,0
31336,3324,-1000.00,6000.00,7000.00,5851.68,2148.32,0.07,0
31337,3324,-1000.00,5000.00,6000.00,0.00,7000.00,0.06,0
31338,3324,-1000.00,4000.00,5000.00,0.00,2598.55,0.06,0
31339,3325,-1000.00,-1000.00,0.00,345.27,654.73,0.33,0
31340,3325,-0.00,-1000.00,0.00,0.00,0.00,0.12,0
31341,3325,-0.00,-1000.00,0.00,0.00,0.00,0.16,0
31342,3326,-1000.00,-1000.00,0.00,365.44,313.75,0.19,0
31343,3327,-1000.00,-1000.00,0.00,0.00,1000.00,0.09,0
31344,3328,1000.00,1000.00,2000.00,0.00,1000.00,0.32,1
31345,3328,1000.00,2000.00,3000.00,630.27,1369.73,0.33,1
31346,3328,1000.00,3000.00,4000.00,0.00,3000.00,0.37,1
31347,3328,1000.00,4000.00,5000.00,0.00,4000.00,0.10,1
31348,3328,1000.00,5000.00,6000.00,877.37,4122.63,0.40,1
31349,3328,1000.00,6000.00,7000.00,2171.65,3828.35,0.30,1
31350,3328,1000.00,7000.00,8000.00,1258.54,5741.46,0.41,1
31351,3328,1000.00,8000.00,9000.00,0.00,7054.88,0.20,1
31352,3328,1000.00,9000.00,10000.00,0.00,7665.97,0.32,1
31353,3328,1000.00,10000.00,11000.00,615.88,9384.12,0.16,1
31354,3328,1000.00,11000.00,12000.00,0.00,1559.54,0.15,1
31355,3328,1000.00,12000.00,13000.00,5439.25,6560.75,0.08,1
31356,3328,-1000.00,11000.00,12000.00,6040.98,4070.37,0.23,0
31357,3328,1000.00,12000.00,13000.00,5300.08,6699.92,0.05,1
31358,3328,1000.00,13000.00,14000.00,0.00,13000.00,0.08,1
31359,3328,1000.00,14000.00,15000.00,7000.00,7000.00,0.02,1
31360,3328,-1000.00,13000.00,14000.00,14151.99,848.01,0.02,0
31361,3328,1000.00,14000.00,15000.00,7000.00,7000.00,0.28,1
31362,3328,-1000.00,13000.00,14000.00,1658.86,0.00,0.09,0
31363,3328,1000.00,14000.00,15000.00,0.00,14000.00,0.10,1
31364,3328,1000.00,15000.00,16000.00,0.00,15000.00,0.13,1
31365,3328,1000.00,16000.00,17000.00,0.00,16000.00,0.35,1
31366,3328,1000.00,17000.00,18000.00,0.00,14371.46,0.34,1
31367,3328,-1000.00,16000.00,17000.00,9000.00,9000.00,0.21,0
31368,3328,-1000.00,15000.00,16000.00,0.00,12764.01,0.04,0
31369,3328,-1000.00,14000.00,15000.00,5493.01,10506.99,0.08,0
31370,3328,-1000.00,13000.00,14000.00,0.00,15000.00,0.30,0
31371,3328,-1000.00,12000.00,13000.00,0.00,1295.03,0.09,0
31372,3328,-1000.00,11000.00,12000.00,1133.94,11866.06,0.40,0
31373,3328,-1000.00,10000.00,11000.00,0.00,4018.09,0.05,0
31374,3328,-1000.00,9000.00,10000.00,0.00,8264.21,0.41,0
31375,3328,0.00,9000.00,10000.00,0.00,0.00,0.06,0
31376,3328,-1000.00,8000.00,9000.00,192.19,0.00,0.05,0
31377,3328,-1000.00,7000.00,8000.00,3360.14,5639.86,0.32,0
31378,3328,-1000.00,6000.00,7000.00,0.00,8000.00,0.25,0
31379,3328,-1000.00,5000.00,6000.00,0.00,6242.04,0.10,0
31380,3328,-1000.00,4000.00,5000.00,3339.84,2660.16,0.10,0
31381,3328,-1000.00,3000.00,4000.00,0.00,5000.00,0.01,0
31382,3328,-1000.00,2000.00,3000.00,230.67,3769.33,0.26,0
31383,3328,-1000.00,1000.00,2000.00,0.00,3000.00,0.20,0
31384,3328,-1000.00,0.00,1000.00,0.00,2000.00,0.21,0
31385,3328,-1000.00,-1000.00,0.00,444.55,555.45,0.13,0
31386,3329,-265.73,-265.73,734.27,12.81,252.93,0.20,0
31387,3329,-734.27,-1000.00,0.00,0.00,734.27,0.22,0
31388,3330,-1000.00,-1000.00,0.00,0.00,1000.00,0.20,0
31389,3331,-848.03,-848.03,151.97,0.00,848.03,0.43,0
31390,3331,-149.65,-997.68,2.32,0.00,149.65,0.32,0
31391,3331,-2.32,-1000.00,0.00,0.01,2.31,0.09,0
31392,3332,1000.00,1000.00,2000.00,363.82,0.00,0.09,1
31393,3332,-1000.00,0.00,1000.00,0.00,1564.26,0.22,0
31394,3332,0.00,0.00,1000.00,0.00,0.00,0.21,0
31395,3332,1000.00,1000.00,2000.00,221.11,0.00,0.33,1
31396,3332,-1000.00,0.00,1000.00,0.00,1385.34,0.04,0
31397,3332,-1000.00,-1000.00,0.00,0.00,1000.00,0.02,0
31398,3333,1000.00,1000.00,2000.00,500.00,500.00,0.01,1
31399,3333,1000.00,2000.00,3000.00,706.03,1293.97,0.03,1
31400,3333,0.00,2000.00,3000.00,0.00,0.00,0.01,0
31401,3333,1000.00,3000.00,4000.00,0.00,2964.09,0.40,1
31402,3333,1000.00,4000.00,5000.00,1792.02,2207.98,0.25,1
31403,3333,-1000.00,3000.00,4000.00,2400.67,1878.14,0.19,0
31404,3333,1000.00,4000.00,5000.00,515.74,3484.26,0.42,1
31405,3333,1000.00,5000.00,6000.00,1976.79,3023.21,0.22,1
31406,3333,1000.00,6000.00,7000.00,383.69,5616.31,0.01,1
31407,3333,1000.00,7000.00,8000.00,0.00,7000.00,0.41,1
31408,3333,-1000.00,6000.00,7000.00,5568.23,2431.77,0.10,0
31409,3333,-992.39,5007.61,6007.61,758.80,233.59,0.12,0
31410,3333,-1000.00,4007.61,5007.61,3039.96,2967.65,0.38,0
31411,3333,1000.00,5007.61,6007.61,0.00,4541.36,0.43,1
31412,3333,1000.00,6007.61,7007.61,0.00,2071.77,0.30,1
31413,3333,1000.00,7007.61,8007.61,3182.66,3824.95,0.15,1
31414,3333,1000.00,8007.61,9007.61,0.00,3462.31,0.28,1
31415,3333,1000.00,9007.61,10007.61,3604.12,4322.28,0.25,1
31416,3333,1000.00,10007.61,11007.61,0.00,4875.78,0.31,1
31417,3333,1000.00,11007.61,12007.61,0.00,8797.07,0.11,1
31418,3333,1000.00,12007.61,13007.61,0.00,12007.61,0.21,1
31419,3333,1000.00,13007.61,14007.61,2401.84,10605.77,0.31,1
31420,3333,-1000.00,12007.61,13007.61,0.00,14007.61,0.04,0
31421,3333,-1000.00,11007.61,12007.61,2890.99,3064.69,0.19,0
31422,3333,-1000.00,10007.61,11007.61,10187.50,0.00,0.02,0
31423,3333,-1000.00,9007.61,10007.61,3503.68,7503.93,0.03,0
31424,3333,0.00,9007.61,10007.61,0.00,0.00,0.03,0
31425,3333,-1000.00,8007.61,9007.61,593.00,6968.17,0.39,0
31426,3333,-1000.00,7007.61,8007.61,0.00,3924.56,0.21,0
31427,3333,-1000.00,6007.61,7007.61,4482.86,3524.75,0.28,0
31428,3333,-1000.00,5007.61,6007.61,648.37,6211.15,0.43,0
31429,3333,-1000.00,4007.61,5007.61,546.84,609.48,0.14,0
31430,3333,-1000.00,3007.61,4007.61,567.46,4440.15,0.22,0
31431,3333,-1000.00,2007.61,3007.61,0.00,2818.43,0.09,0
31432,3333,-883.52,1124.09,2124.09,0.00,883.52,0.15,0
31433,3333,-1000.00,124.09,1124.09,0.00,2124.09,0.33,0
31434,3333,-228.59,-104.51,895.49,0.00,228.59,0.23,0
31435,3333,-895.49,-1000.00,0.00,0.00,895.49,0.06,0
31436,3334,-1000.00,-1000.00,0.00,188.54,811.46,0.41,0
31437,3335,-1000.00,-1000.00,0.00,100.56,899.44,0.43,0
31438,3336,-698.29,-698.29,301.71,150.94,547.34,0.32,0
31439,3336,-301.71,-1000.00,0.00,75.99,225.72,0.35,0
31440,3337,-1000.00,-1000.00,0.00,116.39,883.61,0.42,0
31441,3338,-1000.00,-1000.00,0.00,425.56,574.44,0.22,0
31442,3339,-1000.00,-1000.00,0.00,0.00,1000.00,0.12,0
31443,3340,-649.25,-649.25,350.75,649.25,0.00,0.14,0
31444,3340,-1000.00,-1649.25,-649.25,103.48,247.27,0.06,0
31445,3341,-1000.00,-1000.00,0.00,785.29,214.71,0.02,0
31446,3342,-667.94,-667.94,332.06,0.00,667.94,0.44,0
31447,3342,1000.00,332.06,1332.06,195.70,136.37,0.16,1
31448,3342,-1000.00,-667.94,332.06,325.51,1006.55,0.38,0
31449,3342,1000.00,332.06,1332.06,234.99,84.20,0.13,1
31450,3342,-935.35,-603.28,396.72,0.00,935.35,0.31,0
31451,3342,-333.09,-936.37,63.63,9.37,323.72,0.42,0
31452,3342,-48.46,-984.84,15.16,0.00,48.46,0.11,0
31453,3342,-15.16,-1000.00,0.00,2.78,12.38,0.12,0
31454,3343,0.00,0.00,1000.00,0.00,0.00,0.04,0
31455,3343,-1000.00,-1000.00,0.00,0.00,1000.00,0.27,0
31456,3344,-625.28,-625.28,374.72,0.00,625.28,0.27,0
31457,3344,-374.72,-1000.00,0.00,0.00,374.72,0.33,0
31458,3345,-1000.00,-1000.00,0.00,0.00,806.65,0.37,0
31459,3346,-1000.00,-1000.00,0.00,0.00,1000.00,0.35,0
31460,3347,-1000.00,-1000.00,0.00,0.00,1000.00,0.04,0
31461,3348,-1000.00,-1000.00,0.00,385.92,614.08,0.25,0
31462,3349,-202.74,-202.74,797.26,8.44,194.30,0.18,0
31463,3349,-797.26,-1000.00,0.00,0.00,797.26,0.32,0
31464,3350,-1000.00,-1000.00,0.00,0.00,286.07,0.24,0
31465,3351,-1000.00,-1000.00,0.00,874.19,125.81,0.01,0
31466,3352,-1000.00,-1000.00,0.00,419.81,580.19,0.22,0
31467,3353,-233.29,-233.29,766.71,0.00,233.29,0.37,0
31468,3353,-714.34,-947.64,52.36,326.34,388.01,0.26,0
31469,3353,-27.42,-975.06,24.94,11.23,16.19,0.39,0
31470,3353,0.00,-975.06,24.94,0.00,0.00,0.19,0
31471,3353,-24.94,-1000.00,0.00,7.72,17.22,0.07,0
31472,3354,-596.31,-596.31,403.69,113.87,482.44,0.30,0
31473,3354,-403.69,-1000.00,0.00,195.67,208.02,0.08,0
31474,3355,1000.00,1000.00,2000.00,0.00,332.61,0.20,1
31475,3355,1000.00,2000.00,3000.00,0.00,1781.93,0.44,1
31476,3355,1000.00,3000.00,4000.00,0.00,2746.61,0.09,1
31477,3355,1000.00,4000.00,5000.00,0.00,4000.00,0.13,1
31478,3355,1000.00,5000.00,6000.00,1849.44,3150.56,0.22,1
31479,3355,1000.00,6000.00,7000.00,2162.74,3837.26,0.09,1
31480,3355,1000.00,7000.00,8000.00,2922.28,4077.72,0.25,1
31481,3355,1000.00,8000.00,9000.00,3558.54,4441.46,0.14,1
31482,3355,-1000.00,7000.00,8000.00,2055.81,1361.36,0.31,0
31483,3355,1000.00,8000.00,9000.00,149.08,7850.92,0.35,1
31484,3355,1000.00,9000.00,10000.00,4390.30,4609.70,0.15,1
31485,3355,1000.00,10000.00,11000.00,1147.71,4504.69,0.29,1
31486,3355,1000.00,11000.00,12000.00,0.00,11000.00,0.19,1
31487,3355,1000.00,12000.00,13000.00,0.00,9699.27,0.24,1
31488,3355,1000.00,13000.00,14000.00,3425.88,9574.12,0.05,1
31489,3355,1000.00,14000.00,15000.00,5086.20,8913.80,0.07,1
31490,3355,1000.00,15000.00,16000.00,1569.23,13430.77,0.18,1
31491,3355,1000.00,16000.00,17000.00,262.24,5921.61,0.27,1
31492,3355,-1000.00,15000.00,16000.00,16269.99,730.01,0.08,0
31493,3355,1000.00,16000.00,17000.00,0.00,12575.90,0.29,1
31494,3355,1000.00,17000.00,18000.00,1660.88,6349.39,0.25,1
31495,3355,1000.00,18000.00,19000.00,1172.09,15439.72,0.43,1
31496,3355,1000.00,19000.00,20000.00,0.00,19000.00,0.15,1
31497,3355,1000.00,20000.00,21000.00,0.00,20000.00,0.00,1
31498,3355,-1000.00,19000.00,20000.00,5761.30,15238.70,0.25,0
31499,3355,-1000.00,18000.00,19000.00,0.00,15950.31,0.39,0
31500,3355,-1000.00,17000.00,18000.00,8605.32,10394.68,0.12,0
31501,3355,-1000.00,16000.00,17000.00,5533.18,12466.82,0.06,0
31502,3355,-1000.00,15000.00,16000.00,7939.20,9060.80,0.07,0
31503,3355,-1000.00,14000.00,15000.00,7710.94,8289.06,0.24,0
31504,3355,-1000.00,13000.00,14000.00,2267.83,12732.17,0.26,0
31505,3355,-1000.00,12000.00,13000.00,0.00,14000.00,0.21,0
31506,3355,-1000.00,11000.00,12000.00,2989.96,10010.04,0.39,0
31507,3355,-1000.00,10000.00,11000.00,3256.31,8743.69,0.36,0
31508,3355,-1000.00,9000.00,10000.00,0.00,11000.00,0.23,0
31509,3355,-1000.00,8000.00,9000.00,7185.03,2314.70,0.10,0
31510,3355,-1000.00,7000.00,8000.00,4500.00,4500.00,0.13,0
31511,3355,-1000.00,6000.00,7000.00,1387.56,6612.44,0.41,0
31512,3355,-1000.00,5000.00,6000.00,1064.83,0.00,0.36,0
31513,3355,-1000.00,4000.00,5000.00,0.00,6000.00,0.29,0
31514,3355,0.00,4000.00,5000.00,0.00,0.00,0.28,0
31515,3355,1000.00,5000.00,6000.00,4187.00,0.00,0.15,1
31516,3355,1000.00,6000.00,7000.00,1760.90,509.82,0.39,1
31517,3356,0.00,0.00,1000.00,0.00,0.00,0.07,0
31518,3356,-1000.00,-1000.00,0.00,0.00,331.36,0.19,0
31519,3357,1000.00,1000.00,2000.00,221.22,778.78,0.34,1
31520,3357,1000.00,2000.00,3000.00,0.00,2000.00,0.27,1
31521,3357,1000.00,3000.00,4000.00,0.00,935.46,0.15,1
31522,3357,1000.00,4000.00,5000.00,0.00,4000.00,0.25,1
31523,3357,1000.00,5000.00,6000.00,0.00,2533.59,0.27,1
31524,3357,1000.00,6000.00,7000.00,0.00,3727.98,0.22,1
31525,3357,1000.00,7000.00,8000.00,0.00,4137.74,0.33,1
31526,3357,1000.00,8000.00,9000.00,0.00,2976.61,0.26,1
31527,3357,1000.00,9000.00,10000.00,0.00,6136.28,0.22,1
31528,3357,1000.00,10000.00,11000.00,4972.13,5027.87,0.11,1
31529,3357,1000.00,11000.00,12000.00,3244.28,7755.72,0.36,1
31530,3357,1000.00,12000.00,13000.00,0.00,6253.72,0.11,1
31531,3357,1000.00,13000.00,14000.00,0.00,13000.00,0.29,1
31532,3357,1000.00,14000.00,15000.00,0.00,13104.87,0.06,1
31533,3357,-1000.00,13000.00,14000.00,1110.76,0.00,0.05,0
31534,3357,1000.00,14000.00,15000.00,0.00,14000.00,0.11,1
31535,3357,-1000.00,13000.00,14000.00,14522.84,0.00,0.03,0
31536,3357,1000.00,14000.00,15000.00,0.00,14000.00,0.29,1
31537,3357,1000.00,15000.00,16000.00,0.00,15000.00,0.13,1
31538,3357,1000.00,16000.00,17000.00,6955.33,9044.67,0.42,1
31539,3357,1000.00,17000.00,18000.00,193.19,16806.81,0.28,1
31540,3357,-1000.00,16000.00,17000.00,10345.39,7654.61,0.27,0
31541,3357,1000.00,17000.00,18000.00,4574.20,5553.99,0.21,1
31542,3357,-1000.00,16000.00,17000.00,6386.47,2881.24,0.18,0
31543,3357,1000.00,17000.00,18000.00,7557.97,9442.03,0.18,1
31544,3357,1000.00,18000.00,19000.00,0.00,18000.00,0.35,1
31545,3357,-1000.00,17000.00,18000.00,0.00,14044.52,0.40,0
31546,3357,-1000.00,16000.00,17000.00,8874.26,2053.83,0.31,0
31547,3357,-856.36,15143.64,16143.64,856.36,0.00,0.39,0
31548,3357,-1000.00,14143.64,15143.64,0.00,13432.10,0.17,0
31549,3357,0.00,14143.64,15143.64,0.00,0.00,0.41,0
31550,3357,-1000.00,13143.64,14143.64,0.00,11240.84,0.20,0
31551,3357,-1000.00,12143.64,13143.64,9285.52,4129.28,0.22,0
31552,3357,-1000.00,11143.64,12143.64,0.00,6329.56,0.05,0
31553,3357,-1000.00,10143.64,11143.64,1321.17,10822.47,0.43,0
31554,3357,-1000.00,9143.64,10143.64,0.00,1127.69,0.12,0
31555,3357,-1000.00,8143.64,9143.64,0.00,7008.83,0.39,0
31556,3357,0.00,8143.64,9143.64,0.00,0.00,0.32,0
31557,3357,-1000.00,7143.64,8143.64,10.54,9133.11,0.01,0
31558,3357,-1000.00,6143.64,7143.64,3413.08,4730.56,0.27,0
31559,3357,-1000.00,5143.64,6143.64,2029.87,1372.35,0.17,0
31560,3357,-1000.00,4143.64,5143.64,626.45,1198.77,0.20,0
31561,3357,-1000.00,3143.64,4143.64,134.98,5008.66,0.29,0
31562,3357,-1000.00,2143.64,3143.64,2247.10,1896.55,0.20,0
31563,3357,-1000.00,1143.64,2143.64,1504.81,1638.83,0.11,0
31564,3358,0.00,0.00,1000.00,0.00,0.00,0.06,0
31565,3358,-647.17,-647.17,352.83,0.00,647.17,0.43,0
31566,3358,-352.83,-1000.00,0.00,157.09,195.74,0.03,0
31567,3359,-1000.00,-1000.00,0.00,500.00,500.00,0.02,0
31568,3360,1000.00,1000.00,2000.00,0.00,701.50,0.32,1
31569,3360,1000.00,2000.00,3000.00,0.00,2000.00,0.10,1
31570,3360,-1000.00,1000.00,2000.00,1184.56,536.07,0.15,0
31571,3360,1000.00,2000.00,3000.00,1000.00,1000.00,0.28,1
31572,3360,1000.00,3000.00,4000.00,859.92,2140.08,0.35,1
31573,3360,1000.00,4000.00,5000.00,0.00,4000.00,0.26,1
31574,3360,1000.00,5000.00,6000.00,2079.66,2920.34,0.33,1
31575,3360,1000.00,6000.00,7000.00,2759.38,3049.82,0.24,1
31576,3360,1000.00,7000.00,8000.00,0.00,4230.84,0.35,1
31577,3360,1000.00,8000.00,9000.00,0.00,7180.91,0.39,1
31578,3360,1000.00,9000.00,10000.00,0.00,5310.02,0.35,1
31579,3360,1000.00,10000.00,11000.00,0.00,4533.01,0.29,1
31580,3360,1000.00,11000.00,12000.00,0.00,11000.00,0.28,1
31581,3360,1000.00,12000.00,13000.00,2705.03,9294.97,0.31,1
31582,3360,1000.00,13000.00,14000.00,0.00,13000.00,0.29,1
31583,3360,1000.00,14000.00,15000.00,0.00,14000.00,0.35,1
31584,3360,1000.00,15000.00,16000.00,0.00,10488.13,0.05,1
31585,3360,1000.00,16000.00,17000.00,0.00,16000.00,0.16,1
31586,3360,-1000.00,15000.00,16000.00,7941.86,3367.16,0.13,0
31587,3360,1000.00,16000.00,17000.00,0.00,16000.00,0.09,1
31588,3360,0.00,16000.00,17000.00,0.00,0.00,0.02,0
31589,3360,1000.00,17000.00,18000.00,0.00,11809.46,0.18,1
31590,3360,1000.00,18000.00,19000.00,0.00,18000.00,0.01,1
31591,3360,1000.00,19000.00,20000.00,0.00,18474.81,0.43,1
31592,3360,1000.00,20000.00,21000.00,6698.54,13165.21,0.37,1
31593,3360,1000.00,21000.00,22000.00,0.00,21000.00,0.25,1
31594,3360,1000.00,22000.00,23000.00,0.00,20349.09,0.09,1
31595,3360,1000.00,23000.00,24000.00,3959.00,16254.71,0.38,1
31596,3360,1000.00,24000.00,25000.00,9130.61,14869.39,0.39,1
31597,3360,-1000.00,23000.00,24000.00,17137.26,7862.74,0.10,0
31598,3360,1000.00,24000.00,25000.00,0.00,24000.00,0.43,1
31599,3360,1000.00,25000.00,26000.00,0.00,25000.00,0.11,1
31600,3360,1000.00,26000.00,27000.00,3864.28,22135.72,0.42,1
31601,3360,1000.00,27000.00,28000.00,0.00,27000.00,0.12,1
31602,3360,1000.00,28000.00,29000.00,0.00,28000.00,0.12,1
31603,3360,1000.00,29000.00,30000.00,11496.72,17503.28,0.08,1
31604,3360,1000.00,30000.00,31000.00,0.00,30000.00,0.10,1
31605,3360,1000.00,31000.00,32000.00,0.00,31000.00,0.28,1
31606,3360,1000.00,32000.00,33000.00,0.00,15748.28,0.09,1
31607,3360,1000.00,33000.00,34000.00,10347.18,22652.82,0.23,1
31608,3360,1000.00,34000.00,35000.00,0.00,34000.00,0.05,1
31609,3361,-1000.00,-1000.00,0.00,0.00,1000.00,0.20,0
31610,3362,-1000.00,-1000.00,0.00,0.00,1000.00,0.39,0
31611,3363,-1000.00,-1000.00,0.00,0.00,1000.00,0.19,0
31612,3364,-1000.00,-1000.00,0.00,0.00,761.87,0.32,0
31613,3365,1000.00,1000.00,2000.00,454.59,545.41,0.12,1
31614,3365,1000.00,2000.00,3000.00,78.45,140.30,0.13,1
31615,3365,1000.00,3000.00,4000.00,989.97,2010.03,0.31,1
31616,3365,1000.00,4000.00,5000.00,0.00,1909.17,0.27,1
31617,3365,1000.00,5000.00,6000.00,14.14,2936.60,0.35,1
31618,3365,1000.00,6000.00,7000.00,0.00,2564.20,0.27,1
31619,3365,1000.00,7000.00,8000.00,621.72,5402.22,0.41,1
31620,3365,-1000.00,6000.00,7000.00,7316.71,683.29,0.04,0
31621,3365,1000.00,7000.00,8000.00,487.39,6512.61,0.44,1
31622,3365,0.00,7000.00,8000.00,0.00,0.00,0.05,0
31623,3365,1000.00,8000.00,9000.00,0.00,7023.42,0.43,1
31624,3365,1000.00,9000.00,10000.00,2864.31,4051.15,0.26,1
31625,3365,-1000.00,8000.00,9000.00,7305.17,2694.83,0.09,0
31626,3365,1000.00,9000.00,10000.00,4154.55,4845.45,0.19,1
31627,3365,1000.00,10000.00,11000.00,0.00,10000.00,0.10,1
31628,3365,1000.00,11000.00,12000.00,0.00,5718.33,0.06,1
31629,3365,-1000.00,10000.00,11000.00,6259.40,0.00,0.03,0
31630,3365,1000.00,11000.00,12000.00,0.00,11000.00,0.23,1
31631,3365,1000.00,12000.00,13000.00,0.00,8313.81,0.05,1
31632,3365,1000.00,13000.00,14000.00,0.00,6252.30,0.31,1
31633,3365,1000.00,14000.00,15000.00,2449.03,5169.99,0.25,1
31634,3365,1000.00,15000.00,16000.00,7500.00,7500.00,0.24,1
31635,3365,1000.00,16000.00,17000.00,0.00,16000.00,0.00,1
31636,3365,1000.00,17000.00,18000.00,3786.82,13213.18,0.20,1
31637,3365,1000.00,18000.00,19000.00,2494.02,15505.98,0.27,1
31638,3365,-1000.00,17000.00,18000.00,12080.04,6919.96,0.01,0
31639,3365,1000.00,18000.00,19000.00,0.00,18000.00,0.41,1
31640,3365,-1000.00,17000.00,18000.00,7414.16,3587.28,0.14,0
31641,3365,1000.00,18000.00,19000.00,6994.28,11005.72,0.19,1
31642,3365,1000.00,19000.00,20000.00,0.00,4952.79,0.02,1
31643,3365,1000.00,20000.00,21000.00,0.00,8494.16,0.11,1
31644,3365,1000.00,21000.00,22000.00,4057.61,16942.39,0.29,1
31645,3365,1000.00,22000.00,23000.00,5191.92,16808.08,0.39,1
31646,3365,-1000.00,21000.00,22000.00,13420.28,9579.72,0.31,0
31647,3365,1000.00,22000.00,23000.00,9713.93,12286.07,0.19,1
31648,3365,1000.00,23000.00,24000.00,6707.82,16292.18,0.19,1
31649,3365,1000.00,24000.00,25000.00,0.00,18106.12,0.27,1
31650,3365,1000.00,25000.00,26000.00,0.00,25000.00,0.12,1
31651,3365,1000.00,26000.00,27000.00,0.00,26000.00,0.18,1
31652,3365,1000.00,27000.00,28000.00,6023.02,20976.98,0.38,1
31653,3366,-1000.00,-1000.00,0.00,157.51,0.00,0.00,0
31654,3367,-1000.00,-1000.00,0.00,0.00,1000.00,0.33,0
31655,3368,-1000.00,-1000.00,0.00,500.00,500.00,0.01,0
31656,3369,-1000.00,-1000.00,0.00,0.00,118.28,0.33,0
31657,3370,1000.00,1000.00,2000.00,0.00,474.57,0.05,1
31658,3370,-1000.00,0.00,1000.00,1507.73,492.27,0.04,0
31659,3370,1000.00,1000.00,2000.00,0.00,1000.00,0.11,1
31660,3370,1000.00,2000.00,3000.00,0.00,1163.28,0.25,1
31661,3370,1000.00,3000.00,4000.00,849.45,2150.55,0.17,1
31662,3370,1000.00,4000.00,5000.00,0.00,1581.68,0.00,1
31663,3370,1000.00,5000.00,6000.00,2332.71,2667.29,0.20,1
31664,3370,1000.00,6000.00,7000.00,0.00,5095.52,0.06,1
31665,3370,1000.00,7000.00,8000.00,0.00,4056.73,0.10,1
31666,3370,1000.00,8000.00,9000.00,3228.37,4771.63,0.29,1
31667,3370,1000.00,9000.00,10000.00,4500.00,4500.00,0.02,1
31668,3370,1000.00,10000.00,11000.00,3770.23,6229.77,0.11,1
31669,3370,1000.00,11000.00,12000.00,0.00,11000.00,0.43,1
31670,3370,1000.00,12000.00,13000.00,6000.00,6000.00,0.02,1
31671,3370,1000.00,13000.00,14000.00,0.00,3922.81,0.08,1
31672,3370,1000.00,14000.00,15000.00,7000.00,7000.00,0.36,1
31673,3370,-1000.00,13000.00,14000.00,13925.25,1074.75,0.03,0
31674,3370,1000.00,14000.00,15000.00,7000.00,7000.00,0.15,1
31675,3370,1000.00,15000.00,16000.00,3338.85,11617.17,0.39,1
31676,3370,1000.00,16000.00,17000.00,8000.00,8000.00,0.19,1
31677,3370,-1000.00,15000.00,16000.00,13330.78,3669.22,0.05,0
31678,3370,1000.00,16000.00,17000.00,0.00,16000.00,0.13,1
31679,3370,1000.00,17000.00,18000.00,0.00,12622.40,0.40,1
31680,3370,1000.00,18000.00,19000.00,6520.50,11479.50,0.27,1
31681,3370,-1000.00,17000.00,18000.00,9761.54,4576.97,0.14,0
31682,3370,1000.00,18000.00,19000.00,0.00,17602.58,0.42,1
31683,3370,1000.00,19000.00,20000.00,0.00,19000.00,0.37,1
31684,3370,1000.00,20000.00,21000.00,441.25,19558.75,0.39,1
31685,3370,0.00,20000.00,21000.00,0.00,0.00,0.03,0
31686,3370,1000.00,21000.00,22000.00,0.00,19956.71,0.42,1
31687,3370,1000.00,22000.00,23000.00,4850.96,17149.04,0.40,1
31688,3370,0.00,22000.00,23000.00,0.00,0.00,0.05,0
31689,3370,1000.00,23000.00,24000.00,0.00,23000.00,0.13,1
31690,3370,1000.00,24000.00,25000.00,0.00,17295.44,0.20,1
31691,3370,1000.00,25000.00,26000.00,4470.72,20529.28,0.23,1
31692,3370,1000.00,26000.00,27000.00,10280.96,15719.04,0.04,1
31693,3370,1000.00,27000.00,28000.00,9451.90,17548.10,0.27,1
31694,3370,1000.00,28000.00,29000.00,0.00,28000.00,0.32,1
31695,3370,1000.00,29000.00,30000.00,0.00,20671.69,0.32,1
31696,3371,-1000.00,-1000.00,0.00,466.96,533.04,0.21,0
31697,3372,0.00,0.00,1000.00,0.00,0.00,0.05,0
31698,3372,-875.65,-875.65,124.35,459.52,416.13,0.21,0
31699,3372,1000.00,124.35,1124.35,0.00,66.84,0.16,1
31700,3372,1000.00,1124.35,2124.35,402.34,722.01,0.14,1
31701,3372,-1000.00,124.35,1124.35,1106.73,1017.62,0.07,0
31702,3372,1000.00,1124.35,2124.35,376.30,701.39,0.36,1
31703,3372,1000.00,2124.35,3124.35,0.00,2124.35,0.35,1
31704,3372,1000.00,3124.35,4124.35,0.00,1919.43,0.28,1
31705,3372,1000.00,4124.35,5124.35,1764.76,2359.59,0.40,1
31706,3372,1000.00,5124.35,6124.35,0.00,5124.35,0.32,1
31707,3372,1000.00,6124.35,7124.35,0.00,6124.35,0.16,1
31708,3372,1000.00,7124.35,8124.35,2136.31,4988.03,0.33,1
31709,3372,1000.00,8124.35,9124.35,309.90,7814.45,0.44,1
31710,3372,1000.00,9124.35,10124.35,0.00,9074.87,0.08,1
31711,3372,1000.00,10124.35,11124.35,5062.17,5062.17,0.25,1
31712,3372,1000.00,11124.35,12124.35,0.00,11124.35,0.24,1
31713,3372,-1000.00,10124.35,11124.35,7481.29,0.00,0.02,0
31714,3372,1000.00,11124.35,12124.35,0.00,11124.35,0.24,1
31715,3372,1000.00,12124.35,13124.35,6062.17,6062.17,0.43,1
31716,3372,1000.00,13124.35,14124.35,0.00,667.21,0.04,1
31717,3372,1000.00,14124.35,15124.35,138.77,7496.62,0.33,1
31718,3372,1000.00,15124.35,16124.35,0.00,13330.70,0.19,1
31719,3372,1000.00,16124.35,17124.35,0.00,5369.85,0.23,1
31720,3372,1000.00,17124.35,18124.35,8562.17,8562.17,0.02,1
31721,3372,0.00,17124.35,18124.35,0.00,0.00,0.01,0
31722,3372,1000.00,18124.35,19124.35,8031.74,10092.61,0.09,1
31723,3372,1000.00,19124.35,20124.35,0.00,15140.29,0.41,1
31724,3372,1000.00,20124.35,21124.35,5579.99,14544.36,0.15,1
31725,3372,1000.00,21124.35,22124.35,0.00,12121.46,0.32,1
31726,3372,1000.00,22124.35,23124.35,2030.80,18868.26,0.42,1
31727,3372,1000.00,23124.35,24124.35,0.00,19197.67,0.32,1
31728,3372,1000.00,24124.35,25124.35,0.00,24124.35,0.41,1
31729,3372,-1000.00,23124.35,24124.35,14992.14,7300.28,0.13,0
31730,3372,1000.00,24124.35,25124.35,8632.17,15492.18,0.29,1
31731,3372,1000.00,25124.35,26124.35,12562.17,12562.17,0.40,1
31732,3372,-1000.00,24124.35,25124.35,13290.71,12833.64,0.14,0
31733,3372,1000.00,25124.35,26124.35,0.00,13340.44,0.30,1
31734,3372,-1000.00,24124.35,25124.35,18434.38,7689.97,0.01,0
31735,3372,0.00,24124.35,25124.35,0.00,0.00,0.09,0
31736,3372,1000.00,25124.35,26124.35,600.73,13401.68,0.11,1
31737,3372,1000.00,26124.35,27124.35,0.00,17722.50,0.23,1
31738,3373,-1000.00,-1000.00,0.00,0.00,1000.00,0.18,0
31739,3374,-240.00,-240.00,760.00,0.00,240.00,0.40,0
31740,3374,0.00,-240.00,760.00,0.00,0.00,0.22,0
31741,3374,1000.00,760.00,1760.00,247.17,0.00,0.31,1
31742,3374,0.00,760.00,1760.00,0.00,0.00,0.24,0
31743,3374,0.00,760.00,1760.00,0.00,0.00,0.33,0
31744,3374,1000.00,1760.00,2760.00,1080.73,162.42,0.26,1
31745,3374,0.00,1760.00,2760.00,0.00,0.00,0.28,0
31746,3374,1000.00,2760.00,3760.00,2246.98,310.24,0.15,1
31747,3374,-1000.00,1760.00,2760.00,0.00,2723.88,0.07,0
31748,3374,-728.58,1031.42,2031.42,0.00,728.58,0.39,0
31749,3374,1000.00,2031.42,3031.42,1362.75,0.00,0.20,1
31750,3374,1000.00,3031.42,4031.42,2239.15,0.00,0.05,1
31751,3374,0.00,3031.42,4031.42,0.00,0.00,0.21,0
31752,3374,-1000.00,2031.42,3031.42,847.72,3183.70,0.38,0
31753,3374,-1000.00,1031.42,2031.42,0.00,3031.42,0.03,0
31754,3374,-1000.00,31.42,1031.42,763.34,1268.08,0.06,0
31755,3374,1000.00,1031.42,2031.42,620.10,0.00,0.07,1
31756,3374,0.00,1031.42,2031.42,0.00,0.00,0.06,0
31757,3374,1000.00,2031.42,3031.42,2031.42,0.00,0.07,1
31758,3374,-1000.00,1031.42,2031.42,606.92,2318.77,0.39,0
31759,3374,-1000.00,31.42,1031.42,0.00,1458.17,0.37,0
31760,3374,-394.11,-362.69,637.31,90.95,303.16,0.39,0
31761,3374,-637.31,-1000.00,0.00,82.51,554.80,0.39,0
31762,3375,1000.00,1000.00,2000.00,0.00,933.51,0.24,1
31763,3375,1000.00,2000.00,3000.00,0.00,2000.00,0.01,1
31764,3375,-1000.00,1000.00,2000.00,2623.41,376.59,0.11,0
31765,3375,1000.00,2000.00,3000.00,751.30,1248.70,0.41,1
31766,3375,1000.00,3000.00,4000.00,1500.00,1500.00,0.03,1
31767,3375,1000.00,4000.00,5000.00,645.43,3354.57,0.41,1
31768,3375,1000.00,5000.00,6000.00,0.00,3879.46,0.37,1
31769,3375,-1000.00,4000.00,5000.00,4649.06,521.37,0.13,0
31770,3375,1000.00,5000.00,6000.00,2484.86,2515.14,0.19,1
31771,3375,1000.00,6000.00,7000.00,1441.85,4558.15,0.39,1
31772,3375,1000.00,7000.00,8000.00,242.96,6757.04,0.32,1
31773,3375,1000.00,8000.00,9000.00,0.00,5193.64,0.32,1
31774,3375,1000.00,9000.00,10000.00,0.00,9000.00,0.11,1
31775,3375,1000.00,10000.00,11000.00,372.70,4815.12,0.30,1
31776,3375,1000.00,11000.00,12000.00,3846.67,7153.33,0.27,1
31777,3375,1000.00,12000.00,13000.00,6000.00,6000.00,0.33,1
31778,3375,1000.00,13000.00,14000.00,0.00,13000.00,0.03,1
31779,3375,-1000.00,12000.00,13000.00,11247.62,2752.38,0.12,0
31780,3375,1000.00,13000.00,14000.00,4898.24,8101.76,0.20,1
31781,3375,1000.00,14000.00,15000.00,6790.44,7209.56,0.22,1
31782,3375,-1000.00,13000.00,14000.00,10974.41,2259.16,0.08,0
31783,3375,1000.00,14000.00,15000.00,6942.28,7057.72,0.32,1
31784,3375,1000.00,15000.00,16000.00,0.00,957.35,0.06,1
31785,3375,1000.00,16000.00,17000.00,0.00,1745.73,0.14,1
31786,3375,1000.00,17000.00,18000.00,663.11,7586.99,0.29,1
31787,3375,1000.00,18000.00,19000.00,2614.84,11099.00,0.35,1
31788,3375,1000.00,19000.00,20000.00,0.00,14903.20,0.41,1
31789,3375,1000.00,20000.00,21000.00,0.00,14979.93,0.40,1
31790,3375,1000.00,21000.00,22000.00,0.00,21000.00,0.05,1
31791,3375,1000.00,22000.00,23000.00,9936.01,12063.99,0.24,1
31792,3375,1000.00,23000.00,24000.00,0.00,23000.00,0.09,1
31793,3375,1000.00,24000.00,25000.00,8672.93,15327.07,0.05,1
31794,3375,1000.00,25000.00,26000.00,0.00,11773.82,0.30,1
31795,3375,1000.00,26000.00,27000.00,11555.10,14444.90,0.12,1
31796,3375,1000.00,27000.00,28000.00,0.00,27000.00,0.19,1
31797,3375,-1000.00,26000.00,27000.00,18143.69,9856.31,0.31,0
31798,3375,1000.00,27000.00,28000.00,13500.00,13500.00,0.07,1
31799,3375,1000.00,28000.00,29000.00,6878.60,21121.40,0.20,1
31800,3375,1000.00,29000.00,30000.00,0.00,29000.00,0.06,1
31801,3375,1000.00,30000.00,31000.00,0.00,23460.81,0.41,1
31802,3375,1000.00,31000.00,32000.00,4292.06,26707.94,0.15,1
31803,3375,1000.00,32000.00,33000.00,16000.00,16000.00,0.07,1
31804,3375,-1000.00,31000.00,32000.00,10590.74,8843.64,0.18,0
31805,3375,1000.00,32000.00,33000.00,0.00,17490.51,0.16,1
31806,3375,1000.00,33000.00,34000.00,0.00,33000.00,0.20,1
31807,3376,1000.00,1000.00,2000.00,0.00,787.57,0.39,1
31808,3376,1000.00,2000.00,3000.00,1000.00,1000.00,0.10,1
31809,3376,1000.00,3000.00,4000.00,0.00,2286.30,0.39,1
31810,3376,1000.00,4000.00,5000.00,1022.85,2977.15,0.01,1
31811,3376,1000.00,5000.00,6000.00,379.58,4620.42,0.37,1
31812,3376,1000.00,6000.00,7000.00,654.69,5345.31,0.19,1
31813,3376,1000.00,7000.00,8000.00,790.02,2009.05,0.21,1
31814,3376,1000.00,8000.00,9000.00,0.00,8000.00,0.12,1
31815,3376,1000.00,9000.00,10000.00,0.00,4206.06,0.25,1
31816,3376,1000.00,10000.00,11000.00,67.34,9932.66,0.43,1
31817,3376,1000.00,11000.00,12000.00,3238.31,7761.69,0.36,1
31818,3376,1000.00,12000.00,13000.00,6000.00,6000.00,0.01,1
31819,3376,1000.00,13000.00,14000.00,0.00,13000.00,0.35,1
31820,3376,1000.00,14000.00,15000.00,0.00,14000.00,0.43,1
31821,3376,1000.00,15000.00,16000.00,6220.00,8780.00,0.37,1
31822,3376,1000.00,16000.00,17000.00,5456.10,5968.74,0.22,1
31823,3376,1000.00,17000.00,18000.00,0.00,9858.91,0.35,1
31824,3376,-1000.00,16000.00,17000.00,17315.81,684.19,0.02,0
31825,3376,1000.00,17000.00,18000.00,0.00,6622.49,0.26,1
31826,3376,-1000.00,16000.00,17000.00,8255.26,7927.49,0.21,0
31827,3376,1000.00,17000.00,18000.00,0.00,10391.43,0.33,1
31828,3376,1000.00,18000.00,19000.00,5999.02,12000.98,0.03,1
31829,3376,-1000.00,17000.00,18000.00,10433.50,8566.50,0.19,0
31830,3376,1000.00,18000.00,19000.00,0.00,18000.00,0.16,1
31831,3376,-1000.00,17000.00,18000.00,5549.27,665.38,0.11,0
31832,3376,1000.00,18000.00,19000.00,8408.54,9591.46,0.23,1
31833,3376,1000.00,19000.00,20000.00,0.00,19000.00,0.42,1
31834,3376,1000.00,20000.00,21000.00,0.00,20000.00,0.04,1
31835,3376,-1000.00,19000.00,20000.00,8397.07,1458.99,0.11,0
31836,3376,1000.00,20000.00,21000.00,87.41,19912.59,0.38,1
31837,3376,1000.00,21000.00,22000.00,0.00,19757.64,0.43,1
31838,3376,1000.00,22000.00,23000.00,10541.49,11458.51,0.14,1
31839,3376,1000.00,23000.00,24000.00,670.96,22329.04,0.09,1
31840,3376,1000.00,24000.00,25000.00,0.00,17234.68,0.38,1
31841,3376,1000.00,25000.00,26000.00,7709.02,17290.98,0.35,1
31842,3376,1000.00,26000.00,27000.00,0.00,8235.52,0.01,1
31843,3376,-1000.00,25000.00,26000.00,14623.50,12376.50,0.19,0
31844,3376,1000.00,26000.00,27000.00,12293.77,13706.23,0.14,1
31845,3376,1000.00,27000.00,28000.00,93.54,16707.78,0.36,1
31846,3376,1000.00,28000.00,29000.00,2607.01,25392.99,0.23,1
31847,3376,-1000.00,27000.00,28000.00,18162.33,10837.67,0.24,0
31848,3376,1000.00,28000.00,29000.00,0.00,11863.97,0.28,1
31849,3376,1000.00,29000.00,30000.00,0.00,21761.11,0.38,1
31850,3377,1000.00,1000.00,2000.00,30.88,0.00,0.10,1
31851,3377,1000.00,2000.00,3000.00,855.97,0.00,0.19,1
31852,3377,1000.00,3000.00,4000.00,392.32,0.00,0.24,1
31853,3377,-1000.00,2000.00,3000.00,2000.00,2000.00,0.03,0
31854,3377,1000.00,3000.00,4000.00,2295.30,334.85,0.07,1
31855,3377,-1000.00,2000.00,3000.00,1659.98,2340.02,0.11,0
31856,3377,-1000.00,1000.00,2000.00,699.20,2300.80,0.16,0
31857,3377,-1000.00,0.00,1000.00,0.00,1451.76,0.23,0
31858,3377,-1000.00,-1000.00,0.00,148.11,851.89,0.15,0
31859,3377,-0.00,-1000.00,0.00,0.00,0.00,0.39,0
31860,3377,0.00,-1000.00,0.00,0.00,0.00,0.02,1
31861,3377,-0.00,-1000.00,0.00,0.00,0.00,0.36,0
31862,3377,0.00,-1000.00,0.00,0.00,0.00,0.02,1
31863,3377,-0.00,-1000.00,0.00,0.00,0.00,0.18,0
31864,3378,1000.00,1000.00,2000.00,15.21,337.47,0.24,1
31865,3378,1000.00,2000.00,3000.00,0.00,1982.72,0.31,1
31866,3378,-1000.00,1000.00,2000.00,1397.73,1138.20,0.19,0
31867,3378,1000.00,2000.00,3000.00,1000.00,1000.00,0.07,1
31868,3378,1000.00,3000.00,4000.00,1006.94,1993.06,0.09,1
31869,3378,1000.00,4000.00,5000.00,0.00,4000.00,0.03,1
31870,3378,1000.00,5000.00,6000.00,0.00,1430.24,0.21,1
31871,3378,-1000.00,4000.00,5000.00,3755.70,2244.30,0.14,0
31872,3378,1000.00,5000.00,6000.00,0.00,5000.00,0.02,1
31873,3378,1000.00,6000.00,7000.00,1773.13,3883.79,0.33,1
31874,3378,1000.00,7000.00,8000.00,0.00,5667.55,0.24,1
31875,3378,1000.00,8000.00,9000.00,122.90,7877.10,0.38,1
31876,3378,1000.00,9000.00,10000.00,0.00,9000.00,0.03,1
31877,3378,1000.00,10000.00,11000.00,3073.16,5073.67,0.28,1
31878,3378,1000.00,11000.00,12000.00,0.00,11000.00,0.11,1
31879,3378,-1000.00,10000.00,11000.00,9661.15,2338.85,0.18,0
31880,3378,1000.00,11000.00,12000.00,1644.35,6657.57,0.35,1
31881,3378,1000.00,12000.00,13000.00,4037.78,7962.22,0.26,1
31882,3378,1000.00,13000.00,14000.00,0.00,2436.48,0.16,1
31883,3378,1000.00,14000.00,15000.00,0.00,14000.00,0.02,1
31884,3378,1000.00,15000.00,16000.00,1117.55,13143.31,0.43,1
31885,3378,1000.00,16000.00,17000.00,143.57,15856.43,0.25,1
31886,3378,1000.00,17000.00,18000.00,0.00,8065.21,0.05,1
31887,3378,1000.00,18000.00,19000.00,0.00,18000.00,0.14,1
31888,3378,-1000.00,17000.00,18000.00,2391.64,6227.42,0.23,0
31889,3378,-1000.00,16000.00,17000.00,2859.02,8060.81,0.32,0
31890,3378,-1000.00,15000.00,16000.00,0.00,13996.80,0.15,0
31891,3378,-1000.00,14000.00,15000.00,0.00,2018.18,0.42,0
31892,3378,-1000.00,13000.00,14000.00,0.00,15000.00,0.05,0
31893,3378,-1000.00,12000.00,13000.00,303.07,10396.90,0.21,0
31894,3378,-1000.00,11000.00,12000.00,0.00,13000.00,0.01,0
31895,3378,-1000.00,10000.00,11000.00,0.00,12000.00,0.00,0
31896,3378,-1000.00,9000.00,10000.00,4932.57,6067.43,0.42,0
31897,3378,-1000.00,8000.00,9000.00,0.00,10000.00,0.04,0
31898,3379,-1000.00,-1000.00,0.00,0.00,1000.00,0.31,0
31899,3380,1000.00,1000.00,2000.00,0.00,1000.00,0.32,1
31900,3380,1000.00,2000.00,3000.00,434.00,1566.00,0.20,1
31901,3380,1000.00,3000.00,4000.00,646.99,1792.86,0.33,1
31902,3380,1000.00,4000.00,5000.00,442.69,1764.88,0.28,1
31903,3380,1000.00,5000.00,6000.00,1106.25,3893.75,0.37,1
31904,3380,1000.00,6000.00,7000.00,3000.00,3000.00,0.40,1
31905,3380,0.00,6000.00,7000.00,0.00,0.00,0.05,0
31906,3380,1000.00,7000.00,8000.00,0.00,7000.00,0.13,1
31907,3380,1000.00,8000.00,9000.00,2632.54,5367.46,0.33,1
31908,3380,1000.00,9000.00,10000.00,3945.08,5054.92,0.34,1
31909,3380,1000.00,10000.00,11000.00,3787.57,5356.04,0.27,1
31910,3380,1000.00,11000.00,12000.00,0.00,5323.86,0.27,1
31911,3380,-1000.00,10000.00,11000.00,5643.91,0.00,0.05,0
31912,3380,1000.00,11000.00,12000.00,0.00,11000.00,0.36,1
31913,3380,1000.00,12000.00,13000.00,4928.18,7071.82,0.22,1
31914,3380,1000.00,13000.00,14000.00,6500.00,6500.00,0.09,1
31915,3380,1000.00,14000.00,15000.00,984.12,12637.41,0.43,1
31916,3380,1000.00,15000.00,16000.00,5177.68,9822.32,0.29,1
31917,3380,1000.00,16000.00,17000.00,1647.30,10885.87,0.38,1
31918,3380,-1000.00,15000.00,16000.00,8708.41,8291.59,0.44,0
31919,3380,0.00,15000.00,16000.00,0.00,0.00,0.07,0
31920,3380,1000.00,16000.00,17000.00,0.00,10497.08,0.35,1
31921,3380,1000.00,17000.00,18000.00,2362.65,14637.35,0.38,1
31922,3380,-1000.00,16000.00,17000.00,9000.00,9000.00,0.31,0
31923,3380,-1000.00,15000.00,16000.00,0.00,13907.06,0.28,0
31924,3380,-1000.00,14000.00,15000.00,0.00,16000.00,0.03,0
31925,3380,-1000.00,13000.00,14000.00,0.00,13677.41,0.22,0
31926,3380,-1000.00,12000.00,13000.00,7000.00,7000.00,0.04,0
31927,3380,-1000.00,11000.00,12000.00,0.00,6693.11,0.17,0
31928,3380,-1000.00,10000.00,11000.00,0.00,12000.00,0.34,0
31929,3380,-1000.00,9000.00,10000.00,0.00,11000.00,0.40,0
31930,3380,-1000.00,8000.00,9000.00,4251.96,5748.04,0.20,0
31931,3380,-1000.00,7000.00,8000.00,0.00,9000.00,0.35,0
31932,3380,-1000.00,6000.00,7000.00,3507.51,4492.49,0.23,0
31933,3380,-1000.00,5000.00,6000.00,0.00,7000.00,0.42,0
31934,3380,-1000.00,4000.00,5000.00,3000.00,3000.00,0.05,0
31935,3380,-1000.00,3000.00,4000.00,1466.88,3533.12,0.35,0
31936,3380,-1000.00,2000.00,3000.00,916.18,3083.82,0.18,0
31937,3380,-1000.00,1000.00,2000.00,628.34,1759.11,0.33,0
31938,3380,-1000.00,0.00,1000.00,0.00,1976.50,0.40,0
31939,3380,-1000.00,-1000.00,0.00,0.00,1000.00,0.36,0
31940,3381,-1000.00,-1000.00,0.00,0.00,1000.00,0.28,0
31941,3382,-1000.00,-1000.00,0.00,1000.00,0.00,0.02,0
31942,3383,-1000.00,-1000.00,0.00,379.22,620.78,0.02,0
31943,3384,0.00,0.00,1000.00,0.00,0.00,0.05,0
31944,3384,-724.77,-724.77,275.23,0.00,724.77,0.23,0
31945,3384,-275.23,-1000.00,0.00,0.00,275.23,0.16,0
31946,3385,-1000.00,-1000.00,0.00,141.34,858.66,0.36,0
31947,3386,-1000.00,-1000.00,0.00,0.00,1000.00,0.20,0
31948,3387,-703.42,-703.42,296.58,0.00,703.42,0.38,0
31949,3387,0.00,-703.42,296.58,0.00,0.00,0.01,0
31950,3387,-296.58,-1000.00,0.00,0.00,296.58,0.00,0
31951,3388,1000.00,1000.00,2000.00,0.00,1000.00,0.25,1
31952,3388,1000.00,2000.00,3000.00,0.00,1580.92,0.40,1
31953,3388,1000.00,3000.00,4000.00,1427.43,1572.57,0.10,1
31954,3388,1000.00,4000.00,5000.00,1240.52,2759.48,0.25,1
31955,3388,1000.00,5000.00,6000.00,0.00,5000.00,0.31,1
31956,3388,1000.00,6000.00,7000.00,0.00,6000.00,0.43,1
31957,3388,1000.00,7000.00,8000.00,3500.00,3500.00,0.02,1
31958,3388,1000.00,8000.00,9000.00,0.00,679.12,0.14,1
31959,3388,1000.00,9000.00,10000.00,0.00,9000.00,0.10,1
31960,3388,1000.00,10000.00,11000.00,3425.00,6575.00,0.42,1
31961,3388,1000.00,11000.00,12000.00,0.00,11000.00,0.38,1
31962,3388,1000.00,12000.00,13000.00,4074.09,7925.91,0.37,1
31963,3388,1000.00,13000.00,14000.00,4283.49,8716.51,0.02,1
31964,3388,1000.00,14000.00,15000.00,0.00,4955.78,0.25,1
31965,3388,1000.00,15000.00,16000.00,0.00,15000.00,0.04,1
31966,3388,-114.32,14885.68,15885.68,114.32,0.00,0.06,0
31967,3388,1000.00,15885.68,16885.68,7942.84,7942.84,0.09,1
31968,3388,-1000.00,14885.68,15885.68,11435.18,4680.05,0.11,0
31969,3388,1000.00,15885.68,16885.68,0.00,15885.68,0.22,1
31970,3388,1000.00,16885.68,17885.68,0.00,16885.68,0.09,1
31971,3388,-1000.00,15885.68,16885.68,11493.57,0.00,0.08,0
31972,3388,1000.00,16885.68,17885.68,0.00,2921.66,0.10,1
31973,3388,1000.00,17885.68,18885.68,0.00,17885.68,0.19,1
31974,3388,1000.00,18885.68,19885.68,5897.18,12988.50,0.33,1
31975,3388,-1000.00,17885.68,18885.68,10955.69,8929.99,0.06,0
31976,3388,-1000.00,16885.68,17885.68,0.00,5900.85,0.06,0
31977,3388,-1000.00,15885.68,16885.68,0.00,17885.68,0.16,0
31978,3388,-1000.00,14885.68,15885.68,0.00,6101.29,0.23,0
31979,3388,-1000.00,13885.68,14885.68,0.00,15885.68,0.27,0
31980,3388,-1000.00,12885.68,13885.68,0.00,14885.68,0.32,0
31981,3388,-1000.00,11885.68,12885.68,2308.36,11577.32,0.35,0
31982,3388,-1000.00,10885.68,11885.68,0.00,12885.68,0.31,0
31983,3388,-1000.00,9885.68,10885.68,0.00,11885.68,0.10,0
31984,3388,-1000.00,8885.68,9885.68,5667.83,4452.34,0.19,0
31985,3388,-1000.00,7885.68,8885.68,2166.05,7719.64,0.14,0
31986,3388,-1000.00,6885.68,7885.68,0.00,6373.10,0.38,0
31987,3388,-1000.00,5885.68,6885.68,0.00,7885.68,0.08,0
31988,3388,-1000.00,4885.68,5885.68,0.00,6885.68,0.33,0
31989,3388,-1000.00,3885.68,4885.68,0.00,4413.71,0.11,0
31990,3388,-1000.00,2885.68,3885.68,3086.17,1799.51,0.08,0
31991,3388,-1000.00,1885.68,2885.68,0.00,2292.11,0.36,0
31992,3388,-1000.00,885.68,1885.68,0.00,2885.68,0.11,0
31993,3388,-1000.00,-114.32,885.68,399.00,1486.68,0.21,0
31994,3388,-556.75,-671.07,328.93,0.00,556.75,0.36,0
31995,3388,1000.00,328.93,1328.93,154.72,174.21,0.24,1
31996,3388,-1000.00,-671.07,328.93,831.00,497.93,0.06,0
31997,3388,1000.00,328.93,1328.93,94.54,106.12,0.21,1
31998,3388,1000.00,1328.93,2328.93,0.00,1328.93,0.27,1
31999,3388,1000.00,2328.93,3328.93,114.92,473.57,0.18,1
32000,3388,-715.96,1612.97,2612.97,715.96,0.00,0.05,0
32001,3388,-1000.00,612.97,1612.97,797.38,661.91,0.18,0
32002,3388,1000.00,1612.97,2612.97,0.00,1488.95,0.42,1
32003,3388,1000.00,2612.97,3612.97,0.00,2612.97,0.41,1
32004,3388,1000.00,3612.97,4612.97,0.00,3612.97,0.35,1
32005,3388,-1000.00,2612.97,3612.97,3411.93,1134.85,0.09,0
32006,3388,-1000.00,1612.97,2612.97,1736.09,1391.66,0.25,0
32007,3388,1000.00,2612.97,3612.97,566.98,2046.00,0.39,1
32008,3388,1000.00,3612.97,4612.97,0.00,3612.97,0.03,1
32009,3388,1000.00,4612.97,5612.97,0.00,2806.95,0.09,1
32010,3389,-1000.00,-1000.00,0.00,65.53,66.06,0.36,0
32011,3390,1000.00,1000.00,2000.00,0.00,1000.00,0.44,1
32012,3390,1000.00,2000.00,3000.00,0.00,2000.00,0.42,1
32013,3390,1000.00,3000.00,4000.00,0.00,276.55,0.13,1
32014,3390,1000.00,4000.00,5000.00,0.00,3638.64,0.41,1
32015,3390,0.00,4000.00,5000.00,0.00,0.00,0.05,0
32016,3390,1000.00,5000.00,6000.00,716.51,4283.49,0.06,1
32017,3390,1000.00,6000.00,7000.00,0.00,6000.00,0.25,1
32018,3390,1000.00,7000.00,8000.00,0.00,2746.20,0.21,1
32019,3390,1000.00,8000.00,9000.00,3277.84,4722.16,0.39,1
32020,3390,1000.00,9000.00,10000.00,0.00,1832.08,0.15,1
32021,3390,1000.00,10000.00,11000.00,3286.96,6713.04,0.32,1
32022,3390,1000.00,11000.00,12000.00,0.00,11000.00,0.15,1
32023,3390,1000.00,12000.00,13000.00,1629.31,10370.69,0.42,1
32024,3390,1000.00,13000.00,14000.00,0.00,13000.00,0.36,1
32025,3390,-1000.00,12000.00,13000.00,7015.14,6984.86,0.17,0
32026,3390,-1000.00,11000.00,12000.00,6695.91,6304.09,0.17,0
32027,3390,1000.00,12000.00,13000.00,5563.88,6436.12,0.30,1
32028,3390,1000.00,13000.00,14000.00,0.00,1184.83,0.08,1
32029,3390,-1000.00,12000.00,13000.00,13162.69,837.31,0.07,0
32030,3390,1000.00,13000.00,14000.00,2073.64,10926.36,0.42,1
32031,3390,-1000.00,12000.00,13000.00,8953.63,5046.37,0.14,0
32032,3390,-1000.00,11000.00,12000.00,10275.43,2163.64,0.07,0
32033,3390,-1000.00,10000.00,11000.00,8758.74,3241.26,0.23,0
32034,3390,-1000.00,9000.00,10000.00,0.00,11000.00,0.00,0
32035,3390,-1000.00,8000.00,9000.00,5000.00,5000.00,0.00,0
32036,3390,-1000.00,7000.00,8000.00,1733.92,7266.08,0.06,0
32037,3390,-1000.00,6000.00,7000.00,4200.15,3799.85,0.20,0
32038,3390,-1000.00,5000.00,6000.00,0.00,7000.00,0.29,0
32039,3390,-1000.00,4000.00,5000.00,3000.00,3000.00,0.09,0
32040,3390,-1000.00,3000.00,4000.00,1375.97,3624.03,0.15,0
32041,3390,-1000.00,2000.00,3000.00,2000.00,2000.00,0.02,0
32042,3390,-1000.00,1000.00,2000.00,766.11,2020.62,0.37,0
32043,3390,-1000.00,0.00,1000.00,439.94,1435.20,0.37,0
32044,3390,-1000.00,-1000.00,0.00,460.89,539.11,0.04,0
32045,3391,1000.00,1000.00,2000.00,500.00,500.00,0.09,1
32046,3391,1000.00,2000.00,3000.00,342.22,1657.78,0.42,1
32047,3391,1000.00,3000.00,4000.00,878.70,2121.30,0.30,1
32048,3391,1000.00,4000.00,5000.00,0.00,3613.93,0.41,1
32049,3391,1000.00,5000.00,6000.00,1393.66,3606.34,0.21,1
32050,3391,1000.00,6000.00,7000.00,659.59,5340.41,0.41,1
32051,3391,1000.00,7000.00,8000.00,979.84,6020.16,0.41,1
32052,3391,1000.00,8000.00,9000.00,0.00,7572.47,0.17,1
32053,3391,1000.00,9000.00,10000.00,2301.51,6698.49,0.15,1
32054,3391,1000.00,10000.00,11000.00,0.00,10000.00,0.31,1
32055,3391,1000.00,11000.00,12000.00,727.60,5377.55,0.31,1
32056,3391,1000.00,12000.00,13000.00,0.00,12000.00,0.34,1
32057,3391,1000.00,13000.00,14000.00,0.00,6817.29,0.41,1
32058,3391,1000.00,14000.00,15000.00,0.00,7026.94,0.27,1
32059,3391,1000.00,15000.00,16000.00,0.00,15000.00,0.42,1
32060,3391,1000.00,16000.00,17000.00,8000.00,8000.00,0.36,1
32061,3391,1000.00,17000.00,18000.00,335.53,16664.47,0.44,1
32062,3391,1000.00,18000.00,19000.00,0.00,18000.00,0.04,1
32063,3391,1000.00,19000.00,20000.00,3000.17,15999.83,0.42,1
32064,3391,1000.00,20000.00,21000.00,378.95,19621.05,0.31,1
32065,3391,1000.00,21000.00,22000.00,0.00,8540.98,0.22,1
32066,3391,1000.00,22000.00,23000.00,0.00,22000.00,0.34,1
32067,3391,1000.00,23000.00,24000.00,2433.17,20566.83,0.08,1
32068,3391,1000.00,24000.00,25000.00,0.00,24000.00,0.44,1
32069,3391,-1000.00,23000.00,24000.00,19871.07,4329.44,0.09,0
32070,3391,1000.00,24000.00,25000.00,1525.94,22474.06,0.30,1
32071,3391,1000.00,25000.00,26000.00,0.00,16964.18,0.06,1
32072,3391,1000.00,26000.00,27000.00,0.00,26000.00,0.00,1
32073,3391,1000.00,27000.00,28000.00,0.00,27000.00,0.11,1
32074,3391,1000.00,28000.00,29000.00,0.00,7521.68,0.37,1
32075,3391,1000.00,29000.00,30000.00,14500.00,14500.00,0.01,1
32076,3391,-1000.00,28000.00,29000.00,1795.32,0.00,0.00,0
32077,3391,1000.00,29000.00,30000.00,0.00,27506.02,0.38,1
32078,3391,1000.00,30000.00,31000.00,0.00,30000.00,0.20,1
32079,3391,1000.00,31000.00,32000.00,6679.62,18444.78,0.33,1
32080,3391,1000.00,32000.00,33000.00,0.00,19154.17,0.33,1
32081,3391,1000.00,33000.00,34000.00,0.00,33000.00,0.27,1
32082,3391,1000.00,34000.00,35000.00,830.99,21505.29,0.37,1
32083,3391,1000.00,35000.00,36000.00,0.00,35000.00,0.29,1
32084,3391,1000.00,36000.00,37000.00,3354.88,32645.12,0.38,1
32085,3391,1000.00,37000.00,38000.00,0.00,32259.28,0.14,1
32086,3391,1000.00,38000.00,39000.00,0.00,31451.36,0.39,1
32087,3391,1000.00,39000.00,40000.00,9934.08,29065.92,0.39,1
32088,3391,1000.00,40000.00,41000.00,9165.28,30834.72,0.08,1
32089,3391,1000.00,41000.00,42000.00,16830.77,24169.23,0.20,1
32090,3391,0.00,41000.00,42000.00,0.00,0.00,0.02,0
32091,3391,1000.00,42000.00,43000.00,21000.00,21000.00,0.15,1
32092,3391,-1000.00,41000.00,42000.00,31161.93,4983.50,0.14,0
32093,3391,0.00,41000.00,42000.00,0.00,0.00,0.03,0
32094,3391,0.00,41000.00,42000.00,0.00,0.00,0.01,0
32095,3391,-1000.00,40000.00,41000.00,0.00,41634.79,0.35,0
32096,3391,-1000.00,39000.00,40000.00,11961.40,24444.00,0.32,0
32097,3391,-1000.00,38000.00,39000.00,2168.23,37831.77,0.27,0
32098,3391,-1000.00,37000.00,38000.00,10684.96,28315.04,0.32,0
32099,3391,-1000.00,36000.00,37000.00,18994.98,19005.02,0.02,0
32100,3391,-1000.00,35000.00,36000.00,0.00,37000.00,0.37,0
32101,3391,-1000.00,34000.00,35000.00,0.00,36000.00,0.16,0
32102,3391,-1000.00,33000.00,34000.00,8199.16,26800.84,0.16,0
32103,3391,-1000.00,32000.00,33000.00,2247.51,31752.49,0.32,0
32104,3391,-1000.00,31000.00,32000.00,0.00,28395.34,0.41,0
32105,3391,-1000.00,30000.00,31000.00,1478.03,30521.97,0.36,0
32106,3391,-1000.00,29000.00,30000.00,0.00,19161.92,0.30,0
32107,3391,-1000.00,28000.00,29000.00,16254.42,13745.58,0.16,0
32108,3391,-1000.00,27000.00,28000.00,0.00,29000.00,0.20,0
32109,3391,-1000.00,26000.00,27000.00,3748.85,23515.84,0.43,0
32110,3391,-1000.00,25000.00,26000.00,0.00,19282.28,0.41,0
32111,3391,-1000.00,24000.00,25000.00,9929.96,16070.04,0.24,0
32112,3391,-1000.00,23000.00,24000.00,378.79,24621.21,0.41,0
32113,3391,-1000.00,22000.00,23000.00,0.00,24000.00,0.17,0
32114,3391,-1000.00,21000.00,22000.00,11542.98,11457.02,0.38,0
32115,3391,-1000.00,20000.00,21000.00,9620.67,12379.33,0.01,0
32116,3391,-1000.00,19000.00,20000.00,2134.67,18865.33,0.41,0
32117,3391,-1000.00,18000.00,19000.00,9573.23,10426.77,0.24,0
32118,3391,-1000.00,17000.00,18000.00,4485.46,14514.54,0.39,0
32119,3391,-1000.00,16000.00,17000.00,6812.95,0.00,0.02,0
32120,3391,-1000.00,15000.00,16000.00,6259.89,10740.11,0.31,0
32121,3391,-1000.00,14000.00,15000.00,4870.33,11129.67,0.35,0
32122,3391,-1000.00,13000.00,14000.00,0.00,4460.42,0.22,0
32123,3391,-1000.00,12000.00,13000.00,0.00,14000.00,0.41,0
32124,3391,-1000.00,11000.00,12000.00,2776.67,10223.33,0.39,0
32125,3391,-1000.00,10000.00,11000.00,338.04,10037.96,0.43,0
32126,3391,-1000.00,9000.00,10000.00,0.00,11000.00,0.22,0
32127,3391,-1000.00,8000.00,9000.00,6297.77,3702.23,0.05,0
32128,3391,-1000.00,7000.00,8000.00,0.00,5917.14,0.38,0
32129,3391,-1000.00,6000.00,7000.00,1614.74,6385.26,0.11,0
32130,3391,-1000.00,5000.00,6000.00,1991.80,5008.20,0.23,0
32131,3391,-1000.00,4000.00,5000.00,0.00,6000.00,0.37,0
32132,3391,-1000.00,3000.00,4000.00,1445.22,3554.78,0.25,0
32133,3391,-1000.00,2000.00,3000.00,379.89,3620.11,0.42,0
32134,3391,-1000.00,1000.00,2000.00,1089.13,1910.87,0.30,0
32135,3391,-1000.00,0.00,1000.00,634.68,1365.32,0.02,0
32136,3391,-1000.00,-1000.00,0.00,474.73,525.27,0.14,0
32137,3392,-389.45,-389.45,610.55,389.45,0.00,0.18,0
32138,3392,-1000.00,-1389.45,-389.45,0.00,610.55,0.11,0
32139,3393,0.00,0.00,1000.00,0.00,0.00,0.20,0
32140,3393,-1000.00,-1000.00,0.00,0.00,1000.00,0.00,0
32141,3394,-1000.00,-1000.00,0.00,737.40,262.60,0.09,0
32142,3395,-315.41,-315.41,684.59,0.00,315.41,0.06,0
32143,3395,-684.59,-1000.00,0.00,77.65,606.93,0.43,0
32144,3396,1000.00,1000.00,2000.00,788.69,0.00,0.10,1
32145,3396,0.00,1000.00,2000.00,0.00,0.00,0.30,0
32146,3396,-1000.00,0.00,1000.00,274.21,1542.39,0.23,0
32147,3396,-645.23,-645.23,354.77,0.00,645.23,0.25,0
32148,3396,-272.49,-917.72,82.28,20.89,251.61,0.22,0
32149,3396,1000.00,82.28,1082.28,69.50,12.77,0.15,1
32150,3396,1000.00,1082.28,2082.28,642.45,0.00,0.27,1
32151,3396,-1000.00,82.28,1082.28,0.00,1727.06,0.17,0
32152,3396,0.00,82.28,1082.28,0.00,0.00,0.08,0
32153,3396,0.00,82.28,1082.28,0.00,0.00,0.41,0
32154,3396,-1000.00,-917.72,82.28,0.00,1050.32,0.12,0
32155,3396,1000.00,82.28,1082.28,66.44,0.00,0.11,1
32156,3396,-793.01,-710.73,289.27,226.60,566.41,0.30,0
32157,3396,0.00,-710.73,289.27,0.00,0.00,0.36,0
32158,3396,-219.00,-929.73,70.27,0.00,219.00,0.01,0
32159,3396,0.00,-929.73,70.27,0.00,0.00,0.16,0
32160,3396,1000.00,70.27,1070.27,41.60,0.00,0.17,1
32161,3396,-1000.00,-929.73,70.27,0.00,1070.27,0.26,0
32162,3396,-70.27,-1000.00,0.00,0.00,70.27,0.07,0
32163,3397,-1000.00,-1000.00,0.00,0.00,1000.00,0.09,0
32164,3398,-1000.00,-1000.00,0.00,440.40,559.60,0.00,0
32165,3399,-1000.00,-1000.00,0.00,17.97,982.03,0.08,0
32166,3400,-1000.00,-1000.00,0.00,469.23,530.77,0.26,0
32167,3401,-698.80,-698.80,301.20,0.00,698.80,0.35,0
32168,3401,-301.20,-1000.00,0.00,138.04,163.16,0.09,0
32169,3402,0.00,0.00,1000.00,0.00,0.00,0.05,0
32170,3402,1000.00,1000.00,2000.00,0.00,908.75,0.43,1
32171,3402,1000.00,2000.00,3000.00,0.00,1699.91,0.01,1
32172,3402,1000.00,3000.00,4000.00,46.23,2953.77,0.33,1
32173,3402,1000.00,4000.00,5000.00,1856.20,2143.80,0.14,1
32174,3402,1000.00,5000.00,6000.00,1948.63,2059.29,0.22,1
32175,3402,-1000.00,4000.00,5000.00,6000.00,0.00,0.01,0
32176,3402,1000.00,5000.00,6000.00,2500.00,2500.00,0.23,1
32177,3402,1000.00,6000.00,7000.00,2726.26,3273.74,0.23,1
32178,3402,-1000.00,5000.00,6000.00,7000.00,0.00,0.01,0
32179,3402,1000.00,6000.00,7000.00,711.89,5288.11,0.44,1
32180,3402,1000.00,7000.00,8000.00,0.00,7000.00,0.06,1
32181,3402,1000.00,8000.00,9000.00,0.00,8000.00,0.14,1
32182,3402,1000.00,9000.00,10000.00,0.00,9000.00,0.38,1
32183,3402,1000.00,10000.00,11000.00,0.00,10000.00,0.07,1
32184,3402,1000.00,11000.00,12000.00,441.79,2839.53,0.07,1
32185,3402,1000.00,12000.00,13000.00,0.00,12000.00,0.39,1
32186,3402,-1000.00,11000.00,12000.00,9518.59,2011.59,0.08,0
32187,3402,1000.00,12000.00,13000.00,5145.34,6854.66,0.43,1
32188,3402,0.00,12000.00,13000.00,0.00,0.00,0.02,0
32189,3402,1000.00,13000.00,14000.00,1725.23,11274.77,0.34,1
32190,3402,1000.00,14000.00,15000.00,4427.84,9572.16,0.33,1
32191,3402,1000.00,15000.00,16000.00,0.00,3723.48,0.07,1
32192,3402,1000.00,16000.00,17000.00,0.00,15721.17,0.06,1
32193,3402,1000.00,17000.00,18000.00,0.00,7342.05,0.27,1
32194,3402,-1000.00,16000.00,17000.00,10544.83,7455.17,0.27,0
32195,3402,1000.00,17000.00,18000.00,0.00,17000.00,0.26,1
32196,3402,1000.00,18000.00,19000.00,0.00,1652.32,0.13,1
32197,3402,1000.00,19000.00,20000.00,9500.00,9500.00,0.17,1
32198,3402,1000.00,20000.00,21000.00,0.00,9202.61,0.21,1
32199,3402,1000.00,21000.00,22000.00,1218.03,18897.01,0.43,1
32200,3402,-1000.00,20000.00,21000.00,0.00,17530.25,0.35,0
32201,3402,-1000.00,19000.00,20000.00,15067.33,5932.67,0.09,0
32202,3402,-1000.00,18000.00,19000.00,0.00,19334.96,0.43,0
32203,3402,-1000.00,17000.00,18000.00,8178.85,10821.15,0.37,0
32204,3402,-1000.00,16000.00,17000.00,6127.66,11872.34,0.29,0
32205,3402,-1000.00,15000.00,16000.00,1395.13,0.00,0.08,0
32206,3402,-1000.00,14000.00,15000.00,0.00,16000.00,0.11,0
32207,3402,-1000.00,13000.00,14000.00,6133.38,0.00,0.10,0
32208,3402,-1000.00,12000.00,13000.00,2816.52,7191.01,0.40,0
32209,3402,-1000.00,11000.00,12000.00,4569.53,8430.47,0.21,0
32210,3403,-1000.00,-1000.00,0.00,1000.00,0.00,0.02,0
32211,3404,1000.00,1000.00,2000.00,0.00,1000.00,0.01,1
32212,3404,1000.00,2000.00,3000.00,0.00,2000.00,0.25,1
32213,3404,1000.00,3000.00,4000.00,0.00,3000.00,0.42,1
32214,3404,1000.00,4000.00,5000.00,0.00,3321.42,0.16,1
32215,3404,1000.00,5000.00,6000.00,0.00,5000.00,0.28,1
32216,3404,1000.00,6000.00,7000.00,0.00,6000.00,0.10,1
32217,3404,1000.00,7000.00,8000.00,1196.47,5803.53,0.25,1
32218,3404,1000.00,8000.00,9000.00,191.63,7115.17,0.43,1
32219,3404,1000.00,9000.00,10000.00,733.58,898.06,0.14,1
32220,3404,1000.00,10000.00,11000.00,4342.97,5657.03,0.08,1
32221,3404,1000.00,11000.00,12000.00,4975.80,6024.20,0.25,1
32222,3404,1000.00,12000.00,13000.00,0.00,9368.19,0.41,1
32223,3404,1000.00,13000.00,14000.00,0.00,13000.00,0.29,1
32224,3404,1000.00,14000.00,15000.00,6491.45,7508.55,0.06,1
32225,3404,1000.00,15000.00,16000.00,4704.71,10295.29,0.32,1
32226,3404,1000.00,16000.00,17000.00,1687.19,14312.81,0.37,1
32227,3404,-1000.00,15000.00,16000.00,10361.69,6638.31,0.15,0
32228,3404,1000.00,16000.00,17000.00,0.00,16000.00,0.01,1
32229,3404,1000.00,17000.00,18000.00,8101.99,8898.01,0.20,1
32230,3404,-1000.00,16000.00,17000.00,9066.71,8933.29,0.36,0
32231,3404,0.00,16000.00,17000.00,0.00,0.00,0.02,0
32232,3404,1000.00,17000.00,18000.00,0.00,16655.68,0.33,1
32233,3404,1000.00,18000.00,19000.00,5723.10,12276.90,0.32,1
32234,3404,-1000.00,17000.00,18000.00,12364.66,6635.34,0.19,0
32235,3404,1000.00,18000.00,19000.00,0.00,18000.00,0.38,1
32236,3404,1000.00,19000.00,20000.00,0.00,19000.00,0.24,1
32237,3404,1000.00,20000.00,21000.00,4979.78,15020.22,0.38,1
32238,3404,-1000.00,19000.00,20000.00,11238.11,9761.89,0.15,0
32239,3404,1000.00,20000.00,21000.00,8554.78,11445.22,0.26,1
32240,3404,1000.00,21000.00,22000.00,0.00,2078.58,0.14,1
32241,3404,1000.00,22000.00,23000.00,3459.29,18540.71,0.33,1
32242,3404,1000.00,23000.00,24000.00,0.00,23000.00,0.39,1
32243,3404,1000.00,24000.00,25000.00,0.00,24000.00,0.11,1
32244,3404,1000.00,25000.00,26000.00,0.00,18325.85,0.40,1
32245,3404,1000.00,26000.00,27000.00,0.00,24680.54,0.18,1
32246,3404,1000.00,27000.00,28000.00,0.00,20297.63,0.16,1
32247,3404,1000.00,28000.00,29000.00,0.00,18498.94,0.37,1
32248,3404,1000.00,29000.00,30000.00,3727.24,25272.76,0.42,1
32249,3404,1000.00,30000.00,31000.00,5439.40,15059.46,0.30,1
32250,3404,1000.00,31000.00,32000.00,0.00,27723.75,0.11,1
32251,3404,1000.00,32000.00,33000.00,0.00,32000.00,0.22,1
32252,3404,1000.00,33000.00,34000.00,3254.18,29745.82,0.43,1
32253,3404,1000.00,34000.00,35000.00,13782.92,20217.08,0.28,1
32254,3404,1000.00,35000.00,36000.00,5695.24,29304.76,0.23,1
32255,3404,1000.00,36000.00,37000.00,0.00,36000.00,0.02,1
32256,3404,1000.00,37000.00,38000.00,0.00,28661.88,0.11,1
32257,3404,1000.00,38000.00,39000.00,5685.13,32314.87,0.42,1
32258,3405,-817.10,-817.10,182.90,0.00,817.10,0.38,0
32259,3405,-152.60,-969.71,30.29,0.00,152.60,0.18,0
32260,3405,-30.29,-1000.00,0.00,6.20,24.09,0.12,0
32261,3405,-0.00,-1000.00,0.00,0.00,0.00,0.34,0
32262,3406,1000.00,1000.00,2000.00,312.43,687.57,0.09,1
32263,3406,1000.00,2000.00,3000.00,139.13,1860.87,0.23,1
32264,3406,1000.00,3000.00,4000.00,0.00,2442.43,0.39,1
32265,3406,1000.00,4000.00,5000.00,0.00,3235.36,0.04,1
32266,3406,1000.00,5000.00,6000.00,1079.31,3920.69,0.38,1
32267,3406,1000.00,6000.00,7000.00,3000.00,3000.00,0.00,1
32268,3406,-1000.00,5000.00,6000.00,4052.31,0.00,0.04,0
32269,3406,1000.00,6000.00,7000.00,2179.32,3820.68,0.12,1
32270,3406,1000.00,7000.00,8000.00,973.71,6026.29,0.14,1
32271,3406,1000.00,8000.00,9000.00,2249.27,5750.73,0.06,1
32272,3406,-1000.00,7000.00,8000.00,6043.74,2596.91,0.12,0
32273,3406,1000.00,8000.00,9000.00,2722.90,5277.10,0.21,1
32274,3406,1000.00,9000.00,10000.00,4500.00,4500.00,0.04,1
32275,3406,1000.00,10000.00,11000.00,4264.49,5735.51,0.26,1
32276,3406,1000.00,11000.00,12000.00,5500.00,5500.00,0.10,1
32277,3406,1000.00,12000.00,13000.00,2769.69,9230.31,0.14,1
32278,3406,1000.00,13000.00,14000.00,5646.10,7353.90,0.31,1
32279,3406,1000.00,14000.00,15000.00,0.00,14000.00,0.36,1
32280,3406,1000.00,15000.00,16000.00,3172.77,11827.23,0.40,1
32281,3406,1000.00,16000.00,17000.00,1888.54,14111.46,0.43,1
32282,3406,-1000.00,15000.00,16000.00,11527.71,5472.29,0.22,0
32283,3406,1000.00,16000.00,17000.00,0.00,13839.08,0.24,1
32284,3406,1000.00,17000.00,18000.00,6268.63,10731.37,0.22,1
32285,3406,1000.00,18000.00,19000.00,0.00,7183.82,0.14,1
32286,3406,-1000.00,17000.00,18000.00,6585.66,12414.34,0.24,0
32287,3406,-1000.00,16000.00,17000.00,9363.74,8636.26,0.16,0
32288,3406,-1000.00,15000.00,16000.00,0.00,3518.71,0.02,0
32289,3406,-1000.00,14000.00,15000.00,9418.31,6581.69,0.08,0
32290,3406,-1000.00,13000.00,14000.00,0.00,15000.00,0.04,0
32291,3406,-1000.00,12000.00,13000.00,0.00,1183.79,0.13,0
32292,3406,-1000.00,11000.00,12000.00,828.47,12171.53,0.35,0
32293,3406,-1000.00,10000.00,11000.00,1591.16,10408.84,0.29,0
32294,3406,-1000.00,9000.00,10000.00,0.00,11000.00,0.27,0
32295,3406,-1000.00,8000.00,9000.00,5000.00,5000.00,0.01,0
32296,3406,-1000.00,7000.00,8000.00,1412.30,7587.70,0.05,0
32297,3406,-1000.00,6000.00,7000.00,88.90,7911.10,0.44,0
32298,3406,-1000.00,5000.00,6000.00,0.00,7000.00,0.09,0
32299,3406,-1000.00,4000.00,5000.00,0.00,6000.00,0.09,0
32300,3406,-1000.00,3000.00,4000.00,0.00,2708.23,0.33,0
32301,3406,-1000.00,2000.00,3000.00,0.00,4000.00,0.28,0
32302,3406,-1000.00,1000.00,2000.00,509.85,1599.99,0.31,0
32303,3406,-1000.00,0.00,1000.00,254.95,1567.75,0.41,0
32304,3406,-150.57,-150.57,849.43,47.72,102.86,0.14,0
32305,3406,-849.43,-1000.00,0.00,209.08,640.34,0.39,0
32306,3407,-463.99,-463.99,536.01,463.99,0.00,0.23,0
32307,3407,0.00,-463.99,536.01,0.00,0.00,0.40,0
32308,3407,-1000.00,-1463.99,-463.99,0.00,536.01,0.09,0
32309,3408,1000.00,1000.00,2000.00,0.00,974.43,0.43,1
32310,3408,1000.00,2000.00,3000.00,0.00,2000.00,0.22,1
32311,3408,1000.00,3000.00,4000.00,1157.40,1842.60,0.25,1
32312,3408,1000.00,4000.00,5000.00,0.00,4000.00,0.32,1
32313,3408,-1000.00,3000.00,4000.00,2508.30,2491.70,0.06,0
32314,3408,1000.00,4000.00,5000.00,1984.74,2015.26,0.08,1
32315,3408,1000.00,5000.00,6000.00,2500.00,2500.00,0.08,1
32316,3408,1000.00,6000.00,7000.00,443.47,5556.53,0.15,1
32317,3408,1000.00,7000.00,8000.00,885.63,6114.37,0.43,1
32318,3408,1000.00,8000.00,9000.00,0.00,8000.00,0.30,1
32319,3408,1000.00,9000.00,10000.00,524.81,8475.19,0.44,1
32320,3408,1000.00,10000.00,11000.00,0.00,10000.00,0.06,1
32321,3408,-1000.00,9000.00,10000.00,5655.65,5344.35,0.28,0
32322,3408,1000.00,10000.00,11000.00,883.50,9116.50,0.34,1
32323,3408,1000.00,11000.00,12000.00,0.00,11000.00,0.22,1
32324,3408,1000.00,12000.00,13000.00,0.00,1667.25,0.13,1
32325,3408,1000.00,13000.00,14000.00,1867.58,11132.42,0.17,1
32326,3408,1000.00,14000.00,15000.00,0.00,14000.00,0.06,1
32327,3408,-1000.00,13000.00,14000.00,8777.01,6222.99,0.25,0
32328,3408,-1000.00,12000.00,13000.00,0.00,5703.45,0.22,0
32329,3408,-1000.00,11000.00,12000.00,0.00,4472.86,0.24,0
32330,3408,-1000.00,10000.00,11000.00,0.00,10851.45,0.43,0
32331,3408,-1000.00,9000.00,10000.00,5500.00,5500.00,0.18,0
32332,3408,-688.08,8311.92,9311.92,0.00,688.08,0.13,0
32333,3408,-1000.00,7311.92,8311.92,0.00,9311.92,0.20,0
32334,3408,-1000.00,6311.92,7311.92,101.57,8116.95,0.44,0
32335,3408,-1000.00,5311.92,6311.92,0.00,1068.02,0.12,0
32336,3408,-1000.00,4311.92,5311.92,0.00,6311.92,0.28,0
32337,3408,-1000.00,3311.92,4311.92,2590.44,2721.48,0.11,0
32338,3408,-1000.00,2311.92,3311.92,0.00,4311.92,0.42,0
32339,3408,-1000.00,1311.92,2311.92,91.64,3220.28,0.41,0
32340,3408,-1000.00,311.92,1311.92,674.45,1637.47,0.25,0
32341,3408,-683.26,-371.34,628.66,0.00,683.26,0.32,0
32342,3408,-199.27,-570.61,429.39,0.00,199.27,0.15,0
32343,3408,-429.39,-1000.00,0.00,0.00,429.39,0.11,0
32344,3409,-1000.00,-1000.00,0.00,0.00,1000.00,0.07,0
32345,3410,-778.65,-778.65,221.35,128.90,649.76,0.36,0
32346,3410,-219.96,-998.61,1.39,14.31,205.65,0.44,0
32347,3410,-0.48,-999.09,0.91,0.00,0.48,0.10,0
32348,3410,-298.51,-1297.60,-297.60,0.63,0.28,0.02,0
32349,3411,-1000.00,-1000.00,0.00,0.00,1000.00,0.08,0
32350,3412,-1000.00,-1000.00,0.00,0.00,1000.00,0.35,0
32351,3413,-1000.00,-1000.00,0.00,0.00,1000.00,0.19,0
32352,3414,-1000.00,-1000.00,0.00,113.00,656.48,0.37,0
32353,3415,1000.00,1000.00,2000.00,0.00,537.85,0.21,1
32354,3415,1000.00,2000.00,3000.00,0.00,1975.91,0.30,1
32355,3415,1000.00,3000.00,4000.00,0.00,2220.89,0.40,1
32356,3415,1000.00,4000.00,5000.00,1285.17,2714.83,0.32,1
32357,3415,1000.00,5000.00,6000.00,2211.58,2646.66,0.25,1
32358,3415,1000.00,6000.00,7000.00,666.57,5333.43,0.43,1
32359,3415,-868.59,5131.41,6131.41,868.59,0.00,0.01,0
32360,3415,1000.00,6131.41,7131.41,0.00,6131.41,0.19,1
32361,3415,1000.00,7131.41,8131.41,0.00,7131.41,0.29,1
32362,3415,1000.00,8131.41,9131.41,2505.89,5625.52,0.35,1
32363,3415,1000.00,9131.41,10131.41,0.00,9131.41,0.32,1
32364,3415,1000.00,10131.41,11131.41,399.94,9731.46,0.30,1
32365,3415,1000.00,11131.41,12131.41,60.01,11071.39,0.23,1
32366,3415,1000.00,12131.41,13131.41,0.00,9684.67,0.20,1
32367,3415,-1000.00,11131.41,12131.41,8377.18,4754.23,0.01,0
32368,3415,1000.00,12131.41,13131.41,4740.33,7391.08,0.18,1
32369,3415,0.00,12131.41,13131.41,0.00,0.00,0.08,0
32370,3415,1000.00,13131.41,14131.41,3067.77,10063.64,0.30,1
32371,3415,1000.00,14131.41,15131.41,7065.70,7065.70,0.02,1
32372,3415,1000.00,15131.41,16131.41,0.00,1452.03,0.08,1
32373,3415,1000.00,16131.41,17131.41,0.00,16131.41,0.16,1
32374,3415,1000.00,17131.41,18131.41,0.00,13624.94,0.05,1
32375,3415,1000.00,18131.41,19131.41,0.00,18131.41,0.43,1
32376,3415,1000.00,19131.41,20131.41,0.00,13054.49,0.30,1
32377,3415,-1000.00,18131.41,19131.41,10065.70,10065.70,0.23,0
32378,3415,-1000.00,17131.41,18131.41,3828.76,15302.64,0.31,0
32379,3415,-1000.00,16131.41,17131.41,2129.59,16001.82,0.40,0
32380,3415,-1000.00,15131.41,16131.41,0.00,16228.57,0.39,0
32381,3415,-1000.00,14131.41,15131.41,5011.55,11119.86,0.34,0
32382,3415,-1000.00,13131.41,14131.41,0.00,15131.41,0.34,0
32383,3415,-1000.00,12131.41,13131.41,653.79,13477.62,0.23,0
32384,3415,-1000.00,11131.41,12131.41,0.00,13131.41,0.33,0
32385,3415,-1000.00,10131.41,11131.41,624.21,11507.20,0.11,0
32386,3415,-1000.00,9131.41,10131.41,0.00,11131.41,0.08,0
32387,3415,-1000.00,8131.41,9131.41,0.00,3647.33,0.21,0
32388,3415,-1000.00,7131.41,8131.41,0.00,3685.82,0.20,0
32389,3415,-1000.00,6131.41,7131.41,0.00,5367.13,0.08,0
32390,3415,-1000.00,5131.41,6131.41,0.00,5707.58,0.40,0
32391,3415,-1000.00,4131.41,5131.41,2551.73,3579.68,0.28,0
32392,3415,-1000.00,3131.41,4131.41,1567.34,3564.07,0.27,0
32393,3415,-1000.00,2131.41,3131.41,2304.75,627.90,0.11,0
32394,3415,-1000.00,1131.41,2131.41,714.85,2402.82,0.39,0
32395,3415,-1000.00,131.41,1131.41,892.23,1239.18,0.11,0
32396,3415,-1000.00,-868.59,131.41,0.00,1060.12,0.29,0
32397,3415,-131.41,-1000.00,0.00,0.00,131.41,0.00,0
32398,3416,1000.00,1000.00,2000.00,0.00,1000.00,0.16,1
32399,3416,1000.00,2000.00,3000.00,0.00,408.24,0.16,1
32400,3416,-1000.00,1000.00,2000.00,1685.04,1314.96,0.12,0
32401,3416,1000.00,2000.00,3000.00,0.00,1992.95,0.43,1
32402,3416,1000.00,3000.00,4000.00,0.00,3000.00,0.34,1
32403,3416,-381.73,2618.27,3618.27,381.73,0.00,0.02,0
32404,3416,1000.00,3618.27,4618.27,0.00,352.51,0.06,1
32405,3416,1000.00,4618.27,5618.27,1013.04,3605.23,0.26,1
32406,3416,1000.00,5618.27,6618.27,0.00,5618.27,0.30,1
32407,3416,1000.00,6618.27,7618.27,0.00,6618.27,0.03,1
32408,3416,0.00,6618.27,7618.27,0.00,0.00,0.02,0
32409,3416,1000.00,7618.27,8618.27,2865.26,4753.01,0.24,1
32410,3416,1000.00,8618.27,9618.27,4309.13,4309.13,0.11,1
32411,3416,1000.00,9618.27,10618.27,4136.58,5481.69,0.27,1
32412,3416,1000.00,10618.27,11618.27,0.00,8532.74,0.38,1
32413,3416,1000.00,11618.27,12618.27,5301.13,6317.14,0.13,1
32414,3416,1000.00,12618.27,13618.27,0.00,12618.27,0.15,1
32415,3416,1000.00,13618.27,14618.27,6809.13,6809.13,0.13,1
32416,3416,1000.00,14618.27,15618.27,0.00,14618.27,0.33,1
32417,3416,1000.00,15618.27,16618.27,0.00,5659.80,0.13,1
32418,3416,1000.00,16618.27,17618.27,1463.71,15154.55,0.31,1
32419,3416,1000.00,17618.27,18618.27,4619.11,8464.56,0.28,1
32420,3416,1000.00,18618.27,19618.27,9309.13,9309.13,0.41,1
32421,3416,1000.00,19618.27,20618.27,5418.29,14199.98,0.36,1
32422,3416,1000.00,20618.27,21618.27,0.00,19077.00,0.08,1
32423,3416,1000.00,21618.27,22618.27,0.00,21618.27,0.30,1
32424,3416,1000.00,22618.27,23618.27,0.00,14533.00,0.24,1
32425,3416,1000.00,23618.27,24618.27,0.00,6487.10,0.20,1
32426,3416,0.00,23618.27,24618.27,0.00,0.00,0.09,0
32427,3416,-1000.00,22618.27,23618.27,13475.10,11143.17,0.12,0
32428,3416,1000.00,23618.27,24618.27,0.00,23618.27,0.24,1
32429,3416,1000.00,24618.27,25618.27,8095.61,16522.66,0.44,1
32430,3416,1000.00,25618.27,26618.27,7814.69,17803.58,0.37,1
32431,3416,1000.00,26618.27,27618.27,9809.77,16808.50,0.30,1
32432,3416,1000.00,27618.27,28618.27,0.00,17696.49,0.09,1
32433,3416,1000.00,28618.27,29618.27,7010.33,7151.08,0.19,1
32434,3416,1000.00,29618.27,30618.27,1448.02,28170.24,0.40,1
32435,3416,1000.00,30618.27,31618.27,15309.13,15309.13,0.23,1
32436,3417,-868.33,-868.33,131.67,0.00,868.33,0.23,0
32437,3417,-131.67,-1000.00,0.00,48.22,83.45,0.31,0
32438,3418,-1000.00,-1000.00,0.00,589.30,410.70,0.15,0
32439,3419,-1000.00,-1000.00,0.00,162.16,769.03,0.40,0
32440,3420,0.00,0.00,1000.00,0.00,0.00,0.44,0
32441,3420,-478.50,-478.50,521.50,478.50,0.00,0.24,0
32442,3420,0.00,-478.50,521.50,0.00,0.00,0.23,0
32443,3420,-349.14,-827.64,172.36,349.14,0.00,0.16,0
32444,3420,-1000.00,-1827.64,-827.64,0.00,79.08,0.31,0
32445,3421,-1000.00,-1000.00,0.00,486.77,513.23,0.09,0
32446,3422,-1000.00,-1000.00,0.00,942.59,57.41,0.01,0
32447,3423,1000.00,1000.00,2000.00,500.00,500.00,0.09,1
32448,3423,1000.00,2000.00,3000.00,0.00,238.27,0.14,1
32449,3423,1000.00,3000.00,4000.00,0.00,3000.00,0.13,1
32450,3423,1000.00,4000.00,5000.00,0.00,449.35,0.12,1
32451,3423,1000.00,5000.00,6000.00,2195.60,2804.40,0.23,1
32452,3423,-1000.00,4000.00,5000.00,3171.50,2828.50,0.03,0
32453,3423,1000.00,5000.00,6000.00,1599.96,3400.04,0.36,1
32454,3423,-1000.00,4000.00,5000.00,3229.26,2770.74,0.05,0
32455,3423,1000.00,5000.00,6000.00,1481.36,3518.64,0.33,1
32456,3423,1000.00,6000.00,7000.00,0.00,4552.73,0.03,1
32457,3423,1000.00,7000.00,8000.00,0.00,7000.00,0.17,1
32458,3423,1000.00,8000.00,9000.00,960.19,7039.81,0.39,1
32459,3423,1000.00,9000.00,10000.00,2887.31,6112.69,0.29,1
32460,3423,1000.00,10000.00,11000.00,0.00,3759.92,0.00,1
32461,3423,1000.00,11000.00,12000.00,0.00,11000.00,0.18,1
32462,3423,1000.00,12000.00,13000.00,484.24,11515.76,0.43,1
32463,3423,1000.00,13000.00,14000.00,2331.71,10668.29,0.40,1
32464,3423,1000.00,14000.00,15000.00,5459.54,8540.46,0.33,1
32465,3423,1000.00,15000.00,16000.00,0.00,14466.53,0.42,1
32466,3423,1000.00,16000.00,17000.00,8000.00,8000.00,0.23,1
32467,3423,-1000.00,15000.00,16000.00,0.00,12629.29,0.15,0
32468,3423,-1000.00,14000.00,15000.00,0.00,16000.00,0.40,0
32469,3423,-1000.00,13000.00,14000.00,4202.37,10797.63,0.17,0
32470,3423,-1000.00,12000.00,13000.00,2635.03,11364.97,0.41,0
32471,3423,-1000.00,11000.00,12000.00,0.00,13000.00,0.12,0
32472,3423,-1000.00,10000.00,11000.00,5275.89,1699.35,0.12,0
32473,3423,-1000.00,9000.00,10000.00,0.00,11000.00,0.24,0
32474,3423,-1000.00,8000.00,9000.00,0.00,8639.58,0.28,0
32475,3423,-1000.00,7000.00,8000.00,0.00,9000.00,0.22,0
32476,3423,-1000.00,6000.00,7000.00,0.00,8000.00,0.13,0
32477,3423,-1000.00,5000.00,6000.00,3274.35,3725.65,0.03,0
32478,3423,-1000.00,4000.00,5000.00,0.00,5899.82,0.41,0
32479,3423,-1000.00,3000.00,4000.00,817.22,4182.78,0.22,0
32480,3423,-1000.00,2000.00,3000.00,228.83,1960.45,0.31,0
32481,3423,-1000.00,1000.00,2000.00,781.36,2218.64,0.24,0
32482,3423,-1000.00,0.00,1000.00,744.02,998.15,0.26,0
32483,3423,-1000.00,-1000.00,0.00,215.47,784.53,0.40,0
32484,3424,1000.00,1000.00,2000.00,408.19,591.81,0.28,1
32485,3424,1000.00,2000.00,3000.00,0.00,2000.00,0.30,1
32486,3424,1000.00,3000.00,4000.00,0.00,3000.00,0.15,1
32487,3424,1000.00,4000.00,5000.00,252.40,2936.31,0.40,1
32488,3424,1000.00,5000.00,6000.00,1971.50,3028.50,0.29,1
32489,3424,1000.00,6000.00,7000.00,655.09,5344.91,0.41,1
32490,3424,1000.00,7000.00,8000.00,0.00,4676.05,0.06,1
32491,3424,1000.00,8000.00,9000.00,55.31,7944.69,0.44,1
32492,3424,1000.00,9000.00,10000.00,0.00,9000.00,0.03,1
32493,3424,1000.00,10000.00,11000.00,0.00,5305.50,0.21,1
32494,3424,1000.00,11000.00,12000.00,1461.60,2122.39,0.17,1
32495,3424,1000.00,12000.00,13000.00,0.00,12000.00,0.27,1
32496,3424,1000.00,13000.00,14000.00,1960.04,11039.96,0.42,1
32497,3424,1000.00,14000.00,15000.00,0.00,10917.87,0.05,1
32498,3424,1000.00,15000.00,16000.00,6107.76,8892.24,0.03,1
32499,3424,1000.00,16000.00,17000.00,0.00,16000.00,0.33,1
32500,3424,1000.00,17000.00,18000.00,1506.28,14953.65,0.43,1
32501,3424,1000.00,18000.00,19000.00,165.33,16791.35,0.44,1
32502,3424,1000.00,19000.00,20000.00,0.00,7515.01,0.27,1
32503,3424,1000.00,20000.00,21000.00,6405.51,13594.49,0.34,1
32504,3424,1000.00,21000.00,22000.00,5820.08,10704.36,0.29,1
32505,3424,1000.00,22000.00,23000.00,9391.19,12608.81,0.08,1
32506,3424,1000.00,23000.00,24000.00,987.12,14598.65,0.37,1
32507,3424,1000.00,24000.00,25000.00,0.00,17622.52,0.21,1
32508,3424,-1000.00,23000.00,24000.00,11739.78,13260.22,0.42,0
32509,3424,-1000.00,22000.00,23000.00,0.00,8312.51,0.13,0
32510,3424,0.00,22000.00,23000.00,0.00,0.00,0.03,0
32511,3424,-1000.00,21000.00,22000.00,10096.64,12903.36,0.02,0
32512,3424,-1000.00,20000.00,21000.00,10048.30,11951.70,0.01,0
32513,3424,-1000.00,19000.00,20000.00,0.00,21000.00,0.36,0
32514,3424,-1000.00,18000.00,19000.00,9832.65,10167.35,0.27,0
32515,3424,-1000.00,17000.00,18000.00,1050.94,17949.06,0.01,0
32516,3424,-1000.00,16000.00,17000.00,0.00,13335.87,0.34,0
32517,3424,-1000.00,15000.00,16000.00,0.00,17000.00,0.37,0
32518,3424,-1000.00,14000.00,15000.00,8000.00,8000.00,0.17,0
32519,3424,-1000.00,13000.00,14000.00,5934.54,9065.46,0.26,0
32520,3424,-1000.00,12000.00,13000.00,0.00,8327.83,0.35,0
32521,3424,-1000.00,11000.00,12000.00,5880.42,6507.41,0.24,0
32522,3424,-1000.00,10000.00,11000.00,2064.46,9935.54,0.16,0
32523,3424,-1000.00,9000.00,10000.00,0.00,11000.00,0.15,0
32524,3424,-1000.00,8000.00,9000.00,0.00,6125.13,0.25,0
32525,3424,-1000.00,7000.00,8000.00,3311.53,5688.47,0.31,0
32526,3424,-1000.00,6000.00,7000.00,3611.49,4388.51,0.25,0
32527,3424,-1000.00,5000.00,6000.00,2690.57,4309.43,0.20,0
32528,3424,-1000.00,4000.00,5000.00,1004.16,4995.84,0.41,0
32529,3424,-1000.00,3000.00,4000.00,0.00,5000.00,0.05,0
32530,3424,-1000.00,2000.00,3000.00,773.18,3226.82,0.36,0
32531,3424,-1000.00,1000.00,2000.00,431.57,2568.43,0.15,0
32532,3424,-1000.00,0.00,1000.00,0.00,2000.00,0.03,0
32533,3424,-93.35,-93.35,906.65,0.00,93.35,0.13,0
32534,3424,-380.81,-474.16,525.84,35.86,344.95,0.26,0
32535,3424,-525.84,-1000.00,0.00,248.16,277.68,0.14,0
32536,3425,-1000.00,-1000.00,0.00,500.00,500.00,0.02,0
32537,3426,-1000.00,-1000.00,0.00,0.00,1000.00,0.40,0
32538,3427,1000.00,1000.00,2000.00,500.00,500.00,0.03,1
32539,3427,1000.00,2000.00,3000.00,0.00,2000.00,0.04,1
32540,3427,1000.00,3000.00,4000.00,831.10,2168.90,0.38,1
32541,3427,1000.00,4000.00,5000.00,0.00,2259.06,0.23,1
32542,3427,1000.00,5000.00,6000.00,2500.00,2500.00,0.00,1
32543,3427,1000.00,6000.00,7000.00,0.00,6000.00,0.37,1
32544,3427,-1000.00,5000.00,6000.00,3845.45,3154.55,0.18,0
32545,3427,1000.00,6000.00,7000.00,0.00,6000.00,0.02,1
32546,3427,1000.00,7000.00,8000.00,1766.19,5233.81,0.29,1
32547,3427,1000.00,8000.00,9000.00,3206.64,4793.36,0.19,1
32548,3427,1000.00,9000.00,10000.00,0.00,9000.00,0.18,1
32549,3427,1000.00,10000.00,11000.00,3787.47,6212.53,0.08,1
32550,3427,1000.00,11000.00,12000.00,156.86,10843.14,0.43,1
32551,3427,1000.00,12000.00,13000.00,3438.48,6642.61,0.30,1
32552,3427,1000.00,13000.00,14000.00,6500.00,6500.00,0.25,1
32553,3427,-1000.00,12000.00,13000.00,11923.59,2076.41,0.08,0
32554,3427,1000.00,13000.00,14000.00,530.11,12469.89,0.37,1
32555,3427,-1000.00,12000.00,13000.00,7320.70,6679.30,0.38,0
32556,3427,-1000.00,11000.00,12000.00,4371.68,8628.32,0.14,0
32557,3427,-1000.00,10000.00,11000.00,5182.28,6817.72,0.08,0
32558,3427,-1000.00,9000.00,10000.00,0.00,11000.00,0.31,0
32559,3427,-1000.00,8000.00,9000.00,2733.52,7266.48,0.40,0
32560,3427,-1000.00,7000.00,8000.00,2297.48,47.64,0.10,0
32561,3427,-1000.00,6000.00,7000.00,3536.20,4463.80,0.02,0
32562,3427,-1000.00,5000.00,6000.00,0.00,7000.00,0.44,0
32563,3427,-1000.00,4000.00,5000.00,1531.80,910.55,0.15,0
32564,3427,-1000.00,3000.00,4000.00,2464.87,2535.13,0.06,0
32565,3427,-1000.00,2000.00,3000.00,2088.82,1911.18,0.08,0
32566,3427,-1000.00,1000.00,2000.00,481.18,1723.09,0.33,0
32567,3427,-998.15,1.85,1001.85,202.20,795.95,0.26,0
32568,3427,-1000.00,-998.15,1.85,532.68,469.17,0.19,0
32569,3427,-0.48,-998.63,1.37,0.00,0.48,0.20,0
32570,3427,-1.37,-1000.00,0.00,0.50,0.87,0.16,0
32571,3428,1000.00,1000.00,2000.00,0.00,1000.00,0.13,1
32572,3428,1000.00,2000.00,3000.00,0.00,2000.00,0.21,1
32573,3428,1000.00,3000.00,4000.00,0.00,3000.00,0.16,1
32574,3428,1000.00,4000.00,5000.00,862.89,3137.11,0.37,1
32575,3428,-1000.00,3000.00,4000.00,0.00,5000.00,0.16,0
32576,3428,-1000.00,2000.00,3000.00,833.11,3166.89,0.38,0
32577,3428,-1000.00,1000.00,2000.00,0.00,3000.00,0.35,0
32578,3428,0.00,1000.00,2000.00,0.00,0.00,0.27,0
32579,3428,-1000.00,0.00,1000.00,990.40,1009.60,0.25,0
32580,3428,-1000.00,-1000.00,0.00,0.00,306.04,0.17,0
32581,3429,-384.78,-384.78,615.22,0.00,384.78,0.22,0
32582,3429,-615.22,-1000.00,0.00,97.36,517.86,0.39,0
32583,3430,-1000.00,-1000.00,0.00,500.00,500.00,0.02,0
32584,3431,-1000.00,-1000.00,0.00,611.87,388.13,0.05,0
32585,3432,-1000.00,-1000.00,0.00,0.00,614.45,0.35,0
32586,3433,1000.00,1000.00,2000.00,435.61,564.39,0.16,1
32587,3433,1000.00,2000.00,3000.00,0.00,1614.70,0.23,1
32588,3433,1000.00,3000.00,4000.00,1500.00,1500.00,0.09,1
32589,3433,1000.00,4000.00,5000.00,0.00,4000.00,0.04,1
32590,3433,1000.00,5000.00,6000.00,278.84,4721.16,0.36,1
32591,3433,1000.00,6000.00,7000.00,0.00,2270.30,0.14,1
32592,3433,-1000.00,5000.00,6000.00,4580.04,2113.85,0.12,0
32593,3433,1000.00,6000.00,7000.00,977.21,4913.04,0.41,1
32594,3433,1000.00,7000.00,8000.00,47.51,3122.38,0.29,1
32595,3433,1000.00,8000.00,9000.00,2634.12,3852.41,0.26,1
32596,3433,1000.00,9000.00,10000.00,4013.58,4986.42,0.05,1
32597,3433,-1000.00,8000.00,9000.00,6185.77,3814.23,0.07,0
32598,3433,1000.00,9000.00,10000.00,3395.14,5604.86,0.44,1
32599,3433,1000.00,10000.00,11000.00,0.00,10000.00,0.09,1
32600,3433,1000.00,11000.00,12000.00,0.00,3420.93,0.03,1
32601,3433,1000.00,12000.00,13000.00,4019.85,7980.15,0.26,1
32602,3433,1000.00,13000.00,14000.00,2666.62,10333.38,0.07,1
32603,3433,1000.00,14000.00,15000.00,6864.34,7135.66,0.11,1
32604,3433,1000.00,15000.00,16000.00,7500.00,7500.00,0.31,1
32605,3433,1000.00,16000.00,17000.00,3456.08,5314.04,0.22,1
32606,3433,1000.00,17000.00,18000.00,0.00,17000.00,0.16,1
32607,3433,1000.00,18000.00,19000.00,0.00,8075.07,0.28,1
32608,3433,1000.00,19000.00,20000.00,0.00,19000.00,0.40,1
32609,3433,1000.00,20000.00,21000.00,0.00,20000.00,0.38,1
32610,3433,1000.00,21000.00,22000.00,8439.10,12560.90,0.21,1
32611,3433,1000.00,22000.00,23000.00,9261.34,12738.66,0.03,1
32612,3433,1000.00,23000.00,24000.00,1681.59,12138.43,0.32,1
32613,3433,1000.00,24000.00,25000.00,0.00,22749.42,0.39,1
32614,3433,1000.00,25000.00,26000.00,5640.13,19359.87,0.31,1
32615,3433,0.00,25000.00,26000.00,0.00,0.00,0.03,0
32616,3433,1000.00,26000.00,27000.00,9367.76,16632.24,0.32,1
32617,3433,1000.00,27000.00,28000.00,8360.90,18639.10,0.33,1
32618,3434,-698.93,-698.93,301.07,0.00,698.93,0.33,0
32619,3434,-6.93,-705.86,294.14,0.00,6.93,0.01,0
32620,3434,-294.14,-1000.00,0.00,36.53,257.61,0.34,0
32621,3435,1000.00,1000.00,2000.00,210.78,789.22,0.31,1
32622,3435,1000.00,2000.00,3000.00,1000.00,1000.00,0.02,1
32623,3435,1000.00,3000.00,4000.00,42.14,2957.86,0.14,1
32624,3435,1000.00,4000.00,5000.00,379.04,2492.34,0.36,1
32625,3435,1000.00,5000.00,6000.00,0.00,5000.00,0.09,1
32626,3435,1000.00,6000.00,7000.00,0.00,1638.20,0.21,1
32627,3435,1000.00,7000.00,8000.00,2055.46,4681.31,0.34,1
32628,3435,1000.00,8000.00,9000.00,0.00,8000.00,0.09,1
32629,3435,1000.00,9000.00,10000.00,0.00,9000.00,0.18,1
32630,3435,1000.00,10000.00,11000.00,2723.46,6981.62,0.35,1
32631,3435,-1000.00,9000.00,10000.00,6424.04,4575.96,0.20,0
32632,3435,-1000.00,8000.00,9000.00,5927.63,4072.37,0.05,0
32633,3435,1000.00,9000.00,10000.00,0.00,9000.00,0.12,1
32634,3435,1000.00,10000.00,11000.00,0.00,10000.00,0.21,1
32635,3435,1000.00,11000.00,12000.00,2554.10,8445.90,0.35,1
32636,3435,1000.00,12000.00,13000.00,1488.60,10511.40,0.13,1
32637,3435,-1000.00,11000.00,12000.00,7522.52,5477.48,0.06,0
32638,3435,1000.00,12000.00,13000.00,0.00,4532.17,0.08,1
32639,3435,1000.00,13000.00,14000.00,5235.87,7764.13,0.24,1
32640,3435,1000.00,14000.00,15000.00,2162.92,11837.08,0.15,1
32641,3435,1000.00,15000.00,16000.00,6980.46,8019.54,0.12,1
32642,3435,-1000.00,14000.00,15000.00,6629.82,9370.18,0.36,0
32643,3435,-1000.00,13000.00,14000.00,0.00,15000.00,0.21,0
32644,3435,-1000.00,12000.00,13000.00,0.00,11833.58,0.13,0
32645,3435,-1000.00,11000.00,12000.00,3756.88,9243.12,0.03,0
32646,3435,-1000.00,10000.00,11000.00,0.00,12000.00,0.43,0
32647,3435,-1000.00,9000.00,10000.00,0.00,11000.00,0.32,0
32648,3435,-1000.00,8000.00,9000.00,2974.74,0.00,0.08,0
32649,3435,-1000.00,7000.00,8000.00,2284.15,6715.85,0.37,0
32650,3435,-1000.00,6000.00,7000.00,3144.59,4855.41,0.28,0
32651,3435,-348.22,5651.78,6651.78,0.00,348.22,0.11,0
32652,3435,-1000.00,4651.78,5651.78,1319.39,5332.39,0.24,0
32653,3435,-1000.00,3651.78,4651.78,677.81,1891.69,0.23,0
32654,3435,-1000.00,2651.78,3651.78,0.00,4651.78,0.44,0
32655,3435,-1000.00,1651.78,2651.78,580.37,1766.44,0.30,0
32656,3435,-274.53,1377.24,2377.24,0.00,274.53,0.11,0
32657,3435,-1000.00,377.24,1377.24,613.37,1455.83,0.33,0
32658,3435,-1000.00,-622.76,377.24,997.31,379.93,0.09,0
32659,3435,1000.00,377.24,1377.24,165.20,212.04,0.25,1
32660,3435,1000.00,1377.24,2377.24,0.00,1138.57,0.11,1
32661,3435,1000.00,2377.24,3377.24,0.00,2377.24,0.37,1
32662,3435,1000.00,3377.24,4377.24,17.18,3360.07,0.44,1
32663,3435,1000.00,4377.24,5377.24,0.00,4377.24,0.41,1
32664,3435,1000.00,5377.24,6377.24,0.00,5370.19,0.43,1
32665,3435,1000.00,6377.24,7377.24,0.00,6377.24,0.17,1
32666,3435,1000.00,7377.24,8377.24,3043.57,4333.68,0.28,1
32667,3435,1000.00,8377.24,9377.24,1712.38,4623.60,0.32,1
32668,3435,1000.00,9377.24,10377.24,0.00,5655.80,0.23,1
32669,3435,1000.00,10377.24,11377.24,0.00,10377.24,0.14,1
32670,3435,1000.00,11377.24,12377.24,2682.37,6167.26,0.31,1
32671,3435,1000.00,12377.24,13377.24,0.00,8411.65,0.09,1
32672,3435,1000.00,13377.24,14377.24,0.00,13377.24,0.02,1
32673,3435,1000.00,14377.24,15377.24,853.89,4283.38,0.22,1
32674,3435,1000.00,15377.24,16377.24,0.00,15377.24,0.34,1
32675,3435,1000.00,16377.24,17377.24,6484.45,9892.80,0.24,1
32676,3435,1000.00,17377.24,18377.24,0.00,13042.60,0.36,1
32677,3435,-1000.00,16377.24,17377.24,11946.60,0.00,0.04,0
32678,3435,1000.00,17377.24,18377.24,0.00,13519.85,0.08,1
32679,3435,1000.00,18377.24,19377.24,3397.76,14979.48,0.40,1
32680,3436,-205.30,-205.30,794.70,0.00,205.30,0.18,0
32681,3436,-465.33,-670.63,329.37,50.88,414.45,0.32,0
32682,3436,-294.68,-965.30,34.70,65.26,229.41,0.37,0
32683,3436,-34.70,-1000.00,0.00,0.96,33.74,0.38,0
32684,3437,-991.26,-991.26,8.74,0.00,991.26,0.36,0
32685,3437,-8.58,-999.84,0.16,0.09,8.49,0.44,0
32686,3437,-0.16,-1000.00,0.00,0.00,0.16,0.15,0
32687,3438,-1000.00,-1000.00,0.00,287.48,712.52,0.14,0
32688,3439,1000.00,1000.00,2000.00,0.00,1000.00,0.02,1
32689,3439,1000.00,2000.00,3000.00,309.43,1690.57,0.16,1
32690,3439,1000.00,3000.00,4000.00,337.04,2662.96,0.19,1
32691,3439,1000.00,4000.00,5000.00,1412.93,2587.07,0.21,1
32692,3439,-1000.00,3000.00,4000.00,1965.42,1068.14,0.15,0
32693,3439,1000.00,4000.00,5000.00,0.00,2908.06,0.12,1
32694,3439,-1000.00,3000.00,4000.00,0.00,3319.46,0.37,0
32695,3439,-1000.00,2000.00,3000.00,1885.24,1429.53,0.18,0
32696,3439,-1000.00,1000.00,2000.00,0.00,1618.30,0.26,0
32697,3439,-1000.00,0.00,1000.00,278.81,1647.73,0.41,0
32698,3439,-1000.00,-1000.00,0.00,0.00,1000.00,0.01,0
32699,3440,-1000.00,-1000.00,0.00,0.00,276.40,0.21,0
32700,3441,1000.00,1000.00,2000.00,500.00,500.00,0.00,1
32701,3441,1000.00,2000.00,3000.00,0.00,1520.45,0.41,1
32702,3441,1000.00,3000.00,4000.00,1500.00,1500.00,0.08,1
32703,3441,-1000.00,2000.00,3000.00,2723.28,1276.72,0.25,0
32704,3441,1000.00,3000.00,4000.00,1203.39,1796.61,0.15,1
32705,3441,1000.00,4000.00,5000.00,1503.28,2496.72,0.38,1
32706,3441,-1000.00,3000.00,4000.00,2532.23,2467.77,0.13,0
32707,3441,1000.00,4000.00,5000.00,671.73,2886.37,0.38,1
32708,3441,1000.00,5000.00,6000.00,2471.21,2528.79,0.07,1
32709,3441,1000.00,6000.00,7000.00,0.00,6000.00,0.19,1
32710,3441,-574.68,5425.32,6425.32,574.68,0.00,0.08,0
32711,3441,1000.00,6425.32,7425.32,2574.57,3850.75,0.27,1
32712,3441,1000.00,7425.32,8425.32,0.00,7425.32,0.19,1
32713,3441,1000.00,8425.32,9425.32,2080.04,6345.28,0.30,1
32714,3441,1000.00,9425.32,10425.32,0.00,6072.54,0.34,1
32715,3441,1000.00,10425.32,11425.32,0.00,9736.33,0.37,1
32716,3441,1000.00,11425.32,12425.32,5540.08,5885.25,0.20,1
32717,3441,1000.00,12425.32,13425.32,0.00,12338.23,0.37,1
32718,3441,1000.00,13425.32,14425.32,0.00,13425.32,0.40,1
32719,3441,1000.00,14425.32,15425.32,0.00,3995.26,0.21,1
32720,3441,-1000.00,13425.32,14425.32,7897.04,7528.29,0.43,0
32721,3441,1000.00,14425.32,15425.32,5891.20,8534.12,0.35,1
32722,3441,1000.00,15425.32,16425.32,0.00,4630.57,0.12,1
32723,3441,-1000.00,14425.32,15425.32,16425.32,0.00,0.03,0
32724,3441,0.00,14425.32,15425.32,0.00,0.00,0.03,0
32725,3441,-1000.00,13425.32,14425.32,3062.70,12362.63,0.33,0
32726,3441,-1000.00,12425.32,13425.32,6741.38,7683.94,0.15,0
32727,3441,0.00,12425.32,13425.32,0.00,0.00,0.06,0
32728,3441,-1000.00,11425.32,12425.32,0.00,4478.62,0.03,0
32729,3441,-1000.00,10425.32,11425.32,5527.60,6897.73,0.20,0
32730,3441,-1000.00,9425.32,10425.32,3574.68,7850.64,0.22,0
32731,3441,-1000.00,8425.32,9425.32,1950.20,8475.13,0.41,0
32732,3441,-1000.00,7425.32,8425.32,4712.66,4712.66,0.13,0
32733,3441,-1000.00,6425.32,7425.32,1631.55,6793.77,0.28,0
32734,3441,-1000.00,5425.32,6425.32,0.00,2797.67,0.08,0
32735,3441,-1000.00,4425.32,5425.32,0.00,5031.07,0.02,0
32736,3441,-1000.00,3425.32,4425.32,3024.68,2400.64,0.18,0
32737,3441,-1000.00,2425.32,3425.32,1129.38,3295.94,0.38,0
32738,3441,-1000.00,1425.32,2425.32,566.69,2858.64,0.37,0
32739,3441,-797.79,627.53,1627.53,0.00,797.79,0.23,0
32740,3441,-1000.00,-372.47,627.53,684.09,943.44,0.02,0
32741,3441,-627.53,-1000.00,0.00,313.77,313.77,0.03,0
32742,3442,1000.00,1000.00,2000.00,192.84,807.16,0.41,1
32743,3442,1000.00,2000.00,3000.00,468.46,1531.54,0.00,1
32744,3442,1000.00,3000.00,4000.00,80.97,2919.03,0.43,1
32745,3442,1000.00,4000.00,5000.00,0.00,2029.04,0.02,1
32746,3442,1000.00,5000.00,6000.00,1801.38,2835.38,0.28,1
32747,3442,1000.00,6000.00,7000.00,0.00,6000.00,0.35,1
32748,3442,1000.00,7000.00,8000.00,2798.44,4201.56,0.19,1
32749,3442,1000.00,8000.00,9000.00,0.00,7457.14,0.16,1
32750,3442,1000.00,9000.00,10000.00,940.10,8059.90,0.39,1
32751,3442,1000.00,10000.00,11000.00,0.00,1637.97,0.08,1
32752,3442,1000.00,11000.00,12000.00,4750.50,6249.50,0.26,1
32753,3442,-1000.00,10000.00,11000.00,6007.23,5992.77,0.42,0
32754,3442,1000.00,11000.00,12000.00,5340.39,5659.61,0.13,1
32755,3442,-1000.00,10000.00,11000.00,6208.15,5791.85,0.06,0
32756,3442,1000.00,11000.00,12000.00,3907.30,7092.70,0.31,1
32757,3442,1000.00,12000.00,13000.00,0.00,11784.74,0.04,1
32758,3442,1000.00,13000.00,14000.00,0.00,1716.11,0.04,1
32759,3442,1000.00,14000.00,15000.00,0.00,14000.00,0.07,1
32760,3442,1000.00,15000.00,16000.00,0.00,15000.00,0.41,1
32761,3442,1000.00,16000.00,17000.00,7759.05,8240.95,0.02,1
32762,3442,0.00,16000.00,17000.00,0.00,0.00,0.04,0
32763,3442,1000.00,17000.00,18000.00,0.00,17000.00,0.21,1
32764,3442,1000.00,18000.00,19000.00,0.00,15636.28,0.25,1
32765,3442,1000.00,19000.00,20000.00,4172.06,5381.61,0.21,1
32766,3442,1000.00,20000.00,21000.00,0.00,20000.00,0.17,1
32767,3442,1000.00,21000.00,22000.00,6205.69,14794.31,0.35,1
32768,3442,1000.00,22000.00,23000.00,0.00,22000.00,0.30,1
32769,3442,-1000.00,21000.00,22000.00,6847.14,2543.59,0.13,0
32770,3442,1000.00,22000.00,23000.00,0.00,22000.00,0.41,1
32771,3442,1000.00,23000.00,24000.00,1998.83,4575.81,0.18,1
32772,3442,1000.00,24000.00,25000.00,0.00,14230.22,0.05,1
32773,3442,1000.00,25000.00,26000.00,12500.00,12500.00,0.22,1
32774,3442,1000.00,26000.00,27000.00,57.82,19285.27,0.40,1
32775,3442,1000.00,27000.00,28000.00,5368.26,21631.74,0.44,1
32776,3442,1000.00,28000.00,29000.00,12520.30,15479.70,0.20,1
32777,3442,1000.00,29000.00,30000.00,3803.62,25196.38,0.14,1
32778,3442,1000.00,30000.00,31000.00,0.00,26149.99,0.39,1
32779,3442,-1000.00,29000.00,30000.00,15741.37,15258.63,0.41,0
32780,3443,0.00,0.00,1000.00,0.00,0.00,0.03,0
32781,3443,1000.00,1000.00,2000.00,557.99,0.00,0.19,1
32782,3443,1000.00,2000.00,3000.00,1108.77,339.57,0.28,1
32783,3443,0.00,2000.00,3000.00,0.00,0.00,0.21,0
32784,3443,1000.00,3000.00,4000.00,1291.77,0.00,0.34,1
32785,3443,1000.00,4000.00,5000.00,563.30,0.00,0.36,1
32786,3443,-366.53,3633.47,4633.47,0.00,366.53,0.39,0
32787,3443,-385.34,3248.12,4248.12,0.00,385.34,0.44,0
32788,3443,1000.00,4248.12,5248.12,2781.49,0.00,0.22,1
32789,3443,-630.36,3617.76,4617.76,0.00,630.36,0.25,0
32790,3443,-1000.00,2617.76,3617.76,0.00,2100.52,0.13,0
32791,3443,0.00,2617.76,3617.76,0.00,0.00,0.29,0
32792,3443,1000.00,3617.76,4617.76,2845.06,0.00,0.17,1
32793,3443,1000.00,4617.76,5617.76,3814.09,0.00,0.04,1
32794,3443,1000.00,5617.76,6617.76,4226.64,0.00,0.08,1
32795,3443,0.00,5617.76,6617.76,0.00,0.00,0.01,0
32796,3443,-1000.00,4617.76,5617.76,0.00,6617.76,0.11,0
32797,3443,0.00,4617.76,5617.76,0.00,0.00,0.39,0
32798,3443,0.00,4617.76,5617.76,0.00,0.00,0.11,0
32799,3443,0.00,4617.76,5617.76,0.00,0.00,0.28,0
32800,3443,0.00,4617.76,5617.76,0.00,0.00,0.26,0
32801,3443,0.00,4617.76,5617.76,0.00,0.00,0.01,0
32802,3443,1000.00,5617.76,6617.76,1153.88,0.00,0.40,1
32803,3443,1000.00,6617.76,7617.76,221.70,0.00,0.06,1
32804,3443,0.00,6617.76,7617.76,0.00,0.00,0.22,0
32805,3443,0.00,6617.76,7617.76,0.00,0.00,0.11,0
32806,3443,-1000.00,5617.76,6617.76,5490.67,0.00,0.20,0
32807,3443,-1000.00,4617.76,5617.76,4243.39,2374.37,0.03,0
32808,3443,-1000.00,3617.76,4617.76,3391.34,0.00,0.19,0
32809,3443,-1000.00,2617.76,3617.76,195.60,4032.03,0.15,0
32810,3443,-1000.00,1617.76,2617.76,0.00,3023.05,0.16,0
32811,3443,0.00,1617.76,2617.76,0.00,0.00,0.14,0
32812,3443,-1000.00,617.76,1617.76,1308.88,1308.88,0.00,0
32813,3443,-582.87,34.89,1034.89,582.87,0.00,0.24,0
32814,3443,-73.91,-39.02,960.98,73.91,0.00,0.39,0
32815,3443,-1000.00,-1039.02,-39.02,0.00,294.86,0.11,0
32816,3444,-1000.00,-1000.00,0.00,0.00,1000.00,0.37,0
32817,3445,-1000.00,-1000.00,0.00,500.00,500.00,0.02,0
32818,3446,-898.60,-898.60,101.40,3.15,895.44,0.44,0
32819,3446,-101.40,-1000.00,0.00,27.82,73.58,0.30,0
32820,3447,-1000.00,-1000.00,0.00,0.00,159.78,0.41,0
32821,3448,-1000.00,-1000.00,0.00,289.23,327.73,0.25,0
32822,3449,-1000.00,-1000.00,0.00,1000.00,0.00,0.00,0
32823,3450,-434.04,-434.04,565.96,434.04,0.00,0.30,0
32824,3450,-1000.00,-1434.04,-434.04,174.60,180.03,0.34,0
32825,3451,-1000.00,-1000.00,0.00,319.89,680.11,0.21,0
32826,3452,-1000.00,-1000.00,0.00,278.83,721.17,0.07,0
32827,3453,-1000.00,-1000.00,0.00,0.00,1000.00,0.09,0
32828,3454,1000.00,1000.00,2000.00,0.00,1000.00,0.35,1
32829,3454,1000.00,2000.00,3000.00,0.00,1771.09,0.43,1
32830,3454,1000.00,3000.00,4000.00,0.00,1751.89,0.14,1
32831,3454,1000.00,4000.00,5000.00,0.00,2632.79,0.20,1
32832,3454,1000.00,5000.00,6000.00,637.77,1847.84,0.25,1
32833,3454,1000.00,6000.00,7000.00,0.00,6000.00,0.08,1
32834,3454,1000.00,7000.00,8000.00,0.00,7000.00,0.43,1
32835,3454,1000.00,8000.00,9000.00,0.00,8000.00,0.20,1
32836,3454,1000.00,9000.00,10000.00,0.00,5964.18,0.38,1
32837,3454,1000.00,10000.00,11000.00,4728.91,5271.09,0.12,1
32838,3454,1000.00,11000.00,12000.00,3069.95,7930.05,0.31,1
32839,3454,1000.00,12000.00,13000.00,0.00,6879.23,0.13,1
32840,3454,-1000.00,11000.00,12000.00,6562.90,6437.10,0.20,0
32841,3454,-1000.00,10000.00,11000.00,7218.81,4781.19,0.12,0
32842,3454,1000.00,11000.00,12000.00,0.00,7616.37,0.22,1
32843,3454,1000.00,12000.00,13000.00,6000.00,6000.00,0.06,1
32844,3454,1000.00,13000.00,14000.00,6500.00,6500.00,0.08,1
32845,3454,0.00,13000.00,14000.00,0.00,0.00,0.07,0
32846,3454,1000.00,14000.00,15000.00,5422.00,8578.00,0.19,1
32847,3454,1000.00,15000.00,16000.00,0.00,15000.00,0.27,1
32848,3454,1000.00,16000.00,17000.00,0.00,8945.78,0.15,1
32849,3454,1000.00,17000.00,18000.00,7844.50,9155.50,0.31,1
32850,3454,1000.00,18000.00,19000.00,7453.93,10546.07,0.28,1
32851,3454,1000.00,19000.00,20000.00,3705.90,15294.10,0.41,1
32852,3454,-1000.00,18000.00,19000.00,0.00,20000.00,0.39,0
32853,3454,-1000.00,17000.00,18000.00,1356.87,15689.49,0.42,0
32854,3454,-1000.00,16000.00,17000.00,0.00,18000.00,0.16,0
32855,3454,-1000.00,15000.00,16000.00,643.73,16356.27,0.42,0
32856,3454,-1000.00,14000.00,15000.00,0.00,6727.20,0.13,0
32857,3454,-1000.00,13000.00,14000.00,7335.45,7664.55,0.12,0
32858,3454,-1000.00,12000.00,13000.00,0.00,7351.96,0.32,0
32859,3454,-1000.00,11000.00,12000.00,0.00,13000.00,0.30,0
32860,3454,-1000.00,10000.00,11000.00,0.00,12000.00,0.08,0
32861,3454,-781.45,9218.55,10218.55,0.00,781.45,0.12,0
32862,3454,0.00,9218.55,10218.55,0.00,0.00,0.04,0
32863,3454,-1000.00,8218.55,9218.55,7584.38,1806.89,0.08,0
32864,3454,0.00,8218.55,9218.55,0.00,0.00,0.07,0
32865,3454,-1000.00,7218.55,8218.55,0.00,9218.55,0.13,0
32866,3454,-1000.00,6218.55,7218.55,0.00,8218.55,0.03,0
32867,3454,-1000.00,5218.55,6218.55,3481.99,0.00,0.04,0
32868,3454,-1000.00,4218.55,5218.55,3109.28,3109.28,0.22,0
32869,3454,-1000.00,3218.55,4218.55,2609.28,2609.28,0.04,0
32870,3454,-1000.00,2218.55,3218.55,1789.28,2429.27,0.01,0
32871,3454,-1000.00,1218.55,2218.55,944.81,2273.74,0.36,0
32872,3454,-1000.00,218.55,1218.55,1101.10,1117.46,0.09,0
32873,3455,1000.00,1000.00,2000.00,0.00,1000.00,0.43,1
32874,3455,1000.00,2000.00,3000.00,629.81,1370.19,0.33,1
32875,3455,1000.00,3000.00,4000.00,1303.80,1696.20,0.07,1
32876,3455,1000.00,4000.00,5000.00,0.00,2806.67,0.38,1
32877,3455,1000.00,5000.00,6000.00,0.00,4979.35,0.44,1
32878,3455,1000.00,6000.00,7000.00,0.00,6000.00,0.21,1
32879,3455,1000.00,7000.00,8000.00,0.00,7000.00,0.14,1
32880,3455,1000.00,8000.00,9000.00,0.00,7035.59,0.42,1
32881,3455,1000.00,9000.00,10000.00,0.00,9000.00,0.23,1
32882,3455,1000.00,10000.00,11000.00,0.00,10000.00,0.07,1
32883,3455,1000.00,11000.00,12000.00,0.00,3657.91,0.04,1
32884,3455,1000.00,12000.00,13000.00,0.00,12000.00,0.26,1
32885,3455,1000.00,13000.00,14000.00,0.00,13000.00,0.35,1
32886,3455,-1000.00,12000.00,13000.00,4209.56,1526.72,0.13,0
32887,3455,1000.00,13000.00,14000.00,0.00,13000.00,0.18,1
32888,3455,1000.00,14000.00,15000.00,1622.86,12377.14,0.03,1
32889,3455,-1000.00,13000.00,14000.00,8406.20,6593.80,0.23,0
32890,3455,1000.00,14000.00,15000.00,0.00,14000.00,0.18,1
32891,3455,-1000.00,13000.00,14000.00,15000.00,0.00,0.02,0
32892,3455,-1000.00,12000.00,13000.00,6242.36,7757.64,0.32,0
32893,3455,-1000.00,11000.00,12000.00,624.64,8030.38,0.36,0
32894,3455,-1000.00,10000.00,11000.00,5675.26,6324.74,0.18,0
32895,3455,-1000.00,9000.00,10000.00,45.07,9160.41,0.43,0
32896,3455,-1000.00,8000.00,9000.00,5598.72,4401.28,0.06,0
32897,3455,-1000.00,7000.00,8000.00,0.00,9000.00,0.15,0
32898,3455,-1000.00,6000.00,7000.00,4000.00,4000.00,0.05,0
32899,3455,-1000.00,5000.00,6000.00,0.00,7000.00,0.29,0
32900,3455,-1000.00,4000.00,5000.00,601.34,5398.66,0.40,0
32901,3455,-1000.00,3000.00,4000.00,0.00,1267.58,0.20,0
32902,3455,-1000.00,2000.00,3000.00,0.00,3816.20,0.05,0
32903,3455,-1000.00,1000.00,2000.00,1359.46,1640.54,0.16,0
32904,3455,-1000.00,0.00,1000.00,0.00,2000.00,0.21,0
32905,3455,-1000.00,-1000.00,0.00,0.00,1000.00,0.31,0
32906,3456,-1000.00,-1000.00,0.00,0.00,1000.00,0.26,0
32907,3457,1000.00,1000.00,2000.00,392.36,607.64,0.29,1
32908,3457,1000.00,2000.00,3000.00,0.00,267.63,0.09,1
32909,3457,0.00,2000.00,3000.00,0.00,0.00,0.11,0
32910,3457,1000.00,3000.00,4000.00,0.00,221.07,0.06,1
32911,3457,1000.00,4000.00,5000.00,284.47,3715.53,0.44,1
32912,3457,-1000.00,3000.00,4000.00,2907.63,225.33,0.08,0
32913,3457,1000.00,4000.00,5000.00,0.00,4000.00,0.41,1
32914,3457,1000.00,5000.00,6000.00,0.00,4055.65,0.23,1
32915,3457,-1000.00,4000.00,5000.00,4335.23,1664.77,0.07,0
32916,3457,1000.00,5000.00,6000.00,0.00,4312.50,0.18,1
32917,3457,1000.00,6000.00,7000.00,1849.28,4150.72,0.35,1
32918,3457,1000.00,7000.00,8000.00,2655.91,4344.09,0.31,1
32919,3457,-1000.00,6000.00,7000.00,2851.36,5148.64,0.37,0
32920,3457,-1000.00,5000.00,6000.00,2838.71,4161.29,0.08,0
32921,3457,-1000.00,4000.00,5000.00,0.00,6000.00,0.02,0
32922,3457,-1000.00,3000.00,4000.00,4624.55,375.45,0.13,0
32923,3457,-1000.00,2000.00,3000.00,1369.57,2630.43,0.04,0
32924,3457,-1000.00,1000.00,2000.00,1500.00,1500.00,0.09,0
32925,3457,-555.68,444.32,1444.32,555.68,0.00,0.03,0
32926,3457,-100.82,343.50,1343.50,0.00,0.95,0.09,0
32927,3457,-1000.00,-656.50,343.50,7.33,1336.17,0.42,0
32928,3457,-1000.00,-1656.50,-656.50,93.79,249.71,0.35,0
32929,3458,1000.00,1000.00,2000.00,366.12,0.00,0.09,1
32930,3458,1000.00,2000.00,3000.00,153.23,0.00,0.00,1
32931,3458,-701.51,1298.49,2298.49,0.00,701.51,0.34,0
32932,3458,0.00,1298.49,2298.49,0.00,0.00,0.18,0
32933,3458,1000.00,2298.49,3298.49,1960.09,338.40,0.06,1
32934,3458,-1000.00,1298.49,2298.49,0.00,1450.36,0.33,0
32935,3458,-1000.00,298.49,1298.49,505.00,1793.49,0.36,0
32936,3458,-251.77,46.72,1046.72,0.00,251.77,0.23,0
32937,3458,-1000.00,-953.28,46.72,0.00,1046.72,0.07,0
32938,3458,-1.29,-954.58,45.42,0.00,1.29,0.40,0
32939,3458,-45.42,-1000.00,0.00,0.00,45.42,0.02,0
32940,3459,-1000.00,-1000.00,0.00,0.00,442.51,0.17,0
32941,3460,-1000.00,-1000.00,0.00,0.00,1000.00,0.12,0
32942,3461,-422.07,-422.07,577.93,106.44,315.63,0.23,0
32943,3461,-577.93,-1000.00,0.00,228.48,349.45,0.01,0
32944,3462,-1000.00,-1000.00,0.00,0.00,185.17,0.22,0
32945,3463,-1000.00,-1000.00,0.00,671.89,328.11,0.04,0
32946,3464,-1000.00,-1000.00,0.00,464.19,535.81,0.04,0
32947,3465,-1000.00,-1000.00,0.00,938.13,61.87,0.06,0
32948,3466,1000.00,1000.00,2000.00,102.91,897.09,0.40,1
32949,3466,1000.00,2000.00,3000.00,0.00,1769.01,0.17,1
32950,3466,1000.00,3000.00,4000.00,1309.79,1690.21,0.24,1
32951,3466,1000.00,4000.00,5000.00,0.00,1694.54,0.27,1
32952,3466,1000.00,5000.00,6000.00,2020.09,2979.91,0.19,1
32953,3466,1000.00,6000.00,7000.00,2946.61,3053.39,0.14,1
32954,3466,1000.00,7000.00,8000.00,0.00,7000.00,0.18,1
32955,3466,1000.00,8000.00,9000.00,0.00,7577.12,0.25,1
32956,3466,1000.00,9000.00,10000.00,1529.48,7470.52,0.42,1
32957,3466,1000.00,10000.00,11000.00,2150.57,3056.97,0.21,1
32958,3466,1000.00,11000.00,12000.00,4391.73,6608.27,0.10,1
32959,3466,1000.00,12000.00,13000.00,4115.94,7884.06,0.38,1
32960,3466,-1000.00,11000.00,12000.00,11923.64,1076.36,0.14,0
32961,3466,1000.00,12000.00,13000.00,0.00,12000.00,0.32,1
32962,3466,1000.00,13000.00,14000.00,0.00,13000.00,0.39,1
32963,3466,1000.00,14000.00,15000.00,2416.46,4149.53,0.21,1
32964,3466,1000.00,15000.00,16000.00,0.00,15000.00,0.13,1
32965,3466,1000.00,16000.00,17000.00,4407.18,11592.82,0.31,1
32966,3466,1000.00,17000.00,18000.00,8247.13,8752.87,0.13,1
32967,3466,1000.00,18000.00,19000.00,0.00,10439.63,0.22,1
32968,3466,1000.00,19000.00,20000.00,0.00,14171.07,0.22,1
32969,3466,1000.00,20000.00,21000.00,9966.69,10033.31,0.42,1
32970,3466,1000.00,21000.00,22000.00,0.00,18369.70,0.43,1
32971,3466,1000.00,22000.00,23000.00,0.00,22000.00,0.42,1
32972,3466,1000.00,23000.00,24000.00,3533.62,19466.38,0.40,1
32973,3466,1000.00,24000.00,25000.00,0.00,24000.00,0.21,1
32974,3466,1000.00,25000.00,26000.00,0.00,4187.68,0.05,1
32975,3466,1000.00,26000.00,27000.00,0.00,26000.00,0.08,1
32976,3466,1000.00,27000.00,28000.00,0.00,17422.39,0.14,1
32977,3466,-1000.00,26000.00,27000.00,28000.00,0.00,0.01,0
32978,3466,1000.00,27000.00,28000.00,0.00,16935.92,0.15,1
32979,3466,1000.00,28000.00,29000.00,0.00,28000.00,0.13,1
32980,3466,1000.00,29000.00,30000.00,0.00,29000.00,0.15,1
32981,3466,1000.00,30000.00,31000.00,14096.89,15903.11,0.15,1
32982,3466,-1000.00,29000.00,30000.00,17773.30,0.00,0.07,0
32983,3466,1000.00,30000.00,31000.00,4550.94,25449.06,0.42,1
32984,3466,1000.00,31000.00,32000.00,4510.66,26489.34,0.42,1
32985,3466,-1000.00,30000.00,31000.00,20467.52,11532.48,0.03,0
32986,3466,1000.00,31000.00,32000.00,0.00,25057.69,0.35,1
32987,3466,1000.00,32000.00,33000.00,0.00,16863.11,0.32,1
32988,3466,1000.00,33000.00,34000.00,0.00,15178.07,0.22,1
32989,3466,1000.00,34000.00,35000.00,7745.35,26254.65,0.36,1
32990,3466,1000.00,35000.00,36000.00,12066.23,22933.77,0.26,1
32991,3466,1000.00,36000.00,37000.00,18000.00,18000.00,0.03,1
32992,3466,1000.00,37000.00,38000.00,0.00,37000.00,0.34,1
32993,3466,-1000.00,36000.00,37000.00,0.00,38000.00,0.21,0
32994,3466,-1000.00,35000.00,36000.00,0.00,16476.46,0.25,0
32995,3466,-1000.00,34000.00,35000.00,24005.87,11994.13,0.12,0
32996,3466,-1000.00,33000.00,34000.00,0.00,35000.00,0.15,0
32997,3466,-1000.00,32000.00,33000.00,1001.40,32998.60,0.35,0
32998,3466,-1000.00,31000.00,32000.00,0.00,14543.95,0.27,0
32999,3466,-1000.00,30000.00,31000.00,0.00,22032.04,0.36,0
33000,3466,-1000.00,29000.00,30000.00,15467.89,15532.11,0.12,0
33001,3466,-1000.00,28000.00,29000.00,5516.17,12147.53,0.26,0
33002,3466,-1000.00,27000.00,28000.00,5935.77,9344.22,0.22,0
33003,3466,-1000.00,26000.00,27000.00,0.00,28000.00,0.14,0
33004,3466,-1000.00,25000.00,26000.00,13500.00,13500.00,0.13,0
33005,3466,-1000.00,24000.00,25000.00,0.00,15112.28,0.30,0
33006,3466,-1000.00,23000.00,24000.00,7470.93,17529.07,0.21,0
33007,3466,-1000.00,22000.00,23000.00,8615.20,15384.80,0.25,0
33008,3466,0.00,22000.00,23000.00,0.00,0.00,0.04,0
33009,3466,-1000.00,21000.00,22000.00,0.00,23000.00,0.22,0
33010,3466,-1000.00,20000.00,21000.00,6707.76,15292.24,0.19,0
33011,3466,-1000.00,19000.00,20000.00,0.00,21000.00,0.35,0
33012,3467,-1000.00,-1000.00,0.00,191.08,218.80,0.19,0
33013,3468,-1000.00,-1000.00,0.00,0.00,1000.00,0.38,0
33014,3469,-470.76,-470.76,529.24,9.21,461.56,0.30,0
33015,3469,-529.24,-1000.00,0.00,0.00,529.24,0.40,0
33016,3470,-1000.00,-1000.00,0.00,304.12,695.88,0.35,0
33017,3471,-1000.00,-1000.00,0.00,77.17,922.83,0.32,0
33018,3472,-553.85,-553.85,446.15,0.00,553.85,0.34,0
33019,3472,-446.15,-1000.00,0.00,0.00,446.15,0.24,0
33020,3473,-1000.00,-1000.00,0.00,0.00,1000.00,0.12,0
33021,3474,-1000.00,-1000.00,0.00,103.71,896.29,0.36,0
33022,3475,1000.00,1000.00,2000.00,411.66,588.34,0.05,1
33023,3475,1000.00,2000.00,3000.00,736.47,1263.53,0.10,1
33024,3475,-1000.00,1000.00,2000.00,1708.50,1291.50,0.14,0
33025,3475,1000.00,2000.00,3000.00,0.00,2000.00,0.34,1
33026,3475,1000.00,3000.00,4000.00,1349.92,1650.08,0.19,1
33027,3475,1000.00,4000.00,5000.00,0.00,4000.00,0.21,1
33028,3475,-208.17,3791.83,4791.83,208.17,0.00,0.08,0
33029,3475,1000.00,4791.83,5791.83,0.00,2934.64,0.12,1
33030,3475,-1000.00,3791.83,4791.83,4730.54,1061.29,0.05,0
33031,3475,1000.00,4791.83,5791.83,0.00,3944.69,0.40,1
33032,3475,1000.00,5791.83,6791.83,0.00,4520.84,0.20,1
33033,3475,1000.00,6791.83,7791.83,3395.91,3395.91,0.06,1
33034,3475,1000.00,7791.83,8791.83,0.00,2399.34,0.22,1
33035,3475,1000.00,8791.83,9791.83,0.00,2189.02,0.12,1
33036,3475,1000.00,9791.83,10791.83,0.00,5909.81,0.06,1
33037,3475,1000.00,10791.83,11791.83,0.00,10052.10,0.14,1
33038,3475,1000.00,11791.83,12791.83,1998.86,9792.97,0.16,1
33039,3475,-177.45,11614.38,12614.38,177.45,0.00,0.04,0
33040,3475,1000.00,12614.38,13614.38,0.00,12614.38,0.21,1
33041,3475,-1000.00,11614.38,12614.38,11475.53,0.00,0.04,0
33042,3475,1000.00,12614.38,13614.38,0.00,12614.38,0.25,1
33043,3475,1000.00,13614.38,14614.38,3906.06,9708.32,0.43,1
33044,3475,-1000.00,12614.38,13614.38,8243.31,6371.08,0.25,0
33045,3475,1000.00,13614.38,14614.38,0.00,13614.38,0.41,1
33046,3475,1000.00,14614.38,15614.38,1057.47,13225.62,0.44,1
33047,3475,1000.00,15614.38,16614.38,7175.04,8439.34,0.13,1
33048,3475,1000.00,16614.38,17614.38,0.00,16614.38,0.41,1
33049,3475,-1000.00,15614.38,16614.38,9714.25,7900.13,0.02,0
33050,3475,1000.00,16614.38,17614.38,0.00,14733.74,0.32,1
33051,3475,1000.00,17614.38,18614.38,4136.90,13477.49,0.23,1
33052,3475,1000.00,18614.38,19614.38,0.00,18614.38,0.31,1
33053,3475,1000.00,19614.38,20614.38,0.00,19614.38,0.41,1
33054,3475,1000.00,20614.38,21614.38,0.00,20614.38,0.16,1
33055,3475,-1000.00,19614.38,20614.38,12270.89,9343.50,0.05,0
33056,3475,1000.00,20614.38,21614.38,0.00,4266.36,0.12,1
33057,3475,1000.00,21614.38,22614.38,0.00,21614.38,0.19,1
33058,3475,1000.00,22614.38,23614.38,0.00,22614.38,0.19,1
33059,3475,1000.00,23614.38,24614.38,0.00,14853.04,0.36,1
33060,3475,1000.00,24614.38,25614.38,1028.07,23586.32,0.44,1
33061,3475,1000.00,25614.38,26614.38,0.00,25614.38,0.13,1
33062,3475,1000.00,26614.38,27614.38,13307.19,13307.19,0.07,1
33063,3475,-1000.00,25614.38,26614.38,8707.37,7730.39,0.19,0
33064,3475,1000.00,26614.38,27614.38,0.00,26614.38,0.25,1
33065,3475,1000.00,27614.38,28614.38,0.00,17832.83,0.26,1
33066,3475,1000.00,28614.38,29614.38,0.00,28614.38,0.29,1
33067,3475,1000.00,29614.38,30614.38,0.00,29614.38,0.06,1
33068,3476,-903.48,-903.48,96.52,0.00,903.48,0.40,0
33069,3476,-96.52,-1000.00,0.00,0.00,96.52,0.09,0
33070,3477,-1000.00,-1000.00,0.00,120.08,879.92,0.43,0
33071,3478,-1000.00,-1000.00,0.00,0.00,1000.00,0.11,0
33072,3479,-400.46,-400.46,599.54,130.82,269.64,0.21,0
33073,3479,-599.54,-1000.00,0.00,0.00,599.54,0.24,0
33074,3480,-1000.00,-1000.00,0.00,0.00,1000.00,0.08,0
33075,3481,-1000.00,-1000.00,0.00,0.00,489.50,0.29,0
33076,3482,-1000.00,-1000.00,0.00,0.00,1000.00,0.32,0
33077,3483,1000.00,1000.00,2000.00,0.00,1000.00,0.42,1
33078,3483,1000.00,2000.00,3000.00,267.15,1732.85,0.23,1
33079,3483,1000.00,3000.00,4000.00,1279.58,1720.42,0.22,1
33080,3483,1000.00,4000.00,5000.00,0.00,4000.00,0.16,1
33081,3483,1000.00,5000.00,6000.00,0.00,3228.02,0.30,1
33082,3483,0.00,5000.00,6000.00,0.00,0.00,0.06,0
33083,3483,1000.00,6000.00,7000.00,2467.58,3532.42,0.21,1
33084,3483,1000.00,7000.00,8000.00,502.31,6497.69,0.42,1
33085,3483,1000.00,8000.00,9000.00,2132.26,5867.74,0.39,1
33086,3483,1000.00,9000.00,10000.00,0.00,9000.00,0.07,1
33087,3483,1000.00,10000.00,11000.00,4571.31,5428.69,0.20,1
33088,3483,1000.00,11000.00,12000.00,30.07,10969.93,0.36,1
33089,3483,1000.00,12000.00,13000.00,0.00,10006.06,0.41,1
33090,3483,1000.00,13000.00,14000.00,0.00,13000.00,0.26,1
33091,3483,1000.00,14000.00,15000.00,0.00,12287.66,0.32,1
33092,3483,1000.00,15000.00,16000.00,0.00,15000.00,0.20,1
33093,3483,1000.00,16000.00,17000.00,0.00,16000.00,0.36,1
33094,3483,0.00,16000.00,17000.00,0.00,0.00,0.08,0
33095,3483,1000.00,17000.00,18000.00,0.00,17000.00,0.44,1
33096,3483,1000.00,18000.00,19000.00,0.00,18000.00,0.17,1
33097,3483,1000.00,19000.00,20000.00,3490.04,4531.22,0.19,1
33098,3483,-1000.00,18000.00,19000.00,10538.24,6985.78,0.17,0
33099,3483,-1000.00,17000.00,18000.00,9500.00,9500.00,0.10,0
33100,3483,-1000.00,16000.00,17000.00,8330.26,9669.74,0.06,0
33101,3483,-1000.00,15000.00,16000.00,7958.77,5917.68,0.18,0
33102,3483,-1000.00,14000.00,15000.00,0.00,16000.00,0.20,0
33103,3483,-1000.00,13000.00,14000.00,0.00,4164.47,0.12,0
33104,3483,-1000.00,12000.00,13000.00,7000.00,7000.00,0.05,0
33105,3483,-1000.00,11000.00,12000.00,6224.40,6775.60,0.20,0
33106,3483,-1000.00,10000.00,11000.00,8607.58,955.86,0.07,0
33107,3483,-1000.00,9000.00,10000.00,0.00,9882.93,0.18,0
33108,3483,-1000.00,8000.00,9000.00,0.00,10000.00,0.10,0
33109,3483,-1000.00,7000.00,8000.00,2680.36,6319.64,0.17,0
33110,3483,-1000.00,6000.00,7000.00,2792.26,5207.74,0.29,0
33111,3483,-1000.00,5000.00,6000.00,409.66,6590.34,0.01,0
33112,3483,-1000.00,4000.00,5000.00,0.00,6000.00,0.07,0
33113,3483,-1000.00,3000.00,4000.00,1795.54,3204.46,0.25,0
33114,3483,-1000.00,2000.00,3000.00,2011.02,1988.98,0.18,0
33115,3483,-1000.00,1000.00,2000.00,0.00,3000.00,0.26,0
33116,3483,0.00,1000.00,2000.00,0.00,0.00,0.01,0
33117,3483,-1000.00,0.00,1000.00,544.70,1455.30,0.35,0
33118,3483,-1000.00,-1000.00,0.00,156.36,843.64,0.40,0
33119,3483,-0.00,-1000.00,0.00,0.00,0.00,0.20,0
33120,3484,-1000.00,-1000.00,0.00,0.00,1000.00,0.10,0
33121,3485,0.00,0.00,1000.00,0.00,0.00,0.03,0
33122,3485,-1000.00,-1000.00,0.00,433.77,566.23,0.20,0
33123,3486,-1000.00,-1000.00,0.00,135.90,864.10,0.36,0
33124,3487,-1000.00,-1000.00,0.00,0.00,64.64,0.42,0
33125,3488,1000.00,1000.00,2000.00,138.18,861.82,0.22,1
33126,3488,1000.00,2000.00,3000.00,233.57,1766.43,0.36,1
33127,3488,1000.00,3000.00,4000.00,0.00,2610.41,0.42,1
33128,3488,1000.00,4000.00,5000.00,0.00,2055.18,0.24,1
33129,3488,1000.00,5000.00,6000.00,711.64,848.37,0.17,1
33130,3488,1000.00,6000.00,7000.00,0.00,814.46,0.05,1
33131,3488,1000.00,7000.00,8000.00,0.00,5252.56,0.40,1
33132,3488,-1000.00,6000.00,7000.00,4113.06,3886.94,0.10,0
33133,3488,1000.00,7000.00,8000.00,3313.67,3686.33,0.03,1
33134,3488,1000.00,8000.00,9000.00,1259.36,6557.33,0.31,1
33135,3488,1000.00,9000.00,10000.00,0.00,9000.00,0.01,1
33136,3488,1000.00,10000.00,11000.00,709.87,9290.13,0.09,1
33137,3488,1000.00,11000.00,12000.00,0.00,11000.00,0.21,1
33138,3488,1000.00,12000.00,13000.00,4745.68,7254.32,0.23,1
33139,3488,1000.00,13000.00,14000.00,0.00,13000.00,0.35,1
33140,3488,1000.00,14000.00,15000.00,2660.52,11339.48,0.38,1
33141,3488,1000.00,15000.00,16000.00,4578.86,10421.14,0.19,1
33142,3488,1000.00,16000.00,17000.00,7738.97,8261.03,0.06,1
33143,3488,-1000.00,15000.00,16000.00,8500.00,8500.00,0.05,0
33144,3488,-1000.00,14000.00,15000.00,0.00,11456.46,0.19,0
33145,3488,-1000.00,13000.00,14000.00,3417.60,11582.40,0.40,0
33146,3488,-1000.00,12000.00,13000.00,2828.31,11171.69,0.33,0
33147,3488,-1000.00,11000.00,12000.00,0.00,13000.00,0.13,0
33148,3488,-1000.00,10000.00,11000.00,0.00,6260.21,0.19,0
33149,3488,-1000.00,9000.00,10000.00,1264.48,9735.52,0.28,0
33150,3488,-1000.00,8000.00,9000.00,0.00,10000.00,0.02,0
33151,3488,-1000.00,7000.00,8000.00,0.00,6719.15,0.40,0
33152,3488,-1000.00,6000.00,7000.00,2446.42,2331.13,0.19,0
33153,3488,-1000.00,5000.00,6000.00,383.88,5905.58,0.43,0
33154,3488,-1000.00,4000.00,5000.00,0.00,4630.02,0.32,0
33155,3488,-1000.00,3000.00,4000.00,1506.45,3493.55,0.36,0
33156,3488,-1000.00,2000.00,3000.00,0.00,4000.00,0.35,0
33157,3488,-1000.00,1000.00,2000.00,3000.00,0.00,0.01,0
33158,3488,-1000.00,0.00,1000.00,1452.66,0.00,0.01,0
33159,3488,-960.61,-960.61,39.39,0.00,960.61,0.35,0
33160,3488,-39.39,-1000.00,0.00,0.00,39.39,0.10,0
33161,3489,-830.43,-830.43,169.57,0.00,830.43,0.42,0
33162,3489,-169.57,-1000.00,0.00,0.00,169.57,0.06,0
33163,3490,1000.00,1000.00,2000.00,0.00,532.84,0.05,1
33164,3490,1000.00,2000.00,3000.00,895.00,1105.00,0.05,1
33165,3490,1000.00,3000.00,4000.00,879.15,2120.85,0.35,1
33166,3490,1000.00,4000.00,5000.00,1023.74,2976.26,0.38,1
33167,3490,1000.00,5000.00,6000.00,0.00,5000.00,0.07,1
33168,3490,1000.00,6000.00,7000.00,0.00,6000.00,0.13,1
33169,3490,0.00,6000.00,7000.00,0.00,0.00,0.03,0
33170,3490,1000.00,7000.00,8000.00,2021.60,4978.40,0.32,1
33171,3490,1000.00,8000.00,9000.00,0.00,8000.00,0.09,1
33172,3490,1000.00,9000.00,10000.00,147.80,6056.68,0.38,1
33173,3490,1000.00,10000.00,11000.00,0.00,3487.54,0.21,1
33174,3490,1000.00,11000.00,12000.00,5012.19,5987.81,0.11,1
33175,3490,1000.00,12000.00,13000.00,0.00,6358.67,0.10,1
33176,3490,-1000.00,11000.00,12000.00,9251.06,3748.94,0.10,0
33177,3490,1000.00,12000.00,13000.00,6000.00,6000.00,0.00,1
33178,3490,1000.00,13000.00,14000.00,6227.50,6772.50,0.38,1
33179,3490,1000.00,14000.00,15000.00,3477.16,10522.84,0.34,1
33180,3490,-1000.00,13000.00,14000.00,12395.69,2604.31,0.01,0
33181,3490,1000.00,14000.00,15000.00,0.00,14000.00,0.10,1
33182,3490,1000.00,15000.00,16000.00,6060.94,8939.06,0.28,1
33183,3490,1000.00,16000.00,17000.00,0.00,16000.00,0.01,1
33184,3490,-1000.00,15000.00,16000.00,9012.04,7987.96,0.39,0
33185,3490,1000.00,16000.00,17000.00,7339.80,8660.20,0.14,1
33186,3490,1000.00,17000.00,18000.00,4599.48,12400.52,0.31,1
33187,3490,1000.00,18000.00,19000.00,0.00,14479.97,0.12,1
33188,3490,1000.00,19000.00,20000.00,0.00,19000.00,0.01,1
33189,3490,1000.00,20000.00,21000.00,1647.39,18101.07,0.43,1
33190,3490,1000.00,21000.00,22000.00,7610.61,10138.90,0.25,1
33191,3490,1000.00,22000.00,23000.00,7075.66,14924.34,0.19,1
33192,3490,1000.00,23000.00,24000.00,7515.16,15484.84,0.18,1
33193,3490,1000.00,24000.00,25000.00,0.00,14756.67,0.35,1
33194,3490,1000.00,25000.00,26000.00,7023.41,11054.26,0.27,1
33195,3490,1000.00,26000.00,27000.00,3539.70,19486.96,0.40,1
33196,3490,1000.00,27000.00,28000.00,0.00,26217.18,0.35,1
33197,3490,1000.00,28000.00,29000.00,10002.77,17997.23,0.29,1
33198,3490,0.00,28000.00,29000.00,0.00,0.00,0.01,0
33199,3490,1000.00,29000.00,30000.00,7680.91,21319.09,0.29,1
33200,3490,1000.00,30000.00,31000.00,0.00,26474.23,0.26,1
33201,3490,1000.00,31000.00,32000.00,11515.85,19484.15,0.31,1
33202,3491,0.00,0.00,1000.00,0.00,0.00,0.21,0
33203,3491,-270.42,-270.42,729.58,250.74,19.68,0.41,0
33204,3491,-1000.00,-1270.42,-270.42,0.00,726.18,0.10,0
33205,3492,-1000.00,-1000.00,0.00,193.88,806.12,0.37,0
33206,3493,-1000.00,-1000.00,0.00,266.26,733.74,0.28,0
33207,3494,-1000.00,-1000.00,0.00,0.00,1000.00,0.26,0
33208,3495,1000.00,1000.00,2000.00,600.24,399.76,0.24,1
33209,3495,1000.00,2000.00,3000.00,1149.72,850.28,0.19,1
33210,3495,-1000.00,1000.00,2000.00,1053.71,1946.29,0.28,0
33211,3495,1000.00,2000.00,3000.00,404.23,0.00,0.03,1
33212,3495,-1000.00,1000.00,2000.00,0.00,2887.07,0.31,0
33213,3495,-1000.00,0.00,1000.00,761.94,1238.06,0.29,0
33214,3495,-273.34,-273.34,726.66,0.00,273.34,0.35,0
33215,3495,-726.66,-1000.00,0.00,223.84,502.82,0.18,0
33216,3496,-1000.00,-1000.00,0.00,500.00,500.00,0.03,0
33217,3497,-1000.00,-1000.00,0.00,293.41,706.59,0.19,0
33218,3498,-1000.00,-1000.00,0.00,0.00,1000.00,0.02,0
33219,3499,-1000.00,-1000.00,0.00,0.00,171.08,0.42,0
33220,3500,1000.00,1000.00,2000.00,1000.00,0.00,0.01,1
33221,3500,-1000.00,0.00,1000.00,793.46,1206.54,0.22,0
33222,3500,-1000.00,-1000.00,0.00,26.15,973.85,0.28,0
33223,3501,1000.00,1000.00,2000.00,371.66,628.34,0.28,1
33224,3501,1000.00,2000.00,3000.00,639.59,1360.41,0.18,1
33225,3501,1000.00,3000.00,4000.00,0.00,3000.00,0.44,1
33226,3501,-1000.00,2000.00,3000.00,2081.49,1918.51,0.14,0
33227,3501,-1000.00,1000.00,2000.00,1645.89,1354.11,0.12,0
33228,3501,-1000.00,0.00,1000.00,1144.80,855.20,0.10,0
33229,3501,1000.00,1000.00,2000.00,0.00,1000.00,0.24,1
33230,3501,1000.00,2000.00,3000.00,0.00,668.27,0.18,1
33231,3501,1000.00,3000.00,4000.00,0.00,2963.04,0.39,1
33232,3501,1000.00,4000.00,5000.00,0.00,4000.00,0.07,1
33233,3501,1000.00,5000.00,6000.00,1007.22,2844.53,0.32,1
33234,3501,-1000.00,4000.00,5000.00,3672.84,2327.16,0.12,0
33235,3501,1000.00,5000.00,6000.00,0.00,4354.69,0.42,1
33236,3501,1000.00,6000.00,7000.00,3000.00,3000.00,0.00,1
33237,3501,1000.00,7000.00,8000.00,0.00,4365.76,0.31,1
33238,3501,1000.00,8000.00,9000.00,2064.25,5935.75,0.38,1
33239,3501,1000.00,9000.00,10000.00,988.76,8011.24,0.37,1
33240,3501,1000.00,10000.00,11000.00,824.65,9175.35,0.39,1
33241,3501,-1000.00,9000.00,10000.00,5387.09,577.66,0.09,0
33242,3501,1000.00,10000.00,11000.00,0.00,10000.00,0.27,1
33243,3501,1000.00,11000.00,12000.00,0.00,8305.50,0.41,1
33244,3501,1000.00,12000.00,13000.00,0.00,12000.00,0.04,1
33245,3501,-1000.00,11000.00,12000.00,6082.16,414.23,0.09,0
33246,3501,1000.00,12000.00,13000.00,0.00,12000.00,0.29,1
33247,3501,-1000.00,11000.00,12000.00,10698.72,2301.28,0.10,0
33248,3501,-1000.00,10000.00,11000.00,5838.18,6161.82,0.10,0
33249,3501,-1000.00,9000.00,10000.00,209.62,10790.38,0.44,0
33250,3501,-1000.00,8000.00,9000.00,0.00,10000.00,0.06,0
33251,3501,-1000.00,7000.00,8000.00,4500.00,4500.00,0.02,0
33252,3501,-1000.00,6000.00,7000.00,0.00,8000.00,0.29,0
33253,3501,-1000.00,5000.00,6000.00,0.00,7000.00,0.13,0
33254,3501,-1000.00,4000.00,5000.00,918.96,5081.04,0.34,0
33255,3501,-1000.00,3000.00,4000.00,0.00,2546.61,0.10,0
33256,3501,-1000.00,2000.00,3000.00,1958.80,2041.20,0.13,0
33257,3501,-1000.00,1000.00,2000.00,0.00,3000.00,0.42,0
33258,3501,-1000.00,0.00,1000.00,283.49,1716.51,0.03,0
33259,3501,-1000.00,-1000.00,0.00,636.05,341.44,0.14,0
33260,3502,-1000.00,-1000.00,0.00,1000.00,0.00,0.05,0
33261,3503,-879.92,-879.92,120.08,0.00,879.92,0.39,0
33262,3503,-120.08,-1000.00,0.00,41.59,78.49,0.23,0
33263,3504,-1000.00,-1000.00,0.00,0.00,1000.00,0.24,0
33264,3505,-1000.00,-1000.00,0.00,0.00,1000.00,0.22,0
33265,3506,-1000.00,-1000.00,0.00,0.00,1000.00,0.30,0
33266,3507,-1000.00,-1000.00,0.00,0.00,367.12,0.38,0
33267,3508,1000.00,1000.00,2000.00,0.00,1000.00,0.14,1
33268,3508,1000.00,2000.00,3000.00,11.27,1506.57,0.41,1
33269,3508,1000.00,3000.00,4000.00,0.00,3000.00,0.16,1
33270,3508,1000.00,4000.00,5000.00,2000.00,2000.00,0.09,1
33271,3508,-1000.00,3000.00,4000.00,2510.57,0.00,0.04,0
33272,3508,1000.00,4000.00,5000.00,0.00,3410.38,0.12,1
33273,3508,-1000.00,3000.00,4000.00,3375.66,1624.34,0.04,0
33274,3508,1000.00,4000.00,5000.00,1761.21,2238.79,0.12,1
33275,3508,-1000.00,3000.00,4000.00,3015.45,1984.55,0.12,0
33276,3508,0.00,3000.00,4000.00,0.00,0.00,0.03,0
33277,3508,1000.00,4000.00,5000.00,1481.33,2518.67,0.31,1
33278,3508,1000.00,5000.00,6000.00,2010.53,2887.59,0.28,1
33279,3508,1000.00,6000.00,7000.00,834.34,3070.27,0.31,1
33280,3508,1000.00,7000.00,8000.00,0.00,7000.00,0.09,1
33281,3508,1000.00,8000.00,9000.00,0.00,8000.00,0.07,1
33282,3508,1000.00,9000.00,10000.00,1262.36,7737.64,0.36,1
33283,3508,1000.00,10000.00,11000.00,0.00,5248.14,0.31,1
33284,3508,1000.00,11000.00,12000.00,3147.86,7852.14,0.03,1
33285,3508,1000.00,12000.00,13000.00,0.00,8766.85,0.38,1
33286,3508,1000.00,13000.00,14000.00,2668.31,3667.43,0.20,1
33287,3508,-1000.00,12000.00,13000.00,8881.73,5118.27,0.12,0
33288,3508,1000.00,13000.00,14000.00,0.00,13000.00,0.29,1
33289,3508,1000.00,14000.00,15000.00,6115.88,7884.12,0.25,1
33290,3508,1000.00,15000.00,16000.00,3371.97,11628.03,0.33,1
33291,3508,-1000.00,14000.00,15000.00,13044.53,2955.47,0.12,0
33292,3508,1000.00,15000.00,16000.00,558.09,13429.74,0.43,1
33293,3508,1000.00,16000.00,17000.00,0.00,16000.00,0.15,1
33294,3508,1000.00,17000.00,18000.00,0.00,17000.00,0.36,1
33295,3508,1000.00,18000.00,19000.00,0.00,9689.19,0.33,1
33296,3508,1000.00,19000.00,20000.00,8967.43,10032.57,0.15,1
33297,3508,0.00,19000.00,20000.00,0.00,0.00,0.01,0
33298,3508,1000.00,20000.00,21000.00,0.00,10518.53,0.28,1
33299,3508,1000.00,21000.00,22000.00,0.00,21000.00,0.40,1
33300,3508,1000.00,22000.00,23000.00,0.00,22000.00,0.38,1
33301,3508,1000.00,23000.00,24000.00,531.23,22468.77,0.11,1
33302,3508,1000.00,24000.00,25000.00,0.00,24000.00,0.06,1
33303,3508,1000.00,25000.00,26000.00,2598.50,19866.90,0.41,1
33304,3508,1000.00,26000.00,27000.00,11700.19,14299.81,0.17,1
33305,3508,-1000.00,25000.00,26000.00,13400.22,8802.79,0.17,0
33306,3508,-1000.00,24000.00,25000.00,15286.59,10713.41,0.15,0
33307,3508,1000.00,25000.00,26000.00,7553.78,17446.22,0.24,1
33308,3508,1000.00,26000.00,27000.00,8664.79,17335.21,0.30,1
33309,3508,1000.00,27000.00,28000.00,5489.09,21510.91,0.31,1
33310,3508,1000.00,28000.00,29000.00,10405.89,17594.11,0.32,1
33311,3508,1000.00,29000.00,30000.00,9886.06,19113.94,0.31,1
33312,3508,1000.00,30000.00,31000.00,6820.27,23179.73,0.40,1
33313,3508,-1000.00,29000.00,30000.00,16430.09,14569.91,0.33,0
33314,3508,0.00,29000.00,30000.00,0.00,0.00,0.04,0
33315,3508,-1000.00,28000.00,29000.00,23381.43,0.00,0.05,0
33316,3508,-1000.00,27000.00,28000.00,0.00,29000.00,0.19,0
33317,3508,-1000.00,26000.00,27000.00,9962.75,18037.25,0.26,0
33318,3508,-1000.00,25000.00,26000.00,0.00,19217.52,0.31,0
33319,3508,-1000.00,24000.00,25000.00,13429.46,12570.54,0.41,0
33320,3508,-1000.00,23000.00,24000.00,0.00,25000.00,0.06,0
33321,3508,-1000.00,22000.00,23000.00,0.00,24000.00,0.08,0
33322,3508,-1000.00,21000.00,22000.00,0.00,10970.60,0.05,0
33323,3508,-1000.00,20000.00,21000.00,0.00,6426.48,0.21,0
33324,3508,-1000.00,19000.00,20000.00,0.00,21000.00,0.09,0
33325,3508,-1000.00,18000.00,19000.00,8164.98,11835.02,0.12,0
33326,3508,-1000.00,17000.00,18000.00,0.00,18502.49,0.43,0
33327,3508,-1000.00,16000.00,17000.00,855.39,14386.89,0.41,0
33328,3508,-1000.00,15000.00,16000.00,0.00,17000.00,0.35,0
33329,3508,-1000.00,14000.00,15000.00,8000.00,8000.00,0.02,0
33330,3508,-1000.00,13000.00,14000.00,0.00,15000.00,0.41,0
33331,3508,-1000.00,12000.00,13000.00,0.00,3993.89,0.15,0
33332,3508,-1000.00,11000.00,12000.00,0.00,11582.69,0.42,0
33333,3508,-1000.00,10000.00,11000.00,0.00,12000.00,0.10,0
33334,3508,-1000.00,9000.00,10000.00,6757.69,2826.51,0.12,0
33335,3508,-1000.00,8000.00,9000.00,0.00,8175.24,0.42,0
33336,3508,-1000.00,7000.00,8000.00,0.00,7290.98,0.18,0
33337,3508,0.00,7000.00,8000.00,0.00,0.00,0.03,0
33338,3509,-1000.00,-1000.00,0.00,105.99,557.91,0.36,0
33339,3510,1000.00,1000.00,2000.00,0.00,1000.00,0.27,1
33340,3510,1000.00,2000.00,3000.00,889.59,1110.41,0.14,1
33341,3510,1000.00,3000.00,4000.00,0.00,1195.60,0.12,1
33342,3510,1000.00,4000.00,5000.00,0.00,2696.21,0.29,1
33343,3510,1000.00,5000.00,6000.00,0.00,1980.38,0.23,1
33344,3510,-1000.00,4000.00,5000.00,3220.96,2686.44,0.19,0
33345,3510,-1000.00,3000.00,4000.00,2950.07,754.08,0.11,0
33346,3510,1000.00,4000.00,5000.00,1351.11,2648.89,0.08,1
33347,3510,1000.00,5000.00,6000.00,2335.88,2664.12,0.22,1
33348,3510,-1000.00,4000.00,5000.00,4596.44,1403.56,0.08,0
33349,3510,1000.00,5000.00,6000.00,0.00,5000.00,0.15,1
33350,3510,1000.00,6000.00,7000.00,2281.36,3718.64,0.27,1
33351,3510,1000.00,7000.00,8000.00,0.00,1222.20,0.04,1
33352,3510,1000.00,8000.00,9000.00,0.00,8000.00,0.19,1
33353,3510,1000.00,9000.00,10000.00,0.00,9000.00,0.22,1
33354,3510,1000.00,10000.00,11000.00,571.07,9428.93,0.42,1
33355,3510,1000.00,11000.00,12000.00,1075.51,9924.49,0.23,1
33356,3510,1000.00,12000.00,13000.00,863.47,3994.74,0.24,1
33357,3510,1000.00,13000.00,14000.00,4824.39,8175.61,0.22,1
33358,3510,1000.00,14000.00,15000.00,3286.40,10713.60,0.29,1
33359,3510,-1000.00,13000.00,14000.00,989.14,14010.86,0.10,0
33360,3510,-1000.00,12000.00,13000.00,4613.82,8862.41,0.32,0
33361,3510,-1000.00,11000.00,12000.00,6063.49,6936.51,0.24,0
33362,3510,-1000.00,10000.00,11000.00,5238.50,1316.17,0.11,0
33363,3510,-1000.00,9000.00,10000.00,4562.86,5053.50,0.26,0
33364,3510,-1000.00,8000.00,9000.00,2774.55,7225.45,0.37,0
33365,3510,-1000.00,7000.00,8000.00,0.00,8982.70,0.24,0
33366,3510,-1000.00,6000.00,7000.00,0.00,8000.00,0.04,0
33367,3510,-1000.00,5000.00,6000.00,0.00,7000.00,0.09,0
33368,3510,-1000.00,4000.00,5000.00,2905.73,3094.27,0.10,0
33369,3510,-1000.00,3000.00,4000.00,0.00,5000.00,0.21,0
33370,3510,-1000.00,2000.00,3000.00,0.00,3562.14,0.36,0
33371,3510,-1000.00,1000.00,2000.00,1419.09,1580.91,0.18,0
33372,3510,-1000.00,0.00,1000.00,2000.00,0.00,0.02,0
33373,3510,-1000.00,-1000.00,0.00,0.00,1000.00,0.44,0
33374,3511,-222.19,-222.19,777.81,0.00,222.19,0.14,0
33375,3511,-777.81,-1000.00,0.00,145.72,632.08,0.41,0
33376,3512,-1000.00,-1000.00,0.00,9.01,695.16,0.39,0
33377,3513,1000.00,1000.00,2000.00,495.61,0.00,0.09,1
33378,3513,-1000.00,0.00,1000.00,0.00,2000.00,0.12,0
33379,3513,-991.34,-991.34,8.66,0.00,991.34,0.23,0
33380,3513,-6.80,-998.14,1.86,1.67,5.13,0.42,0
33381,3513,-1.32,-999.46,0.54,0.00,1.32,0.33,0
33382,3513,-0.54,-1000.00,0.00,0.00,0.54,0.00,0
33383,3514,1000.00,1000.00,2000.00,398.65,0.00,0.07,1
33384,3514,-937.66,62.34,1062.34,0.00,937.66,0.33,0
33385,3514,1000.00,1062.34,2062.34,268.09,88.07,0.40,1
33386,3514,-905.53,156.81,1156.81,0.00,905.53,0.24,0
33387,3514,-280.12,-123.31,876.69,75.61,204.51,0.42,0
33388,3514,-585.22,-708.53,291.47,110.40,474.83,0.29,0
33389,3514,1000.00,291.47,1291.47,3.46,0.00,0.43,1
33390,3514,1000.00,1291.47,2291.47,205.08,101.32,0.42,1
33391,3514,1000.00,2291.47,3291.47,2291.47,0.00,0.09,1
33392,3514,0.00,2291.47,3291.47,0.00,0.00,0.10,0
33393,3514,1000.00,3291.47,4291.47,1021.92,0.00,0.37,1
33394,3514,-1000.00,2291.47,3291.47,1200.63,3090.84,0.01,0
33395,3514,-1000.00,1291.47,2291.47,443.74,2296.21,0.22,0
33396,3514,-76.55,1214.92,2214.92,0.00,76.55,0.44,0
33397,3514,1000.00,2214.92,3214.92,1265.44,944.85,0.23,1
33398,3514,-1000.00,1214.92,2214.92,0.00,2189.73,0.19,0
33399,3514,1000.00,2214.92,3214.92,2214.92,0.00,0.05,1
33400,3514,-1000.00,1214.92,2214.92,0.00,1889.34,0.18,0
33401,3514,1000.00,2214.92,3214.92,1696.66,0.00,0.16,1
33402,3514,-1000.00,1214.92,2214.92,0.00,1140.27,0.36,0
33403,3514,-1000.00,214.92,1214.92,681.38,518.64,0.36,0
33404,3514,-1000.00,-785.08,214.92,0.00,443.48,0.30,0
33405,3514,-144.04,-929.12,70.88,82.09,61.95,0.32,0
33406,3514,-1000.00,-1929.12,-929.12,22.43,48.46,0.06,0
33407,3515,1000.00,1000.00,2000.00,789.60,210.40,0.04,1
33408,3515,1000.00,2000.00,3000.00,1841.82,158.18,0.05,1
33409,3515,1000.00,3000.00,4000.00,665.21,0.00,0.27,1
33410,3515,-1000.00,2000.00,3000.00,0.00,1110.80,0.38,0
33411,3515,0.00,2000.00,3000.00,0.00,0.00,0.07,0
33412,3515,1000.00,3000.00,4000.00,2417.98,582.02,0.10,1
33413,3515,0.00,3000.00,4000.00,0.00,0.00,0.14,0
33414,3515,-1000.00,2000.00,3000.00,0.00,4000.00,0.03,0
33415,3515,-568.92,1431.08,2431.08,0.00,568.92,0.18,0
33416,3515,-1000.00,431.08,1431.08,463.38,793.88,0.38,0
33417,3515,1000.00,1431.08,2431.08,86.98,0.00,0.26,1
33418,3515,-812.19,618.89,1618.89,0.00,812.19,0.42,0
33419,3515,-996.71,-377.82,622.18,0.00,996.71,0.27,0
33420,3515,-622.18,-1000.00,0.00,0.00,622.18,0.41,0
33421,3516,1000.00,1000.00,2000.00,384.46,615.54,0.30,1
33422,3516,1000.00,2000.00,3000.00,0.00,2000.00,0.42,1
33423,3516,1000.00,3000.00,4000.00,711.97,2288.03,0.41,1
33424,3516,1000.00,4000.00,5000.00,0.00,4000.00,0.09,1
33425,3516,1000.00,5000.00,6000.00,0.00,5000.00,0.34,1
33426,3516,1000.00,6000.00,7000.00,0.00,1131.67,0.15,1
33427,3516,1000.00,7000.00,8000.00,2426.06,4573.94,0.20,1
33428,3516,1000.00,8000.00,9000.00,2030.46,5969.54,0.38,1
33429,3516,1000.00,9000.00,10000.00,1905.57,7094.43,0.19,1
33430,3516,1000.00,10000.00,11000.00,0.00,10000.00,0.39,1
33431,3516,1000.00,11000.00,12000.00,1502.27,9497.73,0.43,1
33432,3516,1000.00,12000.00,13000.00,0.00,6561.25,0.33,1
33433,3516,1000.00,13000.00,14000.00,0.00,7687.66,0.35,1
33434,3516,1000.00,14000.00,15000.00,0.00,14000.00,0.28,1
33435,3516,1000.00,15000.00,16000.00,7500.00,7500.00,0.10,1
33436,3516,1000.00,16000.00,17000.00,7544.56,8455.44,0.18,1
33437,3516,-1000.00,15000.00,16000.00,12546.41,4453.59,0.23,0
33438,3516,-1000.00,14000.00,15000.00,0.00,7214.02,0.18,0
33439,3516,-1000.00,13000.00,14000.00,10879.26,0.00,0.02,0
33440,3516,-1000.00,12000.00,13000.00,0.00,14000.00,0.11,0
33441,3516,-1000.00,11000.00,12000.00,0.00,13000.00,0.06,0
33442,3516,-1000.00,10000.00,11000.00,0.00,9948.14,0.42,0
33443,3516,0.00,10000.00,11000.00,0.00,0.00,0.07,0
33444,3516,-1000.00,9000.00,10000.00,984.30,3164.64,0.24,0
33445,3516,-1000.00,8000.00,9000.00,28.23,9971.77,0.26,0
33446,3516,-1000.00,7000.00,8000.00,0.00,9000.00,0.18,0
33447,3516,-1000.00,6000.00,7000.00,4401.48,0.00,0.01,0
33448,3516,-1000.00,5000.00,6000.00,3317.01,3682.99,0.14,0
33449,3516,-1000.00,4000.00,5000.00,69.69,2992.42,0.31,0
33450,3516,-1000.00,3000.00,4000.00,803.48,4196.52,0.30,0
33451,3516,-1000.00,2000.00,3000.00,2221.64,1778.36,0.14,0
33452,3516,-1000.00,1000.00,2000.00,507.98,2492.02,0.08,0
33453,3516,-1000.00,0.00,1000.00,0.00,2000.00,0.37,0
33454,3516,-1000.00,-1000.00,0.00,500.00,500.00,0.13,0
33455,3517,-1000.00,-1000.00,0.00,325.20,674.80,0.11,0
33456,3518,-1000.00,-1000.00,0.00,0.00,1000.00,0.05,0
33457,3519,-934.78,-934.78,65.22,0.00,934.78,0.44,0
33458,3519,-65.22,-1000.00,0.00,0.00,65.22,0.25,0
33459,3520,1000.00,1000.00,2000.00,0.00,523.61,0.15,1
33460,3520,1000.00,2000.00,3000.00,1000.00,1000.00,0.01,1
33461,3520,1000.00,3000.00,4000.00,1174.19,1825.81,0.19,1
33462,3520,0.00,3000.00,4000.00,0.00,0.00,0.08,0
33463,3520,1000.00,4000.00,5000.00,1766.19,2233.81,0.19,1
33464,3520,-1000.00,3000.00,4000.00,5000.00,0.00,0.02,0
33465,3520,1000.00,4000.00,5000.00,0.00,3142.49,0.36,1
33466,3520,1000.00,5000.00,6000.00,0.00,5000.00,0.09,1
33467,3520,1000.00,6000.00,7000.00,1725.14,3603.56,0.32,1
33468,3520,1000.00,7000.00,8000.00,0.00,5482.31,0.11,1
33469,3520,1000.00,8000.00,9000.00,0.00,8000.00,0.35,1
33470,3520,1000.00,9000.00,10000.00,0.00,2673.67,0.12,1
33471,3520,1000.00,10000.00,11000.00,0.00,1906.32,0.18,1
33472,3520,1000.00,11000.00,12000.00,1382.70,9617.30,0.40,1
33473,3520,1000.00,12000.00,13000.00,3397.60,8602.40,0.13,1
33474,3520,-1000.00,11000.00,12000.00,2044.83,0.00,0.09,0
33475,3520,1000.00,12000.00,13000.00,5273.46,6726.54,0.35,1
33476,3520,1000.00,13000.00,14000.00,1805.81,11194.19,0.43,1
33477,3520,1000.00,14000.00,15000.00,0.00,5600.44,0.06,1
33478,3520,-1000.00,13000.00,14000.00,9576.73,5423.27,0.12,0
33479,3520,-1000.00,12000.00,13000.00,0.00,6525.98,0.17,0
33480,3520,-1000.00,11000.00,12000.00,2565.32,0.00,0.07,0
33481,3520,-1000.00,10000.00,11000.00,3943.01,8056.99,0.34,0
33482,3520,-1000.00,9000.00,10000.00,2523.30,8476.70,0.22,0
33483,3520,-1000.00,8000.00,9000.00,0.00,10000.00,0.02,0
33484,3520,-1000.00,7000.00,8000.00,0.00,9000.00,0.23,0
33485,3520,-1000.00,6000.00,7000.00,4074.33,3925.67,0.05,0
33486,3520,-1000.00,5000.00,6000.00,1792.08,5207.92,0.25,0
33487,3520,-1000.00,4000.00,5000.00,1506.23,4493.77,0.38,0
33488,3520,-1000.00,3000.00,4000.00,1132.53,3867.47,0.38,0
33489,3520,-977.10,2022.90,3022.90,0.00,977.10,0.01,0
33490,3520,-1000.00,1022.90,2022.90,0.00,3022.90,0.21,0
33491,3520,-1000.00,22.90,1022.90,1589.68,433.22,0.04,0
33492,3520,-1000.00,-977.10,22.90,412.18,610.72,0.28,0
33493,3520,-22.90,-1000.00,0.00,6.81,16.09,0.30,0
33494,3521,-652.93,-652.93,347.07,0.00,652.93,0.25,0
33495,3521,-347.07,-1000.00,0.00,0.00,347.07,0.30,0
33496,3522,-1000.00,-1000.00,0.00,365.37,634.63,0.19,0
33497,3523,1000.00,1000.00,2000.00,0.00,918.55,0.24,1
33498,3523,1000.00,2000.00,3000.00,0.00,701.99,0.24,1
33499,3523,1000.00,3000.00,4000.00,1320.01,1476.84,0.24,1
33500,3523,1000.00,4000.00,5000.00,0.00,4000.00,0.38,1
33501,3523,1000.00,5000.00,6000.00,0.00,2432.94,0.25,1
33502,3523,1000.00,6000.00,7000.00,0.00,6000.00,0.36,1
33503,3523,1000.00,7000.00,8000.00,68.23,6931.77,0.37,1
33504,3523,1000.00,8000.00,9000.00,2399.55,5600.45,0.34,1
33505,3523,1000.00,9000.00,10000.00,2263.27,6736.73,0.38,1
33506,3523,1000.00,10000.00,11000.00,0.00,10000.00,0.39,1
33507,3523,0.00,10000.00,11000.00,0.00,0.00,0.03,0
33508,3523,1000.00,11000.00,12000.00,3836.44,7163.56,0.25,1
33509,3523,-1000.00,10000.00,11000.00,8089.03,0.00,0.02,0
33510,3523,1000.00,11000.00,12000.00,0.00,3998.18,0.07,1
33511,3523,1000.00,12000.00,13000.00,4410.57,7589.43,0.28,1
33512,3523,1000.00,13000.00,14000.00,0.00,13000.00,0.13,1
33513,3523,-1000.00,12000.00,13000.00,11759.23,2240.77,0.06,0
33514,3523,1000.00,13000.00,14000.00,0.00,12584.20,0.28,1
33515,3523,1000.00,14000.00,15000.00,1785.48,12214.52,0.29,1
33516,3523,1000.00,15000.00,16000.00,0.00,11527.66,0.40,1
33517,3523,1000.00,16000.00,17000.00,0.00,16000.00,0.20,1
33518,3523,1000.00,17000.00,18000.00,2648.73,14351.27,0.20,1
33519,3523,-1000.00,16000.00,17000.00,9000.00,9000.00,0.28,0
33520,3523,-1000.00,15000.00,16000.00,6616.80,10383.20,0.23,0
33521,3523,-1000.00,14000.00,15000.00,0.00,16000.00,0.09,0
33522,3523,-1000.00,13000.00,14000.00,0.00,13901.07,0.40,0
33523,3523,-1000.00,12000.00,13000.00,0.00,13522.70,0.36,0
33524,3523,-1000.00,11000.00,12000.00,0.00,13000.00,0.26,0
33525,3523,-1000.00,10000.00,11000.00,0.00,12000.00,0.29,0
33526,3523,-1000.00,9000.00,10000.00,0.00,11000.00,0.32,0
33527,3523,-1000.00,8000.00,9000.00,0.00,8241.24,0.24,0
33528,3523,-1000.00,7000.00,8000.00,0.00,9000.00,0.08,0
33529,3523,-1000.00,6000.00,7000.00,0.00,8000.00,0.15,0
33530,3523,-1000.00,5000.00,6000.00,3103.07,3896.93,0.05,0
33531,3523,-1000.00,4000.00,5000.00,0.00,6000.00,0.02,0
33532,3523,-1000.00,3000.00,4000.00,0.00,5000.00,0.18,0
33533,3523,-1000.00,2000.00,3000.00,435.60,2694.98,0.38,0
33534,3523,-1000.00,1000.00,2000.00,1500.00,1500.00,0.01,0
33535,3523,-1000.00,0.00,1000.00,1000.00,1000.00,0.23,0
33536,3523,-1000.00,-1000.00,0.00,0.00,1000.00,0.14,0
33537,3524,1000.00,1000.00,2000.00,0.00,614.59,0.18,1
33538,3524,1000.00,2000.00,3000.00,0.00,1305.71,0.36,1
33539,3524,0.00,2000.00,3000.00,0.00,0.00,0.02,0
33540,3524,1000.00,3000.00,4000.00,0.00,3000.00,0.42,1
33541,3524,1000.00,4000.00,5000.00,0.00,4000.00,0.33,1
33542,3524,1000.00,5000.00,6000.00,1845.51,3154.49,0.35,1
33543,3524,1000.00,6000.00,7000.00,1886.38,4113.62,0.33,1
33544,3524,1000.00,7000.00,8000.00,0.00,7000.00,0.16,1
33545,3524,1000.00,8000.00,9000.00,0.00,6754.00,0.42,1
33546,3524,1000.00,9000.00,10000.00,0.00,1125.95,0.09,1
33547,3524,1000.00,10000.00,11000.00,3631.28,6368.72,0.21,1
33548,3524,1000.00,11000.00,12000.00,4403.53,6596.47,0.10,1
33549,3524,1000.00,12000.00,13000.00,0.00,12000.00,0.40,1
33550,3524,0.00,12000.00,13000.00,0.00,0.00,0.01,0
33551,3524,1000.00,13000.00,14000.00,0.00,13000.00,0.32,1
33552,3524,1000.00,14000.00,15000.00,0.00,6411.41,0.29,1
33553,3524,1000.00,15000.00,16000.00,2857.95,12142.05,0.41,1
33554,3524,1000.00,16000.00,17000.00,0.00,16000.00,0.30,1
33555,3524,1000.00,17000.00,18000.00,6063.41,10412.13,0.30,1
33556,3524,1000.00,18000.00,19000.00,4160.52,13839.48,0.29,1
33557,3524,1000.00,19000.00,20000.00,7949.56,11050.44,0.26,1
33558,3524,1000.00,20000.00,21000.00,0.00,13518.81,0.33,1
33559,3524,1000.00,21000.00,22000.00,1759.32,17008.64,0.39,1
33560,3524,-1000.00,20000.00,21000.00,11000.00,11000.00,0.37,0
33561,3524,-1000.00,19000.00,20000.00,159.16,20840.84,0.41,0
33562,3524,-1000.00,18000.00,19000.00,4790.37,15209.63,0.39,0
33563,3524,-1000.00,17000.00,18000.00,0.00,19000.00,0.06,0
33564,3524,-1000.00,16000.00,17000.00,0.00,17683.98,0.31,0
33565,3524,-1000.00,15000.00,16000.00,1862.18,15137.82,0.42,0
33566,3524,-1000.00,14000.00,15000.00,0.00,16000.00,0.19,0
33567,3524,-1000.00,13000.00,14000.00,0.00,15000.00,0.29,0
33568,3524,-1000.00,12000.00,13000.00,0.00,4006.85,0.03,0
33569,3524,-1000.00,11000.00,12000.00,6500.00,6500.00,0.09,0
33570,3524,-1000.00,10000.00,11000.00,503.29,11496.71,0.34,0
33571,3524,-1000.00,9000.00,10000.00,0.00,11000.00,0.25,0
33572,3524,-1000.00,8000.00,9000.00,0.00,10000.00,0.19,0
33573,3524,-1000.00,7000.00,8000.00,3559.76,5440.24,0.02,0
33574,3524,-1000.00,6000.00,7000.00,3323.41,4676.59,0.16,0
33575,3524,-1000.00,5000.00,6000.00,0.00,7000.00,0.14,0
33576,3524,-1000.00,4000.00,5000.00,0.00,1388.81,0.19,0
33577,3524,-1000.00,3000.00,4000.00,0.00,5000.00,0.14,0
33578,3524,-1000.00,2000.00,3000.00,0.00,4000.00,0.18,0
33579,3524,-1000.00,1000.00,2000.00,0.00,2058.12,0.36,0
33580,3524,-1000.00,0.00,1000.00,0.00,2000.00,0.24,0
33581,3524,-1000.00,-1000.00,0.00,0.00,1000.00,0.38,0
33582,3525,-1000.00,-1000.00,0.00,623.34,376.66,0.06,0
33583,3526,1000.00,1000.00,2000.00,0.00,829.49,0.40,1
33584,3526,1000.00,2000.00,3000.00,0.00,2000.00,0.39,1
33585,3526,1000.00,3000.00,4000.00,0.00,2592.29,0.43,1
33586,3526,-1000.00,2000.00,3000.00,1853.31,0.00,0.08,0
33587,3526,1000.00,3000.00,4000.00,0.00,2944.43,0.39,1
33588,3526,1000.00,4000.00,5000.00,839.97,3160.03,0.43,1
33589,3526,1000.00,5000.00,6000.00,0.00,5000.00,0.08,1
33590,3526,1000.00,6000.00,7000.00,2284.56,3715.44,0.23,1
33591,3526,1000.00,7000.00,8000.00,3052.23,3319.91,0.23,1
33592,3526,1000.00,8000.00,9000.00,0.00,8000.00,0.30,1
33593,3526,-1000.00,7000.00,8000.00,2762.44,2344.66,0.18,0
33594,3526,1000.00,8000.00,9000.00,0.00,47.65,0.10,1
33595,3526,1000.00,9000.00,10000.00,0.00,9000.00,0.42,1
33596,3526,1000.00,10000.00,11000.00,2926.85,3409.12,0.22,1
33597,3526,1000.00,11000.00,12000.00,0.00,8926.87,0.40,1
33598,3526,1000.00,12000.00,13000.00,0.00,12000.00,0.13,1
33599,3526,1000.00,13000.00,14000.00,0.00,13000.00,0.30,1
33600,3526,1000.00,14000.00,15000.00,4461.01,9538.99,0.16,1
33601,3526,1000.00,15000.00,16000.00,1805.90,13194.10,0.43,1
33602,3526,1000.00,16000.00,17000.00,0.00,3361.29,0.18,1
33603,3526,1000.00,17000.00,18000.00,0.00,17000.00,0.41,1
33604,3526,1000.00,18000.00,19000.00,0.00,18000.00,0.05,1
33605,3526,1000.00,19000.00,20000.00,2654.15,4065.21,0.18,1
33606,3526,1000.00,20000.00,21000.00,6122.88,13877.12,0.35,1
33607,3526,-1000.00,19000.00,20000.00,7227.74,13772.26,0.18,0
33608,3526,-1000.00,18000.00,19000.00,3412.00,16588.00,0.05,0
33609,3526,-1000.00,17000.00,18000.00,5665.17,13334.83,0.32,0
33610,3526,-1000.00,16000.00,17000.00,0.00,7400.20,0.38,0
33611,3526,-1000.00,15000.00,16000.00,0.00,17000.00,0.31,0
33612,3526,-1000.00,14000.00,15000.00,0.00,7770.98,0.29,0
33613,3526,-1000.00,13000.00,14000.00,7025.30,7974.70,0.08,0
33614,3526,-1000.00,12000.00,13000.00,0.00,14000.00,0.25,0
33615,3526,-1000.00,11000.00,12000.00,7094.65,5905.35,0.08,0
33616,3526,-1000.00,10000.00,11000.00,2108.03,9891.97,0.36,0
33617,3526,-1000.00,9000.00,10000.00,0.00,11000.00,0.36,0
33618,3526,-1000.00,8000.00,9000.00,2474.26,5368.67,0.31,0
33619,3526,-1000.00,7000.00,8000.00,0.00,9000.00,0.38,0
33620,3526,-1000.00,6000.00,7000.00,0.00,8000.00,0.36,0
33621,3526,-1000.00,5000.00,6000.00,0.00,5951.74,0.39,0
33622,3526,-1000.00,4000.00,5000.00,2333.52,3666.48,0.30,0
33623,3526,-1000.00,3000.00,4000.00,793.78,4206.22,0.40,0
33624,3526,-1000.00,2000.00,3000.00,0.00,2671.36,0.38,0
33625,3526,-1000.00,1000.00,2000.00,0.00,3000.00,0.33,0
33626,3526,-1000.00,0.00,1000.00,1111.95,888.05,0.11,0
33627,3526,-1000.00,-1000.00,0.00,0.00,1000.00,0.36,0
33628,3527,1000.00,1000.00,2000.00,0.00,1000.00,0.22,1
33629,3527,1000.00,2000.00,3000.00,55.51,1944.49,0.44,1
33630,3527,1000.00,3000.00,4000.00,0.00,3000.00,0.15,1
33631,3527,-1000.00,2000.00,3000.00,3071.65,928.35,0.22,0
33632,3527,1000.00,3000.00,4000.00,0.00,1980.20,0.07,1
33633,3527,1000.00,4000.00,5000.00,0.00,4000.00,0.12,1
33634,3527,1000.00,5000.00,6000.00,795.60,4204.40,0.42,1
33635,3527,1000.00,6000.00,7000.00,0.00,6000.00,0.32,1
33636,3527,1000.00,7000.00,8000.00,608.15,6391.85,0.44,1
33637,3527,1000.00,8000.00,9000.00,3294.04,4705.96,0.31,1
33638,3527,1000.00,9000.00,10000.00,0.00,9000.00,0.34,1
33639,3527,1000.00,10000.00,11000.00,0.00,7948.58,0.26,1
33640,3527,1000.00,11000.00,12000.00,0.00,7197.05,0.37,1
33641,3527,0.00,11000.00,12000.00,0.00,0.00,0.08,0
33642,3527,1000.00,12000.00,13000.00,2407.41,9592.59,0.41,1
33643,3527,1000.00,13000.00,14000.00,6398.25,6601.75,0.15,1
33644,3527,1000.00,14000.00,15000.00,0.00,4144.08,0.20,1
33645,3527,1000.00,15000.00,16000.00,0.00,12562.83,0.41,1
33646,3527,-1000.00,14000.00,15000.00,10074.36,5925.64,0.14,0
33647,3527,1000.00,15000.00,16000.00,0.00,11147.57,0.38,1
33648,3527,1000.00,16000.00,17000.00,0.00,5291.51,0.19,1
33649,3527,1000.00,17000.00,18000.00,7626.75,9373.25,0.34,1
33650,3527,-1000.00,16000.00,17000.00,2661.75,15338.25,0.34,0
33651,3527,-1000.00,15000.00,16000.00,5056.08,11943.92,0.35,0
33652,3527,-1000.00,14000.00,15000.00,0.00,16000.00,0.15,0
33653,3527,-1000.00,13000.00,14000.00,0.00,15000.00,0.20,0
33654,3527,-1000.00,12000.00,13000.00,8042.15,5957.85,0.18,0
33655,3527,-1000.00,11000.00,12000.00,0.00,6795.25,0.31,0
33656,3527,-1000.00,10000.00,11000.00,0.00,7700.04,0.23,0
33657,3527,-1000.00,9000.00,10000.00,0.00,6596.57,0.29,0
33658,3527,-1000.00,8000.00,9000.00,579.41,9420.59,0.06,0
33659,3527,-1000.00,7000.00,8000.00,0.00,9000.00,0.36,0
33660,3527,-1000.00,6000.00,7000.00,0.00,8000.00,0.06,0
33661,3527,-1000.00,5000.00,6000.00,1903.79,3132.42,0.26,0
33662,3527,-1000.00,4000.00,5000.00,1996.58,308.33,0.11,0
33663,3527,-1000.00,3000.00,4000.00,0.00,5000.00,0.03,0
33664,3527,-1000.00,2000.00,3000.00,0.00,2899.50,0.40,0
33665,3527,-1000.00,1000.00,2000.00,1851.54,1148.46,0.07,0
33666,3527,1000.00,2000.00,3000.00,770.99,1229.01,0.25,1
33667,3527,-1000.00,1000.00,2000.00,2810.61,189.39,0.12,0
33668,3527,1000.00,2000.00,3000.00,0.00,2000.00,0.04,1
33669,3527,1000.00,3000.00,4000.00,1347.71,1369.49,0.22,1
33670,3527,1000.00,4000.00,5000.00,0.00,4000.00,0.19,1
33671,3527,1000.00,5000.00,6000.00,0.00,4167.93,0.02,1
33672,3527,1000.00,6000.00,7000.00,0.00,6000.00,0.16,1
33673,3527,1000.00,7000.00,8000.00,0.00,1418.29,0.11,1
33674,3527,1000.00,8000.00,9000.00,0.00,4994.80,0.20,1
33675,3527,1000.00,9000.00,10000.00,4500.00,4500.00,0.05,1
33676,3527,1000.00,10000.00,11000.00,0.00,4188.32,0.24,1
33677,3527,1000.00,11000.00,12000.00,4275.21,6724.79,0.25,1
33678,3527,1000.00,12000.00,13000.00,833.64,11166.36,0.22,1
33679,3527,1000.00,13000.00,14000.00,0.00,13000.00,0.05,1
33680,3527,1000.00,14000.00,15000.00,5819.23,8180.77,0.20,1
33681,3528,-1000.00,-1000.00,0.00,0.00,1000.00,0.24,0
33682,3529,-1000.00,-1000.00,0.00,0.00,1000.00,0.37,0
33683,3530,-1000.00,-1000.00,0.00,0.00,342.20,0.13,0
33684,3531,-327.29,-327.29,672.71,189.04,138.25,0.42,0
33685,3531,-353.35,-680.64,319.36,230.57,122.79,0.37,0
33686,3531,-1000.00,-1680.64,-680.64,135.89,183.47,0.14,0
33687,3532,1000.00,1000.00,2000.00,0.00,631.33,0.29,1
33688,3532,1000.00,2000.00,3000.00,0.00,2000.00,0.35,1
33689,3532,1000.00,3000.00,4000.00,471.00,2529.00,0.41,1
33690,3532,-1000.00,2000.00,3000.00,2581.64,452.09,0.08,0
33691,3532,0.00,2000.00,3000.00,0.00,0.00,0.01,0
33692,3532,-1000.00,1000.00,2000.00,1503.92,1496.08,0.11,0
33693,3532,1000.00,2000.00,3000.00,944.40,1055.60,0.07,1
33694,3532,1000.00,3000.00,4000.00,0.00,3000.00,0.11,1
33695,3532,1000.00,4000.00,5000.00,813.08,3186.92,0.02,1
33696,3532,-1000.00,3000.00,4000.00,1612.25,107.11,0.10,0
33697,3532,1000.00,4000.00,5000.00,783.21,1571.51,0.25,1
33698,3532,1000.00,5000.00,6000.00,1516.09,3483.91,0.34,1
33699,3532,1000.00,6000.00,7000.00,740.40,5259.60,0.42,1
33700,3532,1000.00,7000.00,8000.00,371.99,6628.01,0.02,1
33701,3532,1000.00,8000.00,9000.00,0.00,7506.61,0.38,1
33702,3532,1000.00,9000.00,10000.00,0.00,9000.00,0.21,1
33703,3532,1000.00,10000.00,11000.00,0.00,10000.00,0.09,1
33704,3532,1000.00,11000.00,12000.00,0.00,11000.00,0.11,1
33705,3532,-1000.00,10000.00,11000.00,12000.00,0.00,0.00,0
33706,3532,1000.00,11000.00,12000.00,0.00,9135.74,0.34,1
33707,3532,-1000.00,10000.00,11000.00,8889.62,3110.38,0.21,0
33708,3532,-1000.00,9000.00,10000.00,6734.16,4265.84,0.05,0
33709,3532,1000.00,10000.00,11000.00,0.00,4923.05,0.09,1
33710,3532,1000.00,11000.00,12000.00,4034.05,6965.95,0.36,1
33711,3532,-1000.00,10000.00,11000.00,4299.62,3848.14,0.21,0
33712,3532,1000.00,11000.00,12000.00,2496.68,7159.55,0.35,1
33713,3532,1000.00,12000.00,13000.00,0.00,10379.31,0.31,1
33714,3532,1000.00,13000.00,14000.00,2206.67,10793.33,0.16,1
33715,3532,1000.00,14000.00,15000.00,0.00,14000.00,0.39,1
33716,3532,1000.00,15000.00,16000.00,5575.17,9424.83,0.29,1
33717,3532,1000.00,16000.00,17000.00,5016.77,5212.31,0.21,1
33718,3532,1000.00,17000.00,18000.00,0.00,17000.00,0.24,1
33719,3532,-1000.00,16000.00,17000.00,6799.26,4795.62,0.17,0
33720,3532,1000.00,17000.00,18000.00,4429.54,12570.46,0.37,1
33721,3532,1000.00,18000.00,19000.00,8420.45,9579.55,0.14,1
33722,3532,1000.00,19000.00,20000.00,8926.29,10073.71,0.13,1
33723,3532,1000.00,20000.00,21000.00,0.00,17110.36,0.29,1
33724,3532,1000.00,21000.00,22000.00,0.00,21000.00,0.14,1
33725,3532,1000.00,22000.00,23000.00,0.00,22000.00,0.33,1
33726,3532,-1000.00,21000.00,22000.00,3180.49,2066.79,0.14,0
33727,3532,1000.00,22000.00,23000.00,3427.28,18572.72,0.40,1
33728,3532,1000.00,23000.00,24000.00,6592.59,16407.41,0.05,1
33729,3532,1000.00,24000.00,25000.00,0.00,8571.49,0.19,1
33730,3532,1000.00,25000.00,26000.00,0.00,25000.00,0.04,1
33731,3533,-60.76,-60.76,939.24,0.00,60.76,0.14,0
33732,3533,0.00,-60.76,939.24,0.00,0.00,0.23,0
33733,3533,-722.96,-783.72,216.28,0.00,722.96,0.43,0
33734,3533,-106.63,-890.36,109.64,0.00,106.63,0.04,0
33735,3533,1000.00,109.64,1109.64,75.32,0.00,0.23,1
33736,3533,-670.46,-560.82,439.18,0.00,670.46,0.21,0
33737,3533,0.00,-560.82,439.18,0.00,0.00,0.10,0
33738,3533,0.00,-560.82,439.18,0.00,0.00,0.36,0
33739,3533,0.00,-560.82,439.18,0.00,0.00,0.23,0
33740,3533,1000.00,439.18,1439.18,229.15,54.93,0.30,1
33741,3533,1000.00,1439.18,2439.18,244.00,0.00,0.11,1
33742,3533,-920.71,518.47,1518.47,0.00,920.71,0.31,0
33743,3533,-1000.00,-481.53,518.47,150.40,0.00,0.33,0
33744,3533,-518.47,-1000.00,0.00,0.00,518.47,0.34,0
33745,3534,-1000.00,-1000.00,0.00,0.00,791.82,0.29,0
33746,3535,-1000.00,-1000.00,0.00,605.40,394.60,0.10,0
33747,3536,1000.00,1000.00,2000.00,0.00,1000.00,0.01,1
33748,3536,1000.00,2000.00,3000.00,405.39,1594.61,0.41,1
33749,3536,1000.00,3000.00,4000.00,0.00,2059.80,0.27,1
33750,3536,1000.00,4000.00,5000.00,0.00,358.09,0.03,1
33751,3536,-1000.00,3000.00,4000.00,2850.99,2149.01,0.13,0
33752,3536,1000.00,4000.00,5000.00,0.00,4000.00,0.15,1
33753,3536,1000.00,5000.00,6000.00,1260.30,3739.70,0.43,1
33754,3536,1000.00,6000.00,7000.00,1069.55,4930.45,0.39,1
33755,3536,1000.00,7000.00,8000.00,0.00,7000.00,0.08,1
33756,3536,1000.00,8000.00,9000.00,0.00,2660.75,0.17,1
33757,3536,1000.00,9000.00,10000.00,2684.04,6315.96,0.35,1
33758,3536,1000.00,10000.00,11000.00,2557.43,7442.57,0.44,1
33759,3536,1000.00,11000.00,12000.00,2188.45,8811.55,0.40,1
33760,3536,1000.00,12000.00,13000.00,0.00,7163.84,0.31,1
33761,3536,1000.00,13000.00,14000.00,4109.80,8890.20,0.05,1
33762,3536,-1000.00,12000.00,13000.00,7000.00,7000.00,0.22,0
33763,3536,-1000.00,11000.00,12000.00,3094.31,9905.69,0.35,0
33764,3536,-1000.00,10000.00,11000.00,0.00,12000.00,0.07,0
33765,3536,-1000.00,9000.00,10000.00,0.00,11000.00,0.07,0
33766,3536,-1000.00,8000.00,9000.00,5000.00,5000.00,0.09,0
33767,3536,-1000.00,7000.00,8000.00,0.00,9000.00,0.17,0
33768,3536,1000.00,8000.00,9000.00,2413.82,0.00,0.09,1
33769,3536,-1000.00,7000.00,8000.00,3040.53,5959.47,0.15,0
33770,3536,-1000.00,6000.00,7000.00,3627.96,4372.04,0.37,0
33771,3536,-1000.00,5000.00,6000.00,1568.57,3102.77,0.28,0
33772,3536,-1000.00,4000.00,5000.00,0.00,3683.66,0.36,0
33773,3536,1000.00,5000.00,6000.00,2683.66,178.14,0.08,1
33774,3536,1000.00,6000.00,7000.00,4242.95,1757.05,0.07,1
33775,3536,-1000.00,5000.00,6000.00,340.13,6659.87,0.36,0
33776,3536,-1000.00,4000.00,5000.00,2323.85,3676.15,0.30,0
33777,3536,-1000.00,3000.00,4000.00,0.00,1923.77,0.23,0
33778,3536,-1000.00,2000.00,3000.00,1761.92,2238.08,0.16,0
33779,3536,-1000.00,1000.00,2000.00,672.46,2327.54,0.22,0
33780,3536,-1000.00,0.00,1000.00,0.00,1467.81,0.15,0
33781,3536,-107.09,-107.09,892.91,0.00,107.09,0.08,0
33782,3536,1000.00,892.91,1892.91,726.93,0.00,0.01,1
33783,3536,-1000.00,-107.09,892.91,0.00,1892.91,0.04,0
33784,3536,-892.91,-1000.00,0.00,244.64,648.27,0.43,0
33785,3536,0.00,-1000.00,0.00,0.00,0.00,0.35,1
33786,3536,0.00,-1000.00,0.00,0.00,0.00,0.29,1
33787,3536,0.00,-1000.00,0.00,0.00,0.00,0.07,1
33788,3536,0.00,-1000.00,0.00,0.00,0.00,0.17,1
33789,3536,0.58,-999.41,0.59,0.00,0.00,0.19,1
33790,3536,103.99,-895.43,104.57,0.13,0.22,0.24,1
33791,3536,1000.00,104.57,1104.57,0.00,96.04,0.39,1
33792,3536,1000.00,1104.57,2104.57,0.00,804.64,0.06,1
33793,3536,1000.00,2104.57,3104.57,320.34,1784.23,0.44,1
33794,3536,1000.00,3104.57,4104.57,551.91,2552.67,0.41,1
33795,3536,-1000.00,2104.57,3104.57,2978.36,1126.22,0.08,0
33796,3536,1000.00,3104.57,4104.57,0.00,1931.86,0.30,1
33797,3536,-1000.00,2104.57,3104.57,2850.40,0.00,0.02,0
33798,3536,1000.00,3104.57,4104.57,451.03,2653.54,0.36,1
33799,3536,1000.00,4104.57,5104.57,0.00,2450.92,0.12,1
33800,3536,-1000.00,3104.57,4104.57,3326.20,1778.38,0.02,0
33801,3536,1000.00,4104.57,5104.57,679.35,3425.22,0.42,1
33802,3536,1000.00,5104.57,6104.57,0.00,4903.98,0.25,1
33803,3537,1000.00,1000.00,2000.00,141.89,858.11,0.42,1
33804,3537,-1000.00,0.00,1000.00,1315.45,684.55,0.09,0
33805,3537,1000.00,1000.00,2000.00,0.00,1000.00,0.03,1
33806,3537,1000.00,2000.00,3000.00,0.00,723.31,0.10,1
33807,3537,-359.74,1640.26,2640.26,205.51,154.22,0.13,0
33808,3537,1000.00,2640.26,3640.26,51.63,2588.63,0.03,1
33809,3537,1000.00,3640.26,4640.26,0.00,2989.53,0.32,1
33810,3537,1000.00,4640.26,5640.26,0.00,4640.26,0.23,1
33811,3537,1000.00,5640.26,6640.26,0.00,5640.26,0.07,1
33812,3537,1000.00,6640.26,7640.26,0.00,6640.26,0.33,1
33813,3537,1000.00,7640.26,8640.26,3680.86,3959.40,0.13,1
33814,3537,1000.00,8640.26,9640.26,2978.37,5661.90,0.15,1
33815,3537,1000.00,9640.26,10640.26,0.00,9640.26,0.07,1
33816,3537,-1000.00,8640.26,9640.26,4998.83,4096.39,0.19,0
33817,3537,1000.00,9640.26,10640.26,0.00,9640.26,0.38,1
33818,3537,1000.00,10640.26,11640.26,0.00,9495.24,0.34,1
33819,3537,1000.00,11640.26,12640.26,4077.82,7562.45,0.44,1
33820,3537,1000.00,12640.26,13640.26,0.00,12640.26,0.18,1
33821,3537,1000.00,13640.26,14640.26,6052.91,7587.36,0.42,1
33822,3537,-1000.00,12640.26,13640.26,7320.13,7320.13,0.22,0
33823,3537,-1000.00,11640.26,12640.26,12128.66,1511.60,0.05,0
33824,3537,-1000.00,10640.26,11640.26,1940.45,10699.81,0.30,0
33825,3537,-1000.00,9640.26,10640.26,0.00,11640.26,0.13,0
33826,3537,-1000.00,8640.26,9640.26,0.00,3378.35,0.11,0
33827,3537,0.00,8640.26,9640.26,0.00,0.00,0.02,0
33828,3537,-1000.00,7640.26,8640.26,3115.34,6524.92,0.36,0
33829,3537,-1000.00,6640.26,7640.26,2385.71,6254.55,0.21,0
33830,3537,-1000.00,5640.26,6640.26,3167.63,4472.63,0.23,0
33831,3537,-1000.00,4640.26,5640.26,0.00,2117.09,0.17,0
33832,3537,-1000.00,3640.26,4640.26,0.00,1746.99,0.23,0
33833,3537,-1000.00,2640.26,3640.26,372.00,4268.27,0.11,0
33834,3537,-1000.00,1640.26,2640.26,0.00,3640.26,0.18,0
33835,3537,-1000.00,640.26,1640.26,1014.73,1625.53,0.27,0
33836,3537,-1000.00,-359.74,640.26,0.00,1640.26,0.07,0
33837,3537,-63.79,-423.52,576.48,0.00,63.79,0.14,0
33838,3537,-1000.00,-1423.52,-423.52,322.11,254.37,0.14,0
33839,3538,-1000.00,-1000.00,0.00,0.00,1000.00,0.42,0
33840,3539,-1000.00,-1000.00,0.00,0.00,944.23,0.19,0
33841,3540,1000.00,1000.00,2000.00,0.00,985.87,0.44,1
33842,3540,1000.00,2000.00,3000.00,469.33,1530.67,0.20,1
33843,3540,1000.00,3000.00,4000.00,0.00,3000.00,0.31,1
33844,3540,1000.00,4000.00,5000.00,1586.14,2413.86,0.29,1
33845,3540,-1000.00,3000.00,4000.00,2779.86,13.38,0.07,0
33846,3540,1000.00,4000.00,5000.00,0.00,2930.97,0.31,1
33847,3540,0.00,4000.00,5000.00,0.00,0.00,0.01,0
33848,3540,1000.00,5000.00,6000.00,0.00,4985.24,0.38,1
33849,3540,1000.00,6000.00,7000.00,1013.90,4986.10,0.27,1
33850,3540,-1000.00,5000.00,6000.00,6192.06,358.26,0.04,0
33851,3540,1000.00,6000.00,7000.00,0.00,6000.00,0.16,1
33852,3540,1000.00,7000.00,8000.00,0.00,6493.91,0.41,1
33853,3540,1000.00,8000.00,9000.00,0.00,4286.30,0.08,1
33854,3540,1000.00,9000.00,10000.00,0.00,9000.00,0.20,1
33855,3540,1000.00,10000.00,11000.00,3921.77,6078.23,0.23,1
33856,3540,1000.00,11000.00,12000.00,2871.75,4677.58,0.28,1
33857,3540,1000.00,12000.00,13000.00,0.00,6694.43,0.04,1
33858,3540,1000.00,13000.00,14000.00,0.00,11735.95,0.42,1
33859,3540,1000.00,14000.00,15000.00,3296.95,10703.05,0.27,1
33860,3540,1000.00,15000.00,16000.00,0.00,15000.00,0.08,1
33861,3540,1000.00,16000.00,17000.00,8000.00,8000.00,0.01,1
33862,3540,1000.00,17000.00,18000.00,0.00,2916.30,0.17,1
33863,3540,1000.00,18000.00,19000.00,4111.70,13888.30,0.10,1
33864,3540,1000.00,19000.00,20000.00,9500.00,9500.00,0.00,1
33865,3540,-1000.00,18000.00,19000.00,4169.89,15830.11,0.39,0
33866,3540,-1000.00,17000.00,18000.00,0.00,2764.29,0.03,0
33867,3540,-1000.00,16000.00,17000.00,0.00,18000.00,0.03,0
33868,3540,-1000.00,15000.00,16000.00,0.00,5841.36,0.23,0
33869,3540,-1000.00,14000.00,15000.00,0.00,16000.00,0.11,0
33870,3540,-1000.00,13000.00,14000.00,6668.88,8331.12,0.22,0
33871,3540,-1000.00,12000.00,13000.00,7825.44,6174.56,0.17,0
33872,3540,-1000.00,11000.00,12000.00,2058.89,10058.38,0.40,0
33873,3540,-1000.00,10000.00,11000.00,3076.73,8923.27,0.37,0
33874,3540,-1000.00,9000.00,10000.00,1531.66,7129.81,0.36,0
33875,3540,-1000.00,8000.00,9000.00,0.00,7560.25,0.41,0
33876,3540,-1000.00,7000.00,8000.00,2566.42,4674.19,0.29,0
33877,3540,-1000.00,6000.00,7000.00,3858.97,4141.03,0.22,0
33878,3540,-1000.00,5000.00,6000.00,0.00,7000.00,0.34,0
33879,3540,-1000.00,4000.00,5000.00,769.63,5230.37,0.15,0
33880,3540,-1000.00,3000.00,4000.00,393.44,2574.05,0.32,0
33881,3540,-1000.00,2000.00,3000.00,4000.00,0.00,0.01,0
33882,3540,-1000.00,1000.00,2000.00,1500.00,1500.00,0.01,0
33883,3540,-1000.00,0.00,1000.00,571.29,1428.71,0.34,0
33884,3540,-1000.00,-1000.00,0.00,0.00,1000.00,0.37,0
33885,3541,-1000.00,-1000.00,0.00,324.85,675.15,0.19,0
33886,3542,-1000.00,-1000.00,0.00,0.00,1000.00,0.29,0
33887,3543,-1000.00,-1000.00,0.00,198.97,801.03,0.41,0
33888,3544,-1000.00,-1000.00,0.00,328.86,671.14,0.21,0
33889,3545,1000.00,1000.00,2000.00,30.00,970.00,0.42,1
33890,3545,1000.00,2000.00,3000.00,0.00,2000.00,0.30,1
33891,3545,1000.00,3000.00,4000.00,0.00,3000.00,0.10,1
33892,3545,1000.00,4000.00,5000.00,527.50,3472.50,0.31,1
33893,3545,1000.00,5000.00,6000.00,0.00,5000.00,0.44,1
33894,3545,-51.39,4948.61,5948.61,51.39,0.00,0.02,0
33895,3545,1000.00,5948.61,6948.61,980.12,4968.49,0.31,1
33896,3545,1000.00,6948.61,7948.61,0.00,6154.11,0.30,1
33897,3545,-1000.00,5948.61,6948.61,4225.92,3722.69,0.10,0
33898,3545,-1000.00,4948.61,5948.61,3168.19,0.00,0.04,0
33899,3545,1000.00,5948.61,6948.61,0.00,5948.61,0.19,1
33900,3545,1000.00,6948.61,7948.61,3474.30,3474.30,0.25,1
33901,3545,1000.00,7948.61,8948.61,0.00,7948.61,0.43,1
33902,3545,1000.00,8948.61,9948.61,0.00,8235.24,0.42,1
33903,3545,1000.00,9948.61,10948.61,0.00,9078.84,0.31,1
33904,3545,1000.00,10948.61,11948.61,0.00,10948.61,0.19,1
33905,3545,1000.00,11948.61,12948.61,0.00,11948.61,0.37,1
33906,3545,1000.00,12948.61,13948.61,2750.70,10197.91,0.42,1
33907,3545,1000.00,13948.61,14948.61,0.00,6766.05,0.30,1
33908,3545,1000.00,14948.61,15948.61,7399.65,7548.96,0.11,1
33909,3545,1000.00,15948.61,16948.61,5359.62,9648.57,0.30,1
33910,3545,1000.00,16948.61,17948.61,8474.30,8474.30,0.01,1
33911,3545,1000.00,17948.61,18948.61,8974.30,8974.30,0.09,1
33912,3545,1000.00,18948.61,19948.61,9026.16,9922.45,0.09,1
33913,3545,1000.00,19948.61,20948.61,0.00,11803.22,0.24,1
33914,3545,1000.00,20948.61,21948.61,2837.26,18111.35,0.42,1
33915,3545,1000.00,21948.61,22948.61,877.18,20250.34,0.44,1
33916,3545,1000.00,22948.61,23948.61,0.00,22948.61,0.26,1
33917,3545,1000.00,23948.61,24948.61,0.00,23948.61,0.13,1
33918,3545,1000.00,24948.61,25948.61,7485.90,17462.71,0.17,1
33919,3545,1000.00,25948.61,26948.61,0.00,17512.17,0.06,1
33920,3545,-1000.00,24948.61,25948.61,13973.89,12974.72,0.42,0
33921,3545,1000.00,25948.61,26948.61,7757.96,18190.65,0.18,1
33922,3545,1000.00,26948.61,27948.61,12180.38,14768.23,0.10,1
33923,3545,1000.00,27948.61,28948.61,0.00,14547.22,0.07,1
33924,3545,1000.00,28948.61,29948.61,0.00,27528.96,0.29,1
33925,3545,1000.00,29948.61,30948.61,6876.71,23071.90,0.39,1
33926,3545,1000.00,30948.61,31948.61,4120.56,26828.05,0.43,1
33927,3545,1000.00,31948.61,32948.61,0.00,31948.61,0.16,1
33928,3545,-1000.00,30948.61,31948.61,15322.84,10390.86,0.17,0
33929,3545,1000.00,31948.61,32948.61,0.00,31948.61,0.32,1
33930,3545,1000.00,32948.61,33948.61,4994.53,27954.07,0.35,1
33931,3545,-1000.00,31948.61,32948.61,13355.11,11913.95,0.20,0
33932,3545,1000.00,32948.61,33948.61,0.00,17719.08,0.13,1
33933,3545,1000.00,33948.61,34948.61,0.00,15547.04,0.23,1
33934,3545,1000.00,34948.61,35948.61,11257.42,23691.19,0.18,1
33935,3546,1000.00,1000.00,2000.00,261.00,739.00,0.23,1
33936,3546,1000.00,2000.00,3000.00,462.43,1312.45,0.35,1
33937,3546,1000.00,3000.00,4000.00,0.00,2243.61,0.39,1
33938,3546,1000.00,4000.00,5000.00,0.00,216.51,0.01,1
33939,3546,1000.00,5000.00,6000.00,0.00,5000.00,0.28,1
33940,3546,1000.00,6000.00,7000.00,492.38,2003.73,0.24,1
33941,3546,-1000.00,5000.00,6000.00,1648.87,517.03,0.13,0
33942,3546,1000.00,6000.00,7000.00,1667.86,4332.14,0.27,1
33943,3546,1000.00,7000.00,8000.00,0.00,6165.06,0.36,1
33944,3546,-1000.00,6000.00,7000.00,5145.54,1979.93,0.11,0
33945,3546,1000.00,7000.00,8000.00,544.91,6455.09,0.24,1
33946,3546,1000.00,8000.00,9000.00,2333.83,4308.53,0.32,1
33947,3546,1000.00,9000.00,10000.00,0.00,8048.86,0.40,1
33948,3546,-1000.00,8000.00,9000.00,5623.84,4376.16,0.18,0
33949,3546,1000.00,9000.00,10000.00,0.00,9000.00,0.36,1
33950,3546,0.00,9000.00,10000.00,0.00,0.00,0.09,0
33951,3546,1000.00,10000.00,11000.00,0.00,10000.00,0.37,1
33952,3546,1000.00,11000.00,12000.00,1654.19,9345.81,0.40,1
33953,3546,1000.00,12000.00,13000.00,736.05,11263.95,0.34,1
33954,3546,-1000.00,11000.00,12000.00,6520.28,6479.72,0.28,0
33955,3546,-1000.00,10000.00,11000.00,7370.75,2081.28,0.10,0
33956,3547,-1000.00,-1000.00,0.00,705.74,294.26,0.08,0
33957,3548,0.00,0.00,1000.00,0.00,0.00,0.34,0
33958,3548,-962.95,-962.95,37.05,962.95,0.00,0.10,0
33959,3548,-1000.00,-1962.95,-962.95,0.00,29.31,0.18,0
33960,3549,-1000.00,-1000.00,0.00,631.93,368.07,0.13,0
33961,3550,-1000.00,-1000.00,0.00,0.00,1000.00,0.05,0
33962,3551,-1000.00,-1000.00,0.00,289.03,710.97,0.17,0
33963,3552,-1000.00,-1000.00,0.00,144.39,855.61,0.08,0
33964,3553,-1000.00,-1000.00,0.00,0.00,1000.00,0.18,0
33965,3554,-1000.00,-1000.00,0.00,0.00,1000.00,0.28,0
33966,3555,1000.00,1000.00,2000.00,0.00,67.03,0.06,1
33967,3555,1000.00,2000.00,3000.00,0.00,1808.40,0.32,1
33968,3555,1000.00,3000.00,4000.00,0.00,1368.96,0.24,1
33969,3555,1000.00,4000.00,5000.00,0.00,4000.00,0.07,1
33970,3555,1000.00,5000.00,6000.00,690.21,4205.19,0.42,1
33971,3555,1000.00,6000.00,7000.00,0.00,1133.50,0.41,1
33972,3555,1000.00,7000.00,8000.00,622.79,6377.21,0.22,1
33973,3555,1000.00,8000.00,9000.00,0.00,6932.27,0.36,1
33974,3555,1000.00,9000.00,10000.00,0.00,5004.96,0.23,1
33975,3555,1000.00,10000.00,11000.00,0.00,10000.00,0.34,1
33976,3555,1000.00,11000.00,12000.00,3788.22,7211.78,0.31,1
33977,3555,-1000.00,10000.00,11000.00,7488.71,0.00,0.07,0
33978,3555,-735.99,9264.01,10264.01,735.99,0.00,0.02,0
33979,3555,1000.00,10264.01,11264.01,0.00,10264.01,0.33,1
33980,3555,-1000.00,9264.01,10264.01,5873.31,5390.69,0.44,0
33981,3555,1000.00,10264.01,11264.01,4922.44,5341.57,0.17,1
33982,3555,1000.00,11264.01,12264.01,2917.73,8346.28,0.38,1
33983,3555,1000.00,12264.01,13264.01,1356.19,10907.82,0.43,1
33984,3555,1000.00,13264.01,14264.01,5810.88,7453.13,0.19,1
33985,3555,-1000.00,12264.01,13264.01,0.00,14264.01,0.32,0
33986,3555,-1000.00,11264.01,12264.01,0.00,13264.01,0.26,0
33987,3555,-1000.00,10264.01,11264.01,0.00,12264.01,0.29,0
33988,3555,-1000.00,9264.01,10264.01,7108.76,4155.25,0.03,0
33989,3555,-1000.00,8264.01,9264.01,295.58,9968.43,0.25,0
33990,3555,-1000.00,7264.01,8264.01,7.78,9256.23,0.12,0
33991,3555,-1000.00,6264.01,7264.01,0.00,8264.01,0.28,0
33992,3555,-1000.00,5264.01,6264.01,0.00,4116.70,0.30,0
33993,3555,-1000.00,4264.01,5264.01,450.15,1939.21,0.36,0
33994,3555,-1000.00,3264.01,4264.01,0.00,5264.01,0.30,0
33995,3555,-1000.00,2264.01,3264.01,0.00,2015.89,0.17,0
33996,3555,-1000.00,1264.01,2264.01,0.00,896.13,0.20,0
33997,3555,-1000.00,264.01,1264.01,312.97,712.97,0.26,0
33998,3555,-1000.00,-735.99,264.01,0.00,1079.36,0.33,0
33999,3555,-1000.00,-1735.99,-735.99,0.00,263.52,0.42,0
34000,3556,-1000.00,-1000.00,0.00,305.92,694.08,0.35,0
34001,3557,-1000.00,-1000.00,0.00,369.95,630.05,0.30,0
34002,3558,-1000.00,-1000.00,0.00,0.00,93.87,0.38,0
34003,3559,-1000.00,-1000.00,0.00,0.00,119.66,0.08,0
34004,3560,-1000.00,-1000.00,0.00,0.00,1000.00,0.32,0
34005,3561,-1000.00,-1000.00,0.00,0.00,1000.00,0.38,0
34006,3562,-942.66,-942.66,57.34,942.66,0.00,0.02,0
34007,3562,1000.00,57.34,1057.34,12.37,21.37,0.25,1
34008,3562,1000.00,1057.34,2057.34,48.98,1008.36,0.44,1
34009,3562,1000.00,2057.34,3057.34,255.69,1801.65,0.42,1
34010,3562,1000.00,3057.34,4057.34,489.89,2567.46,0.15,1
34011,3562,-1000.00,2057.34,3057.34,3278.68,0.00,0.04,0
34012,3562,1000.00,3057.34,4057.34,0.00,3057.34,0.41,1
34013,3562,1000.00,4057.34,5057.34,1463.85,2593.49,0.30,1
34014,3562,1000.00,5057.34,6057.34,612.45,4444.89,0.43,1
34015,3562,1000.00,6057.34,7057.34,0.00,4505.81,0.15,1
34016,3562,1000.00,7057.34,8057.34,0.00,7057.34,0.39,1
34017,3562,1000.00,8057.34,9057.34,0.00,3567.41,0.20,1
34018,3562,1000.00,9057.34,10057.34,0.00,9057.34,0.15,1
34019,3562,1000.00,10057.34,11057.34,1133.24,8924.10,0.25,1
34020,3562,1000.00,11057.34,12057.34,4641.42,6415.92,0.27,1
34021,3562,1000.00,12057.34,13057.34,0.00,12057.34,0.02,1
34022,3562,1000.00,13057.34,14057.34,0.00,6638.19,0.20,1
34023,3562,1000.00,14057.34,15057.34,222.62,8512.05,0.36,1
34024,3562,1000.00,15057.34,16057.34,2897.26,12160.08,0.38,1
34025,3562,1000.00,16057.34,17057.34,0.00,16057.34,0.11,1
34026,3562,1000.00,17057.34,18057.34,0.00,17057.34,0.09,1
34027,3562,-1000.00,16057.34,17057.34,9614.18,8443.17,0.32,0
34028,3562,-1000.00,15057.34,16057.34,4651.98,12405.36,0.31,0
34029,3562,-1000.00,14057.34,15057.34,703.78,4115.96,0.21,0
34030,3562,-1000.00,13057.34,14057.34,1339.58,11043.18,0.40,0
34031,3562,-1000.00,12057.34,13057.34,4475.44,0.00,0.03,0
34032,3562,-1000.00,11057.34,12057.34,1943.08,11114.26,0.35,0
34033,3562,-1000.00,10057.34,11057.34,0.00,8637.53,0.22,0
34034,3562,-1000.00,9057.34,10057.34,9819.41,0.00,0.03,0
34035,3562,-1000.00,8057.34,9057.34,0.00,10057.34,0.30,0
34036,3562,-1000.00,7057.34,8057.34,4506.87,4550.47,0.09,0
34037,3562,-1000.00,6057.34,7057.34,0.00,7662.35,0.32,0
34038,3562,-192.64,5864.71,6864.71,0.00,192.64,0.11,0
34039,3562,-1000.00,4864.71,5864.71,0.00,5348.27,0.42,0
34040,3562,-1000.00,3864.71,4864.71,900.41,4964.29,0.17,0
34041,3562,-1000.00,2864.71,3864.71,0.00,4864.71,0.40,0
34042,3562,-1000.00,1864.71,2864.71,0.00,3864.71,0.01,0
34043,3562,-1000.00,864.71,1864.71,1294.51,1570.20,0.16,0
34044,3562,-1000.00,-135.29,864.71,0.00,1864.71,0.23,0
34045,3562,1000.00,864.71,1864.71,391.47,443.10,0.24,1
34046,3562,1000.00,1864.71,2864.71,0.00,1473.76,0.16,1
34047,3562,1000.00,2864.71,3864.71,0.00,1478.80,0.28,1
34048,3562,0.00,2864.71,3864.71,0.00,0.00,0.02,0
34049,3562,1000.00,3864.71,4864.71,1021.47,2843.24,0.02,1
34050,3562,1000.00,4864.71,5864.71,0.00,4864.71,0.43,1
34051,3562,1000.00,5864.71,6864.71,0.00,4299.65,0.23,1
34052,3562,1000.00,6864.71,7864.71,0.00,6864.71,0.14,1
34053,3562,-1000.00,5864.71,6864.71,4210.12,3654.59,0.19,0
34054,3562,-1000.00,4864.71,5864.71,3323.69,3191.17,0.21,0
34055,3562,-1000.00,3864.71,4864.71,2910.60,121.61,0.08,0
34056,3562,1000.00,4864.71,5864.71,1529.97,2328.82,0.26,1
34057,3562,1000.00,5864.71,6864.71,0.00,818.74,0.03,1
34058,3562,1000.00,6864.71,7864.71,0.00,4093.45,0.02,1
34059,3562,-1000.00,5864.71,6864.71,4224.31,3640.40,0.03,0
34060,3562,1000.00,6864.71,7864.71,2816.90,4047.81,0.04,1
34061,3562,1000.00,7864.71,8864.71,1402.63,5181.95,0.36,1
34062,3562,1000.00,8864.71,9864.71,0.00,8864.71,0.42,1
34063,3562,1000.00,9864.71,10864.71,72.19,7401.67,0.41,1
34064,3562,1000.00,10864.71,11864.71,0.00,2529.50,0.00,1
34065,3562,1000.00,11864.71,12864.71,1833.19,2873.66,0.19,1
34066,3562,1000.00,12864.71,13864.71,3448.44,9416.26,0.38,1
34067,3563,-1000.00,-1000.00,0.00,0.00,1000.00,0.12,0
34068,3564,-1000.00,-1000.00,0.00,30.81,969.19,0.36,0
34069,3565,-1000.00,-1000.00,0.00,326.24,610.59,0.38,0
34070,3566,-1000.00,-1000.00,0.00,388.56,611.44,0.30,0
34071,3567,1000.00,1000.00,2000.00,229.04,770.96,0.10,1
34072,3567,-1000.00,0.00,1000.00,1146.91,853.09,0.11,0
34073,3567,1000.00,1000.00,2000.00,154.97,845.03,0.42,1
34074,3567,1000.00,2000.00,3000.00,349.94,1650.06,0.15,1
34075,3567,1000.00,3000.00,4000.00,1460.18,1539.82,0.14,1
34076,3567,-1000.00,2000.00,3000.00,2113.00,1887.00,0.09,0
34077,3567,1000.00,3000.00,4000.00,0.00,3000.00,0.30,1
34078,3567,0.00,3000.00,4000.00,0.00,0.00,0.05,0
34079,3567,1000.00,4000.00,5000.00,1165.66,2834.34,0.15,1
34080,3567,-1000.00,3000.00,4000.00,1316.09,521.02,0.13,0
34081,3567,1000.00,4000.00,5000.00,245.71,2942.71,0.40,1
34082,3567,1000.00,5000.00,6000.00,0.00,5000.00,0.27,1
34083,3567,1000.00,6000.00,7000.00,1691.55,4308.45,0.37,1
34084,3567,1000.00,7000.00,8000.00,2538.46,3805.47,0.28,1
34085,3567,1000.00,8000.00,9000.00,0.00,8000.00,0.03,1
34086,3567,1000.00,9000.00,10000.00,4500.00,4500.00,0.02,1
34087,3567,-1000.00,8000.00,9000.00,8189.29,822.20,0.06,0
34088,3567,-1000.00,7000.00,8000.00,6013.29,2156.71,0.11,0
34089,3567,1000.00,8000.00,9000.00,0.00,8000.00,0.12,1
34090,3567,1000.00,9000.00,10000.00,246.91,8093.44,0.44,1
34091,3567,1000.00,10000.00,11000.00,0.00,4335.16,0.20,1
34092,3567,1000.00,11000.00,12000.00,1517.14,9482.86,0.03,1
34093,3567,1000.00,12000.00,13000.00,0.00,11039.89,0.40,1
34094,3567,1000.00,13000.00,14000.00,0.00,9267.51,0.32,1
34095,3567,1000.00,14000.00,15000.00,5217.34,8782.66,0.24,1
34096,3567,1000.00,15000.00,16000.00,2126.28,3487.31,0.20,1
34097,3567,1000.00,16000.00,17000.00,0.00,479.77,0.07,1
34098,3567,1000.00,17000.00,18000.00,0.00,8061.16,0.24,1
34099,3567,1000.00,18000.00,19000.00,0.00,18000.00,0.01,1
34100,3567,-1000.00,17000.00,18000.00,4005.08,831.74,0.12,0
34101,3567,-1000.00,16000.00,17000.00,12046.59,5953.41,0.12,0
34102,3567,1000.00,17000.00,18000.00,4822.99,12177.01,0.22,1
34103,3567,-1000.00,16000.00,17000.00,10285.63,7714.37,0.38,0
34104,3567,1000.00,17000.00,18000.00,6823.10,10176.90,0.20,1
34105,3567,1000.00,18000.00,19000.00,0.00,18000.00,0.21,1
34106,3567,1000.00,19000.00,20000.00,0.00,19000.00,0.40,1
34107,3567,1000.00,20000.00,21000.00,475.91,19524.09,0.43,1
34108,3567,1000.00,21000.00,22000.00,0.00,18175.32,0.41,1
34109,3567,1000.00,22000.00,23000.00,0.00,22000.00,0.24,1
34110,3567,1000.00,23000.00,24000.00,0.00,23000.00,0.22,1
34111,3567,1000.00,24000.00,25000.00,3214.32,15240.91,0.36,1
34112,3567,1000.00,25000.00,26000.00,8397.29,16602.71,0.33,1
34113,3567,1000.00,26000.00,27000.00,4491.09,21508.91,0.41,1
34114,3567,1000.00,27000.00,28000.00,0.00,22305.86,0.43,1
34115,3567,1000.00,28000.00,29000.00,9350.29,18649.71,0.33,1
34116,3567,-1000.00,27000.00,28000.00,8314.30,6808.77,0.27,0
34117,3567,1000.00,28000.00,29000.00,0.00,28000.00,0.16,1
34118,3567,1000.00,29000.00,30000.00,9696.75,19303.25,0.33,1
34119,3568,-1000.00,-1000.00,0.00,166.15,358.09,0.24,0
34120,3569,-262.59,-262.59,737.41,0.00,262.59,0.09,0
34121,3569,-555.27,-817.86,182.14,58.86,496.41,0.26,0
34122,3569,-117.17,-935.03,64.97,25.53,91.64,0.33,0
34123,3569,-51.90,-986.93,13.07,5.44,46.46,0.25,0
34124,3569,-13.07,-1000.00,0.00,0.00,13.07,0.12,0
34125,3570,0.00,0.00,1000.00,0.00,0.00,0.20,0
34126,3570,0.00,0.00,1000.00,0.00,0.00,0.37,0
34127,3570,0.00,0.00,1000.00,0.00,0.00,0.18,0
34128,3570,1000.00,1000.00,2000.00,250.01,150.15,0.39,1
34129,3570,1000.00,2000.00,3000.00,637.01,466.34,0.36,1
34130,3570,0.00,2000.00,3000.00,0.00,0.00,0.02,0
34131,3570,1000.00,3000.00,4000.00,339.52,0.00,0.42,1
34132,3570,-802.66,2197.34,3197.34,0.00,802.66,0.25,0
34133,3570,1000.00,3197.34,4197.34,3065.48,0.00,0.11,1
34134,3570,1000.00,4197.34,5197.34,3541.02,0.00,0.16,1
34135,3570,-124.10,4073.24,5073.24,0.00,124.10,0.10,0
34136,3570,1000.00,5073.24,6073.24,3208.06,528.61,0.25,1
34137,3570,1000.00,6073.24,7073.24,3635.89,2437.35,0.04,1
34138,3570,1000.00,7073.24,8073.24,4375.99,0.00,0.13,1
34139,3570,0.00,7073.24,8073.24,0.00,0.00,0.36,0
34140,3570,0.00,7073.24,8073.24,0.00,0.00,0.01,0
34141,3570,-1000.00,6073.24,7073.24,0.00,1471.47,0.40,0
34142,3570,0.00,6073.24,7073.24,0.00,0.00,0.44,0
34143,3570,0.00,6073.24,7073.24,0.00,0.00,0.01,0
34144,3570,0.00,6073.24,7073.24,0.00,0.00,0.09,0
34145,3570,-1000.00,5073.24,6073.24,0.00,4890.13,0.05,0
34146,3570,1000.00,6073.24,7073.24,2024.11,485.89,0.38,1
34147,3570,-1000.00,5073.24,6073.24,0.00,5045.79,0.14,0
34148,3570,1000.00,6073.24,7073.24,4614.02,0.00,0.15,1
34149,3570,1000.00,7073.24,8073.24,1069.86,0.00,0.13,1
34150,3570,-169.04,6904.20,7904.20,0.00,169.04,0.44,0
34151,3570,1000.00,7904.20,8904.20,3687.32,2703.75,0.28,1
34152,3570,0.00,7904.20,8904.20,0.00,0.00,0.25,0
34153,3570,1000.00,8904.20,9904.20,8288.15,0.00,0.12,1
34154,3570,-1000.00,7904.20,8904.20,0.00,4832.25,0.31,0
34155,3570,-1000.00,6904.20,7904.20,0.00,1241.43,0.14,0
34156,3570,-1000.00,5904.20,6904.20,0.00,2846.36,0.09,0
34157,3571,0.00,0.00,1000.00,0.00,0.00,0.00,0
34158,3571,1000.00,1000.00,2000.00,0.00,1000.00,0.15,1
34159,3571,-1000.00,0.00,1000.00,960.96,79.12,0.09,0
34160,3571,1000.00,1000.00,2000.00,246.94,568.60,0.31,1
34161,3571,1000.00,2000.00,3000.00,0.00,2000.00,0.03,1
34162,3571,1000.00,3000.00,4000.00,0.00,1243.10,0.22,1
34163,3571,-1000.00,2000.00,3000.00,3976.11,23.89,0.03,0
34164,3571,1000.00,3000.00,4000.00,148.25,2851.75,0.44,1
34165,3571,1000.00,4000.00,5000.00,0.00,4000.00,0.03,1
34166,3571,-1000.00,3000.00,4000.00,2500.90,2499.10,0.17,0
34167,3571,1000.00,4000.00,5000.00,0.00,3624.83,0.43,1
34168,3571,1000.00,5000.00,6000.00,2368.49,2631.51,0.00,1
34169,3571,1000.00,6000.00,7000.00,0.00,3228.27,0.33,1
34170,3571,1000.00,7000.00,8000.00,0.00,1087.63,0.16,1
34171,3571,1000.00,8000.00,9000.00,0.00,8000.00,0.21,1
34172,3571,1000.00,9000.00,10000.00,0.00,9000.00,0.24,1
34173,3571,1000.00,10000.00,11000.00,2023.21,7976.79,0.08,1
34174,3571,1000.00,11000.00,12000.00,2611.25,8388.75,0.39,1
34175,3571,-1000.00,10000.00,11000.00,2348.19,0.00,0.04,0
34176,3571,1000.00,11000.00,12000.00,5159.23,5840.77,0.37,1
34177,3571,1000.00,12000.00,13000.00,0.00,12000.00,0.15,1
34178,3571,1000.00,13000.00,14000.00,1921.50,10891.26,0.41,1
34179,3571,1000.00,14000.00,15000.00,0.00,4373.80,0.18,1
34180,3571,0.00,14000.00,15000.00,0.00,0.00,0.05,0
34181,3571,1000.00,15000.00,16000.00,7500.00,7500.00,0.03,1
34182,3571,1000.00,16000.00,17000.00,0.00,13204.10,0.38,1
34183,3571,1000.00,17000.00,18000.00,6295.21,8876.54,0.27,1
34184,3571,1000.00,18000.00,19000.00,1247.52,16752.48,0.40,1
34185,3571,1000.00,19000.00,20000.00,0.00,14081.26,0.20,1
34186,3571,1000.00,20000.00,21000.00,0.00,20000.00,0.17,1
34187,3571,1000.00,21000.00,22000.00,0.00,21000.00,0.42,1
34188,3571,1000.00,22000.00,23000.00,11000.00,11000.00,0.08,1
34189,3571,1000.00,23000.00,24000.00,3215.46,19784.54,0.14,1
34190,3571,1000.00,24000.00,25000.00,10374.88,13625.12,0.18,1
34191,3571,1000.00,25000.00,26000.00,483.90,5387.47,0.19,1
34192,3571,1000.00,26000.00,27000.00,0.00,26000.00,0.28,1
34193,3571,-1000.00,25000.00,26000.00,0.00,27000.00,0.11,0
34194,3572,1000.00,1000.00,2000.00,0.00,1000.00,0.05,1
34195,3572,-1000.00,0.00,1000.00,1790.47,0.00,0.02,0
34196,3572,1000.00,1000.00,2000.00,0.00,1000.00,0.22,1
34197,3572,1000.00,2000.00,3000.00,0.00,2000.00,0.30,1
34198,3572,1000.00,3000.00,4000.00,0.00,2335.76,0.35,1
34199,3572,-1000.00,2000.00,3000.00,1663.44,891.70,0.15,0
34200,3572,0.00,2000.00,3000.00,0.00,0.00,0.02,0
34201,3572,-1000.00,1000.00,2000.00,1684.42,1266.12,0.18,0
34202,3572,1000.00,2000.00,3000.00,0.00,1798.89,0.34,1
34203,3572,1000.00,3000.00,4000.00,538.07,2461.93,0.33,1
34204,3572,1000.00,4000.00,5000.00,0.00,3970.28,0.14,1
34205,3572,1000.00,5000.00,6000.00,0.00,5000.00,0.29,1
34206,3572,-1000.00,4000.00,5000.00,0.00,5878.41,0.35,0
34207,3572,0.00,4000.00,5000.00,0.00,0.00,0.12,0
34208,3572,-1000.00,3000.00,4000.00,3194.77,1805.23,0.13,0
34209,3572,-1000.00,2000.00,3000.00,0.00,1680.30,0.18,0
34210,3572,-1000.00,1000.00,2000.00,0.00,3000.00,0.31,0
34211,3572,-1000.00,0.00,1000.00,73.19,1804.64,0.44,0
34212,3572,-1000.00,-1000.00,0.00,0.00,994.21,0.44,0
34213,3573,-1000.00,-1000.00,0.00,0.00,917.88,0.15,0
34214,3574,-1000.00,-1000.00,0.00,193.07,0.00,0.10,0
34215,3575,-1000.00,-1000.00,0.00,413.79,586.21,0.27,0
34216,3576,-1000.00,-1000.00,0.00,475.61,524.39,0.14,0
34217,3577,-1000.00,-1000.00,0.00,0.00,687.46,0.37,0
34218,3578,-1000.00,-1000.00,0.00,506.79,493.21,0.21,0
34219,3579,-1000.00,-1000.00,0.00,323.18,676.82,0.23,0
34220,3580,1000.00,1000.00,2000.00,0.00,1000.00,0.14,1
34221,3580,1000.00,2000.00,3000.00,990.69,1009.31,0.02,1
34222,3580,1000.00,3000.00,4000.00,108.15,2888.05,0.44,1
34223,3580,1000.00,4000.00,5000.00,1944.37,2055.63,0.03,1
34224,3580,-1000.00,3000.00,4000.00,3655.68,1344.32,0.09,0
34225,3580,1000.00,4000.00,5000.00,0.00,4000.00,0.13,1
34226,3580,1000.00,5000.00,6000.00,597.83,4171.46,0.42,1
34227,3580,1000.00,6000.00,7000.00,2764.41,3235.59,0.19,1
34228,3580,-1000.00,5000.00,6000.00,6455.84,544.16,0.03,0
34229,3580,1000.00,6000.00,7000.00,852.27,5147.73,0.27,1
34230,3580,1000.00,7000.00,8000.00,0.00,4425.02,0.21,1
34231,3580,1000.00,8000.00,9000.00,2675.75,5324.25,0.28,1
34232,3580,1000.00,9000.00,10000.00,4068.72,4931.28,0.12,1
34233,3580,1000.00,10000.00,11000.00,2681.48,7318.52,0.01,1
34234,3580,1000.00,11000.00,12000.00,0.00,11000.00,0.05,1
34235,3580,1000.00,12000.00,13000.00,0.00,12000.00,0.29,1
34236,3580,1000.00,13000.00,14000.00,0.00,13000.00,0.16,1
34237,3580,1000.00,14000.00,15000.00,0.00,7066.29,0.29,1
34238,3580,1000.00,15000.00,16000.00,365.83,14634.17,0.20,1
34239,3580,-1000.00,14000.00,15000.00,6712.00,5912.84,0.20,0
34240,3580,-1000.00,13000.00,14000.00,8829.59,6170.41,0.03,0
34241,3580,1000.00,14000.00,15000.00,2318.15,11681.85,0.14,1
34242,3580,1000.00,15000.00,16000.00,5224.14,9775.86,0.07,1
34243,3580,1000.00,16000.00,17000.00,0.00,16000.00,0.23,1
34244,3580,1000.00,17000.00,18000.00,8500.00,8500.00,0.40,1
34245,3580,1000.00,18000.00,19000.00,0.00,18000.00,0.26,1
34246,3580,1000.00,19000.00,20000.00,0.00,19000.00,0.38,1
34247,3580,1000.00,20000.00,21000.00,875.72,19124.28,0.42,1
34248,3580,1000.00,21000.00,22000.00,0.00,4577.82,0.16,1
34249,3580,1000.00,22000.00,23000.00,11000.00,11000.00,0.02,1
34250,3580,1000.00,23000.00,24000.00,8916.59,14083.41,0.10,1
34251,3580,1000.00,24000.00,25000.00,327.73,20049.56,0.43,1
34252,3580,1000.00,25000.00,26000.00,0.00,23790.95,0.35,1
34253,3580,1000.00,26000.00,27000.00,0.00,20842.91,0.29,1
34254,3580,-1000.00,25000.00,26000.00,15209.66,11790.34,0.18,0
34255,3580,1000.00,26000.00,27000.00,148.84,2173.82,0.14,1
34256,3580,1000.00,27000.00,28000.00,0.00,27000.00,0.04,1
34257,3580,-1000.00,26000.00,27000.00,18730.57,9269.43,0.12,0
34258,3580,1000.00,27000.00,28000.00,4795.74,22204.26,0.14,1
34259,3580,1000.00,28000.00,29000.00,0.00,19062.76,0.27,1
34260,3580,1000.00,29000.00,30000.00,0.00,10525.14,0.25,1
34261,3581,-1000.00,-1000.00,0.00,0.00,1000.00,0.20,0
34262,3582,1000.00,1000.00,2000.00,119.99,869.35,0.42,1
34263,3582,1000.00,2000.00,3000.00,0.00,876.46,0.13,1
34264,3582,1000.00,3000.00,4000.00,717.33,2282.67,0.37,1
34265,3582,-1000.00,2000.00,3000.00,3614.15,0.00,0.03,0
34266,3582,1000.00,3000.00,4000.00,460.94,572.83,0.17,1
34267,3582,1000.00,4000.00,5000.00,1044.33,2955.67,0.37,1
34268,3582,1000.00,5000.00,6000.00,0.00,5000.00,0.31,1
34269,3582,1000.00,6000.00,7000.00,0.00,6000.00,0.22,1
34270,3582,1000.00,7000.00,8000.00,0.00,7000.00,0.36,1
34271,3582,1000.00,8000.00,9000.00,0.00,8000.00,0.16,1
34272,3582,1000.00,9000.00,10000.00,3613.42,5386.58,0.17,1
34273,3582,1000.00,10000.00,11000.00,0.00,10000.00,0.11,1
34274,3582,1000.00,11000.00,12000.00,0.00,11000.00,0.33,1
34275,3582,1000.00,12000.00,13000.00,0.00,12000.00,0.29,1
34276,3582,1000.00,13000.00,14000.00,340.23,12659.77,0.31,1
34277,3582,1000.00,14000.00,15000.00,4633.20,9366.80,0.11,1
34278,3582,1000.00,15000.00,16000.00,7500.00,7500.00,0.11,1
34279,3582,1000.00,16000.00,17000.00,0.00,11415.72,0.37,1
34280,3582,-1000.00,15000.00,16000.00,11695.48,5304.52,0.10,0
34281,3582,1000.00,16000.00,17000.00,4987.25,6670.17,0.24,1
34282,3582,1000.00,17000.00,18000.00,0.00,14423.99,0.33,1
34283,3582,1000.00,18000.00,19000.00,0.00,15721.05,0.05,1
34284,3582,1000.00,19000.00,20000.00,0.00,19000.00,0.20,1
34285,3582,1000.00,20000.00,21000.00,4540.66,15459.34,0.39,1
34286,3582,1000.00,21000.00,22000.00,1240.57,1550.22,0.13,1
34287,3582,1000.00,22000.00,23000.00,0.00,13153.48,0.23,1
34288,3582,1000.00,23000.00,24000.00,0.00,23000.00,0.22,1
34289,3582,1000.00,24000.00,25000.00,8143.31,15856.69,0.24,1
34290,3582,1000.00,25000.00,26000.00,11346.63,13653.37,0.06,1
34291,3582,1000.00,26000.00,27000.00,3359.06,22640.94,0.09,1
34292,3582,1000.00,27000.00,28000.00,2036.55,24963.45,0.43,1
34293,3582,1000.00,28000.00,29000.00,0.00,21751.19,0.29,1
34294,3582,1000.00,29000.00,30000.00,1896.23,18109.72,0.36,1
34295,3582,-1000.00,28000.00,29000.00,14822.40,6666.88,0.14,0
34296,3582,1000.00,29000.00,30000.00,2943.21,26056.79,0.24,1
34297,3582,1000.00,30000.00,31000.00,0.00,23927.21,0.37,1
34298,3582,0.00,30000.00,31000.00,0.00,0.00,0.05,0
34299,3582,-1000.00,29000.00,30000.00,16058.02,14941.98,0.06,0
34300,3582,1000.00,30000.00,31000.00,0.00,30000.00,0.12,1
34301,3582,1000.00,31000.00,32000.00,3734.95,26372.65,0.42,1
34302,3582,1000.00,32000.00,33000.00,0.00,32000.00,0.15,1
34303,3582,1000.00,33000.00,34000.00,14222.70,18777.30,0.20,1
34304,3582,1000.00,34000.00,35000.00,6864.74,12349.75,0.24,1
34305,3582,1000.00,35000.00,36000.00,0.00,35000.00,0.10,1
34306,3582,1000.00,36000.00,37000.00,0.00,18424.24,0.15,1
34307,3582,1000.00,37000.00,38000.00,0.00,37000.00,0.00,1
34308,3582,1000.00,38000.00,39000.00,0.00,38000.00,0.11,1
34309,3582,-1000.00,37000.00,38000.00,19102.64,19897.36,0.34,0
34310,3582,-1000.00,36000.00,37000.00,4235.54,33764.46,0.33,0
34311,3582,-1000.00,35000.00,36000.00,0.00,37000.00,0.19,0
34312,3582,-1000.00,34000.00,35000.00,0.00,36000.00,0.04,0
34313,3582,-1000.00,33000.00,34000.00,0.00,35000.00,0.34,0
34314,3582,-1000.00,32000.00,33000.00,0.00,18175.34,0.27,0
34315,3582,-1000.00,31000.00,32000.00,0.00,5988.73,0.11,0
34316,3582,-1000.00,30000.00,31000.00,21956.85,10043.15,0.09,0
34317,3582,-1000.00,29000.00,30000.00,0.00,31000.00,0.09,0
34318,3582,-1000.00,28000.00,29000.00,0.00,15055.05,0.27,0
34319,3582,-1000.00,27000.00,28000.00,0.00,29000.00,0.33,0
34320,3582,-1000.00,26000.00,27000.00,0.00,20225.56,0.37,0
34321,3582,-1000.00,25000.00,26000.00,6684.75,20315.25,0.37,0
34322,3582,-1000.00,24000.00,25000.00,13000.00,13000.00,0.03,0
34323,3582,-1000.00,23000.00,24000.00,8840.92,16159.08,0.28,0
34324,3582,-1000.00,22000.00,23000.00,0.00,17125.71,0.24,0
34325,3582,-1000.00,21000.00,22000.00,10505.52,12494.48,0.16,0
34326,3582,-1000.00,20000.00,21000.00,6391.45,15608.55,0.04,0
34327,3582,-1000.00,19000.00,20000.00,7097.38,13902.62,0.27,0
34328,3582,-1000.00,18000.00,19000.00,0.00,20000.00,0.20,0
34329,3582,-1000.00,17000.00,18000.00,0.00,19000.00,0.15,0
34330,3582,-1000.00,16000.00,17000.00,5840.46,12159.54,0.34,0
34331,3582,-1000.00,15000.00,16000.00,3729.25,13270.75,0.16,0
34332,3583,-1000.00,-1000.00,0.00,0.00,1000.00,0.01,0
34333,3584,-1000.00,-1000.00,0.00,0.00,1000.00,0.15,0
34334,3585,-1000.00,-1000.00,0.00,0.00,1000.00,0.42,0
34335,3586,-1000.00,-1000.00,0.00,334.22,665.78,0.33,0
34336,3586,-0.00,-1000.00,0.00,0.00,0.00,0.15,0
34337,3587,-958.12,-958.12,41.88,0.00,958.12,0.34,0
34338,3587,-1000.00,-1958.12,-958.12,29.83,12.06,0.10,0
34339,3588,-795.34,-795.34,204.66,0.00,795.34,0.36,0
34340,3588,0.00,-795.34,204.66,0.00,0.00,0.06,0
34341,3588,-204.66,-1000.00,0.00,70.01,134.64,0.32,0
34342,3589,-1000.00,-1000.00,0.00,355.56,644.44,0.12,0
34343,3590,0.00,0.00,1000.00,0.00,0.00,0.39,0
34344,3590,0.00,0.00,1000.00,0.00,0.00,0.34,0
34345,3590,-911.71,-911.71,88.29,0.00,911.71,0.12,0
34346,3590,0.00,-911.71,88.29,0.00,0.00,0.13,0
34347,3590,0.00,-911.71,88.29,0.00,0.00,0.02,0
34348,3590,-88.29,-1000.00,0.00,0.00,88.29,0.05,0
34349,3591,-81.31,-81.31,918.69,0.00,81.31,0.13,0
34350,3591,-693.17,-774.49,225.51,0.00,693.17,0.40,0
34351,3591,-225.51,-1000.00,0.00,104.92,120.59,0.22,0
34352,3592,-1000.00,-1000.00,0.00,240.38,759.62,0.39,0
34353,3593,0.00,0.00,1000.00,0.00,0.00,0.09,0
34354,3593,-1000.00,-1000.00,0.00,646.12,353.88,0.11,0
34355,3594,-1000.00,-1000.00,0.00,391.05,608.95,0.24,0
34356,3595,1000.00,1000.00,2000.00,534.83,465.17,0.19,1
34357,3595,-1000.00,0.00,1000.00,976.94,1023.06,0.03,0
34358,3595,1000.00,1000.00,2000.00,703.88,296.12,0.10,1
34359,3595,-1000.00,0.00,1000.00,0.00,2000.00,0.11,0
34360,3595,-582.36,-582.36,417.64,0.00,582.36,0.32,0
34361,3595,-417.64,-1000.00,0.00,0.00,417.64,0.34,0
34362,3596,0.00,0.00,1000.00,0.00,0.00,0.06,0
34363,3596,-801.46,-801.46,198.54,101.23,700.22,0.39,0
34364,3596,-74.81,-876.27,123.73,0.00,74.81,0.27,0
34365,3596,-123.73,-1000.00,0.00,32.12,91.61,0.36,0
34366,3597,-1000.00,-1000.00,0.00,0.00,1000.00,0.12,0
34367,3598,-1000.00,-1000.00,0.00,299.57,700.43,0.23,0
34368,3599,0.00,0.00,1000.00,0.00,0.00,0.43,0
34369,3599,-1000.00,-1000.00,0.00,0.00,635.54,0.01,0
34370,3600,-1000.00,-1000.00,0.00,0.00,1000.00,0.41,0
34371,3601,-1000.00,-1000.00,0.00,121.96,878.04,0.18,0
34372,3602,0.00,0.00,1000.00,0.00,0.00,0.03,0
34373,3602,-1000.00,-1000.00,0.00,114.86,885.14,0.17,0
34374,3603,-1000.00,-1000.00,0.00,0.00,1000.00,0.13,0
34375,3604,-1000.00,-1000.00,0.00,429.59,570.41,0.25,0
34376,3605,-937.64,-937.64,62.36,0.00,937.64,0.21,0
34377,3605,-20.86,-958.49,41.51,8.13,12.72,0.43,0
34378,3605,-36.82,-995.31,4.69,0.00,36.82,0.34,0
34379,3605,0.00,-995.31,4.69,0.00,0.00,0.07,0
34380,3605,-2.68,-997.99,2.01,0.00,2.68,0.19,0
34381,3605,-2.01,-1000.00,0.00,0.65,1.36,0.06,0
34382,3606,-1000.00,-1000.00,0.00,1000.00,0.00,0.01,0
34383,3607,-667.73,-667.73,332.27,334.42,333.31,0.24,0
34384,3607,-1000.00,-1667.73,-667.73,130.76,201.51,0.23,0
34385,3608,-1000.00,-1000.00,0.00,0.00,499.80,0.32,0
34386,3609,-1000.00,-1000.00,0.00,215.02,784.98,0.40,0
34387,3610,-778.88,-778.88,221.12,215.66,563.22,0.37,0
34388,3610,1000.00,221.12,1221.12,109.65,9.38,0.29,1
34389,3610,1000.00,1221.12,2221.12,134.79,0.00,0.39,1
34390,3610,1000.00,2221.12,3221.12,680.64,655.26,0.36,1
34391,3610,-1000.00,1221.12,2221.12,1248.17,1972.95,0.27,0
34392,3610,0.00,1221.12,2221.12,0.00,0.00,0.29,0
34393,3610,-551.34,669.78,1669.78,0.00,551.34,0.41,0
34394,3610,0.00,669.78,1669.78,0.00,0.00,0.02,0
34395,3610,1000.00,1669.78,2669.78,197.36,0.00,0.37,1
34396,3610,1000.00,2669.78,3669.78,270.31,102.97,0.44,1
34397,3610,1000.00,3669.78,4669.78,878.55,0.00,0.23,1
34398,3610,1000.00,4669.78,5669.78,2695.13,0.00,0.10,1
34399,3610,-1000.00,3669.78,4669.78,0.00,5548.25,0.08,0
34400,3610,-1000.00,2669.78,3669.78,0.00,4669.78,0.04,0
34401,3610,-1000.00,1669.78,2669.78,0.00,1297.93,0.12,0
34402,3610,-1000.00,669.78,1669.78,0.00,1283.81,0.15,0
34403,3610,-879.59,-209.80,790.20,879.59,0.00,0.30,0
34404,3610,-1000.00,-1209.80,-209.80,66.42,723.78,0.31,0
34405,3611,0.00,0.00,1000.00,0.00,0.00,0.17,0
34406,3611,-800.04,-800.04,199.96,0.00,800.04,0.23,0
34407,3611,-199.96,-1000.00,0.00,0.00,199.96,0.35,0
34408,3612,-1000.00,-1000.00,0.00,432.89,567.11,0.13,0
34409,3613,1000.00,1000.00,2000.00,320.89,679.11,0.34,1
34410,3613,1000.00,2000.00,3000.00,285.80,779.29,0.26,1
34411,3613,1000.00,3000.00,4000.00,0.00,2317.20,0.03,1
34412,3613,1000.00,4000.00,5000.00,0.00,4000.00,0.33,1
34413,3613,1000.00,5000.00,6000.00,2087.72,2912.28,0.01,1
34414,3613,1000.00,6000.00,7000.00,2757.98,3242.02,0.24,1
34415,3613,1000.00,7000.00,8000.00,3077.64,3922.36,0.05,1
34416,3613,1000.00,8000.00,9000.00,0.00,7882.03,0.34,1
34417,3613,1000.00,9000.00,10000.00,1096.87,7903.13,0.10,1
34418,3613,1000.00,10000.00,11000.00,4821.20,5178.80,0.10,1
34419,3613,1000.00,11000.00,12000.00,1259.49,4691.56,0.28,1
34420,3613,1000.00,12000.00,13000.00,0.00,12000.00,0.07,1
34421,3613,-1000.00,11000.00,12000.00,3607.64,2242.71,0.15,0
34422,3613,1000.00,12000.00,13000.00,0.00,12000.00,0.23,1
34423,3613,1000.00,13000.00,14000.00,2905.28,10094.72,0.28,1
34424,3613,1000.00,14000.00,15000.00,5417.08,8582.92,0.17,1
34425,3613,-1000.00,13000.00,14000.00,4149.47,3358.84,0.17,0
34426,3613,1000.00,14000.00,15000.00,0.00,14000.00,0.02,1
34427,3613,1000.00,15000.00,16000.00,0.00,15000.00,0.24,1
34428,3613,1000.00,16000.00,17000.00,0.00,16000.00,0.21,1
34429,3613,1000.00,17000.00,18000.00,0.00,17000.00,0.20,1
34430,3613,1000.00,18000.00,19000.00,6986.50,11013.50,0.36,1
34431,3613,1000.00,19000.00,20000.00,0.00,19000.00,0.02,1
34432,3613,1000.00,20000.00,21000.00,9797.23,10202.77,0.03,1
34433,3613,1000.00,21000.00,22000.00,0.00,11541.64,0.27,1
34434,3613,1000.00,22000.00,23000.00,0.00,10298.00,0.29,1
34435,3613,1000.00,23000.00,24000.00,0.00,23000.00,0.17,1
34436,3613,-1000.00,22000.00,23000.00,13283.86,10716.14,0.16,0
34437,3613,1000.00,23000.00,24000.00,0.00,23000.00,0.44,1
34438,3613,1000.00,24000.00,25000.00,7460.31,16539.69,0.35,1
34439,3613,-1000.00,23000.00,24000.00,13590.08,11409.92,0.22,0
34440,3613,1000.00,24000.00,25000.00,0.00,24000.00,0.14,1
34441,3613,1000.00,25000.00,26000.00,395.50,17987.40,0.40,1
34442,3613,1000.00,26000.00,27000.00,0.00,23041.70,0.40,1
34443,3613,1000.00,27000.00,28000.00,10274.87,16725.13,0.29,1
34444,3613,1000.00,28000.00,29000.00,13256.36,14743.64,0.14,1
34445,3613,0.00,28000.00,29000.00,0.00,0.00,0.02,0
34446,3613,-1000.00,27000.00,28000.00,24174.86,4825.14,0.04,0
34447,3613,1000.00,28000.00,29000.00,5040.29,22959.71,0.35,1
34448,3613,1000.00,29000.00,30000.00,0.00,15414.58,0.08,1
34449,3613,1000.00,30000.00,31000.00,12431.68,17568.32,0.22,1
34450,3613,1000.00,31000.00,32000.00,0.00,31000.00,0.24,1
34451,3613,0.00,31000.00,32000.00,0.00,0.00,0.04,0
34452,3614,1000.00,1000.00,2000.00,0.00,241.84,0.18,1
34453,3614,0.00,1000.00,2000.00,0.00,0.00,0.04,0
34454,3614,1000.00,2000.00,3000.00,165.06,1834.94,0.43,1
34455,3614,1000.00,3000.00,4000.00,0.00,3000.00,0.44,1
34456,3614,1000.00,4000.00,5000.00,0.00,4000.00,0.27,1
34457,3614,1000.00,5000.00,6000.00,2282.14,2717.86,0.24,1
34458,3614,-1000.00,4000.00,5000.00,3034.24,2965.76,0.16,0
34459,3614,1000.00,5000.00,6000.00,0.00,1567.24,0.18,1
34460,3614,1000.00,6000.00,7000.00,2769.55,3230.45,0.15,1
34461,3614,1000.00,7000.00,8000.00,0.00,7000.00,0.19,1
34462,3614,1000.00,8000.00,9000.00,0.00,2738.54,0.21,1
34463,3614,-1000.00,7000.00,8000.00,2096.04,1125.39,0.14,0
34464,3614,1000.00,8000.00,9000.00,1562.69,6437.31,0.14,1
34465,3614,1000.00,9000.00,10000.00,4500.00,4500.00,0.10,1
34466,3614,1000.00,10000.00,11000.00,3170.56,6780.12,0.33,1
34467,3614,1000.00,11000.00,12000.00,0.00,11000.00,0.33,1
34468,3614,0.00,11000.00,12000.00,0.00,0.00,0.10,0
34469,3614,1000.00,12000.00,13000.00,0.00,12000.00,0.33,1
34470,3614,-1000.00,11000.00,12000.00,31.51,12968.49,0.38,0
34471,3614,-1000.00,10000.00,11000.00,0.00,12000.00,0.29,0
34472,3614,-1000.00,9000.00,10000.00,0.00,11000.00,0.23,0
34473,3614,-1000.00,8000.00,9000.00,0.00,3953.07,0.19,0
34474,3614,-1000.00,7000.00,8000.00,0.00,5234.58,0.18,0
34475,3614,-1000.00,6000.00,7000.00,4815.80,3184.20,0.06,0
34476,3614,1000.00,7000.00,8000.00,495.29,6504.71,0.18,1
34477,3614,1000.00,8000.00,9000.00,0.00,8000.00,0.19,1
34478,3614,1000.00,9000.00,10000.00,0.00,6613.12,0.38,1
34479,3614,1000.00,10000.00,11000.00,0.00,10000.00,0.06,1
34480,3614,1000.00,11000.00,12000.00,2686.26,8313.74,0.35,1
34481,3614,-1000.00,10000.00,11000.00,5723.24,4413.07,0.19,0
34482,3614,1000.00,11000.00,12000.00,0.00,11000.00,0.19,1
34483,3614,1000.00,12000.00,13000.00,0.00,12000.00,0.40,1
34484,3614,1000.00,13000.00,14000.00,4554.39,8445.61,0.24,1
34485,3614,1000.00,14000.00,15000.00,0.00,13605.59,0.44,1
34486,3614,-1000.00,13000.00,14000.00,3175.20,0.00,0.07,0
34487,3614,1000.00,14000.00,15000.00,1248.42,1418.19,0.10,1
34488,3614,1000.00,15000.00,16000.00,455.34,9987.09,0.38,1
34489,3614,1000.00,16000.00,17000.00,6638.53,9361.47,0.09,1
34490,3614,1000.00,17000.00,18000.00,6065.77,10934.23,0.25,1
34491,3614,1000.00,18000.00,19000.00,0.00,16123.80,0.42,1
34492,3614,1000.00,19000.00,20000.00,3217.80,10542.85,0.32,1
34493,3614,1000.00,20000.00,21000.00,0.00,20000.00,0.14,1
34494,3614,1000.00,21000.00,22000.00,8903.31,12096.69,0.39,1
34495,3614,1000.00,22000.00,23000.00,0.00,12427.65,0.28,1
34496,3614,1000.00,23000.00,24000.00,11500.00,11500.00,0.04,1
34497,3614,1000.00,24000.00,25000.00,4209.00,16563.59,0.39,1
34498,3614,1000.00,25000.00,26000.00,6522.23,18477.77,0.20,1
34499,3615,-1000.00,-1000.00,0.00,0.00,1000.00,0.07,0
34500,3616,-1000.00,-1000.00,0.00,352.88,647.12,0.28,0
34501,3617,1000.00,1000.00,2000.00,0.00,1000.00,0.02,1
34502,3617,-361.44,638.56,1638.56,361.44,0.00,0.25,0
34503,3617,1000.00,1638.56,2638.56,0.00,1264.34,0.38,1
34504,3617,1000.00,2638.56,3638.56,0.00,2350.69,0.34,1
34505,3617,1000.00,3638.56,4638.56,1745.56,1893.00,0.16,1
34506,3617,-1000.00,2638.56,3638.56,2936.40,1702.15,0.16,0
34507,3617,1000.00,3638.56,4638.56,0.00,3638.56,0.26,1
34508,3617,1000.00,4638.56,5638.56,789.46,3849.09,0.28,1
34509,3617,1000.00,5638.56,6638.56,0.00,5638.56,0.39,1
34510,3617,-1000.00,4638.56,5638.56,6638.56,0.00,0.01,0
34511,3617,1000.00,5638.56,6638.56,0.00,5638.56,0.03,1
34512,3617,1000.00,6638.56,7638.56,2570.09,4068.46,0.16,1
34513,3617,1000.00,7638.56,8638.56,0.00,7638.56,0.28,1
34514,3617,1000.00,8638.56,9638.56,0.00,8638.56,0.29,1
34515,3617,1000.00,9638.56,10638.56,1470.49,8168.07,0.16,1
34516,3617,1000.00,10638.56,11638.56,0.00,3290.77,0.09,1
34517,3617,1000.00,11638.56,12638.56,0.00,7647.00,0.11,1
34518,3617,1000.00,12638.56,13638.56,6319.28,6319.28,0.28,1
34519,3617,-1000.00,11638.56,12638.56,8394.80,5243.75,0.08,0
34520,3617,1000.00,12638.56,13638.56,1942.36,3979.82,0.22,1
34521,3617,1000.00,13638.56,14638.56,3655.35,9983.21,0.12,1
34522,3617,1000.00,14638.56,15638.56,4563.38,10075.18,0.30,1
34523,3617,-1000.00,13638.56,14638.56,13342.31,2296.25,0.10,0
34524,3617,-984.58,12653.97,13653.97,984.58,0.00,0.14,0
34525,3617,1000.00,13653.97,14653.97,6826.99,6826.99,0.26,1
34526,3617,1000.00,14653.97,15653.97,3670.90,10983.07,0.38,1
34527,3617,1000.00,15653.97,16653.97,1562.58,14091.39,0.38,1
34528,3617,1000.00,16653.97,17653.97,0.00,16653.97,0.07,1
34529,3617,1000.00,17653.97,18653.97,0.00,17653.97,0.36,1
34530,3617,1000.00,18653.97,19653.97,9326.99,9326.99,0.01,1
34531,3617,-1000.00,17653.97,18653.97,11686.48,4392.18,0.12,0
34532,3617,1000.00,18653.97,19653.97,4678.13,13975.84,0.20,1
34533,3617,-1000.00,17653.97,18653.97,16242.00,2752.69,0.06,0
34534,3617,1000.00,18653.97,19653.97,0.00,13828.08,0.34,1
34535,3617,1000.00,19653.97,20653.97,5306.24,11140.54,0.31,1
34536,3617,1000.00,20653.97,21653.97,4794.33,15859.64,0.37,1
34537,3617,1000.00,21653.97,22653.97,0.00,21653.97,0.03,1
34538,3617,1000.00,22653.97,23653.97,0.00,22653.97,0.01,1
34539,3617,-1000.00,21653.97,22653.97,11895.42,11758.55,0.40,0
34540,3617,1000.00,22653.97,23653.97,0.00,22653.97,0.21,1
34541,3617,-1000.00,21653.97,22653.97,14362.21,9291.76,0.37,0
34542,3617,1000.00,22653.97,23653.97,0.00,22653.97,0.32,1
34543,3617,1000.00,23653.97,24653.97,0.00,5651.52,0.11,1
34544,3618,-1000.00,-1000.00,0.00,0.00,1000.00,0.06,0
34545,3619,-886.46,-886.46,113.54,0.00,886.46,0.32,0
34546,3619,1000.00,113.54,1113.54,35.02,8.71,0.33,1
34547,3619,-658.25,-544.70,455.30,0.00,658.25,0.08,0
34548,3619,-28.00,-572.70,427.30,0.00,28.00,0.27,0
34549,3619,-225.59,-798.29,201.71,13.43,212.15,0.38,0
34550,3619,-90.59,-888.88,111.12,0.00,90.59,0.04,0
34551,3619,1000.00,111.12,1111.12,57.47,0.98,0.17,1
34552,3619,-1000.00,-888.88,111.12,0.00,1111.12,0.09,0
34553,3619,0.00,-888.88,111.12,0.00,0.00,0.00,0
34554,3619,-97.30,-986.18,13.82,10.25,87.05,0.41,0
34555,3619,-13.82,-1000.00,0.00,0.00,13.82,0.18,0
34556,3620,-1000.00,-1000.00,0.00,0.00,1000.00,0.15,0
34557,3621,-432.59,-432.59,567.41,259.70,172.89,0.36,0
34558,3621,-1000.00,-1432.59,-432.59,0.00,14.50,0.32,0
34559,3622,-660.09,-660.09,339.91,0.00,660.09,0.18,0
34560,3622,-339.91,-1000.00,0.00,0.00,339.91,0.39,0
34561,3623,-489.41,-489.41,510.59,12.79,476.62,0.31,0
34562,3623,-510.59,-1000.00,0.00,250.56,260.03,0.03,0
34563,3624,-1000.00,-1000.00,0.00,0.00,1000.00,0.09,0
34564,3625,0.00,0.00,1000.00,0.00,0.00,0.05,0
34565,3625,-666.12,-666.12,333.88,0.00,666.12,0.31,0
34566,3625,-249.87,-915.99,84.01,0.00,249.87,0.40,0
34567,3625,-69.98,-985.97,14.03,10.32,59.65,0.39,0
34568,3625,-14.03,-1000.00,0.00,3.14,10.89,0.39,0
34569,3626,-1000.00,-1000.00,0.00,23.87,976.13,0.44,0
34570,3627,-897.06,-897.06,102.94,0.00,897.06,0.15,0
34571,3627,0.00,-897.06,102.94,0.00,0.00,0.44,0
34572,3627,0.00,-897.06,102.94,0.00,0.00,0.02,0
34573,3627,-1000.00,-1897.06,-897.06,31.92,3.85,0.38,0
34574,3628,-1000.00,-1000.00,0.00,0.00,1000.00,0.31,0
34575,3629,-1000.00,-1000.00,0.00,474.27,309.48,0.17,0
34576,3630,1000.00,1000.00,2000.00,260.39,739.61,0.38,1
34577,3630,1000.00,2000.00,3000.00,0.00,1324.97,0.38,1
34578,3630,1000.00,3000.00,4000.00,0.00,2044.11,0.38,1
34579,3630,1000.00,4000.00,5000.00,0.00,4000.00,0.21,1
34580,3630,1000.00,5000.00,6000.00,600.72,4399.28,0.44,1
34581,3630,1000.00,6000.00,7000.00,2698.43,3301.57,0.25,1
34582,3630,1000.00,7000.00,8000.00,3396.24,3603.76,0.15,1
34583,3630,0.00,7000.00,8000.00,0.00,0.00,0.01,0
34584,3630,-1000.00,6000.00,7000.00,0.00,6325.09,0.17,0
34585,3630,0.00,6000.00,7000.00,0.00,0.00,0.15,0
34586,3630,-1000.00,5000.00,6000.00,3968.08,3031.92,0.13,0
34587,3630,-1000.00,4000.00,5000.00,556.27,4790.97,0.19,0
34588,3630,-1000.00,3000.00,4000.00,0.00,5000.00,0.33,0
34589,3630,-1000.00,2000.00,3000.00,1729.49,0.00,0.34,0
34590,3630,-1000.00,1000.00,2000.00,178.75,2821.25,0.10,0
34591,3630,-508.74,491.26,1491.26,508.74,0.00,0.37,0
34592,3630,-1000.00,-508.74,491.26,0.00,427.46,0.07,0
34593,3630,-217.27,-726.01,273.99,217.27,0.00,0.22,0
34594,3630,-1000.00,-1726.01,-726.01,0.00,273.99,0.03,0
34595,3631,-1000.00,-1000.00,0.00,13.05,679.78,0.40,0
34596,3632,1000.00,1000.00,2000.00,677.95,0.00,0.09,1
34597,3632,1000.00,2000.00,3000.00,2000.00,0.00,0.06,1
34598,3632,-1000.00,1000.00,2000.00,0.00,1998.88,0.11,0
34599,3632,-1000.00,0.00,1000.00,0.00,2000.00,0.28,0
34600,3632,-838.60,-838.60,161.40,133.98,704.62,0.37,0
34601,3632,1000.00,161.40,1161.40,66.76,49.15,0.27,1
34602,3632,-1000.00,-838.60,161.40,29.94,1131.46,0.30,0
34603,3632,-161.40,-1000.00,0.00,24.82,136.58,0.41,0
34604,3633,-1000.00,-1000.00,0.00,0.00,770.67,0.23,0
34605,3634,-1000.00,-1000.00,0.00,231.18,768.82,0.01,0
34606,3635,-497.08,-497.08,502.92,0.00,497.08,0.19,0
34607,3635,-1000.00,-1497.08,-497.08,134.86,0.00,0.06,0
34608,3636,0.00,0.00,1000.00,0.00,0.00,0.08,0
34609,3636,-1000.00,-1000.00,0.00,237.93,762.07,0.19,0
34610,3637,-1000.00,-1000.00,0.00,0.00,1000.00,0.43,0
34611,3638,-1000.00,-1000.00,0.00,579.16,0.00,0.23,0
34612,3639,1000.00,1000.00,2000.00,0.00,694.43,0.39,1
34613,3639,1000.00,2000.00,3000.00,0.00,2000.00,0.25,1
34614,3639,1000.00,3000.00,4000.00,791.34,2208.66,0.33,1
34615,3639,1000.00,4000.00,5000.00,252.57,1577.19,0.26,1
34616,3639,1000.00,5000.00,6000.00,2500.00,2500.00,0.02,1
34617,3639,1000.00,6000.00,7000.00,0.00,6000.00,0.21,1
34618,3639,1000.00,7000.00,8000.00,905.98,6094.02,0.41,1
34619,3639,1000.00,8000.00,9000.00,0.00,5473.59,0.32,1
34620,3639,-1000.00,7000.00,8000.00,8807.96,0.00,0.03,0
34621,3639,1000.00,8000.00,9000.00,157.11,5823.67,0.40,1
34622,3639,1000.00,9000.00,10000.00,4500.00,4500.00,0.08,1
34623,3639,1000.00,10000.00,11000.00,1927.75,8072.25,0.41,1
34624,3639,1000.00,11000.00,12000.00,0.00,11000.00,0.42,1
34625,3639,1000.00,12000.00,13000.00,0.00,12000.00,0.14,1
34626,3639,1000.00,13000.00,14000.00,0.00,13000.00,0.36,1
34627,3639,1000.00,14000.00,15000.00,4504.28,9495.72,0.34,1
34628,3639,1000.00,15000.00,16000.00,0.00,3473.69,0.05,1
34629,3639,1000.00,16000.00,17000.00,8000.00,8000.00,0.27,1
34630,3639,1000.00,17000.00,18000.00,2362.15,14637.85,0.31,1
34631,3639,-1000.00,16000.00,17000.00,6544.75,11455.25,0.30,0
34632,3639,-1000.00,15000.00,16000.00,0.00,17000.00,0.05,0
34633,3639,-1000.00,14000.00,15000.00,3252.92,12747.08,0.41,0
34634,3639,-1000.00,13000.00,14000.00,9443.40,5556.60,0.01,0
34635,3639,-1000.00,12000.00,13000.00,5845.13,8154.87,0.04,0
34636,3639,-1000.00,11000.00,12000.00,0.00,13000.00,0.40,0
34637,3639,-1000.00,10000.00,11000.00,1394.08,6090.45,0.20,0
34638,3639,-1000.00,9000.00,10000.00,5500.00,5500.00,0.04,0
34639,3639,-1000.00,8000.00,9000.00,0.00,10000.00,0.16,0
34640,3639,-1000.00,7000.00,8000.00,0.00,9000.00,0.12,0
34641,3639,-1000.00,6000.00,7000.00,4563.66,3436.34,0.17,0
34642,3639,-1000.00,5000.00,6000.00,46.73,6953.27,0.44,0
34643,3639,-1000.00,4000.00,5000.00,3048.94,2951.06,0.00,0
34644,3639,-1000.00,3000.00,4000.00,0.00,5000.00,0.23,0
34645,3639,-1000.00,2000.00,3000.00,0.00,3001.92,0.32,0
34646,3639,-1000.00,1000.00,2000.00,1278.87,1721.13,0.20,0
34647,3639,-1000.00,0.00,1000.00,0.00,1873.41,0.05,0
34648,3639,-1000.00,-1000.00,0.00,471.07,528.93,0.18,0
34649,3640,1000.00,1000.00,2000.00,0.00,561.78,0.03,1
34650,3640,1000.00,2000.00,3000.00,0.00,1219.87,0.20,1
34651,3640,1000.00,3000.00,4000.00,1281.21,1718.79,0.10,1
34652,3640,1000.00,4000.00,5000.00,1775.69,2224.31,0.10,1
34653,3640,1000.00,5000.00,6000.00,0.00,5000.00,0.22,1
34654,3640,1000.00,6000.00,7000.00,0.00,6000.00,0.00,1
34655,3640,1000.00,7000.00,8000.00,0.00,7000.00,0.33,1
34656,3640,1000.00,8000.00,9000.00,2683.62,5316.38,0.32,1
34657,3640,1000.00,9000.00,10000.00,0.00,6833.81,0.40,1
34658,3640,1000.00,10000.00,11000.00,1774.99,8225.01,0.31,1
34659,3640,-1000.00,9000.00,10000.00,7541.71,3458.29,0.02,0
34660,3640,1000.00,10000.00,11000.00,0.00,10000.00,0.43,1
34661,3640,1000.00,11000.00,12000.00,5486.58,5513.42,0.11,1
34662,3640,1000.00,12000.00,13000.00,0.00,6923.04,0.06,1
34663,3640,1000.00,13000.00,14000.00,0.00,8686.58,0.01,1
34664,3640,1000.00,14000.00,15000.00,885.67,1488.36,0.15,1
34665,3640,1000.00,15000.00,16000.00,0.00,15000.00,0.07,1
34666,3640,1000.00,16000.00,17000.00,0.00,16000.00,0.13,1
34667,3640,1000.00,17000.00,18000.00,0.00,17000.00,0.30,1
34668,3640,1000.00,18000.00,19000.00,1769.49,16230.51,0.43,1
34669,3640,-1000.00,17000.00,18000.00,10956.82,8043.18,0.08,0
34670,3640,1000.00,18000.00,19000.00,5212.20,12787.80,0.24,1
34671,3640,1000.00,19000.00,20000.00,2591.97,16408.03,0.42,1
34672,3640,1000.00,20000.00,21000.00,0.00,20000.00,0.23,1
34673,3640,-1000.00,19000.00,20000.00,10500.00,10500.00,0.09,0
34674,3640,-1000.00,18000.00,19000.00,0.00,20000.00,0.21,0
34675,3640,-1000.00,17000.00,18000.00,6734.08,12265.92,0.35,0
34676,3640,-1000.00,16000.00,17000.00,0.00,12308.16,0.36,0
34677,3640,-1000.00,15000.00,16000.00,0.00,16101.14,0.17,0
34678,3640,-1000.00,14000.00,15000.00,352.27,5974.17,0.26,0
34679,3640,-1000.00,13000.00,14000.00,2244.80,10430.69,0.38,0
34680,3640,-1000.00,12000.00,13000.00,1785.94,12214.06,0.43,0
34681,3640,-1000.00,11000.00,12000.00,4684.89,8315.11,0.22,0
34682,3640,-1000.00,10000.00,11000.00,3354.45,8645.55,0.38,0
34683,3640,-1000.00,9000.00,10000.00,3201.26,872.48,0.12,0
34684,3640,-1000.00,8000.00,9000.00,4345.26,5654.74,0.14,0
34685,3640,-1000.00,7000.00,8000.00,0.00,7828.95,0.41,0
34686,3640,-1000.00,6000.00,7000.00,3180.34,0.00,0.13,0
34687,3640,-1000.00,5000.00,6000.00,0.00,7000.00,0.15,0
34688,3640,-1000.00,4000.00,5000.00,0.00,6000.00,0.02,0
34689,3640,-1000.00,3000.00,4000.00,0.00,5000.00,0.25,0
34690,3640,-1000.00,2000.00,3000.00,1976.24,2023.76,0.12,0
34691,3640,-1000.00,1000.00,2000.00,1287.60,1712.40,0.27,0
34692,3640,-1000.00,0.00,1000.00,1462.57,537.43,0.09,0
34693,3640,-1000.00,-1000.00,0.00,392.98,607.02,0.07,0
34694,3641,-504.84,-504.84,495.16,504.84,0.00,0.19,0
34695,3641,-350.03,-854.87,145.13,264.81,85.22,0.30,0
34696,3641,-145.13,-1000.00,0.00,94.28,50.85,0.13,0
34697,3642,-1000.00,-1000.00,0.00,403.48,596.52,0.28,0
34698,3643,-1000.00,-1000.00,0.00,343.19,656.81,0.17,0
34699,3644,-1000.00,-1000.00,0.00,0.00,80.54,0.26,0
34700,3645,-595.25,-595.25,404.75,0.00,595.25,0.33,0
34701,3645,-404.75,-1000.00,0.00,0.00,404.75,0.25,0
34702,3646,1000.00,1000.00,2000.00,386.44,280.03,0.36,1
34703,3646,-717.19,282.81,1282.81,0.00,717.19,0.38,0
34704,3646,-183.35,99.46,1099.46,0.00,183.35,0.39,0
34705,3646,1000.00,1099.46,2099.46,400.43,0.00,0.04,1
34706,3646,-1000.00,99.46,1099.46,1049.73,1049.73,0.07,0
34707,3646,-567.18,-467.72,532.28,0.00,567.18,0.35,0
34708,3646,1000.00,532.28,1532.28,42.34,0.00,0.06,1
34709,3646,-391.71,140.57,1140.57,0.00,391.71,0.29,0
34710,3646,-1000.00,-859.43,140.57,0.00,1140.57,0.16,0
34711,3646,-41.48,-900.91,99.09,0.00,41.48,0.16,0
34712,3646,-63.84,-964.74,35.26,0.00,63.84,0.42,0
34713,3646,-3.62,-968.36,31.64,0.00,3.62,0.32,0
34714,3646,-5.35,-973.70,26.30,0.00,5.35,0.42,0
34715,3646,-26.30,-1000.00,0.00,0.00,26.30,0.24,0
34716,3647,1000.00,1000.00,2000.00,0.00,138.31,0.08,1
34717,3647,-1000.00,0.00,1000.00,1128.38,504.55,0.13,0
34718,3647,1000.00,1000.00,2000.00,0.00,277.98,0.14,1
34719,3647,1000.00,2000.00,3000.00,436.55,1563.45,0.39,1
34720,3647,1000.00,3000.00,4000.00,297.97,2702.03,0.43,1
34721,3647,1000.00,4000.00,5000.00,1627.32,2372.68,0.04,1
34722,3647,1000.00,5000.00,6000.00,0.00,3422.26,0.19,1
34723,3647,1000.00,6000.00,7000.00,2864.57,3135.43,0.14,1
34724,3647,1000.00,7000.00,8000.00,1815.80,5184.20,0.11,1
34725,3647,1000.00,8000.00,9000.00,36.14,7963.86,0.41,1
34726,3647,1000.00,9000.00,10000.00,0.00,4683.56,0.16,1
34727,3647,0.00,9000.00,10000.00,0.00,0.00,0.00,0
34728,3647,0.00,9000.00,10000.00,0.00,0.00,0.01,0
34729,3647,1000.00,10000.00,11000.00,1886.59,8113.41,0.41,1
34730,3647,-1000.00,9000.00,10000.00,6909.38,0.00,0.06,0
34731,3647,-1000.00,8000.00,9000.00,10000.00,0.00,0.01,0
34732,3647,1000.00,9000.00,10000.00,3851.77,5148.23,0.17,1
34733,3647,1000.00,10000.00,11000.00,0.00,10000.00,0.25,1
34734,3647,1000.00,11000.00,12000.00,656.25,4227.64,0.26,1
34735,3647,1000.00,12000.00,13000.00,4343.69,7656.31,0.31,1
34736,3647,1000.00,13000.00,14000.00,0.00,13000.00,0.25,1
34737,3647,1000.00,14000.00,15000.00,0.00,4128.42,0.21,1
34738,3647,1000.00,15000.00,16000.00,7500.00,7500.00,0.14,1
34739,3647,1000.00,16000.00,17000.00,313.48,3079.40,0.18,1
34740,3647,1000.00,17000.00,18000.00,8500.00,8500.00,0.04,1
34741,3647,1000.00,18000.00,19000.00,0.00,18000.00,0.07,1
34742,3647,-1000.00,17000.00,18000.00,13670.84,0.00,0.01,0
34743,3647,1000.00,18000.00,19000.00,7930.28,10069.72,0.11,1
34744,3647,1000.00,19000.00,20000.00,0.00,12605.72,0.38,1
34745,3647,1000.00,20000.00,21000.00,1608.84,18391.16,0.26,1
34746,3647,1000.00,21000.00,22000.00,2137.88,18862.12,0.34,1
34747,3647,1000.00,22000.00,23000.00,255.65,21744.35,0.41,1
34748,3647,-1000.00,21000.00,22000.00,11892.97,11107.03,0.10,0
34749,3647,1000.00,22000.00,23000.00,0.00,3501.28,0.07,1
34750,3647,1000.00,23000.00,24000.00,0.00,23000.00,0.12,1
34751,3647,1000.00,24000.00,25000.00,12000.00,12000.00,0.04,1
34752,3647,1000.00,25000.00,26000.00,720.13,24279.87,0.44,1
34753,3647,-1000.00,24000.00,25000.00,1612.78,1238.96,0.12,0
34754,3647,1000.00,25000.00,26000.00,2564.83,22435.17,0.37,1
34755,3647,1000.00,26000.00,27000.00,13000.00,13000.00,0.01,1
34756,3647,-1000.00,25000.00,26000.00,9780.67,7276.05,0.18,0
34757,3648,-639.64,-639.64,360.36,0.00,639.64,0.22,0
34758,3648,-360.36,-1000.00,0.00,112.67,247.69,0.06,0
34759,3649,1000.00,1000.00,2000.00,230.79,769.21,0.08,1
34760,3649,1000.00,2000.00,3000.00,1000.00,1000.00,0.08,1
34761,3649,1000.00,3000.00,4000.00,0.00,1622.24,0.25,1
34762,3649,-1000.00,2000.00,3000.00,1573.32,0.00,0.09,0
34763,3649,1000.00,3000.00,4000.00,404.14,2595.86,0.40,1
34764,3649,1000.00,4000.00,5000.00,2000.00,2000.00,0.28,1
34765,3649,1000.00,5000.00,6000.00,0.00,3419.06,0.38,1
34766,3649,1000.00,6000.00,7000.00,0.00,6000.00,0.03,1
34767,3649,1000.00,7000.00,8000.00,0.00,7000.00,0.08,1
34768,3649,1000.00,8000.00,9000.00,0.00,8000.00,0.12,1
34769,3649,1000.00,9000.00,10000.00,4500.00,4500.00,0.03,1
34770,3649,-1000.00,8000.00,9000.00,5101.17,4898.83,0.43,0
34771,3649,1000.00,9000.00,10000.00,0.00,9000.00,0.03,1
34772,3649,1000.00,10000.00,11000.00,0.00,10000.00,0.30,1
34773,3649,1000.00,11000.00,12000.00,3753.47,7246.53,0.25,1
34774,3649,1000.00,12000.00,13000.00,3262.68,8737.32,0.31,1
34775,3649,1000.00,13000.00,14000.00,6500.00,6500.00,0.09,1
34776,3649,1000.00,14000.00,15000.00,384.10,5783.07,0.27,1
34777,3649,1000.00,15000.00,16000.00,0.00,15000.00,0.10,1
34778,3649,1000.00,16000.00,17000.00,8000.00,8000.00,0.21,1
34779,3649,1000.00,17000.00,18000.00,3637.73,13362.27,0.40,1
34780,3649,1000.00,18000.00,19000.00,0.00,18000.00,0.00,1
34781,3649,1000.00,19000.00,20000.00,0.00,9393.99,0.28,1
34782,3649,1000.00,20000.00,21000.00,6477.37,13522.63,0.22,1
34783,3649,1000.00,21000.00,22000.00,0.00,17119.94,0.20,1
34784,3649,1000.00,22000.00,23000.00,10561.00,11439.00,0.21,1
34785,3649,1000.00,23000.00,24000.00,9309.47,13690.53,0.20,1
34786,3649,1000.00,24000.00,25000.00,6951.71,17048.29,0.36,1
34787,3649,1000.00,25000.00,26000.00,0.00,25000.00,0.24,1
34788,3649,-1000.00,24000.00,25000.00,13942.76,12057.24,0.33,0
34789,3649,1000.00,25000.00,26000.00,0.00,11098.17,0.22,1
34790,3649,1000.00,26000.00,27000.00,8237.25,17762.75,0.18,1
34791,3649,1000.00,27000.00,28000.00,0.00,23953.75,0.43,1
34792,3649,1000.00,28000.00,29000.00,0.00,26379.38,0.44,1
34793,3649,1000.00,29000.00,30000.00,0.00,28687.82,0.11,1
34794,3649,-1000.00,28000.00,29000.00,10392.28,0.00,0.09,0
34795,3649,1000.00,29000.00,30000.00,7983.74,21016.26,0.22,1
34796,3649,-1000.00,28000.00,29000.00,17281.26,1139.32,0.08,0
34797,3649,1000.00,29000.00,30000.00,0.00,29000.00,0.08,1
34798,3649,1000.00,30000.00,31000.00,0.00,23397.46,0.40,1
34799,3649,1000.00,31000.00,32000.00,0.00,31000.00,0.43,1
34800,3650,-1000.00,-1000.00,0.00,0.00,1000.00,0.11,0
34801,3651,1000.00,1000.00,2000.00,181.74,818.26,0.15,1
34802,3651,1000.00,2000.00,3000.00,675.81,1324.19,0.30,1
34803,3651,1000.00,3000.00,4000.00,0.00,2651.56,0.31,1
34804,3651,1000.00,4000.00,5000.00,0.00,2588.06,0.27,1
34805,3651,1000.00,5000.00,6000.00,0.00,5000.00,0.37,1
34806,3651,1000.00,6000.00,7000.00,0.00,6000.00,0.08,1
34807,3651,1000.00,7000.00,8000.00,1433.13,5566.87,0.18,1
34808,3651,-1000.00,6000.00,7000.00,7083.94,0.00,0.03,0
34809,3651,1000.00,7000.00,8000.00,0.00,7000.00,0.31,1
34810,3651,1000.00,8000.00,9000.00,4000.00,4000.00,0.03,1
34811,3651,1000.00,9000.00,10000.00,0.00,9000.00,0.40,1
34812,3651,1000.00,10000.00,11000.00,4733.84,5266.16,0.34,1
34813,3651,1000.00,11000.00,12000.00,4852.53,6147.47,0.20,1
34814,3651,1000.00,12000.00,13000.00,0.00,12000.00,0.07,1
34815,3651,1000.00,13000.00,14000.00,3238.75,9761.25,0.39,1
34816,3651,-1000.00,12000.00,13000.00,7134.15,6865.85,0.44,0
34817,3651,-1000.00,11000.00,12000.00,4655.58,8344.42,0.04,0
34818,3651,-1000.00,10000.00,11000.00,3166.44,2326.11,0.16,0
34819,3651,-1000.00,9000.00,10000.00,0.00,11000.00,0.12,0
34820,3651,-1000.00,8000.00,9000.00,0.00,10000.00,0.01,0
34821,3651,-1000.00,7000.00,8000.00,0.00,9000.00,0.35,0
34822,3651,0.00,7000.00,8000.00,0.00,0.00,0.01,0
34823,3651,0.00,7000.00,8000.00,0.00,0.00,0.05,0
34824,3651,-1000.00,6000.00,7000.00,0.00,8000.00,0.04,0
34825,3651,-1000.00,5000.00,6000.00,2618.08,4381.92,0.30,0
34826,3651,-1000.00,4000.00,5000.00,2032.33,3967.67,0.19,0
34827,3651,-1000.00,3000.00,4000.00,1775.92,3224.08,0.07,0
34828,3651,-1000.00,2000.00,3000.00,1370.92,2629.08,0.06,0
34829,3651,-1000.00,1000.00,2000.00,0.00,3000.00,0.33,0
34830,3651,-1000.00,0.00,1000.00,0.00,2000.00,0.27,0
34831,3651,-758.26,-758.26,241.74,0.00,758.26,0.41,0
34832,3651,-1000.00,-1758.26,-758.26,167.51,74.24,0.04,0
34833,3652,0.00,0.00,1000.00,0.00,0.00,0.05,0
34834,3652,-1000.00,-1000.00,0.00,104.47,812.26,0.24,0
34835,3653,-1000.00,-1000.00,0.00,234.60,765.40,0.31,0
34836,3654,-1000.00,-1000.00,0.00,0.00,1000.00,0.19,0
34837,3655,-1000.00,-1000.00,0.00,0.00,1000.00,0.40,0
34838,3656,1000.00,1000.00,2000.00,0.00,1000.00,0.27,1
34839,3656,1000.00,2000.00,3000.00,895.03,1104.97,0.25,1
34840,3656,-1000.00,1000.00,2000.00,1968.18,1031.82,0.01,0
34841,3656,1000.00,2000.00,3000.00,649.69,1350.31,0.29,1
34842,3656,1000.00,3000.00,4000.00,0.00,1897.52,0.23,1
34843,3656,1000.00,4000.00,5000.00,1840.94,2159.06,0.07,1
34844,3656,1000.00,5000.00,6000.00,0.00,5000.00,0.36,1
34845,3656,1000.00,6000.00,7000.00,2399.01,3600.99,0.29,1
34846,3656,1000.00,7000.00,8000.00,0.00,6226.93,0.28,1
34847,3656,1000.00,8000.00,9000.00,1026.99,6973.01,0.42,1
34848,3656,1000.00,9000.00,10000.00,2127.74,6872.26,0.13,1
34849,3656,1000.00,10000.00,11000.00,0.00,10000.00,0.24,1
34850,3656,1000.00,11000.00,12000.00,3568.36,7431.64,0.34,1
34851,3656,1000.00,12000.00,13000.00,0.00,8051.34,0.38,1
34852,3656,0.00,12000.00,13000.00,0.00,0.00,0.02,0
34853,3656,1000.00,13000.00,14000.00,0.00,13000.00,0.20,1
34854,3656,1000.00,14000.00,15000.00,0.00,7617.46,0.06,1
34855,3656,1000.00,15000.00,16000.00,4526.77,10473.23,0.34,1
34856,3656,1000.00,16000.00,17000.00,4537.53,11462.47,0.36,1
34857,3656,1000.00,17000.00,18000.00,0.00,17000.00,0.03,1
34858,3656,1000.00,18000.00,19000.00,0.00,18000.00,0.08,1
34859,3656,1000.00,19000.00,20000.00,7599.38,11400.62,0.19,1
34860,3656,1000.00,20000.00,21000.00,0.00,17958.43,0.29,1
34861,3656,1000.00,21000.00,22000.00,2116.58,18883.42,0.41,1
34862,3656,1000.00,22000.00,23000.00,9270.86,12729.14,0.20,1
34863,3656,1000.00,23000.00,24000.00,1354.95,21645.05,0.44,1
34864,3656,1000.00,24000.00,25000.00,0.00,20668.27,0.41,1
34865,3656,1000.00,25000.00,26000.00,9635.84,9798.76,0.22,1
34866,3656,1000.00,26000.00,27000.00,0.00,17631.06,0.18,1
34867,3656,1000.00,27000.00,28000.00,2368.95,22699.99,0.42,1
34868,3656,1000.00,28000.00,29000.00,11333.50,16666.50,0.26,1
34869,3656,1000.00,29000.00,30000.00,4447.93,24552.07,0.22,1
34870,3656,1000.00,30000.00,31000.00,0.00,23571.12,0.41,1
34871,3656,1000.00,31000.00,32000.00,14624.39,16375.61,0.13,1
34872,3656,1000.00,32000.00,33000.00,9341.03,22658.97,0.25,1
34873,3656,1000.00,33000.00,34000.00,0.00,32084.84,0.44,1
34874,3656,1000.00,34000.00,35000.00,9529.84,24470.16,0.33,1
34875,3656,-1000.00,33000.00,34000.00,17527.28,17472.72,0.17,0
34876,3656,1000.00,34000.00,35000.00,0.00,34000.00,0.43,1
34877,3656,1000.00,35000.00,36000.00,0.00,34962.00,0.31,1
34878,3656,1000.00,36000.00,37000.00,10512.28,17307.69,0.27,1
34879,3656,1000.00,37000.00,38000.00,7173.58,29826.42,0.32,1
34880,3656,1000.00,38000.00,39000.00,0.00,38000.00,0.06,1
34881,3656,1000.00,39000.00,40000.00,0.00,35323.85,0.39,1
34882,3656,-1000.00,38000.00,39000.00,17278.44,22721.56,0.26,0
34883,3656,-1000.00,37000.00,38000.00,7619.80,31380.20,0.34,0
34884,3656,-1000.00,36000.00,37000.00,18291.77,19708.23,0.11,0
34885,3656,-1000.00,35000.00,36000.00,12808.62,24191.38,0.10,0
34886,3656,-1000.00,34000.00,35000.00,2376.31,33623.69,0.16,0
34887,3656,-1000.00,33000.00,34000.00,6672.60,28327.40,0.41,0
34888,3656,-1000.00,32000.00,33000.00,0.00,34000.00,0.23,0
34889,3656,-1000.00,31000.00,32000.00,0.00,33000.00,0.30,0
34890,3656,-1000.00,30000.00,31000.00,3681.76,28318.24,0.17,0
34891,3656,-1000.00,29000.00,30000.00,0.00,25762.18,0.42,0
34892,3656,-1000.00,28000.00,29000.00,10950.40,19049.60,0.25,0
34893,3656,-1000.00,27000.00,28000.00,13125.44,15874.56,0.16,0
34894,3656,-1000.00,26000.00,27000.00,3828.18,24171.82,0.30,0
34895,3656,-1000.00,25000.00,26000.00,0.00,27000.00,0.29,0
34896,3656,-1000.00,24000.00,25000.00,0.00,18743.64,0.17,0
34897,3656,-1000.00,23000.00,24000.00,0.00,25000.00,0.43,0
34898,3656,-1000.00,22000.00,23000.00,0.00,24000.00,0.15,0
34899,3656,-1000.00,21000.00,22000.00,3795.92,19204.08,0.42,0
34900,3656,-1000.00,20000.00,21000.00,0.00,22000.00,0.19,0
34901,3656,-1000.00,19000.00,20000.00,3988.17,17011.83,0.22,0
34902,3656,-1000.00,18000.00,19000.00,0.00,3284.79,0.13,0
34903,3656,-1000.00,17000.00,18000.00,19000.00,0.00,0.02,0
34904,3656,-1000.00,16000.00,17000.00,0.00,16591.31,0.42,0
34905,3656,-1000.00,15000.00,16000.00,1954.76,15045.24,0.37,0
34906,3657,-1000.00,-1000.00,0.00,417.86,582.14,0.27,0
34907,3658,-1000.00,-1000.00,0.00,236.24,763.76,0.37,0
34908,3659,-1000.00,-1000.00,0.00,0.00,1000.00,0.12,0
34909,3660,1000.00,1000.00,2000.00,0.00,325.51,0.23,1
34910,3660,1000.00,2000.00,3000.00,0.00,2000.00,0.34,1
34911,3660,1000.00,3000.00,4000.00,996.35,2003.65,0.33,1
34912,3660,1000.00,4000.00,5000.00,585.54,3414.46,0.28,1
34913,3660,1000.00,5000.00,6000.00,1685.54,3314.46,0.31,1
34914,3660,1000.00,6000.00,7000.00,724.30,5275.70,0.42,1
34915,3660,1000.00,7000.00,8000.00,0.00,3407.51,0.24,1
34916,3660,1000.00,8000.00,9000.00,0.00,2833.56,0.24,1
34917,3660,1000.00,9000.00,10000.00,0.00,9000.00,0.37,1
34918,3660,1000.00,10000.00,11000.00,0.00,8433.82,0.42,1
34919,3660,1000.00,11000.00,12000.00,2817.28,3543.92,0.21,1
34920,3660,1000.00,12000.00,13000.00,0.00,2289.95,0.18,1
34921,3660,1000.00,13000.00,14000.00,1156.43,11843.57,0.39,1
34922,3660,1000.00,14000.00,15000.00,5701.50,8298.50,0.18,1
34923,3660,1000.00,15000.00,16000.00,488.88,14511.12,0.43,1
34924,3660,1000.00,16000.00,17000.00,0.00,8156.07,0.31,1
34925,3660,1000.00,17000.00,18000.00,0.00,2983.90,0.09,1
34926,3660,1000.00,18000.00,19000.00,0.00,18000.00,0.37,1
34927,3660,1000.00,19000.00,20000.00,0.00,19000.00,0.18,1
34928,3660,1000.00,20000.00,21000.00,176.52,19823.48,0.43,1
34929,3660,1000.00,21000.00,22000.00,9384.56,11615.44,0.26,1
34930,3660,1000.00,22000.00,23000.00,0.00,20811.13,0.33,1
34931,3660,-1000.00,21000.00,22000.00,0.00,18905.71,0.07,0
34932,3660,-1000.00,20000.00,21000.00,1399.67,20600.33,0.38,0
34933,3660,-1000.00,19000.00,20000.00,0.00,21000.00,0.39,0
34934,3660,-1000.00,18000.00,19000.00,0.00,20000.00,0.09,0
34935,3660,-1000.00,17000.00,18000.00,2122.82,9208.88,0.30,0
34936,3660,-1000.00,16000.00,17000.00,4341.07,13658.93,0.07,0
34937,3660,0.00,16000.00,17000.00,0.00,0.00,0.02,0
34938,3660,-1000.00,15000.00,16000.00,0.00,5604.55,0.24,0
34939,3660,-1000.00,14000.00,15000.00,5276.64,8579.15,0.28,0
34940,3660,-1000.00,13000.00,14000.00,10949.57,0.00,0.04,0
34941,3660,-1000.00,12000.00,13000.00,0.00,13315.84,0.36,0
34942,3660,-1000.00,11000.00,12000.00,6500.00,6500.00,0.05,0
34943,3660,-1000.00,10000.00,11000.00,86.76,11913.24,0.37,0
34944,3660,-1000.00,9000.00,10000.00,3442.62,7557.38,0.22,0
34945,3660,-1000.00,8000.00,9000.00,3426.20,6573.80,0.30,0
34946,3660,-1000.00,7000.00,8000.00,3878.24,5121.76,0.17,0
34947,3660,-1000.00,6000.00,7000.00,0.00,8000.00,0.22,0
34948,3660,-1000.00,5000.00,6000.00,0.00,2255.90,0.23,0
34949,3660,-1000.00,4000.00,5000.00,778.08,5221.92,0.32,0
34950,3660,-1000.00,3000.00,4000.00,1441.35,3558.65,0.36,0
34951,3660,0.00,3000.00,4000.00,0.00,0.00,0.08,0
34952,3660,-1000.00,2000.00,3000.00,632.12,3367.88,0.42,0
34953,3660,-1000.00,1000.00,2000.00,924.70,2075.30,0.33,0
34954,3660,-1000.00,0.00,1000.00,0.00,2000.00,0.12,0
34955,3661,-696.02,-696.02,303.98,0.00,696.02,0.39,0
34956,3661,-303.98,-1000.00,0.00,0.00,303.98,0.42,0
34957,3662,-1000.00,-1000.00,0.00,0.00,1000.00,0.01,0
34958,3663,-717.27,-717.27,282.73,0.00,717.27,0.16,0
34959,3663,-1000.00,-1717.27,-717.27,27.46,7.81,0.12,0
34960,3664,-69.68,-69.68,930.32,69.68,0.00,0.02,0
34961,3664,1000.00,930.32,1930.32,23.00,907.32,0.44,1
34962,3664,1000.00,1930.32,2930.32,718.87,1211.46,0.30,1
34963,3664,1000.00,2930.32,3930.32,1014.39,1915.93,0.25,1
34964,3664,1000.00,3930.32,4930.32,196.69,3733.63,0.40,1
34965,3664,-1000.00,2930.32,3930.32,2503.28,2427.04,0.21,0
34966,3664,1000.00,3930.32,4930.32,0.00,3930.32,0.22,1
34967,3664,1000.00,4930.32,5930.32,0.00,4276.34,0.34,1
34968,3664,1000.00,5930.32,6930.32,2696.88,3233.44,0.15,1
34969,3664,1000.00,6930.32,7930.32,0.00,3306.73,0.28,1
34970,3664,1000.00,7930.32,8930.32,0.00,7930.32,0.01,1
34971,3664,1000.00,8930.32,9930.32,3855.79,5074.53,0.20,1
34972,3664,1000.00,9930.32,10930.32,0.00,3122.91,0.20,1
34973,3664,1000.00,10930.32,11930.32,3262.26,7668.07,0.34,1
34974,3664,1000.00,11930.32,12930.32,0.00,7980.49,0.08,1
34975,3664,1000.00,12930.32,13930.32,4552.32,8378.00,0.13,1
34976,3664,1000.00,13930.32,14930.32,0.00,13930.32,0.25,1
34977,3664,1000.00,14930.32,15930.32,0.00,6883.83,0.12,1
34978,3664,-1000.00,13930.32,14930.32,3403.84,10192.32,0.37,0
34979,3664,-1000.00,12930.32,13930.32,5754.31,8950.69,0.29,0
34980,3664,-1000.00,11930.32,12930.32,0.00,13930.32,0.28,0
34981,3664,-1000.00,10930.32,11930.32,3135.72,5052.38,0.24,0
34982,3664,-1000.00,9930.32,10930.32,5156.21,6774.11,0.24,0
34983,3664,-1000.00,8930.32,9930.32,4424.01,6506.31,0.25,0
34984,3664,-1000.00,7930.32,8930.32,2619.88,7310.44,0.35,0
34985,3664,-1000.00,6930.32,7930.32,0.00,4121.11,0.26,0
34986,3664,-1000.00,5930.32,6930.32,0.00,7486.47,0.13,0
34987,3664,-1000.00,4930.32,5930.32,0.00,6930.32,0.44,0
34988,3664,-1000.00,3930.32,4930.32,2279.49,3650.84,0.25,0
34989,3664,-1000.00,2930.32,3930.32,0.00,4879.11,0.15,0
34990,3664,-1000.00,1930.32,2930.32,1645.55,2284.77,0.17,0
34991,3664,-1000.00,930.32,1930.32,657.38,2272.94,0.39,0
34992,3664,-1000.00,-69.68,930.32,965.16,965.16,0.01,0
34993,3664,-612.37,-682.05,317.95,227.40,384.97,0.25,0
34994,3664,-317.95,-1000.00,0.00,133.35,184.61,0.25,0
34995,3665,-1000.00,-1000.00,0.00,0.00,1000.00,0.18,0
34996,3666,-1000.00,-1000.00,0.00,476.89,523.11,0.21,0
34997,3666,-0.00,-1000.00,0.00,0.00,0.00,0.20,0
34998,3667,1000.00,1000.00,2000.00,299.06,700.94,0.33,1
34999,3667,1000.00,2000.00,3000.00,221.85,1778.15,0.38,1
35000,3667,1000.00,3000.00,4000.00,399.16,2600.84,0.24,1
35001,3667,1000.00,4000.00,5000.00,1718.54,2281.46,0.19,1
35002,3667,1000.00,5000.00,6000.00,2029.35,2938.87,0.28,1
35003,3667,1000.00,6000.00,7000.00,0.00,3445.91,0.34,1
35004,3667,1000.00,7000.00,8000.00,0.00,7000.00,0.20,1
35005,3667,1000.00,8000.00,9000.00,0.00,5880.42,0.07,1
35006,3667,1000.00,9000.00,10000.00,0.00,812.29,0.06,1
35007,3667,1000.00,10000.00,11000.00,0.00,10000.00,0.38,1
35008,3667,1000.00,11000.00,12000.00,301.45,8619.32,0.41,1
35009,3667,1000.00,12000.00,13000.00,6000.00,6000.00,0.04,1
35010,3667,1000.00,13000.00,14000.00,0.00,13000.00,0.25,1
35011,3667,1000.00,14000.00,15000.00,0.00,14000.00,0.44,1
35012,3667,1000.00,15000.00,16000.00,0.00,15000.00,0.28,1
35013,3667,1000.00,16000.00,17000.00,0.00,6206.40,0.16,1
35014,3667,-1000.00,15000.00,16000.00,12029.33,4970.67,0.08,0
35015,3667,-1000.00,14000.00,15000.00,10748.68,5251.32,0.08,0
35016,3667,1000.00,15000.00,16000.00,2807.45,12192.55,0.41,1
35017,3667,1000.00,16000.00,17000.00,0.00,4427.38,0.21,1
35018,3667,1000.00,17000.00,18000.00,0.00,15532.15,0.23,1
35019,3667,1000.00,18000.00,19000.00,4630.38,13369.62,0.29,1
35020,3667,1000.00,19000.00,20000.00,2503.13,12673.18,0.37,1
35021,3667,1000.00,20000.00,21000.00,1036.31,18963.69,0.39,1
35022,3667,1000.00,21000.00,22000.00,3611.34,17388.66,0.34,1
35023,3667,1000.00,22000.00,23000.00,0.00,14787.42,0.37,1
35024,3667,1000.00,23000.00,24000.00,170.23,22829.77,0.43,1
35025,3667,1000.00,24000.00,25000.00,0.00,21890.84,0.30,1
35026,3667,1000.00,25000.00,26000.00,0.00,25000.00,0.43,1
35027,3667,1000.00,26000.00,27000.00,0.00,26000.00,0.18,1
35028,3667,1000.00,27000.00,28000.00,7773.37,19226.63,0.13,1
35029,3667,-1000.00,26000.00,27000.00,16782.98,11217.02,0.10,0
35030,3667,1000.00,27000.00,28000.00,0.00,27000.00,0.37,1
35031,3667,1000.00,28000.00,29000.00,0.00,6373.20,0.08,1
35032,3667,1000.00,29000.00,30000.00,0.00,29000.00,0.30,1
35033,3667,1000.00,30000.00,31000.00,0.00,30000.00,0.29,1
35034,3667,1000.00,31000.00,32000.00,0.00,15539.65,0.17,1
35035,3667,1000.00,32000.00,33000.00,0.00,2636.31,0.11,1
35036,3667,1000.00,33000.00,34000.00,16500.00,16500.00,0.04,1
35037,3667,-1000.00,32000.00,33000.00,17131.14,16868.86,0.19,0
35038,3667,1000.00,33000.00,34000.00,13882.50,19117.50,0.23,1
35039,3667,1000.00,34000.00,35000.00,15411.68,18588.32,0.10,1
35040,3667,1000.00,35000.00,36000.00,0.00,35000.00,0.13,1
35041,3667,1000.00,36000.00,37000.00,0.00,35713.96,0.44,1
35042,3667,1000.00,37000.00,38000.00,0.00,37000.00,0.09,1
35043,3667,1000.00,38000.00,39000.00,0.00,31553.20,0.37,1
35044,3667,1000.00,39000.00,40000.00,0.00,23500.69,0.32,1
35045,3667,-1000.00,38000.00,39000.00,17224.53,22775.47,0.13,0
35046,3667,-1000.00,37000.00,38000.00,0.00,39000.00,0.32,0
35047,3667,-1000.00,36000.00,37000.00,10589.05,27410.95,0.01,0
35048,3667,-1000.00,35000.00,36000.00,2610.66,0.00,0.09,0
35049,3667,-1000.00,34000.00,35000.00,27200.03,8799.97,0.09,0
35050,3667,-1000.00,33000.00,34000.00,14867.98,20132.02,0.24,0
35051,3667,-1000.00,32000.00,33000.00,0.00,34000.00,0.38,0
35052,3667,-1000.00,31000.00,32000.00,16989.25,11164.13,0.17,0
35053,3667,-1000.00,30000.00,31000.00,0.00,32000.00,0.43,0
35054,3667,-1000.00,29000.00,30000.00,0.00,16566.84,0.21,0
35055,3667,-1000.00,28000.00,29000.00,10567.88,19432.12,0.32,0
35056,3667,-1000.00,27000.00,28000.00,0.00,29000.00,0.33,0
35057,3667,-1000.00,26000.00,27000.00,668.01,24187.08,0.43,0
35058,3667,-1000.00,25000.00,26000.00,0.00,27000.00,0.30,0
35059,3667,-1000.00,24000.00,25000.00,0.00,15537.95,0.30,0
35060,3667,-1000.00,23000.00,24000.00,0.00,25000.00,0.20,0
35061,3667,-1000.00,22000.00,23000.00,0.00,24000.00,0.05,0
35062,3667,-1000.00,21000.00,22000.00,0.00,23000.00,0.35,0
35063,3667,-1000.00,20000.00,21000.00,0.00,22000.00,0.39,0
35064,3667,-1000.00,19000.00,20000.00,7426.36,13573.64,0.17,0
35065,3668,-1000.00,-1000.00,0.00,585.02,414.98,0.07,0
35066,3669,-1000.00,-1000.00,0.00,0.00,1000.00,0.03,0
35067,3670,-1000.00,-1000.00,0.00,0.00,1000.00,0.14,0
35068,3671,-681.04,-681.04,318.96,350.08,330.97,0.28,0
35069,3671,-1000.00,-1681.04,-681.04,0.00,45.07,0.18,0
35070,3672,-1000.00,-1000.00,0.00,19.29,947.30,0.44,0
35071,3673,1000.00,1000.00,2000.00,0.00,1000.00,0.27,1
35072,3673,-1000.00,0.00,1000.00,1107.79,892.21,0.07,0
35073,3673,1000.00,1000.00,2000.00,0.00,1000.00,0.22,1
35074,3673,1000.00,2000.00,3000.00,0.00,2000.00,0.18,1
35075,3673,-1000.00,1000.00,2000.00,970.27,161.21,0.11,0
35076,3673,-1000.00,0.00,1000.00,1679.27,187.86,0.05,0
35077,3673,1000.00,1000.00,2000.00,455.15,528.95,0.24,1
35078,3673,1000.00,2000.00,3000.00,1000.00,1000.00,0.03,1
35079,3673,-1000.00,1000.00,2000.00,2199.35,800.65,0.06,0
35080,3673,1000.00,2000.00,3000.00,0.00,1244.84,0.22,1
35081,3673,1000.00,3000.00,4000.00,1454.36,1545.64,0.07,1
35082,3673,1000.00,4000.00,5000.00,44.66,3955.34,0.44,1
35083,3673,1000.00,5000.00,6000.00,540.98,3290.87,0.37,1
35084,3673,1000.00,6000.00,7000.00,0.00,4016.49,0.33,1
35085,3673,-1000.00,5000.00,6000.00,2250.14,1495.12,0.16,0
35086,3673,1000.00,6000.00,7000.00,535.69,1384.12,0.19,1
35087,3673,1000.00,7000.00,8000.00,691.96,6308.04,0.41,1
35088,3673,1000.00,8000.00,9000.00,3094.92,4545.18,0.28,1
35089,3673,1000.00,9000.00,10000.00,0.00,9000.00,0.23,1
35090,3673,1000.00,10000.00,11000.00,0.00,10000.00,0.38,1
35091,3673,1000.00,11000.00,12000.00,0.00,11000.00,0.21,1
35092,3673,1000.00,12000.00,13000.00,4649.18,7350.82,0.21,1
35093,3673,1000.00,13000.00,14000.00,0.00,13000.00,0.24,1
35094,3673,1000.00,14000.00,15000.00,0.00,14000.00,0.03,1
35095,3673,1000.00,15000.00,16000.00,3458.37,11541.63,0.38,1
35096,3673,1000.00,16000.00,17000.00,2733.60,13266.40,0.40,1
35097,3673,1000.00,17000.00,18000.00,5528.59,11471.41,0.31,1
35098,3673,1000.00,18000.00,19000.00,0.00,18000.00,0.10,1
35099,3673,1000.00,19000.00,20000.00,3690.06,15309.94,0.37,1
35100,3673,1000.00,20000.00,21000.00,5647.27,14352.73,0.18,1
35101,3673,1000.00,21000.00,22000.00,34.77,12439.01,0.35,1
35102,3673,1000.00,22000.00,23000.00,0.00,19253.85,0.22,1
35103,3673,1000.00,23000.00,24000.00,0.00,1262.67,0.06,1
35104,3673,1000.00,24000.00,25000.00,0.00,20143.33,0.43,1
35105,3673,1000.00,25000.00,26000.00,12125.13,12874.87,0.08,1
35106,3673,0.00,25000.00,26000.00,0.00,0.00,0.06,0
35107,3673,1000.00,26000.00,27000.00,0.00,26000.00,0.04,1
35108,3673,1000.00,27000.00,28000.00,1950.38,14706.81,0.33,1
35109,3673,1000.00,28000.00,29000.00,4898.44,23101.56,0.42,1
35110,3673,1000.00,29000.00,30000.00,0.00,29000.00,0.25,1
35111,3673,1000.00,30000.00,31000.00,0.00,9801.69,0.21,1
35112,3673,1000.00,31000.00,32000.00,0.00,29223.36,0.24,1
35113,3673,1000.00,32000.00,33000.00,0.00,19234.99,0.35,1
35114,3673,1000.00,33000.00,34000.00,0.00,14242.84,0.22,1
35115,3673,1000.00,34000.00,35000.00,1696.90,32303.10,0.22,1
35116,3673,1000.00,35000.00,36000.00,0.00,35000.00,0.21,1
35117,3673,1000.00,36000.00,37000.00,0.00,36000.00,0.31,1
35118,3673,-1000.00,35000.00,36000.00,28583.01,8416.99,0.06,0
35119,3673,-1000.00,34000.00,35000.00,24250.53,11749.47,0.05,0
35120,3673,-1000.00,33000.00,34000.00,20392.00,14608.00,0.12,0
35121,3673,1000.00,34000.00,35000.00,4907.95,29092.05,0.41,1
35122,3673,1000.00,35000.00,36000.00,0.00,33234.63,0.02,1
35123,3673,1000.00,36000.00,37000.00,591.73,30810.20,0.43,1
35124,3673,1000.00,37000.00,38000.00,18500.00,18500.00,0.03,1
35125,3673,1000.00,38000.00,39000.00,4498.31,29372.25,0.40,1
35126,3673,1000.00,39000.00,40000.00,5215.42,33784.58,0.43,1
35127,3673,1000.00,40000.00,41000.00,0.00,26339.76,0.28,1
35128,3673,1000.00,41000.00,42000.00,5155.15,35844.85,0.36,1
35129,3673,1000.00,42000.00,43000.00,13812.24,28187.76,0.16,1
35130,3673,1000.00,43000.00,44000.00,0.00,43000.00,0.43,1
35131,3673,1000.00,44000.00,45000.00,12800.78,31199.22,0.31,1
35132,3673,1000.00,45000.00,46000.00,0.00,45000.00,0.36,1
35133,3673,1000.00,46000.00,47000.00,1927.05,29941.73,0.37,1
35134,3673,1000.00,47000.00,48000.00,0.00,47000.00,0.36,1
35135,3673,1000.00,48000.00,49000.00,19997.29,28002.71,0.23,1
35136,3673,1000.00,49000.00,50000.00,13656.61,35343.39,0.36,1
35137,3673,1000.00,50000.00,51000.00,0.00,26583.08,0.17,1
35138,3673,1000.00,51000.00,52000.00,0.00,51000.00,0.27,1
35139,3673,1000.00,52000.00,53000.00,0.00,52000.00,0.08,1
35140,3674,-1000.00,-1000.00,0.00,0.00,1000.00,0.02,0
35141,3675,-954.64,-954.64,45.36,0.00,954.64,0.39,0
35142,3675,-45.36,-1000.00,0.00,0.00,45.36,0.02,0
35143,3676,-131.09,-131.09,868.91,0.00,131.09,0.10,0
35144,3676,-868.91,-1000.00,0.00,36.79,832.12,0.19,0
35145,3677,-1000.00,-1000.00,0.00,299.54,700.46,0.35,0
35146,3678,1000.00,1000.00,2000.00,215.93,784.07,0.38,1
35147,3678,1000.00,2000.00,3000.00,741.06,1258.94,0.09,1
35148,3678,1000.00,3000.00,4000.00,401.20,2598.80,0.43,1
35149,3678,1000.00,4000.00,5000.00,0.00,4000.00,0.35,1
35150,3678,1000.00,5000.00,6000.00,195.09,2072.13,0.27,1
35151,3678,1000.00,6000.00,7000.00,1705.69,4294.31,0.34,1
35152,3678,1000.00,7000.00,8000.00,0.00,7000.00,0.26,1
35153,3678,1000.00,8000.00,9000.00,519.85,7480.15,0.28,1
35154,3678,1000.00,9000.00,10000.00,4101.19,4898.81,0.21,1
35155,3678,-1000.00,8000.00,9000.00,5570.29,4429.71,0.08,0
35156,3678,1000.00,9000.00,10000.00,3614.28,5385.72,0.03,1
35157,3678,1000.00,10000.00,11000.00,3021.58,6978.42,0.34,1
35158,3678,1000.00,11000.00,12000.00,0.00,5497.52,0.19,1
35159,3678,1000.00,12000.00,13000.00,0.00,5461.65,0.29,1
35160,3678,-1000.00,11000.00,12000.00,7342.28,5657.72,0.14,0
35161,3678,1000.00,12000.00,13000.00,0.00,12000.00,0.19,1
35162,3678,1000.00,13000.00,14000.00,0.00,9044.95,0.35,1
35163,3678,1000.00,14000.00,15000.00,6079.42,7920.58,0.26,1
35164,3678,1000.00,15000.00,16000.00,0.00,3409.95,0.13,1
35165,3678,1000.00,16000.00,17000.00,8000.00,8000.00,0.17,1
35166,3678,1000.00,17000.00,18000.00,8500.00,8500.00,0.16,1
35167,3678,-1000.00,16000.00,17000.00,0.00,18000.00,0.28,0
35168,3678,-1000.00,15000.00,16000.00,2072.42,14927.58,0.20,0
35169,3678,-1000.00,14000.00,15000.00,0.00,14726.42,0.44,0
35170,3678,-1000.00,13000.00,14000.00,5933.05,9066.95,0.16,0
35171,3678,-1000.00,12000.00,13000.00,6409.66,7590.34,0.17,0
35172,3678,-1000.00,11000.00,12000.00,0.00,7879.49,0.10,0
35173,3678,-1000.00,10000.00,11000.00,6440.08,5559.92,0.15,0
35174,3678,-1000.00,9000.00,10000.00,3311.02,7688.98,0.35,0
35175,3678,-1000.00,8000.00,9000.00,5000.00,5000.00,0.05,0
35176,3678,-1000.00,7000.00,8000.00,0.00,9000.00,0.04,0
35177,3678,-1000.00,6000.00,7000.00,3570.94,4429.06,0.15,0
35178,3678,-1000.00,5000.00,6000.00,0.00,7000.00,0.41,0
35179,3678,-1000.00,4000.00,5000.00,0.00,6000.00,0.05,0
35180,3678,-1000.00,3000.00,4000.00,2500.00,2500.00,0.04,0
35181,3678,-1000.00,2000.00,3000.00,0.00,4000.00,0.42,0
35182,3678,-1000.00,1000.00,2000.00,0.00,1986.64,0.05,0
35183,3678,-1000.00,0.00,1000.00,0.00,2000.00,0.07,0
35184,3678,-1000.00,-1000.00,0.00,124.50,875.50,0.16,0
35185,3678,-0.00,-1000.00,0.00,0.00,0.00,0.22,0
35186,3679,-1000.00,-1000.00,0.00,171.02,828.98,0.38,0
35187,3680,-1000.00,-1000.00,0.00,500.00,500.00,0.03,0
35188,3681,-1000.00,-1000.00,0.00,440.55,559.45,0.17,0
35189,3682,0.00,0.00,1000.00,0.00,1000.00,0.05,0
35190,3682,0.00,0.00,1000.00,0.00,650.46,0.18,0
35191,3682,0.00,0.00,1000.00,0.00,1000.00,0.27,0
35192,3682,0.00,0.00,1000.00,0.00,1000.00,0.22,0
35193,3682,0.00,0.00,1000.00,0.00,407.82,0.26,0
35194,3682,0.00,0.00,1000.00,285.55,714.45,0.32,0
35195,3682,0.00,0.00,1000.00,0.00,0.00,0.08,0
35196,3682,0.00,0.00,1000.00,60.13,464.37,0.30,0
35197,3682,0.00,0.00,1000.00,0.00,1000.00,0.28,0
35198,3682,0.00,0.00,1000.00,268.52,731.48,0.35,0
35199,3682,0.00,0.00,1000.00,0.00,1000.00,0.22,0
35200,3682,0.00,0.00,1000.00,0.00,1000.00,0.19,0
35201,3682,0.00,0.00,1000.00,446.93,553.07,0.15,0
35202,3682,0.00,0.00,1000.00,0.00,1000.00,0.13,0
35203,3682,0.00,0.00,1000.00,0.00,509.20,0.26,0
35204,3682,0.00,0.00,1000.00,0.00,1000.00,0.19,0
35205,3682,0.00,0.00,1000.00,121.47,878.53,0.15,0
35206,3682,0.00,0.00,1000.00,0.00,637.91,0.27,0
35207,3682,0.00,0.00,1000.00,336.30,663.70,0.25,0
35208,3682,0.00,0.00,1000.00,40.40,959.60,0.43,0
35209,3682,0.00,0.00,1000.00,0.00,1000.00,0.32,0
35210,3682,-1000.00,-1000.00,0.00,520.21,479.79,0.05,0
35211,3683,-1000.00,-1000.00,0.00,445.27,554.73,0.24,0
35212,3684,-1000.00,-1000.00,0.00,0.00,706.71,0.36,0
35213,3685,-1000.00,-1000.00,0.00,381.10,618.90,0.30,0
35214,3686,1000.00,1000.00,2000.00,155.65,0.00,0.10,1
35215,3686,-1000.00,0.00,1000.00,0.00,1122.82,0.35,0
35216,3686,0.00,0.00,1000.00,0.00,0.00,0.03,0
35217,3686,-1000.00,-1000.00,0.00,481.62,518.38,0.11,0
35218,3687,-1000.00,-1000.00,0.00,266.16,733.84,0.37,0
35219,3688,1000.00,1000.00,2000.00,0.00,973.61,0.20,1
35220,3688,1000.00,2000.00,3000.00,0.00,1524.63,0.09,1
35221,3688,1000.00,3000.00,4000.00,0.00,2439.87,0.04,1
35222,3688,1000.00,4000.00,5000.00,0.00,3165.74,0.41,1
35223,3688,1000.00,5000.00,6000.00,1626.24,3373.76,0.34,1
35224,3688,1000.00,6000.00,7000.00,0.00,6000.00,0.44,1
35225,3688,1000.00,7000.00,8000.00,3287.67,3712.33,0.20,1
35226,3688,1000.00,8000.00,9000.00,0.00,6586.80,0.22,1
35227,3688,1000.00,9000.00,10000.00,2247.80,6752.20,0.32,1
35228,3688,1000.00,10000.00,11000.00,3191.68,6808.32,0.34,1
35229,3688,1000.00,11000.00,12000.00,0.00,5708.30,0.24,1
35230,3688,1000.00,12000.00,13000.00,0.00,4509.54,0.22,1
35231,3688,1000.00,13000.00,14000.00,0.00,8058.10,0.18,1
35232,3688,1000.00,14000.00,15000.00,0.00,14000.00,0.22,1
35233,3688,1000.00,15000.00,16000.00,0.00,15000.00,0.23,1
35234,3688,1000.00,16000.00,17000.00,0.00,16000.00,0.40,1
35235,3688,1000.00,17000.00,18000.00,8500.00,8500.00,0.04,1
35236,3688,-1000.00,16000.00,17000.00,6040.33,565.34,0.10,0
35237,3688,1000.00,17000.00,18000.00,7861.56,9138.44,0.22,1
35238,3688,1000.00,18000.00,19000.00,2955.43,9873.35,0.32,1
35239,3688,1000.00,19000.00,20000.00,0.00,19000.00,0.24,1
35240,3688,1000.00,20000.00,21000.00,4138.77,15861.23,0.40,1
35241,3688,1000.00,21000.00,22000.00,0.00,20229.88,0.44,1
35242,3688,1000.00,22000.00,23000.00,11000.00,11000.00,0.06,1
35243,3688,1000.00,23000.00,24000.00,0.00,2285.38,0.00,1
35244,3688,1000.00,24000.00,25000.00,12000.00,12000.00,0.01,1
35245,3688,-1000.00,23000.00,24000.00,16346.88,8653.12,0.03,0
35246,3688,1000.00,24000.00,25000.00,494.74,15680.73,0.37,1
35247,3688,1000.00,25000.00,26000.00,11666.53,13333.47,0.19,1
35248,3688,1000.00,26000.00,27000.00,4623.38,21376.62,0.31,1
35249,3688,1000.00,27000.00,28000.00,0.00,27000.00,0.07,1
35250,3688,1000.00,28000.00,29000.00,0.00,15505.42,0.22,1
35251,3688,1000.00,29000.00,30000.00,13661.61,15338.39,0.12,1
35252,3688,1000.00,30000.00,31000.00,0.00,5965.25,0.13,1
35253,3688,1000.00,31000.00,32000.00,0.00,19127.24,0.18,1
35254,3688,1000.00,32000.00,33000.00,0.00,32000.00,0.28,1
35255,3688,-1000.00,31000.00,32000.00,24481.42,6094.04,0.08,0
35256,3688,-1000.00,30000.00,31000.00,2473.95,0.00,0.10,0
35257,3688,1000.00,31000.00,32000.00,0.00,24604.00,0.41,1
35258,3688,-1000.00,30000.00,31000.00,21404.87,10595.13,0.07,0
35259,3688,1000.00,31000.00,32000.00,34.82,30965.18,0.33,1
35260,3688,1000.00,32000.00,33000.00,6613.50,25386.50,0.31,1
35261,3688,1000.00,33000.00,34000.00,0.00,33000.00,0.04,1
35262,3688,1000.00,34000.00,35000.00,0.00,34000.00,0.31,1
35263,3688,-1000.00,33000.00,34000.00,21312.24,13687.76,0.04,0
35264,3689,-1000.00,-1000.00,0.00,0.00,1000.00,0.23,0
35265,3690,-565.39,-565.39,434.61,19.95,545.44,0.33,0
35266,3690,-434.61,-1000.00,0.00,143.73,290.88,0.32,0
35267,3691,-1000.00,-1000.00,0.00,110.84,889.16,0.06,0
35268,3692,-461.01,-461.01,538.99,0.00,461.01,0.22,0
35269,3692,-538.99,-1000.00,0.00,0.00,538.99,0.12,0
35270,3693,-1000.00,-1000.00,0.00,454.04,545.96,0.24,0
35271,3694,1000.00,1000.00,2000.00,0.00,258.59,0.16,1
35272,3694,1000.00,2000.00,3000.00,215.87,1180.54,0.35,1
35273,3694,1000.00,3000.00,4000.00,0.00,3000.00,0.43,1
35274,3694,1000.00,4000.00,5000.00,0.00,586.19,0.15,1
35275,3694,-1000.00,3000.00,4000.00,2654.34,1680.94,0.16,0
35276,3694,-1000.00,2000.00,3000.00,0.00,4000.00,0.20,0
35277,3694,-1000.00,1000.00,2000.00,1698.81,1301.19,0.08,0
35278,3694,-1000.00,0.00,1000.00,0.00,2000.00,0.34,0
35279,3694,-1000.00,-1000.00,0.00,439.53,560.47,0.16,0
35280,3695,-1000.00,-1000.00,0.00,490.89,509.11,0.23,0
35281,3696,-1000.00,-1000.00,0.00,0.00,1000.00,0.01,0
35282,3697,1000.00,1000.00,2000.00,0.00,1000.00,0.32,1
35283,3697,1000.00,2000.00,3000.00,609.59,1390.41,0.34,1
35284,3697,-1000.00,1000.00,2000.00,1124.21,695.92,0.16,0
35285,3697,-1000.00,0.00,1000.00,961.67,842.57,0.20,0
35286,3697,-1000.00,-1000.00,0.00,640.74,359.26,0.13,0
35287,3698,1000.00,1000.00,2000.00,361.74,638.26,0.25,1
35288,3698,1000.00,2000.00,3000.00,0.00,787.86,0.23,1
35289,3698,1000.00,3000.00,4000.00,1474.17,1525.83,0.20,1
35290,3698,1000.00,4000.00,5000.00,0.00,4000.00,0.42,1
35291,3698,1000.00,5000.00,6000.00,0.00,5000.00,0.25,1
35292,3698,0.00,5000.00,6000.00,0.00,0.00,0.05,0
35293,3698,1000.00,6000.00,7000.00,1392.57,4607.43,0.21,1
35294,3698,1000.00,7000.00,8000.00,0.00,7000.00,0.16,1
35295,3698,1000.00,8000.00,9000.00,3233.32,4766.68,0.14,1
35296,3698,1000.00,9000.00,10000.00,0.00,9000.00,0.23,1
35297,3698,0.00,9000.00,10000.00,0.00,0.00,0.08,0
35298,3698,1000.00,10000.00,11000.00,0.00,10000.00,0.14,1
35299,3698,1000.00,11000.00,12000.00,2175.12,8824.88,0.41,1
35300,3698,1000.00,12000.00,13000.00,0.00,12000.00,0.14,1
35301,3698,-1000.00,11000.00,12000.00,8635.72,0.00,0.05,0
35302,3698,1000.00,12000.00,13000.00,0.00,12000.00,0.07,1
35303,3698,1000.00,13000.00,14000.00,0.00,13000.00,0.12,1
35304,3698,1000.00,14000.00,15000.00,0.00,14000.00,0.03,1
35305,3698,1000.00,15000.00,16000.00,0.00,3199.78,0.17,1
35306,3698,1000.00,16000.00,17000.00,0.00,15035.50,0.12,1
35307,3698,1000.00,17000.00,18000.00,0.00,17000.00,0.11,1
35308,3698,1000.00,18000.00,19000.00,6026.06,11973.94,0.33,1
35309,3698,0.00,18000.00,19000.00,0.00,0.00,0.09,0
35310,3698,1000.00,19000.00,20000.00,5408.63,13591.37,0.09,1
35311,3698,-1000.00,18000.00,19000.00,11118.51,8881.49,0.07,0
35312,3698,1000.00,19000.00,20000.00,0.00,19000.00,0.23,1
35313,3698,1000.00,20000.00,21000.00,4914.10,5530.17,0.20,1
35314,3698,1000.00,21000.00,22000.00,4007.36,16992.64,0.41,1
35315,3698,1000.00,22000.00,23000.00,10787.40,11212.60,0.21,1
35316,3698,1000.00,23000.00,24000.00,0.00,23000.00,0.24,1
35317,3698,1000.00,24000.00,25000.00,0.00,24000.00,0.41,1
35318,3698,1000.00,25000.00,26000.00,7183.37,17816.63,0.35,1
35319,3698,-1000.00,24000.00,25000.00,12910.43,0.00,0.01,0
35320,3698,1000.00,25000.00,26000.00,6743.70,18256.30,0.24,1
35321,3698,1000.00,26000.00,27000.00,0.00,26000.00,0.00,1
35322,3698,1000.00,27000.00,28000.00,8203.19,18796.81,0.35,1
35323,3698,1000.00,28000.00,29000.00,0.00,26819.03,0.42,1
35324,3698,1000.00,29000.00,30000.00,4151.38,20522.49,0.38,1
35325,3698,1000.00,30000.00,31000.00,0.00,30000.00,0.26,1
35326,3698,1000.00,31000.00,32000.00,0.00,31000.00,0.38,1
35327,3698,1000.00,32000.00,33000.00,0.00,16595.12,0.18,1
35328,3698,1000.00,33000.00,34000.00,5834.58,27165.42,0.37,1
35329,3698,1000.00,34000.00,35000.00,0.00,17490.73,0.20,1
35330,3698,-1000.00,33000.00,34000.00,20641.74,14358.26,0.11,0
35331,3698,1000.00,34000.00,35000.00,0.00,12196.30,0.21,1
35332,3698,1000.00,35000.00,36000.00,0.00,35000.00,0.26,1
35333,3698,1000.00,36000.00,37000.00,0.00,36000.00,0.14,1
35334,3698,1000.00,37000.00,38000.00,0.00,37000.00,0.08,1
35335,3698,-1000.00,36000.00,37000.00,3993.29,34006.71,0.36,0
35336,3698,-1000.00,35000.00,36000.00,0.00,37000.00,0.16,0
35337,3698,-1000.00,34000.00,35000.00,14812.13,21187.87,0.25,0
35338,3698,-1000.00,33000.00,34000.00,0.00,35000.00,0.39,0
35339,3698,-1000.00,32000.00,33000.00,30304.82,3695.18,0.15,0
35340,3698,-1000.00,31000.00,32000.00,14777.30,18222.70,0.18,0
35341,3698,-1000.00,30000.00,31000.00,0.00,32000.00,0.27,0
35342,3698,0.00,30000.00,31000.00,0.00,0.00,0.04,0
35343,3698,-1000.00,29000.00,30000.00,0.00,31000.00,0.14,0
35344,3698,0.00,29000.00,30000.00,0.00,0.00,0.01,0
35345,3698,-1000.00,28000.00,29000.00,0.00,30000.00,0.17,0
35346,3698,-1000.00,27000.00,28000.00,14500.00,14500.00,0.06,0
35347,3698,-1000.00,26000.00,27000.00,0.00,2993.32,0.07,0
35348,3698,-1000.00,25000.00,26000.00,0.00,26564.92,0.34,0
35349,3698,-1000.00,24000.00,25000.00,363.62,25636.38,0.19,0
35350,3698,-1000.00,23000.00,24000.00,0.00,25000.00,0.38,0
35351,3698,-1000.00,22000.00,23000.00,10721.59,13278.41,0.12,0
35352,3698,-1000.00,21000.00,22000.00,0.00,23000.00,0.22,0
35353,3698,-1000.00,20000.00,21000.00,0.00,22000.00,0.22,0
35354,3698,-1000.00,19000.00,20000.00,9140.82,11859.18,0.16,0
35355,3698,-1000.00,18000.00,19000.00,7562.42,12437.58,0.25,0
35356,3698,-1000.00,17000.00,18000.00,2065.06,16934.94,0.20,0
35357,3698,-1000.00,16000.00,17000.00,0.00,16926.15,0.08,0
35358,3699,1000.00,1000.00,2000.00,0.00,529.84,0.31,1
35359,3699,1000.00,2000.00,3000.00,0.00,2000.00,0.34,1
35360,3699,1000.00,3000.00,4000.00,918.61,2081.39,0.35,1
35361,3699,1000.00,4000.00,5000.00,0.00,2395.33,0.32,1
35362,3699,-1000.00,3000.00,4000.00,3632.44,1367.56,0.09,0
35363,3699,1000.00,4000.00,5000.00,1458.36,2541.64,0.35,1
35364,3699,1000.00,5000.00,6000.00,1875.13,3124.87,0.31,1
35365,3699,1000.00,6000.00,7000.00,0.00,1148.10,0.05,1
35366,3699,1000.00,7000.00,8000.00,0.00,3834.15,0.15,1
35367,3699,1000.00,8000.00,9000.00,2247.94,5752.06,0.16,1
35368,3699,1000.00,9000.00,10000.00,0.00,9000.00,0.12,1
35369,3699,-1000.00,8000.00,9000.00,6109.20,3890.80,0.15,0
35370,3699,-1000.00,7000.00,8000.00,1438.12,376.19,0.12,0
35371,3699,1000.00,8000.00,9000.00,0.00,4675.52,0.32,1
35372,3699,1000.00,9000.00,10000.00,0.00,5160.97,0.29,1
35373,3699,1000.00,10000.00,11000.00,0.00,10000.00,0.16,1
35374,3699,1000.00,11000.00,12000.00,3501.89,7498.11,0.21,1
35375,3699,1000.00,12000.00,13000.00,6000.00,6000.00,0.18,1
35376,3699,1000.00,13000.00,14000.00,0.00,5434.56,0.26,1
35377,3699,1000.00,14000.00,15000.00,7000.00,7000.00,0.05,1
35378,3699,-1000.00,13000.00,14000.00,0.00,5139.98,0.19,0
35379,3699,-1000.00,12000.00,13000.00,0.00,14000.00,0.22,0
35380,3699,-1000.00,11000.00,12000.00,0.00,13000.00,0.28,0
35381,3699,-1000.00,10000.00,11000.00,0.00,12000.00,0.37,0
35382,3699,-1000.00,9000.00,10000.00,1346.62,9653.38,0.40,0
35383,3699,-1000.00,8000.00,9000.00,2620.83,7379.17,0.37,0
35384,3699,-1000.00,7000.00,8000.00,0.00,9000.00,0.41,0
35385,3699,-1000.00,6000.00,7000.00,2016.41,5983.59,0.31,0
35386,3699,-1000.00,5000.00,6000.00,3452.27,2623.37,0.18,0
35387,3699,-1000.00,4000.00,5000.00,1163.78,4836.22,0.39,0
35388,3699,-1000.00,3000.00,4000.00,1400.32,3599.68,0.36,0
35389,3699,-1000.00,2000.00,3000.00,0.00,2065.16,0.31,0
35390,3699,-1000.00,1000.00,2000.00,480.42,858.03,0.21,0
35391,3699,-1000.00,0.00,1000.00,553.53,1446.47,0.26,0
35392,3699,-223.37,-223.37,776.63,0.00,223.37,0.11,0
35393,3699,-776.63,-1000.00,0.00,0.00,776.63,0.34,0
35394,3700,-1000.00,-1000.00,0.00,325.23,674.77,0.32,0
35395,3701,0.00,0.00,1000.00,0.00,0.00,0.16,0
35396,3701,1000.00,1000.00,2000.00,894.47,105.53,0.01,1
35397,3701,1000.00,2000.00,3000.00,1560.54,0.00,0.08,1
35398,3701,-1000.00,1000.00,2000.00,0.00,3000.00,0.28,0
35399,3701,-1000.00,0.00,1000.00,1000.00,1000.00,0.05,0
35400,3701,1000.00,1000.00,2000.00,535.46,464.54,0.02,1
35401,3701,1000.00,2000.00,3000.00,524.85,147.83,0.13,1
35402,3701,-1000.00,1000.00,2000.00,0.00,2364.96,0.24,0
35403,3701,-1000.00,0.00,1000.00,424.54,1575.46,0.33,0
35404,3701,-1000.00,-1000.00,0.00,94.52,905.48,0.35,0
35405,3702,1000.00,1000.00,2000.00,818.11,64.13,0.05,1
35406,3702,-1000.00,0.00,1000.00,631.27,1368.73,0.33,0
35407,3702,-878.13,-878.13,121.87,158.84,719.28,0.38,0
35408,3702,-121.87,-1000.00,-0.00,27.49,94.39,0.03,0
35409,3703,-1000.00,-1000.00,0.00,616.63,264.11,0.12,0
35410,3704,1000.00,1000.00,2000.00,0.00,1000.00,0.32,1
35411,3704,0.00,1000.00,2000.00,0.00,0.00,0.05,0
35412,3704,1000.00,2000.00,3000.00,198.54,556.64,0.21,1
35413,3704,1000.00,3000.00,4000.00,1271.70,1728.30,0.21,1
35414,3704,1000.00,4000.00,5000.00,0.00,4000.00,0.31,1
35415,3704,1000.00,5000.00,6000.00,0.00,5000.00,0.30,1
35416,3704,1000.00,6000.00,7000.00,0.00,750.15,0.11,1
35417,3704,1000.00,7000.00,8000.00,0.00,3128.05,0.21,1
35418,3704,1000.00,8000.00,9000.00,0.00,2547.07,0.17,1
35419,3704,1000.00,9000.00,10000.00,2748.53,6251.47,0.36,1
35420,3704,1000.00,10000.00,11000.00,0.00,10000.00,0.19,1
35421,3704,1000.00,11000.00,12000.00,5500.00,5500.00,0.02,1
35422,3704,1000.00,12000.00,13000.00,0.00,1901.45,0.01,1
35423,3704,1000.00,13000.00,14000.00,0.00,10523.88,0.42,1
35424,3704,-1000.00,12000.00,13000.00,5969.01,0.00,0.06,0
35425,3704,1000.00,13000.00,14000.00,0.00,13000.00,0.11,1
35426,3704,1000.00,14000.00,15000.00,5315.43,8684.57,0.15,1
35427,3704,1000.00,15000.00,16000.00,0.00,768.84,0.12,1
35428,3704,-1000.00,14000.00,15000.00,7144.29,3656.95,0.15,0
35429,3704,1000.00,15000.00,16000.00,0.00,14377.65,0.25,1
35430,3704,1000.00,16000.00,17000.00,5124.04,10875.96,0.34,1
35431,3704,-1000.00,15000.00,16000.00,8500.00,8500.00,0.34,0
35432,3704,-1000.00,14000.00,15000.00,0.00,16000.00,0.21,0
35433,3704,0.00,14000.00,15000.00,0.00,0.00,0.05,0
35434,3704,-534.64,13465.36,14465.36,0.00,534.64,0.08,0
35435,3704,-1000.00,12465.36,13465.36,6050.37,8414.99,0.28,0
35436,3704,-1000.00,11465.36,12465.36,344.04,9743.69,0.40,0
35437,3704,-1000.00,10465.36,11465.36,3870.97,8594.39,0.19,0
35438,3704,-1000.00,9465.36,10465.36,0.00,7516.81,0.16,0
35439,3704,-1000.00,8465.36,9465.36,0.00,10465.36,0.40,0
35440,3704,-1000.00,7465.36,8465.36,0.00,7925.20,0.35,0
35441,3704,-1000.00,6465.36,7465.36,5330.13,3135.23,0.11,0
35442,3704,-1000.00,5465.36,6465.36,2492.87,4972.49,0.05,0
35443,3704,-1000.00,4465.36,5465.36,0.00,6465.36,0.20,0
35444,3704,-1000.00,3465.36,4465.36,1037.10,2070.37,0.25,0
35445,3704,-1000.00,2465.36,3465.36,0.00,3749.99,0.42,0
35446,3704,-1000.00,1465.36,2465.36,2939.45,0.00,0.03,0
35447,3704,-1000.00,465.36,1465.36,1185.12,1280.25,0.05,0
35448,3704,-1000.00,-534.64,465.36,0.00,1465.36,0.11,0
35449,3704,1000.00,465.36,1465.36,0.00,465.36,0.30,1
35450,3704,1000.00,1465.36,2465.36,154.35,1311.01,0.41,1
35451,3704,1000.00,2465.36,3465.36,0.00,1580.78,0.26,1
35452,3704,1000.00,3465.36,4465.36,0.00,1397.96,0.06,1
35453,3704,1000.00,4465.36,5465.36,0.00,4465.36,0.07,1
35454,3704,1000.00,5465.36,6465.36,0.00,5465.36,0.25,1
35455,3704,1000.00,6465.36,7465.36,0.00,4003.52,0.26,1
35456,3704,1000.00,7465.36,8465.36,0.00,7465.36,0.43,1
35457,3704,1000.00,8465.36,9465.36,3684.57,4780.79,0.00,1
35458,3704,1000.00,9465.36,10465.36,1596.02,7869.34,0.42,1
35459,3704,1000.00,10465.36,11465.36,0.00,336.51,0.02,1
35460,3704,1000.00,11465.36,12465.36,2995.59,8469.77,0.38,1
35461,3704,1000.00,12465.36,13465.36,0.00,5999.78,0.09,1
35462,3704,-1000.00,11465.36,12465.36,3630.48,3330.69,0.18,0
35463,3704,1000.00,12465.36,13465.36,17.12,10938.39,0.43,1
35464,3704,-1000.00,11465.36,12465.36,6945.62,6519.74,0.21,0
35465,3704,1000.00,12465.36,13465.36,0.00,12465.36,0.17,1
35466,3704,1000.00,13465.36,14465.36,0.00,6172.45,0.21,1
35467,3704,1000.00,14465.36,15465.36,5558.84,8906.52,0.27,1
35468,3704,1000.00,15465.36,16465.36,0.00,15465.36,0.05,1
35469,3704,1000.00,16465.36,17465.36,0.00,16465.36,0.31,1
35470,3704,1000.00,17465.36,18465.36,3878.84,13586.53,0.39,1
35471,3705,-1000.00,-1000.00,0.00,335.85,664.15,0.34,0
35472,3706,-1000.00,-1000.00,0.00,0.00,1000.00,0.21,0
35473,3707,-730.04,-730.04,269.96,394.92,335.11,0.19,0
35474,3707,-269.96,-1000.00,0.00,141.11,128.85,0.19,0
35475,3708,-1000.00,-1000.00,0.00,0.00,219.24,0.35,0
35476,3709,-1000.00,-1000.00,0.00,0.00,562.87,0.17,0
35477,3710,-501.22,-501.22,498.78,59.76,441.46,0.29,0
35478,3710,-498.78,-1000.00,0.00,154.56,344.21,0.35,0
35479,3711,-958.30,-958.30,41.70,0.00,958.30,0.42,0
35480,3711,-41.70,-1000.00,0.00,0.00,41.70,0.43,0
35481,3712,-12.78,-12.78,987.22,12.78,0.00,0.08,0
35482,3712,0.00,-12.78,987.22,0.00,0.00,0.35,0
35483,3712,-987.22,-1000.00,0.00,515.22,472.00,0.20,0
35484,3713,-1000.00,-1000.00,0.00,1000.00,0.00,0.09,0
35485,3714,-1000.00,-1000.00,0.00,0.00,281.51,0.31,0
35486,3715,-447.65,-447.65,552.35,0.00,447.65,0.17,0
35487,3715,-552.35,-1000.00,0.00,43.52,508.83,0.37,0
35488,3716,-719.48,-719.48,280.52,0.00,719.48,0.06,0
35489,3716,-170.08,-889.56,110.44,0.00,170.08,0.26,0
35490,3716,-1000.00,-1889.56,-889.56,80.59,29.86,0.07,0
35491,3717,-1000.00,-1000.00,0.00,695.85,304.15,0.07,0
35492,3718,-917.71,-917.71,82.29,0.00,917.71,0.35,0
35493,3718,-1000.00,-1917.71,-917.71,50.74,31.55,0.04,0
35494,3719,1000.00,1000.00,2000.00,235.57,0.00,0.32,1
35495,3719,0.00,1000.00,2000.00,0.00,0.00,0.16,0
35496,3719,-1000.00,0.00,1000.00,0.00,2000.00,0.43,0
35497,3719,-570.47,-570.47,429.53,0.00,570.47,0.39,0
35498,3719,-429.53,-1000.00,0.00,197.05,232.48,0.23,0
35499,3720,-1000.00,-1000.00,0.00,607.72,392.28,0.01,0
35500,3721,-292.65,-292.65,707.35,0.00,292.65,0.21,0
35501,3721,-707.35,-1000.00,0.00,0.00,707.35,0.05,0
35502,3722,-1000.00,-1000.00,0.00,0.00,1000.00,0.01,0
35503,3723,0.00,0.00,1000.00,0.00,0.00,0.03,0
35504,3723,-1000.00,-1000.00,0.00,0.00,1000.00,0.38,0
35505,3724,-1000.00,-1000.00,0.00,0.00,1000.00,0.10,0
35506,3725,-1000.00,-1000.00,0.00,0.00,1000.00,0.16,0
35507,3726,1000.00,1000.00,2000.00,0.00,72.66,0.05,1
35508,3726,80.38,1080.38,2080.38,0.00,0.69,0.10,1
35509,3726,1000.00,2080.38,3080.38,1040.19,1040.19,0.01,1
35510,3726,1000.00,3080.38,4080.38,565.01,2515.38,0.34,1
35511,3726,1000.00,4080.38,5080.38,201.64,3878.74,0.39,1
35512,3726,1000.00,5080.38,6080.38,1998.69,2309.24,0.24,1
35513,3726,-1000.00,4080.38,5080.38,3978.31,2102.07,0.11,0
35514,3726,-1000.00,3080.38,4080.38,2598.14,2482.25,0.21,0
35515,3726,1000.00,4080.38,5080.38,995.52,3084.86,0.23,1
35516,3726,1000.00,5080.38,6080.38,0.00,5080.38,0.43,1
35517,3726,-1000.00,4080.38,5080.38,3183.31,2782.11,0.20,0
35518,3726,1000.00,5080.38,6080.38,0.00,2868.12,0.34,1
35519,3726,1000.00,6080.38,7080.38,1898.18,4182.20,0.43,1
35520,3726,1000.00,7080.38,8080.38,0.00,7080.38,0.13,1
35521,3726,1000.00,8080.38,9080.38,69.70,8010.68,0.27,1
35522,3726,1000.00,9080.38,10080.38,0.00,1073.42,0.14,1
35523,3726,1000.00,10080.38,11080.38,4454.40,5625.98,0.12,1
35524,3726,1000.00,11080.38,12080.38,0.00,1552.31,0.15,1
35525,3726,-1000.00,10080.38,11080.38,6040.19,6040.19,0.34,0
35526,3726,-1000.00,9080.38,10080.38,2972.31,8108.08,0.32,0
35527,3726,-1000.00,8080.38,9080.38,0.00,10080.38,0.31,0
35528,3726,-1000.00,7080.38,8080.38,2612.81,6467.57,0.27,0
35529,3726,-1000.00,6080.38,7080.38,4220.95,3859.43,0.39,0
35530,3726,-1000.00,5080.38,6080.38,647.13,6433.25,0.15,0
35531,3726,-1000.00,4080.38,5080.38,0.00,4408.81,0.23,0
35532,3726,-1000.00,3080.38,4080.38,0.00,5042.13,0.22,0
35533,3726,-946.73,2133.65,3133.65,0.00,946.73,0.18,0
35534,3726,-1000.00,1133.65,2133.65,0.00,3133.65,0.19,0
35535,3726,-1000.00,133.65,1133.65,0.00,1511.76,0.11,0
35536,3726,-1000.00,-866.35,133.65,387.49,746.16,0.17,0
35537,3726,-133.65,-1000.00,0.00,0.00,133.65,0.38,0
35538,3727,-1000.00,-1000.00,0.00,0.00,1000.00,0.44,0
35539,3728,-1000.00,-1000.00,0.00,380.59,619.41,0.21,0
35540,3729,1000.00,1000.00,2000.00,0.00,117.27,0.15,1
35541,3729,1000.00,2000.00,3000.00,0.00,1986.17,0.33,1
35542,3729,1000.00,3000.00,4000.00,389.08,2610.92,0.15,1
35543,3729,1000.00,4000.00,5000.00,1647.51,2352.49,0.09,1
35544,3729,1000.00,5000.00,6000.00,0.00,5000.00,0.37,1
35545,3729,1000.00,6000.00,7000.00,0.00,2153.92,0.11,1
35546,3729,1000.00,7000.00,8000.00,0.00,3856.81,0.33,1
35547,3729,-1000.00,6000.00,7000.00,4330.22,3669.78,0.04,0
35548,3729,1000.00,7000.00,8000.00,3208.33,3791.67,0.21,1
35549,3729,1000.00,8000.00,9000.00,438.47,7032.99,0.43,1
35550,3729,1000.00,9000.00,10000.00,111.93,714.85,0.14,1
35551,3729,1000.00,10000.00,11000.00,0.00,1170.08,0.07,1
35552,3729,1000.00,11000.00,12000.00,0.00,3977.43,0.25,1
35553,3729,1000.00,12000.00,13000.00,0.00,12000.00,0.31,1
35554,3729,1000.00,13000.00,14000.00,5341.68,7658.32,0.04,1
35555,3729,-1000.00,12000.00,13000.00,8971.79,0.00,0.02,0
35556,3729,1000.00,13000.00,14000.00,0.00,12724.23,0.38,1
35557,3729,1000.00,14000.00,15000.00,2986.23,9428.96,0.36,1
35558,3729,1000.00,15000.00,16000.00,0.00,15000.00,0.11,1
35559,3729,1000.00,16000.00,17000.00,7038.62,8961.38,0.18,1
35560,3729,1000.00,17000.00,18000.00,8500.00,8500.00,0.37,1
35561,3729,1000.00,18000.00,19000.00,0.00,18000.00,0.14,1
35562,3729,1000.00,19000.00,20000.00,8750.82,10249.18,0.16,1
35563,3729,1000.00,20000.00,21000.00,0.00,20000.00,0.16,1
35564,3729,-1000.00,19000.00,20000.00,10500.00,10500.00,0.34,0
35565,3729,-1000.00,18000.00,19000.00,9982.43,10017.57,0.05,0
35566,3729,-1000.00,17000.00,18000.00,0.00,19000.00,0.08,0
35567,3729,-1000.00,16000.00,17000.00,0.00,14681.80,0.39,0
35568,3729,-1000.00,15000.00,16000.00,0.00,17000.00,0.31,0
35569,3729,-1000.00,14000.00,15000.00,7728.20,8271.80,0.03,0
35570,3729,-1000.00,13000.00,14000.00,0.00,15000.00,0.39,0
35571,3729,-1000.00,12000.00,13000.00,0.00,12898.80,0.43,0
35572,3729,-1000.00,11000.00,12000.00,0.00,13000.00,0.10,0
35573,3729,-1000.00,10000.00,11000.00,0.00,12000.00,0.18,0
35574,3729,-1000.00,9000.00,10000.00,4221.08,6778.92,0.09,0
35575,3729,-1000.00,8000.00,9000.00,1765.82,8234.18,0.27,0
35576,3729,-1000.00,7000.00,8000.00,1476.04,7523.96,0.36,0
35577,3729,-1000.00,6000.00,7000.00,0.00,8000.00,0.32,0
35578,3729,-1000.00,5000.00,6000.00,2734.24,4265.76,0.25,0
35579,3729,-1000.00,4000.00,5000.00,0.00,4114.28,0.35,0
35580,3729,-1000.00,3000.00,4000.00,0.00,4426.68,0.35,0
35581,3729,-942.73,2057.27,3057.27,0.00,942.73,0.19,0
35582,3729,-1000.00,1057.27,2057.27,796.65,2260.61,0.38,0
35583,3729,-1000.00,57.27,1057.27,382.44,1674.83,0.40,0
35584,3729,1000.00,1057.27,2057.27,189.57,867.70,0.34,1
35585,3729,1000.00,2057.27,3057.27,1023.27,1033.99,0.10,1
35586,3729,1000.00,3057.27,4057.27,1528.63,1528.63,0.03,1
35587,3729,1000.00,4057.27,5057.27,339.06,3683.62,0.43,1
35588,3729,-1000.00,3057.27,4057.27,3706.33,1319.11,0.10,0
35589,3729,-1000.00,2057.27,3057.27,2110.32,1946.95,0.33,0
35590,3729,1000.00,3057.27,4057.27,430.43,2626.84,0.04,1
35591,3729,1000.00,4057.27,5057.27,137.29,2993.07,0.40,1
35592,3729,1000.00,5057.27,6057.27,1047.46,1950.33,0.25,1
35593,3729,1000.00,6057.27,7057.27,0.00,6057.27,0.21,1
35594,3729,1000.00,7057.27,8057.27,0.00,6865.20,0.24,1
35595,3729,1000.00,8057.27,9057.27,0.00,8005.27,0.44,1
35596,3729,1000.00,9057.27,10057.27,0.00,9057.27,0.20,1
35597,3729,1000.00,10057.27,11057.27,0.00,10057.27,0.19,1
35598,3729,1000.00,11057.27,12057.27,4564.92,6492.35,0.28,1
35599,3730,1000.00,1000.00,2000.00,0.00,1000.00,0.41,1
35600,3730,1000.00,2000.00,3000.00,0.00,2000.00,0.43,1
35601,3730,1000.00,3000.00,4000.00,0.00,1366.25,0.24,1
35602,3730,-512.60,2487.40,3487.40,323.87,188.73,0.12,0
35603,3730,1000.00,3487.40,4487.40,1144.64,2342.77,0.26,1
35604,3730,1000.00,4487.40,5487.40,166.70,4320.70,0.33,1
35605,3730,-349.24,4138.16,5138.16,349.24,0.00,0.09,0
35606,3730,1000.00,5138.16,6138.16,787.67,4350.50,0.42,1
35607,3730,1000.00,6138.16,7138.16,0.00,1869.08,0.06,1
35608,3730,1000.00,7138.16,8138.16,0.00,5149.55,0.33,1
35609,3730,1000.00,8138.16,9138.16,1934.69,6203.47,0.39,1
35610,3730,-1000.00,7138.16,8138.16,5735.99,3402.17,0.10,0
35611,3730,1000.00,8138.16,9138.16,2323.26,4112.53,0.28,1
35612,3730,1000.00,9138.16,10138.16,2662.67,6475.49,0.36,1
35613,3730,1000.00,10138.16,11138.16,4228.34,5909.83,0.02,1
35614,3730,1000.00,11138.16,12138.16,0.00,11138.16,0.19,1
35615,3730,-1000.00,10138.16,11138.16,6323.68,0.00,0.06,0
35616,3730,1000.00,11138.16,12138.16,0.00,10526.03,0.37,1
35617,3730,1000.00,12138.16,13138.16,0.00,12138.16,0.28,1
35618,3730,-1000.00,11138.16,12138.16,11778.92,1140.09,0.14,0
35619,3730,1000.00,12138.16,13138.16,1202.89,8215.37,0.38,1
35620,3730,-1000.00,11138.16,12138.16,6147.00,6991.17,0.16,0
35621,3730,-1000.00,10138.16,11138.16,0.00,9979.41,0.26,0
35622,3730,-1000.00,9138.16,10138.16,0.00,11138.16,0.13,0
35623,3730,-1000.00,8138.16,9138.16,8061.76,2076.41,0.01,0
35624,3730,-1000.00,7138.16,8138.16,0.00,9138.16,0.37,0
35625,3730,-1000.00,6138.16,7138.16,5533.73,2604.44,0.06,0
35626,3730,-1000.00,5138.16,6138.16,3558.05,0.00,0.05,0
35627,3730,-1000.00,4138.16,5138.16,2474.28,3663.89,0.29,0
35628,3730,-1000.00,3138.16,4138.16,1133.24,4004.93,0.40,0
35629,3730,-1000.00,2138.16,3138.16,0.00,4138.16,0.26,0
35630,3730,-1000.00,1138.16,2138.16,1324.05,1814.12,0.00,0
35631,3730,-1000.00,138.16,1138.16,0.00,1990.21,0.24,0
35632,3730,-1000.00,-861.84,138.16,408.68,729.49,0.03,0
35633,3730,-138.16,-1000.00,0.00,0.00,138.16,0.24,0
35634,3731,-584.76,-584.76,415.24,0.00,584.76,0.32,0
35635,3731,-48.23,-632.99,367.01,13.50,34.73,0.14,0
35636,3731,-367.01,-1000.00,0.00,127.82,239.18,0.30,0
35637,3732,-1000.00,-1000.00,0.00,500.00,500.00,0.06,0
35638,3733,1000.00,1000.00,2000.00,499.86,500.14,0.03,1
35639,3733,1000.00,2000.00,3000.00,3.54,1945.01,0.44,1
35640,3733,1000.00,3000.00,4000.00,0.00,290.46,0.14,1
35641,3733,1000.00,4000.00,5000.00,0.00,577.08,0.15,1
35642,3733,1000.00,5000.00,6000.00,0.00,5000.00,0.28,1
35643,3733,1000.00,6000.00,7000.00,0.00,1024.34,0.16,1
35644,3733,1000.00,7000.00,8000.00,840.52,6159.48,0.25,1
35645,3733,1000.00,8000.00,9000.00,451.52,7548.48,0.15,1
35646,3733,1000.00,9000.00,10000.00,1326.04,3841.29,0.27,1
35647,3733,1000.00,10000.00,11000.00,0.00,10000.00,0.24,1
35648,3733,1000.00,11000.00,12000.00,2920.59,8079.41,0.28,1
35649,3733,1000.00,12000.00,13000.00,0.00,5454.74,0.20,1
35650,3733,1000.00,13000.00,14000.00,0.00,13000.00,0.36,1
35651,3733,1000.00,14000.00,15000.00,0.00,14000.00,0.17,1
35652,3733,1000.00,15000.00,16000.00,6240.57,8759.43,0.22,1
35653,3733,-1000.00,14000.00,15000.00,7995.85,6215.06,0.19,0
35654,3733,1000.00,15000.00,16000.00,0.00,9354.51,0.10,1
35655,3733,1000.00,16000.00,17000.00,7431.75,8568.25,0.15,1
35656,3733,1000.00,17000.00,18000.00,641.88,16358.12,0.10,1
35657,3733,1000.00,18000.00,19000.00,9000.00,9000.00,0.07,1
35658,3733,1000.00,19000.00,20000.00,0.00,3165.74,0.09,1
35659,3733,1000.00,20000.00,21000.00,9794.53,10205.47,0.35,1
35660,3733,1000.00,21000.00,22000.00,0.00,21000.00,0.09,1
35661,3733,1000.00,22000.00,23000.00,0.00,22000.00,0.19,1
35662,3733,1000.00,23000.00,24000.00,0.00,22502.82,0.41,1
35663,3733,1000.00,24000.00,25000.00,12000.00,12000.00,0.27,1
35664,3733,1000.00,25000.00,26000.00,0.00,23442.42,0.42,1
35665,3733,1000.00,26000.00,27000.00,11450.69,14549.31,0.20,1
35666,3733,1000.00,27000.00,28000.00,0.00,27000.00,0.41,1
35667,3733,1000.00,28000.00,29000.00,0.00,28000.00,0.05,1
35668,3733,1000.00,29000.00,30000.00,9974.51,19025.49,0.29,1
35669,3733,1000.00,30000.00,31000.00,0.00,30000.00,0.16,1
35670,3733,-1000.00,29000.00,30000.00,19416.97,11583.03,0.11,0
35671,3733,1000.00,30000.00,31000.00,1614.20,28385.80,0.04,1
35672,3733,1000.00,31000.00,32000.00,0.00,31000.00,0.18,1
35673,3733,1000.00,32000.00,33000.00,2782.08,29217.92,0.43,1
35674,3733,1000.00,33000.00,34000.00,13092.84,19907.16,0.22,1
35675,3733,1000.00,34000.00,35000.00,7449.42,26550.58,0.40,1
35676,3733,1000.00,35000.00,36000.00,15772.20,19227.80,0.15,1
35677,3733,1000.00,36000.00,37000.00,0.00,36000.00,0.38,1
35678,3733,1000.00,37000.00,38000.00,13518.28,23481.72,0.29,1
35679,3733,1000.00,38000.00,39000.00,10247.15,10543.59,0.19,1
35680,3733,1000.00,39000.00,40000.00,11649.08,27350.92,0.09,1
35681,3734,1000.00,1000.00,2000.00,171.72,828.28,0.42,1
35682,3734,-1000.00,0.00,1000.00,1174.28,485.32,0.12,0
35683,3734,1000.00,1000.00,2000.00,0.00,922.32,0.30,1
35684,3734,1000.00,2000.00,3000.00,526.09,1473.91,0.30,1
35685,3734,1000.00,3000.00,4000.00,702.59,2297.41,0.25,1
35686,3734,1000.00,4000.00,5000.00,159.77,3840.23,0.36,1
35687,3734,1000.00,5000.00,6000.00,0.00,5000.00,0.23,1
35688,3734,1000.00,6000.00,7000.00,2048.17,3951.83,0.24,1
35689,3734,1000.00,7000.00,8000.00,0.00,7000.00,0.19,1
35690,3734,1000.00,8000.00,9000.00,0.00,8000.00,0.12,1
35691,3734,1000.00,9000.00,10000.00,3896.12,5103.88,0.23,1
35692,3734,1000.00,10000.00,11000.00,0.00,4973.16,0.25,1
35693,3734,1000.00,11000.00,12000.00,0.00,11000.00,0.08,1
35694,3734,1000.00,12000.00,13000.00,5533.26,6466.74,0.25,1
35695,3734,1000.00,13000.00,14000.00,0.00,13000.00,0.06,1
35696,3734,1000.00,14000.00,15000.00,0.00,14000.00,0.07,1
35697,3734,1000.00,15000.00,16000.00,0.00,15000.00,0.30,1
35698,3734,1000.00,16000.00,17000.00,0.00,2997.65,0.16,1
35699,3734,-1000.00,15000.00,16000.00,8763.41,8236.59,0.21,0
35700,3734,1000.00,16000.00,17000.00,5547.41,10452.59,0.22,1
35701,3734,-1000.00,15000.00,16000.00,4509.25,2248.61,0.14,0
35702,3734,1000.00,16000.00,17000.00,8000.00,8000.00,0.03,1
35703,3734,1000.00,17000.00,18000.00,0.00,17000.00,0.20,1
35704,3734,1000.00,18000.00,19000.00,2065.82,15934.18,0.15,1
35705,3734,1000.00,19000.00,20000.00,0.00,8368.44,0.28,1
35706,3734,1000.00,20000.00,21000.00,0.00,9427.47,0.26,1
35707,3734,1000.00,21000.00,22000.00,0.00,21000.00,0.33,1
35708,3734,1000.00,22000.00,23000.00,4716.22,17283.78,0.34,1
35709,3734,1000.00,23000.00,24000.00,6505.85,10713.58,0.27,1
35710,3734,1000.00,24000.00,25000.00,0.00,11272.83,0.29,1
35711,3734,1000.00,25000.00,26000.00,0.00,23547.52,0.14,1
35712,3734,1000.00,26000.00,27000.00,0.00,15502.88,0.33,1
35713,3734,1000.00,27000.00,28000.00,0.00,8378.72,0.18,1
35714,3734,1000.00,28000.00,29000.00,0.00,28000.00,0.42,1
35715,3734,1000.00,29000.00,30000.00,12315.02,16684.98,0.15,1
35716,3734,1000.00,30000.00,31000.00,0.00,11888.65,0.26,1
35717,3734,1000.00,31000.00,32000.00,0.00,31000.00,0.03,1
35718,3734,1000.00,32000.00,33000.00,16000.00,16000.00,0.07,1
35719,3734,1000.00,33000.00,34000.00,8980.10,24019.90,0.05,1
35720,3734,-1000.00,32000.00,33000.00,11868.25,1849.30,0.11,0
35721,3734,1000.00,33000.00,34000.00,11872.92,21127.08,0.24,1
35722,3734,1000.00,34000.00,35000.00,11033.49,22966.51,0.30,1
35723,3734,1000.00,35000.00,36000.00,16054.40,18945.60,0.16,1
35724,3734,1000.00,36000.00,37000.00,0.00,36000.00,0.04,1
35725,3734,-1000.00,35000.00,36000.00,14307.69,13450.97,0.21,0
35726,3735,-863.91,-863.91,136.09,0.00,863.91,0.42,0
35727,3735,-136.09,-1000.00,0.00,41.95,94.13,0.27,0
35728,3736,-1000.00,-1000.00,0.00,190.76,809.24,0.32,0
35729,3737,-1000.00,-1000.00,0.00,250.68,268.25,0.26,0
35730,3738,0.00,0.00,1000.00,0.00,0.00,0.06,0
35731,3738,1000.00,1000.00,2000.00,968.26,0.00,0.06,1
35732,3738,-1000.00,0.00,1000.00,387.92,801.93,0.34,0
35733,3738,1000.00,1000.00,2000.00,329.39,0.00,0.26,1
35734,3738,1000.00,2000.00,3000.00,1371.99,137.47,0.23,1
35735,3738,1000.00,3000.00,4000.00,1471.85,174.51,0.32,1
35736,3738,1000.00,4000.00,5000.00,2245.41,0.00,0.17,1
35737,3738,1000.00,5000.00,6000.00,2763.62,476.04,0.29,1
35738,3738,0.00,5000.00,6000.00,0.00,0.00,0.08,0
35739,3738,1000.00,6000.00,7000.00,2992.21,0.00,0.22,1
35740,3738,-368.55,5631.45,6631.45,0.00,368.55,0.16,0
35741,3738,-1000.00,4631.45,5631.45,0.00,1220.83,0.15,0
35742,3738,-1000.00,3631.45,4631.45,875.39,1322.20,0.40,0
35743,3738,1000.00,4631.45,5631.45,2438.93,286.05,0.30,1
35744,3738,0.00,4631.45,5631.45,0.00,0.00,0.06,0
35745,3738,0.00,4631.45,5631.45,0.00,0.00,0.21,0
35746,3738,0.00,4631.45,5631.45,0.00,0.00,0.30,0
35747,3738,1000.00,5631.45,6631.45,5631.45,0.00,0.06,1
35748,3738,-1000.00,4631.45,5631.45,0.00,6631.45,0.07,0
35749,3738,1000.00,5631.45,6631.45,3555.78,609.76,0.25,1
35750,3738,-797.15,4834.30,5834.30,0.00,797.15,0.41,0
35751,3738,-960.53,3873.77,4873.77,0.00,960.53,0.41,0
35752,3738,0.00,3873.77,4873.77,0.00,0.00,0.11,0
35753,3738,1000.00,4873.77,5873.77,3264.36,1609.41,0.15,1
35754,3738,-1000.00,3873.77,4873.77,280.49,5050.53,0.16,0
35755,3738,0.00,3873.77,4873.77,0.00,0.00,0.10,0
35756,3738,-1000.00,2873.77,3873.77,2254.25,965.93,0.31,0
35757,3738,0.00,2873.77,3873.77,0.00,0.00,0.07,0
35758,3738,-1000.00,1873.77,2873.77,2100.40,0.00,0.28,0
35759,3738,-1000.00,873.77,1873.77,601.51,738.76,0.38,0
35760,3738,-727.80,145.97,1145.97,546.38,181.42,0.39,0
35761,3738,0.00,145.97,1145.97,0.00,0.00,0.35,0
35762,3738,-849.01,-703.04,296.96,625.66,223.35,0.28,0
35763,3738,0.00,-703.04,296.96,0.00,0.00,0.23,0
35764,3738,-1000.00,-1703.04,-703.04,3.31,293.66,0.06,0
35765,3739,-1000.00,-1000.00,0.00,439.47,560.53,0.17,0
35766,3740,-671.59,-671.59,328.41,92.37,579.21,0.34,0
35767,3740,-328.41,-1000.00,0.00,87.67,240.75,0.37,0
35768,3741,-1000.00,-1000.00,0.00,244.17,755.83,0.23,0
35769,3742,-308.71,-308.71,691.29,0.00,308.71,0.07,0
35770,3742,-691.29,-1000.00,0.00,145.85,545.43,0.30,0
35771,3743,-1000.00,-1000.00,0.00,614.46,0.00,0.01,0
35772,3744,-1000.00,-1000.00,0.00,0.00,1000.00,0.32,0
35773,3745,-1000.00,-1000.00,0.00,0.00,1000.00,0.25,0
35774,3746,0.00,0.00,1000.00,0.00,0.00,0.23,0
35775,3746,-1000.00,-1000.00,0.00,0.00,55.43,0.35,0
35776,3747,-1000.00,-1000.00,0.00,474.85,525.15,0.14,0
35777,3748,1000.00,1000.00,2000.00,0.00,1000.00,0.03,1
35778,3748,-1000.00,0.00,1000.00,1216.82,0.00,0.02,0
35779,3748,1000.00,1000.00,2000.00,500.00,500.00,0.10,1
35780,3748,1000.00,2000.00,3000.00,0.00,770.90,0.13,1
35781,3748,1000.00,3000.00,4000.00,0.00,3000.00,0.20,1
35782,3748,1000.00,4000.00,5000.00,0.00,4000.00,0.12,1
35783,3748,1000.00,5000.00,6000.00,41.13,2548.79,0.32,1
35784,3748,-1000.00,4000.00,5000.00,1871.26,0.00,0.07,0
35785,3748,1000.00,5000.00,6000.00,1857.22,3142.78,0.29,1
35786,3748,1000.00,6000.00,7000.00,5.34,5994.66,0.34,1
35787,3748,1000.00,7000.00,8000.00,1204.45,5795.55,0.32,1
35788,3748,-1000.00,6000.00,7000.00,6166.13,1833.87,0.05,0
35789,3748,1000.00,7000.00,8000.00,0.00,4719.66,0.20,1
35790,3748,1000.00,8000.00,9000.00,0.00,8000.00,0.36,1
35791,3748,1000.00,9000.00,10000.00,0.00,9000.00,0.08,1
35792,3748,1000.00,10000.00,11000.00,0.00,3945.92,0.26,1
35793,3748,1000.00,11000.00,12000.00,0.00,4028.99,0.24,1
35794,3748,1000.00,12000.00,13000.00,0.00,5007.65,0.22,1
35795,3748,-1000.00,11000.00,12000.00,0.00,4052.51,0.12,0
35796,3748,-1000.00,10000.00,11000.00,0.00,12000.00,0.32,0
35797,3748,-1000.00,9000.00,10000.00,0.00,11000.00,0.24,0
35798,3748,-1000.00,8000.00,9000.00,2354.29,7645.71,0.17,0
35799,3748,-1000.00,7000.00,8000.00,1820.80,7179.20,0.38,0
35800,3748,-1000.00,6000.00,7000.00,0.00,3531.39,0.25,0
35801,3748,-1000.00,5000.00,6000.00,0.00,7000.00,0.29,0
35802,3748,-1000.00,4000.00,5000.00,490.02,3159.70,0.32,0
35803,3748,-1000.00,3000.00,4000.00,2442.84,2557.16,0.09,0
35804,3748,-1000.00,2000.00,3000.00,828.57,3171.43,0.40,0
35805,3748,-1000.00,1000.00,2000.00,586.39,2413.61,0.40,0
35806,3748,-900.60,99.40,1099.40,12.82,887.78,0.29,0
35807,3748,-970.13,-870.72,129.28,57.11,913.02,0.42,0
35808,3748,-75.07,-945.79,54.21,2.27,72.79,0.34,0
35809,3748,-26.32,-972.11,27.89,0.00,26.32,0.21,0
35810,3748,-27.89,-1000.00,-0.00,10.67,17.22,0.16,0
35811,3749,-729.76,-729.76,270.24,0.00,729.76,0.34,0
35812,3749,-1000.00,-1729.76,-729.76,270.24,0.00,0.02,0
35813,3750,-39.74,-39.74,960.26,0.00,39.74,0.12,0
35814,3750,-12.16,-51.90,948.10,0.00,12.16,0.10,0
35815,3750,-948.10,-1000.00,-0.00,448.75,499.35,0.19,0
35816,3751,-1000.00,-1000.00,0.00,458.95,541.05,0.19,0
35817,3752,-958.19,-958.19,41.81,0.00,958.19,0.09,0
35818,3752,-41.81,-1000.00,0.00,19.93,21.88,0.10,0
35819,3753,0.00,0.00,1000.00,0.00,0.00,0.07,0
35820,3753,-232.52,-232.52,767.48,0.00,232.52,0.16,0
35821,3753,-767.48,-1000.00,0.00,315.07,452.42,0.06,0
35822,3754,-1000.00,-1000.00,0.00,0.00,1000.00,0.02,0
35823,3755,1000.00,1000.00,2000.00,179.21,820.79,0.41,1
35824,3755,1000.00,2000.00,3000.00,0.00,2000.00,0.29,1
35825,3755,1000.00,3000.00,4000.00,0.00,3000.00,0.32,1
35826,3755,1000.00,4000.00,5000.00,0.00,4000.00,0.02,1
35827,3755,1000.00,5000.00,6000.00,0.00,1392.39,0.21,1
35828,3755,1000.00,6000.00,7000.00,0.00,6000.00,0.13,1
35829,3755,1000.00,7000.00,8000.00,1881.57,5118.43,0.37,1
35830,3755,-1000.00,6000.00,7000.00,6396.09,1603.91,0.07,0
35831,3755,1000.00,7000.00,8000.00,745.59,6254.41,0.43,1
35832,3755,-1000.00,6000.00,7000.00,869.67,236.01,0.12,0
35833,3755,1000.00,7000.00,8000.00,2910.71,3617.19,0.25,1
35834,3755,1000.00,8000.00,9000.00,4000.00,4000.00,0.03,1
35835,3755,1000.00,9000.00,10000.00,3455.35,5544.65,0.28,1
35836,3755,-1000.00,8000.00,9000.00,6668.17,3331.83,0.13,0
35837,3755,-1000.00,7000.00,8000.00,7308.18,1691.82,0.06,0
35838,3755,1000.00,8000.00,9000.00,0.00,7425.01,0.39,1
35839,3755,1000.00,9000.00,10000.00,0.00,8286.12,0.30,1
35840,3755,1000.00,10000.00,11000.00,1294.07,8705.93,0.43,1
35841,3755,1000.00,11000.00,12000.00,0.00,7300.57,0.36,1
35842,3755,1000.00,12000.00,13000.00,5255.11,6744.89,0.11,1
35843,3755,1000.00,13000.00,14000.00,0.00,8107.53,0.34,1
35844,3755,1000.00,14000.00,15000.00,0.00,14000.00,0.04,1
35845,3755,1000.00,15000.00,16000.00,0.00,4636.43,0.19,1
35846,3755,1000.00,16000.00,17000.00,0.00,4857.63,0.22,1
35847,3755,1000.00,17000.00,18000.00,0.00,17000.00,0.26,1
35848,3755,1000.00,18000.00,19000.00,0.00,4358.28,0.17,1
35849,3755,1000.00,19000.00,20000.00,0.00,19000.00,0.26,1
35850,3755,1000.00,20000.00,21000.00,0.00,19834.21,0.29,1
35851,3755,-1000.00,19000.00,20000.00,1386.07,0.00,0.04,0
35852,3755,1000.00,20000.00,21000.00,0.00,20000.00,0.34,1
35853,3755,1000.00,21000.00,22000.00,10500.00,10500.00,0.03,1
35854,3755,1000.00,22000.00,23000.00,0.00,22000.00,0.27,1
35855,3755,-1000.00,21000.00,22000.00,10540.98,7460.66,0.18,0
35856,3755,1000.00,22000.00,23000.00,947.58,21052.42,0.25,1
35857,3755,1000.00,23000.00,24000.00,0.00,23000.00,0.11,1
35858,3755,-1000.00,22000.00,23000.00,674.23,542.16,0.12,0
35859,3755,1000.00,23000.00,24000.00,8871.15,14128.85,0.16,1
35860,3755,1000.00,24000.00,25000.00,5390.95,18609.05,0.39,1
35861,3755,1000.00,25000.00,26000.00,0.00,21408.56,0.25,1
35862,3755,1000.00,26000.00,27000.00,0.00,17882.25,0.22,1
35863,3755,1000.00,27000.00,28000.00,0.00,27000.00,0.20,1
35864,3755,1000.00,28000.00,29000.00,4180.49,23709.77,0.41,1
35865,3755,1000.00,29000.00,30000.00,0.00,20493.78,0.30,1
35866,3755,1000.00,30000.00,31000.00,1934.14,28065.86,0.39,1
35867,3755,1000.00,31000.00,32000.00,0.00,31000.00,0.34,1
35868,3755,1000.00,32000.00,33000.00,15097.82,16902.18,0.12,1
35869,3755,-1000.00,31000.00,32000.00,5230.68,4397.62,0.15,0
35870,3755,-1000.00,30000.00,31000.00,15474.21,16525.79,0.34,0
35871,3755,-1000.00,29000.00,30000.00,6943.78,24056.22,0.14,0
35872,3755,-1000.00,28000.00,29000.00,8455.75,21544.25,0.38,0
35873,3755,-1000.00,27000.00,28000.00,0.00,29000.00,0.15,0
35874,3755,-1000.00,26000.00,27000.00,0.00,21333.58,0.39,0
35875,3755,-1000.00,25000.00,26000.00,3471.72,14178.80,0.32,0
35876,3755,-1000.00,24000.00,25000.00,15043.85,10956.15,0.12,0
35877,3755,-1000.00,23000.00,24000.00,0.00,25000.00,0.22,0
35878,3755,-1000.00,22000.00,23000.00,0.00,21880.00,0.42,0
35879,3755,-1000.00,21000.00,22000.00,0.00,23000.00,0.43,0
35880,3755,-1000.00,20000.00,21000.00,0.00,9401.01,0.11,0
35881,3755,-1000.00,19000.00,20000.00,844.46,20155.54,0.43,0
35882,3755,-1000.00,18000.00,19000.00,2334.54,10665.12,0.32,0
35883,3755,-1000.00,17000.00,18000.00,3753.94,7148.54,0.24,0
35884,3755,-1000.00,16000.00,17000.00,0.00,18000.00,0.16,0
35885,3755,-1000.00,15000.00,16000.00,4461.31,12538.69,0.37,0
35886,3755,-1000.00,14000.00,15000.00,7698.69,8301.31,0.10,0
35887,3755,-1000.00,13000.00,14000.00,0.00,9599.87,0.26,0
35888,3755,-1000.00,12000.00,13000.00,0.00,5131.00,0.13,0
35889,3755,0.00,12000.00,13000.00,0.00,0.00,0.01,0
35890,3755,-1000.00,11000.00,12000.00,6502.02,6497.98,0.18,0
35891,3755,-1000.00,10000.00,11000.00,0.00,12000.00,0.40,0
35892,3755,-1000.00,9000.00,10000.00,3708.28,3573.78,0.20,0
35893,3755,-1000.00,8000.00,9000.00,0.00,10000.00,0.02,0
35894,3755,-1000.00,7000.00,8000.00,0.00,7558.52,0.39,0
35895,3755,-1000.00,6000.00,7000.00,0.00,7211.09,0.36,0
35896,3755,-1000.00,5000.00,6000.00,0.00,2789.07,0.24,0
35897,3755,-1000.00,4000.00,5000.00,0.00,6000.00,0.03,0
35898,3755,-1000.00,3000.00,4000.00,0.00,3260.15,0.08,0
35899,3755,-1000.00,2000.00,3000.00,2254.10,1745.90,0.18,0
35900,3755,-1000.00,1000.00,2000.00,0.00,1034.76,0.23,0
35901,3755,-1000.00,0.00,1000.00,0.00,2000.00,0.20,0
35902,3755,-897.34,-897.34,102.66,0.00,897.34,0.42,0
35903,3755,-102.66,-1000.00,0.00,0.00,102.66,0.25,0
35904,3756,-1000.00,-1000.00,0.00,608.17,391.83,0.16,0
35905,3757,-1000.00,-1000.00,0.00,339.23,660.77,0.33,0
35906,3758,-1000.00,-1000.00,0.00,0.00,1000.00,0.38,0
35907,3759,1000.00,1000.00,2000.00,218.72,781.28,0.39,1
35908,3759,-515.90,484.10,1484.10,444.17,71.73,0.11,0
35909,3759,1000.00,1484.10,2484.10,187.59,790.35,0.32,1
35910,3759,1000.00,2484.10,3484.10,0.00,2252.70,0.01,1
35911,3759,1000.00,3484.10,4484.10,0.00,3484.10,0.16,1
35912,3759,1000.00,4484.10,5484.10,0.00,2600.43,0.26,1
35913,3759,1000.00,5484.10,6484.10,0.00,3220.26,0.29,1
35914,3759,1000.00,6484.10,7484.10,0.00,6484.10,0.17,1
35915,3759,1000.00,7484.10,8484.10,0.00,7484.10,0.05,1
35916,3759,1000.00,8484.10,9484.10,0.00,2187.22,0.19,1
35917,3759,1000.00,9484.10,10484.10,0.00,9484.10,0.10,1
35918,3759,1000.00,10484.10,11484.10,0.00,8506.18,0.07,1
35919,3759,1000.00,11484.10,12484.10,0.00,9845.97,0.44,1
35920,3759,1000.00,12484.10,13484.10,3069.88,9157.19,0.37,1
35921,3759,1000.00,13484.10,14484.10,3948.68,9535.42,0.23,1
35922,3759,1000.00,14484.10,15484.10,3803.89,10680.21,0.19,1
35923,3759,1000.00,15484.10,16484.10,0.00,15484.10,0.13,1
35924,3759,1000.00,16484.10,17484.10,0.00,16484.10,0.15,1
35925,3759,1000.00,17484.10,18484.10,768.11,2918.32,0.17,1
35926,3759,-1000.00,16484.10,17484.10,0.00,18484.10,0.10,0
35927,3759,-1000.00,15484.10,16484.10,3622.17,13861.93,0.43,0
35928,3759,-1000.00,14484.10,15484.10,0.00,837.65,0.11,0
35929,3759,-1000.00,13484.10,14484.10,0.00,15484.10,0.27,0
35930,3759,-1000.00,12484.10,13484.10,6999.70,7484.41,0.09,0
35931,3759,-1000.00,11484.10,12484.10,7016.60,0.00,0.15,0
35932,3759,-1000.00,10484.10,11484.10,0.00,12484.10,0.31,0
35933,3759,-1000.00,9484.10,10484.10,2858.59,8625.52,0.23,0
35934,3759,-1000.00,8484.10,9484.10,0.00,10484.10,0.28,0
35935,3759,-1000.00,7484.10,8484.10,0.00,9484.10,0.12,0
35936,3759,-1000.00,6484.10,7484.10,2020.99,6463.11,0.08,0
35937,3759,-1000.00,5484.10,6484.10,5351.41,2132.69,0.10,0
35938,3759,0.00,5484.10,6484.10,0.00,0.00,0.04,0
35939,3759,-1000.00,4484.10,5484.10,2192.46,3746.10,0.37,0
35940,3759,-1000.00,3484.10,4484.10,1986.44,3497.66,0.30,0
35941,3759,-1000.00,2484.10,3484.10,0.00,4484.10,0.44,0
35942,3759,-1000.00,1484.10,2484.10,2029.00,1455.10,0.09,0
35943,3759,-1000.00,484.10,1484.10,0.00,2484.10,0.29,0
35944,3759,-1000.00,-515.90,484.10,827.99,656.11,0.14,0
35945,3759,-1000.00,-1515.90,-515.90,64.72,350.48,0.39,0
35946,3760,-1000.00,-1000.00,0.00,0.00,1000.00,0.39,0
35947,3761,1000.00,1000.00,2000.00,0.00,1000.00,0.29,1
35948,3761,-1000.00,0.00,1000.00,1261.82,628.61,0.13,0
35949,3761,1000.00,1000.00,2000.00,264.73,735.27,0.38,1
35950,3761,-496.28,503.72,1503.72,496.28,0.00,0.04,0
35951,3761,1000.00,1503.72,2503.72,495.48,1008.24,0.19,1
35952,3761,1000.00,2503.72,3503.72,0.00,2503.72,0.26,1
35953,3761,1000.00,3503.72,4503.72,0.00,3503.72,0.19,1
35954,3761,1000.00,4503.72,5503.72,192.70,235.59,0.13,1
35955,3761,1000.00,5503.72,6503.72,2296.42,3207.30,0.26,1
35956,3761,-1000.00,4503.72,5503.72,1276.75,116.39,0.11,0
35957,3761,1000.00,5503.72,6503.72,2751.86,2751.86,0.13,1
35958,3761,1000.00,6503.72,7503.72,0.00,1916.18,0.22,1
35959,3761,1000.00,7503.72,8503.72,3751.86,3751.86,0.35,1
35960,3761,1000.00,8503.72,9503.72,2272.14,6231.58,0.37,1
35961,3761,1000.00,9503.72,10503.72,3967.04,5536.68,0.14,1
35962,3761,1000.00,10503.72,11503.72,0.00,9585.28,0.26,1
35963,3761,1000.00,11503.72,12503.72,0.00,11365.57,0.16,1
35964,3761,1000.00,12503.72,13503.72,5413.64,7090.08,0.18,1
35965,3761,-1000.00,11503.72,12503.72,7779.53,5724.19,0.09,0
35966,3761,1000.00,12503.72,13503.72,5838.76,6664.96,0.16,1
35967,3761,1000.00,13503.72,14503.72,0.00,13503.72,0.11,1
35968,3761,1000.00,14503.72,15503.72,7076.45,7427.27,0.03,1
35969,3761,1000.00,15503.72,16503.72,3255.63,12248.09,0.39,1
35970,3761,1000.00,16503.72,17503.72,5765.68,10738.04,0.16,1
35971,3761,1000.00,17503.72,18503.72,0.00,17503.72,0.40,1
35972,3761,1000.00,18503.72,19503.72,0.00,18503.72,0.37,1
35973,3761,1000.00,19503.72,20503.72,0.00,19503.72,0.41,1
35974,3761,1000.00,20503.72,21503.72,0.00,17801.81,0.27,1
35975,3761,-1000.00,19503.72,20503.72,11664.95,9838.77,0.14,0
35976,3761,1000.00,20503.72,21503.72,5038.16,15465.56,0.39,1
35977,3761,1000.00,21503.72,22503.72,0.00,21503.72,0.26,1
35978,3761,1000.00,22503.72,23503.72,8525.77,13977.95,0.17,1
35979,3761,1000.00,23503.72,24503.72,0.00,23503.72,0.24,1
35980,3761,1000.00,24503.72,25503.72,4780.98,19722.74,0.39,1
35981,3761,1000.00,25503.72,26503.72,11280.03,14223.69,0.17,1
35982,3761,-1000.00,24503.72,25503.72,15149.69,11354.03,0.17,0
35983,3761,1000.00,25503.72,26503.72,8443.83,17059.89,0.20,1
35984,3761,1000.00,26503.72,27503.72,13251.86,13251.86,0.01,1
35985,3761,1000.00,27503.72,28503.72,13374.48,14129.24,0.11,1
35986,3761,-1000.00,26503.72,27503.72,16161.49,0.00,0.06,0
35987,3761,0.00,26503.72,27503.72,0.00,0.00,0.05,0
35988,3761,1000.00,27503.72,28503.72,7177.14,12500.88,0.27,1
35989,3761,1000.00,28503.72,29503.72,2487.98,12370.23,0.28,1
35990,3761,1000.00,29503.72,30503.72,0.00,29503.72,0.14,1
35991,3761,-1000.00,28503.72,29503.72,16389.99,14113.73,0.19,0
35992,3761,-1000.00,27503.72,28503.72,0.00,12765.43,0.13,0
35993,3761,-1000.00,26503.72,27503.72,0.00,28503.72,0.43,0
35994,3761,-1000.00,25503.72,26503.72,12635.84,14867.88,0.16,0
35995,3761,-1000.00,24503.72,25503.72,12419.23,14084.49,0.14,0
35996,3761,-1000.00,23503.72,24503.72,0.00,21552.34,0.34,0
35997,3761,0.00,23503.72,24503.72,0.00,0.00,0.08,0
35998,3761,-1000.00,22503.72,23503.72,1100.62,23403.10,0.30,0
35999,3761,-1000.00,21503.72,22503.72,23503.72,0.00,0.01,0
36000,3761,-1000.00,20503.72,21503.72,4628.25,17875.47,0.40,0
36001,3761,-1000.00,19503.72,20503.72,0.00,21503.72,0.38,0
36002,3761,-1000.00,18503.72,19503.72,0.00,9990.54,0.21,0
36003,3761,-1000.00,17503.72,18503.72,7590.78,11912.94,0.38,0
36004,3761,-1000.00,16503.72,17503.72,0.00,18503.72,0.38,0
36005,3761,-1000.00,15503.72,16503.72,0.00,17503.72,0.29,0
36006,3761,-1000.00,14503.72,15503.72,0.00,15566.58,0.20,0
36007,3761,-1000.00,13503.72,14503.72,0.00,7526.01,0.28,0
36008,3761,-1000.00,12503.72,13503.72,0.00,14503.72,0.24,0
36009,3761,-1000.00,11503.72,12503.72,0.00,6706.21,0.13,0
36010,3761,-1000.00,10503.72,11503.72,1327.20,704.72,0.13,0
36011,3762,1000.00,1000.00,2000.00,317.20,682.80,0.33,1
36012,3762,1000.00,2000.00,3000.00,465.25,1534.75,0.39,1
36013,3762,1000.00,3000.00,4000.00,0.00,3000.00,0.31,1
36014,3762,0.00,3000.00,4000.00,0.00,0.00,0.03,0
36015,3762,1000.00,4000.00,5000.00,0.00,4000.00,0.16,1
36016,3762,1000.00,5000.00,6000.00,2275.50,2724.50,0.10,1
36017,3762,1000.00,6000.00,7000.00,2118.23,3827.05,0.31,1
36018,3762,1000.00,7000.00,8000.00,0.00,7000.00,0.40,1
36019,3762,1000.00,8000.00,9000.00,44.28,3609.39,0.29,1
36020,3762,1000.00,9000.00,10000.00,0.00,7317.43,0.33,1
36021,3762,1000.00,10000.00,11000.00,199.33,3964.71,0.27,1
36022,3762,1000.00,11000.00,12000.00,0.00,11000.00,0.30,1
36023,3762,1000.00,12000.00,13000.00,0.00,1733.71,0.01,1
36024,3762,1000.00,13000.00,14000.00,0.00,7802.37,0.26,1
36025,3762,1000.00,14000.00,15000.00,924.56,13075.44,0.37,1
36026,3762,1000.00,15000.00,16000.00,0.00,15000.00,0.23,1
36027,3762,1000.00,16000.00,17000.00,3743.35,12256.65,0.38,1
36028,3762,1000.00,17000.00,18000.00,0.00,16129.07,0.03,1
36029,3762,1000.00,18000.00,19000.00,7685.91,10314.09,0.20,1
36030,3762,1000.00,19000.00,20000.00,0.00,19000.00,0.43,1
36031,3762,-1000.00,18000.00,19000.00,10033.70,9966.30,0.07,0
36032,3762,1000.00,19000.00,20000.00,0.00,18475.52,0.30,1
36033,3762,1000.00,20000.00,21000.00,8631.91,11368.09,0.12,1
36034,3762,1000.00,21000.00,22000.00,2493.20,18506.80,0.43,1
36035,3762,0.00,21000.00,22000.00,0.00,0.00,0.01,0
36036,3762,-1000.00,20000.00,21000.00,0.00,18184.09,0.41,0
36037,3762,-1000.00,19000.00,20000.00,3434.46,17565.54,0.42,0
36038,3762,-1000.00,18000.00,19000.00,5457.50,14542.50,0.36,0
36039,3762,-1000.00,17000.00,18000.00,8734.91,10265.09,0.23,0
36040,3762,-1000.00,16000.00,17000.00,9182.80,8817.20,0.20,0
36041,3762,-1000.00,15000.00,16000.00,0.00,17000.00,0.24,0
36042,3762,-1000.00,14000.00,15000.00,154.54,2840.92,0.17,0
36043,3762,-1000.00,13000.00,14000.00,0.00,15000.00,0.10,0
36044,3762,-1000.00,12000.00,13000.00,1421.60,12578.40,0.43,0
36045,3762,-1000.00,11000.00,12000.00,0.00,13000.00,0.11,0
36046,3762,-1000.00,10000.00,11000.00,1079.47,10920.53,0.21,0
36047,3762,-1000.00,9000.00,10000.00,199.23,10800.77,0.41,0
36048,3762,-1000.00,8000.00,9000.00,0.00,10000.00,0.27,0
36049,3762,-1000.00,7000.00,8000.00,0.00,1710.35,0.11,0
36050,3762,-1000.00,6000.00,7000.00,1943.51,6056.49,0.19,0
36051,3762,-1000.00,5000.00,6000.00,3292.11,3707.89,0.09,0
36052,3762,-1000.00,4000.00,5000.00,0.00,6000.00,0.07,0
36053,3762,-1000.00,3000.00,4000.00,1385.35,3614.65,0.27,0
36054,3762,-219.60,2780.40,3780.40,0.00,219.60,0.07,0
36055,3762,-1000.00,1780.40,2780.40,0.00,1704.33,0.24,0
36056,3763,-1000.00,-1000.00,0.00,270.90,729.10,0.22,0
36057,3764,1000.00,1000.00,2000.00,209.41,790.59,0.39,1
36058,3764,1000.00,2000.00,3000.00,0.00,1294.82,0.32,1
36059,3764,1000.00,3000.00,4000.00,640.46,2359.54,0.26,1
36060,3764,1000.00,4000.00,5000.00,689.29,3310.71,0.16,1
36061,3764,1000.00,5000.00,6000.00,2500.00,2500.00,0.01,1
36062,3764,1000.00,6000.00,7000.00,2635.72,3364.28,0.13,1
36063,3764,1000.00,7000.00,8000.00,3287.58,3712.42,0.14,1
36064,3764,1000.00,8000.00,9000.00,3498.83,4501.17,0.18,1
36065,3764,-1000.00,7000.00,8000.00,5243.51,952.61,0.09,0
36066,3764,1000.00,8000.00,9000.00,4000.00,4000.00,0.10,1
36067,3764,1000.00,9000.00,10000.00,0.00,9000.00,0.26,1
36068,3764,-1000.00,8000.00,9000.00,10000.00,0.00,0.04,0
36069,3764,-1000.00,7000.00,8000.00,3830.67,0.00,0.08,0
36070,3764,-1000.00,6000.00,7000.00,1857.24,0.00,0.01,0
36071,3764,-1000.00,5000.00,6000.00,6758.33,241.67,0.03,0
36072,3764,-1000.00,4000.00,5000.00,1561.89,4438.11,0.20,0
36073,3764,-1000.00,3000.00,4000.00,0.00,4437.07,0.38,0
36074,3764,-1000.00,2000.00,3000.00,426.65,3573.35,0.38,0
36075,3764,-1000.00,1000.00,2000.00,870.58,2129.42,0.32,0
36076,3764,-1000.00,0.00,1000.00,651.48,1261.70,0.24,0
36077,3764,-602.84,-602.84,397.16,0.00,602.84,0.35,0
36078,3764,-341.74,-944.58,55.42,0.00,341.74,0.33,0
36079,3764,-55.42,-1000.00,0.00,0.00,55.42,0.29,0
36080,3765,-1000.00,-1000.00,0.00,160.40,839.60,0.42,0
36081,3765,-0.00,-1000.00,-0.00,0.00,0.00,0.21,0
36082,3766,-1000.00,-1000.00,0.00,835.42,164.58,0.06,0
36083,3767,-1000.00,-1000.00,0.00,417.40,582.60,0.31,0
36084,3768,1000.00,1000.00,2000.00,108.70,891.30,0.43,1
36085,3768,1000.00,2000.00,3000.00,95.56,1904.44,0.40,1
36086,3768,1000.00,3000.00,4000.00,0.00,2844.96,0.38,1
36087,3768,1000.00,4000.00,5000.00,2000.00,2000.00,0.06,1
36088,3768,1000.00,5000.00,6000.00,1536.25,3463.75,0.34,1
36089,3768,1000.00,6000.00,7000.00,0.00,6000.00,0.05,1
36090,3768,1000.00,7000.00,8000.00,3044.10,3955.90,0.13,1
36091,3768,1000.00,8000.00,9000.00,2437.48,5562.52,0.35,1
36092,3768,1000.00,9000.00,10000.00,0.00,9000.00,0.15,1
36093,3768,1000.00,10000.00,11000.00,0.00,10000.00,0.29,1
36094,3768,1000.00,11000.00,12000.00,0.00,11000.00,0.18,1
36095,3768,1000.00,12000.00,13000.00,0.00,12000.00,0.26,1
36096,3768,1000.00,13000.00,14000.00,0.00,9415.33,0.19,1
36097,3768,1000.00,14000.00,15000.00,3236.89,10763.11,0.26,1
36098,3768,1000.00,15000.00,16000.00,330.12,10852.44,0.40,1
36099,3768,1000.00,16000.00,17000.00,2754.87,13245.13,0.14,1
36100,3768,1000.00,17000.00,18000.00,4029.92,6862.91,0.25,1
36101,3768,1000.00,18000.00,19000.00,4148.09,13851.91,0.14,1
36102,3768,-1000.00,17000.00,18000.00,9657.95,0.00,0.05,0
36103,3768,1000.00,18000.00,19000.00,2269.79,8007.20,0.28,1
36104,3768,1000.00,19000.00,20000.00,8537.62,10462.38,0.29,1
36105,3768,-1000.00,18000.00,19000.00,14613.50,5386.50,0.21,0
36106,3768,1000.00,19000.00,20000.00,0.00,17690.74,0.25,1
36107,3768,-1000.00,18000.00,19000.00,0.00,20000.00,0.00,0
36108,3768,-1000.00,17000.00,18000.00,0.00,19000.00,0.35,0
36109,3768,-1000.00,16000.00,17000.00,0.00,11407.84,0.36,0
36110,3768,-1000.00,15000.00,16000.00,0.00,17000.00,0.16,0
36111,3768,-1000.00,14000.00,15000.00,0.00,16000.00,0.01,0
36112,3768,-1000.00,13000.00,14000.00,0.00,15000.00,0.43,0
36113,3768,-1000.00,12000.00,13000.00,5522.61,8477.39,0.24,0
36114,3768,-1000.00,11000.00,12000.00,1868.87,9870.55,0.40,0
36115,3768,-1000.00,10000.00,11000.00,742.94,11257.06,0.35,0
36116,3768,-1000.00,9000.00,10000.00,5966.50,5033.50,0.40,0
36117,3768,-1000.00,8000.00,9000.00,3213.31,6786.69,0.34,0
36118,3768,-1000.00,7000.00,8000.00,0.00,9000.00,0.37,0
36119,3768,-1000.00,6000.00,7000.00,0.00,3296.97,0.27,0
36120,3768,-1000.00,5000.00,6000.00,0.00,7000.00,0.13,0
36121,3768,-1000.00,4000.00,5000.00,0.00,6000.00,0.09,0
36122,3768,-1000.00,3000.00,4000.00,613.16,4386.84,0.43,0
36123,3768,-1000.00,2000.00,3000.00,0.00,3110.16,0.03,0
36124,3768,-1000.00,1000.00,2000.00,1299.72,1700.28,0.13,0
36125,3768,-1000.00,0.00,1000.00,608.17,1391.83,0.31,0
36126,3768,-1000.00,-1000.00,0.00,0.00,1000.00,0.22,0
36127,3769,-1000.00,-1000.00,0.00,380.64,619.36,0.19,0
36128,3770,-544.69,-544.69,455.31,204.33,340.35,0.23,0
36129,3770,-455.31,-1000.00,0.00,148.73,306.59,0.20,0
36130,3771,1000.00,1000.00,2000.00,0.00,226.29,0.18,1
36131,3771,1000.00,2000.00,3000.00,426.50,1573.50,0.10,1
36132,3771,1000.00,3000.00,4000.00,0.00,2907.33,0.39,1
36133,3771,1000.00,4000.00,5000.00,1936.19,2063.81,0.14,1
36134,3771,1000.00,5000.00,6000.00,0.00,4304.10,0.43,1
36135,3771,1000.00,6000.00,7000.00,0.00,6000.00,0.06,1
36136,3771,1000.00,7000.00,8000.00,0.00,7000.00,0.09,1
36137,3771,1000.00,8000.00,9000.00,2212.32,5787.68,0.37,1
36138,3771,-1000.00,7000.00,8000.00,4558.62,4441.38,0.07,0
36139,3771,-1000.00,6000.00,7000.00,4184.34,3815.66,0.13,0
36140,3771,1000.00,7000.00,8000.00,0.00,1063.70,0.15,1
36141,3771,1000.00,8000.00,9000.00,1522.48,6477.52,0.34,1
36142,3771,1000.00,9000.00,10000.00,4015.53,4984.47,0.04,1
36143,3771,1000.00,10000.00,11000.00,0.00,10000.00,0.12,1
36144,3771,1000.00,11000.00,12000.00,1702.69,8480.78,0.40,1
36145,3771,1000.00,12000.00,13000.00,6000.00,6000.00,0.12,1
36146,3771,1000.00,13000.00,14000.00,1852.46,11147.54,0.17,1
36147,3771,1000.00,14000.00,15000.00,0.00,7617.30,0.30,1
36148,3771,1000.00,15000.00,16000.00,3085.40,11914.60,0.41,1
36149,3771,1000.00,16000.00,17000.00,2506.34,13493.66,0.38,1
36150,3771,1000.00,17000.00,18000.00,0.00,17000.00,0.03,1
36151,3771,1000.00,18000.00,19000.00,6494.83,11505.17,0.31,1
36152,3771,1000.00,19000.00,20000.00,8027.51,10972.49,0.41,1
36153,3771,-1000.00,18000.00,19000.00,2789.49,0.00,0.06,0
36154,3771,1000.00,19000.00,20000.00,0.00,12614.72,0.34,1
36155,3771,1000.00,20000.00,21000.00,0.00,20000.00,0.22,1
36156,3771,-1000.00,19000.00,20000.00,4492.91,2122.09,0.14,0
36157,3771,1000.00,20000.00,21000.00,1137.94,15076.80,0.40,1
36158,3771,1000.00,21000.00,22000.00,0.00,3676.74,0.09,1
36159,3771,1000.00,22000.00,23000.00,11000.00,11000.00,0.37,1
36160,3771,1000.00,23000.00,24000.00,0.00,8342.93,0.00,1
36161,3771,1000.00,24000.00,25000.00,0.00,7709.41,0.18,1
36162,3771,1000.00,25000.00,26000.00,10586.55,14413.45,0.34,1
36163,3771,1000.00,26000.00,27000.00,5460.20,20539.80,0.23,1
36164,3771,1000.00,27000.00,28000.00,7571.78,19428.22,0.27,1
36165,3771,1000.00,28000.00,29000.00,94.49,25142.52,0.44,1
36166,3771,1000.00,29000.00,30000.00,8537.27,17719.33,0.32,1
36167,3771,1000.00,30000.00,31000.00,0.00,12349.16,0.09,1
36168,3771,1000.00,31000.00,32000.00,14699.50,16300.50,0.04,1
36169,3771,1000.00,32000.00,33000.00,0.00,1398.97,0.09,1
36170,3771,1000.00,33000.00,34000.00,5999.40,27000.60,0.40,1
36171,3772,-1000.00,-1000.00,0.00,0.00,1000.00,0.21,0
36172,3773,-412.90,-412.90,587.10,0.00,412.90,0.18,0
36173,3773,-587.10,-1000.00,0.00,0.00,587.10,0.40,0
36174,3774,1000.00,1000.00,2000.00,0.00,1000.00,0.04,1
36175,3774,1000.00,2000.00,3000.00,1000.00,1000.00,0.06,1
36176,3774,1000.00,3000.00,4000.00,0.00,2759.04,0.25,1
36177,3774,1000.00,4000.00,5000.00,1217.64,2782.36,0.35,1
36178,3774,1000.00,5000.00,6000.00,651.37,1737.97,0.24,1
36179,3774,1000.00,6000.00,7000.00,0.00,6000.00,0.01,1
36180,3774,1000.00,7000.00,8000.00,0.00,7000.00,0.18,1
36181,3774,-1000.00,6000.00,7000.00,4566.17,3433.83,0.18,0
36182,3774,1000.00,7000.00,8000.00,0.00,2317.74,0.24,1
36183,3774,1000.00,8000.00,9000.00,0.00,8000.00,0.26,1
36184,3774,1000.00,9000.00,10000.00,899.58,8100.42,0.37,1
36185,3774,1000.00,10000.00,11000.00,183.32,7141.61,0.39,1
36186,3774,1000.00,11000.00,12000.00,5007.06,5992.94,0.02,1
36187,3774,-1000.00,10000.00,11000.00,5536.53,5432.22,0.22,0
36188,3774,1000.00,11000.00,12000.00,0.00,11000.00,0.37,1
36189,3774,1000.00,12000.00,13000.00,0.00,12000.00,0.35,1
36190,3774,1000.00,13000.00,14000.00,795.70,12204.30,0.33,1
36191,3774,-1000.00,12000.00,13000.00,6395.53,5870.38,0.28,0
36192,3774,1000.00,13000.00,14000.00,1504.79,5894.95,0.29,1
36193,3774,1000.00,14000.00,15000.00,0.00,5377.16,0.11,1
36194,3774,1000.00,15000.00,16000.00,0.00,13072.85,0.09,1
36195,3774,1000.00,16000.00,17000.00,3408.90,12591.10,0.40,1
36196,3774,-1000.00,15000.00,16000.00,6506.71,10493.29,0.29,0
36197,3774,-1000.00,14000.00,15000.00,1822.91,9562.63,0.35,0
36198,3774,-1000.00,13000.00,14000.00,0.00,9576.90,0.36,0
36199,3774,-1000.00,12000.00,13000.00,0.00,14000.00,0.30,0
36200,3774,-1000.00,11000.00,12000.00,6500.00,6500.00,0.03,0
36201,3774,-1000.00,10000.00,11000.00,0.00,1977.98,0.17,0
36202,3774,-1000.00,9000.00,10000.00,0.00,11000.00,0.39,0
36203,3774,-1000.00,8000.00,9000.00,7011.10,2988.90,0.10,0
36204,3774,-1000.00,7000.00,8000.00,0.00,9000.00,0.25,0
36205,3774,-1000.00,6000.00,7000.00,0.00,8000.00,0.28,0
36206,3774,-1000.00,5000.00,6000.00,0.00,6199.61,0.32,0
36207,3774,-1000.00,4000.00,5000.00,858.41,5141.59,0.42,0
36208,3774,-1000.00,3000.00,4000.00,4008.28,0.00,0.03,0
36209,3774,-1000.00,2000.00,3000.00,0.00,1840.94,0.10,0
36210,3774,-1000.00,1000.00,2000.00,0.00,3000.00,0.31,0
36211,3774,-1000.00,0.00,1000.00,348.90,0.00,0.08,0
36212,3774,-1000.00,-1000.00,0.00,0.00,1000.00,0.44,0
36213,3775,1000.00,1000.00,2000.00,0.00,1000.00,0.01,1
36214,3775,1000.00,2000.00,3000.00,0.00,1732.29,0.43,1
36215,3775,-1000.00,1000.00,2000.00,1112.73,101.29,0.10,0
36216,3775,1000.00,2000.00,3000.00,0.00,2000.00,0.05,1
36217,3775,1000.00,3000.00,4000.00,1171.36,1828.64,0.04,1
36218,3775,1000.00,4000.00,5000.00,0.00,1200.96,0.22,1
36219,3775,1000.00,5000.00,6000.00,0.00,3140.71,0.11,1
36220,3775,1000.00,6000.00,7000.00,1130.66,4869.34,0.41,1
36221,3775,1000.00,7000.00,8000.00,1214.95,5785.05,0.23,1
36222,3775,-1000.00,6000.00,7000.00,3057.96,3017.87,0.21,0
36223,3775,0.00,6000.00,7000.00,0.00,0.00,0.07,0
36224,3775,1000.00,7000.00,8000.00,620.65,6379.35,0.44,1
36225,3775,1000.00,8000.00,9000.00,0.00,7163.17,0.30,1
36226,3775,1000.00,9000.00,10000.00,0.00,9000.00,0.10,1
36227,3775,0.00,9000.00,10000.00,0.00,0.00,0.04,0
36228,3775,1000.00,10000.00,11000.00,0.00,4128.92,0.19,1
36229,3775,1000.00,11000.00,12000.00,5147.31,5852.69,0.30,1
36230,3775,1000.00,12000.00,13000.00,4795.80,7204.20,0.14,1
36231,3775,1000.00,13000.00,14000.00,5473.54,7526.46,0.34,1
36232,3775,1000.00,14000.00,15000.00,0.00,10644.92,0.31,1
36233,3775,1000.00,15000.00,16000.00,0.00,15000.00,0.03,1
36234,3775,1000.00,16000.00,17000.00,0.00,16000.00,0.06,1
36235,3775,1000.00,17000.00,18000.00,0.00,1479.73,0.01,1
36236,3775,1000.00,18000.00,19000.00,3824.60,8373.54,0.28,1
36237,3775,1000.00,19000.00,20000.00,809.09,18190.91,0.43,1
36238,3775,0.00,19000.00,20000.00,0.00,0.00,0.02,0
36239,3775,1000.00,20000.00,21000.00,0.00,20000.00,0.13,1
36240,3775,1000.00,21000.00,22000.00,0.00,1353.66,0.12,1
36241,3775,1000.00,22000.00,23000.00,0.00,20199.21,0.02,1
36242,3775,1000.00,23000.00,24000.00,8709.54,14290.46,0.26,1
36243,3775,-1000.00,22000.00,23000.00,10781.65,0.00,0.03,0
36244,3775,1000.00,23000.00,24000.00,0.00,17782.97,0.36,1
36245,3775,1000.00,24000.00,25000.00,0.00,24000.00,0.19,1
36246,3775,1000.00,25000.00,26000.00,3950.53,21049.47,0.42,1
36247,3775,1000.00,26000.00,27000.00,0.00,26000.00,0.32,1
36248,3775,1000.00,27000.00,28000.00,2234.25,24765.75,0.41,1
36249,3775,1000.00,28000.00,29000.00,0.00,18881.69,0.31,1
36250,3775,-1000.00,27000.00,28000.00,20500.12,8499.88,0.07,0
36251,3775,0.00,27000.00,28000.00,0.00,0.00,0.05,0
36252,3775,1000.00,28000.00,29000.00,0.00,15242.46,0.25,1
36253,3775,1000.00,29000.00,30000.00,0.00,26901.49,0.07,1
36254,3776,1000.00,1000.00,2000.00,350.52,649.48,0.30,1
36255,3776,1000.00,2000.00,3000.00,747.46,1252.54,0.30,1
36256,3776,-486.66,1513.34,2513.34,486.66,0.00,0.02,0
36257,3776,1000.00,2513.34,3513.34,764.95,915.94,0.22,1
36258,3776,1000.00,3513.34,4513.34,1633.51,1658.78,0.22,1
36259,3776,1000.00,4513.34,5513.34,1094.17,3313.95,0.37,1
36260,3776,-1000.00,3513.34,4513.34,3221.69,2291.64,0.33,0
36261,3776,-1000.00,2513.34,3513.34,1581.10,1032.36,0.16,0
36262,3776,1000.00,3513.34,4513.34,0.00,832.62,0.15,1
36263,3776,-1000.00,2513.34,3513.34,2352.30,2161.04,0.10,0
36264,3776,1000.00,3513.34,4513.34,0.00,3513.34,0.01,1
36265,3776,-1000.00,2513.34,3513.34,2899.86,1613.48,0.10,0
36266,3776,1000.00,3513.34,4513.34,1259.38,2253.96,0.23,1
36267,3776,1000.00,4513.34,5513.34,2042.60,2470.74,0.09,1
36268,3776,1000.00,5513.34,6513.34,0.00,5513.34,0.24,1
36269,3776,1000.00,6513.34,7513.34,2171.68,4341.66,0.30,1
36270,3776,-1000.00,5513.34,6513.34,4280.27,3233.07,0.02,0
36271,3776,1000.00,6513.34,7513.34,3256.67,3256.67,0.30,1
36272,3776,1000.00,7513.34,8513.34,0.00,6315.64,0.41,1
36273,3776,1000.00,8513.34,9513.34,1861.87,6651.47,0.35,1
36274,3776,1000.00,9513.34,10513.34,0.00,7323.63,0.41,1
36275,3776,1000.00,10513.34,11513.34,1539.22,8974.12,0.42,1
36276,3776,1000.00,11513.34,12513.34,0.00,11513.34,0.29,1
36277,3776,1000.00,12513.34,13513.34,2140.03,10373.31,0.02,1
36278,3776,1000.00,13513.34,14513.34,2516.69,10996.64,0.34,1
36279,3776,1000.00,14513.34,15513.34,6399.69,8113.65,0.23,1
36280,3776,1000.00,15513.34,16513.34,1191.41,6179.90,0.27,1
36281,3776,1000.00,16513.34,17513.34,0.00,16513.34,0.35,1
36282,3776,1000.00,17513.34,18513.34,1481.75,16031.59,0.44,1
36283,3776,1000.00,18513.34,19513.34,8714.23,9799.11,0.07,1
36284,3776,1000.00,19513.34,20513.34,0.00,19513.34,0.33,1
36285,3776,1000.00,20513.34,21513.34,0.00,18507.39,0.41,1
36286,3776,1000.00,21513.34,22513.34,9864.45,11648.89,0.32,1
36287,3776,1000.00,22513.34,23513.34,1946.00,20567.33,0.20,1
36288,3776,1000.00,23513.34,24513.34,0.00,17932.61,0.27,1
36289,3776,1000.00,24513.34,25513.34,1905.11,22608.23,0.09,1
36290,3777,-1000.00,-1000.00,0.00,0.00,1000.00,0.40,0
36291,3778,-1000.00,-1000.00,0.00,562.14,437.86,0.22,0
36292,3779,-1000.00,-1000.00,0.00,482.09,517.91,0.13,0
36293,3780,-1000.00,-1000.00,0.00,568.75,431.25,0.13,0
36294,3781,-1000.00,-1000.00,0.00,0.00,1000.00,0.05,0
36295,3782,0.00,0.00,1000.00,0.00,0.00,0.04,0
36296,3782,-1000.00,-1000.00,0.00,222.60,777.40,0.28,0
36297,3783,-1000.00,-1000.00,0.00,547.06,452.94,0.09,0
36298,3784,0.00,0.00,1000.00,0.00,0.00,0.02,0
36299,3784,0.00,0.00,1000.00,0.00,0.00,0.16,0
36300,3784,-230.33,-230.33,769.67,230.33,0.00,0.12,0
36301,3784,-1000.00,-1230.33,-230.33,0.00,334.60,0.34,0
36302,3785,1000.00,1000.00,2000.00,0.00,63.44,0.13,1
36303,3785,1000.00,2000.00,3000.00,0.00,2000.00,0.42,1
36304,3785,1000.00,3000.00,4000.00,0.00,2757.40,0.18,1
36305,3785,0.00,3000.00,4000.00,0.00,0.00,0.05,0
36306,3785,1000.00,4000.00,5000.00,0.00,4000.00,0.34,1
36307,3785,1000.00,5000.00,6000.00,0.00,5000.00,0.06,1
36308,3785,1000.00,6000.00,7000.00,0.00,6000.00,0.02,1
36309,3785,1000.00,7000.00,8000.00,2771.92,4228.08,0.24,1
36310,3785,-1000.00,6000.00,7000.00,4654.96,3345.04,0.16,0
36311,3785,1000.00,7000.00,8000.00,0.00,7000.00,0.28,1
36312,3785,1000.00,8000.00,9000.00,4000.00,4000.00,0.03,1
36313,3785,1000.00,9000.00,10000.00,0.00,5553.20,0.10,1
36314,3785,1000.00,10000.00,11000.00,2005.42,7994.58,0.18,1
36315,3785,1000.00,11000.00,12000.00,0.00,11000.00,0.09,1
36316,3785,-1000.00,10000.00,11000.00,2060.66,0.00,0.01,0
36317,3785,-1000.00,9000.00,10000.00,10012.51,987.49,0.03,0
36318,3785,1000.00,10000.00,11000.00,0.00,3268.38,0.10,1
36319,3785,1000.00,11000.00,12000.00,0.00,11000.00,0.08,1
36320,3785,1000.00,12000.00,13000.00,0.00,12000.00,0.36,1
36321,3785,-1000.00,11000.00,12000.00,7309.11,5690.89,0.31,0
36322,3785,-1000.00,10000.00,11000.00,0.00,12000.00,0.43,0
36323,3785,-1000.00,9000.00,10000.00,0.00,10346.65,0.42,0
36324,3785,-1000.00,8000.00,9000.00,0.00,10000.00,0.14,0
36325,3785,-1000.00,7000.00,8000.00,2243.78,0.00,0.07,0
36326,3785,-1000.00,6000.00,7000.00,3655.92,0.00,0.08,0
36327,3785,-1000.00,5000.00,6000.00,0.00,5075.57,0.39,0
36328,3785,-1000.00,4000.00,5000.00,2088.23,3911.77,0.12,0
36329,3785,-1000.00,3000.00,4000.00,0.00,5000.00,0.23,0
36330,3785,-1000.00,2000.00,3000.00,0.00,2825.34,0.39,0
36331,3785,-1000.00,1000.00,2000.00,2423.08,576.92,0.06,0
36332,3785,-1000.00,0.00,1000.00,0.00,1288.32,0.34,0
36333,3785,-660.61,-660.61,339.39,0.00,660.61,0.19,0
36334,3785,0.00,-660.61,339.39,0.00,0.00,0.03,0
36335,3785,-339.39,-1000.00,0.00,0.00,339.39,0.16,0
36336,3786,0.00,0.00,1000.00,0.00,0.00,0.25,0
36337,3786,0.00,0.00,1000.00,0.00,0.00,0.19,0
36338,3786,0.00,0.00,1000.00,0.00,0.00,0.23,0
36339,3786,-413.91,-413.91,586.09,0.00,413.91,0.33,0
36340,3786,-586.09,-1000.00,0.00,243.98,342.11,0.28,0
36341,3787,-1000.00,-1000.00,0.00,236.38,763.62,0.33,0
36342,3788,1000.00,1000.00,2000.00,113.79,886.21,0.42,1
36343,3788,1000.00,2000.00,3000.00,0.00,1045.38,0.28,1
36344,3788,1000.00,3000.00,4000.00,0.00,3000.00,0.42,1
36345,3788,1000.00,4000.00,5000.00,0.00,2590.43,0.36,1
36346,3788,1000.00,5000.00,6000.00,1068.22,3931.78,0.37,1
36347,3788,1000.00,6000.00,7000.00,0.00,1094.76,0.11,1
36348,3788,1000.00,7000.00,8000.00,0.00,6191.06,0.25,1
36349,3788,1000.00,8000.00,9000.00,0.00,3562.25,0.13,1
36350,3788,1000.00,9000.00,10000.00,0.00,1181.57,0.00,1
36351,3788,1000.00,10000.00,11000.00,0.00,10000.00,0.19,1
36352,3788,1000.00,11000.00,12000.00,0.00,11000.00,0.35,1
36353,3788,0.00,11000.00,12000.00,0.00,0.00,0.04,0
36354,3788,1000.00,12000.00,13000.00,0.00,6116.56,0.25,1
36355,3788,1000.00,13000.00,14000.00,0.00,13000.00,0.17,1
36356,3788,1000.00,14000.00,15000.00,1549.64,12450.36,0.38,1
36357,3788,1000.00,15000.00,16000.00,7500.00,7500.00,0.21,1
36358,3788,-1000.00,14000.00,15000.00,10820.65,5179.35,0.24,0
36359,3788,-1000.00,13000.00,14000.00,0.00,15000.00,0.01,0
36360,3788,-1000.00,12000.00,13000.00,5591.81,8408.19,0.15,0
36361,3788,-1000.00,11000.00,12000.00,0.00,5709.48,0.01,0
36362,3788,-1000.00,10000.00,11000.00,0.00,11962.87,0.34,0
36363,3788,-1000.00,9000.00,10000.00,3503.31,7496.69,0.34,0
36364,3788,-1000.00,8000.00,9000.00,0.00,5830.75,0.10,0
36365,3788,-1000.00,7000.00,8000.00,0.00,9000.00,0.13,0
36366,3788,-1000.00,6000.00,7000.00,0.00,8000.00,0.23,0
36367,3788,-1000.00,5000.00,6000.00,2457.60,4542.40,0.32,0
36368,3788,-1000.00,4000.00,5000.00,0.00,4303.57,0.40,0
36369,3788,-1000.00,3000.00,4000.00,0.00,5000.00,0.14,0
36370,3788,-1000.00,2000.00,3000.00,0.00,2272.27,0.23,0
36371,3788,-1000.00,1000.00,2000.00,431.27,1776.80,0.34,0
36372,3788,-1000.00,0.00,1000.00,26.48,1428.16,0.39,0
36373,3788,-1000.00,-1000.00,0.00,0.00,1000.00,0.29,0
36374,3789,-1000.00,-1000.00,0.00,0.00,321.19,0.28,0
36375,3790,-612.54,-612.54,387.46,0.00,612.54,0.33,0
36376,3790,-387.46,-1000.00,0.00,37.12,350.34,0.23,0
36377,3791,-1000.00,-1000.00,0.00,105.43,894.57,0.43,0
36378,3792,-1000.00,-1000.00,0.00,75.28,924.72,0.41,0
36379,3793,1000.00,1000.00,2000.00,48.07,951.93,0.24,1
36380,3793,1000.00,2000.00,3000.00,298.58,1701.42,0.08,1
36381,3793,1000.00,3000.00,4000.00,490.55,2509.45,0.03,1
36382,3793,1000.00,4000.00,5000.00,0.00,3884.57,0.44,1
36383,3793,1000.00,5000.00,6000.00,0.00,2955.17,0.02,1
36384,3793,1000.00,6000.00,7000.00,0.00,4267.22,0.39,1
36385,3793,1000.00,7000.00,8000.00,0.00,2833.52,0.02,1
36386,3793,1000.00,8000.00,9000.00,3487.46,4512.54,0.30,1
36387,3793,1000.00,9000.00,10000.00,762.28,4010.11,0.29,1
36388,3793,1000.00,10000.00,11000.00,2275.42,7724.58,0.07,1
36389,3793,0.00,10000.00,11000.00,0.00,0.00,0.01,0
36390,3793,1000.00,11000.00,12000.00,0.00,11000.00,0.19,1
36391,3793,-1000.00,10000.00,11000.00,6657.48,5342.52,0.10,0
36392,3793,1000.00,11000.00,12000.00,5500.00,5500.00,0.05,1
36393,3793,-1000.00,10000.00,11000.00,8913.88,3086.12,0.07,0
36394,3793,1000.00,11000.00,12000.00,3190.29,7809.71,0.27,1
36395,3793,1000.00,12000.00,13000.00,0.00,8499.16,0.10,1
36396,3793,1000.00,13000.00,14000.00,0.00,13000.00,0.41,1
36397,3793,1000.00,14000.00,15000.00,0.00,4761.36,0.23,1
36398,3793,1000.00,15000.00,16000.00,5234.63,9765.37,0.32,1
36399,3793,1000.00,16000.00,17000.00,0.00,16000.00,0.10,1
36400,3793,1000.00,17000.00,18000.00,8235.33,8764.67,0.32,1
36401,3793,-1000.00,16000.00,17000.00,2141.01,1174.59,0.13,0
36402,3793,-1000.00,15000.00,16000.00,9209.57,7790.43,0.10,0
36403,3793,1000.00,16000.00,17000.00,1353.17,13320.37,0.42,1
36404,3793,1000.00,17000.00,18000.00,606.85,14746.42,0.43,1
36405,3793,-1000.00,16000.00,17000.00,9290.23,8709.77,0.06,0
36406,3793,1000.00,17000.00,18000.00,0.00,17000.00,0.33,1
36407,3793,1000.00,18000.00,19000.00,7137.25,8034.16,0.24,1
36408,3793,1000.00,19000.00,20000.00,0.00,19000.00,0.13,1
36409,3793,-1000.00,18000.00,19000.00,12659.91,6510.34,0.14,0
36410,3793,1000.00,19000.00,20000.00,4200.67,14799.33,0.38,1
36411,3793,1000.00,20000.00,21000.00,9153.62,10846.38,0.23,1
36412,3793,1000.00,21000.00,22000.00,7181.22,13818.78,0.19,1
36413,3793,1000.00,22000.00,23000.00,5191.18,16808.82,0.39,1
36414,3793,1000.00,23000.00,24000.00,9831.04,13168.96,0.39,1
36415,3793,0.00,23000.00,24000.00,0.00,0.00,0.01,0
36416,3793,-1000.00,22000.00,23000.00,12809.45,11190.55,0.15,0
36417,3793,1000.00,23000.00,24000.00,0.00,23000.00,0.13,1
36418,3793,0.00,23000.00,24000.00,0.00,0.00,0.01,0
36419,3793,1000.00,24000.00,25000.00,0.00,24000.00,0.35,1
36420,3793,1000.00,25000.00,26000.00,0.00,12520.59,0.31,1
36421,3793,1000.00,26000.00,27000.00,0.00,26000.00,0.15,1
36422,3793,1000.00,27000.00,28000.00,3276.73,17387.81,0.36,1
36423,3793,1000.00,28000.00,29000.00,2548.31,19410.72,0.38,1
36424,3794,-1000.00,-1000.00,0.00,559.49,150.55,0.28,0
36425,3795,-1000.00,-1000.00,0.00,258.95,741.05,0.38,0
36426,3796,-1000.00,-1000.00,0.00,414.71,585.29,0.05,0
36427,3797,-1000.00,-1000.00,0.00,123.96,876.04,0.43,0
36428,3798,-1000.00,-1000.00,0.00,0.00,1000.00,0.05,0
36429,3799,-1000.00,-1000.00,0.00,420.89,579.11,0.04,0
36430,3800,0.00,0.00,1000.00,0.00,0.00,0.38,0
36431,3800,-460.83,-460.83,539.17,0.00,460.83,0.32,0
36432,3800,-539.17,-1000.00,0.00,180.67,358.50,0.13,0
36433,3801,0.00,0.00,1000.00,0.00,0.00,0.02,0
36434,3801,-1000.00,-1000.00,0.00,460.17,539.83,0.16,0
36435,3802,-866.80,-866.80,133.20,0.00,866.80,0.20,0
36436,3802,184.76,-682.04,317.96,1.31,0.00,0.39,1
36437,3802,-155.94,-837.98,162.02,0.00,155.94,0.02,0
36438,3802,-131.58,-969.56,30.44,43.22,88.36,0.30,0
36439,3802,-30.44,-1000.00,0.00,4.02,26.42,0.30,0
36440,3803,-549.92,-549.92,450.08,549.92,0.00,0.28,0
36441,3803,0.00,-549.92,450.08,0.00,0.00,0.08,0
36442,3803,-450.08,-1000.00,0.00,450.08,0.00,0.02,0
36443,3804,-1000.00,-1000.00,0.00,770.14,0.00,0.04,0
36444,3805,-454.83,-454.83,545.17,0.00,454.83,0.28,0
36445,3805,-545.17,-1000.00,0.00,112.12,433.04,0.40,0
36446,3806,-1000.00,-1000.00,0.00,0.00,1000.00,0.30,0
36447,3807,-751.11,-751.11,248.89,0.00,751.11,0.26,0
36448,3807,-193.88,-944.98,55.02,41.25,152.63,0.35,0
36449,3807,-55.02,-1000.00,0.00,0.00,55.02,0.40,0
36450,3808,-766.81,-766.81,233.19,0.00,766.81,0.39,0
36451,3808,-195.27,-962.08,37.92,6.10,189.18,0.42,0
36452,3808,-37.92,-1000.00,0.00,18.37,19.55,0.05,0
36453,3809,-255.66,-255.66,744.34,255.66,0.00,0.40,0
36454,3809,0.00,-255.66,744.34,0.00,0.00,0.34,0
36455,3809,-1000.00,-1255.66,-255.66,0.00,122.83,0.26,0
36456,3810,-1000.00,-1000.00,0.00,343.64,656.36,0.32,0
36457,3811,0.00,0.00,1000.00,0.00,0.00,0.07,0
36458,3811,-1000.00,-1000.00,0.00,0.00,1000.00,0.13,0
36459,3812,-1000.00,-1000.00,0.00,0.00,627.18,0.32,0
36460,3813,-1000.00,-1000.00,0.00,0.00,1000.00,0.28,0
36461,3814,1000.00,1000.00,2000.00,1000.00,0.00,0.04,1
36462,3814,-1000.00,0.00,1000.00,0.00,1799.73,0.11,0
36463,3814,-353.82,-353.82,646.18,19.87,333.94,0.43,0
36464,3814,-646.18,-1000.00,0.00,60.43,585.75,0.32,0
36465,3815,-952.00,-952.00,48.00,0.00,952.00,0.13,0
36466,3815,-24.97,-976.97,23.03,0.00,24.97,0.29,0
36467,3815,-23.03,-1000.00,0.00,7.83,15.20,0.14,0
36468,3816,1000.00,1000.00,2000.00,0.00,496.51,0.31,1
36469,3816,1000.00,2000.00,3000.00,0.00,976.76,0.05,1
36470,3816,1000.00,3000.00,4000.00,0.00,3000.00,0.05,1
36471,3816,1000.00,4000.00,5000.00,2000.00,2000.00,0.04,1
36472,3816,1000.00,5000.00,6000.00,0.00,3037.13,0.10,1
36473,3816,1000.00,6000.00,7000.00,0.00,3656.95,0.13,1
36474,3816,1000.00,7000.00,8000.00,0.00,7000.00,0.03,1
36475,3816,1000.00,8000.00,9000.00,0.00,8000.00,0.36,1
36476,3816,1000.00,9000.00,10000.00,0.00,9000.00,0.19,1
36477,3816,1000.00,10000.00,11000.00,0.00,994.78,0.14,1
36478,3816,1000.00,11000.00,12000.00,0.00,2246.37,0.17,1
36479,3816,-1000.00,10000.00,11000.00,12000.00,0.00,0.00,0
36480,3816,1000.00,11000.00,12000.00,0.00,11000.00,0.10,1
36481,3816,1000.00,12000.00,13000.00,0.00,12000.00,0.26,1
36482,3816,1000.00,13000.00,14000.00,1214.19,9708.95,0.40,1
36483,3816,1000.00,14000.00,15000.00,0.00,14000.00,0.19,1
36484,3816,1000.00,15000.00,16000.00,0.00,15000.00,0.01,1
36485,3816,1000.00,16000.00,17000.00,5316.97,10683.03,0.06,1
36486,3816,1000.00,17000.00,18000.00,0.00,17000.00,0.40,1
36487,3816,1000.00,18000.00,19000.00,5614.52,12385.48,0.30,1
36488,3816,1000.00,19000.00,20000.00,0.00,19000.00,0.36,1
36489,3816,-1000.00,18000.00,19000.00,15181.44,0.00,0.03,0
36490,3816,1000.00,19000.00,20000.00,3008.92,15991.08,0.43,1
36491,3816,1000.00,20000.00,21000.00,5562.81,14437.19,0.36,1
36492,3816,1000.00,21000.00,22000.00,0.00,21000.00,0.28,1
36493,3816,1000.00,22000.00,23000.00,11000.00,11000.00,0.34,1
36494,3816,1000.00,23000.00,24000.00,10589.25,12410.75,0.09,1
36495,3816,-1000.00,22000.00,23000.00,24000.00,0.00,0.01,0
36496,3816,1000.00,23000.00,24000.00,11500.00,11500.00,0.11,1
36497,3816,1000.00,24000.00,25000.00,0.00,13826.19,0.31,1
36498,3816,1000.00,25000.00,26000.00,0.00,25000.00,0.36,1
36499,3816,-1000.00,24000.00,25000.00,0.00,26000.00,0.12,0
36500,3816,-1000.00,23000.00,24000.00,0.00,25000.00,0.07,0
36501,3816,-1000.00,22000.00,23000.00,0.00,8187.72,0.11,0
36502,3816,-1000.00,21000.00,22000.00,11500.00,11500.00,0.28,0
36503,3816,-1000.00,20000.00,21000.00,3075.01,18924.99,0.32,0
36504,3816,-1000.00,19000.00,20000.00,0.00,21000.00,0.35,0
36505,3816,-1000.00,18000.00,19000.00,0.00,19066.30,0.11,0
36506,3816,-1000.00,17000.00,18000.00,8187.07,9382.98,0.29,0
36507,3816,-1000.00,16000.00,17000.00,6850.62,4145.91,0.30,0
36508,3816,0.00,16000.00,17000.00,0.00,0.00,0.03,0
36509,3817,-1000.00,-1000.00,0.00,1000.00,0.00,0.01,0
36510,3818,1000.00,1000.00,2000.00,262.14,197.42,0.38,1
36511,3818,-1000.00,0.00,1000.00,190.89,1809.11,0.11,0
36512,3818,-1000.00,-1000.00,0.00,395.13,604.87,0.20,0
36513,3819,1000.00,1000.00,2000.00,27.64,972.36,0.36,1
36514,3819,1000.00,2000.00,3000.00,0.00,2000.00,0.04,1
36515,3819,1000.00,3000.00,4000.00,0.00,2499.17,0.12,1
36516,3819,1000.00,4000.00,5000.00,0.00,647.35,0.13,1
36517,3819,1000.00,5000.00,6000.00,0.00,5000.00,0.05,1
36518,3819,1000.00,6000.00,7000.00,0.00,4082.71,0.05,1
36519,3819,0.00,6000.00,7000.00,0.00,0.00,0.06,0
36520,3819,1000.00,7000.00,8000.00,0.00,7000.00,0.32,1
36521,3819,1000.00,8000.00,9000.00,0.00,8000.00,0.12,1
36522,3819,1000.00,9000.00,10000.00,0.00,7892.75,0.41,1
36523,3819,1000.00,10000.00,11000.00,0.00,4312.27,0.28,1
36524,3819,1000.00,11000.00,12000.00,5500.00,5500.00,0.09,1
36525,3819,1000.00,12000.00,13000.00,1961.61,10038.39,0.30,1
36526,3819,1000.00,13000.00,14000.00,0.00,10971.68,0.42,1
36527,3819,1000.00,14000.00,15000.00,0.00,14000.00,0.35,1
36528,3819,1000.00,15000.00,16000.00,0.00,11959.21,0.42,1
36529,3819,1000.00,16000.00,17000.00,4778.59,11221.41,0.33,1
36530,3819,1000.00,17000.00,18000.00,0.00,17000.00,0.12,1
36531,3819,1000.00,18000.00,19000.00,0.00,18000.00,0.23,1
36532,3819,-1000.00,17000.00,18000.00,10424.09,8575.91,0.10,0
36533,3819,1000.00,18000.00,19000.00,0.00,18000.00,0.17,1
36534,3819,1000.00,19000.00,20000.00,0.00,19000.00,0.21,1
36535,3819,-1000.00,18000.00,19000.00,20000.00,0.00,0.00,0
36536,3819,-1000.00,17000.00,18000.00,9500.00,9500.00,0.06,0
36537,3819,-1000.00,16000.00,17000.00,8762.18,9237.82,0.12,0
36538,3819,0.00,16000.00,17000.00,0.00,0.00,0.05,0
36539,3819,-1000.00,15000.00,16000.00,0.00,16618.23,0.11,0
36540,3819,-1000.00,14000.00,15000.00,0.00,16000.00,0.33,0
36541,3819,-1000.00,13000.00,14000.00,0.00,15000.00,0.36,0
36542,3819,-1000.00,12000.00,13000.00,0.00,14000.00,0.18,0
36543,3819,-1000.00,11000.00,12000.00,167.76,12832.24,0.43,0
36544,3819,-1000.00,10000.00,11000.00,0.00,12000.00,0.11,0
36545,3819,-1000.00,9000.00,10000.00,0.00,11000.00,0.30,0
36546,3819,-1000.00,8000.00,9000.00,0.00,10000.00,0.23,0
36547,3819,-1000.00,7000.00,8000.00,4339.15,4660.85,0.39,0
36548,3819,-1000.00,6000.00,7000.00,2608.57,5391.43,0.26,0
36549,3819,-1000.00,5000.00,6000.00,2069.15,4930.85,0.08,0
36550,3819,-1000.00,4000.00,5000.00,2216.49,3783.51,0.18,0
36551,3819,-1000.00,3000.00,4000.00,989.58,4010.42,0.20,0
36552,3819,-1000.00,2000.00,3000.00,0.00,3845.82,0.35,0
36553,3819,-471.96,1528.04,2528.04,0.00,471.96,0.03,0
36554,3819,-1000.00,528.04,1528.04,0.00,2287.89,0.11,0
36555,3819,-1000.00,-471.96,528.04,676.04,852.00,0.07,0
36556,3819,-528.04,-1000.00,0.00,160.14,367.90,0.33,0
36557,3820,-524.88,-524.88,475.12,0.00,524.88,0.28,0
36558,3820,-475.12,-1000.00,0.00,0.00,475.12,0.30,0
36559,3821,-1000.00,-1000.00,0.00,0.00,1000.00,0.04,0
36560,3822,-1000.00,-1000.00,0.00,195.88,804.12,0.14,0
36561,3823,-555.35,-555.35,444.65,51.71,503.64,0.31,0
36562,3823,-444.65,-1000.00,0.00,0.00,444.65,0.27,0
36563,3824,-1000.00,-1000.00,0.00,368.59,587.05,0.35,0
36564,3825,1000.00,1000.00,2000.00,0.00,1000.00,0.17,1
36565,3825,-735.46,264.54,1264.54,735.46,0.00,0.07,0
36566,3825,1000.00,1264.54,2264.54,399.81,864.73,0.31,1
36567,3825,1000.00,2264.54,3264.54,760.32,1504.22,0.28,1
36568,3825,1000.00,3264.54,4264.54,0.00,835.57,0.20,1
36569,3825,1000.00,4264.54,5264.54,0.00,3498.25,0.36,1
36570,3825,1000.00,5264.54,6264.54,1092.96,4171.58,0.07,1
36571,3825,0.00,5264.54,6264.54,0.00,0.00,0.01,0
36572,3825,1000.00,6264.54,7264.54,848.56,5415.98,0.17,1
36573,3825,1000.00,7264.54,8264.54,2731.01,4533.53,0.03,1
36574,3825,-1000.00,6264.54,7264.54,1403.73,0.00,0.05,0
36575,3825,1000.00,7264.54,8264.54,0.00,7264.54,0.40,1
36576,3825,1000.00,8264.54,9264.54,3485.20,4779.35,0.26,1
36577,3825,1000.00,9264.54,10264.54,0.00,9264.54,0.29,1
36578,3825,1000.00,10264.54,11264.54,0.00,10264.54,0.08,1
36579,3825,1000.00,11264.54,12264.54,5632.27,5632.27,0.04,1
36580,3825,-1000.00,10264.54,11264.54,7056.33,2731.57,0.12,0
36581,3825,1000.00,11264.54,12264.54,3102.83,8161.71,0.27,1
36582,3825,1000.00,12264.54,13264.54,4277.98,7986.56,0.18,1
36583,3825,1000.00,13264.54,14264.54,0.00,13264.54,0.24,1
36584,3825,-1000.00,12264.54,13264.54,7168.03,7096.51,0.21,0
36585,3825,-1000.00,11264.54,12264.54,7812.51,5452.03,0.06,0
36586,3825,1000.00,12264.54,13264.54,1953.32,7285.06,0.34,1
36587,3825,1000.00,13264.54,14264.54,0.00,13264.54,0.11,1
36588,3825,1000.00,14264.54,15264.54,7132.27,7132.27,0.06,1
36589,3825,1000.00,15264.54,16264.54,0.00,6764.78,0.19,1
36590,3825,1000.00,16264.54,17264.54,6459.73,9804.81,0.24,1
36591,3825,1000.00,17264.54,18264.54,0.00,12321.04,0.26,1
36592,3825,1000.00,18264.54,19264.54,9132.27,9132.27,0.22,1
36593,3825,1000.00,19264.54,20264.54,0.00,19264.54,0.40,1
36594,3825,-1000.00,18264.54,19264.54,7049.21,1944.74,0.13,0
36595,3825,1000.00,19264.54,20264.54,0.00,19264.54,0.36,1
36596,3825,0.00,19264.54,20264.54,0.00,0.00,0.09,0
36597,3825,1000.00,20264.54,21264.54,0.00,9785.82,0.30,1
36598,3825,1000.00,21264.54,22264.54,0.00,21264.54,0.11,1
36599,3825,-1000.00,20264.54,21264.54,3305.35,0.00,0.07,0
36600,3825,1000.00,21264.54,22264.54,6115.23,15149.32,0.36,1
36601,3825,1000.00,22264.54,23264.54,9788.31,12476.24,0.19,1
36602,3825,-1000.00,21264.54,22264.54,6492.70,4860.02,0.17,0
36603,3826,-1000.00,-1000.00,0.00,145.63,854.37,0.42,0
36604,3827,-1000.00,-1000.00,0.00,326.88,673.12,0.01,0
36605,3828,-1000.00,-1000.00,0.00,449.03,550.97,0.18,0
36606,3829,1000.00,1000.00,2000.00,80.95,919.05,0.43,1
36607,3829,1000.00,2000.00,3000.00,0.00,1268.56,0.14,1
36608,3829,1000.00,3000.00,4000.00,750.11,2249.89,0.38,1
36609,3829,1000.00,4000.00,5000.00,1421.83,2578.17,0.10,1
36610,3829,1000.00,5000.00,6000.00,1100.74,3899.26,0.35,1
36611,3829,1000.00,6000.00,7000.00,2168.08,3831.92,0.26,1
36612,3829,1000.00,7000.00,8000.00,0.00,6476.83,0.42,1
36613,3829,1000.00,8000.00,9000.00,282.35,4384.53,0.33,1
36614,3829,1000.00,9000.00,10000.00,0.00,9000.00,0.31,1
36615,3829,1000.00,10000.00,11000.00,0.00,3811.03,0.26,1
36616,3829,1000.00,11000.00,12000.00,0.00,11000.00,0.41,1
36617,3829,1000.00,12000.00,13000.00,6000.00,6000.00,0.38,1
36618,3829,1000.00,13000.00,14000.00,0.00,13000.00,0.04,1
36619,3829,1000.00,14000.00,15000.00,3084.74,10915.26,0.40,1
36620,3829,1000.00,15000.00,16000.00,0.00,13476.17,0.37,1
36621,3829,-1000.00,14000.00,15000.00,9396.03,6603.97,0.13,0
36622,3829,1000.00,15000.00,16000.00,0.00,15000.00,0.15,1
36623,3829,1000.00,16000.00,17000.00,0.00,5662.22,0.25,1
36624,3829,1000.00,17000.00,18000.00,4985.03,7728.62,0.26,1
36625,3829,1000.00,18000.00,19000.00,0.00,18000.00,0.38,1
36626,3829,1000.00,19000.00,20000.00,0.00,19000.00,0.11,1
36627,3829,1000.00,20000.00,21000.00,10000.00,10000.00,0.21,1
36628,3829,1000.00,21000.00,22000.00,10250.02,10749.98,0.41,1
36629,3829,1000.00,22000.00,23000.00,11000.00,11000.00,0.06,1
36630,3829,1000.00,23000.00,24000.00,1610.14,20727.84,0.43,1
36631,3829,1000.00,24000.00,25000.00,0.00,21938.33,0.20,1
36632,3829,-1000.00,23000.00,24000.00,13496.32,11503.68,0.15,0
36633,3829,1000.00,24000.00,25000.00,10762.28,13168.98,0.27,1
36634,3829,1000.00,25000.00,26000.00,0.00,3605.36,0.04,1
36635,3829,1000.00,26000.00,27000.00,0.00,5904.99,0.10,1
36636,3829,1000.00,27000.00,28000.00,2571.85,24428.15,0.15,1
36637,3829,1000.00,28000.00,29000.00,0.00,7975.44,0.02,1
36638,3829,1000.00,29000.00,30000.00,0.00,27499.42,0.36,1
36639,3829,1000.00,30000.00,31000.00,7416.19,22583.81,0.38,1
36640,3829,1000.00,31000.00,32000.00,0.00,27097.86,0.37,1
36641,3829,1000.00,32000.00,33000.00,6283.13,18357.56,0.33,1
36642,3829,1000.00,33000.00,34000.00,0.00,1218.92,0.12,1
36643,3829,1000.00,34000.00,35000.00,3248.94,7507.27,0.19,1
36644,3829,-1000.00,33000.00,34000.00,25698.47,9301.53,0.08,0
36645,3829,-1000.00,32000.00,33000.00,23136.36,10863.64,0.05,0
36646,3829,1000.00,33000.00,34000.00,0.00,33000.00,0.06,1
36647,3829,0.00,33000.00,34000.00,0.00,0.00,0.00,0
36648,3829,1000.00,34000.00,35000.00,0.00,27231.82,0.42,1
36649,3829,1000.00,35000.00,36000.00,0.00,4979.36,0.02,1
36650,3829,1000.00,36000.00,37000.00,0.00,36000.00,0.37,1
36651,3829,1000.00,37000.00,38000.00,17361.43,19638.57,0.09,1
36652,3830,-1000.00,-1000.00,0.00,636.67,363.33,0.15,0
36653,3831,-1000.00,-1000.00,0.00,183.39,816.61,0.36,0
36654,3832,-266.00,-266.00,734.00,0.00,266.00,0.36,0
36655,3832,1000.00,734.00,1734.00,539.25,194.75,0.05,1
36656,3832,-1000.00,-266.00,734.00,0.00,1674.36,0.44,0
36657,3832,1000.00,734.00,1734.00,604.72,0.00,0.16,1
36658,3832,-1000.00,-266.00,734.00,0.00,1734.00,0.21,0
36659,3832,1000.00,734.00,1734.00,356.95,0.00,0.13,1
36660,3832,-1000.00,-266.00,734.00,0.00,1441.90,0.36,0
36661,3832,0.00,-266.00,734.00,0.00,0.00,0.16,0
36662,3832,1000.00,734.00,1734.00,610.04,103.08,0.17,1
36663,3832,1000.00,1734.00,2734.00,345.99,0.00,0.41,1
36664,3832,1000.00,2734.00,3734.00,1653.62,924.83,0.23,1
36665,3832,-1000.00,1734.00,2734.00,0.00,1956.06,0.21,0
36666,3832,-676.42,1057.59,2057.59,0.00,676.42,0.40,0
36667,3832,0.00,1057.59,2057.59,0.00,0.00,0.26,0
36668,3832,-1000.00,57.59,1057.59,607.03,1450.55,0.28,0
36669,3832,-349.61,-292.02,707.98,0.00,349.61,0.28,0
36670,3832,0.00,-292.02,707.98,0.00,0.00,0.32,0
36671,3832,-325.55,-617.57,382.43,0.00,325.55,0.11,0
36672,3832,-230.49,-848.06,151.94,0.00,230.49,0.08,0
36673,3832,1000.00,151.94,1151.94,40.56,0.00,0.40,1
36674,3832,-256.51,-104.57,895.43,0.00,256.51,0.41,0
36675,3832,-895.43,-1000.00,0.00,0.00,895.43,0.01,0
36676,3833,-1000.00,-1000.00,0.00,309.96,690.04,0.17,0
36677,3834,-1000.00,-1000.00,0.00,0.00,1000.00,0.34,0
36678,3835,0.00,0.00,1000.00,0.00,0.00,0.08,0
36679,3835,-1000.00,-1000.00,0.00,0.00,1000.00,0.21,0
36680,3836,1000.00,1000.00,2000.00,402.61,597.39,0.28,1
36681,3836,1000.00,2000.00,3000.00,0.00,1065.03,0.00,1
36682,3836,1000.00,3000.00,4000.00,200.54,1000.42,0.24,1
36683,3836,1000.00,4000.00,5000.00,0.00,4000.00,0.03,1
36684,3836,1000.00,5000.00,6000.00,1407.28,3093.70,0.32,1
36685,3836,0.00,5000.00,6000.00,0.00,0.00,0.00,0
36686,3836,1000.00,6000.00,7000.00,0.00,779.82,0.09,1
36687,3836,1000.00,7000.00,8000.00,3500.00,3500.00,0.05,1
36688,3836,1000.00,8000.00,9000.00,0.00,5289.67,0.25,1
36689,3836,1000.00,9000.00,10000.00,0.00,9000.00,0.23,1
36690,3836,1000.00,10000.00,11000.00,0.00,9061.65,0.42,1
36691,3836,1000.00,11000.00,12000.00,752.68,10247.32,0.44,1
36692,3836,1000.00,12000.00,13000.00,4641.41,7358.59,0.10,1
36693,3836,-1000.00,11000.00,12000.00,4954.32,1628.75,0.12,0
36694,3836,1000.00,12000.00,13000.00,0.00,12000.00,0.11,1
36695,3836,1000.00,13000.00,14000.00,0.00,7769.07,0.32,1
36696,3836,1000.00,14000.00,15000.00,0.00,3773.65,0.21,1
36697,3836,1000.00,15000.00,16000.00,0.00,5115.30,0.13,1
36698,3836,-1000.00,14000.00,15000.00,9058.99,6941.01,0.17,0
36699,3836,1000.00,15000.00,16000.00,3208.26,11791.74,0.10,1
36700,3836,1000.00,16000.00,17000.00,5026.38,10973.62,0.22,1
36701,3836,1000.00,17000.00,18000.00,0.00,5868.15,0.20,1
36702,3836,1000.00,18000.00,19000.00,0.00,18000.00,0.04,1
36703,3836,0.00,18000.00,19000.00,0.00,0.00,0.00,0
36704,3836,-1000.00,17000.00,18000.00,8690.87,10309.13,0.19,0
36705,3836,-1000.00,16000.00,17000.00,8256.41,9743.59,0.18,0
36706,3836,-1000.00,15000.00,16000.00,3337.43,13662.57,0.41,0
36707,3836,-1000.00,14000.00,15000.00,1661.35,4481.77,0.21,0
36708,3836,-1000.00,13000.00,14000.00,0.00,2445.80,0.01,0
36709,3836,-1000.00,12000.00,13000.00,0.00,7244.43,0.31,0
36710,3836,-1000.00,11000.00,12000.00,3835.89,7332.38,0.30,0
36711,3836,-1000.00,10000.00,11000.00,4861.00,5141.14,0.22,0
36712,3836,-1000.00,9000.00,10000.00,0.00,7922.89,0.23,0
36713,3836,-1000.00,8000.00,9000.00,0.00,10000.00,0.42,0
36714,3836,-1000.00,7000.00,8000.00,805.15,8194.85,0.09,0
36715,3836,-1000.00,6000.00,7000.00,0.00,8000.00,0.12,0
36716,3836,-854.15,5145.85,6145.85,0.00,854.15,0.13,0
36717,3836,-1000.00,4145.85,5145.85,3072.92,3072.92,0.01,0
36718,3836,-526.95,3618.90,4618.90,0.00,526.95,0.13,0
36719,3836,0.00,3618.90,4618.90,0.00,0.00,0.03,0
36720,3836,-1000.00,2618.90,3618.90,1508.60,3110.31,0.31,0
36721,3836,-1000.00,1618.90,2618.90,892.18,2726.72,0.23,0
36722,3836,-1000.00,618.90,1618.90,0.00,2618.90,0.12,0
36723,3836,-997.24,-378.34,621.66,0.00,997.24,0.34,0
36724,3836,-1000.00,-1378.34,-378.34,189.57,0.00,0.07,0
36725,3837,-1000.00,-1000.00,0.00,0.00,54.30,0.42,0
36726,3838,0.00,0.00,1000.00,0.00,977.75,0.44,0
36727,3838,0.00,0.00,1000.00,102.44,360.63,0.25,0
36728,3838,0.00,0.00,1000.00,255.23,744.77,0.38,0
36729,3838,0.00,0.00,1000.00,172.51,827.49,0.32,0
36730,3838,0.00,0.00,1000.00,0.00,955.08,0.43,0
36731,3838,0.00,0.00,1000.00,457.21,542.79,0.23,0
36732,3838,0.00,0.00,1000.00,245.10,754.90,0.21,0
36733,3838,0.00,0.00,1000.00,0.00,1000.00,0.20,0
36734,3838,0.00,0.00,1000.00,299.57,700.43,0.35,0
36735,3838,-1000.00,-1000.00,0.00,567.69,432.31,0.14,0
36736,3839,-1000.00,-1000.00,0.00,311.31,688.69,0.25,0
36737,3840,0.00,0.00,1000.00,0.00,0.00,0.37,0
36738,3840,0.00,0.00,1000.00,0.00,0.00,0.39,0
36739,3840,-1000.00,-1000.00,0.00,299.56,700.44,0.17,0
36740,3841,1000.00,1000.00,2000.00,0.00,420.67,0.22,1
36741,3841,1000.00,2000.00,3000.00,1000.00,1000.00,0.03,1
36742,3841,1000.00,3000.00,4000.00,303.92,2432.42,0.41,1
36743,3841,1000.00,4000.00,5000.00,0.00,4000.00,0.33,1
36744,3841,1000.00,5000.00,6000.00,0.00,5000.00,0.17,1
36745,3841,1000.00,6000.00,7000.00,0.00,6000.00,0.19,1
36746,3841,1000.00,7000.00,8000.00,0.00,7000.00,0.34,1
36747,3841,1000.00,8000.00,9000.00,0.00,8000.00,0.07,1
36748,3841,1000.00,9000.00,10000.00,0.00,2930.46,0.13,1
36749,3841,1000.00,10000.00,11000.00,2456.57,7543.43,0.38,1
36750,3841,1000.00,11000.00,12000.00,4064.56,6935.44,0.12,1
36751,3841,1000.00,12000.00,13000.00,0.00,12000.00,0.01,1
36752,3841,1000.00,13000.00,14000.00,0.00,2705.54,0.18,1
36753,3841,1000.00,14000.00,15000.00,0.00,9419.16,0.08,1
36754,3841,1000.00,15000.00,16000.00,5641.51,9358.49,0.27,1
36755,3841,1000.00,16000.00,17000.00,6774.50,9225.50,0.05,1
36756,3841,1000.00,17000.00,18000.00,3642.53,13357.47,0.40,1
36757,3841,1000.00,18000.00,19000.00,636.34,4278.14,0.20,1
36758,3841,1000.00,19000.00,20000.00,0.00,19000.00,0.23,1
36759,3841,-1000.00,18000.00,19000.00,12142.80,0.00,0.03,0
36760,3841,1000.00,19000.00,20000.00,4517.64,5139.59,0.20,1
36761,3841,1000.00,20000.00,21000.00,0.00,6063.65,0.11,1
36762,3841,-1000.00,19000.00,20000.00,12316.04,8683.96,0.36,0
36763,3841,-1000.00,18000.00,19000.00,5800.89,14199.11,0.36,0
36764,3841,-1000.00,17000.00,18000.00,1701.99,2390.74,0.15,0
36765,3841,-1000.00,16000.00,17000.00,0.00,13034.42,0.33,0
36766,3841,-1000.00,15000.00,16000.00,0.00,15357.55,0.27,0
36767,3841,-1000.00,14000.00,15000.00,3607.36,4585.88,0.20,0
36768,3841,-1000.00,13000.00,14000.00,3422.24,11577.76,0.39,0
36769,3841,-1000.00,12000.00,13000.00,0.00,14000.00,0.04,0
36770,3841,-1000.00,11000.00,12000.00,0.00,11148.79,0.43,0
36771,3841,-1000.00,10000.00,11000.00,318.56,21.16,0.11,0
36772,3841,-1000.00,9000.00,10000.00,595.67,8412.49,0.41,0
36773,3841,-1000.00,8000.00,9000.00,0.00,8384.74,0.42,0
36774,3841,-1000.00,7000.00,8000.00,391.67,8608.33,0.44,0
36775,3841,-1000.00,6000.00,7000.00,570.23,7429.77,0.40,0
36776,3841,-1000.00,5000.00,6000.00,4261.35,2738.65,0.07,0
36777,3841,-1000.00,4000.00,5000.00,0.00,6000.00,0.29,0
36778,3841,-1000.00,3000.00,4000.00,2429.58,0.00,0.07,0
36779,3841,-1000.00,2000.00,3000.00,0.00,4000.00,0.15,0
36780,3841,-1000.00,1000.00,2000.00,1690.07,847.45,0.14,0
36781,3841,-1000.00,0.00,1000.00,0.00,1620.97,0.42,0
36782,3841,-1000.00,-1000.00,0.00,0.00,1000.00,0.01,0
36783,3842,-1000.00,-1000.00,0.00,488.22,511.78,0.12,0
36784,3843,-653.84,-653.84,346.16,0.00,653.84,0.37,0
36785,3843,-242.03,-895.87,104.13,0.00,242.03,0.33,0
36786,3843,-104.13,-1000.00,0.00,0.00,104.13,0.00,0
36787,3844,1000.00,1000.00,2000.00,0.00,924.75,0.29,1
36788,3844,1000.00,2000.00,3000.00,0.00,1519.11,0.03,1
36789,3844,1000.00,3000.00,4000.00,1379.69,1620.31,0.13,1
36790,3844,1000.00,4000.00,5000.00,2000.00,2000.00,0.06,1
36791,3844,1000.00,5000.00,6000.00,650.12,4349.88,0.38,1
36792,3844,1000.00,6000.00,7000.00,2338.66,3661.34,0.22,1
36793,3844,1000.00,7000.00,8000.00,1737.20,5262.80,0.39,1
36794,3844,1000.00,8000.00,9000.00,0.00,8000.00,0.43,1
36795,3844,1000.00,9000.00,10000.00,0.00,3907.45,0.27,1
36796,3844,1000.00,10000.00,11000.00,3375.62,4804.26,0.26,1
36797,3844,1000.00,11000.00,12000.00,0.00,7762.58,0.36,1
36798,3844,1000.00,12000.00,13000.00,0.00,12000.00,0.39,1
36799,3844,1000.00,13000.00,14000.00,0.00,13000.00,0.37,1
36800,3844,1000.00,14000.00,15000.00,0.00,13526.47,0.36,1
36801,3844,1000.00,15000.00,16000.00,0.00,15000.00,0.04,1
36802,3844,-1000.00,14000.00,15000.00,8611.76,7388.24,0.09,0
36803,3844,1000.00,15000.00,16000.00,7500.00,7500.00,0.07,1
36804,3844,1000.00,16000.00,17000.00,6795.67,9204.33,0.27,1
36805,3844,-1000.00,15000.00,16000.00,9901.45,1290.03,0.08,0
36806,3844,1000.00,16000.00,17000.00,6988.70,9011.30,0.14,1
36807,3844,1000.00,17000.00,18000.00,7930.22,9069.78,0.44,1
36808,3844,1000.00,18000.00,19000.00,7670.40,10329.60,0.21,1
36809,3844,1000.00,19000.00,20000.00,7868.96,11131.04,0.05,1
36810,3844,1000.00,20000.00,21000.00,0.00,20000.00,0.12,1
36811,3844,1000.00,21000.00,22000.00,9615.47,11384.53,0.11,1
36812,3844,1000.00,22000.00,23000.00,0.00,9766.64,0.24,1
36813,3844,1000.00,23000.00,24000.00,0.00,23000.00,0.27,1
36814,3844,1000.00,24000.00,25000.00,9578.70,14421.30,0.23,1
36815,3844,0.00,24000.00,25000.00,0.00,0.00,0.09,0
36816,3844,1000.00,25000.00,26000.00,0.00,25000.00,0.30,1
36817,3844,1000.00,26000.00,27000.00,0.00,1706.12,0.06,1
36818,3844,1000.00,27000.00,28000.00,0.00,6991.41,0.12,1
36819,3844,1000.00,28000.00,29000.00,0.00,28000.00,0.20,1
36820,3844,1000.00,29000.00,30000.00,0.00,29000.00,0.05,1
36821,3844,1000.00,30000.00,31000.00,13611.64,16388.36,0.25,1
36822,3844,-1000.00,29000.00,30000.00,31000.00,0.00,0.01,0
36823,3844,1000.00,30000.00,31000.00,0.00,13736.57,0.26,1
36824,3844,1000.00,31000.00,32000.00,5882.41,19605.52,0.35,1
36825,3844,1000.00,32000.00,33000.00,0.00,32000.00,0.04,1
36826,3844,1000.00,33000.00,34000.00,5728.57,27271.43,0.12,1
36827,3844,0.00,33000.00,34000.00,0.00,0.00,0.02,0
36828,3844,1000.00,34000.00,35000.00,2904.77,31095.23,0.44,1
36829,3844,1000.00,35000.00,36000.00,2780.77,18015.79,0.32,1
36830,3844,-1000.00,34000.00,35000.00,21428.00,14572.00,0.35,0
36831,3845,-1000.00,-1000.00,0.00,570.89,429.11,0.18,0
36832,3846,1000.00,1000.00,2000.00,0.00,1000.00,0.15,1
36833,3846,1000.00,2000.00,3000.00,0.00,2000.00,0.16,1
36834,3846,1000.00,3000.00,4000.00,0.00,978.08,0.13,1
36835,3846,1000.00,4000.00,5000.00,1851.06,2148.94,0.13,1
36836,3846,1000.00,5000.00,6000.00,0.00,5000.00,0.42,1
36837,3846,1000.00,6000.00,7000.00,0.00,5549.12,0.44,1
36838,3846,1000.00,7000.00,8000.00,0.00,5070.52,0.40,1
36839,3846,1000.00,8000.00,9000.00,855.17,3491.94,0.28,1
36840,3846,1000.00,9000.00,10000.00,0.00,5476.08,0.16,1
36841,3846,1000.00,10000.00,11000.00,0.00,8113.83,0.30,1
36842,3846,1000.00,11000.00,12000.00,555.11,10244.89,0.44,1
36843,3846,1000.00,12000.00,13000.00,4604.10,7395.90,0.29,1
36844,3846,1000.00,13000.00,14000.00,0.00,4608.94,0.04,1
36845,3846,1000.00,14000.00,15000.00,7000.00,7000.00,0.04,1
36846,3846,1000.00,15000.00,16000.00,0.00,15000.00,0.15,1
36847,3846,1000.00,16000.00,17000.00,0.00,16000.00,0.30,1
36848,3846,1000.00,17000.00,18000.00,0.00,9190.83,0.23,1
36849,3846,1000.00,18000.00,19000.00,7988.05,10011.95,0.34,1
36850,3846,1000.00,19000.00,20000.00,0.00,9662.09,0.08,1
36851,3846,1000.00,20000.00,21000.00,8222.09,11777.91,0.41,1
36852,3846,1000.00,21000.00,22000.00,4915.09,16084.91,0.25,1
36853,3846,1000.00,22000.00,23000.00,11000.00,11000.00,0.12,1
36854,3846,1000.00,23000.00,24000.00,6671.90,16328.10,0.35,1
36855,3846,1000.00,24000.00,25000.00,4255.94,19744.06,0.41,1
36856,3846,1000.00,25000.00,26000.00,0.00,25000.00,0.05,1
36857,3846,1000.00,26000.00,27000.00,0.00,26000.00,0.37,1
36858,3846,1000.00,27000.00,28000.00,0.00,27000.00,0.21,1
36859,3846,1000.00,28000.00,29000.00,0.00,28000.00,0.35,1
36860,3846,1000.00,29000.00,30000.00,0.00,29000.00,0.28,1
36861,3846,-1000.00,28000.00,29000.00,12503.86,10848.83,0.20,0
36862,3846,1000.00,29000.00,30000.00,14500.00,14500.00,0.44,1
36863,3846,1000.00,30000.00,31000.00,14677.25,15322.75,0.04,1
36864,3846,1000.00,31000.00,32000.00,7542.02,23457.98,0.38,1
36865,3846,1000.00,32000.00,33000.00,9968.48,22031.52,0.35,1
36866,3846,1000.00,33000.00,34000.00,5299.61,27700.39,0.40,1
36867,3846,1000.00,34000.00,35000.00,4017.65,15013.37,0.28,1
36868,3846,1000.00,35000.00,36000.00,0.00,35000.00,0.25,1
36869,3846,1000.00,36000.00,37000.00,13131.83,22868.17,0.28,1
36870,3846,1000.00,37000.00,38000.00,0.00,19789.82,0.31,1
36871,3846,1000.00,38000.00,39000.00,8684.20,29315.80,0.23,1
36872,3846,1000.00,39000.00,40000.00,0.00,39000.00,0.28,1
36873,3846,1000.00,40000.00,41000.00,16917.96,23082.04,0.22,1
36874,3846,1000.00,41000.00,42000.00,0.00,27948.84,0.32,1
36875,3847,-1000.00,-1000.00,0.00,269.07,730.93,0.36,0
36876,3848,1000.00,1000.00,2000.00,0.00,1000.00,0.42,1
36877,3848,1000.00,2000.00,3000.00,0.00,2000.00,0.31,1
36878,3848,0.00,2000.00,3000.00,0.00,0.00,0.04,0
36879,3848,1000.00,3000.00,4000.00,1189.78,1810.22,0.14,1
36880,3848,1000.00,4000.00,5000.00,230.34,3769.66,0.22,1
36881,3848,1000.00,5000.00,6000.00,0.00,5000.00,0.20,1
36882,3848,1000.00,6000.00,7000.00,557.29,5442.71,0.16,1
36883,3848,1000.00,7000.00,8000.00,0.00,4704.84,0.33,1
36884,3848,1000.00,8000.00,9000.00,0.00,8000.00,0.33,1
36885,3848,1000.00,9000.00,10000.00,0.00,6748.75,0.37,1
36886,3848,1000.00,10000.00,11000.00,0.00,10000.00,0.22,1
36887,3848,1000.00,11000.00,12000.00,0.00,11000.00,0.06,1
36888,3848,1000.00,12000.00,13000.00,1520.34,9724.59,0.41,1
36889,3848,1000.00,13000.00,14000.00,0.00,13000.00,0.40,1
36890,3848,1000.00,14000.00,15000.00,0.00,14000.00,0.04,1
36891,3848,1000.00,15000.00,16000.00,4156.12,10843.88,0.39,1
36892,3848,-1000.00,14000.00,15000.00,9536.80,6463.20,0.03,0
36893,3848,1000.00,15000.00,16000.00,7317.36,7682.64,0.12,1
36894,3848,1000.00,16000.00,17000.00,0.00,16000.00,0.08,1
36895,3848,1000.00,17000.00,18000.00,0.00,17000.00,0.26,1
36896,3848,1000.00,18000.00,19000.00,0.00,11574.40,0.06,1
36897,3848,1000.00,19000.00,20000.00,640.31,2956.37,0.16,1
36898,3848,1000.00,20000.00,21000.00,2457.97,17542.03,0.31,1
36899,3848,1000.00,21000.00,22000.00,10500.00,10500.00,0.32,1
36900,3848,-1000.00,20000.00,21000.00,0.00,22000.00,0.02,0
36901,3848,-1000.00,19000.00,20000.00,5430.81,15569.19,0.35,0
36902,3848,-1000.00,18000.00,19000.00,0.00,20000.00,0.16,0
36903,3848,-1000.00,17000.00,18000.00,0.00,16013.80,0.10,0
36904,3848,-1000.00,16000.00,17000.00,3630.49,14369.51,0.00,0
36905,3848,-1000.00,15000.00,16000.00,11972.98,5027.02,0.02,0
36906,3848,-1000.00,14000.00,15000.00,0.00,14860.82,0.19,0
36907,3848,-1000.00,13000.00,14000.00,4871.21,10128.79,0.07,0
36908,3848,-1000.00,12000.00,13000.00,0.00,14000.00,0.01,0
36909,3848,-1000.00,11000.00,12000.00,3931.44,9068.56,0.28,0
36910,3848,-1000.00,10000.00,11000.00,0.00,12000.00,0.33,0
36911,3848,-1000.00,9000.00,10000.00,0.00,2174.67,0.13,0
36912,3848,-1000.00,8000.00,9000.00,478.12,9521.88,0.42,0
36913,3848,-1000.00,7000.00,8000.00,3740.95,0.00,0.04,0
36914,3848,-1000.00,6000.00,7000.00,0.00,8000.00,0.02,0
36915,3848,-1000.00,5000.00,6000.00,474.08,2837.75,0.27,0
36916,3848,-1000.00,4000.00,5000.00,0.00,3815.37,0.29,0
36917,3848,-1000.00,3000.00,4000.00,0.00,5000.00,0.37,0
36918,3848,-1000.00,2000.00,3000.00,1517.28,2482.72,0.26,0
36919,3848,-1000.00,1000.00,2000.00,2019.47,980.53,0.12,0
36920,3848,-1000.00,0.00,1000.00,37.91,1281.76,0.37,0
36921,3848,-947.06,-947.06,52.94,0.00,947.06,0.39,0
36922,3848,-20.22,-967.28,32.72,0.00,20.22,0.21,0
36923,3848,-7.73,-975.01,24.99,0.00,7.73,0.18,0
36924,3848,-24.99,-1000.00,0.00,6.57,18.43,0.33,0
36925,3849,1000.00,1000.00,2000.00,0.00,1000.00,0.24,1
36926,3849,1000.00,2000.00,3000.00,409.95,1061.37,0.31,1
36927,3849,1000.00,3000.00,4000.00,0.00,3000.00,0.16,1
36928,3849,1000.00,4000.00,5000.00,0.00,3951.90,0.42,1
36929,3849,1000.00,5000.00,6000.00,0.00,4544.50,0.35,1
36930,3849,1000.00,6000.00,7000.00,0.00,4614.38,0.16,1
36931,3849,1000.00,7000.00,8000.00,0.00,7000.00,0.01,1
36932,3849,1000.00,8000.00,9000.00,1110.72,2826.58,0.24,1
36933,3849,1000.00,9000.00,10000.00,3117.61,5882.39,0.29,1
36934,3849,1000.00,10000.00,11000.00,1217.00,8783.00,0.43,1
36935,3849,1000.00,11000.00,12000.00,0.00,11000.00,0.26,1
36936,3849,1000.00,12000.00,13000.00,3843.29,8156.71,0.06,1
36937,3849,1000.00,13000.00,14000.00,0.00,10087.55,0.41,1
36938,3849,1000.00,14000.00,15000.00,0.00,14000.00,0.34,1
36939,3849,1000.00,15000.00,16000.00,2490.79,12509.21,0.38,1
36940,3849,1000.00,16000.00,17000.00,0.00,16000.00,0.38,1
36941,3849,0.00,16000.00,17000.00,0.00,0.00,0.10,0
36942,3849,1000.00,17000.00,18000.00,6698.79,10301.21,0.24,1
36943,3849,1000.00,18000.00,19000.00,0.00,18000.00,0.16,1
36944,3849,-1000.00,17000.00,18000.00,10415.00,8585.00,0.00,0
36945,3849,1000.00,18000.00,19000.00,0.00,15013.97,0.43,1
36946,3849,1000.00,19000.00,20000.00,0.00,19000.00,0.34,1
36947,3849,1000.00,20000.00,21000.00,3791.76,16208.24,0.23,1
36948,3849,1000.00,21000.00,22000.00,10500.00,10500.00,0.09,1
36949,3849,-1000.00,20000.00,21000.00,11000.00,11000.00,0.05,0
36950,3849,-1000.00,19000.00,20000.00,0.00,21000.00,0.16,0
36951,3849,-1000.00,18000.00,19000.00,0.00,20000.00,0.44,0
36952,3849,-1000.00,17000.00,18000.00,0.00,19000.00,0.44,0
36953,3849,-946.01,16053.99,17053.99,0.00,946.01,0.11,0
36954,3849,-1000.00,15053.99,16053.99,10198.99,6855.00,0.14,0
36955,3849,-1000.00,14053.99,15053.99,0.00,6081.37,0.05,0
36956,3849,-1000.00,13053.99,14053.99,0.00,6902.67,0.26,0
36957,3849,-1000.00,12053.99,13053.99,0.00,14053.99,0.24,0
36958,3849,-1000.00,11053.99,12053.99,0.00,13053.99,0.29,0
36959,3849,-1000.00,10053.99,11053.99,6067.88,5986.11,0.13,0
36960,3849,-1000.00,9053.99,10053.99,0.00,11053.99,0.04,0
36961,3849,-1000.00,8053.99,9053.99,4575.27,5478.73,0.02,0
36962,3849,-1000.00,7053.99,8053.99,0.00,9053.99,0.17,0
36963,3849,-1000.00,6053.99,7053.99,68.60,7985.39,0.31,0
36964,3849,-1000.00,5053.99,6053.99,0.00,7053.99,0.36,0
36965,3849,-1000.00,4053.99,5053.99,0.00,5406.32,0.29,0
36966,3849,-1000.00,3053.99,4053.99,0.00,2914.56,0.07,0
36967,3849,-1000.00,2053.99,3053.99,912.57,3141.42,0.38,0
36968,3849,-1000.00,1053.99,2053.99,1622.67,1431.32,0.14,0
36969,3849,-1000.00,53.99,1053.99,0.00,1561.47,0.38,0
36970,3849,-1000.00,-946.01,53.99,0.00,1053.99,0.15,0
36971,3849,-41.75,-987.76,12.24,0.00,41.75,0.27,0
36972,3849,-7.25,-995.01,4.99,0.00,7.25,0.24,0
36973,3849,-4.99,-1000.00,0.00,0.00,4.99,0.13,0
36974,3850,-1000.00,-1000.00,0.00,543.74,456.26,0.04,0
36975,3851,-1000.00,-1000.00,0.00,23.87,922.13,0.19,0
36976,3852,1000.00,1000.00,2000.00,0.00,1000.00,0.09,1
36977,3852,-1000.00,0.00,1000.00,1381.63,223.90,0.08,0
36978,3852,1000.00,1000.00,2000.00,51.35,473.70,0.30,1
36979,3852,1000.00,2000.00,3000.00,0.00,62.01,0.12,1
36980,3852,-985.95,1014.05,2014.05,985.95,0.00,0.06,0
36981,3852,1000.00,2014.05,3014.05,1007.02,1007.02,0.18,1
36982,3852,-1000.00,1014.05,2014.05,1827.34,1186.70,0.09,0
36983,3852,1000.00,2014.05,3014.05,0.00,1858.62,0.20,1
36984,3852,-1000.00,1014.05,2014.05,2369.84,0.00,0.02,0
36985,3852,1000.00,2014.05,3014.05,989.25,1024.80,0.11,1
36986,3852,1000.00,3014.05,4014.05,0.00,3014.05,0.40,1
36987,3852,1000.00,4014.05,5014.05,0.00,4014.05,0.01,1
36988,3852,1000.00,5014.05,6014.05,407.52,810.55,0.17,1
36989,3852,1000.00,6014.05,7014.05,997.16,5016.89,0.27,1
36990,3852,1000.00,7014.05,8014.05,1520.53,5493.52,0.09,1
36991,3852,1000.00,8014.05,9014.05,0.00,8014.05,0.23,1
36992,3852,1000.00,9014.05,10014.05,0.00,6714.83,0.32,1
36993,3852,1000.00,10014.05,11014.05,0.00,8204.69,0.40,1
36994,3852,0.00,10014.05,11014.05,0.00,0.00,0.09,0
36995,3852,-1000.00,9014.05,10014.05,6963.68,4050.37,0.24,0
36996,3852,1000.00,10014.05,11014.05,655.03,6790.37,0.38,1
36997,3852,-1000.00,9014.05,10014.05,6620.54,2027.72,0.11,0
36998,3852,-637.08,8376.97,9376.97,361.78,275.30,0.12,0
36999,3852,1000.00,9376.97,10376.97,0.00,1421.22,0.15,1
37000,3852,1000.00,10376.97,11376.97,5188.48,5188.48,0.03,1
37001,3852,-1000.00,9376.97,10376.97,4889.33,4081.70,0.19,0
37002,3852,1000.00,10376.97,11376.97,0.00,10376.97,0.33,1
37003,3852,1000.00,11376.97,12376.97,0.00,11376.97,0.04,1
37004,3852,-1000.00,10376.97,11376.97,7845.04,4531.93,0.14,0
37005,3852,1000.00,11376.97,12376.97,3470.44,7906.53,0.27,1
37006,3852,1000.00,12376.97,13376.97,0.00,12376.97,0.07,1
37007,3852,1000.00,13376.97,14376.97,6688.48,6688.48,0.21,1
37008,3852,-1000.00,12376.97,13376.97,7984.31,6392.65,0.18,0
37009,3852,1000.00,13376.97,14376.97,2373.00,10880.33,0.40,1
37010,3852,1000.00,14376.97,15376.97,6229.90,8147.07,0.18,1
37011,3852,1000.00,15376.97,16376.97,0.00,1790.25,0.10,1
37012,3852,1000.00,16376.97,17376.97,0.00,16376.97,0.08,1
37013,3852,1000.00,17376.97,18376.97,0.00,17376.97,0.43,1
37014,3852,1000.00,18376.97,19376.97,0.00,13268.50,0.27,1
37015,3852,1000.00,19376.97,20376.97,6469.89,12907.08,0.10,1
37016,3852,1000.00,20376.97,21376.97,0.00,18872.82,0.25,1
37017,3853,1000.00,1000.00,2000.00,507.84,0.00,0.03,1
37018,3853,-1000.00,0.00,1000.00,0.00,1467.48,0.43,0
37019,3853,-1000.00,-1000.00,0.00,341.84,658.16,0.28,0
37020,3854,1000.00,1000.00,2000.00,0.00,859.33,0.34,1
37021,3854,1000.00,2000.00,3000.00,0.00,2000.00,0.06,1
37022,3854,1000.00,3000.00,4000.00,1362.99,1637.01,0.14,1
37023,3854,1000.00,4000.00,5000.00,0.00,4000.00,0.37,1
37024,3854,1000.00,5000.00,6000.00,0.00,5000.00,0.22,1
37025,3854,1000.00,6000.00,7000.00,0.00,1881.70,0.13,1
37026,3854,1000.00,7000.00,8000.00,0.00,7000.00,0.29,1
37027,3854,1000.00,8000.00,9000.00,0.00,8000.00,0.31,1
37028,3854,1000.00,9000.00,10000.00,0.00,9000.00,0.05,1
37029,3854,1000.00,10000.00,11000.00,5000.00,5000.00,0.04,1
37030,3854,1000.00,11000.00,12000.00,0.00,8265.27,0.33,1
37031,3854,1000.00,12000.00,13000.00,5284.96,6715.04,0.16,1
37032,3854,-1000.00,11000.00,12000.00,8268.91,4731.09,0.23,0
37033,3854,1000.00,12000.00,13000.00,5204.43,6795.57,0.26,1
37034,3854,1000.00,13000.00,14000.00,4723.59,8276.41,0.30,1
37035,3854,1000.00,14000.00,15000.00,0.00,8039.02,0.29,1
37036,3854,1000.00,15000.00,16000.00,0.00,15000.00,0.13,1
37037,3854,1000.00,16000.00,17000.00,0.00,16000.00,0.21,1
37038,3854,1000.00,17000.00,18000.00,3912.17,13087.83,0.39,1
37039,3854,-1000.00,16000.00,17000.00,1013.71,0.00,0.01,0
37040,3854,0.00,16000.00,17000.00,0.00,0.00,0.03,0
37041,3854,-1000.00,15000.00,16000.00,11541.88,5458.12,0.11,0
37042,3854,-1000.00,14000.00,15000.00,3524.16,12475.84,0.14,0
37043,3854,-1000.00,13000.00,14000.00,7552.63,7447.37,0.23,0
37044,3854,-1000.00,12000.00,13000.00,5182.22,8817.78,0.27,0
37045,3854,-1000.00,11000.00,12000.00,4329.02,6449.33,0.27,0
37046,3854,-1000.00,10000.00,11000.00,2450.11,9549.89,0.36,0
37047,3854,-1000.00,9000.00,10000.00,3400.88,7599.12,0.33,0
37048,3854,-1000.00,8000.00,9000.00,0.00,10000.00,0.38,0
37049,3854,-1000.00,7000.00,8000.00,5636.10,3363.90,0.33,0
37050,3854,-1000.00,6000.00,7000.00,0.00,3568.61,0.20,0
37051,3854,-1000.00,5000.00,6000.00,0.00,4392.64,0.36,0
37052,3854,-1000.00,4000.00,5000.00,957.99,3824.49,0.36,0
37053,3854,-1000.00,3000.00,4000.00,2918.63,2081.37,0.39,0
37054,3854,-1000.00,2000.00,3000.00,2300.61,1699.39,0.11,0
37055,3854,-1000.00,1000.00,2000.00,428.29,2571.71,0.40,0
37056,3854,-1000.00,0.00,1000.00,541.00,1459.00,0.35,0
37057,3854,-776.50,-776.50,223.50,0.00,776.50,0.32,0
37058,3854,-223.50,-1000.00,0.00,13.22,210.28,0.16,0
37059,3854,0.00,-1000.00,0.00,0.00,0.00,0.01,0
37060,3854,-0.00,-1000.00,0.00,0.00,0.00,0.32,0
37061,3855,0.00,0.00,1000.00,0.00,0.00,0.17,0
37062,3855,-1000.00,-1000.00,0.00,0.00,134.98,0.40,0
37063,3856,-1000.00,-1000.00,0.00,302.89,697.11,0.36,0
37064,3857,-1000.00,-1000.00,0.00,194.52,805.48,0.27,0
37065,3858,-728.99,-728.99,271.01,728.99,0.00,0.16,0
37066,3858,-222.09,-951.08,48.92,222.09,0.00,0.14,0
37067,3858,-25.29,-976.37,23.63,25.29,0.00,0.26,0
37068,3858,-23.63,-1000.00,0.00,11.82,11.81,0.27,0
37069,3859,1000.00,1000.00,2000.00,343.34,656.66,0.30,1
37070,3859,1000.00,2000.00,3000.00,636.66,1363.34,0.34,1
37071,3859,1000.00,3000.00,4000.00,0.00,714.36,0.18,1
37072,3859,0.00,3000.00,4000.00,0.00,0.00,0.05,0
37073,3859,-1000.00,2000.00,3000.00,2069.66,549.47,0.11,0
37074,3859,1000.00,3000.00,4000.00,0.00,3000.00,0.31,1
37075,3859,1000.00,4000.00,5000.00,1873.38,2126.62,0.09,1
37076,3859,1000.00,5000.00,6000.00,122.15,4264.56,0.43,1
37077,3859,1000.00,6000.00,7000.00,900.73,5099.27,0.38,1
37078,3859,1000.00,7000.00,8000.00,0.00,7000.00,0.14,1
37079,3859,1000.00,8000.00,9000.00,0.00,8000.00,0.28,1
37080,3859,1000.00,9000.00,10000.00,0.00,4683.24,0.03,1
37081,3859,1000.00,10000.00,11000.00,0.00,10000.00,0.29,1
37082,3859,1000.00,11000.00,12000.00,0.00,5802.94,0.32,1
37083,3859,1000.00,12000.00,13000.00,0.00,12000.00,0.41,1
37084,3859,1000.00,13000.00,14000.00,907.95,12092.05,0.38,1
37085,3859,1000.00,14000.00,15000.00,0.00,5815.99,0.19,1
37086,3859,1000.00,15000.00,16000.00,0.00,9733.96,0.35,1
37087,3859,1000.00,16000.00,17000.00,0.00,9126.60,0.32,1
37088,3859,1000.00,17000.00,18000.00,277.38,10971.62,0.38,1
37089,3859,-1000.00,16000.00,17000.00,12300.38,4267.07,0.10,0
37090,3859,-1000.00,15000.00,16000.00,8649.37,8350.63,0.31,0
37091,3859,1000.00,16000.00,17000.00,5088.11,10911.89,0.32,1
37092,3859,-1000.00,15000.00,16000.00,17000.00,0.00,0.01,0
37093,3859,-1000.00,14000.00,15000.00,8524.23,7475.77,0.06,0
37094,3859,1000.00,15000.00,16000.00,0.00,15000.00,0.24,1
37095,3859,1000.00,16000.00,17000.00,0.00,16000.00,0.21,1
37096,3859,1000.00,17000.00,18000.00,4905.84,12094.16,0.33,1
37097,3859,1000.00,18000.00,19000.00,0.00,18000.00,0.04,1
37098,3859,1000.00,19000.00,20000.00,0.00,19000.00,0.34,1
37099,3859,1000.00,20000.00,21000.00,5328.08,14671.92,0.37,1
37100,3859,1000.00,21000.00,22000.00,0.00,12379.05,0.30,1
37101,3859,1000.00,22000.00,23000.00,3183.17,7193.66,0.23,1
37102,3859,-1000.00,21000.00,22000.00,17476.16,5523.84,0.17,0
37103,3859,1000.00,22000.00,23000.00,0.00,16782.08,0.09,1
37104,3859,1000.00,23000.00,24000.00,2911.96,16772.28,0.39,1
37105,3859,1000.00,24000.00,25000.00,0.00,24000.00,0.40,1
37106,3859,1000.00,25000.00,26000.00,4891.96,20108.04,0.34,1
37107,3859,-1000.00,24000.00,25000.00,1027.03,0.00,0.03,0
37108,3859,-1000.00,23000.00,24000.00,25000.00,0.00,0.01,0
37109,3860,-1000.00,-1000.00,0.00,684.39,315.61,0.07,0
37110,3861,1000.00,1000.00,2000.00,0.00,1000.00,0.11,1
37111,3861,1000.00,2000.00,3000.00,538.39,1461.61,0.26,1
37112,3861,1000.00,3000.00,4000.00,0.00,2941.09,0.44,1
37113,3861,1000.00,4000.00,5000.00,198.88,3801.12,0.44,1
37114,3861,-1000.00,3000.00,4000.00,2794.48,128.37,0.08,0
37115,3861,0.00,3000.00,4000.00,0.00,0.00,0.02,0
37116,3861,1000.00,4000.00,5000.00,0.00,1708.04,0.26,1
37117,3861,1000.00,5000.00,6000.00,0.00,2861.30,0.27,1
37118,3861,-1000.00,4000.00,5000.00,3580.80,2419.20,0.11,0
37119,3861,1000.00,5000.00,6000.00,328.33,4671.67,0.19,1
37120,3861,1000.00,6000.00,7000.00,0.00,6000.00,0.05,1
37121,3861,1000.00,7000.00,8000.00,1051.88,5948.12,0.34,1
37122,3861,1000.00,8000.00,9000.00,3433.75,4566.25,0.42,1
37123,3861,1000.00,9000.00,10000.00,0.00,7146.44,0.27,1
37124,3861,1000.00,10000.00,11000.00,0.00,10000.00,0.10,1
37125,3861,1000.00,11000.00,12000.00,0.00,8212.35,0.10,1
37126,3861,1000.00,12000.00,13000.00,6000.00,6000.00,0.03,1
37127,3861,-1000.00,11000.00,12000.00,6977.54,6022.46,0.16,0
37128,3861,1000.00,12000.00,13000.00,6000.00,6000.00,0.30,1
37129,3861,1000.00,13000.00,14000.00,6500.00,6500.00,0.05,1
37130,3861,-1000.00,12000.00,13000.00,1785.20,1696.27,0.15,0
37131,3861,1000.00,13000.00,14000.00,0.00,13000.00,0.36,1
37132,3861,1000.00,14000.00,15000.00,466.20,13533.80,0.35,1
37133,3861,1000.00,15000.00,16000.00,0.00,10854.26,0.38,1
37134,3861,-1000.00,14000.00,15000.00,8300.26,7699.74,0.21,0
37135,3861,-1000.00,13000.00,14000.00,6625.71,4404.24,0.17,0
37136,3861,1000.00,14000.00,15000.00,2933.78,11066.22,0.24,1
37137,3861,1000.00,15000.00,16000.00,0.00,15000.00,0.43,1
37138,3861,1000.00,16000.00,17000.00,5700.85,10299.15,0.04,1
37139,3861,0.00,16000.00,17000.00,0.00,0.00,0.03,0
37140,3861,1000.00,17000.00,18000.00,7778.31,9221.69,0.43,1
37141,3861,1000.00,18000.00,19000.00,6340.93,11659.07,0.32,1
37142,3862,1000.00,1000.00,2000.00,0.00,1000.00,0.04,1
37143,3862,1000.00,2000.00,3000.00,0.00,1737.11,0.23,1
37144,3862,1000.00,3000.00,4000.00,0.00,3000.00,0.13,1
37145,3862,1000.00,4000.00,5000.00,0.00,2021.06,0.14,1
37146,3862,1000.00,5000.00,6000.00,0.00,5000.00,0.22,1
37147,3862,1000.00,6000.00,7000.00,0.00,6000.00,0.13,1
37148,3862,1000.00,7000.00,8000.00,2854.97,4145.03,0.22,1
37149,3862,1000.00,8000.00,9000.00,0.00,8000.00,0.13,1
37150,3862,1000.00,9000.00,10000.00,1401.92,7598.08,0.33,1
37151,3862,1000.00,10000.00,11000.00,0.00,7543.91,0.40,1
37152,3862,1000.00,11000.00,12000.00,2276.74,2976.46,0.20,1
37153,3862,0.00,11000.00,12000.00,0.00,0.00,0.08,0
37154,3862,1000.00,12000.00,13000.00,0.00,12000.00,0.23,1
37155,3862,1000.00,13000.00,14000.00,0.00,11048.56,0.25,1
37156,3862,1000.00,14000.00,15000.00,0.00,6217.68,0.24,1
37157,3862,1000.00,15000.00,16000.00,4386.07,10613.93,0.35,1
37158,3862,1000.00,16000.00,17000.00,0.00,9877.24,0.22,1
37159,3862,1000.00,17000.00,18000.00,0.00,17000.00,0.22,1
37160,3862,1000.00,18000.00,19000.00,3979.54,14020.46,0.37,1
37161,3862,1000.00,19000.00,20000.00,0.00,13697.98,0.38,1
37162,3862,1000.00,20000.00,21000.00,2921.13,17078.87,0.37,1
37163,3862,1000.00,21000.00,22000.00,658.39,7703.41,0.25,1
37164,3862,1000.00,22000.00,23000.00,0.00,7185.78,0.27,1
37165,3862,1000.00,23000.00,24000.00,0.00,16153.39,0.29,1
37166,3862,-1000.00,22000.00,23000.00,18428.25,5571.75,0.03,0
37167,3862,1000.00,23000.00,24000.00,994.73,5545.90,0.20,1
37168,3862,-1000.00,22000.00,23000.00,16349.20,7650.80,0.07,0
37169,3862,1000.00,23000.00,24000.00,0.00,10584.44,0.28,1
37170,3862,1000.00,24000.00,25000.00,12000.00,12000.00,0.03,1
37171,3862,1000.00,25000.00,26000.00,2776.87,22223.13,0.21,1
37172,3862,1000.00,26000.00,27000.00,0.00,14386.61,0.23,1
37173,3862,-1000.00,25000.00,26000.00,5619.52,694.17,0.11,0
37174,3862,1000.00,26000.00,27000.00,0.00,26000.00,0.33,1
37175,3862,1000.00,27000.00,28000.00,8082.84,18917.16,0.06,1
37176,3862,-1000.00,26000.00,27000.00,17776.60,10223.40,0.14,0
37177,3862,1000.00,27000.00,28000.00,10111.83,16888.17,0.30,1
37178,3862,1000.00,28000.00,29000.00,0.00,28000.00,0.12,1
37179,3862,1000.00,29000.00,30000.00,0.00,29000.00,0.29,1
37180,3862,1000.00,30000.00,31000.00,14203.92,15796.08,0.03,1
37181,3862,1000.00,31000.00,32000.00,7901.12,23098.88,0.38,1
37182,3862,1000.00,32000.00,33000.00,0.00,32000.00,0.40,1
37183,3863,1000.00,1000.00,2000.00,658.70,341.30,0.00,1
37184,3863,-823.23,176.77,1176.77,0.00,823.23,0.37,0
37185,3863,1000.00,1176.77,2176.77,421.39,238.33,0.34,1
37186,3863,-1000.00,176.77,1176.77,667.02,1509.75,0.07,0
37187,3863,1000.00,1176.77,2176.77,734.81,0.00,0.14,1
37188,3863,-1000.00,176.77,1176.77,712.76,890.39,0.38,0
37189,3863,-1000.00,-823.23,176.77,588.38,588.38,0.00,0
37190,3863,-176.77,-1000.00,0.00,0.00,176.77,0.07,0
37191,3864,1000.00,1000.00,2000.00,0.00,200.27,0.16,1
37192,3864,1000.00,2000.00,3000.00,0.00,2000.00,0.09,1
37193,3864,1000.00,3000.00,4000.00,0.00,3000.00,0.04,1
37194,3864,1000.00,4000.00,5000.00,1962.07,2037.93,0.22,1
37195,3864,1000.00,5000.00,6000.00,1759.53,3240.47,0.22,1
37196,3864,1000.00,6000.00,7000.00,0.00,6000.00,0.00,1
37197,3864,1000.00,7000.00,8000.00,2660.98,4339.02,0.30,1
37198,3864,1000.00,8000.00,9000.00,1749.29,6250.71,0.40,1
37199,3864,1000.00,9000.00,10000.00,2159.10,6840.90,0.33,1
37200,3864,1000.00,10000.00,11000.00,0.00,3548.97,0.11,1
37201,3864,1000.00,11000.00,12000.00,3492.51,7507.49,0.33,1
37202,3864,1000.00,12000.00,13000.00,845.09,11154.91,0.40,1
37203,3864,1000.00,13000.00,14000.00,3388.51,9611.49,0.30,1
37204,3864,1000.00,14000.00,15000.00,976.44,13023.56,0.09,1
37205,3864,1000.00,15000.00,16000.00,0.00,15000.00,0.12,1
37206,3864,1000.00,16000.00,17000.00,6268.63,9731.37,0.21,1
37207,3864,1000.00,17000.00,18000.00,0.00,17000.00,0.42,1
37208,3864,1000.00,18000.00,19000.00,5904.23,12095.77,0.32,1
37209,3864,1000.00,19000.00,20000.00,0.00,18238.67,0.37,1
37210,3864,1000.00,20000.00,21000.00,0.00,20000.00,0.37,1
37211,3864,1000.00,21000.00,22000.00,0.00,21000.00,0.08,1
37212,3864,1000.00,22000.00,23000.00,0.00,22000.00,0.11,1
37213,3864,-1000.00,21000.00,22000.00,14090.84,0.00,0.06,0
37214,3864,1000.00,22000.00,23000.00,0.00,1185.14,0.08,1
37215,3864,-1000.00,21000.00,22000.00,14771.20,8228.80,0.10,0
37216,3864,0.00,21000.00,22000.00,0.00,0.00,0.03,0
37217,3864,1000.00,22000.00,23000.00,0.00,16432.83,0.35,1
37218,3864,1000.00,23000.00,24000.00,10208.47,12791.53,0.11,1
37219,3864,1000.00,24000.00,25000.00,0.00,18687.71,0.14,1
37220,3864,1000.00,25000.00,26000.00,0.00,14278.90,0.19,1
37221,3864,1000.00,26000.00,27000.00,0.00,21849.24,0.40,1
37222,3864,1000.00,27000.00,28000.00,13500.00,13500.00,0.09,1
37223,3864,1000.00,28000.00,29000.00,13653.14,14346.86,0.44,1
37224,3864,1000.00,29000.00,30000.00,0.00,29000.00,0.41,1
37225,3864,1000.00,30000.00,31000.00,0.00,17035.99,0.30,1
37226,3864,-1000.00,29000.00,30000.00,15555.76,15444.24,0.14,0
37227,3864,1000.00,30000.00,31000.00,11193.59,18806.41,0.30,1
37228,3864,1000.00,31000.00,32000.00,15500.00,15500.00,0.05,1
37229,3864,1000.00,32000.00,33000.00,0.00,32000.00,0.03,1
37230,3864,1000.00,33000.00,34000.00,8444.66,24555.34,0.13,1
37231,3864,1000.00,34000.00,35000.00,17000.00,17000.00,0.08,1
37232,3864,1000.00,35000.00,36000.00,0.00,35000.00,0.13,1
37233,3864,-1000.00,34000.00,35000.00,21443.16,7492.86,0.11,0
37234,3864,1000.00,35000.00,36000.00,0.00,35000.00,0.28,1
37235,3864,1000.00,36000.00,37000.00,0.00,36000.00,0.11,1
37236,3864,-1000.00,35000.00,36000.00,18388.87,10307.13,0.19,0
37237,3864,1000.00,36000.00,37000.00,7378.07,28621.93,0.13,1
37238,3864,1000.00,37000.00,38000.00,0.00,37000.00,0.33,1
37239,3865,-1000.00,-1000.00,0.00,110.95,889.05,0.41,0
37240,3866,1000.00,1000.00,2000.00,563.11,436.89,0.18,1
37241,3866,-1000.00,0.00,1000.00,0.00,2000.00,0.06,0
37242,3866,-1000.00,-1000.00,0.00,236.26,763.74,0.30,0
37243,3867,-447.10,-447.10,552.90,0.00,447.10,0.02,0
37244,3867,-1000.00,-1447.10,-447.10,445.64,0.00,0.01,0
37245,3868,1000.00,1000.00,2000.00,917.10,0.00,0.10,1
37246,3868,-515.87,484.13,1484.13,0.00,515.87,0.21,0
37247,3868,1000.00,1484.13,2484.13,572.35,512.56,0.35,1
37248,3868,1000.00,2484.13,3484.13,1622.62,861.51,0.15,1
37249,3868,0.00,2484.13,3484.13,0.00,0.00,0.15,0
37250,3868,0.00,2484.13,3484.13,0.00,0.00,0.02,0
37251,3868,1000.00,3484.13,4484.13,2481.02,1003.11,0.18,1
37252,3868,1000.00,4484.13,5484.13,2834.47,0.00,0.18,1
37253,3868,-1000.00,3484.13,4484.13,0.00,3839.70,0.40,0
37254,3868,1000.00,4484.13,5484.13,679.66,0.00,0.35,1
37255,3868,-1000.00,3484.13,4484.13,0.00,3620.93,0.38,0
37256,3868,-1000.00,2484.13,3484.13,1629.00,2855.13,0.29,0
37257,3868,-666.31,1817.82,2817.82,0.00,666.31,0.32,0
37258,3868,1000.00,2817.82,3817.82,1916.89,16.80,0.09,1
37259,3868,-1000.00,1817.82,2817.82,1463.18,2354.64,0.06,0
37260,3868,-1000.00,817.82,1817.82,0.00,2537.85,0.33,0
37261,3868,-1000.00,-182.18,817.82,810.53,1007.29,0.23,0
37262,3868,-1000.00,-1182.18,-182.18,0.00,151.26,0.42,0
37263,3869,1000.00,1000.00,2000.00,398.56,41.76,0.34,1
37264,3869,-1000.00,0.00,1000.00,381.20,1322.51,0.32,0
37265,3869,1000.00,1000.00,2000.00,300.86,86.38,0.39,1
37266,3869,-1000.00,0.00,1000.00,654.57,1345.43,0.36,0
37267,3869,-1000.00,-1000.00,0.00,0.00,1000.00,0.21,0
37268,3870,-1000.00,-1000.00,0.00,0.00,1000.00,0.23,0
37269,3871,-1000.00,-1000.00,0.00,0.00,1000.00,0.27,0
37270,3872,-1000.00,-1000.00,0.00,0.00,1000.00,0.25,0
37271,3873,-1000.00,-1000.00,0.00,573.22,426.78,0.15,0
37272,3874,-1000.00,-1000.00,0.00,500.00,500.00,0.01,0
37273,3875,-1000.00,-1000.00,0.00,22.28,977.72,0.32,0
37274,3876,-1000.00,-1000.00,0.00,332.25,667.75,0.08,0
37275,3877,-1000.00,-1000.00,0.00,0.00,1000.00,0.11,0
37276,3878,-1000.00,-1000.00,0.00,391.47,608.53,0.02,0
37277,3879,-1000.00,-1000.00,0.00,0.95,999.05,0.40,0
37278,3880,-1000.00,-1000.00,0.00,106.17,199.19,0.32,0
37279,3881,0.00,0.00,1000.00,0.00,0.00,0.06,0
37280,3881,-942.82,-942.82,57.18,0.00,942.82,0.37,0
37281,3881,-57.18,-1000.00,0.00,0.00,57.18,0.15,0
37282,3882,-1000.00,-1000.00,0.00,0.00,613.72,0.33,0
37283,3883,-1000.00,-1000.00,0.00,0.00,1000.00,0.05,0
37284,3884,1000.00,1000.00,2000.00,250.83,0.00,0.35,1
37285,3884,-1000.00,0.00,1000.00,0.00,1440.55,0.02,0
37286,3884,-1000.00,-1000.00,0.00,306.46,693.54,0.11,0
37287,3885,-596.70,-596.70,403.30,0.00,596.70,0.33,0
37288,3885,1000.00,403.30,1403.30,59.53,9.77,0.36,1
37289,3885,-1000.00,-596.70,403.30,0.00,1244.48,0.32,0
37290,3885,1000.00,403.30,1403.30,403.30,0.00,0.02,1
37291,3885,-1000.00,-596.70,403.30,0.00,1403.30,0.02,0
37292,3885,-337.28,-933.98,66.02,0.00,337.28,0.42,0
37293,3885,1000.00,66.02,1066.02,51.31,14.71,0.08,1
37294,3885,-1000.00,-933.98,66.02,246.86,819.16,0.33,0
37295,3885,-66.02,-1000.00,0.00,6.19,59.82,0.39,0
37296,3886,-402.45,-402.45,597.55,402.45,0.00,0.14,0
37297,3886,-88.38,-490.82,509.18,88.38,0.00,0.34,0
37298,3886,-1000.00,-1490.82,-490.82,85.39,423.79,0.07,0
37299,3887,0.00,0.00,1000.00,0.00,0.00,0.27,0
37300,3887,-583.72,-583.72,416.28,0.00,583.72,0.26,0
37301,3887,-368.37,-952.09,47.91,0.00,368.37,0.04,0
37302,3887,0.00,-952.09,47.91,0.00,0.00,0.40,0
37303,3887,-47.91,-1000.00,0.00,0.00,47.91,0.19,0
37304,3888,-1000.00,-1000.00,0.00,586.41,413.59,0.09,0
37305,3889,0.00,0.00,1000.00,0.00,0.00,0.00,0
37306,3889,1000.00,1000.00,2000.00,0.00,434.57,0.12,1
37307,3889,1000.00,2000.00,3000.00,0.00,2000.00,0.28,1
37308,3889,1000.00,3000.00,4000.00,0.00,44.47,0.11,1
37309,3889,-1000.00,2000.00,3000.00,2164.81,1835.19,0.18,0
37310,3889,1000.00,3000.00,4000.00,882.43,2117.57,0.29,1
37311,3889,1000.00,4000.00,5000.00,615.08,3384.92,0.29,1
37312,3889,1000.00,5000.00,6000.00,1069.30,3930.70,0.27,1
37313,3889,1000.00,6000.00,7000.00,2076.99,3923.01,0.28,1
37314,3889,1000.00,7000.00,8000.00,0.00,7000.00,0.27,1
37315,3889,1000.00,8000.00,9000.00,0.00,4515.15,0.34,1
37316,3889,1000.00,9000.00,10000.00,3633.34,5366.66,0.21,1
37317,3889,-1000.00,8000.00,9000.00,5020.67,0.00,0.07,0
37318,3889,1000.00,9000.00,10000.00,0.00,9000.00,0.03,1
37319,3889,1000.00,10000.00,11000.00,1703.28,8296.72,0.43,1
37320,3889,1000.00,11000.00,12000.00,0.00,11000.00,0.24,1
37321,3889,1000.00,12000.00,13000.00,0.00,3588.95,0.21,1
37322,3889,-1000.00,11000.00,12000.00,4223.93,0.00,0.01,0
37323,3889,1000.00,12000.00,13000.00,0.00,6151.03,0.24,1
37324,3889,1000.00,13000.00,14000.00,0.00,7080.63,0.11,1
37325,3889,1000.00,14000.00,15000.00,0.00,12256.94,0.12,1
37326,3889,1000.00,15000.00,16000.00,6749.58,8250.42,0.27,1
37327,3889,-1000.00,14000.00,15000.00,10734.95,5265.05,0.07,0
37328,3889,1000.00,15000.00,16000.00,4222.89,9926.13,0.34,1
37329,3889,1000.00,16000.00,17000.00,0.00,16000.00,0.03,1
37330,3889,1000.00,17000.00,18000.00,4893.85,6430.80,0.23,1
37331,3889,-1000.00,16000.00,17000.00,0.00,18000.00,0.27,0
37332,3889,0.00,16000.00,17000.00,0.00,0.00,0.40,0
37333,3889,-1000.00,15000.00,16000.00,0.00,41.26,0.37,0
37334,3889,-1000.00,14000.00,15000.00,8933.25,7066.75,0.19,0
37335,3889,0.00,14000.00,15000.00,0.00,0.00,0.31,0
37336,3889,0.00,14000.00,15000.00,0.00,0.00,0.08,0
37337,3889,0.00,14000.00,15000.00,0.00,0.00,0.16,0
37338,3889,-1000.00,13000.00,14000.00,6840.53,8159.47,0.26,0
37339,3889,-1000.00,12000.00,13000.00,0.00,12002.07,0.22,0
37340,3889,-1000.00,11000.00,12000.00,0.00,13000.00,0.43,0
37341,3889,-1000.00,10000.00,11000.00,2102.02,9897.98,0.41,0
37342,3889,-1000.00,9000.00,10000.00,3861.57,7138.43,0.30,0
37343,3889,-1000.00,8000.00,9000.00,5736.25,4263.75,0.12,0
37344,3889,-1000.00,7000.00,8000.00,0.00,4148.37,0.14,0
37345,3889,-1000.00,6000.00,7000.00,5009.38,0.00,0.05,0
37346,3889,-1000.00,5000.00,6000.00,1584.57,5415.43,0.09,0
37347,3889,-1000.00,4000.00,5000.00,0.00,6000.00,0.01,0
37348,3889,0.00,4000.00,5000.00,0.00,0.00,0.27,0
37349,3889,-1000.00,3000.00,4000.00,1885.23,947.84,0.33,0
37350,3890,-1000.00,-1000.00,0.00,0.00,1000.00,0.40,0
37351,3891,-1000.00,-1000.00,0.00,564.31,435.69,0.09,0
37352,3892,-1000.00,-1000.00,0.00,460.27,539.73,0.14,0
37353,3893,1000.00,1000.00,2000.00,389.74,610.26,0.01,1
37354,3893,1000.00,2000.00,3000.00,0.00,1559.22,0.29,1
37355,3893,1000.00,3000.00,4000.00,0.00,3000.00,0.07,1
37356,3893,1000.00,4000.00,5000.00,985.98,3014.02,0.38,1
37357,3893,1000.00,5000.00,6000.00,647.15,4352.85,0.39,1
37358,3893,1000.00,6000.00,7000.00,2455.42,3544.58,0.17,1
37359,3893,1000.00,7000.00,8000.00,1256.06,2977.56,0.27,1
37360,3893,1000.00,8000.00,9000.00,2673.61,5326.39,0.03,1
37361,3893,1000.00,9000.00,10000.00,0.00,8300.95,0.30,1
37362,3893,1000.00,10000.00,11000.00,3960.00,6040.00,0.29,1
37363,3893,1000.00,11000.00,12000.00,3705.40,7294.60,0.15,1
37364,3893,1000.00,12000.00,13000.00,0.00,10362.70,0.23,1
37365,3893,1000.00,13000.00,14000.00,1008.51,11991.49,0.39,1
37366,3893,-1000.00,12000.00,13000.00,14000.00,0.00,0.00,0
37367,3893,1000.00,13000.00,14000.00,6107.25,6892.75,0.14,1
37368,3893,1000.00,14000.00,15000.00,6105.49,7894.51,0.24,1
37369,3893,1000.00,15000.00,16000.00,0.00,14578.23,0.22,1
37370,3893,1000.00,16000.00,17000.00,3457.02,12542.98,0.38,1
37371,3893,1000.00,17000.00,18000.00,1793.44,10839.54,0.36,1
37372,3893,-1000.00,16000.00,17000.00,0.00,16396.30,0.21,0
37373,3893,-1000.00,15000.00,16000.00,6258.42,10472.08,0.30,0
37374,3893,-1000.00,14000.00,15000.00,10081.14,5918.86,0.15,0
37375,3893,-1000.00,13000.00,14000.00,3211.92,11788.08,0.04,0
37376,3893,-1000.00,12000.00,13000.00,6473.68,7526.32,0.22,0
37377,3893,-1000.00,11000.00,12000.00,10043.68,0.00,0.05,0
37378,3893,-1000.00,10000.00,11000.00,0.00,12000.00,0.32,0
37379,3893,-1000.00,9000.00,10000.00,0.00,11000.00,0.41,0
37380,3893,-1000.00,8000.00,9000.00,5573.52,1670.58,0.11,0
37381,3893,-1000.00,7000.00,8000.00,496.97,4686.89,0.32,0
37382,3893,-1000.00,6000.00,7000.00,4219.63,3780.37,0.16,0
37383,3893,-1000.00,5000.00,6000.00,0.00,6621.34,0.42,0
37384,3893,-1000.00,4000.00,5000.00,4086.55,698.63,0.08,0
37385,3893,-1000.00,3000.00,4000.00,2392.69,2607.31,0.12,0
37386,3893,-1000.00,2000.00,3000.00,902.80,3097.20,0.33,0
37387,3893,-1000.00,1000.00,2000.00,496.27,655.92,0.20,0
37388,3893,-1000.00,0.00,1000.00,0.00,1015.13,0.06,0
37389,3893,-1000.00,-1000.00,0.00,223.17,31.51,0.12,0
37390,3894,-1000.00,-1000.00,0.00,465.79,534.21,0.01,0
37391,3895,-1000.00,-1000.00,0.00,0.00,770.93,0.40,0
37392,3896,-1000.00,-1000.00,0.00,348.26,651.74,0.17,0
37393,3897,-1000.00,-1000.00,0.00,188.63,811.37,0.30,0
37394,3898,-1000.00,-1000.00,0.00,0.00,1000.00,0.16,0
37395,3899,1000.00,1000.00,2000.00,22.48,977.52,0.11,1
37396,3899,1000.00,2000.00,3000.00,209.59,1516.85,0.40,1
37397,3899,1000.00,3000.00,4000.00,0.00,3000.00,0.19,1
37398,3899,1000.00,4000.00,5000.00,0.00,4000.00,0.41,1
37399,3899,1000.00,5000.00,6000.00,980.56,3156.50,0.35,1
37400,3899,-1000.00,4000.00,5000.00,4116.90,1883.10,0.03,0
37401,3899,-1000.00,3000.00,4000.00,856.19,4143.81,0.40,0
37402,3899,-1000.00,2000.00,3000.00,414.82,3585.18,0.42,0
37403,3899,-1000.00,1000.00,2000.00,0.00,905.53,0.02,0
37404,3899,-1000.00,0.00,1000.00,501.24,857.44,0.26,0
37405,3899,-1000.00,-1000.00,0.00,272.77,727.23,0.25,0
37406,3900,-157.25,-157.25,842.75,157.25,0.00,0.21,0
37407,3900,-842.75,-1000.00,0.00,607.35,235.40,0.12,0
37408,3901,-1000.00,-1000.00,0.00,0.00,868.37,0.30,0
37409,3902,-37.28,-37.28,962.72,0.00,37.28,0.09,0
37410,3902,0.00,-37.28,962.72,0.00,0.00,0.01,0
37411,3902,-962.72,-1000.00,0.00,277.99,684.74,0.35,0
37412,3903,0.00,0.00,1000.00,0.00,0.00,0.29,0
37413,3903,0.00,0.00,1000.00,0.00,0.00,0.31,0
37414,3903,-893.22,-893.22,106.78,382.37,510.86,0.36,0
37415,3903,-35.06,-928.29,71.71,0.00,35.06,0.43,0
37416,3903,-71.71,-1000.00,0.00,30.02,41.69,0.17,0
37417,3904,-1000.00,-1000.00,0.00,415.86,584.14,0.01,0
37418,3905,-1000.00,-1000.00,0.00,103.42,896.58,0.13,0
37419,3906,-5.97,-5.97,994.03,0.00,5.97,0.43,0
37420,3906,1000.00,994.03,1994.03,126.72,0.00,0.37,1
37421,3906,-1000.00,-5.97,994.03,0.00,1923.00,0.01,0
37422,3906,-994.03,-1000.00,0.00,335.09,658.94,0.00,0
37423,3907,-1000.00,-1000.00,0.00,476.32,523.68,0.04,0
37424,3908,-294.80,-294.80,705.20,161.79,133.01,0.15,0
37425,3908,1000.00,705.20,1705.20,0.00,705.20,0.09,1
37426,3908,1000.00,1705.20,2705.20,55.33,1649.87,0.21,1
37427,3908,1000.00,2705.20,3705.20,792.51,1912.69,0.20,1
37428,3908,0.00,2705.20,3705.20,0.00,0.00,0.02,0
37429,3908,1000.00,3705.20,4705.20,1417.44,2287.76,0.25,1
37430,3908,1000.00,4705.20,5705.20,2352.60,2352.60,0.06,1
37431,3908,1000.00,5705.20,6705.20,0.00,2623.37,0.25,1
37432,3908,1000.00,6705.20,7705.20,2233.59,4471.62,0.18,1
37433,3908,1000.00,7705.20,8705.20,0.00,7705.20,0.19,1
37434,3908,1000.00,8705.20,9705.20,1555.73,3586.35,0.26,1
37435,3908,0.00,8705.20,9705.20,0.00,0.00,0.03,0
37436,3908,1000.00,9705.20,10705.20,0.00,9705.20,0.05,1
37437,3908,1000.00,10705.20,11705.20,230.67,10474.53,0.31,1
37438,3908,1000.00,11705.20,12705.20,0.00,2338.70,0.11,1
37439,3908,1000.00,12705.20,13705.20,0.00,12705.20,0.31,1
37440,3908,1000.00,13705.20,14705.20,6852.60,6852.60,0.03,1
37441,3908,1000.00,14705.20,15705.20,0.00,14705.20,0.28,1
37442,3908,1000.00,15705.20,16705.20,7852.60,7852.60,0.04,1
37443,3908,1000.00,16705.20,17705.20,2645.80,14059.40,0.26,1
37444,3908,1000.00,17705.20,18705.20,4286.28,13418.92,0.23,1
37445,3908,1000.00,18705.20,19705.20,9352.60,9352.60,0.32,1
37446,3908,1000.00,19705.20,20705.20,7917.44,11787.76,0.26,1
37447,3908,1000.00,20705.20,21705.20,9296.84,11408.37,0.11,1
37448,3908,1000.00,21705.20,22705.20,10852.60,10852.60,0.03,1
37449,3908,1000.00,22705.20,23705.20,0.00,22705.20,0.32,1
37450,3908,1000.00,23705.20,24705.20,9035.29,14669.91,0.22,1
37451,3908,1000.00,24705.20,25705.20,0.00,24705.20,0.01,1
37452,3908,-1000.00,23705.20,24705.20,14846.33,10858.88,0.17,0
37453,3908,1000.00,24705.20,25705.20,9996.18,14709.02,0.18,1
37454,3908,1000.00,25705.20,26705.20,0.00,25705.20,0.11,1
37455,3908,-1000.00,24705.20,25705.20,4038.74,864.99,0.12,0
37456,3908,1000.00,25705.20,26705.20,0.00,22263.40,0.43,1
37457,3908,1000.00,26705.20,27705.20,13352.60,13352.60,0.05,1
37458,3908,0.00,26705.20,27705.20,0.00,0.00,0.00,0
37459,3908,1000.00,27705.20,28705.20,2025.14,25680.06,0.35,1
37460,3908,1000.00,28705.20,29705.20,856.28,27848.93,0.36,1
37461,3908,1000.00,29705.20,30705.20,0.00,9641.97,0.13,1
37462,3908,1000.00,30705.20,31705.20,0.00,30705.20,0.25,1
37463,3908,1000.00,31705.20,32705.20,5916.59,25788.61,0.41,1
37464,3908,1000.00,32705.20,33705.20,358.11,32347.09,0.27,1
37465,3908,1000.00,33705.20,34705.20,0.00,19072.00,0.32,1
37466,3908,1000.00,34705.20,35705.20,13032.59,21672.61,0.27,1
37467,3908,1000.00,35705.20,36705.20,0.00,23275.68,0.28,1
37468,3908,1000.00,36705.20,37705.20,13492.66,23212.54,0.27,1
37469,3908,1000.00,37705.20,38705.20,18852.60,18852.60,0.09,1
37470,3908,1000.00,38705.20,39705.20,0.00,38705.20,0.32,1
37471,3908,1000.00,39705.20,40705.20,9143.68,30561.52,0.39,1
37472,3908,1000.00,40705.20,41705.20,3099.02,12880.60,0.23,1
37473,3908,1000.00,41705.20,42705.20,0.00,41705.20,0.10,1
37474,3908,1000.00,42705.20,43705.20,0.00,4727.45,0.11,1
37475,3908,1000.00,43705.20,44705.20,6501.08,37204.12,0.42,1
37476,3908,1000.00,44705.20,45705.20,8565.09,36140.11,0.07,1
37477,3908,1000.00,45705.20,46705.20,7799.82,37905.38,0.41,1
37478,3908,1000.00,46705.20,47705.20,13852.15,32853.06,0.12,1
37479,3908,1000.00,47705.20,48705.20,0.00,47705.20,0.19,1
37480,3908,1000.00,48705.20,49705.20,0.00,48705.20,0.15,1
37481,3908,1000.00,49705.20,50705.20,6964.98,15262.00,0.22,1
37482,3908,1000.00,50705.20,51705.20,0.00,50705.20,0.26,1
37483,3908,1000.00,51705.20,52705.20,11700.27,40004.93,0.37,1
37484,3908,1000.00,52705.20,53705.20,26009.12,26696.08,0.22,1
37485,3908,1000.00,53705.20,54705.20,0.00,11716.48,0.16,1
37486,3908,1000.00,54705.20,55705.20,7109.30,47595.90,0.43,1
37487,3908,1000.00,55705.20,56705.20,23338.27,32366.93,0.10,1
37488,3908,1000.00,56705.20,57705.20,17678.07,39027.13,0.34,1
37489,3908,1000.00,57705.20,58705.20,12621.79,45083.41,0.40,1
37490,3908,1000.00,58705.20,59705.20,0.00,58705.20,0.25,1
37491,3908,1000.00,59705.20,60705.20,0.00,2670.28,0.10,1
37492,3908,1000.00,60705.20,61705.20,17716.33,42988.88,0.36,1
37493,3909,-1000.00,-1000.00,0.00,0.00,1000.00,0.27,0
37494,3910,-884.76,-884.76,115.24,0.00,884.76,0.19,0
37495,3910,-115.24,-1000.00,0.00,24.93,90.31,0.20,0
37496,3911,1000.00,1000.00,2000.00,180.57,312.44,0.22,1
37497,3911,1000.00,2000.00,3000.00,0.00,2000.00,0.06,1
37498,3911,1000.00,3000.00,4000.00,0.00,1809.60,0.35,1
37499,3911,1000.00,4000.00,5000.00,0.00,4000.00,0.36,1
37500,3911,1000.00,5000.00,6000.00,438.47,4561.53,0.44,1
37501,3911,1000.00,6000.00,7000.00,917.31,5082.69,0.42,1
37502,3911,1000.00,7000.00,8000.00,0.00,7000.00,0.42,1
37503,3911,-1000.00,6000.00,7000.00,4216.00,3784.00,0.03,0
37504,3911,1000.00,7000.00,8000.00,0.00,7000.00,0.05,1
37505,3911,1000.00,8000.00,9000.00,0.00,1876.45,0.18,1
37506,3911,-1000.00,7000.00,8000.00,7901.25,0.00,0.01,0
37507,3911,1000.00,8000.00,9000.00,2336.01,3692.48,0.26,1
37508,3911,-1000.00,7000.00,8000.00,0.00,8878.93,0.43,0
37509,3911,-1000.00,6000.00,7000.00,0.00,921.09,0.41,0
37510,3911,-1000.00,5000.00,6000.00,319.29,2626.43,0.26,0
37511,3911,-1000.00,4000.00,5000.00,3627.33,2372.67,0.16,0
37512,3911,-1000.00,3000.00,4000.00,1671.72,283.45,0.34,0
37513,3911,0.00,3000.00,4000.00,0.00,0.00,0.03,0
37514,3911,-1000.00,2000.00,3000.00,1960.83,2039.17,0.23,0
37515,3911,-1000.00,1000.00,2000.00,380.48,416.15,0.42,0
37516,3911,-1000.00,0.00,1000.00,1724.62,0.00,0.14,0
37517,3911,-1000.00,-1000.00,0.00,343.27,656.73,0.28,0
37518,3911,0.00,-1000.00,0.00,0.00,0.00,0.38,1
37519,3911,-0.00,-1000.00,0.00,0.00,0.00,0.44,0
37520,3911,0.00,-1000.00,0.00,0.00,0.00,0.41,1
37521,3911,-0.00,-1000.00,0.00,0.00,0.00,0.31,0
37522,3912,-1000.00,-1000.00,0.00,12.68,987.32,0.25,0
37523,3913,-1000.00,-1000.00,0.00,500.00,500.00,0.01,0
37524,3914,-1000.00,-1000.00,0.00,0.00,1000.00,0.00,0
37525,3915,-1000.00,-1000.00,0.00,0.00,1000.00,0.29,0
37526,3916,-880.25,-880.25,119.75,0.00,880.25,0.40,0
37527,3916,-119.75,-1000.00,0.00,59.88,59.88,0.08,0
37528,3917,-1000.00,-1000.00,0.00,268.07,731.93,0.29,0
37529,3918,-1000.00,-1000.00,0.00,178.95,821.05,0.38,0
37530,3919,-980.69,-980.69,19.31,132.50,848.19,0.42,0
37531,3919,-3.03,-983.73,16.27,0.00,3.03,0.13,0
37532,3919,-16.27,-1000.00,0.00,5.12,11.15,0.33,0
37533,3920,1000.00,1000.00,2000.00,407.16,592.84,0.08,1
37534,3920,1000.00,2000.00,3000.00,586.19,1413.81,0.23,1
37535,3920,1000.00,3000.00,4000.00,1123.53,1876.47,0.26,1
37536,3920,1000.00,4000.00,5000.00,0.00,4000.00,0.31,1
37537,3920,1000.00,5000.00,6000.00,1075.89,1198.21,0.19,1
37538,3920,1000.00,6000.00,7000.00,0.00,6000.00,0.06,1
37539,3920,1000.00,7000.00,8000.00,0.00,5993.97,0.12,1
37540,3920,1000.00,8000.00,9000.00,0.00,8000.00,0.22,1
37541,3920,1000.00,9000.00,10000.00,0.00,9000.00,0.31,1
37542,3920,1000.00,10000.00,11000.00,458.53,4344.84,0.28,1
37543,3920,1000.00,11000.00,12000.00,0.00,11000.00,0.27,1
37544,3920,1000.00,12000.00,13000.00,4258.85,7741.15,0.32,1
37545,3920,-1000.00,11000.00,12000.00,973.62,661.13,0.13,0
37546,3920,1000.00,12000.00,13000.00,684.08,11315.92,0.39,1
37547,3920,1000.00,13000.00,14000.00,6500.00,6500.00,0.02,1
37548,3920,1000.00,14000.00,15000.00,0.00,2138.79,0.14,1
37549,3920,1000.00,15000.00,16000.00,2679.92,12320.08,0.41,1
37550,3920,1000.00,16000.00,17000.00,0.00,16000.00,0.23,1
37551,3920,1000.00,17000.00,18000.00,0.00,17000.00,0.08,1
37552,3920,-1000.00,16000.00,17000.00,10339.34,7660.66,0.24,0
37553,3920,1000.00,17000.00,18000.00,0.00,11853.04,0.33,1
37554,3920,1000.00,18000.00,19000.00,3810.41,10614.76,0.33,1
37555,3920,1000.00,19000.00,20000.00,0.00,13116.72,0.38,1
37556,3920,1000.00,20000.00,21000.00,6832.35,13167.65,0.23,1
37557,3920,1000.00,21000.00,22000.00,10500.00,10500.00,0.20,1
37558,3920,1000.00,22000.00,23000.00,0.00,22000.00,0.07,1
37559,3920,1000.00,23000.00,24000.00,0.00,23000.00,0.12,1
37560,3920,1000.00,24000.00,25000.00,12000.00,12000.00,0.02,1
37561,3920,-1000.00,23000.00,24000.00,10857.04,8426.04,0.18,0
37562,3920,1000.00,24000.00,25000.00,1404.37,22595.63,0.42,1
37563,3920,-1000.00,23000.00,24000.00,16835.58,8164.42,0.11,0
37564,3920,1000.00,24000.00,25000.00,0.00,24000.00,0.25,1
37565,3920,1000.00,25000.00,26000.00,0.00,21963.44,0.34,1
37566,3920,1000.00,26000.00,27000.00,0.00,26000.00,0.24,1
37567,3920,1000.00,27000.00,28000.00,1217.38,25782.62,0.40,1
37568,3920,1000.00,28000.00,29000.00,14000.00,14000.00,0.03,1
37569,3920,-1000.00,27000.00,28000.00,15754.95,13245.05,0.30,0
37570,3921,-1000.00,-1000.00,0.00,482.56,517.44,0.22,0
37571,3922,1000.00,1000.00,2000.00,10.47,989.53,0.42,1
37572,3922,-1000.00,0.00,1000.00,58.86,938.62,0.30,0
37573,3922,-1000.00,-1000.00,0.00,0.00,1000.00,0.09,0
37574,3923,-687.40,-687.40,312.60,0.00,687.40,0.37,0
37575,3923,-312.60,-1000.00,0.00,0.00,312.60,0.03,0
37576,3924,-1000.00,-1000.00,0.00,324.46,675.54,0.26,0
37577,3925,-460.66,-460.66,539.34,0.00,460.66,0.28,0
37578,3925,-539.34,-1000.00,0.00,0.00,539.34,0.20,0
37579,3926,1000.00,1000.00,2000.00,0.00,1000.00,0.00,1
37580,3926,1000.00,2000.00,3000.00,0.00,2000.00,0.09,1
37581,3926,1000.00,3000.00,4000.00,35.88,2964.12,0.43,1
37582,3926,1000.00,4000.00,5000.00,0.00,4000.00,0.15,1
37583,3926,1000.00,5000.00,6000.00,1561.22,3438.78,0.10,1
37584,3926,1000.00,6000.00,7000.00,0.00,5266.59,0.01,1
37585,3926,1000.00,7000.00,8000.00,3394.95,3605.05,0.12,1
37586,3926,-1000.00,6000.00,7000.00,0.00,8000.00,0.22,0
37587,3926,-1000.00,5000.00,6000.00,1634.69,0.00,0.35,0
37588,3926,0.00,5000.00,6000.00,0.00,0.00,0.08,0
37589,3926,-1000.00,4000.00,5000.00,6000.00,0.00,0.03,0
37590,3926,0.00,4000.00,5000.00,0.00,0.00,0.37,0
37591,3926,-1000.00,3000.00,4000.00,0.00,5000.00,0.02,0
37592,3926,-1000.00,2000.00,3000.00,1790.02,2209.98,0.12,0
37593,3926,-158.95,1841.05,2841.05,158.95,0.00,0.41,0
37594,3926,-1000.00,841.05,1841.05,946.30,1508.91,0.26,0
37595,3926,-590.46,250.58,1250.58,590.46,0.00,0.24,0
37596,3926,0.00,250.58,1250.58,0.00,0.00,0.13,0
37597,3926,-661.14,-410.55,589.45,374.22,286.92,0.36,0
37598,3926,-1000.00,-1410.55,-410.55,235.81,353.64,0.20,0
37599,3927,-1000.00,-1000.00,0.00,0.00,1000.00,0.20,0
37600,3928,1000.00,1000.00,2000.00,0.00,1000.00,0.13,1
37601,3928,1000.00,2000.00,3000.00,0.00,2000.00,0.41,1
37602,3928,1000.00,3000.00,4000.00,0.00,2897.39,0.16,1
37603,3928,1000.00,4000.00,5000.00,0.00,2259.75,0.33,1
37604,3928,1000.00,5000.00,6000.00,1243.77,3756.23,0.39,1
37605,3928,1000.00,6000.00,7000.00,2777.23,3222.77,0.10,1
37606,3928,1000.00,7000.00,8000.00,1456.53,5543.47,0.01,1
37607,3928,1000.00,8000.00,9000.00,0.00,8000.00,0.10,1
37608,3928,1000.00,9000.00,10000.00,0.00,9000.00,0.30,1
37609,3928,1000.00,10000.00,11000.00,0.00,10000.00,0.28,1
37610,3928,1000.00,11000.00,12000.00,0.00,11000.00,0.07,1
37611,3928,-1000.00,10000.00,11000.00,5997.13,5587.63,0.21,0
37612,3928,1000.00,11000.00,12000.00,0.00,6301.57,0.26,1
37613,3928,1000.00,12000.00,13000.00,0.00,9437.58,0.41,1
37614,3928,1000.00,13000.00,14000.00,5956.65,7043.35,0.10,1
37615,3928,1000.00,14000.00,15000.00,0.00,1490.62,0.15,1
37616,3928,1000.00,15000.00,16000.00,2178.13,12821.87,0.37,1
37617,3928,-1000.00,14000.00,15000.00,15399.53,0.00,0.03,0
37618,3928,1000.00,15000.00,16000.00,3059.22,11940.78,0.41,1
37619,3928,-1000.00,14000.00,15000.00,2820.46,6205.04,0.10,0
37620,3928,-1000.00,13000.00,14000.00,1122.06,13084.67,0.43,0
37621,3928,-1000.00,12000.00,13000.00,0.00,1151.70,0.05,0
37622,3928,-1000.00,11000.00,12000.00,3384.64,9615.36,0.19,0
37623,3928,-1000.00,10000.00,11000.00,0.00,1747.86,0.03,0
37624,3928,-1000.00,9000.00,10000.00,495.25,4909.04,0.29,0
37625,3928,-1000.00,8000.00,9000.00,5000.00,5000.00,0.39,0
37626,3928,-1000.00,7000.00,8000.00,2482.42,3152.41,0.22,0
37627,3928,-1000.00,6000.00,7000.00,1606.37,5771.99,0.38,0
37628,3928,-1000.00,5000.00,6000.00,0.00,7000.00,0.11,0
37629,3928,-1000.00,4000.00,5000.00,1121.23,4878.77,0.28,0
37630,3928,-1000.00,3000.00,4000.00,0.00,5000.00,0.19,0
37631,3928,-1000.00,2000.00,3000.00,1327.12,2672.88,0.28,0
37632,3928,-1000.00,1000.00,2000.00,0.00,3000.00,0.16,0
37633,3928,-1000.00,0.00,1000.00,668.15,1331.85,0.30,0
37634,3928,-1000.00,-1000.00,0.00,0.00,1000.00,0.27,0
37635,3929,-1000.00,-1000.00,0.00,137.86,291.41,0.37,0
37636,3930,1000.00,1000.00,2000.00,394.82,605.18,0.29,1
37637,3930,-1000.00,0.00,1000.00,961.89,100.08,0.10,0
37638,3930,1000.00,1000.00,2000.00,0.00,885.43,0.26,1
37639,3930,1000.00,2000.00,3000.00,839.82,1160.18,0.08,1
37640,3930,1000.00,3000.00,4000.00,953.50,2046.50,0.33,1
37641,3930,1000.00,4000.00,5000.00,0.00,2312.49,0.30,1
37642,3930,1000.00,5000.00,6000.00,0.00,5000.00,0.25,1
37643,3930,1000.00,6000.00,7000.00,1001.05,4998.95,0.40,1
37644,3930,1000.00,7000.00,8000.00,0.00,3416.26,0.07,1
37645,3930,1000.00,8000.00,9000.00,2091.03,5908.97,0.30,1
37646,3930,1000.00,9000.00,10000.00,4017.02,4982.98,0.17,1
37647,3930,1000.00,10000.00,11000.00,0.00,10000.00,0.08,1
37648,3930,1000.00,11000.00,12000.00,0.00,6490.22,0.23,1
37649,3930,1000.00,12000.00,13000.00,850.26,11149.74,0.21,1
37650,3930,1000.00,13000.00,14000.00,0.00,13000.00,0.22,1
37651,3930,1000.00,14000.00,15000.00,0.00,14000.00,0.05,1
37652,3930,-1000.00,13000.00,14000.00,7680.23,7319.77,0.13,0
37653,3930,1000.00,14000.00,15000.00,4031.31,9968.69,0.25,1
37654,3930,1000.00,15000.00,16000.00,0.00,4612.17,0.09,1
37655,3930,1000.00,16000.00,17000.00,8000.00,8000.00,0.42,1
37656,3930,1000.00,17000.00,18000.00,0.00,11625.89,0.08,1
37657,3931,1000.00,1000.00,2000.00,519.15,480.85,0.21,1
37658,3931,-1000.00,0.00,1000.00,615.76,1384.24,0.15,0
37659,3931,-263.99,-263.99,736.01,0.00,263.99,0.18,0
37660,3931,-327.06,-591.06,408.94,0.00,327.06,0.28,0
37661,3931,-202.29,-793.35,206.65,0.00,202.29,0.22,0
37662,3931,-61.04,-854.38,145.62,0.00,61.04,0.18,0
37663,3931,0.00,-854.38,145.62,0.00,0.00,0.17,0
37664,3931,0.00,-854.38,145.62,0.00,0.00,0.17,0
37665,3931,-36.64,-891.02,108.98,0.00,36.64,0.37,0
37666,3931,-22.51,-913.53,86.47,0.00,22.51,0.37,0
37667,3931,-8.92,-922.45,77.55,0.00,8.92,0.40,0
37668,3931,0.00,-922.45,77.55,0.00,0.00,0.02,0
37669,3931,-77.55,-1000.00,0.00,0.00,77.55,0.03,0
37670,3932,-437.30,-437.30,562.70,0.00,437.30,0.28,0
37671,3932,-562.70,-1000.00,0.00,64.04,498.66,0.19,0
37672,3933,-599.42,-599.42,400.58,0.00,599.42,0.21,0
37673,3933,-267.63,-867.05,132.95,0.00,267.63,0.35,0
37674,3933,-65.49,-932.54,67.46,0.00,65.49,0.31,0
37675,3933,-67.46,-1000.00,0.00,0.00,67.46,0.29,0
37676,3934,-1000.00,-1000.00,0.00,430.21,569.79,0.25,0
37677,3935,-1000.00,-1000.00,0.00,439.28,560.72,0.09,0
37678,3936,-680.66,-680.66,319.34,464.48,216.18,0.16,0
37679,3936,-1000.00,-1680.66,-680.66,115.85,190.89,0.32,0
37680,3937,-616.69,-616.69,383.31,0.00,616.69,0.11,0
37681,3937,-383.31,-1000.00,0.00,0.00,383.31,0.30,0
37682,3938,-1000.00,-1000.00,0.00,0.00,366.26,0.05,0
37683,3939,-1000.00,-1000.00,0.00,0.00,1000.00,0.39,0
37684,3940,-746.42,-746.42,253.58,729.00,17.42,0.21,0
37685,3940,0.00,-746.42,253.58,0.00,0.00,0.31,0
37686,3940,-117.91,-864.33,135.67,117.91,0.00,0.25,0
37687,3940,-113.82,-978.15,21.85,113.82,0.00,0.12,0
37688,3940,-1000.00,-1978.15,-978.15,0.00,5.42,0.27,0
37689,3941,-1000.00,-1000.00,0.00,0.00,1000.00,0.08,0
37690,3942,-1000.00,-1000.00,0.00,0.00,1000.00,0.24,0
37691,3943,-1000.00,-1000.00,0.00,0.00,1000.00,0.23,0
37692,3944,-1000.00,-1000.00,0.00,742.23,257.77,0.06,0
37693,3945,-1000.00,-1000.00,0.00,0.00,1000.00,0.17,0
37694,3946,-1000.00,-1000.00,0.00,0.00,1000.00,0.33,0
37695,3947,1000.00,1000.00,2000.00,0.00,1000.00,0.04,1
37696,3947,1000.00,2000.00,3000.00,0.00,2000.00,0.06,1
37697,3947,1000.00,3000.00,4000.00,0.00,2465.28,0.36,1
37698,3947,1000.00,4000.00,5000.00,0.00,2493.27,0.08,1
37699,3947,1000.00,5000.00,6000.00,0.00,5000.00,0.22,1
37700,3947,1000.00,6000.00,7000.00,2737.17,3262.83,0.13,1
37701,3947,1000.00,7000.00,8000.00,0.00,6512.95,0.44,1
37702,3947,1000.00,8000.00,9000.00,0.00,1258.42,0.04,1
37703,3947,-1000.00,7000.00,8000.00,4507.93,4492.07,0.18,0
37704,3947,1000.00,8000.00,9000.00,0.00,3401.96,0.24,1
37705,3947,1000.00,9000.00,10000.00,608.05,7172.13,0.41,1
37706,3947,1000.00,10000.00,11000.00,3363.51,6636.49,0.20,1
37707,3947,1000.00,11000.00,12000.00,460.14,1873.76,0.42,1
37708,3947,1000.00,12000.00,13000.00,0.00,9680.43,0.42,1
37709,3947,-1000.00,11000.00,12000.00,7929.41,5070.59,0.14,0
37710,3947,1000.00,12000.00,13000.00,0.00,11272.84,0.16,1
37711,3947,1000.00,13000.00,14000.00,5145.37,7854.63,0.21,1
37712,3947,1000.00,14000.00,15000.00,6414.39,7585.61,0.15,1
37713,3947,1000.00,15000.00,16000.00,7018.64,7981.36,0.21,1
37714,3947,1000.00,16000.00,17000.00,3643.30,12356.70,0.39,1
37715,3947,1000.00,17000.00,18000.00,0.00,10525.26,0.21,1
37716,3947,1000.00,18000.00,19000.00,6568.13,11431.87,0.14,1
37717,3947,-1000.00,17000.00,18000.00,2798.18,0.00,0.08,0
37718,3947,1000.00,18000.00,19000.00,0.00,1048.46,0.06,1
37719,3947,-1000.00,17000.00,18000.00,9500.00,9500.00,0.18,0
37720,3947,-1000.00,16000.00,17000.00,0.00,11220.11,0.23,0
37721,3947,-1000.00,15000.00,16000.00,4076.12,12923.88,0.39,0
37722,3947,-1000.00,14000.00,15000.00,0.00,11870.56,0.39,0
37723,3947,-1000.00,13000.00,14000.00,2292.85,0.00,0.09,0
37724,3947,-1000.00,12000.00,13000.00,0.00,14000.00,0.38,0
37725,3947,-1000.00,11000.00,12000.00,0.00,13000.00,0.03,0
37726,3947,-1000.00,10000.00,11000.00,4534.66,5898.00,0.25,0
37727,3947,-1000.00,9000.00,10000.00,0.00,9302.51,0.32,0
37728,3947,-1000.00,8000.00,9000.00,4587.66,3140.29,0.17,0
37729,3947,-1000.00,7000.00,8000.00,0.00,5765.54,0.36,0
37730,3947,-1000.00,6000.00,7000.00,2662.98,5337.02,0.32,0
37731,3947,-1000.00,5000.00,6000.00,0.00,7000.00,0.15,0
37732,3947,-1000.00,4000.00,5000.00,1706.90,4293.10,0.33,0
37733,3947,-1000.00,3000.00,4000.00,0.00,5000.00,0.34,0
37734,3947,-1000.00,2000.00,3000.00,2479.55,1520.45,0.01,0
37735,3947,-1000.00,1000.00,2000.00,76.54,2602.43,0.43,0
37736,3947,-1000.00,0.00,1000.00,817.45,1182.55,0.12,0
37737,3947,-1000.00,-1000.00,0.00,88.36,911.64,0.06,0
37738,3948,-249.25,-249.25,750.75,0.00,249.25,0.23,0
37739,3948,-423.60,-672.86,327.14,136.00,287.60,0.35,0
37740,3948,-245.09,-917.95,82.05,0.00,245.09,0.14,0
37741,3948,-51.65,-969.59,30.41,1.42,50.22,0.27,0
37742,3948,-11.43,-981.02,18.98,0.00,11.43,0.36,0
37743,3948,-1.61,-982.63,17.37,0.00,1.61,0.41,0
37744,3948,-13.83,-996.46,3.54,0.00,13.83,0.16,0
37745,3948,-2.77,-999.24,0.76,0.00,2.77,0.18,0
37746,3948,178.01,-821.22,178.78,0.58,0.18,0.05,1
37747,3948,1000.00,178.78,1178.78,82.38,64.47,0.29,1
37748,3948,1000.00,1178.78,2178.78,933.55,0.00,0.04,1
37749,3948,-147.61,1031.16,2031.16,0.00,147.61,0.41,0
37750,3948,1000.00,2031.16,3031.16,1750.17,280.99,0.08,1
37751,3948,0.00,2031.16,3031.16,0.00,0.00,0.33,0
37752,3948,0.00,2031.16,3031.16,0.00,0.00,0.20,0
37753,3948,1000.00,3031.16,4031.16,1582.60,0.00,0.29,1
37754,3948,1000.00,4031.16,5031.16,628.55,0.00,0.34,1
37755,3948,0.00,4031.16,5031.16,0.00,0.00,0.11,0
37756,3948,-1000.00,3031.16,4031.16,0.00,2489.29,0.20,0
37757,3948,0.00,3031.16,4031.16,0.00,0.00,0.39,0
37758,3948,1000.00,4031.16,5031.16,503.73,0.00,0.35,1
37759,3948,-1000.00,3031.16,4031.16,0.00,1805.37,0.12,0
37760,3948,-1000.00,2031.16,3031.16,0.00,410.53,0.38,0
37761,3948,0.00,2031.16,3031.16,0.00,0.00,0.24,0
37762,3948,-840.52,1190.64,2190.64,840.52,0.00,0.13,0
37763,3948,-1000.00,190.64,1190.64,0.00,1210.68,0.31,0
37764,3948,-1000.00,-809.36,190.64,1058.95,0.00,0.13,0
37765,3948,-1000.00,-1809.36,-809.36,0.00,20.27,0.37,0
37766,3949,-1000.00,-1000.00,0.00,4.50,995.50,0.43,0
37767,3949,-0.00,-1000.00,0.00,0.00,0.00,0.11,0
37768,3949,-0.00,-1000.00,0.00,0.00,0.00,0.03,0
37769,3949,-0.00,-1000.00,0.00,0.00,0.00,0.33,0
37770,3949,-0.00,-1000.00,0.00,0.00,0.00,0.43,0
37771,3950,-410.05,-410.05,589.95,0.00,410.05,0.24,0
37772,3950,-589.95,-1000.00,-0.00,29.18,560.77,0.35,0
37773,3951,-604.22,-604.22,395.78,559.57,44.65,0.08,0
37774,3951,1000.00,395.78,1395.78,0.00,395.78,0.16,1
37775,3951,1000.00,1395.78,2395.78,564.75,831.03,0.29,1
37776,3951,1000.00,2395.78,3395.78,0.00,2395.78,0.27,1
37777,3951,1000.00,3395.78,4395.78,1697.89,1697.89,0.06,1
37778,3951,1000.00,4395.78,5395.78,530.92,3864.86,0.42,1
37779,3951,1000.00,5395.78,6395.78,2549.78,2846.00,0.15,1
37780,3951,1000.00,6395.78,7395.78,920.38,1789.87,0.21,1
37781,3951,1000.00,7395.78,8395.78,0.00,5985.01,0.41,1
37782,3951,1000.00,8395.78,9395.78,0.00,2854.51,0.21,1
37783,3951,1000.00,9395.78,10395.78,0.00,9395.78,0.14,1
37784,3951,1000.00,10395.78,11395.78,3065.66,7330.12,0.36,1
37785,3951,1000.00,11395.78,12395.78,0.00,11395.78,0.12,1
37786,3951,1000.00,12395.78,13395.78,0.00,5135.69,0.22,1
37787,3951,1000.00,13395.78,14395.78,6697.89,6697.89,0.00,1
37788,3951,1000.00,14395.78,15395.78,5915.02,8480.76,0.27,1
37789,3951,1000.00,15395.78,16395.78,6084.91,9310.87,0.38,1
37790,3951,1000.00,16395.78,17395.78,0.00,11761.20,0.39,1
37791,3951,1000.00,17395.78,18395.78,0.00,17395.78,0.05,1
37792,3951,1000.00,18395.78,19395.78,3219.58,15176.20,0.37,1
37793,3951,1000.00,19395.78,20395.78,0.00,19395.78,0.02,1
37794,3951,1000.00,20395.78,21395.78,0.00,20395.78,0.37,1
37795,3951,1000.00,21395.78,22395.78,0.00,21395.78,0.05,1
37796,3951,1000.00,22395.78,23395.78,0.00,22395.78,0.09,1
37797,3951,-1000.00,21395.78,22395.78,0.00,23395.78,0.12,0
37798,3951,-1000.00,20395.78,21395.78,0.00,10762.87,0.30,0
37799,3951,-1000.00,19395.78,20395.78,9305.14,12090.64,0.15,0
37800,3951,-1000.00,18395.78,19395.78,9744.50,10651.28,0.14,0
37801,3951,-1000.00,17395.78,18395.78,0.00,19395.78,0.33,0
37802,3951,-1000.00,16395.78,17395.78,9381.02,9014.76,0.15,0
37803,3951,-1000.00,15395.78,16395.78,6710.27,10685.51,0.25,0
37804,3951,0.00,15395.78,16395.78,0.00,0.00,0.08,0
37805,3951,-1000.00,14395.78,15395.78,10369.54,6026.24,0.04,0
37806,3951,-1000.00,13395.78,14395.78,0.00,9885.85,0.17,0
37807,3951,0.00,13395.78,14395.78,0.00,0.00,0.03,0
37808,3951,-1000.00,12395.78,13395.78,0.00,2633.01,0.15,0
37809,3951,-1000.00,11395.78,12395.78,3750.19,9645.59,0.15,0
37810,3951,-1000.00,10395.78,11395.78,8710.69,3685.09,0.06,0
37811,3951,-1000.00,9395.78,10395.78,2514.58,8881.20,0.29,0
37812,3951,-1000.00,8395.78,9395.78,0.00,10395.78,0.39,0
37813,3951,-1000.00,7395.78,8395.78,0.00,9395.78,0.25,0
37814,3951,-1000.00,6395.78,7395.78,682.86,7186.74,0.43,0
37815,3951,-1000.00,5395.78,6395.78,3551.66,1308.71,0.13,0
37816,3951,-1000.00,4395.78,5395.78,0.00,6395.78,0.26,0
37817,3951,-1000.00,3395.78,4395.78,252.57,2379.23,0.29,0
37818,3951,-1000.00,2395.78,3395.78,2201.76,2194.02,0.20,0
37819,3951,-1000.00,1395.78,2395.78,53.59,1789.04,0.33,0
37820,3951,-1000.00,395.78,1395.78,83.98,2311.80,0.36,0
37821,3951,-1000.00,-604.22,395.78,661.26,734.53,0.14,0
37822,3951,-1000.00,-1604.22,-604.22,284.66,64.39,0.08,0
37823,3952,-560.94,-560.94,439.06,0.00,560.94,0.15,0
37824,3952,-359.53,-920.47,79.53,0.00,359.53,0.42,0
37825,3952,-79.53,-1000.00,0.00,0.00,79.53,0.14,0
37826,3953,-1000.00,-1000.00,0.00,268.94,307.91,0.31,0
37827,3954,-1000.00,-1000.00,0.00,545.93,0.00,0.01,0
37828,3955,1000.00,1000.00,2000.00,171.82,828.18,0.30,1
37829,3955,1000.00,2000.00,3000.00,0.00,222.25,0.09,1
37830,3955,-791.06,1208.94,2208.94,791.06,0.00,0.08,0
37831,3955,1000.00,2208.94,3208.94,256.35,1952.59,0.30,1
37832,3955,1000.00,3208.94,4208.94,0.00,3208.94,0.31,1
37833,3955,-1000.00,2208.94,3208.94,2430.43,1778.51,0.04,0
37834,3955,1000.00,3208.94,4208.94,0.00,1867.85,0.28,1
37835,3955,1000.00,4208.94,5208.94,0.00,3077.11,0.39,1
37836,3955,-1000.00,3208.94,4208.94,4491.40,717.54,0.03,0
37837,3955,1000.00,4208.94,5208.94,0.00,4208.94,0.17,1
37838,3955,1000.00,5208.94,6208.94,0.00,4843.52,0.21,1
37839,3955,1000.00,6208.94,7208.94,508.38,5700.56,0.25,1
37840,3955,1000.00,7208.94,8208.94,0.00,7147.27,0.31,1
37841,3955,1000.00,8208.94,9208.94,0.00,8208.94,0.34,1
37842,3955,1000.00,9208.94,10208.94,0.00,9208.94,0.12,1
37843,3955,1000.00,10208.94,11208.94,1352.34,8856.60,0.42,1
37844,3955,-1000.00,9208.94,10208.94,8604.62,1730.80,0.07,0
37845,3955,1000.00,10208.94,11208.94,0.00,6051.92,0.12,1
37846,3955,1000.00,11208.94,12208.94,0.00,3310.59,0.15,1
37847,3955,1000.00,12208.94,13208.94,0.00,12208.94,0.27,1
37848,3955,1000.00,13208.94,14208.94,0.00,13208.94,0.02,1
37849,3955,1000.00,14208.94,15208.94,245.52,13650.63,0.44,1
37850,3955,1000.00,15208.94,16208.94,3713.63,5851.75,0.24,1
37851,3955,-1000.00,14208.94,15208.94,9687.74,6521.20,0.38,0
37852,3955,-1000.00,13208.94,14208.94,2655.57,12553.37,0.38,0
37853,3955,-1000.00,12208.94,13208.94,930.99,6486.88,0.29,0
37854,3955,-1000.00,11208.94,12208.94,0.00,10982.72,0.42,0
37855,3955,-1000.00,10208.94,11208.94,0.00,12208.94,0.13,0
37856,3955,-1000.00,9208.94,10208.94,0.00,5782.47,0.31,0
37857,3955,-1000.00,8208.94,9208.94,0.00,7441.57,0.32,0
37858,3955,-1000.00,7208.94,8208.94,1598.04,5171.09,0.32,0
37859,3955,-1000.00,6208.94,7208.94,0.00,6318.70,0.34,0
37860,3955,-1000.00,5208.94,6208.94,2971.69,4237.25,0.17,0
37861,3955,-1000.00,4208.94,5208.94,0.00,5589.35,0.15,0
37862,3955,-1000.00,3208.94,4208.94,4119.78,0.00,0.03,0
37863,3955,-1000.00,2208.94,3208.94,0.00,2417.08,0.34,0
37864,3955,-1000.00,1208.94,2208.94,1735.15,1473.79,0.19,0
37865,3955,-1000.00,208.94,1208.94,318.04,1890.90,0.33,0
37866,3955,-1000.00,-791.06,208.94,0.00,1208.94,0.27,0
37867,3955,-208.94,-1000.00,0.00,1.86,207.08,0.21,0
37868,3956,1000.00,1000.00,2000.00,0.00,194.20,0.17,1
37869,3956,1000.00,2000.00,3000.00,117.56,1882.44,0.43,1
37870,3956,1000.00,3000.00,4000.00,0.00,1104.28,0.17,1
37871,3956,1000.00,4000.00,5000.00,0.00,4000.00,0.06,1
37872,3956,1000.00,5000.00,6000.00,2014.64,2679.16,0.32,1
37873,3956,1000.00,6000.00,7000.00,2617.79,3382.21,0.07,1
37874,3956,1000.00,7000.00,8000.00,0.00,7000.00,0.28,1
37875,3956,-1000.00,6000.00,7000.00,830.51,423.47,0.13,0
37876,3956,1000.00,7000.00,8000.00,0.00,7000.00,0.15,1
37877,3956,-1000.00,6000.00,7000.00,4620.09,3379.91,0.13,0
37878,3956,1000.00,7000.00,8000.00,0.00,7000.00,0.06,1
37879,3956,1000.00,8000.00,9000.00,2736.43,5263.57,0.08,1
37880,3956,-1000.00,7000.00,8000.00,9000.00,0.00,0.02,0
37881,3956,1000.00,8000.00,9000.00,2223.17,5776.83,0.27,1
37882,3956,1000.00,9000.00,10000.00,0.00,7128.16,0.22,1
37883,3956,-1000.00,8000.00,9000.00,6508.92,3491.08,0.13,0
37884,3956,1000.00,9000.00,10000.00,2230.56,6769.44,0.35,1
37885,3956,1000.00,10000.00,11000.00,5000.00,5000.00,0.37,1
37886,3956,1000.00,11000.00,12000.00,0.00,11000.00,0.15,1
37887,3956,1000.00,12000.00,13000.00,0.00,6380.71,0.31,1
37888,3956,1000.00,13000.00,14000.00,0.00,7493.68,0.33,1
37889,3956,1000.00,14000.00,15000.00,0.00,1355.52,0.08,1
37890,3956,1000.00,15000.00,16000.00,0.00,7110.85,0.06,1
37891,3956,1000.00,16000.00,17000.00,0.00,4338.58,0.11,1
37892,3956,1000.00,17000.00,18000.00,632.22,16367.78,0.27,1
37893,3956,1000.00,18000.00,19000.00,0.00,18000.00,0.25,1
37894,3956,1000.00,19000.00,20000.00,0.00,12421.89,0.33,1
37895,3956,1000.00,20000.00,21000.00,0.00,20000.00,0.28,1
37896,3956,1000.00,21000.00,22000.00,0.00,19353.48,0.27,1
37897,3956,1000.00,22000.00,23000.00,3194.77,18805.23,0.33,1
37898,3956,1000.00,23000.00,24000.00,0.00,23000.00,0.10,1
37899,3956,1000.00,24000.00,25000.00,8703.81,15296.19,0.28,1
37900,3956,1000.00,25000.00,26000.00,10254.11,14745.89,0.28,1
37901,3956,-1000.00,24000.00,25000.00,13765.12,2939.05,0.10,0
37902,3956,1000.00,25000.00,26000.00,0.00,25000.00,0.17,1
37903,3956,1000.00,26000.00,27000.00,10125.24,15874.76,0.24,1
37904,3956,1000.00,27000.00,28000.00,0.00,27000.00,0.38,1
37905,3956,-1000.00,26000.00,27000.00,12030.43,3411.37,0.12,0
37906,3957,-1000.00,-1000.00,0.00,0.00,1000.00,0.06,0
37907,3958,0.00,0.00,1000.00,0.00,0.00,0.22,0
37908,3958,-7.66,-7.66,992.34,0.00,7.66,0.00,0
37909,3958,-59.65,-67.31,932.69,0.00,59.65,0.07,0
37910,3958,-556.29,-623.60,376.40,0.00,556.29,0.05,0
37911,3958,0.00,-623.60,376.40,0.00,0.00,0.02,0
37912,3958,0.00,-623.60,376.40,0.00,0.00,0.14,0
37913,3958,-30.15,-653.75,346.25,0.00,30.15,0.43,0
37914,3958,-346.25,-1000.00,0.00,0.00,346.25,0.09,0
37915,3959,-1000.00,-1000.00,0.00,0.00,1000.00,0.31,0
37916,3960,1000.00,1000.00,2000.00,0.00,1000.00,0.19,1
37917,3960,1000.00,2000.00,3000.00,0.00,2000.00,0.30,1
37918,3960,-215.53,1784.47,2784.47,215.53,0.00,0.09,0
37919,3960,1000.00,2784.47,3784.47,0.00,1404.01,0.15,1
37920,3960,1000.00,3784.47,4784.47,1506.60,2277.87,0.14,1
37921,3960,1000.00,4784.47,5784.47,1817.04,2967.43,0.20,1
37922,3960,1000.00,5784.47,6784.47,258.56,5525.91,0.31,1
37923,3960,1000.00,6784.47,7784.47,1122.66,5318.68,0.40,1
37924,3960,1000.00,7784.47,8784.47,1456.75,6327.72,0.39,1
37925,3960,1000.00,8784.47,9784.47,0.00,8784.47,0.40,1
37926,3960,1000.00,9784.47,10784.47,1918.73,4902.58,0.30,1
37927,3960,1000.00,10784.47,11784.47,5392.24,5392.24,0.07,1
37928,3960,1000.00,11784.47,12784.47,0.00,7857.63,0.29,1
37929,3960,1000.00,12784.47,13784.47,0.00,10152.37,0.28,1
37930,3960,1000.00,13784.47,14784.47,1255.29,12529.19,0.28,1
37931,3960,1000.00,14784.47,15784.47,3969.60,4660.14,0.21,1
37932,3960,1000.00,15784.47,16784.47,6859.54,8924.93,0.35,1
37933,3960,1000.00,16784.47,17784.47,1015.57,14795.23,0.43,1
37934,3960,1000.00,17784.47,18784.47,7625.19,10159.29,0.28,1
37935,3960,1000.00,18784.47,19784.47,524.31,18260.16,0.15,1
37936,3960,1000.00,19784.47,20784.47,0.00,1723.88,0.06,1
37937,3960,-1000.00,18784.47,19784.47,12748.90,8035.57,0.02,0
37938,3960,-1000.00,17784.47,18784.47,5308.23,14476.24,0.25,0
37939,3960,-1000.00,16784.47,17784.47,12761.01,6023.47,0.10,0
37940,3960,-1000.00,15784.47,16784.47,5148.47,12636.00,0.19,0
37941,3960,-1000.00,14784.47,15784.47,0.00,16784.47,0.22,0
37942,3960,-1000.00,13784.47,14784.47,0.00,1572.37,0.08,0
37943,3960,-1000.00,12784.47,13784.47,3439.31,11345.16,0.38,0
37944,3960,-1000.00,11784.47,12784.47,827.75,12956.72,0.33,0
37945,3960,-1000.00,10784.47,11784.47,0.00,12074.78,0.42,0
37946,3960,-1000.00,9784.47,10784.47,2443.96,4172.73,0.23,0
37947,3960,-1000.00,8784.47,9784.47,6998.72,3785.76,0.12,0
37948,3960,-1000.00,7784.47,8784.47,0.00,9784.47,0.22,0
37949,3960,-1000.00,6784.47,7784.47,3034.40,5750.07,0.28,0
37950,3960,-1000.00,5784.47,6784.47,0.00,7784.47,0.17,0
37951,3960,-1000.00,4784.47,5784.47,0.00,6784.47,0.12,0
37952,3960,0.00,4784.47,5784.47,0.00,0.00,0.05,0
37953,3960,-1000.00,3784.47,4784.47,0.00,5040.94,0.33,0
37954,3960,-493.18,3291.30,4291.30,172.90,320.28,0.13,0
37955,3960,-1000.00,2291.30,3291.30,1536.47,0.00,0.07,0
37956,3960,-1000.00,1291.30,2291.30,0.00,3163.94,0.41,0
37957,3960,-742.81,548.48,1548.48,0.00,742.81,0.20,0
37958,3960,1000.00,1548.48,2548.48,0.00,1548.48,0.09,1
37959,3960,1000.00,2548.48,3548.48,139.52,1810.66,0.39,1
37960,3960,1000.00,3548.48,4548.48,996.77,2551.71,0.35,1
37961,3960,-1000.00,2548.48,3548.48,817.08,3494.17,0.39,0
37962,3960,-643.08,1905.40,2905.40,643.08,0.00,0.40,0
37963,3960,-1000.00,905.40,1905.40,675.16,1276.13,0.31,0
37964,3960,-1000.00,-94.60,905.40,0.00,387.88,0.39,0
37965,3960,0.00,-94.60,905.40,0.00,0.00,0.32,0
37966,3960,-1000.00,-1094.60,-94.60,0.00,44.22,0.42,0
37967,3961,-1000.00,-1000.00,0.00,1000.00,0.00,0.00,0
37968,3962,-939.77,-939.77,60.23,279.12,660.65,0.34,0
37969,3962,-33.41,-973.17,26.83,0.00,33.41,0.29,0
37970,3962,-26.83,-1000.00,0.00,0.00,26.83,0.19,0
37971,3963,1000.00,1000.00,2000.00,0.00,1000.00,0.43,1
37972,3963,1000.00,2000.00,3000.00,0.00,2000.00,0.35,1
37973,3963,1000.00,3000.00,4000.00,567.07,2432.93,0.41,1
37974,3963,1000.00,4000.00,5000.00,0.00,4000.00,0.21,1
37975,3963,1000.00,5000.00,6000.00,0.00,5000.00,0.25,1
37976,3963,1000.00,6000.00,7000.00,0.00,6000.00,0.29,1
37977,3963,1000.00,7000.00,8000.00,2810.23,4189.77,0.28,1
37978,3963,1000.00,8000.00,9000.00,0.00,60.23,0.07,1
37979,3963,1000.00,9000.00,10000.00,0.00,9000.00,0.13,1
37980,3963,1000.00,10000.00,11000.00,0.00,10000.00,0.13,1
37981,3963,1000.00,11000.00,12000.00,3328.51,7671.49,0.08,1
37982,3963,1000.00,12000.00,13000.00,0.00,12000.00,0.37,1
37983,3963,-1000.00,11000.00,12000.00,7355.45,3581.54,0.14,0
37984,3963,1000.00,12000.00,13000.00,1425.54,10574.46,0.34,1
37985,3963,-1000.00,11000.00,12000.00,8039.68,4960.32,0.36,0
37986,3963,-1000.00,10000.00,11000.00,6622.90,5377.10,0.34,0
37987,3963,1000.00,11000.00,12000.00,1081.51,9918.49,0.43,1
37988,3963,1000.00,12000.00,13000.00,0.00,12000.00,0.02,1
37989,3963,1000.00,13000.00,14000.00,4263.21,8736.79,0.33,1
37990,3963,1000.00,14000.00,15000.00,0.00,14000.00,0.31,1
37991,3963,1000.00,15000.00,16000.00,0.00,15000.00,0.01,1
37992,3963,1000.00,16000.00,17000.00,0.00,15076.35,0.34,1
37993,3963,1000.00,17000.00,18000.00,0.00,9092.52,0.18,1
37994,3963,1000.00,18000.00,19000.00,2534.31,15465.69,0.43,1
37995,3963,-1000.00,17000.00,18000.00,2218.44,1218.64,0.13,0
37996,3963,0.00,17000.00,18000.00,0.00,0.00,0.40,0
37997,3963,-1000.00,16000.00,17000.00,4161.25,7739.72,0.32,0
37998,3963,0.00,16000.00,17000.00,0.00,0.00,0.39,0
37999,3963,-1000.00,15000.00,16000.00,3809.13,6169.96,0.34,0
38000,3963,-1000.00,14000.00,15000.00,11651.61,209.77,0.22,0
38001,3963,-1000.00,13000.00,14000.00,6742.91,8257.09,0.07,0
38002,3963,-1000.00,12000.00,13000.00,6606.91,7393.09,0.10,0
38003,3963,-1000.00,11000.00,12000.00,6214.98,6785.02,0.42,0
38004,3963,-1000.00,10000.00,11000.00,0.00,612.03,0.08,0
38005,3964,1000.00,1000.00,2000.00,0.00,1000.00,0.09,1
38006,3964,-1000.00,0.00,1000.00,1125.92,548.92,0.14,0
38007,3964,-650.85,-650.85,349.15,391.55,259.30,0.17,0
38008,3964,1000.00,349.15,1349.15,15.34,333.81,0.42,1
38009,3964,1000.00,1349.15,2349.15,0.00,1349.15,0.05,1
38010,3964,1000.00,2349.15,3349.15,1126.29,1222.86,0.06,1
38011,3964,1000.00,3349.15,4349.15,1062.02,2287.13,0.34,1
38012,3964,1000.00,4349.15,5349.15,0.00,3005.59,0.39,1
38013,3964,1000.00,5349.15,6349.15,0.00,5349.15,0.22,1
38014,3964,1000.00,6349.15,7349.15,1963.30,3568.52,0.30,1
38015,3964,1000.00,7349.15,8349.15,2393.37,4154.99,0.29,1
38016,3964,-1000.00,6349.15,7349.15,5584.73,0.00,0.03,0
38017,3964,1000.00,7349.15,8349.15,0.00,7219.83,0.44,1
38018,3964,1000.00,8349.15,9349.15,3799.73,4549.42,0.11,1
38019,3964,1000.00,9349.15,10349.15,0.00,9349.15,0.26,1
38020,3964,1000.00,10349.15,11349.15,4058.78,6290.36,0.09,1
38021,3964,1000.00,11349.15,12349.15,0.00,11349.15,0.32,1
38022,3964,1000.00,12349.15,13349.15,0.00,7936.30,0.30,1
38023,3964,1000.00,13349.15,14349.15,131.58,10412.35,0.41,1
38024,3964,1000.00,14349.15,15349.15,7174.57,7174.57,0.39,1
38025,3964,1000.00,15349.15,16349.15,0.00,15349.15,0.43,1
38026,3964,1000.00,16349.15,17349.15,0.00,2943.15,0.16,1
38027,3964,1000.00,17349.15,18349.15,2913.39,14435.76,0.40,1
38028,3964,1000.00,18349.15,19349.15,332.49,18016.66,0.16,1
38029,3964,1000.00,19349.15,20349.15,8514.51,10834.63,0.16,1
38030,3964,1000.00,20349.15,21349.15,0.00,5030.42,0.20,1
38031,3964,1000.00,21349.15,22349.15,1361.19,19987.96,0.44,1
38032,3964,1000.00,22349.15,23349.15,0.00,8685.09,0.17,1
38033,3964,1000.00,23349.15,24349.15,0.00,21036.83,0.42,1
38034,3964,1000.00,24349.15,25349.15,9918.85,14430.30,0.21,1
38035,3964,1000.00,25349.15,26349.15,5131.23,20217.92,0.15,1
38036,3964,1000.00,26349.15,27349.15,11407.29,14941.85,0.36,1
38037,3964,1000.00,27349.15,28349.15,4572.16,22776.99,0.35,1
38038,3964,1000.00,28349.15,29349.15,0.00,15311.44,0.28,1
38039,3964,1000.00,29349.15,30349.15,0.00,29349.15,0.00,1
38040,3964,1000.00,30349.15,31349.15,13193.30,17155.84,0.12,1
38041,3964,1000.00,31349.15,32349.15,0.00,31349.15,0.27,1
38042,3964,1000.00,32349.15,33349.15,0.00,32349.15,0.07,1
38043,3965,-1000.00,-1000.00,0.00,0.00,1000.00,0.41,0
38044,3966,-307.88,-307.88,692.12,190.76,117.13,0.42,0
38045,3966,-600.85,-908.74,91.26,559.20,41.65,0.18,0
38046,3966,-1000.00,-1908.74,-908.74,45.63,45.63,0.12,0
38047,3967,-1000.00,-1000.00,0.00,371.51,628.49,0.10,0
38048,3968,-1000.00,-1000.00,0.00,0.00,1000.00,0.05,0
38049,3969,-1000.00,-1000.00,0.00,427.27,572.73,0.19,0
38050,3970,0.00,0.00,1000.00,0.00,0.00,0.12,0
38051,3970,-1000.00,-1000.00,0.00,259.77,282.94,0.36,0
38052,3971,-1000.00,-1000.00,0.00,523.85,314.23,0.22,0
38053,3972,-423.89,-423.89,576.11,423.89,0.00,0.26,0
38054,3972,-1000.00,-1423.89,-423.89,95.73,480.38,0.05,0
38055,3973,0.00,0.00,1000.00,0.00,0.00,0.11,0
38056,3973,-1000.00,-1000.00,0.00,0.00,1000.00,0.34,0
38057,3974,-270.78,-270.78,729.22,270.78,0.00,0.03,0
38058,3974,-729.22,-1000.00,0.00,453.12,276.10,0.09,0
38059,3975,-130.04,-130.04,869.96,130.04,0.00,0.08,0
38060,3975,1000.00,869.96,1869.96,100.12,769.85,0.07,1
38061,3975,1000.00,1869.96,2869.96,0.00,1838.33,0.24,1
38062,3975,0.00,1869.96,2869.96,0.00,0.00,0.03,0
38063,3975,-1000.00,869.96,1869.96,1788.36,1081.60,0.13,0
38064,3975,1000.00,1869.96,2869.96,0.00,1869.96,0.37,1
38065,3975,1000.00,2869.96,3869.96,1089.76,1780.21,0.18,1
38066,3975,1000.00,3869.96,4869.96,923.79,2946.18,0.39,1
38067,3975,0.00,3869.96,4869.96,0.00,0.00,0.05,0
38068,3975,1000.00,4869.96,5869.96,1806.97,3062.99,0.27,1
38069,3975,1000.00,5869.96,6869.96,874.55,4995.42,0.02,1
38070,3975,1000.00,6869.96,7869.96,0.00,2539.21,0.21,1
38071,3975,1000.00,7869.96,8869.96,0.00,7869.96,0.08,1
38072,3975,1000.00,8869.96,9869.96,0.00,8869.96,0.26,1
38073,3975,1000.00,9869.96,10869.96,4934.98,4934.98,0.08,1
38074,3975,1000.00,10869.96,11869.96,0.00,7392.33,0.38,1
38075,3975,1000.00,11869.96,12869.96,0.00,10435.58,0.25,1
38076,3975,1000.00,12869.96,13869.96,0.00,12869.96,0.42,1
38077,3975,1000.00,13869.96,14869.96,6934.98,6934.98,0.04,1
38078,3975,1000.00,14869.96,15869.96,5760.09,9109.87,0.28,1
38079,3975,1000.00,15869.96,16869.96,0.00,15869.96,0.09,1
38080,3975,1000.00,16869.96,17869.96,0.00,16869.96,0.07,1
38081,3975,1000.00,17869.96,18869.96,0.00,17869.96,0.07,1
38082,3975,-1000.00,16869.96,17869.96,11494.54,7375.42,0.08,0
38083,3975,1000.00,17869.96,18869.96,1913.29,8385.46,0.29,1
38084,3975,1000.00,18869.96,19869.96,0.00,18869.96,0.09,1
38085,3975,1000.00,19869.96,20869.96,7506.60,12363.36,0.24,1
38086,3975,-1000.00,18869.96,19869.96,10248.57,1372.22,0.09,0
38087,3975,1000.00,19869.96,20869.96,6286.88,13583.08,0.10,1
38088,3975,1000.00,20869.96,21869.96,5491.73,15378.23,0.08,1
38089,3975,1000.00,21869.96,22869.96,0.00,21869.96,0.08,1
38090,3975,1000.00,22869.96,23869.96,0.00,22869.96,0.30,1
38091,3975,1000.00,23869.96,24869.96,0.00,23869.96,0.34,1
38092,3975,1000.00,24869.96,25869.96,7120.71,17749.25,0.13,1
38093,3975,-1000.00,23869.96,24869.96,15797.53,7178.91,0.13,0
38094,3975,1000.00,24869.96,25869.96,182.75,24687.22,0.38,1
38095,3975,1000.00,25869.96,26869.96,0.00,25869.96,0.40,1
38096,3975,1000.00,26869.96,27869.96,0.00,26869.96,0.20,1
38097,3975,1000.00,27869.96,28869.96,0.00,18251.84,0.28,1
38098,3975,1000.00,28869.96,29869.96,14434.98,14434.98,0.40,1
38099,3975,-1000.00,27869.96,28869.96,14459.30,0.00,0.07,0
38100,3975,1000.00,28869.96,29869.96,7043.84,21826.13,0.39,1
38101,3975,1000.00,29869.96,30869.96,0.00,20270.08,0.26,1
38102,3975,1000.00,30869.96,31869.96,4362.30,26507.66,0.34,1
38103,3975,1000.00,31869.96,32869.96,0.00,28306.44,0.40,1
38104,3975,1000.00,32869.96,33869.96,13142.09,19727.87,0.35,1
38105,3975,1000.00,33869.96,34869.96,0.00,33869.96,0.04,1
38106,3975,-1000.00,32869.96,33869.96,0.00,34869.96,0.31,0
38107,3975,-1000.00,31869.96,32869.96,0.00,22690.03,0.01,0
38108,3975,-1000.00,30869.96,31869.96,3513.57,29356.40,0.30,0
38109,3975,-1000.00,29869.96,30869.96,0.00,31869.96,0.16,0
38110,3975,-1000.00,28869.96,29869.96,3540.86,10560.43,0.24,0
38111,3975,-1000.00,27869.96,28869.96,1857.60,20340.78,0.38,0
38112,3975,-1000.00,26869.96,27869.96,0.00,28869.96,0.40,0
38113,3975,-1000.00,25869.96,26869.96,0.00,27869.96,0.04,0
38114,3975,-1000.00,24869.96,25869.96,6593.68,20145.27,0.37,0
38115,3975,-1000.00,23869.96,24869.96,1487.74,24382.22,0.21,0
38116,3975,-1000.00,22869.96,23869.96,0.00,15500.85,0.11,0
38117,3975,-1000.00,21869.96,22869.96,0.00,17175.16,0.37,0
38118,3975,-1000.00,20869.96,21869.96,0.00,16525.05,0.05,0
38119,3975,-1000.00,19869.96,20869.96,0.00,21869.96,0.31,0
38120,3975,-1000.00,18869.96,19869.96,7926.44,12943.52,0.26,0
38121,3975,-1000.00,17869.96,18869.96,2586.69,16111.08,0.41,0
38122,3975,-1000.00,16869.96,17869.96,6948.50,11921.46,0.28,0
38123,3975,-1000.00,15869.96,16869.96,4536.93,13333.04,0.38,0
38124,3975,-1000.00,14869.96,15869.96,1324.85,13113.75,0.41,0
38125,3975,-1000.00,13869.96,14869.96,0.00,1195.48,0.05,0
38126,3976,0.00,0.00,1000.00,0.00,0.00,0.28,0
38127,3976,0.00,0.00,1000.00,0.00,0.00,0.42,0
38128,3976,-1000.00,-1000.00,0.00,541.95,458.05,0.01,0
38129,3977,1000.00,1000.00,2000.00,289.37,448.13,0.26,1
38130,3977,1000.00,2000.00,3000.00,0.00,76.14,0.04,1
38131,3977,1000.00,3000.00,4000.00,493.70,2430.10,0.41,1
38132,3977,1000.00,4000.00,5000.00,1806.02,2193.98,0.04,1
38133,3977,1000.00,5000.00,6000.00,0.00,5000.00,0.06,1
38134,3977,1000.00,6000.00,7000.00,2193.64,3806.36,0.13,1
38135,3977,1000.00,7000.00,8000.00,1610.37,3931.76,0.31,1
38136,3977,0.00,7000.00,8000.00,0.00,0.00,0.00,0
38137,3977,1000.00,8000.00,9000.00,0.00,4138.46,0.25,1
38138,3977,0.00,8000.00,9000.00,0.00,0.00,0.03,0
38139,3977,1000.00,9000.00,10000.00,1704.24,7295.76,0.29,1
38140,3977,1000.00,10000.00,11000.00,0.00,10000.00,0.20,1
38141,3977,1000.00,11000.00,12000.00,0.00,11000.00,0.26,1
38142,3977,1000.00,12000.00,13000.00,0.00,4043.47,0.04,1
38143,3977,1000.00,13000.00,14000.00,0.00,13000.00,0.19,1
38144,3977,1000.00,14000.00,15000.00,0.00,6384.21,0.28,1
38145,3977,1000.00,15000.00,16000.00,0.00,15000.00,0.00,1
38146,3977,-1000.00,14000.00,15000.00,12059.56,3940.44,0.09,0
38147,3977,1000.00,15000.00,16000.00,0.00,15000.00,0.43,1
38148,3977,-1000.00,14000.00,15000.00,8515.56,7484.44,0.12,0
38149,3977,1000.00,15000.00,16000.00,0.00,14962.23,0.15,1
38150,3977,1000.00,16000.00,17000.00,4438.04,11561.96,0.36,1
38151,3977,1000.00,17000.00,18000.00,8500.00,8500.00,0.07,1
38152,3977,-1000.00,16000.00,17000.00,11872.61,6127.39,0.28,0
38153,3977,-1000.00,15000.00,16000.00,0.00,12075.81,0.22,0
38154,3977,-1000.00,14000.00,15000.00,7696.94,8303.06,0.12,0
38155,3977,-1000.00,13000.00,14000.00,1486.13,13513.87,0.37,0
38156,3977,-1000.00,12000.00,13000.00,7651.14,6348.86,0.17,0
38157,3977,-1000.00,11000.00,12000.00,1648.05,11351.95,0.10,0
38158,3977,-1000.00,10000.00,11000.00,6206.42,5793.58,0.20,0
38159,3977,-1000.00,9000.00,10000.00,0.00,11000.00,0.16,0
38160,3977,0.00,9000.00,10000.00,0.00,0.00,0.09,0
38161,3977,-1000.00,8000.00,9000.00,0.00,10000.00,0.04,0
38162,3977,-1000.00,7000.00,8000.00,0.00,3717.04,0.12,0
38163,3977,-1000.00,6000.00,7000.00,1926.13,6073.87,0.01,0
38164,3977,-1000.00,5000.00,6000.00,599.90,0.00,0.01,0
38165,3977,0.00,5000.00,6000.00,0.00,0.00,0.01,0
38166,3977,-1000.00,4000.00,5000.00,0.00,3254.65,0.26,0
38167,3977,-1000.00,3000.00,4000.00,0.00,5000.00,0.20,0
38168,3977,-1000.00,2000.00,3000.00,573.88,3426.12,0.14,0
38169,3977,-1000.00,1000.00,2000.00,0.00,1107.54,0.25,0
38170,3977,-1000.00,0.00,1000.00,1000.00,1000.00,0.16,0
38171,3977,-1000.00,-1000.00,0.00,520.15,479.85,0.17,0
38172,3978,-837.78,-837.78,162.22,365.74,472.04,0.25,0
38173,3978,-162.22,-1000.00,0.00,0.00,162.22,0.36,0
38174,3979,-1000.00,-1000.00,0.00,0.00,1000.00,0.06,0
38175,3980,0.00,0.00,1000.00,0.00,0.00,0.24,0
38176,3980,0.00,0.00,1000.00,0.00,0.00,0.01,0
38177,3980,-532.80,-532.80,467.20,0.00,532.80,0.11,0
38178,3980,-118.29,-651.09,348.91,0.00,118.29,0.22,0
38179,3980,1000.00,348.91,1348.91,348.91,0.00,0.07,1
38180,3980,1000.00,1348.91,2348.91,601.97,0.00,0.15,1
38181,3980,0.00,1348.91,2348.91,0.00,0.00,0.05,0
38182,3980,-867.94,480.98,1480.98,0.00,867.94,0.03,0
38183,3980,1000.00,1480.98,2480.98,923.77,0.00,0.17,1
38184,3980,-1000.00,480.98,1480.98,690.68,785.29,0.35,0
38185,3980,1000.00,1480.98,2480.98,582.03,0.00,0.31,1
38186,3980,1000.00,2480.98,3480.98,2480.98,0.00,0.11,1
38187,3980,-1000.00,1480.98,2480.98,0.00,1132.36,0.07,0
38188,3980,1000.00,2480.98,3480.98,2118.29,0.00,0.13,1
38189,3980,-1000.00,1480.98,2480.98,0.00,3480.98,0.26,0
38190,3980,1000.00,2480.98,3480.98,75.36,0.00,0.43,1
38191,3980,1000.00,3480.98,4480.98,2085.53,560.80,0.26,1
38192,3980,0.00,3480.98,4480.98,0.00,0.00,0.07,0
38193,3980,-1000.00,2480.98,3480.98,0.00,1941.09,0.32,0
38194,3980,1000.00,3480.98,4480.98,1062.88,0.00,0.27,1
38195,3980,0.00,3480.98,4480.98,0.00,0.00,0.41,0
38196,3980,1000.00,4480.98,5480.98,2288.14,0.00,0.29,1
38197,3980,-1000.00,3480.98,4480.98,0.00,3109.10,0.13,0
38198,3980,-1000.00,2480.98,3480.98,0.00,1409.53,0.38,0
38199,3980,0.00,2480.98,3480.98,0.00,0.00,0.07,0
38200,3980,1000.00,3480.98,4480.98,1863.22,1617.76,0.04,1
38201,3980,-1000.00,2480.98,3480.98,1461.75,2291.96,0.29,0
38202,3980,-1000.00,1480.98,2480.98,849.18,2442.92,0.36,0
38203,3980,1000.00,2480.98,3480.98,2480.98,0.00,0.03,1
38204,3980,1000.00,3480.98,4480.98,2919.08,0.00,0.02,1
38205,3980,-1000.00,2480.98,3480.98,0.00,1832.54,0.04,0
38206,3980,1000.00,3480.98,4480.98,2023.00,742.55,0.27,1
38207,3980,1000.00,4480.98,5480.98,819.14,0.00,0.33,1
38208,3980,1000.00,5480.98,6480.98,849.26,0.00,0.23,1
38209,3980,0.00,5480.98,6480.98,0.00,0.00,0.43,0
38210,3981,-1000.00,-1000.00,0.00,47.37,952.63,0.23,0
38211,3981,0.00,-1000.00,0.00,0.00,0.00,0.03,1
38212,3981,-0.00,-1000.00,0.00,0.00,0.00,0.35,0
38213,3982,-281.16,-281.16,718.84,0.00,281.16,0.40,0
38214,3982,-545.90,-827.06,172.94,0.00,545.90,0.20,0
38215,3982,-2.92,-829.97,170.03,0.00,2.92,0.41,0
38216,3982,1000.00,170.03,1170.03,94.33,75.69,0.17,1
38217,3982,-429.41,-259.39,740.61,214.49,214.92,0.39,0
38218,3982,1000.00,740.61,1740.61,408.43,332.19,0.20,1
38219,3982,1000.00,1740.61,2740.61,768.63,0.00,0.31,1
38220,3982,-308.20,1432.41,2432.41,0.00,308.20,0.43,0
38221,3982,0.00,1432.41,2432.41,0.00,0.00,0.19,0
38222,3982,1000.00,2432.41,3432.41,1254.67,1177.75,0.11,1
38223,3982,-1000.00,1432.41,2432.41,113.06,3189.12,0.44,0
38224,3982,1000.00,2432.41,3432.41,812.06,0.00,0.27,1
38225,3982,-1000.00,1432.41,2432.41,1716.21,1716.21,0.05,0
38226,3982,-1000.00,432.41,1432.41,0.00,1369.90,0.31,0
38227,3982,1000.00,1432.41,2432.41,633.80,0.00,0.18,1
38228,3982,-682.71,749.71,1749.71,0.00,682.71,0.16,0
38229,3982,0.00,749.71,1749.71,0.00,0.00,0.04,0
38230,3982,-1000.00,-250.29,749.71,0.00,1749.71,0.14,0
38231,3982,1000.00,749.71,1749.71,384.62,0.00,0.07,1
38232,3982,-1000.00,-250.29,749.71,106.25,308.35,0.44,0
38233,3982,-58.09,-308.38,691.62,58.09,0.00,0.43,0
38234,3982,-1000.00,-1308.38,-308.38,0.00,181.30,0.42,0
38235,3983,-1000.00,-1000.00,0.00,717.40,282.60,0.09,0
38236,3984,-1000.00,-1000.00,0.00,467.21,532.79,0.17,0
38237,3985,1000.00,1000.00,2000.00,0.00,544.53,0.25,1
38238,3985,1000.00,2000.00,3000.00,0.00,2000.00,0.09,1
38239,3985,1000.00,3000.00,4000.00,0.00,3000.00,0.19,1
38240,3985,-1000.00,2000.00,3000.00,2420.15,1579.85,0.16,0
38241,3985,1000.00,3000.00,4000.00,1167.16,1832.84,0.24,1
38242,3985,1000.00,4000.00,5000.00,0.00,4000.00,0.08,1
38243,3985,1000.00,5000.00,6000.00,1314.18,3685.82,0.30,1
38244,3985,1000.00,6000.00,7000.00,658.37,5341.63,0.36,1
38245,3985,1000.00,7000.00,8000.00,1264.82,5644.74,0.40,1
38246,3985,1000.00,8000.00,9000.00,1317.53,6682.47,0.42,1
38247,3985,1000.00,9000.00,10000.00,172.92,8017.79,0.43,1
38248,3985,1000.00,10000.00,11000.00,620.96,9379.04,0.12,1
38249,3985,1000.00,11000.00,12000.00,0.00,4606.16,0.28,1
38250,3985,1000.00,12000.00,13000.00,0.00,8768.75,0.08,1
38251,3985,1000.00,13000.00,14000.00,3227.78,9772.22,0.12,1
38252,3985,-1000.00,12000.00,13000.00,277.52,3037.29,0.05,0
38253,3985,-1000.00,11000.00,12000.00,0.00,13000.00,0.38,0
38254,3985,-1000.00,10000.00,11000.00,0.00,3922.00,0.10,0
38255,3985,-1000.00,9000.00,10000.00,4748.27,6251.73,0.12,0
38256,3985,-1000.00,8000.00,9000.00,2989.79,4688.40,0.26,0
38257,3985,1000.00,9000.00,10000.00,5211.70,2095.03,0.12,1
38258,3985,-1000.00,8000.00,9000.00,0.00,10000.00,0.01,0
38259,3985,1000.00,9000.00,10000.00,5366.27,3633.73,0.16,1
38260,3985,-1000.00,8000.00,9000.00,0.00,2276.20,0.15,0
38261,3985,-1000.00,7000.00,8000.00,3361.94,3412.44,0.25,0
38262,3985,-1000.00,6000.00,7000.00,2278.92,5721.08,0.29,0
38263,3985,-1000.00,5000.00,6000.00,0.00,5741.04,0.09,0
38264,3985,-1000.00,4000.00,5000.00,0.00,6000.00,0.11,0
38265,3985,0.00,4000.00,5000.00,0.00,0.00,0.09,0
38266,3985,-1000.00,3000.00,4000.00,0.00,5000.00,0.06,0
38267,3985,-432.53,2567.47,3567.47,0.00,432.53,0.00,0
38268,3985,1000.00,3567.47,4567.47,1409.71,1064.81,0.18,1
38269,3985,-1000.00,2567.47,3567.47,0.00,4195.56,0.41,0
38270,3985,0.00,2567.47,3567.47,0.00,0.00,0.02,0
38271,3985,-1000.00,1567.47,2567.47,0.00,1684.77,0.30,0
38272,3985,-1000.00,567.47,1567.47,0.00,2158.76,0.13,0
38273,3985,-1000.00,-432.53,567.47,522.30,870.36,0.29,0
38274,3985,-544.18,-976.71,23.29,0.00,544.18,0.40,0
38275,3985,1000.00,23.29,1023.29,0.00,23.29,0.39,1
38276,3985,1000.00,1023.29,2023.29,0.00,1023.29,0.38,1
38277,3985,1000.00,2023.29,3023.29,0.00,2023.29,0.06,1
38278,3985,1000.00,3023.29,4023.29,0.00,3023.29,0.39,1
38279,3985,1000.00,4023.29,5023.29,1455.81,2567.48,0.15,1
38280,3985,1000.00,5023.29,6023.29,0.00,1531.19,0.13,1
38281,3985,1000.00,6023.29,7023.29,0.00,6023.29,0.08,1
38282,3985,1000.00,7023.29,8023.29,0.00,7023.29,0.42,1
38283,3985,-1000.00,6023.29,7023.29,2906.52,0.00,0.08,0
38284,3985,1000.00,7023.29,8023.29,0.00,5513.16,0.26,1
38285,3985,1000.00,8023.29,9023.29,1419.24,4033.31,0.30,1
38286,3985,1000.00,9023.29,10023.29,3067.76,5955.52,0.20,1
38287,3985,1000.00,10023.29,11023.29,0.00,8279.04,0.17,1
38288,3985,1000.00,11023.29,12023.29,0.00,9414.96,0.38,1
38289,3985,1000.00,12023.29,13023.29,0.00,12023.29,0.34,1
38290,3985,1000.00,13023.29,14023.29,0.00,13023.29,0.11,1
38291,3985,1000.00,14023.29,15023.29,0.00,14023.29,0.41,1
38292,3985,1000.00,15023.29,16023.29,0.00,15023.29,0.36,1
38293,3986,-1000.00,-1000.00,0.00,0.00,1000.00,0.39,0
38294,3987,-825.89,-825.89,174.11,0.00,825.89,0.23,0
38295,3987,-174.11,-1000.00,0.00,0.00,174.11,0.22,0
38296,3988,-1000.00,-1000.00,0.00,0.00,15.88,0.44,0
38297,3989,-301.93,-301.93,698.07,0.00,301.93,0.22,0
38298,3989,-28.34,-330.26,669.74,0.00,28.34,0.06,0
38299,3989,-620.78,-951.04,48.96,0.00,620.78,0.28,0
38300,3989,-36.18,-987.22,12.78,0.00,36.18,0.33,0
38301,3989,-12.78,-1000.00,0.00,4.23,8.55,0.33,0
38302,3990,-1000.00,-1000.00,0.00,0.00,571.28,0.35,0
38303,3991,1000.00,1000.00,2000.00,0.00,1000.00,0.03,1
38304,3991,1000.00,2000.00,3000.00,667.41,1332.59,0.33,1
38305,3991,0.00,2000.00,3000.00,0.00,0.00,0.05,0
38306,3991,1000.00,3000.00,4000.00,0.00,3000.00,0.16,1
38307,3991,1000.00,4000.00,5000.00,894.72,3105.28,0.42,1
38308,3991,1000.00,5000.00,6000.00,0.00,5000.00,0.01,1
38309,3991,0.00,5000.00,6000.00,0.00,0.00,0.04,0
38310,3991,1000.00,6000.00,7000.00,0.00,4607.67,0.35,1
38311,3991,1000.00,7000.00,8000.00,2159.96,4282.37,0.32,1
38312,3991,1000.00,8000.00,9000.00,789.91,3317.13,0.27,1
38313,3991,1000.00,9000.00,10000.00,0.00,9000.00,0.18,1
38314,3991,-1000.00,8000.00,9000.00,5204.99,4795.01,0.18,0
38315,3991,1000.00,9000.00,10000.00,0.00,9000.00,0.10,1
38316,3991,1000.00,10000.00,11000.00,4299.46,5700.54,0.06,1
38317,3991,1000.00,11000.00,12000.00,1843.69,9156.31,0.25,1
38318,3991,1000.00,12000.00,13000.00,571.15,7014.22,0.35,1
38319,3991,1000.00,13000.00,14000.00,0.00,13000.00,0.38,1
38320,3991,1000.00,14000.00,15000.00,7000.00,7000.00,0.15,1
38321,3991,1000.00,15000.00,16000.00,2292.83,12707.17,0.36,1
38322,3991,1000.00,16000.00,17000.00,1192.17,14807.83,0.13,1
38323,3991,1000.00,17000.00,18000.00,0.00,11608.07,0.15,1
38324,3991,-1000.00,16000.00,17000.00,13575.33,4424.67,0.18,0
38325,3991,-1000.00,15000.00,16000.00,0.00,7780.73,0.09,0
38326,3991,-1000.00,14000.00,15000.00,0.00,16000.00,0.28,0
38327,3991,0.00,14000.00,15000.00,0.00,0.00,0.09,0
38328,3991,-1000.00,13000.00,14000.00,9228.93,5771.07,0.24,0
38329,3991,-1000.00,12000.00,13000.00,0.00,14000.00,0.12,0
38330,3991,-1000.00,11000.00,12000.00,4116.26,8883.74,0.35,0
38331,3991,-1000.00,10000.00,11000.00,2819.19,9180.81,0.29,0
38332,3991,-1000.00,9000.00,10000.00,1240.27,9759.73,0.42,0
38333,3991,-1000.00,8000.00,9000.00,0.00,10000.00,0.16,0
38334,3991,-1000.00,7000.00,8000.00,2642.47,6357.53,0.30,0
38335,3991,-1000.00,6000.00,7000.00,0.00,8000.00,0.32,0
38336,3991,-1000.00,5000.00,6000.00,0.00,7000.00,0.20,0
38337,3991,-1000.00,4000.00,5000.00,0.00,1734.59,0.00,0
38338,3991,0.00,4000.00,5000.00,0.00,0.00,0.08,0
38339,3991,-1000.00,3000.00,4000.00,2292.96,2707.04,0.43,0
38340,3991,-1000.00,2000.00,3000.00,1871.54,2128.46,0.15,0
38341,3991,-1000.00,1000.00,2000.00,60.66,2939.34,0.44,0
38342,3991,-1000.00,0.00,1000.00,0.00,2000.00,0.23,0
38343,3991,-1000.00,-1000.00,0.00,290.88,709.12,0.25,0
38344,3992,-1000.00,-1000.00,0.00,0.00,1000.00,0.44,0
38345,3993,-1000.00,-1000.00,0.00,500.00,500.00,0.04,0
38346,3994,-1000.00,-1000.00,0.00,407.66,592.34,0.16,0
38347,3995,-675.47,-675.47,324.53,0.00,675.47,0.30,0
38348,3995,-324.53,-1000.00,0.00,121.91,202.62,0.27,0
38349,3996,-1000.00,-1000.00,0.00,457.16,542.84,0.20,0
38350,3997,1000.00,1000.00,2000.00,0.00,1000.00,0.41,1
38351,3997,1000.00,2000.00,3000.00,0.00,1988.45,0.36,1
38352,3997,1000.00,3000.00,4000.00,0.00,486.57,0.05,1
38353,3997,1000.00,4000.00,5000.00,1454.95,2545.05,0.31,1
38354,3997,1000.00,5000.00,6000.00,1692.15,3307.85,0.17,1
38355,3997,0.00,5000.00,6000.00,0.00,0.00,0.08,0
38356,3997,1000.00,6000.00,7000.00,0.00,6000.00,0.22,1
38357,3997,1000.00,7000.00,8000.00,0.00,5125.31,0.22,1
38358,3997,1000.00,8000.00,9000.00,0.00,8000.00,0.38,1
38359,3997,1000.00,9000.00,10000.00,0.00,9000.00,0.24,1
38360,3997,1000.00,10000.00,11000.00,0.00,10000.00,0.34,1
38361,3997,1000.00,11000.00,12000.00,1579.49,9420.51,0.04,1
38362,3997,1000.00,12000.00,13000.00,596.71,10171.31,0.43,1
38363,3997,1000.00,13000.00,14000.00,446.08,12553.92,0.34,1
38364,3997,1000.00,14000.00,15000.00,0.00,11646.52,0.44,1
38365,3997,1000.00,15000.00,16000.00,1923.71,13076.29,0.43,1
38366,3997,1000.00,16000.00,17000.00,0.00,14030.59,0.16,1
38367,3997,1000.00,17000.00,18000.00,4203.32,12796.68,0.20,1
38368,3997,-1000.00,16000.00,17000.00,3358.99,0.00,0.06,0
38369,3997,1000.00,17000.00,18000.00,6721.82,10278.18,0.20,1
38370,3997,-1000.00,16000.00,17000.00,15390.69,2609.31,0.16,0
38371,3997,0.00,16000.00,17000.00,0.00,0.00,0.00,0
38372,3997,1000.00,17000.00,18000.00,0.00,17000.00,0.37,1
38373,3997,0.00,17000.00,18000.00,0.00,0.00,0.10,0
38374,3997,-1000.00,16000.00,17000.00,15600.58,2399.42,0.02,0
38375,3997,-1000.00,15000.00,16000.00,5734.44,11265.56,0.33,0
38376,3997,-1000.00,14000.00,15000.00,2083.35,0.00,0.02,0
38377,3997,-609.65,13390.35,14390.35,0.00,609.65,0.11,0
38378,3997,0.00,13390.35,14390.35,0.00,0.00,0.00,0
38379,3997,-1000.00,12390.35,13390.35,2321.75,12068.60,0.42,0
38380,3997,-1000.00,11390.35,12390.35,4221.28,9169.08,0.20,0
38381,3997,-1000.00,10390.35,11390.35,6593.65,371.04,0.08,0
38382,3997,-1000.00,9390.35,10390.35,0.00,8882.06,0.14,0
38383,3997,-1000.00,8390.35,9390.35,0.00,10390.35,0.39,0
38384,3997,-1000.00,7390.35,8390.35,4736.15,4654.20,0.10,0
38385,3997,-1000.00,6390.35,7390.35,815.62,7574.73,0.44,0
38386,3997,-1000.00,5390.35,6390.35,2552.01,1344.92,0.22,0
38387,3997,-1000.00,4390.35,5390.35,0.00,6390.35,0.37,0
38388,3997,-1000.00,3390.35,4390.35,122.29,5268.06,0.44,0
38389,3997,-1000.00,2390.35,3390.35,0.00,2744.18,0.35,0
38390,3997,-1000.00,1390.35,2390.35,0.00,1511.13,0.25,0
38391,3997,-1000.00,390.35,1390.35,147.95,2242.40,0.41,0
38392,3997,-1000.00,-609.65,390.35,0.00,1129.85,0.05,0
38393,3997,-356.60,-966.25,33.75,139.41,217.19,0.28,0
38394,3997,-33.75,-1000.00,0.00,0.00,33.75,0.28,0
38395,3998,-749.79,-749.79,250.21,0.00,749.79,0.40,0
38396,3998,-250.21,-1000.00,0.00,0.00,250.21,0.19,0
38397,3999,-1000.00,-1000.00,0.00,500.00,500.00,0.05,0
38398,4000,0.00,0.00,1000.00,0.00,0.00,0.23,0
38399,4000,-1000.00,-1000.00,0.00,1000.00,0.00,0.09,0
38400,4001,-1000.00,-1000.00,0.00,0.00,879.66,0.32,0
38401,4002,1000.00,1000.00,2000.00,0.00,527.02,0.38,1
38402,4002,1000.00,2000.00,3000.00,78.66,102.31,0.34,1
38403,4002,1000.00,3000.00,4000.00,863.48,2136.52,0.37,1
38404,4002,1000.00,4000.00,5000.00,0.00,3149.26,0.43,1
38405,4002,1000.00,5000.00,6000.00,0.00,5000.00,0.14,1
38406,4002,0.00,5000.00,6000.00,0.00,0.00,0.05,0
38407,4002,1000.00,6000.00,7000.00,2316.16,3683.84,0.28,1
38408,4002,1000.00,7000.00,8000.00,0.00,7000.00,0.38,1
38409,4002,1000.00,8000.00,9000.00,0.00,6016.03,0.42,1
38410,4002,1000.00,9000.00,10000.00,2118.56,6881.44,0.07,1
38411,4002,-1000.00,8000.00,9000.00,7084.86,2915.14,0.18,0
38412,4002,1000.00,9000.00,10000.00,3895.35,5104.65,0.11,1
38413,4002,-1000.00,8000.00,9000.00,5420.59,4052.74,0.18,0
38414,4002,1000.00,9000.00,10000.00,0.00,9000.00,0.35,1
38415,4002,1000.00,10000.00,11000.00,2228.09,7771.91,0.04,1
38416,4002,1000.00,11000.00,12000.00,4683.31,6316.69,0.19,1
38417,4002,-1000.00,10000.00,11000.00,6187.95,5812.05,0.16,0
38418,4002,1000.00,11000.00,12000.00,0.00,9865.32,0.20,1
38419,4002,1000.00,12000.00,13000.00,1812.77,9972.42,0.39,1
38420,4002,1000.00,13000.00,14000.00,0.00,9920.53,0.39,1
38421,4002,1000.00,14000.00,15000.00,89.33,10174.18,0.40,1
38422,4002,1000.00,15000.00,16000.00,0.00,13243.62,0.36,1
38423,4002,1000.00,16000.00,17000.00,0.00,2725.21,0.11,1
38424,4002,1000.00,17000.00,18000.00,0.00,17000.00,0.41,1
38425,4002,-1000.00,16000.00,17000.00,0.00,18000.00,0.07,0
38426,4002,-1000.00,15000.00,16000.00,0.00,17000.00,0.33,0
38427,4002,-1000.00,14000.00,15000.00,0.00,10295.70,0.30,0
38428,4002,-1000.00,13000.00,14000.00,3031.08,11968.92,0.41,0
38429,4002,-1000.00,12000.00,13000.00,2526.11,11473.89,0.25,0
38430,4002,-1000.00,11000.00,12000.00,5464.44,1319.04,0.22,0
38431,4002,-1000.00,10000.00,11000.00,0.00,7590.00,0.36,0
38432,4002,-1000.00,9000.00,10000.00,7158.65,0.00,0.06,0
38433,4002,-1000.00,8000.00,9000.00,0.00,9439.99,0.17,0
38434,4002,-1000.00,7000.00,8000.00,0.00,9000.00,0.25,0
38435,4002,-1000.00,6000.00,7000.00,1740.00,6260.00,0.21,0
38436,4002,-1000.00,5000.00,6000.00,0.00,3502.54,0.18,0
38437,4002,-1000.00,4000.00,5000.00,0.00,6000.00,0.27,0
38438,4002,-1000.00,3000.00,4000.00,1580.47,3419.53,0.35,0
38439,4002,0.00,3000.00,4000.00,0.00,0.00,0.12,0
38440,4002,0.00,3000.00,4000.00,0.00,0.00,0.09,0
38441,4002,-871.27,2128.73,3128.73,0.00,871.27,0.43,0
38442,4002,-841.74,1286.99,2286.99,0.00,841.74,0.14,0
38443,4002,1000.00,2286.99,3286.99,1369.15,0.00,0.14,1
38444,4003,-1000.00,-1000.00,0.00,48.79,951.21,0.41,0
38445,4004,-449.68,-449.68,550.32,0.00,449.68,0.06,0
38446,4004,-124.44,-574.12,425.88,0.00,124.44,0.35,0
38447,4004,0.00,-574.12,425.88,0.00,0.00,0.04,0
38448,4004,1000.00,425.88,1425.88,256.55,169.33,0.16,1
38449,4004,0.00,425.88,1425.88,0.00,0.00,0.39,0
38450,4004,-1000.00,-574.12,425.88,0.00,1384.18,0.05,0
38451,4004,1000.00,425.88,1425.88,127.42,0.00,0.08,1
38452,4004,-606.41,-180.52,819.48,216.08,390.33,0.42,0
38453,4004,0.00,-180.52,819.48,0.00,0.00,0.40,0
38454,4004,1000.00,819.48,1819.48,309.58,252.64,0.32,1
38455,4004,-1000.00,-180.52,819.48,0.00,1819.48,0.01,0
38456,4004,1000.00,819.48,1819.48,471.92,347.56,0.00,1
38457,4004,0.00,819.48,1819.48,0.00,0.00,0.07,0
38458,4004,1000.00,1819.48,2819.48,925.90,893.58,0.06,1
38459,4004,-1000.00,819.48,1819.48,301.70,1373.37,0.35,0
38460,4004,-1000.00,-180.52,819.48,0.00,1355.60,0.26,0
38461,4004,-819.48,-1000.00,0.00,265.60,553.87,0.03,0
38462,4005,-1000.00,-1000.00,0.00,0.00,1000.00,0.02,0
38463,4006,-1000.00,-1000.00,0.00,0.00,1000.00,0.12,0
38464,4007,0.00,0.00,1000.00,0.00,0.00,0.31,0
38465,4007,-406.56,-406.56,593.44,0.00,406.56,0.27,0
38466,4007,-193.52,-600.08,399.92,23.89,169.63,0.22,0
38467,4007,-399.92,-1000.00,-0.00,116.28,283.63,0.11,0
38468,4008,-1000.00,-1000.00,0.00,0.00,265.03,0.44,0
38469,4009,-1000.00,-1000.00,0.00,286.34,713.66,0.34,0
38470,4010,1000.00,1000.00,2000.00,0.00,499.20,0.08,1
38471,4010,1000.00,2000.00,3000.00,0.00,2000.00,0.32,1
38472,4010,1000.00,3000.00,4000.00,76.64,2923.36,0.34,1
38473,4010,1000.00,4000.00,5000.00,452.99,3547.01,0.27,1
38474,4010,1000.00,5000.00,6000.00,0.00,3871.69,0.30,1
38475,4010,1000.00,6000.00,7000.00,485.71,5514.29,0.06,1
38476,4010,1000.00,7000.00,8000.00,0.00,6454.85,0.43,1
38477,4010,1000.00,8000.00,9000.00,3156.80,4843.20,0.07,1
38478,4010,0.00,8000.00,9000.00,0.00,0.00,0.04,0
38479,4010,1000.00,9000.00,10000.00,0.00,5133.02,0.30,1
38480,4010,1000.00,10000.00,11000.00,2083.09,7916.91,0.37,1
38481,4010,1000.00,11000.00,12000.00,844.28,3756.90,0.24,1
38482,4010,1000.00,12000.00,13000.00,0.00,12000.00,0.22,1
38483,4010,1000.00,13000.00,14000.00,0.00,11359.08,0.43,1
38484,4010,1000.00,14000.00,15000.00,0.00,10858.41,0.41,1
38485,4010,1000.00,15000.00,16000.00,0.00,15000.00,0.30,1
38486,4010,1000.00,16000.00,17000.00,0.00,11811.82,0.13,1
38487,4010,-1000.00,15000.00,16000.00,5319.17,3567.29,0.16,0
38488,4010,1000.00,16000.00,17000.00,0.00,16000.00,0.26,1
38489,4010,1000.00,17000.00,18000.00,0.00,13587.37,0.34,1
38490,4010,1000.00,18000.00,19000.00,0.00,9790.57,0.33,1
38491,4010,1000.00,19000.00,20000.00,0.00,19000.00,0.23,1
38492,4010,-1000.00,18000.00,19000.00,12271.21,7728.79,0.05,0
38493,4010,1000.00,19000.00,20000.00,367.53,18632.47,0.41,1
38494,4010,-1000.00,18000.00,19000.00,11745.06,8254.94,0.06,0
38495,4010,1000.00,19000.00,20000.00,3282.08,15717.92,0.42,1
38496,4010,1000.00,20000.00,21000.00,127.00,15389.37,0.41,1
38497,4010,-1000.00,19000.00,20000.00,11321.94,9678.06,0.39,0
38498,4010,1000.00,20000.00,21000.00,10000.00,10000.00,0.09,1
38499,4010,1000.00,21000.00,22000.00,1017.65,19982.35,0.34,1
38500,4010,1000.00,22000.00,23000.00,0.00,18327.49,0.40,1
38501,4010,-1000.00,21000.00,22000.00,5806.82,0.00,0.01,0
38502,4010,1000.00,22000.00,23000.00,5268.71,16731.29,0.11,1
38503,4010,1000.00,23000.00,24000.00,4223.00,18777.00,0.41,1
38504,4010,1000.00,24000.00,25000.00,0.00,20538.39,0.41,1
38505,4010,1000.00,25000.00,26000.00,0.00,25000.00,0.34,1
38506,4010,1000.00,26000.00,27000.00,0.00,7625.44,0.21,1
38507,4010,1000.00,27000.00,28000.00,1157.37,19581.13,0.40,1
38508,4010,1000.00,28000.00,29000.00,10046.97,17953.03,0.28,1
38509,4010,1000.00,29000.00,30000.00,14500.00,14500.00,0.01,1
38510,4010,1000.00,30000.00,31000.00,14643.35,15356.65,0.01,1
38511,4010,1000.00,31000.00,32000.00,3033.42,24039.34,0.41,1
38512,4010,1000.00,32000.00,33000.00,6094.51,25905.49,0.33,1
38513,4010,1000.00,33000.00,34000.00,0.00,33000.00,0.19,1
38514,4010,1000.00,34000.00,35000.00,4458.40,29541.60,0.43,1
38515,4010,1000.00,35000.00,36000.00,0.00,7818.31,0.13,1
38516,4011,-1000.00,-1000.00,0.00,400.32,0.00,0.29,0
38517,4012,-54.61,-54.61,945.39,0.00,54.61,0.06,0
38518,4012,-288.55,-343.15,656.85,0.00,288.55,0.17,0
38519,4012,-656.85,-1000.00,0.00,233.85,423.00,0.05,0
38520,4013,1000.00,1000.00,2000.00,0.00,461.36,0.29,1
38521,4013,1000.00,2000.00,3000.00,479.51,1520.49,0.28,1
38522,4013,1000.00,3000.00,4000.00,0.00,68.37,0.11,1
38523,4013,1000.00,4000.00,5000.00,670.76,3329.24,0.42,1
38524,4013,-1000.00,3000.00,4000.00,2693.42,2306.58,0.19,0
38525,4013,1000.00,4000.00,5000.00,1627.51,2372.49,0.22,1
38526,4013,-1000.00,3000.00,4000.00,1862.45,1184.53,0.16,0
38527,4013,1000.00,4000.00,5000.00,1233.03,1687.22,0.24,1
38528,4013,1000.00,5000.00,6000.00,0.00,4694.98,0.39,1
38529,4013,1000.00,6000.00,7000.00,1839.64,4160.36,0.25,1
38530,4013,-1000.00,5000.00,6000.00,5426.86,1573.14,0.06,0
38531,4013,1000.00,6000.00,7000.00,2710.22,3289.78,0.13,1
38532,4013,1000.00,7000.00,8000.00,3463.73,3536.27,0.11,1
38533,4013,-1000.00,6000.00,7000.00,4104.90,3895.10,0.12,0
38534,4013,1000.00,7000.00,8000.00,0.00,3732.37,0.06,1
38535,4013,1000.00,8000.00,9000.00,1086.56,5274.83,0.13,1
38536,4013,-1000.00,7000.00,8000.00,8252.30,747.70,0.04,0
38537,4013,-1000.00,6000.00,7000.00,5862.40,2137.60,0.20,0
38538,4013,1000.00,7000.00,8000.00,0.00,7000.00,0.09,1
38539,4013,-1000.00,6000.00,7000.00,4660.70,3339.30,0.31,0
38540,4013,1000.00,7000.00,8000.00,963.45,6036.55,0.34,1
38541,4013,1000.00,8000.00,9000.00,1207.87,6792.13,0.32,1
38542,4013,1000.00,9000.00,10000.00,2.24,8997.76,0.43,1
38543,4013,1000.00,10000.00,11000.00,4269.41,5730.59,0.26,1
38544,4013,1000.00,11000.00,12000.00,0.00,6524.27,0.08,1
38545,4013,1000.00,12000.00,13000.00,3885.95,8114.05,0.29,1
38546,4013,-1000.00,11000.00,12000.00,9443.30,0.00,0.03,0
38547,4013,1000.00,12000.00,13000.00,3377.57,8622.43,0.35,1
38548,4013,1000.00,13000.00,14000.00,0.00,5136.93,0.26,1
38549,4013,1000.00,14000.00,15000.00,0.00,11881.14,0.42,1
38550,4013,1000.00,15000.00,16000.00,2940.75,12059.25,0.31,1
38551,4013,1000.00,16000.00,17000.00,0.00,4720.44,0.16,1
38552,4013,1000.00,17000.00,18000.00,2300.17,6690.31,0.42,1
38553,4013,1000.00,18000.00,19000.00,0.00,12519.40,0.30,1
38554,4013,1000.00,19000.00,20000.00,0.00,19000.00,0.27,1
38555,4013,1000.00,20000.00,21000.00,0.00,19507.52,0.44,1
38556,4013,1000.00,21000.00,22000.00,0.00,21000.00,0.29,1
38557,4013,1000.00,22000.00,23000.00,2444.50,18562.36,0.42,1
38558,4013,1000.00,23000.00,24000.00,2647.30,20352.70,0.41,1
38559,4014,-993.85,-993.85,6.15,0.00,993.85,0.04,0
38560,4014,-6.15,-1000.00,0.00,1.75,4.40,0.09,0
38561,4015,1000.00,1000.00,2000.00,239.22,447.85,0.34,1
38562,4015,-1000.00,0.00,1000.00,1818.95,181.05,0.03,0
38563,4015,1000.00,1000.00,2000.00,471.82,528.18,0.11,1
38564,4015,-1000.00,0.00,1000.00,1998.80,1.20,0.01,0
38565,4015,-757.55,-757.55,242.45,490.13,267.42,0.15,0
38566,4015,1000.00,242.45,1242.45,0.00,233.28,0.24,1
38567,4015,1000.00,1242.45,2242.45,0.00,1242.45,0.01,1
38568,4015,1000.00,2242.45,3242.45,0.00,2242.45,0.20,1
38569,4015,1000.00,3242.45,4242.45,0.00,3242.45,0.05,1
38570,4015,1000.00,4242.45,5242.45,0.00,4242.45,0.02,1
38571,4015,1000.00,5242.45,6242.45,0.00,5242.45,0.20,1
38572,4015,1000.00,6242.45,7242.45,0.00,6242.45,0.27,1
38573,4015,1000.00,7242.45,8242.45,328.31,6577.73,0.44,1
38574,4015,1000.00,8242.45,9242.45,2447.62,5794.83,0.17,1
38575,4015,1000.00,9242.45,10242.45,1045.22,8197.23,0.25,1
38576,4015,1000.00,10242.45,11242.45,0.00,10242.45,0.35,1
38577,4015,1000.00,11242.45,12242.45,2057.81,9184.64,0.31,1
38578,4015,1000.00,12242.45,13242.45,0.00,12172.10,0.14,1
38579,4015,1000.00,13242.45,14242.45,6621.22,6621.22,0.07,1
38580,4015,-1000.00,12242.45,13242.45,3397.86,1575.08,0.14,0
38581,4015,1000.00,13242.45,14242.45,2539.69,10702.76,0.20,1
38582,4015,1000.00,14242.45,15242.45,0.00,9004.28,0.11,1
38583,4015,1000.00,15242.45,16242.45,6327.96,7596.64,0.25,1
38584,4015,-758.05,14484.40,15484.40,758.05,0.00,0.06,0
38585,4015,-1000.00,13484.40,14484.40,7742.20,7742.20,0.10,0
38586,4015,-1000.00,12484.40,13484.40,3948.92,10535.48,0.17,0
38587,4015,-1000.00,11484.40,12484.40,5525.38,7959.02,0.12,0
38588,4015,-1000.00,10484.40,11484.40,6004.04,6480.36,0.07,0
38589,4015,-1000.00,9484.40,10484.40,5633.11,5851.29,0.12,0
38590,4015,-1000.00,8484.40,9484.40,2270.37,8214.03,0.25,0
38591,4015,-1000.00,7484.40,8484.40,0.00,4822.50,0.32,0
38592,4015,-1000.00,6484.40,7484.40,469.74,8014.66,0.30,0
38593,4015,-1000.00,5484.40,6484.40,0.00,7484.40,0.08,0
38594,4015,-1000.00,4484.40,5484.40,0.00,6217.20,0.19,0
38595,4015,-1000.00,3484.40,4484.40,0.00,5484.40,0.10,0
38596,4015,-1000.00,2484.40,3484.40,0.00,4484.40,0.27,0
38597,4015,-1000.00,1484.40,2484.40,0.00,3095.48,0.43,0
38598,4015,-1000.00,484.40,1484.40,1956.09,528.31,0.03,0
38599,4015,-1000.00,-515.60,484.40,571.43,755.21,0.26,0
38600,4015,-216.09,-731.69,268.31,33.87,182.22,0.26,0
38601,4015,-268.31,-1000.00,0.00,41.32,226.99,0.16,0
38602,4016,0.00,0.00,1000.00,0.00,0.00,0.35,0
38603,4016,0.00,0.00,1000.00,0.00,0.00,0.11,0
38604,4016,-1000.00,-1000.00,0.00,408.03,591.97,0.17,0
38605,4017,1000.00,1000.00,2000.00,404.96,595.04,0.28,1
38606,4017,1000.00,2000.00,3000.00,679.84,1320.16,0.03,1
38607,4017,-1000.00,1000.00,2000.00,806.73,268.87,0.13,0
38608,4017,1000.00,2000.00,3000.00,351.51,651.06,0.23,1
38609,4017,1000.00,3000.00,4000.00,0.00,1875.09,0.36,1
38610,4017,1000.00,4000.00,5000.00,0.00,3805.71,0.40,1
38611,4017,1000.00,5000.00,6000.00,1551.13,3448.87,0.35,1
38612,4017,-1000.00,4000.00,5000.00,4807.03,0.00,0.02,0
38613,4017,1000.00,5000.00,6000.00,0.00,4538.72,0.27,1
38614,4017,1000.00,6000.00,7000.00,899.32,3631.61,0.35,1
38615,4017,1000.00,7000.00,8000.00,0.00,7000.00,0.16,1
38616,4017,1000.00,8000.00,9000.00,4000.00,4000.00,0.03,1
38617,4017,1000.00,9000.00,10000.00,3095.02,5904.98,0.31,1
38618,4017,1000.00,10000.00,11000.00,692.78,9307.22,0.40,1
38619,4017,1000.00,11000.00,12000.00,899.22,10100.78,0.40,1
38620,4017,1000.00,12000.00,13000.00,0.00,12000.00,0.33,1
38621,4017,1000.00,13000.00,14000.00,0.00,2951.81,0.06,1
38622,4017,-1000.00,12000.00,13000.00,7175.70,6824.30,0.20,0
38623,4017,1000.00,13000.00,14000.00,0.00,13000.00,0.31,1
38624,4017,1000.00,14000.00,15000.00,0.00,11197.32,0.21,1
38625,4017,1000.00,15000.00,16000.00,2108.24,12891.76,0.03,1
38626,4017,1000.00,16000.00,17000.00,7359.70,8640.30,0.08,1
38627,4017,1000.00,17000.00,18000.00,6504.74,10495.26,0.02,1
38628,4017,1000.00,18000.00,19000.00,7485.51,10514.49,0.39,1
38629,4017,1000.00,19000.00,20000.00,0.00,7173.48,0.25,1
38630,4017,1000.00,20000.00,21000.00,0.00,20000.00,0.02,1
38631,4017,1000.00,21000.00,22000.00,0.00,21000.00,0.04,1
38632,4017,1000.00,22000.00,23000.00,0.00,5873.38,0.20,1
38633,4017,1000.00,23000.00,24000.00,3038.26,19961.74,0.35,1
38634,4017,-1000.00,22000.00,23000.00,6548.81,3355.99,0.14,0
38635,4017,1000.00,23000.00,24000.00,0.00,23000.00,0.27,1
38636,4017,1000.00,24000.00,25000.00,0.00,21804.22,0.34,1
38637,4017,1000.00,25000.00,26000.00,7765.94,17234.06,0.07,1
38638,4017,1000.00,26000.00,27000.00,175.85,11741.09,0.29,1
38639,4017,1000.00,27000.00,28000.00,0.00,24378.66,0.44,1
38640,4017,1000.00,28000.00,29000.00,0.00,28000.00,0.14,1
38641,4017,1000.00,29000.00,30000.00,13122.16,15877.84,0.22,1
38642,4017,1000.00,30000.00,31000.00,0.00,29241.77,0.42,1
38643,4017,1000.00,31000.00,32000.00,0.00,19391.15,0.36,1
38644,4017,1000.00,32000.00,33000.00,3654.08,28345.92,0.19,1
38645,4017,1000.00,33000.00,34000.00,12428.33,20571.67,0.24,1
38646,4017,1000.00,34000.00,35000.00,0.00,34000.00,0.43,1
38647,4017,1000.00,35000.00,36000.00,15269.07,19730.93,0.17,1
38648,4017,1000.00,36000.00,37000.00,0.00,36000.00,0.14,1
38649,4017,1000.00,37000.00,38000.00,13195.39,20703.99,0.28,1
38650,4017,0.00,37000.00,38000.00,0.00,0.00,0.02,0
38651,4017,1000.00,38000.00,39000.00,0.00,38000.00,0.31,1
38652,4018,-293.39,-293.39,706.61,0.00,293.39,0.21,0
38653,4018,-312.95,-606.34,393.66,0.00,312.95,0.19,0
38654,4018,-393.66,-1000.00,0.00,0.00,393.66,0.19,0
38655,4019,-1000.00,-1000.00,0.00,0.00,1000.00,0.30,0
38656,4020,-1000.00,-1000.00,0.00,0.00,1000.00,0.18,0
38657,4021,-1000.00,-1000.00,0.00,163.01,836.99,0.26,0
38658,4022,0.00,0.00,1000.00,0.00,0.00,0.07,0
38659,4022,-737.79,-737.79,262.21,0.00,737.79,0.29,0
38660,4022,-227.35,-965.14,34.86,0.00,227.35,0.37,0
38661,4022,-34.86,-1000.00,0.00,0.00,34.86,0.30,0
38662,4023,-1000.00,-1000.00,0.00,205.68,794.32,0.21,0
38663,4024,-1000.00,-1000.00,0.00,0.00,963.60,0.43,0
38664,4025,-1000.00,-1000.00,0.00,0.00,1000.00,0.11,0
38665,4026,-1000.00,-1000.00,0.00,0.00,1000.00,0.31,0
38666,4027,0.00,0.00,1000.00,0.00,0.00,0.06,0
38667,4027,0.00,0.00,1000.00,0.00,0.00,0.38,0
38668,4027,-1000.00,-1000.00,0.00,0.00,1000.00,0.00,0
38669,4028,1000.00,1000.00,2000.00,0.00,898.34,0.30,1
38670,4028,1000.00,2000.00,3000.00,675.61,1324.39,0.13,1
38671,4028,1000.00,3000.00,4000.00,209.44,2790.56,0.21,1
38672,4028,1000.00,4000.00,5000.00,1576.14,2423.86,0.20,1
38673,4028,1000.00,5000.00,6000.00,182.97,4817.03,0.01,1
38674,4028,1000.00,6000.00,7000.00,2987.88,3012.12,0.11,1
38675,4028,1000.00,7000.00,8000.00,0.00,6147.22,0.38,1
38676,4028,1000.00,8000.00,9000.00,0.00,6462.43,0.35,1
38677,4028,1000.00,9000.00,10000.00,1479.65,7520.35,0.41,1
38678,4028,1000.00,10000.00,11000.00,3841.73,6158.27,0.13,1
38679,4028,1000.00,11000.00,12000.00,0.00,4764.82,0.13,1
38680,4028,1000.00,12000.00,13000.00,4399.05,7600.95,0.18,1
38681,4028,1000.00,13000.00,14000.00,3116.11,9883.89,0.37,1
38682,4028,1000.00,14000.00,15000.00,0.00,14000.00,0.09,1
38683,4028,-1000.00,13000.00,14000.00,7564.80,5258.94,0.17,0
38684,4028,-1000.00,12000.00,13000.00,12126.35,0.00,0.02,0
38685,4028,1000.00,13000.00,14000.00,0.00,13000.00,0.23,1
38686,4028,-1000.00,12000.00,13000.00,12045.33,1954.67,0.00,0
38687,4028,1000.00,13000.00,14000.00,4985.99,8014.01,0.05,1
38688,4028,-617.47,12382.53,13382.53,617.47,0.00,0.11,0
38689,4028,1000.00,13382.53,14382.53,5912.38,7470.15,0.35,1
38690,4028,-1000.00,12382.53,13382.53,7642.60,6739.93,0.29,0
38691,4028,1000.00,13382.53,14382.53,3568.68,9813.84,0.23,1
38692,4028,1000.00,14382.53,15382.53,0.00,13006.32,0.33,1
38693,4028,-1000.00,13382.53,14382.53,3152.72,12229.80,0.10,0
38694,4028,-1000.00,12382.53,13382.53,14382.53,0.00,0.01,0
38695,4028,0.00,12382.53,13382.53,0.00,0.00,0.29,0
38696,4028,-1000.00,11382.53,12382.53,1166.41,12216.11,0.38,0
38697,4028,-1000.00,10382.53,11382.53,7225.64,5156.89,0.01,0
38698,4028,-1000.00,9382.53,10382.53,5691.26,5691.26,0.09,0
38699,4028,-1000.00,8382.53,9382.53,8540.70,1841.82,0.04,0
38700,4028,-1000.00,7382.53,8382.53,4061.76,5320.77,0.19,0
38701,4028,-1000.00,6382.53,7382.53,0.00,3202.22,0.13,0
38702,4028,-1000.00,5382.53,6382.53,2010.35,0.00,0.14,0
38703,4028,-1000.00,4382.53,5382.53,0.00,6382.53,0.11,0
38704,4028,-710.84,3671.69,4671.69,710.84,0.00,0.21,0
38705,4028,-1000.00,2671.69,3671.69,0.00,2766.94,0.15,0
38706,4028,-1000.00,1671.69,2671.69,894.51,2777.18,0.15,0
38707,4028,0.00,1671.69,2671.69,0.00,0.00,0.28,0
38708,4028,-1000.00,671.69,1671.69,241.19,2430.50,0.44,0
38709,4028,-1000.00,-328.31,671.69,0.00,920.26,0.33,0
38710,4028,0.00,-328.31,671.69,0.00,0.00,0.32,0
38711,4028,-1000.00,-1328.31,-328.31,0.00,670.14,0.19,0
38712,4029,1000.00,1000.00,2000.00,280.58,719.42,0.34,1
38713,4029,1000.00,2000.00,3000.00,0.00,1176.79,0.11,1
38714,4029,1000.00,3000.00,4000.00,0.00,3000.00,0.20,1
38715,4029,-1000.00,2000.00,3000.00,1429.14,0.00,0.04,0
38716,4029,1000.00,3000.00,4000.00,1500.00,1500.00,0.01,1
38717,4029,1000.00,4000.00,5000.00,0.00,4000.00,0.24,1
38718,4029,-1000.00,3000.00,4000.00,2017.65,1617.16,0.21,0
38719,4029,-1000.00,2000.00,3000.00,1684.82,147.06,0.10,0
38720,4029,1000.00,3000.00,4000.00,1101.15,1898.85,0.31,1
38721,4029,1000.00,4000.00,5000.00,0.00,4000.00,0.01,1
38722,4029,1000.00,5000.00,6000.00,0.00,4403.50,0.23,1
38723,4029,1000.00,6000.00,7000.00,0.00,1456.26,0.11,1
38724,4029,1000.00,7000.00,8000.00,3482.68,3517.32,0.19,1
38725,4029,1000.00,8000.00,9000.00,0.00,6993.06,0.22,1
38726,4029,1000.00,9000.00,10000.00,0.00,8718.44,0.44,1
38727,4029,-490.28,8509.72,9509.72,490.28,0.00,0.03,0
38728,4029,1000.00,9509.72,10509.72,931.83,8577.90,0.43,1
38729,4029,1000.00,10509.72,11509.72,0.00,5995.30,0.14,1
38730,4029,1000.00,11509.72,12509.72,1895.07,9614.65,0.35,1
38731,4029,1000.00,12509.72,13509.72,4453.08,8056.65,0.18,1
38732,4029,-1000.00,11509.72,12509.72,6600.47,6909.26,0.20,0
38733,4029,-1000.00,10509.72,11509.72,4128.55,8381.17,0.14,0
38734,4029,-1000.00,9509.72,10509.72,0.00,8995.95,0.34,0
38735,4029,-1000.00,8509.72,9509.72,1480.09,9029.63,0.18,0
38736,4029,-1000.00,7509.72,8509.72,0.00,9509.72,0.16,0
38737,4029,-1000.00,6509.72,7509.72,0.00,5949.29,0.32,0
38738,4029,-1000.00,5509.72,6509.72,3754.86,3754.86,0.07,0
38739,4029,-1000.00,4509.72,5509.72,0.00,6509.72,0.38,0
38740,4029,-1000.00,3509.72,4509.72,2817.04,2692.69,0.20,0
38741,4029,-1000.00,2509.72,3509.72,2786.38,1723.35,0.14,0
38742,4029,-1000.00,1509.72,2509.72,1304.01,2205.72,0.22,0
38743,4029,-1000.00,509.72,1509.72,515.29,1994.43,0.28,0
38744,4029,-1000.00,-490.28,509.72,301.86,1207.86,0.40,0
38745,4029,-1000.00,-1490.28,-490.28,500.74,8.99,0.02,0
38746,4030,0.00,0.00,1000.00,0.00,0.00,0.33,0
38747,4030,-1000.00,-1000.00,0.00,0.00,232.57,0.33,0
38748,4031,-1000.00,-1000.00,0.00,0.00,1000.00,0.08,0
38749,4032,1000.00,1000.00,2000.00,503.86,0.00,0.21,1
38750,4032,1000.00,2000.00,3000.00,67.98,0.00,0.29,1
38751,4032,-1000.00,1000.00,2000.00,0.00,1618.31,0.20,0
38752,4032,-1000.00,0.00,1000.00,0.00,1145.92,0.27,0
38753,4032,0.00,0.00,1000.00,0.00,0.00,0.30,0
38754,4032,1000.00,1000.00,2000.00,15.80,0.00,0.40,1
38755,4032,-1000.00,0.00,1000.00,0.00,2000.00,0.24,0
38756,4032,0.00,0.00,1000.00,0.00,0.00,0.14,0
38757,4032,1000.00,1000.00,2000.00,798.82,0.00,0.03,1
38758,4032,-80.39,919.61,1919.61,0.00,80.39,0.29,0
38759,4032,-1000.00,-80.39,919.61,583.32,1336.29,0.17,0
38760,4032,-919.61,-1000.00,0.00,42.92,876.69,0.16,0
38761,4033,-1000.00,-1000.00,0.00,510.21,489.79,0.13,0
38762,4034,-1000.00,-1000.00,0.00,296.12,703.88,0.24,0
38763,4035,0.00,0.00,1000.00,0.00,0.00,0.03,0
38764,4035,-1000.00,-1000.00,0.00,334.72,665.28,0.26,0
38765,4036,-1000.00,-1000.00,0.00,0.00,1000.00,0.13,0
38766,4037,-1000.00,-1000.00,0.00,500.00,500.00,0.02,0
38767,4038,1000.00,1000.00,2000.00,823.46,176.54,0.09,1
38768,4038,0.00,1000.00,2000.00,0.00,0.00,0.11,0
38769,4038,-1000.00,0.00,1000.00,0.00,1719.13,0.44,0
38770,4038,1000.00,1000.00,2000.00,639.10,360.90,0.10,1
38771,4038,-1000.00,0.00,1000.00,499.66,1500.34,0.39,0
38772,4038,-1000.00,-1000.00,0.00,345.61,654.39,0.30,0
38773,4039,-1000.00,-1000.00,0.00,413.86,586.14,0.27,0
38774,4040,1000.00,1000.00,2000.00,150.71,849.29,0.42,1
38775,4040,1000.00,2000.00,3000.00,971.98,1028.02,0.06,1
38776,4040,1000.00,3000.00,4000.00,0.00,3000.00,0.24,1
38777,4040,1000.00,4000.00,5000.00,2000.00,2000.00,0.02,1
38778,4040,1000.00,5000.00,6000.00,0.00,140.77,0.10,1
38779,4040,1000.00,6000.00,7000.00,0.00,6000.00,0.42,1
38780,4040,1000.00,7000.00,8000.00,3500.00,3500.00,0.02,1
38781,4040,1000.00,8000.00,9000.00,2168.74,3287.87,0.25,1
38782,4040,1000.00,9000.00,10000.00,3594.80,5405.20,0.29,1
38783,4040,1000.00,10000.00,11000.00,1565.54,4813.57,0.28,1
38784,4040,1000.00,11000.00,12000.00,0.00,11000.00,0.31,1
38785,4040,1000.00,12000.00,13000.00,0.00,7563.42,0.18,1
38786,4040,1000.00,13000.00,14000.00,0.00,13000.00,0.32,1
38787,4040,1000.00,14000.00,15000.00,4797.33,9202.67,0.31,1
38788,4040,1000.00,15000.00,16000.00,6247.83,8752.17,0.11,1
38789,4040,1000.00,16000.00,17000.00,6804.20,9195.80,0.21,1
38790,4040,1000.00,17000.00,18000.00,0.00,17000.00,0.25,1
38791,4040,-1000.00,16000.00,17000.00,9914.08,8085.92,0.10,0
38792,4040,1000.00,17000.00,18000.00,630.94,11054.98,0.37,1
38793,4040,-1000.00,16000.00,17000.00,6314.35,3222.29,0.15,0
38794,4040,1000.00,17000.00,18000.00,0.00,17000.00,0.21,1
38795,4040,1000.00,18000.00,19000.00,7894.59,10105.41,0.35,1
38796,4040,-1000.00,17000.00,18000.00,0.00,19000.00,0.14,0
38797,4040,-1000.00,16000.00,17000.00,0.00,18000.00,0.23,0
38798,4040,-1000.00,15000.00,16000.00,4017.56,12982.44,0.15,0
38799,4040,-1000.00,14000.00,15000.00,0.00,4406.39,0.21,0
38800,4040,-1000.00,13000.00,14000.00,2295.43,12704.57,0.02,0
38801,4040,-1000.00,12000.00,13000.00,0.00,14000.00,0.12,0
38802,4040,-1000.00,11000.00,12000.00,0.00,12342.54,0.38,0
38803,4040,-1000.00,10000.00,11000.00,0.00,8867.40,0.17,0
38804,4040,-1000.00,9000.00,10000.00,3495.00,7505.00,0.03,0
38805,4040,-1000.00,8000.00,9000.00,4479.32,5520.68,0.17,0
38806,4040,-1000.00,7000.00,8000.00,0.00,8573.08,0.43,0
38807,4040,-1000.00,6000.00,7000.00,0.00,2595.64,0.10,0
38808,4040,-1000.00,5000.00,6000.00,0.00,5297.43,0.27,0
38809,4040,-1000.00,4000.00,5000.00,0.00,4625.42,0.41,0
38810,4040,-948.95,3051.05,4051.05,0.00,948.95,0.18,0
38811,4040,1000.00,4051.05,5051.05,0.00,4051.05,0.29,1
38812,4040,1000.00,5051.05,6051.05,0.00,5051.05,0.27,1
38813,4040,-1000.00,4051.05,5051.05,4271.88,1779.17,0.26,0
38814,4040,1000.00,5051.05,6051.05,2111.45,2939.60,0.21,1
38815,4040,1000.00,6051.05,7051.05,0.00,1804.54,0.19,1
38816,4040,1000.00,7051.05,8051.05,0.00,4622.30,0.37,1
38817,4040,-1000.00,6051.05,7051.05,5890.89,2160.16,0.09,0
38818,4040,1000.00,7051.05,8051.05,0.00,7051.05,0.07,1
38819,4040,1000.00,8051.05,9051.05,4025.53,4025.53,0.04,1
38820,4040,1000.00,9051.05,10051.05,0.00,9051.05,0.44,1
38821,4040,1000.00,10051.05,11051.05,856.21,9194.84,0.44,1
38822,4040,1000.00,11051.05,12051.05,0.00,11051.05,0.40,1
38823,4040,1000.00,12051.05,13051.05,0.00,12051.05,0.01,1
38824,4040,1000.00,13051.05,14051.05,6525.53,6525.53,0.04,1
38825,4040,1000.00,14051.05,15051.05,0.00,13657.14,0.44,1
38826,4040,1000.00,15051.05,16051.05,0.00,6559.25,0.24,1
38827,4041,1000.00,1000.00,2000.00,316.53,0.00,0.38,1
38828,4041,0.00,1000.00,2000.00,0.00,0.00,0.36,0
38829,4041,1000.00,2000.00,3000.00,572.55,0.00,0.01,1
38830,4041,-1000.00,1000.00,2000.00,0.00,1216.86,0.14,0
38831,4041,-1000.00,0.00,1000.00,0.00,2000.00,0.06,0
38832,4041,1000.00,1000.00,2000.00,533.01,466.99,0.19,1
38833,4041,1000.00,2000.00,3000.00,2000.00,0.00,0.08,1
38834,4041,-1000.00,1000.00,2000.00,0.00,2478.70,0.16,0
38835,4041,1000.00,2000.00,3000.00,1297.98,345.84,0.24,1
38836,4041,-1000.00,1000.00,2000.00,0.00,1258.80,0.02,0
38837,4041,1000.00,2000.00,3000.00,447.94,0.00,0.30,1
38838,4041,-1000.00,1000.00,2000.00,0.00,2243.96,0.07,0
38839,4041,1000.00,2000.00,3000.00,2000.00,0.00,0.07,1
38840,4041,0.00,2000.00,3000.00,0.00,0.00,0.00,0
38841,4041,0.00,2000.00,3000.00,0.00,0.00,0.26,0
38842,4041,-717.42,1282.58,2282.58,0.00,717.42,0.38,0
38843,4041,-1000.00,282.58,1282.58,863.88,1078.13,0.27,0
38844,4041,-1000.00,-717.42,282.58,0.00,429.85,0.21,0
38845,4041,-282.58,-1000.00,0.00,217.00,65.58,0.14,0
38846,4042,-1000.00,-1000.00,0.00,0.00,362.59,0.17,0
38847,4043,-1000.00,-1000.00,0.00,614.86,385.14,0.10,0
38848,4044,-1000.00,-1000.00,0.00,0.00,1000.00,0.07,0
38849,4045,-1000.00,-1000.00,0.00,0.00,1000.00,0.01,0
38850,4046,-1000.00,-1000.00,0.00,0.00,1000.00,0.11,0
38851,4047,-1000.00,-1000.00,0.00,202.49,797.51,0.40,0
38852,4048,-1000.00,-1000.00,0.00,0.00,1000.00,0.30,0
38853,4049,-1000.00,-1000.00,0.00,425.99,498.05,0.25,0
38854,4050,1000.00,1000.00,2000.00,180.58,819.42,0.36,1
38855,4050,-1000.00,0.00,1000.00,1035.59,951.73,0.21,0
38856,4050,1000.00,1000.00,2000.00,304.00,696.00,0.21,1
38857,4050,1000.00,2000.00,3000.00,0.00,581.97,0.10,1
38858,4050,1000.00,3000.00,4000.00,595.16,2404.84,0.34,1
38859,4050,0.00,3000.00,4000.00,0.00,0.00,0.06,0
38860,4050,1000.00,4000.00,5000.00,0.00,4000.00,0.24,1
38861,4050,1000.00,5000.00,6000.00,0.00,5000.00,0.21,1
38862,4050,1000.00,6000.00,7000.00,3000.00,3000.00,0.00,1
38863,4050,1000.00,7000.00,8000.00,704.16,6295.84,0.43,1
38864,4050,1000.00,8000.00,9000.00,0.00,7223.59,0.26,1
38865,4050,1000.00,9000.00,10000.00,0.00,4784.16,0.17,1
38866,4050,1000.00,10000.00,11000.00,3823.21,6176.79,0.26,1
38867,4050,1000.00,11000.00,12000.00,2497.16,8502.84,0.24,1
38868,4050,0.00,11000.00,12000.00,0.00,0.00,0.05,0
38869,4050,1000.00,12000.00,13000.00,0.00,12000.00,0.41,1
38870,4050,1000.00,13000.00,14000.00,0.00,5019.10,0.19,1
38871,4050,1000.00,14000.00,15000.00,0.00,3524.14,0.20,1
38872,4050,1000.00,15000.00,16000.00,3472.56,11527.44,0.38,1
38873,4050,1000.00,16000.00,17000.00,0.00,14386.36,0.43,1
38874,4050,1000.00,17000.00,18000.00,0.00,4443.60,0.14,1
38875,4050,1000.00,18000.00,19000.00,6080.99,11919.01,0.23,1
38876,4050,1000.00,19000.00,20000.00,0.00,14622.05,0.26,1
38877,4050,-1000.00,18000.00,19000.00,11577.37,8422.63,0.13,0
38878,4050,1000.00,19000.00,20000.00,0.00,4512.13,0.19,1
38879,4050,1000.00,20000.00,21000.00,4546.85,15453.15,0.40,1
38880,4050,1000.00,21000.00,22000.00,10500.00,10500.00,0.01,1
38881,4050,1000.00,22000.00,23000.00,0.00,15340.27,0.12,1
38882,4050,1000.00,23000.00,24000.00,4887.46,18112.54,0.20,1
38883,4050,-1000.00,22000.00,23000.00,19719.05,0.00,0.03,0
38884,4050,1000.00,23000.00,24000.00,2311.11,20688.89,0.34,1
38885,4050,1000.00,24000.00,25000.00,0.00,14968.43,0.30,1
38886,4050,1000.00,25000.00,26000.00,10224.47,14775.53,0.03,1
38887,4050,1000.00,26000.00,27000.00,0.00,26000.00,0.02,1
38888,4050,1000.00,27000.00,28000.00,7490.39,19509.61,0.35,1
38889,4050,-1000.00,26000.00,27000.00,13761.74,0.00,0.00,0
38890,4050,1000.00,27000.00,28000.00,12179.56,14820.44,0.12,1
38891,4050,1000.00,28000.00,29000.00,9000.01,18999.99,0.27,1
38892,4050,1000.00,29000.00,30000.00,0.00,29000.00,0.07,1
38893,4050,1000.00,30000.00,31000.00,0.00,30000.00,0.28,1
38894,4050,1000.00,31000.00,32000.00,9232.06,21767.94,0.32,1
38895,4050,1000.00,32000.00,33000.00,16000.00,16000.00,0.18,1
38896,4050,1000.00,33000.00,34000.00,8865.93,24134.07,0.37,1
38897,4050,1000.00,34000.00,35000.00,0.00,34000.00,0.33,1
38898,4050,1000.00,35000.00,36000.00,284.08,34715.92,0.13,1
38899,4050,-1000.00,34000.00,35000.00,18086.97,17913.03,0.16,0
38900,4050,1000.00,35000.00,36000.00,0.00,35000.00,0.15,1
38901,4050,-1000.00,34000.00,35000.00,19363.43,16636.57,0.35,0
38902,4050,-1000.00,33000.00,34000.00,14441.80,7836.48,0.15,0
38903,4050,-1000.00,32000.00,33000.00,11406.25,22593.75,0.31,0
38904,4050,-1000.00,31000.00,32000.00,0.00,33000.00,0.09,0
38905,4050,-1000.00,30000.00,31000.00,0.00,13314.40,0.04,0
38906,4050,-1000.00,29000.00,30000.00,0.00,31000.00,0.03,0
38907,4050,-1000.00,28000.00,29000.00,0.00,30000.00,0.12,0
38908,4050,-1000.00,27000.00,28000.00,17464.86,0.00,0.02,0
38909,4050,-1000.00,26000.00,27000.00,2630.24,25369.76,0.03,0
38910,4050,-1000.00,25000.00,26000.00,0.00,27000.00,0.42,0
38911,4050,-1000.00,24000.00,25000.00,0.00,19202.06,0.32,0
38912,4050,-1000.00,23000.00,24000.00,0.00,25000.00,0.12,0
38913,4050,-1000.00,22000.00,23000.00,6696.54,5919.93,0.18,0
38914,4050,-1000.00,21000.00,22000.00,631.58,18491.90,0.42,0
38915,4050,-1000.00,20000.00,21000.00,0.00,22000.00,0.19,0
38916,4050,-1000.00,19000.00,20000.00,0.00,13800.88,0.20,0
38917,4050,-1000.00,18000.00,19000.00,0.00,20000.00,0.35,0
38918,4050,-1000.00,17000.00,18000.00,9500.00,9500.00,0.02,0
38919,4050,-1000.00,16000.00,17000.00,10223.48,7776.52,0.10,0
38920,4050,-1000.00,15000.00,16000.00,6977.06,10022.94,0.27,0
38921,4050,-1000.00,14000.00,15000.00,2835.59,0.00,0.09,0
38922,4051,-1000.00,-1000.00,0.00,0.00,1000.00,0.07,0
38923,4052,1000.00,1000.00,2000.00,306.75,693.25,0.24,1
38924,4052,1000.00,2000.00,3000.00,0.00,2000.00,0.05,1
38925,4052,1000.00,3000.00,4000.00,1500.00,1500.00,0.07,1
38926,4052,1000.00,4000.00,5000.00,299.13,3001.14,0.40,1
38927,4052,1000.00,5000.00,6000.00,0.00,5000.00,0.14,1
38928,4052,1000.00,6000.00,7000.00,994.00,5006.00,0.28,1
38929,4052,1000.00,7000.00,8000.00,0.00,1800.68,0.19,1
38930,4052,1000.00,8000.00,9000.00,1515.16,2537.43,0.22,1
38931,4052,1000.00,9000.00,10000.00,4033.62,4966.38,0.24,1
38932,4052,1000.00,10000.00,11000.00,0.00,9302.86,0.43,1
38933,4052,1000.00,11000.00,12000.00,1505.13,9193.30,0.41,1
38934,4052,1000.00,12000.00,13000.00,3198.90,8010.25,0.34,1
38935,4052,1000.00,13000.00,14000.00,4960.92,8039.08,0.27,1
38936,4052,1000.00,14000.00,15000.00,735.20,13264.80,0.29,1
38937,4052,1000.00,15000.00,16000.00,0.00,9814.98,0.12,1
38938,4052,1000.00,16000.00,17000.00,3410.92,12589.08,0.40,1
38939,4052,1000.00,17000.00,18000.00,0.00,3642.70,0.07,1
38940,4052,1000.00,18000.00,19000.00,0.00,9239.83,0.22,1
38941,4052,-1000.00,17000.00,18000.00,0.00,19000.00,0.22,0
38942,4052,-1000.00,16000.00,17000.00,8914.89,9085.11,0.06,0
38943,4052,-1000.00,15000.00,16000.00,0.00,8212.33,0.26,0
38944,4052,-1000.00,14000.00,15000.00,0.00,10647.44,0.25,0
38945,4052,0.00,14000.00,15000.00,0.00,0.00,0.15,0
38946,4052,-1000.00,13000.00,14000.00,10105.85,4894.15,0.40,0
38947,4052,1000.00,14000.00,15000.00,0.00,8768.90,0.22,1
38948,4052,1000.00,15000.00,16000.00,4270.85,10729.15,0.24,1
38949,4052,1000.00,16000.00,17000.00,0.00,16000.00,0.25,1
38950,4052,-1000.00,15000.00,16000.00,8315.94,6991.05,0.20,0
38951,4052,1000.00,16000.00,17000.00,2588.74,5968.59,0.25,1
38952,4052,1000.00,17000.00,18000.00,3272.35,13727.65,0.01,1
38953,4052,1000.00,18000.00,19000.00,9000.00,9000.00,0.10,1
38954,4052,1000.00,19000.00,20000.00,3861.33,15138.67,0.10,1
38955,4052,1000.00,20000.00,21000.00,0.00,20000.00,0.04,1
38956,4052,1000.00,21000.00,22000.00,0.00,21000.00,0.01,1
38957,4052,1000.00,22000.00,23000.00,0.00,21104.76,0.22,1
38958,4052,1000.00,23000.00,24000.00,767.47,13527.35,0.35,1
38959,4052,1000.00,24000.00,25000.00,0.00,24000.00,0.31,1
38960,4052,1000.00,25000.00,26000.00,7758.13,17241.87,0.28,1
38961,4052,1000.00,26000.00,27000.00,0.00,11065.44,0.27,1
38962,4052,1000.00,27000.00,28000.00,11621.62,15378.38,0.16,1
38963,4052,1000.00,28000.00,29000.00,0.00,12977.08,0.30,1
38964,4052,1000.00,29000.00,30000.00,7255.15,21744.85,0.23,1
38965,4052,1000.00,30000.00,31000.00,12157.17,17842.83,0.38,1
38966,4052,1000.00,31000.00,32000.00,0.00,29719.10,0.29,1
38967,4052,1000.00,32000.00,33000.00,0.00,32000.00,0.44,1
38968,4052,1000.00,33000.00,34000.00,484.63,16547.79,0.31,1
38969,4052,1000.00,34000.00,35000.00,2836.54,31163.46,0.28,1
38970,4053,-658.92,-658.92,341.08,418.29,240.63,0.16,0
38971,4053,1000.00,341.08,1341.08,121.14,219.94,0.28,1
38972,4053,0.00,341.08,1341.08,0.00,0.00,0.08,0
38973,4053,1000.00,1341.08,2341.08,0.00,1341.08,0.19,1
38974,4053,-936.77,404.31,1404.31,936.77,0.00,0.03,0
38975,4053,1000.00,1404.31,2404.31,0.00,216.84,0.16,1
38976,4053,1000.00,2404.31,3404.31,0.00,1625.25,0.37,1
38977,4053,1000.00,3404.31,4404.31,0.00,3404.31,0.40,1
38978,4053,1000.00,4404.31,5404.31,0.00,4404.31,0.42,1
38979,4053,1000.00,5404.31,6404.31,757.61,4646.70,0.39,1
38980,4053,1000.00,6404.31,7404.31,0.00,3808.09,0.32,1
38981,4053,1000.00,7404.31,8404.31,2711.57,4692.74,0.29,1
38982,4053,1000.00,8404.31,9404.31,0.00,8404.31,0.33,1
38983,4053,1000.00,9404.31,10404.31,1627.08,7777.22,0.31,1
38984,4053,1000.00,10404.31,11404.31,1735.92,8668.38,0.40,1
38985,4053,-1000.00,9404.31,10404.31,6300.05,5104.25,0.39,0
38986,4053,1000.00,10404.31,11404.31,0.00,3727.17,0.09,1
38987,4053,1000.00,11404.31,12404.31,0.00,10557.27,0.38,1
38988,4053,1000.00,12404.31,13404.31,0.00,8602.08,0.30,1
38989,4053,1000.00,13404.31,14404.31,0.00,13404.31,0.06,1
38990,4053,1000.00,14404.31,15404.31,3321.65,11082.66,0.32,1
38991,4053,1000.00,15404.31,16404.31,4752.36,10651.95,0.32,1
38992,4053,-1000.00,14404.31,15404.31,8965.87,7438.43,0.41,0
38993,4053,-1000.00,13404.31,14404.31,0.00,15404.31,0.09,0
38994,4053,-1000.00,12404.31,13404.31,5664.74,8739.56,0.24,0
38995,4053,-1000.00,11404.31,12404.31,0.00,3614.33,0.17,0
38996,4053,-1000.00,10404.31,11404.31,0.00,12404.31,0.33,0
38997,4053,-1000.00,9404.31,10404.31,2366.88,9037.43,0.28,0
38998,4053,-71.18,9333.13,10333.13,0.00,71.18,0.09,0
38999,4053,-1000.00,8333.13,9333.13,0.00,10333.13,0.33,0
39000,4053,-1000.00,7333.13,8333.13,4307.98,5025.15,0.13,0
39001,4053,-1000.00,6333.13,7333.13,2617.29,5080.49,0.31,0
39002,4053,-1000.00,5333.13,6333.13,0.00,7333.13,0.33,0
39003,4053,0.00,5333.13,6333.13,0.00,0.00,0.01,0
39004,4053,-1000.00,4333.13,5333.13,2694.65,3638.48,0.25,0
39005,4053,-1000.00,3333.13,4333.13,2092.88,3240.25,0.05,0
39006,4053,-1000.00,2333.13,3333.13,331.22,4001.91,0.20,0
39007,4053,-1000.00,1333.13,2333.13,0.00,3333.13,0.36,0
39008,4053,-1000.00,333.13,1333.13,0.00,2333.13,0.32,0
39009,4053,-1000.00,-666.87,333.13,414.67,918.46,0.28,0
39010,4053,-333.13,-1000.00,0.00,0.00,333.13,0.33,0
39011,4054,-1000.00,-1000.00,0.00,82.18,461.45,0.43,0
39012,4055,-977.28,-977.28,22.72,399.64,577.65,0.35,0
39013,4055,-17.03,-994.31,5.69,0.00,17.03,0.25,0
39014,4055,850.19,-144.13,855.87,5.12,0.00,0.08,1
39015,4055,1000.00,855.87,1855.87,250.26,0.00,0.11,1
39016,4055,1000.00,1855.87,2855.87,1524.36,0.00,0.16,1
39017,4055,-1000.00,855.87,1855.87,426.72,2065.44,0.22,0
39018,4055,0.00,855.87,1855.87,0.00,0.00,0.22,0
39019,4055,-1000.00,-144.13,855.87,0.00,1535.10,0.17,0
39020,4055,-633.75,-777.88,222.12,0.00,633.75,0.25,0
39021,4055,-55.02,-832.90,167.10,0.00,55.02,0.16,0
39022,4055,1000.00,167.10,1167.10,167.10,0.00,0.07,1
39023,4055,1000.00,1167.10,2167.10,656.87,510.23,0.17,1
39024,4055,1000.00,2167.10,3167.10,1248.26,0.00,0.27,1
39025,4055,1000.00,3167.10,4167.10,2226.75,940.35,0.04,1
39026,4055,-1000.00,2167.10,3167.10,0.00,1134.94,0.36,0
39027,4055,1000.00,3167.10,4167.10,1613.90,0.00,0.27,1
39028,4055,-1000.00,2167.10,3167.10,2083.55,2083.55,0.00,0
39029,4055,-1000.00,1167.10,2167.10,0.00,1894.50,0.31,0
39030,4055,1000.00,2167.10,3167.10,1029.40,313.98,0.13,1
39031,4055,-1000.00,1167.10,2167.10,397.27,2769.83,0.27,0
39032,4055,-1000.00,167.10,1167.10,1061.88,1105.22,0.09,0
39033,4055,-1000.00,-832.90,167.10,394.06,773.04,0.20,0
39034,4055,1000.00,167.10,1167.10,112.94,54.16,0.07,1
39035,4055,-518.02,-350.92,649.08,0.00,518.02,0.09,0
39036,4055,-206.06,-556.98,443.02,49.44,156.62,0.41,0
39037,4055,-42.03,-599.01,400.99,0.00,42.03,0.01,0
39038,4055,1000.00,400.99,1400.99,301.40,99.58,0.04,1
39039,4055,-181.74,219.25,1219.25,0.00,181.74,0.33,0
39040,4055,-1000.00,-780.75,219.25,330.62,681.08,0.33,0
39041,4055,0.00,-780.75,219.25,0.00,0.00,0.32,0
39042,4055,0.00,-780.75,219.25,0.00,0.00,0.29,0
39043,4055,-197.53,-978.29,21.71,0.00,197.53,0.10,0
39044,4055,0.00,-978.29,21.71,0.00,0.00,0.30,0
39045,4055,0.00,-978.29,21.71,0.00,0.00,0.31,0
39046,4055,1000.00,21.71,1021.71,21.71,0.00,0.06,1
39047,4056,-1000.00,-1000.00,0.00,841.55,158.45,0.02,0
39048,4057,0.00,0.00,1000.00,0.00,0.00,0.04,0
39049,4057,0.00,0.00,1000.00,0.00,0.00,0.05,0
39050,4057,1000.00,1000.00,2000.00,1000.00,0.00,0.08,1
39051,4057,-1000.00,0.00,1000.00,735.37,1264.63,0.23,0
39052,4057,-1000.00,-1000.00,0.00,415.05,584.95,0.22,0
39053,4058,-1000.00,-1000.00,0.00,0.00,1000.00,0.28,0
39054,4059,0.00,0.00,1000.00,0.00,0.00,0.39,0
39055,4059,0.00,0.00,1000.00,0.00,0.00,0.35,0
39056,4059,-1000.00,-1000.00,0.00,0.00,285.62,0.41,0
39057,4060,-1000.00,-1000.00,0.00,0.00,1000.00,0.31,0
39058,4061,-579.74,-579.74,420.26,579.74,0.00,0.11,0
39059,4061,-1000.00,-1579.74,-579.74,0.00,46.17,0.41,0
39060,4062,-1000.00,-1000.00,0.00,86.46,913.54,0.26,0
39061,4063,-1000.00,-1000.00,0.00,158.39,841.61,0.41,0
39062,4064,-1000.00,-1000.00,0.00,0.00,1000.00,0.26,0
39063,4065,1000.00,1000.00,2000.00,0.00,893.15,0.37,1
39064,4065,1000.00,2000.00,3000.00,814.42,1185.58,0.23,1
39065,4065,1000.00,3000.00,4000.00,0.00,3000.00,0.44,1
39066,4065,1000.00,4000.00,5000.00,0.00,2827.11,0.22,1
39067,4065,1000.00,5000.00,6000.00,0.00,3136.37,0.24,1
39068,4065,-1000.00,4000.00,5000.00,3387.92,2612.08,0.30,0
39069,4065,1000.00,5000.00,6000.00,0.00,5000.00,0.10,1
39070,4065,1000.00,6000.00,7000.00,0.00,6000.00,0.40,1
39071,4065,1000.00,7000.00,8000.00,0.00,7000.00,0.08,1
39072,4065,1000.00,8000.00,9000.00,0.00,8000.00,0.23,1
39073,4065,1000.00,9000.00,10000.00,0.00,9000.00,0.39,1
39074,4065,1000.00,10000.00,11000.00,277.88,9722.12,0.44,1
39075,4065,1000.00,11000.00,12000.00,4570.67,5120.87,0.23,1
39076,4065,1000.00,12000.00,13000.00,0.00,1857.07,0.10,1
39077,4065,1000.00,13000.00,14000.00,0.00,9182.62,0.39,1
39078,4065,1000.00,14000.00,15000.00,0.00,12587.84,0.39,1
39079,4065,1000.00,15000.00,16000.00,0.00,3899.83,0.18,1
39080,4065,1000.00,16000.00,17000.00,0.00,3170.77,0.18,1
39081,4065,1000.00,17000.00,18000.00,0.00,17000.00,0.19,1
39082,4065,1000.00,18000.00,19000.00,0.00,18000.00,0.04,1
39083,4065,1000.00,19000.00,20000.00,8920.05,10079.95,0.10,1
39084,4065,1000.00,20000.00,21000.00,0.00,15425.36,0.40,1
39085,4065,1000.00,21000.00,22000.00,7542.76,13457.24,0.28,1
39086,4065,-1000.00,20000.00,21000.00,19805.80,0.00,0.09,0
39087,4065,-1000.00,19000.00,20000.00,0.00,21000.00,0.04,0
39088,4065,-1000.00,18000.00,19000.00,0.00,4729.44,0.11,0
39089,4065,-1000.00,17000.00,18000.00,0.00,17778.64,0.43,0
39090,4065,-1000.00,16000.00,17000.00,3597.66,14402.34,0.08,0
39091,4065,-1000.00,15000.00,16000.00,0.00,11800.00,0.20,0
39092,4065,-1000.00,14000.00,15000.00,0.00,16000.00,0.38,0
39093,4065,-1000.00,13000.00,14000.00,9930.64,4528.33,0.12,0
39094,4065,-1000.00,12000.00,13000.00,3.61,4412.89,0.23,0
39095,4065,-1000.00,11000.00,12000.00,0.00,13000.00,0.32,0
39096,4065,-1000.00,10000.00,11000.00,0.00,7510.45,0.24,0
39097,4065,-1000.00,9000.00,10000.00,3434.16,7565.84,0.32,0
39098,4065,-1000.00,8000.00,9000.00,6151.17,3848.83,0.13,0
39099,4065,-1000.00,7000.00,8000.00,3284.81,5715.19,0.26,0
39100,4065,-1000.00,6000.00,7000.00,3990.50,3555.80,0.20,0
39101,4065,-1000.00,5000.00,6000.00,0.00,7000.00,0.11,0
39102,4065,-1000.00,4000.00,5000.00,0.00,6000.00,0.25,0
39103,4065,0.00,4000.00,5000.00,0.00,0.00,0.05,0
39104,4065,-1000.00,3000.00,4000.00,1937.42,3062.58,0.24,0
39105,4065,-1000.00,2000.00,3000.00,0.00,3825.68,0.44,0
39106,4065,-1000.00,1000.00,2000.00,0.00,1983.47,0.18,0
39107,4065,-1000.00,0.00,1000.00,0.00,1789.40,0.24,0
39108,4065,-487.51,-487.51,512.49,0.00,487.51,0.28,0
39109,4065,-512.49,-1000.00,0.00,0.00,512.49,0.18,0
39110,4066,-684.13,-684.13,315.87,0.00,684.13,0.28,0
39111,4066,-315.87,-1000.00,0.00,0.00,315.87,0.41,0
39112,4067,-1000.00,-1000.00,0.00,0.00,536.34,0.19,0
39113,4068,-1000.00,-1000.00,0.00,0.00,1000.00,0.42,0
39114,4069,1000.00,1000.00,2000.00,0.00,1000.00,0.12,1
39115,4069,1000.00,2000.00,3000.00,0.00,2000.00,0.14,1
39116,4069,1000.00,3000.00,4000.00,0.00,3000.00,0.41,1
39117,4069,-1000.00,2000.00,3000.00,2227.85,1772.15,0.29,0
39118,4069,1000.00,3000.00,4000.00,10.69,2989.31,0.44,1
39119,4069,-1000.00,2000.00,3000.00,2047.55,728.19,0.12,0
39120,4069,1000.00,3000.00,4000.00,594.78,1996.50,0.36,1
39121,4069,1000.00,4000.00,5000.00,0.00,1468.54,0.22,1
39122,4069,1000.00,5000.00,6000.00,2500.00,2500.00,0.01,1
39123,4069,1000.00,6000.00,7000.00,2112.49,3887.51,0.18,1
39124,4069,1000.00,7000.00,8000.00,0.00,7000.00,0.24,1
39125,4069,0.00,7000.00,8000.00,0.00,0.00,0.06,0
39126,4069,-1000.00,6000.00,7000.00,5442.64,0.00,0.05,0
39127,4069,1000.00,7000.00,8000.00,0.00,3857.78,0.03,1
39128,4069,1000.00,8000.00,9000.00,120.99,7100.94,0.44,1
39129,4069,1000.00,9000.00,10000.00,0.00,2904.56,0.16,1
39130,4069,1000.00,10000.00,11000.00,0.00,4760.97,0.30,1
39131,4069,1000.00,11000.00,12000.00,528.35,10471.65,0.26,1
39132,4069,1000.00,12000.00,13000.00,6000.00,6000.00,0.03,1
39133,4069,1000.00,13000.00,14000.00,0.00,6417.34,0.12,1
39134,4069,1000.00,14000.00,15000.00,1737.64,12262.36,0.20,1
39135,4069,1000.00,15000.00,16000.00,658.80,14341.20,0.40,1
39136,4069,1000.00,16000.00,17000.00,7895.00,8105.00,0.23,1
39137,4069,1000.00,17000.00,18000.00,0.00,6658.61,0.18,1
39138,4069,1000.00,18000.00,19000.00,0.00,8275.42,0.01,1
39139,4069,-1000.00,17000.00,18000.00,11959.11,7040.89,0.12,0
39140,4069,1000.00,18000.00,19000.00,2944.99,15055.01,0.42,1
39141,4069,1000.00,19000.00,20000.00,0.00,19000.00,0.10,1
39142,4069,1000.00,20000.00,21000.00,5066.08,14933.92,0.01,1
39143,4069,1000.00,21000.00,22000.00,0.00,21000.00,0.42,1
39144,4069,1000.00,22000.00,23000.00,9298.91,12701.09,0.14,1
39145,4069,1000.00,23000.00,24000.00,11173.19,11826.81,0.22,1
39146,4069,1000.00,24000.00,25000.00,3519.68,20480.32,0.07,1
39147,4069,1000.00,25000.00,26000.00,8616.31,16383.69,0.22,1
39148,4069,1000.00,26000.00,27000.00,11307.54,14692.46,0.21,1
39149,4069,0.00,26000.00,27000.00,0.00,0.00,0.08,0
39150,4069,1000.00,27000.00,28000.00,2472.32,24527.68,0.40,1
39151,4069,1000.00,28000.00,29000.00,0.00,25402.62,0.33,1
39152,4069,1000.00,29000.00,30000.00,0.00,29000.00,0.16,1
39153,4069,-1000.00,28000.00,29000.00,21459.94,8540.06,0.01,0
39154,4069,1000.00,29000.00,30000.00,0.00,29000.00,0.27,1
39155,4069,1000.00,30000.00,31000.00,934.77,29065.23,0.44,1
39156,4069,1000.00,31000.00,32000.00,14259.13,16740.87,0.11,1
39157,4069,1000.00,32000.00,33000.00,0.00,8666.39,0.12,1
39158,4069,1000.00,33000.00,34000.00,7596.20,25403.80,0.40,1
39159,4069,1000.00,34000.00,35000.00,0.00,26789.19,0.32,1
39160,4069,1000.00,35000.00,36000.00,0.00,35000.00,0.27,1
39161,4069,1000.00,36000.00,37000.00,5504.33,30495.67,0.42,1
39162,4070,-1000.00,-1000.00,0.00,350.01,649.99,0.08,0
39163,4071,-1000.00,-1000.00,0.00,0.00,1000.00,0.06,0
39164,4072,-1000.00,-1000.00,0.00,138.39,861.61,0.43,0
39165,4073,-1000.00,-1000.00,0.00,0.00,820.41,0.19,0
39166,4074,1000.00,1000.00,2000.00,0.00,1000.00,0.03,1
39167,4074,1000.00,2000.00,3000.00,275.32,1238.28,0.35,1
39168,4074,1000.00,3000.00,4000.00,47.65,2952.35,0.14,1
39169,4074,-1000.00,2000.00,3000.00,3297.86,702.14,0.05,0
39170,4074,1000.00,3000.00,4000.00,364.26,1620.73,0.32,1
39171,4074,1000.00,4000.00,5000.00,0.00,3857.14,0.44,1
39172,4074,1000.00,5000.00,6000.00,0.00,2625.41,0.32,1
39173,4074,1000.00,6000.00,7000.00,1526.15,4473.85,0.08,1
39174,4074,1000.00,7000.00,8000.00,1325.25,5674.75,0.30,1
39175,4074,1000.00,8000.00,9000.00,309.00,7691.00,0.44,1
39176,4074,1000.00,9000.00,10000.00,562.91,8437.09,0.21,1
39177,4074,1000.00,10000.00,11000.00,2836.16,4306.79,0.25,1
39178,4074,-1000.00,9000.00,10000.00,0.00,8742.47,0.37,0
39179,4074,0.00,9000.00,10000.00,0.00,0.00,0.04,0
39180,4074,-1000.00,8000.00,9000.00,5746.06,4253.94,0.18,0
39181,4074,0.00,8000.00,9000.00,0.00,0.00,0.03,0
39182,4074,-1000.00,7000.00,8000.00,6222.43,2777.57,0.14,0
39183,4074,-1000.00,6000.00,7000.00,7754.76,245.24,0.25,0
39184,4074,-1000.00,5000.00,6000.00,0.00,7000.00,0.11,0
39185,4074,-1000.00,4000.00,5000.00,0.00,4469.32,0.18,0
39186,4074,-1000.00,3000.00,4000.00,4604.10,395.90,0.05,0
39187,4074,-1000.00,2000.00,3000.00,0.00,2448.00,0.07,0
39188,4074,0.00,2000.00,3000.00,0.00,0.00,0.32,0
39189,4074,-1000.00,1000.00,2000.00,564.96,2435.04,0.14,0
39190,4074,0.00,1000.00,2000.00,0.00,0.00,0.38,0
39191,4074,-1000.00,0.00,1000.00,0.00,2000.00,0.18,0
39192,4074,-1000.00,-1000.00,0.00,0.00,1000.00,0.33,0
39193,4075,-1000.00,-1000.00,0.00,100.42,0.00,0.02,0
39194,4076,1000.00,1000.00,2000.00,0.00,553.21,0.20,1
39195,4076,1000.00,2000.00,3000.00,277.18,599.86,0.30,1
39196,4076,1000.00,3000.00,4000.00,130.63,2869.37,0.33,1
39197,4076,1000.00,4000.00,5000.00,0.00,4000.00,0.33,1
39198,4076,-1000.00,3000.00,4000.00,1752.74,0.00,0.07,0
39199,4076,1000.00,4000.00,5000.00,1589.68,2410.32,0.21,1
39200,4076,1000.00,5000.00,6000.00,0.00,5000.00,0.00,1
39201,4076,1000.00,6000.00,7000.00,0.00,1801.45,0.11,1
39202,4076,1000.00,7000.00,8000.00,298.04,2630.12,0.26,1
39203,4076,1000.00,8000.00,9000.00,0.00,6529.46,0.14,1
39204,4076,1000.00,9000.00,10000.00,2231.56,4436.86,0.28,1
39205,4076,1000.00,10000.00,11000.00,0.00,8549.28,0.26,1
39206,4076,-1000.00,9000.00,10000.00,7766.99,3189.91,0.22,0
39207,4076,1000.00,10000.00,11000.00,2256.45,7743.55,0.27,1
39208,4076,-1000.00,9000.00,10000.00,3660.65,0.00,0.05,0
39209,4076,1000.00,10000.00,11000.00,3688.81,6311.19,0.27,1
39210,4076,1000.00,11000.00,12000.00,1080.46,5776.53,0.32,1
39211,4076,1000.00,12000.00,13000.00,0.00,5498.92,0.08,1
39212,4076,1000.00,13000.00,14000.00,0.00,10827.01,0.25,1
39213,4076,-1000.00,12000.00,13000.00,9348.78,75.80,0.06,0
39214,4076,1000.00,13000.00,14000.00,0.00,5670.78,0.25,1
39215,4076,-1000.00,12000.00,13000.00,1060.33,10880.84,0.16,0
39216,4076,-1000.00,11000.00,12000.00,0.00,5233.64,0.27,0
39217,4076,-1000.00,10000.00,11000.00,0.00,9654.90,0.27,0
39218,4076,-1000.00,9000.00,10000.00,0.00,11000.00,0.37,0
39219,4076,-1000.00,8000.00,9000.00,3887.76,6112.24,0.21,0
39220,4076,-1000.00,7000.00,8000.00,0.00,9000.00,0.08,0
39221,4076,-1000.00,6000.00,7000.00,0.00,6453.89,0.31,0
39222,4076,-1000.00,5000.00,6000.00,753.56,5634.75,0.41,0
39223,4076,-1000.00,4000.00,5000.00,1211.94,4788.06,0.06,0
39224,4076,-1000.00,3000.00,4000.00,2189.78,2810.22,0.10,0
39225,4076,-1000.00,2000.00,3000.00,1725.40,1350.27,0.19,0
39226,4076,-1000.00,1000.00,2000.00,0.00,3000.00,0.35,0
39227,4076,-1000.00,0.00,1000.00,1000.00,1000.00,0.05,0
39228,4076,-1000.00,-1000.00,0.00,0.00,1000.00,0.06,0
39229,4077,-1000.00,-1000.00,0.00,274.17,725.83,0.36,0
39230,4078,-1000.00,-1000.00,0.00,315.69,684.31,0.31,0
39231,4079,-491.52,-491.52,508.48,491.52,0.00,0.24,0
39232,4079,-1000.00,-1491.52,-491.52,190.03,318.45,0.19,0
39233,4080,0.00,0.00,1000.00,0.00,0.00,0.16,0
39234,4080,-1000.00,-1000.00,0.00,907.67,92.33,0.14,0
39235,4081,-1000.00,-1000.00,0.00,0.00,13.47,0.40,0
39236,4082,-1000.00,-1000.00,0.00,500.00,500.00,0.00,0
39237,4083,1000.00,1000.00,2000.00,73.87,926.13,0.22,1
39238,4083,1000.00,2000.00,3000.00,0.00,745.05,0.24,1
39239,4083,1000.00,3000.00,4000.00,1202.83,1797.17,0.24,1
39240,4083,1000.00,4000.00,5000.00,0.00,3808.32,0.28,1
39241,4083,1000.00,5000.00,6000.00,1549.83,3450.17,0.41,1
39242,4083,1000.00,6000.00,7000.00,0.00,4676.47,0.34,1
39243,4083,1000.00,7000.00,8000.00,1662.22,5337.78,0.08,1
39244,4083,1000.00,8000.00,9000.00,0.00,8000.00,0.24,1
39245,4083,1000.00,9000.00,10000.00,0.00,9000.00,0.18,1
39246,4083,1000.00,10000.00,11000.00,0.00,9625.47,0.37,1
39247,4083,1000.00,11000.00,12000.00,0.00,7482.64,0.21,1
39248,4083,1000.00,12000.00,13000.00,2143.96,9856.04,0.01,1
39249,4083,1000.00,13000.00,14000.00,0.00,13000.00,0.06,1
39250,4083,1000.00,14000.00,15000.00,0.00,7690.04,0.12,1
39251,4083,1000.00,15000.00,16000.00,0.00,14939.70,0.26,1
39252,4083,1000.00,16000.00,17000.00,0.00,9779.09,0.34,1
39253,4083,1000.00,17000.00,18000.00,0.00,17000.00,0.13,1
39254,4083,1000.00,18000.00,19000.00,5459.78,7120.81,0.26,1
39255,4083,1000.00,19000.00,20000.00,0.00,19000.00,0.14,1
39256,4083,1000.00,20000.00,21000.00,4501.82,15498.18,0.38,1
39257,4083,1000.00,21000.00,22000.00,0.00,4637.58,0.18,1
39258,4083,1000.00,22000.00,23000.00,0.00,20558.32,0.34,1
39259,4083,-1000.00,21000.00,22000.00,16381.50,6618.50,0.20,0
39260,4083,-1000.00,20000.00,21000.00,6018.32,15981.68,0.36,0
39261,4083,-1000.00,19000.00,20000.00,18701.23,0.00,0.02,0
39262,4083,-529.54,18470.46,19470.46,0.00,529.54,0.01,0
39263,4083,-1000.00,17470.46,18470.46,8410.16,11060.31,0.20,0
39264,4083,-1000.00,16470.46,17470.46,4243.91,14226.55,0.33,0
39265,4083,-1000.00,15470.46,16470.46,13652.33,3818.14,0.06,0
39266,4083,-1000.00,14470.46,15470.46,5091.22,11379.25,0.02,0
39267,4083,-1000.00,13470.46,14470.46,0.00,15470.46,0.04,0
39268,4083,-1000.00,12470.46,13470.46,4687.99,0.00,0.07,0
39269,4083,-1000.00,11470.46,12470.46,0.00,11962.14,0.43,0
39270,4083,-1000.00,10470.46,11470.46,5878.21,6592.25,0.16,0
39271,4083,-1000.00,9470.46,10470.46,2521.57,8948.89,0.39,0
39272,4083,-1000.00,8470.46,9470.46,0.00,9265.09,0.43,0
39273,4083,-1000.00,7470.46,8470.46,1447.60,7291.73,0.40,0
39274,4083,-1000.00,6470.46,7470.46,0.00,8470.46,0.24,0
39275,4083,-1000.00,5470.46,6470.46,111.64,5529.96,0.40,0
39276,4083,-1000.00,4470.46,5470.46,0.00,6470.46,0.34,0
39277,4083,-1000.00,3470.46,4470.46,0.00,3979.07,0.36,0
39278,4083,-1000.00,2470.46,3470.46,4470.46,0.00,0.07,0
39279,4083,-1000.00,1470.46,2470.46,563.06,1507.84,0.27,0
39280,4083,-1000.00,470.46,1470.46,0.00,2470.46,0.31,0
39281,4083,-555.22,-84.75,915.25,0.00,555.22,0.23,0
39282,4083,-384.55,-469.30,530.70,34.97,349.58,0.26,0
39283,4083,-530.70,-1000.00,0.00,0.00,530.70,0.05,0
39284,4084,1000.00,1000.00,2000.00,0.00,841.24,0.36,1
39285,4084,1000.00,2000.00,3000.00,0.00,1370.23,0.41,1
39286,4084,1000.00,3000.00,4000.00,0.00,3000.00,0.10,1
39287,4084,1000.00,4000.00,5000.00,2000.00,2000.00,0.05,1
39288,4084,1000.00,5000.00,6000.00,0.00,5000.00,0.00,1
39289,4084,1000.00,6000.00,7000.00,0.00,6000.00,0.03,1
39290,4084,1000.00,7000.00,8000.00,0.00,6449.19,0.33,1
39291,4084,1000.00,8000.00,9000.00,0.00,8000.00,0.04,1
39292,4084,1000.00,9000.00,10000.00,1187.67,7812.33,0.44,1
39293,4084,1000.00,10000.00,11000.00,4486.72,5513.28,0.18,1
39294,4084,1000.00,11000.00,12000.00,3614.22,7385.78,0.23,1
39295,4084,1000.00,12000.00,13000.00,0.00,12000.00,0.05,1
39296,4084,1000.00,13000.00,14000.00,0.00,13000.00,0.02,1
39297,4084,1000.00,14000.00,15000.00,7000.00,7000.00,0.09,1
39298,4084,1000.00,15000.00,16000.00,4683.66,10316.34,0.33,1
39299,4084,1000.00,16000.00,17000.00,5858.24,10141.76,0.16,1
39300,4084,1000.00,17000.00,18000.00,6858.42,10141.58,0.20,1
39301,4084,-1000.00,16000.00,17000.00,8811.21,0.00,0.03,0
39302,4084,-1000.00,15000.00,16000.00,12257.81,4742.19,0.20,0
39303,4084,1000.00,16000.00,17000.00,5993.13,10006.87,0.28,1
39304,4084,-1000.00,15000.00,16000.00,2258.05,1908.35,0.14,0
39305,4084,1000.00,16000.00,17000.00,5024.66,10975.34,0.30,1
39306,4084,1000.00,17000.00,18000.00,415.64,16584.36,0.25,1
39307,4084,1000.00,18000.00,19000.00,0.00,15964.46,0.35,1
39308,4084,1000.00,19000.00,20000.00,1842.87,17157.13,0.36,1
39309,4084,1000.00,20000.00,21000.00,9926.59,10073.41,0.09,1
39310,4084,1000.00,21000.00,22000.00,2651.70,7749.59,0.25,1
39311,4084,1000.00,22000.00,23000.00,0.00,11630.52,0.32,1
39312,4084,1000.00,23000.00,24000.00,1885.34,15644.62,0.38,1
39313,4084,-1000.00,22000.00,23000.00,13218.93,10781.07,0.18,0
39314,4084,-1000.00,21000.00,22000.00,11695.69,11304.31,0.32,0
39315,4084,1000.00,22000.00,23000.00,0.00,22000.00,0.21,1
39316,4085,-1000.00,-1000.00,0.00,391.13,608.87,0.28,0
39317,4085,-0.00,-1000.00,0.00,0.00,0.00,0.18,0
39318,4085,-0.00,-1000.00,0.00,0.00,0.00,0.39,0
39319,4085,-0.00,-1000.00,0.00,0.00,0.00,0.34,0
39320,4086,1000.00,1000.00,2000.00,279.73,720.27,0.25,1
39321,4086,1000.00,2000.00,3000.00,68.18,1487.03,0.40,1
39322,4086,1000.00,3000.00,4000.00,546.98,2453.02,0.36,1
39323,4086,1000.00,4000.00,5000.00,0.00,3300.59,0.41,1
39324,4086,1000.00,5000.00,6000.00,661.71,4338.29,0.40,1
39325,4086,1000.00,6000.00,7000.00,0.00,4016.40,0.34,1
39326,4086,1000.00,7000.00,8000.00,402.97,6597.03,0.09,1
39327,4086,1000.00,8000.00,9000.00,381.55,6768.52,0.43,1
39328,4086,1000.00,9000.00,10000.00,1851.25,7148.75,0.24,1
39329,4086,1000.00,10000.00,11000.00,0.00,8270.75,0.37,1
39330,4086,1000.00,11000.00,12000.00,0.00,8774.13,0.39,1
39331,4086,1000.00,12000.00,13000.00,846.79,4075.15,0.24,1
39332,4086,1000.00,13000.00,14000.00,3086.06,9913.94,0.39,1
39333,4086,1000.00,14000.00,15000.00,2660.26,11339.74,0.37,1
39334,4086,1000.00,15000.00,16000.00,7500.00,7500.00,0.05,1
39335,4086,1000.00,16000.00,17000.00,5397.14,10602.86,0.35,1
39336,4086,0.00,16000.00,17000.00,0.00,0.00,0.06,0
39337,4086,-1000.00,15000.00,16000.00,11129.98,5870.02,0.04,0
39338,4086,1000.00,16000.00,17000.00,0.00,13658.10,0.24,1
39339,4086,1000.00,17000.00,18000.00,330.49,13138.77,0.41,1
39340,4086,1000.00,18000.00,19000.00,0.00,13947.33,0.03,1
39341,4086,1000.00,19000.00,20000.00,0.00,15151.54,0.38,1
39342,4086,1000.00,20000.00,21000.00,0.00,20000.00,0.41,1
39343,4086,1000.00,21000.00,22000.00,0.00,21000.00,0.02,1
39344,4086,1000.00,22000.00,23000.00,0.00,22000.00,0.13,1
39345,4086,-1000.00,21000.00,22000.00,12497.34,10502.66,0.36,0
39346,4086,1000.00,22000.00,23000.00,486.24,14779.05,0.38,1
39347,4086,1000.00,23000.00,24000.00,0.00,19796.72,0.19,1
39348,4086,-1000.00,22000.00,23000.00,15657.94,8342.06,0.28,0
39349,4086,1000.00,23000.00,24000.00,0.00,23000.00,0.20,1
39350,4086,1000.00,24000.00,25000.00,0.00,24000.00,0.08,1
39351,4086,-1000.00,23000.00,24000.00,0.00,25000.00,0.05,0
39352,4086,-1000.00,22000.00,23000.00,0.00,12855.56,0.36,0
39353,4086,-1000.00,21000.00,22000.00,15590.27,531.89,0.06,0
39354,4086,-1000.00,20000.00,21000.00,9212.20,12787.80,0.37,0
39355,4086,-1000.00,19000.00,20000.00,6338.21,14661.79,0.19,0
39356,4086,-1000.00,18000.00,19000.00,2562.11,0.00,0.29,0
39357,4086,-1000.00,17000.00,18000.00,5945.44,7635.31,0.29,0
39358,4086,-1000.00,16000.00,17000.00,8650.29,9172.06,0.23,0
39359,4086,-1000.00,15000.00,16000.00,7950.52,5791.12,0.30,0
39360,4086,-1000.00,14000.00,15000.00,1313.21,0.00,0.21,0
39361,4087,-1000.00,-1000.00,0.00,458.61,541.39,0.09,0
39362,4088,1000.00,1000.00,2000.00,265.86,310.36,0.21,1
39363,4088,1000.00,2000.00,3000.00,67.87,1932.13,0.44,1
39364,4088,1000.00,3000.00,4000.00,0.00,940.83,0.20,1
39365,4088,1000.00,4000.00,5000.00,0.00,3438.46,0.14,1
39366,4088,-1000.00,3000.00,4000.00,2749.10,2250.90,0.03,0
39367,4088,1000.00,4000.00,5000.00,1200.37,2558.31,0.33,1
39368,4088,-1000.00,3000.00,4000.00,2508.18,2491.82,0.20,0
39369,4088,1000.00,4000.00,5000.00,291.26,3708.74,0.28,1
39370,4088,-1000.00,3000.00,4000.00,2479.10,556.22,0.10,0
39371,4088,1000.00,4000.00,5000.00,0.00,429.65,0.13,1
39372,4088,1000.00,5000.00,6000.00,1917.16,3082.84,0.26,1
39373,4088,1000.00,6000.00,7000.00,0.00,6000.00,0.06,1
39374,4088,1000.00,7000.00,8000.00,3291.85,3708.15,0.08,1
39375,4088,1000.00,8000.00,9000.00,0.00,207.85,0.08,1
39376,4088,1000.00,9000.00,10000.00,4133.32,4866.68,0.16,1
39377,4088,-1000.00,8000.00,9000.00,5099.45,4900.55,0.22,0
39378,4088,1000.00,9000.00,10000.00,1223.49,7776.51,0.08,1
39379,4088,-1000.00,8000.00,9000.00,7418.84,2581.16,0.08,0
39380,4088,1000.00,9000.00,10000.00,0.00,7278.88,0.23,1
39381,4088,-1000.00,8000.00,9000.00,2720.94,2018.00,0.16,0
39382,4088,1000.00,9000.00,10000.00,4189.70,4810.30,0.05,1
39383,4088,1000.00,10000.00,11000.00,2630.59,5904.83,0.32,1
39384,4088,-1000.00,9000.00,10000.00,5500.00,5500.00,0.36,0
39385,4088,-1000.00,8000.00,9000.00,3112.36,6887.64,0.35,0
39386,4088,-1000.00,7000.00,8000.00,0.00,9000.00,0.38,0
39387,4088,-1000.00,6000.00,7000.00,2199.62,4592.56,0.31,0
39388,4088,-1000.00,5000.00,6000.00,1291.75,5708.25,0.36,0
39389,4088,-1000.00,4000.00,5000.00,0.00,3385.61,0.32,0
39390,4088,-1000.00,3000.00,4000.00,0.00,3194.34,0.34,0
39391,4088,-1000.00,2000.00,3000.00,0.00,4000.00,0.06,0
39392,4088,-1000.00,1000.00,2000.00,230.29,155.10,0.13,0
39393,4088,-1000.00,0.00,1000.00,541.25,1458.75,0.23,0
39394,4088,-831.47,-831.47,168.53,0.00,831.47,0.42,0
39395,4088,-77.41,-908.89,91.11,30.54,46.87,0.20,0
39396,4088,-41.00,-949.88,50.12,0.00,41.00,0.21,0
39397,4088,-50.12,-1000.00,0.00,22.65,27.47,0.25,0
39398,4089,-1000.00,-1000.00,0.00,0.00,938.89,0.02,0
39399,4090,-1000.00,-1000.00,0.00,0.00,1000.00,0.40,0
39400,4091,1000.00,1000.00,2000.00,365.77,184.68,0.35,1
39401,4091,1000.00,2000.00,3000.00,1467.91,0.00,0.09,1
39402,4091,-1000.00,1000.00,2000.00,0.00,1368.14,0.21,0
39403,4091,1000.00,2000.00,3000.00,1047.47,952.53,0.06,1
39404,4091,-1000.00,1000.00,2000.00,56.76,2943.24,0.09,0
39405,4091,0.00,1000.00,2000.00,0.00,0.00,0.08,0
39406,4091,-1000.00,0.00,1000.00,627.08,1372.92,0.06,0
39407,4091,-4.60,-4.60,995.40,0.00,4.60,0.27,0
39408,4091,0.00,-4.60,995.40,0.00,0.00,0.10,0
39409,4091,1000.00,995.40,1995.40,505.91,489.48,0.41,1
39410,4091,-711.37,284.03,1284.03,0.00,711.37,0.39,0
39411,4091,1000.00,1284.03,2284.03,711.32,0.00,0.07,1
39412,4091,1000.00,2284.03,3284.03,1591.81,692.22,0.07,1
39413,4091,1000.00,3284.03,4284.03,700.95,0.00,0.18,1
39414,4091,1000.00,4284.03,5284.03,779.06,0.00,0.18,1
39415,4091,1000.00,5284.03,6284.03,923.96,0.00,0.12,1
39416,4091,1000.00,6284.03,7284.03,3934.50,2349.52,0.38,1
39417,4091,-1000.00,5284.03,6284.03,2010.83,3952.95,0.18,0
39418,4091,-1000.00,4284.03,5284.03,0.00,3622.61,0.04,0
39419,4091,-1000.00,3284.03,4284.03,155.97,5128.05,0.11,0
39420,4091,1000.00,4284.03,5284.03,3299.14,0.00,0.11,1
39421,4091,0.00,4284.03,5284.03,0.00,0.00,0.28,0
39422,4091,1000.00,5284.03,6284.03,521.77,0.00,0.04,1
39423,4091,1000.00,6284.03,7284.03,4481.07,0.00,0.21,1
39424,4091,0.00,6284.03,7284.03,0.00,0.00,0.38,0
39425,4091,-1000.00,5284.03,6284.03,0.00,3175.52,0.14,0
39426,4091,-1000.00,4284.03,5284.03,0.00,4495.66,0.24,0
39427,4091,-1000.00,3284.03,4284.03,1076.97,4207.06,0.08,0
39428,4091,-1000.00,2284.03,3284.03,0.00,1366.44,0.31,0
39429,4091,-1000.00,1284.03,2284.03,0.00,3284.03,0.02,0
39430,4091,-1000.00,284.03,1284.03,35.36,2248.67,0.12,0
39431,4091,-1000.00,-715.97,284.03,130.57,1153.45,0.10,0
39432,4091,1000.00,284.03,1284.03,146.38,137.65,0.06,1
39433,4091,-1000.00,-715.97,284.03,452.86,704.91,0.25,0
39434,4091,-153.73,-869.70,130.30,0.00,153.73,0.11,0
39435,4091,1000.00,130.30,1130.30,47.57,42.26,0.34,1
39436,4091,1000.00,1130.30,2130.30,519.06,0.00,0.33,1
39437,4091,-1000.00,130.30,1130.30,0.00,1060.16,0.30,0
39438,4091,1000.00,1130.30,2130.30,361.48,0.00,0.08,1
39439,4091,1000.00,2130.30,3130.30,1765.72,0.00,0.17,1
39440,4091,-728.02,1402.28,2402.28,0.00,728.02,0.40,0
39441,4091,-518.18,884.10,1884.10,0.00,518.18,0.37,0
39442,4091,1000.00,1884.10,2884.10,920.80,439.97,0.29,1
39443,4091,-1000.00,884.10,1884.10,615.40,2268.70,0.08,0
39444,4091,-964.81,-80.71,919.29,0.00,964.81,0.29,0
39445,4091,1000.00,919.29,1919.29,201.38,0.00,0.40,1
39446,4091,1000.00,1919.29,2919.29,322.08,0.00,0.43,1
39447,4091,-1000.00,919.29,1919.29,0.00,1695.31,0.09,0
39448,4091,-1000.00,-80.71,919.29,0.00,533.99,0.38,0
39449,4091,-148.51,-229.22,770.78,148.51,0.00,0.08,0
39450,4091,0.00,-229.22,770.78,0.00,0.00,0.27,0
39451,4091,-1000.00,-1229.22,-229.22,0.00,768.73,0.06,0
39452,4092,0.00,0.00,1000.00,0.00,0.00,0.02,0
39453,4092,1000.00,1000.00,2000.00,17.92,238.64,0.20,1
39454,4092,1000.00,2000.00,3000.00,0.00,2000.00,0.34,1
39455,4092,1000.00,3000.00,4000.00,0.00,3000.00,0.44,1
39456,4092,1000.00,4000.00,5000.00,0.00,2776.00,0.25,1
39457,4092,1000.00,5000.00,6000.00,0.00,5000.00,0.31,1
39458,4092,1000.00,6000.00,7000.00,1589.93,4410.07,0.37,1
39459,4092,1000.00,7000.00,8000.00,0.00,6999.99,0.41,1
39460,4092,1000.00,8000.00,9000.00,345.43,7654.57,0.41,1
39461,4092,1000.00,9000.00,10000.00,3423.38,5257.56,0.28,1
39462,4092,-1000.00,8000.00,9000.00,2724.63,2692.85,0.19,0
39463,4092,1000.00,9000.00,10000.00,2826.04,6173.96,0.32,1
39464,4092,1000.00,10000.00,11000.00,0.00,10000.00,0.19,1
39465,4092,1000.00,11000.00,12000.00,1567.49,9432.51,0.42,1
39466,4092,1000.00,12000.00,13000.00,3108.37,8891.63,0.38,1
39467,4092,-1000.00,11000.00,12000.00,10468.31,0.00,0.01,0
39468,4092,1000.00,12000.00,13000.00,0.00,12000.00,0.11,1
39469,4092,1000.00,13000.00,14000.00,0.00,13000.00,0.03,1
39470,4092,1000.00,14000.00,15000.00,0.00,14000.00,0.25,1
39471,4092,1000.00,15000.00,16000.00,0.00,15000.00,0.14,1
39472,4092,1000.00,16000.00,17000.00,0.00,12219.40,0.24,1
39473,4092,1000.00,17000.00,18000.00,2280.55,14719.45,0.35,1
39474,4092,1000.00,18000.00,19000.00,5686.84,12313.16,0.33,1
39475,4092,-1000.00,17000.00,18000.00,9869.36,9130.64,0.33,0
39476,4092,-1000.00,16000.00,17000.00,0.00,18000.00,0.29,0
39477,4092,-1000.00,15000.00,16000.00,2519.94,14480.06,0.42,0
39478,4092,-1000.00,14000.00,15000.00,0.00,16000.00,0.06,0
39479,4092,-1000.00,13000.00,14000.00,0.00,12261.69,0.05,0
39480,4092,-1000.00,12000.00,13000.00,0.00,12186.50,0.24,0
39481,4092,-1000.00,11000.00,12000.00,117.71,12882.29,0.10,0
39482,4092,-1000.00,10000.00,11000.00,3101.82,6183.57,0.29,0
39483,4092,-1000.00,9000.00,10000.00,0.00,11000.00,0.34,0
39484,4092,-1000.00,8000.00,9000.00,9071.33,928.67,0.02,0
39485,4092,-1000.00,7000.00,8000.00,0.00,5753.00,0.31,0
39486,4092,-1000.00,6000.00,7000.00,3808.99,4191.01,0.16,0
39487,4092,-1000.00,5000.00,6000.00,0.00,3261.20,0.29,0
39488,4092,-1000.00,4000.00,5000.00,325.34,5674.66,0.26,0
39489,4092,-1000.00,3000.00,4000.00,0.00,5000.00,0.39,0
39490,4092,-1000.00,2000.00,3000.00,731.93,3268.07,0.32,0
39491,4092,-1000.00,1000.00,2000.00,350.71,1518.27,0.31,0
39492,4092,-1000.00,0.00,1000.00,0.00,1249.86,0.30,0
39493,4092,-1000.00,-1000.00,0.00,0.00,1000.00,0.27,0
39494,4093,-1000.00,-1000.00,0.00,95.55,904.45,0.29,0
39495,4094,0.00,0.00,1000.00,0.00,0.00,0.40,0
39496,4094,-1000.00,-1000.00,0.00,467.66,532.34,0.10,0
39497,4095,-1000.00,-1000.00,0.00,464.43,535.57,0.10,0
39498,4096,-766.15,-766.15,233.85,0.00,766.15,0.35,0
39499,4096,-5.48,-771.63,228.37,0.00,5.48,0.04,0
39500,4096,-1000.00,-1771.63,-771.63,132.55,95.81,0.10,0
39501,4097,-884.93,-884.93,115.07,430.66,454.27,0.23,0
39502,4097,-1000.00,-1884.93,-884.93,64.36,50.71,0.12,0
39503,4098,1000.00,1000.00,2000.00,127.44,872.56,0.34,1
39504,4098,1000.00,2000.00,3000.00,0.00,2000.00,0.12,1
39505,4098,1000.00,3000.00,4000.00,0.00,2666.57,0.43,1
39506,4098,0.00,3000.00,4000.00,0.00,0.00,0.09,0
39507,4098,1000.00,4000.00,5000.00,0.00,4000.00,0.29,1
39508,4098,1000.00,5000.00,6000.00,0.00,2656.33,0.32,1
39509,4098,1000.00,6000.00,7000.00,0.00,1043.86,0.17,1
39510,4098,1000.00,7000.00,8000.00,0.00,6528.99,0.41,1
39511,4098,1000.00,8000.00,9000.00,4000.00,4000.00,0.39,1
39512,4098,1000.00,9000.00,10000.00,2300.50,6699.50,0.36,1
39513,4098,1000.00,10000.00,11000.00,1765.77,6641.84,0.38,1
39514,4098,1000.00,11000.00,12000.00,3446.06,6010.09,0.29,1
39515,4098,1000.00,12000.00,13000.00,0.00,12000.00,0.06,1
39516,4098,1000.00,13000.00,14000.00,0.00,12792.00,0.42,1
39517,4098,1000.00,14000.00,15000.00,0.00,4564.48,0.23,1
39518,4098,1000.00,15000.00,16000.00,0.00,15000.00,0.36,1
39519,4098,1000.00,16000.00,17000.00,0.00,12553.47,0.19,1
39520,4098,-1000.00,15000.00,16000.00,10706.37,6293.63,0.07,0
39521,4098,-1000.00,14000.00,15000.00,9669.07,6330.93,0.35,0
39522,4098,-1000.00,13000.00,14000.00,0.00,6554.00,0.21,0
39523,4098,-1000.00,12000.00,13000.00,0.00,14000.00,0.02,0
39524,4098,-1000.00,11000.00,12000.00,3201.05,9798.95,0.36,0
39525,4098,-1000.00,10000.00,11000.00,851.08,11148.92,0.02,0
39526,4098,-1000.00,9000.00,10000.00,5301.87,5698.13,0.13,0
39527,4098,-1000.00,8000.00,9000.00,0.00,10000.00,0.23,0
39528,4098,-1000.00,7000.00,8000.00,0.00,9000.00,0.30,0
39529,4098,-1000.00,6000.00,7000.00,2122.91,5877.09,0.21,0
39530,4098,-1000.00,5000.00,6000.00,0.00,7000.00,0.07,0
39531,4098,-1000.00,4000.00,5000.00,2216.06,3783.94,0.21,0
39532,4098,-1000.00,3000.00,4000.00,0.00,5000.00,0.22,0
39533,4098,-1000.00,2000.00,3000.00,3051.67,948.33,0.09,0
39534,4098,-1000.00,1000.00,2000.00,0.00,3000.00,0.35,0
39535,4098,-1000.00,0.00,1000.00,0.00,1596.59,0.31,0
39536,4098,-1000.00,-1000.00,0.00,0.00,1000.00,0.10,0
39537,4099,-1000.00,-1000.00,0.00,0.00,1000.00,0.34,0
39538,4100,-1000.00,-1000.00,0.00,364.61,0.00,0.05,0
39539,4101,0.00,0.00,1000.00,0.00,0.00,0.04,0
39540,4101,-317.52,-317.52,682.48,97.01,220.51,0.42,0
39541,4101,1000.00,682.48,1682.48,499.00,58.43,0.18,1
39542,4101,1000.00,1682.48,2682.48,1380.23,302.25,0.11,1
39543,4101,1000.00,2682.48,3682.48,1961.24,721.25,0.07,1
39544,4101,-1000.00,1682.48,2682.48,760.01,2082.17,0.39,0
39545,4101,-1000.00,682.48,1682.48,989.97,1692.51,0.31,0
39546,4101,-1000.00,-317.52,682.48,0.00,1682.48,0.13,0
39547,4101,0.00,-317.52,682.48,0.00,0.00,0.23,0
39548,4101,-682.48,-1000.00,0.00,0.00,682.48,0.09,0
39549,4102,-668.39,-668.39,331.61,0.00,668.39,0.04,0
39550,4102,-331.61,-1000.00,0.00,0.00,331.61,0.06,0
39551,4103,-1000.00,-1000.00,0.00,222.03,777.97,0.07,0
39552,4103,-0.00,-1000.00,0.00,0.00,0.00,0.21,0
39553,4103,-0.00,-1000.00,0.00,0.00,0.00,0.20,0
39554,4103,-0.00,-1000.00,0.00,0.00,0.00,0.01,0
39555,4104,-1000.00,-1000.00,0.00,0.00,1000.00,0.29,0
39556,4105,-1000.00,-1000.00,0.00,73.63,926.37,0.34,0
39557,4106,-1000.00,-1000.00,0.00,474.77,525.23,0.10,0
39558,4107,-1000.00,-1000.00,0.00,244.29,755.71,0.38,0
39559,4108,-1000.00,-1000.00,0.00,0.00,29.66,0.05,0
39560,4109,-1000.00,-1000.00,0.00,112.36,887.64,0.43,0
39561,4110,1000.00,1000.00,2000.00,18.81,981.19,0.44,1
39562,4110,1000.00,2000.00,3000.00,0.00,2000.00,0.32,1
39563,4110,1000.00,3000.00,4000.00,0.00,3000.00,0.28,1
39564,4110,1000.00,4000.00,5000.00,0.00,4000.00,0.31,1
39565,4110,1000.00,5000.00,6000.00,2500.00,2500.00,0.05,1
39566,4110,1000.00,6000.00,7000.00,0.00,6000.00,0.32,1
39567,4110,1000.00,7000.00,8000.00,0.00,5093.51,0.39,1
39568,4110,0.00,7000.00,8000.00,0.00,0.00,0.08,0
39569,4110,1000.00,8000.00,9000.00,0.00,2650.31,0.11,1
39570,4110,1000.00,9000.00,10000.00,3258.83,5741.17,0.27,1
39571,4110,1000.00,10000.00,11000.00,2881.78,7118.22,0.20,1
39572,4110,1000.00,11000.00,12000.00,0.00,11000.00,0.02,1
39573,4110,1000.00,12000.00,13000.00,4046.07,6354.49,0.28,1
39574,4110,1000.00,13000.00,14000.00,280.53,12719.47,0.26,1
39575,4110,1000.00,14000.00,15000.00,0.00,14000.00,0.38,1
39576,4110,1000.00,15000.00,16000.00,3657.77,11342.23,0.39,1
39577,4110,1000.00,16000.00,17000.00,0.00,16000.00,0.35,1
39578,4110,1000.00,17000.00,18000.00,0.00,17000.00,0.11,1
39579,4110,-1000.00,16000.00,17000.00,2457.91,0.00,0.09,0
39580,4110,-1000.00,15000.00,16000.00,0.00,17000.00,0.03,0
39581,4110,-1000.00,14000.00,15000.00,0.00,16000.00,0.44,0
39582,4110,0.00,14000.00,15000.00,0.00,0.00,0.07,0
39583,4110,0.00,14000.00,15000.00,0.00,0.00,0.18,0
39584,4110,-1000.00,13000.00,14000.00,11349.18,3650.82,0.43,0
39585,4110,1000.00,14000.00,15000.00,7000.00,7000.00,0.02,1
39586,4110,1000.00,15000.00,16000.00,2449.28,12550.72,0.40,1
39587,4110,1000.00,16000.00,17000.00,0.00,16000.00,0.19,1
39588,4110,1000.00,17000.00,18000.00,5746.79,11253.21,0.31,1
39589,4110,1000.00,18000.00,19000.00,0.00,5257.48,0.22,1
39590,4110,1000.00,19000.00,20000.00,0.00,19000.00,0.19,1
39591,4110,1000.00,20000.00,21000.00,9509.38,10490.62,0.01,1
39592,4110,1000.00,21000.00,22000.00,0.00,17547.71,0.35,1
39593,4110,1000.00,22000.00,23000.00,6015.75,15984.25,0.33,1
39594,4110,1000.00,23000.00,24000.00,8808.67,14191.33,0.16,1
39595,4110,1000.00,24000.00,25000.00,0.00,22438.83,0.29,1
39596,4110,1000.00,25000.00,26000.00,0.00,25000.00,0.11,1
39597,4110,1000.00,26000.00,27000.00,0.00,5361.35,0.18,1
39598,4110,1000.00,27000.00,28000.00,12216.78,14783.22,0.16,1
39599,4110,1000.00,28000.00,29000.00,0.00,28000.00,0.08,1
39600,4110,1000.00,29000.00,30000.00,0.00,29000.00,0.07,1
39601,4110,1000.00,30000.00,31000.00,0.00,30000.00,0.36,1
39602,4110,1000.00,31000.00,32000.00,0.00,31000.00,0.11,1
39603,4110,1000.00,32000.00,33000.00,8652.53,23347.47,0.34,1
39604,4110,1000.00,33000.00,34000.00,8956.57,24043.43,0.37,1
39605,4110,1000.00,34000.00,35000.00,0.00,19971.12,0.31,1
39606,4110,1000.00,35000.00,36000.00,7190.20,27809.80,0.41,1
39607,4110,-1000.00,34000.00,35000.00,19497.73,16502.27,0.07,0
39608,4111,1000.00,1000.00,2000.00,0.00,1000.00,0.25,1
39609,4111,1000.00,2000.00,3000.00,732.85,1267.15,0.31,1
39610,4111,1000.00,3000.00,4000.00,1.05,2998.95,0.18,1
39611,4111,-1000.00,2000.00,3000.00,1953.42,1450.94,0.18,0
39612,4111,1000.00,3000.00,4000.00,0.00,1935.92,0.37,1
39613,4111,1000.00,4000.00,5000.00,1171.56,2828.44,0.36,1
39614,4111,1000.00,5000.00,6000.00,1944.04,2940.78,0.28,1
39615,4111,1000.00,6000.00,7000.00,1244.75,4755.25,0.38,1
39616,4111,1000.00,7000.00,8000.00,2469.87,4142.86,0.30,1
39617,4111,1000.00,8000.00,9000.00,0.00,8000.00,0.02,1
39618,4111,1000.00,9000.00,10000.00,2136.36,6863.64,0.38,1
39619,4111,-1000.00,8000.00,9000.00,5851.32,4148.68,0.37,0
39620,4111,1000.00,9000.00,10000.00,149.86,8850.14,0.23,1
39621,4111,-1000.00,8000.00,9000.00,6183.17,3816.83,0.15,0
39622,4111,1000.00,9000.00,10000.00,4500.00,4500.00,0.01,1
39623,4111,1000.00,10000.00,11000.00,0.00,10000.00,0.23,1
39624,4111,-1000.00,9000.00,10000.00,5669.45,970.95,0.10,0
39625,4111,1000.00,10000.00,11000.00,0.00,1968.66,0.03,1
39626,4111,1000.00,11000.00,12000.00,0.00,11000.00,0.10,1
39627,4111,1000.00,12000.00,13000.00,6000.00,6000.00,0.30,1
39628,4111,1000.00,13000.00,14000.00,0.00,7799.96,0.36,1
39629,4111,1000.00,14000.00,15000.00,0.00,13093.44,0.18,1
39630,4111,1000.00,15000.00,16000.00,1854.52,13145.48,0.43,1
39631,4111,1000.00,16000.00,17000.00,0.00,4951.10,0.16,1
39632,4111,1000.00,17000.00,18000.00,0.00,10284.11,0.35,1
39633,4111,1000.00,18000.00,19000.00,0.00,18000.00,0.32,1
39634,4111,-1000.00,17000.00,18000.00,7892.23,0.00,0.07,0
39635,4111,1000.00,18000.00,19000.00,0.00,18000.00,0.06,1
39636,4111,1000.00,19000.00,20000.00,0.00,8528.16,0.24,1
39637,4111,1000.00,20000.00,21000.00,4788.55,15211.45,0.36,1
39638,4111,1000.00,21000.00,22000.00,0.00,21000.00,0.01,1
39639,4111,-1000.00,20000.00,21000.00,12678.37,9321.63,0.36,0
39640,4111,1000.00,21000.00,22000.00,3757.77,17242.23,0.41,1
39641,4111,-1000.00,20000.00,21000.00,11063.34,10936.66,0.22,0
39642,4111,0.00,20000.00,21000.00,0.00,0.00,0.03,0
39643,4111,1000.00,21000.00,22000.00,0.00,18125.46,0.42,1
39644,4111,1000.00,22000.00,23000.00,0.00,22000.00,0.11,1
39645,4111,-1000.00,21000.00,22000.00,13642.34,9357.66,0.09,0
39646,4112,-933.51,-933.51,66.49,100.37,833.14,0.42,0
39647,4112,-66.49,-1000.00,0.00,9.29,57.20,0.42,0
39648,4113,0.00,0.00,1000.00,0.00,0.00,0.11,0
39649,4113,-1000.00,-1000.00,0.00,583.47,416.53,0.00,0
39650,4114,-1000.00,-1000.00,0.00,754.28,245.72,0.07,0
39651,4114,-0.00,-1000.00,0.00,0.00,0.00,0.19,0
39652,4114,0.00,-1000.00,0.00,0.00,0.00,0.35,1
39653,4114,0.00,-1000.00,0.00,0.00,0.00,0.26,1
39654,4114,0.00,-1000.00,0.00,0.00,0.00,0.25,1
39655,4114,0.00,-1000.00,0.00,0.00,0.00,0.03,1
39656,4114,0.00,-1000.00,0.00,0.00,0.00,0.43,1
39657,4114,0.02,-999.98,0.02,0.00,0.00,0.13,1
39658,4114,2.17,-997.81,2.19,0.00,0.01,0.32,1
39659,4114,349.27,-648.54,351.46,0.12,2.07,0.19,1
39660,4114,1000.00,351.46,1351.46,79.73,271.73,0.27,1
39661,4114,1000.00,1351.46,2351.46,0.00,763.19,0.20,1
39662,4114,1000.00,2351.46,3351.46,417.16,613.27,0.20,1
39663,4114,1000.00,3351.46,4351.46,216.81,1022.15,0.22,1
39664,4114,1000.00,4351.46,5351.46,0.00,4351.46,0.17,1
39665,4114,1000.00,5351.46,6351.46,0.00,5351.46,0.29,1
39666,4114,1000.00,6351.46,7351.46,0.00,4921.00,0.29,1
39667,4114,1000.00,7351.46,8351.46,0.00,1537.45,0.18,1
39668,4114,-1000.00,6351.46,7351.46,3882.11,27.33,0.08,0
39669,4114,1000.00,7351.46,8351.46,3675.73,3675.73,0.27,1
39670,4114,1000.00,8351.46,9351.46,0.00,8351.46,0.32,1
39671,4114,1000.00,9351.46,10351.46,2141.44,7210.02,0.26,1
39672,4114,-1000.00,8351.46,9351.46,6947.04,3404.41,0.12,0
39673,4114,1000.00,9351.46,10351.46,3701.20,5526.91,0.28,1
39674,4114,-1000.00,8351.46,9351.46,0.00,10351.46,0.35,0
39675,4114,-1000.00,7351.46,8351.46,2255.87,4664.63,0.29,0
39676,4114,-1000.00,6351.46,7351.46,2901.02,5450.44,0.29,0
39677,4114,-1000.00,5351.46,6351.46,1273.69,6077.77,0.05,0
39678,4114,-1000.00,4351.46,5351.46,0.00,6351.46,0.09,0
39679,4114,-1000.00,3351.46,4351.46,0.00,3864.55,0.05,0
39680,4114,-1000.00,2351.46,3351.46,0.00,4351.46,0.03,0
39681,4114,-1000.00,1351.46,2351.46,0.00,3351.46,0.44,0
39682,4114,-1000.00,351.46,1351.46,1106.41,918.67,0.19,0
39683,4114,-727.44,-375.98,624.02,265.83,461.60,0.23,0
39684,4114,-624.02,-1000.00,0.00,0.00,624.02,0.29,0
39685,4115,0.00,0.00,1000.00,0.00,0.00,0.36,0
39686,4115,-1000.00,-1000.00,0.00,0.00,293.16,0.12,0
39687,4116,-1000.00,-1000.00,0.00,660.49,339.51,0.06,0
39688,4117,-1000.00,-1000.00,0.00,0.00,1000.00,0.13,0
39689,4118,-1000.00,-1000.00,0.00,418.93,581.07,0.08,0
39690,4119,-1000.00,-1000.00,0.00,0.00,1000.00,0.11,0
39691,4120,-1000.00,-1000.00,0.00,0.00,1000.00,0.04,0
39692,4121,-233.81,-233.81,766.19,0.00,233.81,0.09,0
39693,4121,-394.24,-628.06,371.94,0.00,394.24,0.34,0
39694,4121,-371.94,-1000.00,0.00,0.00,371.94,0.37,0
39695,4122,-467.51,-467.51,532.49,441.73,25.79,0.09,0
39696,4122,-365.74,-833.25,166.75,365.74,0.00,0.03,0
39697,4122,-433.60,-1266.85,-266.85,0.00,123.89,0.30,0
39698,4123,0.00,0.00,1000.00,0.00,0.00,0.03,0
39699,4123,-844.44,-844.44,155.56,58.06,786.37,0.41,0
39700,4123,-155.56,-1000.00,0.00,0.00,155.56,0.17,0
39701,4124,-1000.00,-1000.00,0.00,504.22,495.78,0.08,0
39702,4125,1000.00,1000.00,2000.00,0.00,1000.00,0.19,1
39703,4125,-1000.00,0.00,1000.00,1931.33,0.00,0.05,0
39704,4125,-504.21,-504.21,495.79,504.21,0.00,0.07,0
39705,4125,1000.00,495.79,1495.79,0.00,349.87,0.22,1
39706,4125,0.00,495.79,1495.79,0.00,0.00,0.08,0
39707,4125,1000.00,1495.79,2495.79,0.00,1124.49,0.37,1
39708,4125,1000.00,2495.79,3495.79,411.98,1600.68,0.36,1
39709,4125,1000.00,3495.79,4495.79,0.00,3495.79,0.30,1
39710,4125,1000.00,4495.79,5495.79,0.00,4133.06,0.40,1
39711,4125,1000.00,5495.79,6495.79,1096.69,4399.10,0.36,1
39712,4125,-1000.00,4495.79,5495.79,3602.04,2893.75,0.29,0
39713,4125,1000.00,5495.79,6495.79,2192.96,3302.83,0.24,1
39714,4125,1000.00,6495.79,7495.79,2091.74,3143.16,0.26,1
39715,4125,1000.00,7495.79,8495.79,300.75,7195.04,0.07,1
39716,4125,-1000.00,6495.79,7495.79,6198.66,2297.13,0.25,0
39717,4125,1000.00,7495.79,8495.79,3383.42,4112.37,0.17,1
39718,4125,1000.00,8495.79,9495.79,0.00,6977.98,0.20,1
39719,4125,1000.00,9495.79,10495.79,0.00,9495.79,0.12,1
39720,4125,-1000.00,8495.79,9495.79,1481.23,218.05,0.18,0
39721,4125,1000.00,9495.79,10495.79,0.00,1268.44,0.21,1
39722,4125,1000.00,10495.79,11495.79,3624.65,6871.14,0.30,1
39723,4125,1000.00,11495.79,12495.79,3931.94,7563.85,0.34,1
39724,4125,1000.00,12495.79,13495.79,1787.55,4652.73,0.25,1
39725,4125,1000.00,13495.79,14495.79,6747.90,6747.90,0.08,1
39726,4125,-1000.00,12495.79,13495.79,9626.65,4869.14,0.08,0
39727,4125,-1000.00,11495.79,12495.79,0.00,11563.09,0.33,0
39728,4125,-1000.00,10495.79,11495.79,3637.21,8858.58,0.15,0
39729,4125,-1000.00,9495.79,10495.79,0.00,11495.79,0.30,0
39730,4125,-1000.00,8495.79,9495.79,0.00,10495.79,0.27,0
39731,4125,-1000.00,7495.79,8495.79,3363.67,6132.12,0.37,0
39732,4125,-1000.00,6495.79,7495.79,3701.98,4602.17,0.26,0
39733,4125,-1000.00,5495.79,6495.79,1600.84,5894.95,0.09,0
39734,4125,-1000.00,4495.79,5495.79,2743.92,3748.37,0.27,0
39735,4125,-1000.00,3495.79,4495.79,0.00,5495.79,0.13,0
39736,4125,-1000.00,2495.79,3495.79,0.00,3511.45,0.30,0
39737,4125,-1000.00,1495.79,2495.79,1226.46,2269.33,0.29,0
39738,4125,-1000.00,495.79,1495.79,324.49,2171.30,0.33,0
39739,4125,-1000.00,-504.21,495.79,227.65,0.00,0.25,0
39740,4125,0.00,-504.21,495.79,0.00,0.00,0.38,0
39741,4125,-125.98,-630.19,369.81,0.00,125.98,0.39,0
39742,4125,1000.00,369.81,1369.81,25.57,0.00,0.34,1
39743,4125,-673.29,-303.48,696.52,0.00,673.29,0.03,0
39744,4125,-438.23,-741.71,258.29,0.00,438.23,0.21,0
39745,4126,-1000.00,-1000.00,0.00,133.31,866.69,0.33,0
39746,4127,-1000.00,-1000.00,0.00,0.00,1000.00,0.32,0
39747,4128,-1000.00,-1000.00,0.00,527.47,472.53,0.19,0
39748,4129,-1000.00,-1000.00,0.00,0.00,1000.00,0.38,0
39749,4130,-624.93,-624.93,375.07,0.00,624.93,0.36,0
39750,4130,-375.07,-1000.00,0.00,103.20,271.87,0.35,0
39751,4131,-820.19,-820.19,179.81,0.00,820.19,0.36,0
39752,4131,-179.81,-1000.00,0.00,8.31,171.50,0.27,0
39753,4132,1000.00,1000.00,2000.00,0.00,1000.00,0.21,1
39754,4132,0.00,1000.00,2000.00,0.00,0.00,0.11,0
39755,4132,1000.00,2000.00,3000.00,66.00,1934.00,0.11,1
39756,4132,1000.00,3000.00,4000.00,0.00,1077.40,0.23,1
39757,4132,1000.00,4000.00,5000.00,161.33,3838.67,0.32,1
39758,4132,1000.00,5000.00,6000.00,0.00,5000.00,0.18,1
39759,4132,1000.00,6000.00,7000.00,2486.45,3513.55,0.21,1
39760,4132,1000.00,7000.00,8000.00,2221.90,4778.10,0.34,1
39761,4132,1000.00,8000.00,9000.00,0.00,8000.00,0.12,1
39762,4132,1000.00,9000.00,10000.00,107.03,8892.97,0.41,1
39763,4132,-1000.00,8000.00,9000.00,5103.12,4896.88,0.30,0
39764,4132,-1000.00,7000.00,8000.00,4808.51,4191.49,0.12,0
39765,4132,1000.00,8000.00,9000.00,4000.00,4000.00,0.03,1
39766,4132,1000.00,9000.00,10000.00,0.00,5478.50,0.36,1
39767,4132,1000.00,10000.00,11000.00,0.00,9378.84,0.19,1
39768,4132,1000.00,11000.00,12000.00,4655.26,6344.74,0.25,1
39769,4132,1000.00,12000.00,13000.00,0.00,12000.00,0.34,1
39770,4132,1000.00,13000.00,14000.00,0.00,8898.81,0.29,1
39771,4132,1000.00,14000.00,15000.00,2153.30,11846.70,0.36,1
39772,4132,1000.00,15000.00,16000.00,0.00,14568.45,0.26,1
39773,4132,-1000.00,14000.00,15000.00,13641.04,2358.96,0.02,0
39774,4132,-1000.00,13000.00,14000.00,12367.62,2632.38,0.18,0
39775,4132,1000.00,14000.00,15000.00,0.00,14000.00,0.22,1
39776,4132,1000.00,15000.00,16000.00,0.00,15000.00,0.15,1
39777,4132,1000.00,16000.00,17000.00,6930.86,9069.14,0.20,1
39778,4132,1000.00,17000.00,18000.00,1161.71,6668.96,0.26,1
39779,4132,1000.00,18000.00,19000.00,3145.51,14854.49,0.40,1
39780,4132,1000.00,19000.00,20000.00,0.00,19000.00,0.37,1
39781,4132,-1000.00,18000.00,19000.00,2694.51,0.00,0.11,0
39782,4132,1000.00,19000.00,20000.00,0.00,19000.00,0.25,1
39783,4132,-1000.00,18000.00,19000.00,4532.32,4019.05,0.17,0
39784,4132,1000.00,19000.00,20000.00,8110.83,10889.17,0.18,1
39785,4132,1000.00,20000.00,21000.00,8154.35,11845.65,0.23,1
39786,4132,-1000.00,19000.00,20000.00,10177.14,3337.61,0.12,0
39787,4132,-1000.00,18000.00,19000.00,14828.82,0.00,0.06,0
39788,4132,1000.00,19000.00,20000.00,5617.22,13382.78,0.34,1
39789,4132,1000.00,20000.00,21000.00,0.00,8798.45,0.17,1
39790,4132,-1000.00,19000.00,20000.00,5415.04,2803.86,0.14,0
39791,4132,1000.00,20000.00,21000.00,0.00,2668.61,0.15,1
39792,4132,1000.00,21000.00,22000.00,0.00,21000.00,0.24,1
39793,4132,1000.00,22000.00,23000.00,330.60,21669.40,0.31,1
39794,4132,1000.00,23000.00,24000.00,11500.00,11500.00,0.08,1
39795,4132,1000.00,24000.00,25000.00,3294.87,20705.13,0.43,1
39796,4132,1000.00,25000.00,26000.00,0.00,25000.00,0.32,1
39797,4132,1000.00,26000.00,27000.00,338.69,25661.31,0.42,1
39798,4132,-1000.00,25000.00,26000.00,0.00,27000.00,0.15,0
39799,4132,-1000.00,24000.00,25000.00,4695.24,9232.04,0.24,0
39800,4132,-1000.00,23000.00,24000.00,0.00,13020.01,0.31,0
39801,4132,-1000.00,22000.00,23000.00,0.00,24000.00,0.11,0
39802,4132,-1000.00,21000.00,22000.00,500.80,22499.20,0.35,0
39803,4132,-1000.00,20000.00,21000.00,0.00,3503.74,0.16,0
39804,4132,0.00,20000.00,21000.00,0.00,0.00,0.03,0
39805,4132,-1000.00,19000.00,20000.00,0.00,21000.00,0.11,0
39806,4132,-1000.00,18000.00,19000.00,0.00,13749.96,0.20,0
39807,4132,-1000.00,17000.00,18000.00,3618.35,15381.65,0.39,0
39808,4132,-1000.00,16000.00,17000.00,0.00,18000.00,0.36,0
39809,4132,-1000.00,15000.00,16000.00,10431.56,6568.44,0.09,0
39810,4132,-1000.00,14000.00,15000.00,0.00,1484.78,0.07,0
39811,4132,-1000.00,13000.00,14000.00,0.00,15000.00,0.30,0
39812,4132,-1000.00,12000.00,13000.00,0.00,13221.80,0.40,0
39813,4132,-1000.00,11000.00,12000.00,4191.03,8808.97,0.27,0
39814,4132,-1000.00,10000.00,11000.00,0.00,12000.00,0.10,0
39815,4132,0.00,10000.00,11000.00,0.00,0.00,0.04,0
39816,4132,-1000.00,9000.00,10000.00,1106.51,3218.30,0.22,0
39817,4133,1000.00,1000.00,2000.00,0.00,338.12,0.21,1
39818,4133,1000.00,2000.00,3000.00,857.43,1142.57,0.15,1
39819,4133,-1000.00,1000.00,2000.00,1969.38,1030.62,0.12,0
39820,4133,1000.00,2000.00,3000.00,0.00,2000.00,0.16,1
39821,4133,-1000.00,1000.00,2000.00,2159.93,840.07,0.09,0
39822,4133,1000.00,2000.00,3000.00,130.78,510.13,0.20,1
39823,4133,1000.00,3000.00,4000.00,1471.12,1528.88,0.23,1
39824,4133,-1000.00,2000.00,3000.00,3606.92,393.08,0.02,0
39825,4133,-1000.00,1000.00,2000.00,2333.63,666.37,0.02,0
39826,4133,1000.00,2000.00,3000.00,915.20,1084.80,0.25,1
39827,4133,1000.00,3000.00,4000.00,165.42,2120.37,0.39,1
39828,4133,1000.00,4000.00,5000.00,836.03,3001.83,0.38,1
39829,4133,1000.00,5000.00,6000.00,1075.26,3924.74,0.37,1
39830,4133,1000.00,6000.00,7000.00,555.12,5444.88,0.36,1
39831,4133,1000.00,7000.00,8000.00,0.00,522.44,0.13,1
39832,4133,1000.00,8000.00,9000.00,3615.06,4384.94,0.09,1
39833,4133,-1000.00,7000.00,8000.00,8304.78,0.00,0.03,0
39834,4133,1000.00,8000.00,9000.00,3711.52,4288.48,0.13,1
39835,4133,-1000.00,7000.00,8000.00,4655.33,4344.67,0.21,0
39836,4133,1000.00,8000.00,9000.00,0.00,8000.00,0.19,1
39837,4133,1000.00,9000.00,10000.00,1199.35,7800.65,0.23,1
39838,4133,-1000.00,8000.00,9000.00,4081.98,0.00,0.03,0
39839,4133,1000.00,9000.00,10000.00,2684.47,6315.53,0.34,1
39840,4133,1000.00,10000.00,11000.00,2404.24,7595.76,0.10,1
39841,4133,-1000.00,9000.00,10000.00,1881.77,9044.73,0.41,0
39842,4133,-1000.00,8000.00,9000.00,0.00,10000.00,0.05,0
39843,4133,-1000.00,7000.00,8000.00,0.00,1246.77,0.32,0
39844,4133,-1000.00,6000.00,7000.00,2781.79,5218.21,0.31,0
39845,4133,-1000.00,5000.00,6000.00,1304.17,5695.83,0.39,0
39846,4133,-1000.00,4000.00,5000.00,2261.96,3738.04,0.31,0
39847,4133,-1000.00,3000.00,4000.00,279.67,4720.33,0.33,0
39848,4133,-1000.00,2000.00,3000.00,0.00,4000.00,0.28,0
39849,4133,-1000.00,1000.00,2000.00,0.00,3000.00,0.14,0
39850,4133,0.00,1000.00,2000.00,0.00,0.00,0.08,0
39851,4133,-333.90,666.10,1666.10,333.90,0.00,0.24,0
39852,4133,0.00,666.10,1666.10,0.00,0.00,0.29,0
39853,4133,-1000.00,-333.90,666.10,445.44,1220.66,0.28,0
39854,4133,0.00,-333.90,666.10,0.00,0.00,0.11,0
39855,4133,-153.16,-487.06,512.94,153.16,0.00,0.10,0
39856,4133,-1000.00,-1487.06,-487.06,204.35,308.59,0.19,0
39857,4134,1000.00,1000.00,2000.00,460.66,539.34,0.24,1
39858,4134,-559.96,440.04,1440.04,495.54,64.42,0.11,0
39859,4134,1000.00,1440.04,2440.04,698.45,741.60,0.15,1
39860,4134,1000.00,2440.04,3440.04,0.00,2440.04,0.21,1
39861,4134,1000.00,3440.04,4440.04,0.00,3440.04,0.14,1
39862,4134,1000.00,4440.04,5440.04,0.00,3854.74,0.24,1
39863,4134,1000.00,5440.04,6440.04,2371.30,3068.74,0.13,1
39864,4134,1000.00,6440.04,7440.04,636.02,1495.30,0.19,1
39865,4134,1000.00,7440.04,8440.04,0.00,6225.87,0.21,1
39866,4134,1000.00,8440.04,9440.04,0.00,8440.04,0.01,1
39867,4134,1000.00,9440.04,10440.04,2399.61,7040.43,0.36,1
39868,4134,-1000.00,8440.04,9440.04,6053.77,4386.27,0.02,0
39869,4134,1000.00,9440.04,10440.04,0.00,8362.98,0.43,1
39870,4134,1000.00,10440.04,11440.04,0.00,10440.04,0.07,1
39871,4134,1000.00,11440.04,12440.04,4521.50,6918.54,0.05,1
39872,4134,1000.00,12440.04,13440.04,300.14,12139.91,0.03,1
39873,4134,1000.00,13440.04,14440.04,277.17,13162.88,0.37,1
39874,4134,-1000.00,12440.04,13440.04,1753.25,0.00,0.10,0
39875,4134,1000.00,13440.04,14440.04,0.00,13440.04,0.26,1
39876,4134,1000.00,14440.04,15440.04,5032.38,9407.67,0.21,1
39877,4134,1000.00,15440.04,16440.04,0.00,15440.04,0.42,1
39878,4134,-1000.00,14440.04,15440.04,1738.01,202.64,0.11,0
39879,4134,1000.00,15440.04,16440.04,1868.27,7067.10,0.29,1
39880,4134,1000.00,16440.04,17440.04,0.00,12765.22,0.21,1
39881,4134,-1000.00,15440.04,16440.04,5962.56,11477.49,0.18,0
39882,4134,-1000.00,14440.04,15440.04,5176.57,0.00,0.36,0
39883,4134,-1000.00,13440.04,14440.04,0.00,815.96,0.41,0
39884,4134,-1000.00,12440.04,13440.04,8680.88,0.00,0.09,0
39885,4134,-1000.00,11440.04,12440.04,0.00,7329.60,0.25,0
39886,4134,-1000.00,10440.04,11440.04,12440.04,0.00,0.00,0
39887,4134,-1000.00,9440.04,10440.04,3951.13,0.00,0.31,0
39888,4134,-1000.00,8440.04,9440.04,3682.28,6757.76,0.03,0
39889,4134,-1000.00,7440.04,8440.04,3081.12,6358.92,0.29,0
39890,4134,-1000.00,6440.04,7440.04,0.00,8440.04,0.26,0
39891,4135,-1000.00,-1000.00,0.00,395.28,604.72,0.21,0
39892,4135,-0.00,-1000.00,0.00,0.00,0.00,0.38,0
39893,4136,-807.94,-807.94,192.06,807.94,0.00,0.05,0
39894,4136,-1000.00,-1807.94,-807.94,40.40,151.66,0.40,0
39895,4137,1000.00,1000.00,2000.00,0.41,999.59,0.40,1
39896,4137,1000.00,2000.00,3000.00,862.07,1137.93,0.29,1
39897,4137,1000.00,3000.00,4000.00,341.21,2658.79,0.43,1
39898,4137,1000.00,4000.00,5000.00,1515.70,2484.30,0.02,1
39899,4137,1000.00,5000.00,6000.00,1497.15,3502.85,0.32,1
39900,4137,1000.00,6000.00,7000.00,1809.70,4190.30,0.30,1
39901,4137,1000.00,7000.00,8000.00,0.00,7000.00,0.08,1
39902,4137,1000.00,8000.00,9000.00,0.00,6693.34,0.42,1
39903,4137,1000.00,9000.00,10000.00,0.00,9000.00,0.28,1
39904,4137,1000.00,10000.00,11000.00,3402.67,4999.25,0.27,1
39905,4137,1000.00,11000.00,12000.00,4806.77,5373.43,0.24,1
39906,4137,1000.00,12000.00,13000.00,5883.06,6116.94,0.10,1
39907,4137,1000.00,13000.00,14000.00,0.00,13000.00,0.23,1
39908,4137,1000.00,14000.00,15000.00,0.00,4082.82,0.18,1
39909,4137,1000.00,15000.00,16000.00,0.00,15000.00,0.31,1
39910,4137,-1000.00,14000.00,15000.00,6773.96,806.24,0.13,0
39911,4137,1000.00,15000.00,16000.00,4585.49,10414.51,0.21,1
39912,4137,1000.00,16000.00,17000.00,0.00,7171.72,0.27,1
39913,4137,-1000.00,15000.00,16000.00,6662.08,0.00,0.07,0
39914,4137,1000.00,16000.00,17000.00,0.00,16000.00,0.09,1
39915,4137,1000.00,17000.00,18000.00,8500.00,8500.00,0.18,1
39916,4137,1000.00,18000.00,19000.00,6596.46,11403.54,0.21,1
39917,4137,1000.00,19000.00,20000.00,0.00,19000.00,0.01,1
39918,4137,1000.00,20000.00,21000.00,0.00,20000.00,0.38,1
39919,4137,1000.00,21000.00,22000.00,7071.18,13928.82,0.17,1
39920,4137,1000.00,22000.00,23000.00,2366.52,13846.51,0.36,1
39921,4137,1000.00,23000.00,24000.00,0.00,13376.76,0.16,1
39922,4137,1000.00,24000.00,25000.00,12000.00,12000.00,0.10,1
39923,4137,1000.00,25000.00,26000.00,0.00,25000.00,0.18,1
39924,4137,1000.00,26000.00,27000.00,305.07,25694.93,0.21,1
39925,4137,1000.00,27000.00,28000.00,9178.38,17821.62,0.33,1
39926,4137,1000.00,28000.00,29000.00,0.00,28000.00,0.26,1
39927,4137,1000.00,29000.00,30000.00,14500.00,14500.00,0.09,1
39928,4137,1000.00,30000.00,31000.00,448.54,9936.43,0.24,1
39929,4137,1000.00,31000.00,32000.00,4605.57,26394.43,0.41,1
39930,4137,1000.00,32000.00,33000.00,13280.41,18719.59,0.28,1
39931,4137,1000.00,33000.00,34000.00,0.00,33000.00,0.05,1
39932,4137,1000.00,34000.00,35000.00,15743.38,18256.62,0.11,1
39933,4137,-190.95,33809.05,34809.05,190.95,0.00,0.04,0
39934,4137,1000.00,34809.05,35809.05,15228.77,19580.28,0.07,1
39935,4137,1000.00,35809.05,36809.05,8875.31,26933.74,0.14,1
39936,4137,-1000.00,34809.05,35809.05,30245.44,5684.75,0.06,0
39937,4137,1000.00,35809.05,36809.05,7725.08,28083.97,0.36,1
39938,4137,1000.00,36809.05,37809.05,6129.99,30679.05,0.17,1
39939,4138,-1000.00,-1000.00,0.00,0.00,723.74,0.14,0
39940,4139,1000.00,1000.00,2000.00,0.00,679.02,0.38,1
39941,4139,1000.00,2000.00,3000.00,0.00,1147.27,0.34,1
39942,4139,1000.00,3000.00,4000.00,0.00,3000.00,0.42,1
39943,4139,1000.00,4000.00,5000.00,2000.00,2000.00,0.04,1
39944,4139,1000.00,5000.00,6000.00,0.00,5000.00,0.15,1
39945,4139,1000.00,6000.00,7000.00,0.00,2332.93,0.16,1
39946,4139,1000.00,7000.00,8000.00,0.00,4154.86,0.11,1
39947,4139,1000.00,8000.00,9000.00,2090.97,5909.03,0.35,1
39948,4139,0.00,8000.00,9000.00,0.00,0.00,0.07,0
39949,4139,1000.00,9000.00,10000.00,704.86,6806.23,0.40,1
39950,4139,1000.00,10000.00,11000.00,2306.00,3702.22,0.24,1
39951,4139,1000.00,11000.00,12000.00,0.00,11000.00,0.38,1
39952,4139,-1000.00,10000.00,11000.00,6626.53,5373.47,0.12,0
39953,4139,1000.00,11000.00,12000.00,270.80,3971.88,0.25,1
39954,4139,1000.00,12000.00,13000.00,0.00,8837.23,0.39,1
39955,4139,-1000.00,11000.00,12000.00,11357.40,1385.30,0.15,0
39956,4139,1000.00,12000.00,13000.00,2893.74,9106.26,0.39,1
39957,4139,1000.00,13000.00,14000.00,0.00,10132.39,0.33,1
39958,4139,1000.00,14000.00,15000.00,0.00,13767.10,0.15,1
39959,4139,1000.00,15000.00,16000.00,0.00,15000.00,0.12,1
39960,4139,1000.00,16000.00,17000.00,0.00,15451.31,0.43,1
39961,4139,1000.00,17000.00,18000.00,3993.46,7529.47,0.27,1
39962,4139,1000.00,18000.00,19000.00,0.00,17745.98,0.11,1
39963,4139,1000.00,19000.00,20000.00,0.00,3143.38,0.18,1
39964,4139,1000.00,20000.00,21000.00,0.00,20000.00,0.09,1
39965,4139,1000.00,21000.00,22000.00,7459.19,13540.81,0.13,1
39966,4139,1000.00,22000.00,23000.00,184.37,11849.36,0.33,1
39967,4139,1000.00,23000.00,24000.00,0.00,23000.00,0.24,1
39968,4139,1000.00,24000.00,25000.00,0.00,24000.00,0.03,1
39969,4139,1000.00,25000.00,26000.00,4956.33,20043.67,0.22,1
39970,4139,1000.00,26000.00,27000.00,0.00,16624.97,0.34,1
39971,4139,1000.00,27000.00,28000.00,0.00,13109.81,0.17,1
39972,4139,1000.00,28000.00,29000.00,0.00,27306.22,0.39,1
39973,4139,1000.00,29000.00,30000.00,844.67,27386.82,0.44,1
39974,4139,1000.00,30000.00,31000.00,13115.24,16884.76,0.23,1
39975,4139,-1000.00,29000.00,30000.00,18248.67,12751.33,0.09,0
39976,4139,1000.00,30000.00,31000.00,0.00,27849.19,0.27,1
39977,4139,1000.00,31000.00,32000.00,10611.71,20388.29,0.44,1
39978,4139,1000.00,32000.00,33000.00,9766.43,12395.46,0.23,1
39979,4139,1000.00,33000.00,34000.00,0.00,33000.00,0.15,1
39980,4139,-1000.00,32000.00,33000.00,23766.83,10233.17,0.03,0
39981,4140,-81.44,-81.44,918.56,81.44,0.00,0.17,0
39982,4140,-918.56,-1000.00,0.00,488.98,429.58,0.01,0
39983,4141,1000.00,1000.00,2000.00,0.00,1000.00,0.36,1
39984,4141,1000.00,2000.00,3000.00,0.00,841.33,0.12,1
39985,4141,1000.00,3000.00,4000.00,0.00,252.88,0.11,1
39986,4141,1000.00,4000.00,5000.00,676.42,3323.58,0.21,1
39987,4141,1000.00,5000.00,6000.00,0.00,5000.00,0.04,1
39988,4141,-1000.00,4000.00,5000.00,5139.93,860.07,0.05,0
39989,4141,1000.00,5000.00,6000.00,0.00,2823.51,0.34,1
39990,4141,-1000.00,4000.00,5000.00,3195.65,2804.35,0.20,0
39991,4141,1000.00,5000.00,6000.00,0.00,5000.00,0.22,1
39992,4141,1000.00,6000.00,7000.00,1791.85,4208.15,0.31,1
39993,4141,1000.00,7000.00,8000.00,0.00,2793.20,0.22,1
39994,4141,1000.00,8000.00,9000.00,3960.72,4039.28,0.37,1
39995,4141,1000.00,9000.00,10000.00,1304.32,7695.68,0.31,1
39996,4141,1000.00,10000.00,11000.00,5000.00,5000.00,0.05,1
39997,4141,-1000.00,9000.00,10000.00,9448.40,1551.60,0.05,0
39998,4141,1000.00,10000.00,11000.00,2257.19,7742.81,0.40,1
39999,4141,1000.00,11000.00,12000.00,0.00,5559.98,0.18,1
40000,4141,1000.00,12000.00,13000.00,0.00,12000.00,0.13,1
40001,4141,1000.00,13000.00,14000.00,5208.51,7791.49,0.27,1
40002,4141,1000.00,14000.00,15000.00,5205.71,8794.29,0.29,1
40003,4141,1000.00,15000.00,16000.00,0.00,15000.00,0.01,1
40004,4141,1000.00,16000.00,17000.00,5555.79,10444.21,0.32,1
40005,4141,1000.00,17000.00,18000.00,0.00,16741.80,0.36,1
40006,4141,-1000.00,16000.00,17000.00,5860.61,3549.43,0.16,0
40007,4141,1000.00,17000.00,18000.00,0.00,14137.73,0.40,1
40008,4141,1000.00,18000.00,19000.00,0.00,17842.62,0.33,1
40009,4141,1000.00,19000.00,20000.00,0.00,18792.78,0.43,1
40010,4141,1000.00,20000.00,21000.00,0.00,5320.73,0.12,1
40011,4141,-1000.00,19000.00,20000.00,20239.91,760.09,0.02,0
40012,4141,1000.00,20000.00,21000.00,5444.17,14555.83,0.22,1
40013,4141,1000.00,21000.00,22000.00,0.00,21000.00,0.14,1
40014,4141,-1000.00,20000.00,21000.00,12117.14,9882.86,0.31,0
40015,4141,1000.00,21000.00,22000.00,3648.39,17351.61,0.42,1
40016,4141,1000.00,22000.00,23000.00,0.00,22000.00,0.13,1
40017,4141,1000.00,23000.00,24000.00,0.00,2163.93,0.02,1
40018,4141,1000.00,24000.00,25000.00,0.00,20108.43,0.29,1
40019,4141,1000.00,25000.00,26000.00,0.00,7412.26,0.09,1
40020,4141,-1000.00,24000.00,25000.00,4502.47,1010.29,0.12,0
40021,4141,1000.00,25000.00,26000.00,6892.57,18107.43,0.11,1
40022,4141,1000.00,26000.00,27000.00,4089.76,16752.50,0.36,1
40023,4141,-1000.00,25000.00,26000.00,13579.94,13420.06,0.07,0
40024,4142,-1000.00,-1000.00,0.00,83.61,916.39,0.26,0
40025,4143,0.00,0.00,1000.00,0.00,0.00,0.19,0
40026,4143,0.00,0.00,1000.00,0.00,0.00,0.40,0
40027,4143,-1000.00,-1000.00,0.00,154.77,845.23,0.26,0
40028,4144,-1000.00,-1000.00,0.00,1000.00,0.00,0.04,0
40029,4145,1000.00,1000.00,2000.00,0.00,1000.00,0.07,1
40030,4145,1000.00,2000.00,3000.00,0.00,1319.45,0.18,1
40031,4145,1000.00,3000.00,4000.00,856.10,2143.90,0.15,1
40032,4145,-1000.00,2000.00,3000.00,2294.65,1705.35,0.04,0
40033,4145,1000.00,3000.00,4000.00,162.03,2837.97,0.21,1
40034,4145,1000.00,4000.00,5000.00,346.67,3653.33,0.03,1
40035,4145,1000.00,5000.00,6000.00,0.00,3939.21,0.40,1
40036,4145,1000.00,6000.00,7000.00,0.00,5486.85,0.44,1
40037,4145,1000.00,7000.00,8000.00,0.00,2136.48,0.06,1
40038,4145,1000.00,8000.00,9000.00,2849.40,5150.60,0.31,1
40039,4145,0.00,8000.00,9000.00,0.00,0.00,0.06,0
40040,4145,1000.00,9000.00,10000.00,0.00,9000.00,0.15,1
40041,4145,1000.00,10000.00,11000.00,0.00,6822.99,0.30,1
40042,4145,1000.00,11000.00,12000.00,0.00,8367.00,0.36,1
40043,4145,1000.00,12000.00,13000.00,1495.52,5576.50,0.30,1
40044,4145,1000.00,13000.00,14000.00,6081.85,6918.15,0.24,1
40045,4145,1000.00,14000.00,15000.00,0.00,14000.00,0.20,1
40046,4145,1000.00,15000.00,16000.00,4704.64,10295.36,0.14,1
40047,4145,1000.00,16000.00,17000.00,3022.48,12977.52,0.41,1
40048,4145,1000.00,17000.00,18000.00,0.00,17000.00,0.30,1
40049,4145,1000.00,18000.00,19000.00,5644.17,12355.83,0.25,1
40050,4145,1000.00,19000.00,20000.00,0.00,12928.31,0.38,1
40051,4145,1000.00,20000.00,21000.00,8541.77,11458.23,0.22,1
40052,4145,1000.00,21000.00,22000.00,6834.01,14165.99,0.16,1
40053,4145,1000.00,22000.00,23000.00,6281.91,15718.09,0.18,1
40054,4145,1000.00,23000.00,24000.00,0.00,23000.00,0.29,1
40055,4145,1000.00,24000.00,25000.00,3849.60,11082.57,0.29,1
40056,4145,1000.00,25000.00,26000.00,0.00,25000.00,0.34,1
40057,4145,1000.00,26000.00,27000.00,13000.00,13000.00,0.14,1
40058,4145,1000.00,27000.00,28000.00,0.00,27000.00,0.25,1
40059,4145,1000.00,28000.00,29000.00,13409.21,14590.79,0.20,1
40060,4145,1000.00,29000.00,30000.00,9898.09,19101.91,0.30,1
40061,4145,1000.00,30000.00,31000.00,10679.61,17438.38,0.34,1
40062,4145,1000.00,31000.00,32000.00,12932.04,18067.96,0.28,1
40063,4145,1000.00,32000.00,33000.00,11171.34,20828.66,0.32,1
40064,4145,1000.00,33000.00,34000.00,10305.20,22694.80,0.15,1
40065,4145,1000.00,34000.00,35000.00,0.00,17461.93,0.01,1
40066,4145,1000.00,35000.00,36000.00,17209.26,17790.74,0.10,1
40067,4145,1000.00,36000.00,37000.00,17145.43,18854.57,0.16,1
40068,4145,1000.00,37000.00,38000.00,0.00,26125.57,0.19,1
40069,4145,1000.00,38000.00,39000.00,1263.27,31589.06,0.42,1
40070,4145,1000.00,39000.00,40000.00,6166.98,32833.02,0.38,1
40071,4145,1000.00,40000.00,41000.00,9168.88,30831.12,0.36,1
40072,4145,1000.00,41000.00,42000.00,4232.91,31935.75,0.41,1
40073,4145,-1000.00,40000.00,41000.00,39047.37,0.00,0.04,0
40074,4146,-643.16,-643.16,356.84,0.00,643.16,0.27,0
40075,4146,-356.84,-1000.00,0.00,178.42,178.42,0.04,0
40076,4147,-652.36,-652.36,347.64,652.36,0.00,0.03,0
40077,4147,0.00,-652.36,347.64,0.00,0.00,0.21,0
40078,4147,-1000.00,-1652.36,-652.36,0.00,139.23,0.40,0
40079,4148,-1000.00,-1000.00,0.00,263.64,736.36,0.11,0
40080,4149,-1000.00,-1000.00,0.00,371.07,628.93,0.04,0
40081,4150,-1000.00,-1000.00,0.00,78.16,921.84,0.42,0
40082,4151,1000.00,1000.00,2000.00,549.44,0.00,0.24,1
40083,4151,0.00,1000.00,2000.00,0.00,0.00,0.25,0
40084,4151,-1000.00,0.00,1000.00,689.19,1220.43,0.30,0
40085,4151,-238.63,-238.63,761.37,0.00,238.63,0.31,0
40086,4151,-73.32,-311.95,688.05,0.00,73.32,0.43,0
40087,4151,1000.00,688.05,1688.05,601.70,0.00,0.11,1
40088,4151,1000.00,1688.05,2688.05,1162.41,525.65,0.10,1
40089,4151,-1000.00,688.05,1688.05,0.00,1740.66,0.40,0
40090,4151,-1000.00,-311.95,688.05,0.00,1665.39,0.43,0
40091,4151,-172.65,-484.60,515.40,0.00,172.65,0.20,0
40092,4151,-359.41,-844.01,155.99,0.00,359.41,0.35,0
40093,4151,-155.99,-1000.00,0.00,0.00,155.99,0.10,0
40094,4152,-1000.00,-1000.00,0.00,0.00,1000.00,0.13,0
40095,4153,-1000.00,-1000.00,0.00,534.03,465.97,0.19,0
40096,4154,1000.00,1000.00,2000.00,0.00,1000.00,0.42,1
40097,4154,1000.00,2000.00,3000.00,0.00,2000.00,0.19,1
40098,4154,1000.00,3000.00,4000.00,0.00,881.90,0.19,1
40099,4154,1000.00,4000.00,5000.00,1593.96,2406.04,0.28,1
40100,4154,1000.00,5000.00,6000.00,2370.11,2629.89,0.14,1
40101,4154,1000.00,6000.00,7000.00,3000.00,3000.00,0.01,1
40102,4154,1000.00,7000.00,8000.00,0.00,7000.00,0.24,1
40103,4154,-1000.00,6000.00,7000.00,4117.69,3882.31,0.21,0
40104,4154,1000.00,7000.00,8000.00,0.00,7000.00,0.26,1
40105,4154,1000.00,8000.00,9000.00,0.00,8000.00,0.34,1
40106,4154,1000.00,9000.00,10000.00,2223.95,6776.05,0.33,1
40107,4154,1000.00,10000.00,11000.00,0.00,10000.00,0.12,1
40108,4154,-1000.00,9000.00,10000.00,3337.34,0.00,0.08,0
40109,4154,1000.00,10000.00,11000.00,0.00,7162.26,0.36,1
40110,4154,0.00,10000.00,11000.00,0.00,0.00,0.00,0
40111,4154,1000.00,11000.00,12000.00,0.00,11000.00,0.04,1
40112,4154,1000.00,12000.00,13000.00,1483.67,10246.41,0.16,1
40113,4154,-1000.00,11000.00,12000.00,6793.62,6206.38,0.15,0
40114,4154,-1000.00,10000.00,11000.00,10966.89,1033.11,0.08,0
40115,4154,-1000.00,9000.00,10000.00,6274.04,0.00,0.04,0
40116,4154,1000.00,10000.00,11000.00,1614.73,8385.27,0.33,1
40117,4154,1000.00,11000.00,12000.00,0.00,11000.00,0.43,1
40118,4154,1000.00,12000.00,13000.00,0.00,12000.00,0.04,1
40119,4154,1000.00,13000.00,14000.00,2493.84,10506.16,0.35,1
40120,4154,-1000.00,12000.00,13000.00,9799.23,4200.77,0.11,0
40121,4154,1000.00,13000.00,14000.00,0.00,13000.00,0.07,1
40122,4154,1000.00,14000.00,15000.00,0.00,4170.68,0.22,1
40123,4154,1000.00,15000.00,16000.00,0.00,15000.00,0.04,1
40124,4154,1000.00,16000.00,17000.00,0.00,16000.00,0.02,1
40125,4154,1000.00,17000.00,18000.00,4723.12,12276.88,0.26,1
40126,4154,1000.00,18000.00,19000.00,1339.89,16660.11,0.44,1
40127,4154,1000.00,19000.00,20000.00,0.00,5252.32,0.17,1
40128,4154,1000.00,20000.00,21000.00,0.00,20000.00,0.24,1
40129,4154,1000.00,21000.00,22000.00,4101.65,16898.35,0.14,1
40130,4154,1000.00,22000.00,23000.00,1718.68,14942.53,0.38,1
40131,4154,1000.00,23000.00,24000.00,11500.00,11500.00,0.03,1
40132,4154,1000.00,24000.00,25000.00,0.00,24000.00,0.22,1
40133,4154,-1000.00,23000.00,24000.00,21194.59,3805.41,0.07,0
40134,4154,1000.00,24000.00,25000.00,7919.67,16080.33,0.13,1
40135,4154,1000.00,25000.00,26000.00,0.00,25000.00,0.10,1
40136,4154,1000.00,26000.00,27000.00,0.00,11057.49,0.04,1
40137,4155,-1000.00,-1000.00,0.00,105.73,894.27,0.22,0
40138,4156,0.00,0.00,1000.00,0.00,0.00,0.07,0
40139,4156,-1000.00,-1000.00,0.00,416.50,583.50,0.24,0
40140,4157,-59.82,-59.82,940.18,0.00,59.82,0.07,0
40141,4157,-940.18,-1000.00,0.00,5.49,934.68,0.19,0
40142,4157,-0.00,-1000.00,-0.00,0.00,0.00,0.08,0
40143,4158,1000.00,1000.00,2000.00,287.70,712.30,0.36,1
40144,4158,1000.00,2000.00,3000.00,653.12,1346.88,0.27,1
40145,4158,-1000.00,1000.00,2000.00,1715.32,1237.27,0.18,0
40146,4158,1000.00,2000.00,3000.00,506.03,764.04,0.24,1
40147,4158,1000.00,3000.00,4000.00,0.00,2860.24,0.30,1
40148,4158,1000.00,4000.00,5000.00,1693.51,2306.49,0.22,1
40149,4158,1000.00,5000.00,6000.00,1711.61,3288.39,0.33,1
40150,4158,1000.00,6000.00,7000.00,0.00,1588.65,0.07,1
40151,4158,1000.00,7000.00,8000.00,0.00,7000.00,0.25,1
40152,4158,1000.00,8000.00,9000.00,3633.58,4366.42,0.08,1
40153,4158,1000.00,9000.00,10000.00,0.00,9000.00,0.35,1
40154,4158,1000.00,10000.00,11000.00,0.00,10000.00,0.21,1
40155,4158,1000.00,11000.00,12000.00,0.00,6009.88,0.33,1
40156,4158,1000.00,12000.00,13000.00,0.00,8020.42,0.12,1
40157,4158,1000.00,13000.00,14000.00,2469.11,10530.89,0.15,1
40158,4158,1000.00,14000.00,15000.00,0.00,3081.52,0.19,1
40159,4158,1000.00,15000.00,16000.00,0.00,15000.00,0.26,1
40160,4158,-1000.00,14000.00,15000.00,4299.74,11700.26,0.08,0
40161,4158,-1000.00,13000.00,14000.00,4236.15,10763.85,0.32,0
40162,4158,-1000.00,12000.00,13000.00,0.00,14000.00,0.23,0
40163,4158,-1000.00,11000.00,12000.00,1130.27,11869.73,0.33,0
40164,4158,-1000.00,10000.00,11000.00,4840.82,7159.18,0.27,0
40165,4158,-1000.00,9000.00,10000.00,4541.16,1991.70,0.14,0
40166,4158,-1000.00,8000.00,9000.00,1297.49,5606.61,0.33,0
40167,4158,-1000.00,7000.00,8000.00,6014.18,2985.82,0.09,0
40168,4158,-1000.00,6000.00,7000.00,4951.56,3048.44,0.15,0
40169,4158,-1000.00,5000.00,6000.00,0.00,4047.97,0.32,0
40170,4158,-1000.00,4000.00,5000.00,3005.93,2994.07,0.16,0
40171,4158,-1000.00,3000.00,4000.00,576.76,4423.24,0.43,0
40172,4158,-1000.00,2000.00,3000.00,1279.57,10.25,0.10,0
40173,4158,-1000.00,1000.00,2000.00,430.90,2569.10,0.38,0
40174,4158,-1000.00,0.00,1000.00,0.00,1273.29,0.35,0
40175,4158,-1000.00,-1000.00,0.00,0.00,1000.00,0.06,0
40176,4159,-1000.00,-1000.00,0.00,245.00,755.00,0.21,0
40177,4160,0.00,0.00,1000.00,0.00,0.00,0.07,0
40178,4160,-1000.00,-1000.00,0.00,550.15,449.85,0.06,0
40179,4161,0.00,0.00,1000.00,0.00,0.00,0.16,0
40180,4161,-351.84,-351.84,648.16,0.00,351.84,0.31,0
40181,4161,-648.16,-1000.00,0.00,0.00,648.16,0.12,0
40182,4162,0.00,0.00,1000.00,0.00,0.00,0.37,0
40183,4162,-1000.00,-1000.00,0.00,0.00,1000.00,0.00,0
40184,4163,0.00,0.00,1000.00,0.00,0.00,0.30,0
40185,4163,-1000.00,-1000.00,0.00,0.00,212.47,0.40,0
40186,4164,-141.93,-141.93,858.07,141.93,0.00,0.35,0
40187,4164,0.00,-141.93,858.07,0.00,0.00,0.43,0
40188,4164,-1000.00,-1141.93,-141.93,349.62,353.32,0.35,0
40189,4165,-1000.00,-1000.00,0.00,735.60,264.40,0.08,0
40190,4166,1000.00,1000.00,2000.00,191.90,659.41,0.36,1
40191,4166,1000.00,2000.00,3000.00,0.00,1173.24,0.20,1
40192,4166,1000.00,3000.00,4000.00,97.42,2902.58,0.39,1
40193,4166,1000.00,4000.00,5000.00,0.00,4000.00,0.18,1
40194,4166,1000.00,5000.00,6000.00,2500.00,2500.00,0.11,1
40195,4166,0.00,5000.00,6000.00,0.00,0.00,0.00,0
40196,4166,1000.00,6000.00,7000.00,0.00,5017.57,0.05,1
40197,4166,1000.00,7000.00,8000.00,0.00,7000.00,0.34,1
40198,4166,1000.00,8000.00,9000.00,3209.87,4442.32,0.27,1
40199,4166,1000.00,9000.00,10000.00,0.00,9000.00,0.08,1
40200,4166,1000.00,10000.00,11000.00,3652.95,6347.05,0.31,1
40201,4166,1000.00,11000.00,12000.00,3142.39,7857.61,0.17,1
40202,4166,1000.00,12000.00,13000.00,0.00,12000.00,0.24,1
40203,4166,-715.05,11284.95,12284.95,715.05,0.00,0.07,0
40204,4166,1000.00,12284.95,13284.95,0.00,8528.92,0.16,1
40205,4166,1000.00,13284.95,14284.95,0.00,1806.63,0.16,1
40206,4166,1000.00,14284.95,15284.95,3476.70,10808.25,0.43,1
40207,4166,1000.00,15284.95,16284.95,2553.35,12731.60,0.25,1
40208,4166,1000.00,16284.95,17284.95,2770.55,13514.40,0.11,1
40209,4166,-1000.00,15284.95,16284.95,9157.17,8127.79,0.40,0
40210,4166,-1000.00,14284.95,15284.95,0.00,16284.95,0.06,0
40211,4166,-1000.00,13284.95,14284.95,1043.55,5904.38,0.26,0
40212,4166,-1000.00,12284.95,13284.95,0.00,8543.36,0.35,0
40213,4166,-1000.00,11284.95,12284.95,0.00,13242.18,0.44,0
40214,4166,-1000.00,10284.95,11284.95,0.00,12284.95,0.05,0
40215,4166,-1000.00,9284.95,10284.95,0.00,6542.47,0.31,0
40216,4166,-1000.00,8284.95,9284.95,0.00,7794.07,0.41,0
40217,4166,-1000.00,7284.95,8284.95,0.00,7394.61,0.32,0
40218,4166,-1000.00,6284.95,7284.95,0.00,1712.08,0.16,0
40219,4166,-1000.00,5284.95,6284.95,0.00,4443.19,0.20,0
40220,4166,-1000.00,4284.95,5284.95,1621.07,4663.89,0.35,0
40221,4166,-1000.00,3284.95,4284.95,0.00,4689.07,0.22,0
40222,4166,-1000.00,2284.95,3284.95,598.58,3258.05,0.40,0
40223,4166,-1000.00,1284.95,2284.95,1364.23,1920.73,0.18,0
40224,4166,-319.32,965.63,1965.63,0.00,319.32,0.14,0
40225,4166,-432.44,533.20,1533.20,0.00,432.44,0.11,0
40226,4166,-1000.00,-466.80,533.20,0.00,1533.20,0.05,0
40227,4166,-143.55,-610.35,389.65,0.00,143.55,0.07,0
40228,4166,-79.58,-689.94,310.06,0.00,79.58,0.02,0
40229,4166,-297.03,-986.97,13.03,0.00,297.03,0.10,0
40230,4166,-13.03,-1000.00,0.00,0.00,13.03,0.09,0
40231,4167,-585.39,-585.39,414.61,585.39,0.00,0.10,0
40232,4167,-1000.00,-1585.39,-585.39,0.00,84.34,0.41,0
40233,4168,0.00,0.00,1000.00,0.00,0.00,0.16,0
40234,4168,1000.00,1000.00,2000.00,237.26,0.00,0.35,1
40235,4168,-1000.00,0.00,1000.00,442.00,1558.00,0.27,0
40236,4168,-1000.00,-1000.00,0.00,0.00,1000.00,0.32,0
40237,4169,-1000.00,-1000.00,0.00,150.55,849.45,0.16,0
40238,4170,0.00,0.00,1000.00,0.00,0.00,0.38,0
40239,4170,0.00,0.00,1000.00,0.00,0.00,0.40,0
40240,4170,-1000.00,-1000.00,0.00,0.00,647.89,0.26,0
40241,4171,-70.86,-70.86,929.14,70.86,0.00,0.44,0
40242,4171,0.00,-70.86,929.14,0.00,0.00,0.02,0
40243,4171,-1000.00,-1070.86,-70.86,0.00,450.06,0.01,0
40244,4172,1000.00,1000.00,2000.00,270.58,729.42,0.26,1
40245,4172,1000.00,2000.00,3000.00,0.00,2000.00,0.08,1
40246,4172,1000.00,3000.00,4000.00,0.00,3000.00,0.11,1
40247,4172,1000.00,4000.00,5000.00,0.00,2849.78,0.25,1
40248,4172,1000.00,5000.00,6000.00,688.80,4311.20,0.42,1
40249,4172,1000.00,6000.00,7000.00,2543.16,3456.84,0.25,1
40250,4172,1000.00,7000.00,8000.00,1997.78,5002.22,0.11,1
40251,4172,1000.00,8000.00,9000.00,0.00,3967.77,0.18,1
40252,4172,1000.00,9000.00,10000.00,2638.93,6361.07,0.36,1
40253,4172,1000.00,10000.00,11000.00,1343.13,6842.92,0.38,1
40254,4172,1000.00,11000.00,12000.00,0.00,10279.13,0.41,1
40255,4172,1000.00,12000.00,13000.00,0.00,4964.20,0.18,1
40256,4172,1000.00,13000.00,14000.00,0.00,13000.00,0.22,1
40257,4172,1000.00,14000.00,15000.00,0.00,10556.54,0.30,1
40258,4172,1000.00,15000.00,16000.00,4869.51,10130.49,0.23,1
40259,4172,1000.00,16000.00,17000.00,7064.88,8935.12,0.21,1
40260,4172,-1000.00,15000.00,16000.00,9655.51,7344.49,0.02,0
40261,4172,1000.00,16000.00,17000.00,0.00,10447.22,0.36,1
40262,4172,1000.00,17000.00,18000.00,5594.11,11405.89,0.31,1
40263,4172,1000.00,18000.00,19000.00,0.00,18000.00,0.14,1
40264,4172,1000.00,19000.00,20000.00,2010.97,16989.03,0.41,1
40265,4172,-1000.00,18000.00,19000.00,11948.46,6884.23,0.15,0
40266,4172,1000.00,19000.00,20000.00,0.00,19000.00,0.14,1
40267,4172,1000.00,20000.00,21000.00,588.67,19411.33,0.44,1
40268,4172,1000.00,21000.00,22000.00,4809.55,16190.45,0.17,1
40269,4172,1000.00,22000.00,23000.00,0.00,17540.00,0.41,1
40270,4172,1000.00,23000.00,24000.00,10065.59,12934.41,0.22,1
40271,4172,-1000.00,22000.00,23000.00,13524.30,10475.70,0.09,0
40272,4172,1000.00,23000.00,24000.00,0.00,23000.00,0.09,1
40273,4172,1000.00,24000.00,25000.00,10362.22,13637.78,0.20,1
40274,4172,1000.00,25000.00,26000.00,0.00,25000.00,0.31,1
40275,4172,1000.00,26000.00,27000.00,12995.99,13004.01,0.08,1
40276,4172,1000.00,27000.00,28000.00,12659.03,14340.97,0.24,1
40277,4172,1000.00,28000.00,29000.00,0.00,5273.08,0.18,1
40278,4172,1000.00,29000.00,30000.00,0.00,29000.00,0.32,1
40279,4172,1000.00,30000.00,31000.00,0.00,5668.27,0.17,1
40280,4172,-1000.00,29000.00,30000.00,14395.37,14157.42,0.22,0
40281,4172,1000.00,30000.00,31000.00,0.00,13310.57,0.22,1
40282,4172,1000.00,31000.00,32000.00,14606.42,16393.58,0.15,1
40283,4172,1000.00,32000.00,33000.00,13031.45,17126.98,0.20,1
40284,4172,1000.00,33000.00,34000.00,0.00,23616.10,0.18,1
40285,4172,1000.00,34000.00,35000.00,1967.27,32032.73,0.22,1
40286,4172,1000.00,35000.00,36000.00,0.00,35000.00,0.23,1
40287,4172,1000.00,36000.00,37000.00,0.00,36000.00,0.36,1
40288,4172,-1000.00,35000.00,36000.00,8218.86,2553.10,0.12,0
40289,4172,-1000.00,34000.00,35000.00,15624.21,0.00,0.03,0
40290,4172,-1000.00,33000.00,34000.00,23943.70,11056.30,0.09,0
40291,4172,-1000.00,32000.00,33000.00,0.00,28816.29,0.39,0
40292,4172,-1000.00,31000.00,32000.00,15581.46,17418.54,0.18,0
40293,4172,-1000.00,30000.00,31000.00,4594.78,27405.22,0.39,0
40294,4172,-1000.00,29000.00,30000.00,6111.78,23578.20,0.39,0
40295,4172,-1000.00,28000.00,29000.00,9390.70,20609.30,0.32,0
40296,4172,-1000.00,27000.00,28000.00,0.00,28749.85,0.44,0
40297,4172,-1000.00,26000.00,27000.00,0.00,28000.00,0.36,0
40298,4172,-1000.00,25000.00,26000.00,9880.48,17119.52,0.27,0
40299,4172,-1000.00,24000.00,25000.00,0.00,14680.29,0.34,0
40300,4172,-1000.00,23000.00,24000.00,4294.42,20705.58,0.41,0
40301,4172,-1000.00,22000.00,23000.00,0.00,17343.02,0.39,0
40302,4172,-1000.00,21000.00,22000.00,5882.35,17117.65,0.34,0
40303,4172,-1000.00,20000.00,21000.00,5378.57,15109.06,0.36,0
40304,4172,-1000.00,19000.00,20000.00,847.14,15173.44,0.40,0
40305,4172,-1000.00,18000.00,19000.00,9364.39,10635.61,0.15,0
40306,4172,-1000.00,17000.00,18000.00,0.00,13808.54,0.34,0
40307,4172,-1000.00,16000.00,17000.00,7518.27,10481.73,0.26,0
40308,4172,-1000.00,15000.00,16000.00,0.00,7669.62,0.25,0
40309,4172,-1000.00,14000.00,15000.00,0.00,16000.00,0.05,0
40310,4172,-1000.00,13000.00,14000.00,539.52,8790.98,0.35,0
40311,4173,-1000.00,-1000.00,0.00,453.44,546.56,0.24,0
40312,4174,1000.00,1000.00,2000.00,0.00,1000.00,0.41,1
40313,4174,1000.00,2000.00,3000.00,684.25,1315.75,0.14,1
40314,4174,-1000.00,1000.00,2000.00,1609.89,1390.11,0.01,0
40315,4174,1000.00,2000.00,3000.00,0.00,2000.00,0.39,1
40316,4174,1000.00,3000.00,4000.00,27.11,996.35,0.24,1
40317,4174,1000.00,4000.00,5000.00,0.00,2107.31,0.27,1
40318,4174,1000.00,5000.00,6000.00,0.00,18.61,0.05,1
40319,4174,1000.00,6000.00,7000.00,1782.56,2355.54,0.23,1
40320,4174,1000.00,7000.00,8000.00,0.00,7000.00,0.17,1
40321,4174,1000.00,8000.00,9000.00,0.00,6537.73,0.38,1
40322,4174,-819.45,7180.55,8180.55,819.45,0.00,0.05,0
40323,4174,1000.00,8180.55,9180.55,0.00,2989.44,0.18,1
40324,4174,1000.00,9180.55,10180.55,3939.47,5241.08,0.26,1
40325,4174,1000.00,10180.55,11180.55,0.00,10180.55,0.11,1
40326,4174,1000.00,11180.55,12180.55,0.00,11180.55,0.15,1
40327,4174,1000.00,12180.55,13180.55,0.00,12180.55,0.23,1
40328,4174,1000.00,13180.55,14180.55,1263.78,11916.77,0.14,1
40329,4174,-1000.00,12180.55,13180.55,8411.17,5769.37,0.16,0
40330,4174,1000.00,13180.55,14180.55,0.00,13180.55,0.18,1
40331,4174,1000.00,14180.55,15180.55,2369.24,11811.31,0.15,1
40332,4174,1000.00,15180.55,16180.55,7280.82,7899.72,0.11,1
40333,4174,1000.00,16180.55,17180.55,0.00,16180.55,0.24,1
40334,4174,1000.00,17180.55,18180.55,0.00,17180.55,0.30,1
40335,4174,1000.00,18180.55,19180.55,7838.30,10342.25,0.18,1
40336,4174,-1000.00,17180.55,18180.55,13651.65,5528.90,0.09,0
40337,4174,-1000.00,16180.55,17180.55,5939.90,12240.65,0.30,0
40338,4174,-1000.00,15180.55,16180.55,0.00,4112.38,0.11,0
40339,4174,-1000.00,14180.55,15180.55,0.00,12850.37,0.35,0
40340,4174,-1000.00,13180.55,14180.55,7444.59,7735.96,0.10,0
40341,4174,-1000.00,12180.55,13180.55,2796.40,4535.62,0.22,0
40342,4174,-1000.00,11180.55,12180.55,0.00,13180.55,0.18,0
40343,4174,-1000.00,10180.55,11180.55,965.65,11214.90,0.04,0
40344,4174,-1000.00,9180.55,10180.55,0.00,11180.55,0.33,0
40345,4174,-1000.00,8180.55,9180.55,4782.83,5397.71,0.09,0
40346,4174,-1000.00,7180.55,8180.55,4496.61,4683.94,0.12,0
40347,4174,-1000.00,6180.55,7180.55,0.00,6209.99,0.32,0
40348,4174,-1000.00,5180.55,6180.55,2475.41,4705.14,0.33,0
40349,4174,-1000.00,4180.55,5180.55,1385.67,4373.21,0.37,0
40350,4174,-1000.00,3180.55,4180.55,1870.25,3310.30,0.31,0
40351,4174,-1000.00,2180.55,3180.55,892.19,3288.36,0.40,0
40352,4174,-1000.00,1180.55,2180.55,1256.07,1924.48,0.19,0
40353,4174,-1000.00,180.55,1180.55,0.00,2180.55,0.00,0
40354,4174,-1000.00,-819.45,180.55,188.61,991.94,0.41,0
40355,4174,-180.04,-999.50,0.50,0.00,180.04,0.44,0
40356,4174,-0.26,-999.76,0.24,0.05,0.22,0.28,0
40357,4174,-0.17,-999.93,0.07,0.02,0.16,0.37,0
40358,4174,-0.01,-999.94,0.06,0.00,0.01,0.12,0
40359,4174,-0.06,-1000.00,0.00,0.00,0.06,0.33,0
40360,4175,0.00,0.00,1000.00,0.00,0.00,0.18,0
40361,4175,1000.00,1000.00,2000.00,645.92,0.00,0.07,1
40362,4175,0.00,1000.00,2000.00,0.00,0.00,0.18,0
40363,4175,-1000.00,0.00,1000.00,0.00,2000.00,0.09,0
40364,4175,-694.29,-694.29,305.71,0.00,694.29,0.44,0
40365,4175,-83.43,-777.72,222.28,0.00,83.43,0.38,0
40366,4175,-185.00,-962.72,37.28,0.00,185.00,0.32,0
40367,4175,-37.28,-1000.00,0.00,14.28,23.00,0.25,0
40368,4176,1000.00,1000.00,2000.00,208.29,791.71,0.40,1
40369,4176,1000.00,2000.00,3000.00,0.00,1829.22,0.41,1
40370,4176,1000.00,3000.00,4000.00,0.00,2155.34,0.40,1
40371,4176,1000.00,4000.00,5000.00,1393.09,2606.91,0.28,1
40372,4176,1000.00,5000.00,6000.00,2076.18,2923.82,0.28,1
40373,4176,1000.00,6000.00,7000.00,0.00,5645.37,0.01,1
40374,4176,1000.00,7000.00,8000.00,0.00,7000.00,0.36,1
40375,4176,0.00,7000.00,8000.00,0.00,0.00,0.08,0
40376,4176,1000.00,8000.00,9000.00,0.00,536.95,0.01,1
40377,4176,0.00,8000.00,9000.00,0.00,0.00,0.06,0
40378,4176,1000.00,9000.00,10000.00,0.00,8161.11,0.34,1
40379,4176,1000.00,10000.00,11000.00,4310.58,5689.42,0.13,1
40380,4176,1000.00,11000.00,12000.00,2169.33,8830.67,0.29,1
40381,4176,-1000.00,10000.00,11000.00,9285.49,0.00,0.02,0
40382,4176,1000.00,11000.00,12000.00,0.00,10516.83,0.42,1
40383,4176,1000.00,12000.00,13000.00,0.00,11632.80,0.31,1
40384,4176,-1000.00,11000.00,12000.00,8766.89,4233.11,0.00,0
40385,4176,1000.00,12000.00,13000.00,0.00,12000.00,0.39,1
40386,4176,1000.00,13000.00,14000.00,3440.29,9559.71,0.34,1
40387,4176,1000.00,14000.00,15000.00,5771.43,8228.57,0.34,1
40388,4176,1000.00,15000.00,16000.00,0.00,15000.00,0.13,1
40389,4176,1000.00,16000.00,17000.00,8000.00,8000.00,0.34,1
40390,4176,1000.00,17000.00,18000.00,0.00,17000.00,0.13,1
40391,4176,1000.00,18000.00,19000.00,0.00,18000.00,0.30,1
40392,4176,1000.00,19000.00,20000.00,951.11,9106.56,0.30,1
40393,4176,1000.00,20000.00,21000.00,8360.51,11639.49,0.20,1
40394,4176,-1000.00,19000.00,20000.00,0.00,21000.00,0.32,0
40395,4176,-1000.00,18000.00,19000.00,0.00,9713.61,0.32,0
40396,4176,-1000.00,17000.00,18000.00,8663.16,0.00,0.30,0
40397,4176,-1000.00,16000.00,17000.00,5054.36,6089.90,0.34,0
40398,4176,-1000.00,15000.00,16000.00,0.00,6897.49,0.35,0
40399,4176,-1000.00,14000.00,15000.00,2471.60,1806.31,0.42,0
40400,4176,-1000.00,13000.00,14000.00,2392.55,12607.45,0.15,0
40401,4176,-1000.00,12000.00,13000.00,7000.00,7000.00,0.09,0
40402,4176,-1000.00,11000.00,12000.00,2259.44,7998.78,0.40,0
40403,4176,-1000.00,10000.00,11000.00,0.00,3139.38,0.02,0
40404,4176,-1000.00,9000.00,10000.00,953.48,10046.52,0.39,0
40405,4176,-1000.00,8000.00,9000.00,0.00,5689.64,0.37,0
40406,4176,-1000.00,7000.00,8000.00,0.00,9000.00,0.02,0
40407,4176,-1000.00,6000.00,7000.00,0.00,5578.02,0.11,0
40408,4176,-1000.00,5000.00,6000.00,0.00,7000.00,0.04,0
40409,4176,-1000.00,4000.00,5000.00,0.00,5683.46,0.40,0
40410,4176,-1000.00,3000.00,4000.00,439.70,2907.34,0.42,0
40411,4176,-1000.00,2000.00,3000.00,2128.81,1871.19,0.09,0
40412,4176,-1000.00,1000.00,2000.00,0.00,1231.14,0.19,0
40413,4177,-1000.00,-1000.00,0.00,520.50,479.50,0.11,0
40414,4178,-1000.00,-1000.00,0.00,0.00,973.42,0.01,0
40415,4179,-90.95,-90.95,909.05,0.00,90.95,0.12,0
40416,4179,-909.05,-1000.00,0.00,80.91,828.14,0.33,0
40417,4180,-80.27,-80.27,919.73,0.00,80.27,0.12,0
40418,4180,-714.38,-794.65,205.35,0.00,714.38,0.09,0
40419,4180,-205.35,-1000.00,0.00,0.00,205.35,0.03,0
40420,4181,1000.00,1000.00,2000.00,531.90,110.98,0.30,1
40421,4181,-565.20,434.80,1434.80,64.93,500.27,0.41,0
40422,4181,-281.59,153.21,1153.21,0.00,281.59,0.41,0
40423,4181,1000.00,1153.21,2153.21,633.78,92.89,0.29,1
40424,4181,1000.00,2153.21,3153.21,1047.06,0.00,0.29,1
40425,4181,-1000.00,1153.21,2153.21,0.00,2338.45,0.41,0
40426,4181,-1000.00,153.21,1153.21,1076.61,1076.61,0.00,0
40427,4181,1000.00,1153.21,2153.21,468.87,0.00,0.03,1
40428,4181,-1000.00,153.21,1153.21,359.15,1794.07,0.22,0
40429,4181,-77.39,75.82,1075.82,0.00,77.39,0.06,0
40430,4181,-1000.00,-924.18,75.82,188.05,887.76,0.14,0
40431,4181,-75.82,-1000.00,0.00,0.00,75.82,0.38,0
40432,4182,-1000.00,-1000.00,0.00,0.00,7.55,0.30,0
40433,4183,0.00,0.00,1000.00,0.00,0.00,0.09,0
40434,4183,0.00,0.00,1000.00,0.00,0.00,0.31,0
40435,4183,0.00,0.00,1000.00,0.00,0.00,0.29,0
40436,4183,-775.18,-775.18,224.82,0.00,2.17,0.41,0
40437,4183,-1000.00,-1775.18,-775.18,2.13,222.69,0.32,0
40438,4184,0.00,0.00,1000.00,0.00,0.00,0.05,0
40439,4184,-616.14,-616.14,383.86,0.00,616.14,0.27,0
40440,4184,-383.86,-1000.00,0.00,167.43,216.42,0.20,0
40441,4185,1000.00,1000.00,2000.00,279.00,721.00,0.33,1
40442,4185,1000.00,2000.00,3000.00,453.03,1546.97,0.18,1
40443,4185,1000.00,3000.00,4000.00,0.00,3000.00,0.10,1
40444,4185,1000.00,4000.00,5000.00,0.00,2796.36,0.38,1
40445,4185,-1000.00,3000.00,4000.00,889.69,411.07,0.13,0
40446,4185,1000.00,4000.00,5000.00,0.00,4000.00,0.24,1
40447,4185,1000.00,5000.00,6000.00,1923.69,3076.31,0.06,1
40448,4185,1000.00,6000.00,7000.00,1664.21,4335.79,0.37,1
40449,4185,1000.00,7000.00,8000.00,1310.65,5689.35,0.40,1
40450,4185,-1000.00,6000.00,7000.00,6941.42,0.00,0.01,0
40451,4185,1000.00,7000.00,8000.00,0.00,7000.00,0.24,1
40452,4185,1000.00,8000.00,9000.00,0.00,6511.60,0.22,1
40453,4185,1000.00,9000.00,10000.00,2722.01,6277.99,0.32,1
40454,4185,1000.00,10000.00,11000.00,454.58,6832.49,0.38,1
40455,4185,-1000.00,9000.00,10000.00,5569.38,5430.62,0.08,0
40456,4185,1000.00,10000.00,11000.00,0.00,10000.00,0.21,1
40457,4185,1000.00,11000.00,12000.00,1964.08,7235.04,0.36,1
40458,4185,1000.00,12000.00,13000.00,0.00,12000.00,0.02,1
40459,4185,1000.00,13000.00,14000.00,0.00,11714.84,0.43,1
40460,4185,1000.00,14000.00,15000.00,1895.26,9061.77,0.36,1
40461,4185,1000.00,15000.00,16000.00,0.00,15000.00,0.33,1
40462,4185,1000.00,16000.00,17000.00,0.00,16000.00,0.38,1
40463,4185,1000.00,17000.00,18000.00,0.00,17000.00,0.40,1
40464,4185,1000.00,18000.00,19000.00,9000.00,9000.00,0.06,1
40465,4185,1000.00,19000.00,20000.00,0.00,19000.00,0.20,1
40466,4185,1000.00,20000.00,21000.00,0.00,1030.48,0.14,1
40467,4185,1000.00,21000.00,22000.00,8340.77,12659.23,0.18,1
40468,4185,1000.00,22000.00,23000.00,2017.16,19982.84,0.17,1
40469,4185,1000.00,23000.00,24000.00,1582.78,6790.78,0.22,1
40470,4185,1000.00,24000.00,25000.00,10517.49,13482.51,0.17,1
40471,4185,1000.00,25000.00,26000.00,0.00,25000.00,0.21,1
40472,4185,-1000.00,24000.00,25000.00,13758.29,8092.24,0.16,0
40473,4185,1000.00,25000.00,26000.00,0.00,25000.00,0.03,1
40474,4185,1000.00,26000.00,27000.00,8916.20,17083.80,0.14,1
40475,4185,-1000.00,25000.00,26000.00,16836.57,10163.43,0.06,0
40476,4185,1000.00,26000.00,27000.00,0.00,24076.71,0.37,1
40477,4185,1000.00,27000.00,28000.00,7475.08,19524.92,0.15,1
40478,4185,1000.00,28000.00,29000.00,3363.07,24636.93,0.39,1
40479,4185,1000.00,29000.00,30000.00,0.00,19355.82,0.09,1
40480,4185,-1000.00,28000.00,29000.00,17928.35,12071.65,0.14,0
40481,4185,1000.00,29000.00,30000.00,0.00,16189.12,0.27,1
40482,4185,1000.00,30000.00,31000.00,0.00,2786.35,0.05,1
40483,4185,1000.00,31000.00,32000.00,10321.34,20678.66,0.25,1
40484,4185,1000.00,32000.00,33000.00,0.00,32000.00,0.21,1
40485,4185,1000.00,33000.00,34000.00,0.00,33000.00,0.02,1
40486,4185,1000.00,34000.00,35000.00,0.00,34000.00,0.26,1
40487,4185,1000.00,35000.00,36000.00,0.00,12492.10,0.21,1
40488,4185,-1000.00,34000.00,35000.00,32231.00,3769.00,0.09,0
40489,4185,-1000.00,33000.00,34000.00,17500.00,17500.00,0.08,0
40490,4185,-1000.00,32000.00,33000.00,16098.24,17901.76,0.14,0
40491,4185,-1000.00,31000.00,32000.00,0.00,18921.97,0.20,0
40492,4185,-1000.00,30000.00,31000.00,0.00,5173.50,0.15,0
40493,4185,-1000.00,29000.00,30000.00,15500.00,15500.00,0.00,0
40494,4185,-1000.00,28000.00,29000.00,0.00,23176.92,0.16,0
40495,4185,-1000.00,27000.00,28000.00,0.00,6626.79,0.16,0
40496,4185,-1000.00,26000.00,27000.00,8096.75,13493.79,0.27,0
40497,4185,-1000.00,25000.00,26000.00,16458.69,1015.14,0.07,0
40498,4185,-1000.00,24000.00,25000.00,3059.30,22940.70,0.43,0
40499,4185,-1000.00,23000.00,24000.00,0.00,25000.00,0.40,0
40500,4185,-1000.00,22000.00,23000.00,7542.30,16457.70,0.35,0
40501,4185,-1000.00,21000.00,22000.00,8446.77,14553.23,0.01,0
40502,4185,-1000.00,20000.00,21000.00,0.00,22000.00,0.15,0
40503,4185,-1000.00,19000.00,20000.00,0.00,21000.00,0.09,0
40504,4185,0.00,19000.00,20000.00,0.00,0.00,0.10,0
40505,4185,-1000.00,18000.00,19000.00,0.00,20000.00,0.09,0
40506,4185,-1000.00,17000.00,18000.00,5793.49,13206.51,0.35,0
40507,4185,-1000.00,16000.00,17000.00,2661.11,15338.89,0.42,0
40508,4185,-1000.00,15000.00,16000.00,2909.19,14090.81,0.34,0
40509,4185,-1000.00,14000.00,15000.00,6897.30,9102.70,0.33,0
40510,4185,-1000.00,13000.00,14000.00,0.00,12676.42,0.36,0
40511,4186,1000.00,1000.00,2000.00,0.00,145.05,0.06,1
40512,4186,1000.00,2000.00,3000.00,787.72,1212.28,0.21,1
40513,4186,1000.00,3000.00,4000.00,219.90,2780.10,0.28,1
40514,4186,-58.58,2941.42,3941.42,58.58,0.00,0.10,0
40515,4186,1000.00,3941.42,4941.42,1318.55,2622.87,0.10,1
40516,4186,1000.00,4941.42,5941.42,127.14,2911.11,0.35,1
40517,4186,1000.00,5941.42,6941.42,0.00,5941.42,0.37,1
40518,4186,1000.00,6941.42,7941.42,1800.37,5141.06,0.37,1
40519,4186,1000.00,7941.42,8941.42,0.00,5047.90,0.24,1
40520,4186,-1000.00,6941.42,7941.42,4579.56,4361.86,0.20,0
40521,4186,1000.00,7941.42,8941.42,0.00,7941.42,0.33,1
40522,4186,1000.00,8941.42,9941.42,439.19,5635.35,0.37,1
40523,4186,1000.00,9941.42,10941.42,2252.43,7688.99,0.38,1
40524,4186,1000.00,10941.42,11941.42,0.00,1232.02,0.13,1
40525,4186,1000.00,11941.42,12941.42,0.00,11083.62,0.36,1
40526,4186,1000.00,12941.42,13941.42,4280.16,8661.26,0.34,1
40527,4186,1000.00,13941.42,14941.42,4317.11,9624.31,0.35,1
40528,4186,1000.00,14941.42,15941.42,0.00,11676.58,0.39,1
40529,4186,1000.00,15941.42,16941.42,0.00,15941.42,0.31,1
40530,4186,1000.00,16941.42,17941.42,7283.01,9658.41,0.20,1
40531,4186,1000.00,17941.42,18941.42,4375.46,6302.91,0.23,1
40532,4186,-1000.00,16941.42,17941.42,9754.99,9186.43,0.34,0
40533,4186,1000.00,17941.42,18941.42,7468.28,10473.15,0.22,1
40534,4186,-1000.00,16941.42,17941.42,10177.55,8763.87,0.43,0
40535,4186,1000.00,17941.42,18941.42,3443.31,14498.12,0.34,1
40536,4186,1000.00,18941.42,19941.42,0.00,18941.42,0.03,1
40537,4186,1000.00,19941.42,20941.42,0.00,19941.42,0.04,1
40538,4186,1000.00,20941.42,21941.42,5707.68,15233.74,0.36,1
40539,4186,1000.00,21941.42,22941.42,0.00,19856.95,0.34,1
40540,4186,1000.00,22941.42,23941.42,5520.23,10815.63,0.28,1
40541,4186,1000.00,23941.42,24941.42,0.00,23941.42,0.24,1
40542,4186,1000.00,24941.42,25941.42,0.00,24941.42,0.08,1
40543,4186,1000.00,25941.42,26941.42,11598.14,14343.29,0.14,1
40544,4186,1000.00,26941.42,27941.42,11341.99,15599.43,0.42,1
40545,4186,1000.00,27941.42,28941.42,0.00,27781.86,0.44,1
40546,4186,1000.00,28941.42,29941.42,0.00,28941.42,0.06,1
40547,4186,1000.00,29941.42,30941.42,1472.33,23088.81,0.44,1
40548,4186,1000.00,30941.42,31941.42,2652.19,25878.05,0.42,1
40549,4186,1000.00,31941.42,32941.42,15970.71,15970.71,0.00,1
40550,4186,1000.00,32941.42,33941.42,4895.29,15459.27,0.29,1
40551,4187,1000.00,1000.00,2000.00,366.20,633.80,0.28,1
40552,4187,1000.00,2000.00,3000.00,635.64,1364.36,0.38,1
40553,4187,1000.00,3000.00,4000.00,0.00,3000.00,0.02,1
40554,4187,1000.00,4000.00,5000.00,0.00,4000.00,0.03,1
40555,4187,1000.00,5000.00,6000.00,0.00,5000.00,0.17,1
40556,4187,1000.00,6000.00,7000.00,0.00,6000.00,0.30,1
40557,4187,1000.00,7000.00,8000.00,0.00,7000.00,0.29,1
40558,4187,-1000.00,6000.00,7000.00,6803.99,0.00,0.01,0
40559,4187,1000.00,7000.00,8000.00,1476.54,5523.46,0.40,1
40560,4187,-1000.00,6000.00,7000.00,4286.31,3713.69,0.20,0
40561,4187,1000.00,7000.00,8000.00,0.00,4562.91,0.36,1
40562,4187,1000.00,8000.00,9000.00,2387.30,2925.40,0.23,1
40563,4187,1000.00,9000.00,10000.00,0.00,9000.00,0.31,1
40564,4187,-1000.00,8000.00,9000.00,7351.66,2648.34,0.14,0
40565,4187,1000.00,9000.00,10000.00,3281.73,5718.27,0.12,1
40566,4187,1000.00,10000.00,11000.00,0.00,4023.33,0.21,1
40567,4187,1000.00,11000.00,12000.00,0.00,11000.00,0.09,1
40568,4187,-1000.00,10000.00,11000.00,7475.08,4524.92,0.03,0
40569,4187,1000.00,11000.00,12000.00,0.00,11000.00,0.27,1
40570,4187,1000.00,12000.00,13000.00,0.00,11106.32,0.18,1
40571,4187,1000.00,13000.00,14000.00,0.00,13000.00,0.15,1
40572,4187,1000.00,14000.00,15000.00,5270.86,8729.14,0.06,1
40573,4187,1000.00,15000.00,16000.00,0.00,8519.39,0.34,1
40574,4187,1000.00,16000.00,17000.00,0.00,11852.82,0.37,1
40575,4187,1000.00,17000.00,18000.00,132.72,10320.57,0.36,1
40576,4187,1000.00,18000.00,19000.00,0.00,18000.00,0.08,1
40577,4187,1000.00,19000.00,20000.00,8686.01,10313.99,0.22,1
40578,4187,1000.00,20000.00,21000.00,4746.34,14220.54,0.36,1
40579,4187,1000.00,21000.00,22000.00,0.00,21000.00,0.25,1
40580,4187,1000.00,22000.00,23000.00,0.00,22000.00,0.29,1
40581,4187,0.00,22000.00,23000.00,0.00,0.00,0.06,0
40582,4187,1000.00,23000.00,24000.00,9353.68,13646.32,0.24,1
40583,4187,1000.00,24000.00,25000.00,0.00,11478.05,0.12,1
40584,4187,1000.00,25000.00,26000.00,0.00,25000.00,0.05,1
40585,4187,0.00,25000.00,26000.00,0.00,0.00,0.09,0
40586,4187,1000.00,26000.00,27000.00,3280.86,22719.14,0.42,1
40587,4187,1000.00,27000.00,28000.00,0.00,19252.92,0.37,1
40588,4187,1000.00,28000.00,29000.00,0.00,11182.33,0.21,1
40589,4187,1000.00,29000.00,30000.00,0.00,29000.00,0.07,1
40590,4187,1000.00,30000.00,31000.00,0.00,22138.68,0.14,1
40591,4187,-1000.00,29000.00,30000.00,16437.81,14562.19,0.03,0
40592,4187,1000.00,30000.00,31000.00,0.00,30000.00,0.34,1
40593,4187,1000.00,31000.00,32000.00,1864.99,29135.01,0.03,1
40594,4187,1000.00,32000.00,33000.00,0.00,518.90,0.09,1
40595,4187,1000.00,33000.00,34000.00,10243.85,22756.15,0.30,1
40596,4187,1000.00,34000.00,35000.00,5255.57,28360.82,0.43,1
40597,4187,-1000.00,33000.00,34000.00,20671.43,14328.57,0.20,0
40598,4187,-1000.00,32000.00,33000.00,17114.55,16885.45,0.38,0
40599,4187,-1000.00,31000.00,32000.00,16739.38,16260.62,0.07,0
40600,4187,-1000.00,30000.00,31000.00,0.00,13814.67,0.26,0
40601,4187,-1000.00,29000.00,30000.00,0.00,31000.00,0.05,0
40602,4187,-1000.00,28000.00,29000.00,0.00,30000.00,0.36,0
40603,4187,-1000.00,27000.00,28000.00,5108.51,23891.49,0.17,0
40604,4187,-1000.00,26000.00,27000.00,13600.63,14399.37,0.08,0
40605,4187,-1000.00,25000.00,26000.00,0.00,27000.00,0.26,0
40606,4187,-1000.00,24000.00,25000.00,9739.24,16260.76,0.31,0
40607,4187,-327.73,23672.27,24672.27,0.00,327.73,0.06,0
40608,4187,-1000.00,22672.27,23672.27,7368.95,13474.19,0.29,0
40609,4187,-1000.00,21672.27,22672.27,4951.90,18720.36,0.40,0
40610,4187,-1000.00,20672.27,21672.27,15537.28,6685.42,0.12,0
40611,4187,-1000.00,19672.27,20672.27,0.00,21672.27,0.02,0
40612,4187,-1000.00,18672.27,19672.27,178.52,0.00,0.15,0
40613,4187,-1000.00,17672.27,18672.27,4368.15,15304.12,0.44,0
40614,4187,0.00,17672.27,18672.27,0.00,0.00,0.03,0
40615,4187,-1000.00,16672.27,17672.27,9336.13,9336.13,0.08,0
40616,4187,-1000.00,15672.27,16672.27,2152.77,7555.28,0.34,0
40617,4187,-1000.00,14672.27,15672.27,0.00,16672.27,0.38,0
40618,4187,-1000.00,13672.27,14672.27,4871.80,10800.46,0.28,0
40619,4187,-1000.00,12672.27,13672.27,7921.54,6750.73,0.01,0
40620,4187,-1000.00,11672.27,12672.27,0.00,13672.27,0.22,0
40621,4187,-1000.00,10672.27,11672.27,1506.74,0.00,0.01,0
40622,4187,-1000.00,9672.27,10672.27,4560.73,7111.53,0.10,0
40623,4187,-1000.00,8672.27,9672.27,4052.29,6619.98,0.23,0
40624,4187,-1000.00,7672.27,8672.27,0.00,9672.27,0.13,0
40625,4187,-1000.00,6672.27,7672.27,3835.92,4836.35,0.16,0
40626,4187,-1000.00,5672.27,6672.27,0.00,5392.75,0.14,0
40627,4187,-1000.00,4672.27,5672.27,1908.32,1914.40,0.19,0
40628,4187,-1000.00,3672.27,4672.27,0.00,2683.89,0.29,0
40629,4187,-1000.00,2672.27,3672.27,2380.99,2291.28,0.17,0
40630,4187,-1000.00,1672.27,2672.27,1836.13,1836.13,0.04,0
40631,4187,-1000.00,672.27,1672.27,0.00,1636.01,0.34,0
40632,4187,-1000.00,-327.73,672.27,708.55,963.72,0.11,0
40633,4187,-672.27,-1000.00,0.00,0.00,672.27,0.38,0
40634,4188,1000.00,1000.00,2000.00,547.45,452.55,0.23,1
40635,4188,0.00,1000.00,2000.00,0.00,0.00,0.08,0
40636,4188,-1000.00,0.00,1000.00,0.00,2000.00,0.25,0
40637,4188,1000.00,1000.00,2000.00,554.50,445.50,0.15,1
40638,4188,-1000.00,0.00,1000.00,538.31,1461.69,0.35,0
40639,4188,-1000.00,-1000.00,0.00,399.49,600.51,0.05,0
40640,4189,1000.00,1000.00,2000.00,566.60,433.40,0.16,1
40641,4189,-1000.00,0.00,1000.00,902.01,1097.99,0.24,0
40642,4189,0.00,0.00,1000.00,0.00,0.00,0.24,0
40643,4189,-126.56,-126.56,873.44,0.00,126.56,0.30,0
40644,4189,-873.44,-1000.00,0.00,46.05,827.40,0.10,0
40645,4190,1000.00,1000.00,2000.00,307.05,692.95,0.17,1
40646,4190,1000.00,2000.00,3000.00,0.00,1738.65,0.18,1
40647,4190,1000.00,3000.00,4000.00,1500.00,1500.00,0.04,1
40648,4190,1000.00,4000.00,5000.00,0.00,1886.47,0.17,1
40649,4190,1000.00,5000.00,6000.00,2127.51,2872.49,0.16,1
40650,4190,-1000.00,4000.00,5000.00,3633.23,2366.77,0.02,0
40651,4190,1000.00,5000.00,6000.00,1804.08,3195.92,0.12,1
40652,4190,1000.00,6000.00,7000.00,2599.83,3400.17,0.23,1
40653,4190,1000.00,7000.00,8000.00,0.00,4791.12,0.07,1
40654,4190,1000.00,8000.00,9000.00,0.00,8000.00,0.37,1
40655,4190,-1000.00,7000.00,8000.00,9000.00,0.00,0.01,0
40656,4190,1000.00,8000.00,9000.00,998.47,7001.53,0.41,1
40657,4190,1000.00,9000.00,10000.00,2728.59,6271.41,0.35,1
40658,4190,1000.00,10000.00,11000.00,0.00,10000.00,0.06,1
40659,4190,1000.00,11000.00,12000.00,0.00,5893.57,0.26,1
40660,4190,1000.00,12000.00,13000.00,0.00,12000.00,0.11,1
40661,4190,1000.00,13000.00,14000.00,0.00,6327.08,0.18,1
40662,4190,1000.00,14000.00,15000.00,0.00,5579.34,0.27,1
40663,4190,1000.00,15000.00,16000.00,5558.51,9441.49,0.29,1
40664,4190,-1000.00,14000.00,15000.00,10533.25,5466.75,0.02,0
40665,4190,1000.00,15000.00,16000.00,4327.52,10672.48,0.05,1
40666,4190,1000.00,16000.00,17000.00,720.38,10446.73,0.37,1
40667,4190,-1000.00,15000.00,16000.00,0.00,17000.00,0.02,0
40668,4190,-1000.00,14000.00,15000.00,2425.15,13574.85,0.42,0
40669,4190,-1000.00,13000.00,14000.00,0.00,15000.00,0.06,0
40670,4190,-1000.00,12000.00,13000.00,0.00,14000.00,0.20,0
40671,4190,-1000.00,11000.00,12000.00,8801.83,0.00,0.03,0
40672,4190,-1000.00,10000.00,11000.00,1580.96,10419.04,0.40,0
40673,4190,-1000.00,9000.00,10000.00,4959.08,673.31,0.10,0
40674,4190,-1000.00,8000.00,9000.00,5000.00,5000.00,0.04,0
40675,4190,-1000.00,7000.00,8000.00,1916.64,7083.36,0.27,0
40676,4190,-1000.00,6000.00,7000.00,0.00,4767.51,0.09,0
40677,4190,-1000.00,5000.00,6000.00,0.00,4923.22,0.15,0
40678,4190,-1000.00,4000.00,5000.00,0.00,6000.00,0.27,0
40679,4190,-1000.00,3000.00,4000.00,2170.28,2829.72,0.12,0
40680,4190,-1000.00,2000.00,3000.00,95.06,3425.70,0.43,0
40681,4190,-1000.00,1000.00,2000.00,1138.68,1861.32,0.14,0
40682,4190,-1000.00,0.00,1000.00,117.45,86.83,0.12,0
40683,4190,-1000.00,-1000.00,0.00,335.00,665.00,0.09,0
40684,4191,-1000.00,-1000.00,0.00,383.91,616.09,0.22,0
40685,4192,-840.48,-840.48,159.52,0.00,840.48,0.25,0
40686,4192,-159.52,-1000.00,0.00,0.00,159.52,0.14,0
40687,4193,-1000.00,-1000.00,0.00,0.00,1000.00,0.31,0
40688,4194,-1000.00,-1000.00,0.00,423.57,576.43,0.16,0
40689,4195,-941.12,-941.12,58.88,0.00,941.12,0.43,0
40690,4195,-51.33,-992.46,7.54,0.00,51.33,0.11,0
40691,4195,-6.88,-999.33,0.67,2.40,4.48,0.31,0
40692,4195,-0.67,-1000.00,0.00,0.18,0.48,0.36,0
40693,4196,0.00,0.00,1000.00,0.00,0.00,0.01,0
40694,4196,-951.27,-951.27,48.73,109.20,842.08,0.42,0
40695,4196,-48.73,-1000.00,0.00,0.00,48.73,0.14,0
40696,4197,-1000.00,-1000.00,0.00,0.00,1000.00,0.14,0
40697,4198,-894.17,-894.17,105.83,0.00,894.17,0.11,0
40698,4198,0.00,-894.17,105.83,0.00,0.00,0.18,0
40699,4198,0.00,-894.17,105.83,0.00,0.00,0.03,0
40700,4198,-105.83,-1000.00,0.00,0.00,105.83,0.07,0
40701,4199,-1000.00,-1000.00,0.00,691.54,308.46,0.08,0
40702,4200,-1000.00,-1000.00,0.00,63.31,936.69,0.39,0
40703,4201,-944.18,-944.18,55.82,0.00,944.18,0.17,0
40704,4201,-55.82,-1000.00,0.00,22.80,33.02,0.15,0
40705,4202,0.00,0.00,1000.00,0.00,0.00,0.39,0
40706,4202,-566.23,-566.23,433.77,566.23,0.00,0.27,0
40707,4202,1000.00,433.77,1433.77,180.79,252.98,0.27,1
40708,4202,0.00,433.77,1433.77,0.00,0.00,0.06,0
40709,4202,1000.00,1433.77,2433.77,461.59,972.18,0.12,1
40710,4202,1000.00,2433.77,3433.77,837.51,1596.26,0.24,1
40711,4202,1000.00,3433.77,4433.77,0.00,1751.65,0.28,1
40712,4202,1000.00,4433.77,5433.77,0.00,1886.00,0.42,1
40713,4202,1000.00,5433.77,6433.77,0.00,981.14,0.32,1
40714,4202,-1000.00,4433.77,5433.77,4883.69,0.00,0.06,0
40715,4202,-1000.00,3433.77,4433.77,1605.91,0.00,0.36,0
40716,4202,-1000.00,2433.77,3433.77,1030.04,0.00,0.39,0
40717,4202,1000.00,3433.77,4433.77,0.00,3253.80,0.14,1
40718,4202,-1000.00,2433.77,3433.77,3001.52,1316.01,0.22,0
40719,4202,-1000.00,1433.77,2433.77,1220.05,816.25,0.34,0
40720,4202,1000.00,2433.77,3433.77,0.00,657.56,0.40,1
40721,4202,-150.63,2283.14,3283.14,143.69,6.94,0.38,0
40722,4202,1000.00,3283.14,4283.14,1641.57,1641.57,0.37,1
40723,4202,1000.00,4283.14,5283.14,0.00,3086.19,0.04,1
40724,4202,1000.00,5283.14,6283.14,0.00,5283.14,0.27,1
40725,4202,1000.00,6283.14,7283.14,0.00,6283.14,0.22,1
40726,4202,1000.00,7283.14,8283.14,0.00,7283.14,0.24,1
40727,4202,1000.00,8283.14,9283.14,0.00,8283.14,0.02,1
40728,4202,1000.00,9283.14,10283.14,3619.45,5663.69,0.10,1
40729,4202,-1000.00,8283.14,9283.14,8508.61,440.00,0.12,0
40730,4202,1000.00,9283.14,10283.14,730.07,7454.63,0.42,1
40731,4202,1000.00,10283.14,11283.14,0.00,10283.14,0.07,1
40732,4202,1000.00,11283.14,12283.14,426.67,10856.47,0.30,1
40733,4202,1000.00,12283.14,13283.14,0.00,12283.14,0.27,1
40734,4202,1000.00,13283.14,14283.14,1630.82,11652.32,0.34,1
40735,4202,1000.00,14283.14,15283.14,0.00,3058.77,0.12,1
40736,4202,-1000.00,13283.14,14283.14,10944.58,4338.56,0.08,0
40737,4202,1000.00,14283.14,15283.14,5167.84,9115.30,0.00,1
40738,4202,1000.00,15283.14,16283.14,7527.94,7755.20,0.13,1
40739,4202,1000.00,16283.14,17283.14,0.00,16283.14,0.23,1
40740,4202,1000.00,17283.14,18283.14,5437.13,7187.66,0.24,1
40741,4202,1000.00,18283.14,19283.14,0.00,18283.14,0.09,1
40742,4202,1000.00,19283.14,20283.14,0.00,19283.14,0.00,1
40743,4202,1000.00,20283.14,21283.14,0.00,20283.14,0.05,1
40744,4202,1000.00,21283.14,22283.14,7410.76,13872.39,0.22,1
40745,4202,-1000.00,20283.14,21283.14,18422.93,3860.21,0.18,0
40746,4202,1000.00,21283.14,22283.14,0.00,21283.14,0.43,1
40747,4202,1000.00,22283.14,23283.14,0.00,22283.14,0.08,1
40748,4203,-794.69,-794.69,205.31,0.00,794.69,0.44,0
40749,4203,-35.29,-829.97,170.03,0.00,35.29,0.25,0
40750,4203,-170.03,-1000.00,0.00,11.05,158.97,0.38,0
40751,4204,1000.00,1000.00,2000.00,196.56,321.57,0.22,1
40752,4204,1000.00,2000.00,3000.00,0.00,2000.00,0.16,1
40753,4204,0.00,2000.00,3000.00,0.00,0.00,0.03,0
40754,4204,1000.00,3000.00,4000.00,1426.86,1573.14,0.24,1
40755,4204,1000.00,4000.00,5000.00,0.00,4000.00,0.31,1
40756,4204,1000.00,5000.00,6000.00,1019.55,3980.45,0.41,1
40757,4204,1000.00,6000.00,7000.00,758.52,3477.43,0.34,1
40758,4204,1000.00,7000.00,8000.00,1205.53,5794.47,0.33,1
40759,4204,1000.00,8000.00,9000.00,1653.10,6346.90,0.40,1
40760,4204,1000.00,9000.00,10000.00,0.00,9000.00,0.07,1
40761,4204,1000.00,10000.00,11000.00,2381.00,7619.00,0.07,1
40762,4204,1000.00,11000.00,12000.00,407.12,8129.08,0.40,1
40763,4204,1000.00,12000.00,13000.00,0.00,12000.00,0.33,1
40764,4204,1000.00,13000.00,14000.00,4159.63,5534.56,0.26,1
40765,4204,1000.00,14000.00,15000.00,7000.00,7000.00,0.04,1
40766,4204,1000.00,15000.00,16000.00,7405.04,7594.96,0.23,1
40767,4204,1000.00,16000.00,17000.00,0.00,16000.00,0.43,1
40768,4204,1000.00,17000.00,18000.00,0.00,14813.40,0.05,1
40769,4204,1000.00,18000.00,19000.00,8048.50,9951.50,0.23,1
40770,4204,1000.00,19000.00,20000.00,162.48,12295.73,0.13,1
40771,4204,-1000.00,18000.00,19000.00,10973.38,9026.62,0.29,0
40772,4204,-1000.00,17000.00,18000.00,0.00,15062.86,0.19,0
40773,4204,-1000.00,16000.00,17000.00,8544.57,9455.43,0.13,0
40774,4204,-1000.00,15000.00,16000.00,0.00,17000.00,0.28,0
40775,4204,-1000.00,14000.00,15000.00,0.00,15586.73,0.29,0
40776,4204,-1000.00,13000.00,14000.00,9278.59,4985.75,0.14,0
40777,4204,-1000.00,12000.00,13000.00,0.00,14000.00,0.42,0
40778,4204,-1000.00,11000.00,12000.00,0.00,13000.00,0.20,0
40779,4204,-1000.00,10000.00,11000.00,0.00,12000.00,0.16,0
40780,4204,-1000.00,9000.00,10000.00,0.00,11000.00,0.03,0
40781,4204,-1000.00,8000.00,9000.00,0.00,5921.37,0.23,0
40782,4204,-1000.00,7000.00,8000.00,0.00,5287.12,0.33,0
40783,4204,-1000.00,6000.00,7000.00,0.00,8000.00,0.19,0
40784,4204,-1000.00,5000.00,6000.00,0.00,4601.36,0.37,0
40785,4204,-1000.00,4000.00,5000.00,2240.60,3759.40,0.30,0
40786,4204,-1000.00,3000.00,4000.00,1746.75,0.00,0.08,0
40787,4204,-1000.00,2000.00,3000.00,0.00,3582.40,0.42,0
40788,4204,-1000.00,1000.00,2000.00,0.00,2150.73,0.22,0
40789,4204,1000.00,2000.00,3000.00,1000.00,1000.00,0.08,1
40790,4204,1000.00,3000.00,4000.00,838.79,2161.21,0.38,1
40791,4204,1000.00,4000.00,5000.00,0.00,4000.00,0.11,1
40792,4204,1000.00,5000.00,6000.00,0.00,3361.21,0.31,1
40793,4204,1000.00,6000.00,7000.00,2101.49,3898.51,0.23,1
40794,4204,1000.00,7000.00,8000.00,2184.02,4815.98,0.30,1
40795,4204,1000.00,8000.00,9000.00,0.00,8000.00,0.03,1
40796,4204,-1000.00,7000.00,8000.00,749.26,8177.12,0.43,0
40797,4204,-1000.00,6000.00,7000.00,2137.37,5862.63,0.18,0
40798,4204,-1000.00,5000.00,6000.00,0.00,7000.00,0.18,0
40799,4204,-1000.00,4000.00,5000.00,0.00,6000.00,0.14,0
40800,4204,-1000.00,3000.00,4000.00,1304.77,3695.23,0.38,0
40801,4204,-1000.00,2000.00,3000.00,1970.97,2029.03,0.03,0
40802,4204,-1000.00,1000.00,2000.00,793.49,2206.51,0.37,0
40803,4204,-1000.00,0.00,1000.00,1000.00,1000.00,0.01,0
40804,4204,-1000.00,-1000.00,0.00,0.00,348.07,0.10,0
40805,4205,-1000.00,-1000.00,0.00,500.00,500.00,0.07,0
40806,4206,1000.00,1000.00,2000.00,38.72,679.85,0.38,1
40807,4206,1000.00,2000.00,3000.00,428.34,1184.44,0.33,1
40808,4206,1000.00,3000.00,4000.00,0.00,3000.00,0.19,1
40809,4206,1000.00,4000.00,5000.00,1441.20,2558.80,0.22,1
40810,4206,1000.00,5000.00,6000.00,1472.19,3527.81,0.36,1
40811,4206,-1000.00,4000.00,5000.00,3001.90,2998.10,0.12,0
40812,4206,1000.00,5000.00,6000.00,1206.22,3793.78,0.36,1
40813,4206,-1000.00,4000.00,5000.00,3247.80,2752.20,0.13,0
40814,4206,1000.00,5000.00,6000.00,2500.00,2500.00,0.01,1
40815,4206,1000.00,6000.00,7000.00,0.00,334.48,0.05,1
40816,4206,-1000.00,5000.00,6000.00,4558.30,2441.70,0.14,0
40817,4206,1000.00,6000.00,7000.00,3000.00,3000.00,0.26,1
40818,4206,1000.00,7000.00,8000.00,0.00,2543.88,0.03,1
40819,4206,1000.00,8000.00,9000.00,0.00,8000.00,0.26,1
40820,4206,1000.00,9000.00,10000.00,4217.07,4782.93,0.02,1
40821,4206,-1000.00,8000.00,9000.00,5795.58,4204.42,0.35,0
40822,4206,-1000.00,7000.00,8000.00,1295.07,7704.93,0.15,0
40823,4206,-1000.00,6000.00,7000.00,0.00,8000.00,0.42,0
40824,4206,-1000.00,5000.00,6000.00,0.00,3084.81,0.26,0
40825,4206,-1000.00,4000.00,5000.00,3000.00,3000.00,0.05,0
40826,4206,-1000.00,3000.00,4000.00,0.00,5000.00,0.18,0
40827,4206,-1000.00,2000.00,3000.00,0.00,4000.00,0.32,0
40828,4206,0.00,2000.00,3000.00,0.00,0.00,0.02,0
40829,4206,-1000.00,1000.00,2000.00,0.00,1198.24,0.05,0
40830,4206,-265.29,734.71,1734.71,0.00,265.29,0.10,0
40831,4206,-885.41,-150.70,849.30,0.00,885.41,0.28,0
40832,4206,-849.30,-1000.00,0.00,0.00,849.30,0.15,0
40833,4207,-1000.00,-1000.00,0.00,0.00,1000.00,0.26,0
40834,4208,-863.07,-863.07,136.93,0.00,863.07,0.43,0
40835,4208,-136.93,-1000.00,0.00,13.88,123.05,0.39,0
40836,4209,-1000.00,-1000.00,0.00,0.00,1000.00,0.12,0
40837,4210,-1000.00,-1000.00,0.00,646.56,353.44,0.13,0
40838,4211,0.00,0.00,1000.00,0.00,0.00,0.03,0
40839,4211,-379.36,-379.36,620.64,150.12,229.24,0.40,0
40840,4211,-376.23,-755.59,244.41,0.00,376.23,0.21,0
40841,4211,0.00,-755.59,244.41,0.00,0.00,0.42,0
40842,4211,0.00,-755.59,244.41,0.00,0.00,0.36,0
40843,4211,-209.47,-965.07,34.93,0.00,209.47,0.14,0
40844,4211,-12.86,-977.92,22.08,0.00,12.86,0.36,0
40845,4211,0.00,-977.92,22.08,0.00,0.00,0.28,0
40846,4211,-9.91,-987.83,12.17,0.00,9.91,0.32,0
40847,4211,1000.00,12.17,1012.17,12.17,0.00,0.05,1
40848,4211,-781.22,-769.05,230.95,0.00,781.22,0.18,0
40849,4211,-215.08,-984.13,15.87,0.00,215.08,0.05,0
40850,4211,-9.98,-994.11,5.89,0.00,9.98,0.15,0
40851,4211,18.33,-975.77,24.23,0.08,0.00,0.23,1
40852,4211,288.02,-687.75,312.25,1.20,0.00,0.22,1
40853,4211,1000.00,312.25,1312.25,102.70,45.14,0.38,1
40854,4211,0.00,312.25,1312.25,0.00,0.00,0.36,0
40855,4211,1000.00,1312.25,2312.25,55.57,0.00,0.42,1
40856,4211,1000.00,2312.25,3312.25,1806.09,0.00,0.18,1
40857,4211,0.00,2312.25,3312.25,0.00,0.00,0.28,0
40858,4211,1000.00,3312.25,4312.25,2572.05,740.19,0.00,1
40859,4211,-1000.00,2312.25,3312.25,0.00,1216.54,0.29,0
40860,4211,1000.00,3312.25,4312.25,1919.19,378.11,0.27,1
40861,4211,-1000.00,2312.25,3312.25,0.00,3398.42,0.00,0
40862,4211,-1000.00,1312.25,2312.25,0.00,3312.25,0.02,0
40863,4211,-1000.00,312.25,1312.25,496.31,741.74,0.36,0
40864,4211,1000.00,1312.25,2312.25,1266.34,45.91,0.03,1
40865,4211,1000.00,2312.25,3312.25,1780.36,531.88,0.10,1
40866,4211,-1000.00,1312.25,2312.25,0.00,2635.99,0.05,0
40867,4211,-621.07,691.18,1691.18,0.00,621.07,0.15,0
40868,4211,1000.00,1691.18,2691.18,204.95,0.00,0.31,1
40869,4211,0.00,1691.18,2691.18,0.00,0.00,0.05,0
40870,4211,-1000.00,691.18,1691.18,0.00,1463.48,0.02,0
40871,4211,-1000.00,-308.82,691.18,157.71,1533.47,0.09,0
40872,4211,-55.16,-363.98,636.02,3.59,51.56,0.44,0
40873,4211,1000.00,636.02,1636.02,636.02,0.00,0.08,1
40874,4211,1000.00,1636.02,2636.02,1279.65,0.00,0.09,1
40875,4211,-1000.00,636.02,1636.02,656.17,1979.84,0.30,0
40876,4211,1000.00,1636.02,2636.02,1040.02,0.00,0.25,1
40877,4212,-1000.00,-1000.00,0.00,0.00,1000.00,0.39,0
40878,4213,1000.00,1000.00,2000.00,389.70,610.30,0.24,1
40879,4213,-410.82,589.18,1589.18,410.82,0.00,0.07,0
40880,4213,1000.00,1589.18,2589.18,423.39,1165.79,0.34,1
40881,4213,1000.00,2589.18,3589.18,0.00,2123.14,0.11,1
40882,4213,1000.00,3589.18,4589.18,950.16,2121.93,0.32,1
40883,4213,-1000.00,2589.18,3589.18,2314.48,2274.70,0.17,0
40884,4213,1000.00,3589.18,4589.18,739.11,2850.07,0.25,1
40885,4213,1000.00,4589.18,5589.18,0.00,4589.18,0.37,1
40886,4213,1000.00,5589.18,6589.18,0.00,5589.18,0.18,1
40887,4213,1000.00,6589.18,7589.18,0.00,4074.80,0.19,1
40888,4213,-1000.00,5589.18,6589.18,5352.56,2236.62,0.04,0
40889,4213,1000.00,6589.18,7589.18,1728.28,4860.91,0.27,1
40890,4213,1000.00,7589.18,8589.18,1214.64,6374.54,0.24,1
40891,4213,1000.00,8589.18,9589.18,2140.87,6448.31,0.08,1
40892,4213,1000.00,9589.18,10589.18,0.00,5526.08,0.30,1
40893,4213,1000.00,10589.18,11589.18,0.00,4121.53,0.26,1
40894,4213,1000.00,11589.18,12589.18,798.46,8121.90,0.39,1
40895,4213,1000.00,12589.18,13589.18,0.00,11221.94,0.31,1
40896,4213,1000.00,13589.18,14589.18,0.00,4100.23,0.16,1
40897,4213,-1000.00,12589.18,13589.18,11261.87,0.00,0.01,0
40898,4213,1000.00,13589.18,14589.18,6794.59,6794.59,0.03,1
40899,4213,1000.00,14589.18,15589.18,6778.19,7810.99,0.15,1
40900,4213,1000.00,15589.18,16589.18,2563.67,13025.51,0.39,1
40901,4213,-1000.00,14589.18,15589.18,7903.93,8685.25,0.44,0
40902,4213,-1000.00,13589.18,14589.18,0.00,15589.18,0.14,0
40903,4213,-1000.00,12589.18,13589.18,1313.19,10631.36,0.39,0
40904,4213,-1000.00,11589.18,12589.18,0.00,13589.18,0.23,0
40905,4213,-1000.00,10589.18,11589.18,0.00,10055.03,0.40,0
40906,4213,-1000.00,9589.18,10589.18,0.00,10259.09,0.20,0
40907,4213,-1000.00,8589.18,9589.18,2258.41,8330.77,0.35,0
40908,4213,-998.16,7591.02,8591.02,0.00,998.16,0.08,0
40909,4213,-1000.00,6591.02,7591.02,2422.83,6168.19,0.16,0
40910,4213,-1000.00,5591.02,6591.02,1877.79,5713.23,0.38,0
40911,4213,-1000.00,4591.02,5591.02,0.00,2293.39,0.06,0
40912,4213,-1000.00,3591.02,4591.02,2377.59,0.00,0.05,0
40913,4213,-1000.00,2591.02,3591.02,2899.85,1691.17,0.11,0
40914,4213,-1000.00,1591.02,2591.02,1375.99,2215.03,0.21,0
40915,4213,-1000.00,591.02,1591.02,0.00,2591.02,0.29,0
40916,4213,-1000.00,-408.98,591.02,0.00,1591.02,0.44,0
40917,4213,-591.02,-1000.00,0.00,0.00,591.02,0.13,0
40918,4214,1000.00,1000.00,2000.00,206.33,793.67,0.36,1
40919,4214,1000.00,2000.00,3000.00,114.32,1464.01,0.40,1
40920,4214,1000.00,3000.00,4000.00,1417.74,1582.26,0.16,1
40921,4214,-1000.00,2000.00,3000.00,3341.68,658.32,0.14,0
40922,4214,1000.00,3000.00,4000.00,1380.04,1619.96,0.16,1
40923,4214,1000.00,4000.00,5000.00,0.00,3573.58,0.04,1
40924,4214,1000.00,5000.00,6000.00,423.65,1784.58,0.25,1
40925,4214,1000.00,6000.00,7000.00,0.00,5999.74,0.36,1
40926,4214,1000.00,7000.00,8000.00,0.00,7000.00,0.16,1
40927,4214,1000.00,8000.00,9000.00,3334.87,4665.13,0.28,1
40928,4214,1000.00,9000.00,10000.00,3460.18,5539.82,0.23,1
40929,4214,1000.00,10000.00,11000.00,0.00,1135.44,0.05,1
40930,4214,1000.00,11000.00,12000.00,0.00,11000.00,0.36,1
40931,4214,1000.00,12000.00,13000.00,0.00,7196.04,0.35,1
40932,4214,1000.00,13000.00,14000.00,1474.67,11525.33,0.43,1
40933,4214,1000.00,14000.00,15000.00,0.00,8876.40,0.36,1
40934,4214,1000.00,15000.00,16000.00,4274.10,5197.75,0.22,1
40935,4214,1000.00,16000.00,17000.00,0.00,7811.01,0.30,1
40936,4214,1000.00,17000.00,18000.00,0.00,17000.00,0.25,1
40937,4214,1000.00,18000.00,19000.00,0.00,18000.00,0.38,1
40938,4214,1000.00,19000.00,20000.00,0.00,14064.68,0.36,1
40939,4214,1000.00,20000.00,21000.00,0.00,20000.00,0.02,1
40940,4214,-1000.00,19000.00,20000.00,0.00,21000.00,0.27,0
40941,4214,-1000.00,18000.00,19000.00,0.00,20000.00,0.05,0
40942,4214,-1000.00,17000.00,18000.00,9174.54,9825.46,0.15,0
40943,4214,-1000.00,16000.00,17000.00,0.00,18000.00,0.42,0
40944,4214,-1000.00,15000.00,16000.00,0.00,2299.29,0.16,0
40945,4214,-1000.00,14000.00,15000.00,9968.15,1225.01,0.08,0
40946,4214,-1000.00,13000.00,14000.00,0.00,3817.11,0.19,0
40947,4214,-1000.00,12000.00,13000.00,3093.06,8887.36,0.34,0
40948,4214,-1000.00,11000.00,12000.00,0.00,13000.00,0.19,0
40949,4214,-1000.00,10000.00,11000.00,0.00,12000.00,0.37,0
40950,4214,-1000.00,9000.00,10000.00,3448.53,7551.47,0.32,0
40951,4214,-1000.00,8000.00,9000.00,74.89,9925.11,0.02,0
40952,4214,-1000.00,7000.00,8000.00,0.00,9000.00,0.20,0
40953,4214,-1000.00,6000.00,7000.00,0.00,1079.76,0.07,0
40954,4214,-1000.00,5000.00,6000.00,0.00,7000.00,0.11,0
40955,4214,1000.00,6000.00,7000.00,0.00,6000.00,0.38,1
40956,4214,1000.00,7000.00,8000.00,0.00,7000.00,0.26,1
40957,4214,1000.00,8000.00,9000.00,4000.00,4000.00,0.35,1
40958,4214,1000.00,9000.00,10000.00,0.00,9000.00,0.38,1
40959,4214,1000.00,10000.00,11000.00,4714.59,5285.41,0.07,1
40960,4214,1000.00,11000.00,12000.00,0.00,10523.87,0.03,1
40961,4214,1000.00,12000.00,13000.00,1348.00,10652.00,0.35,1
40962,4214,1000.00,13000.00,14000.00,4864.02,8135.98,0.25,1
40963,4214,1000.00,14000.00,15000.00,0.00,10873.37,0.35,1
40964,4214,1000.00,15000.00,16000.00,5173.79,9826.21,0.27,1
40965,4214,1000.00,16000.00,17000.00,0.00,16000.00,0.40,1
40966,4214,1000.00,17000.00,18000.00,8153.45,8846.55,0.17,1
40967,4214,1000.00,18000.00,19000.00,0.00,18000.00,0.16,1
40968,4214,1000.00,19000.00,20000.00,0.00,19000.00,0.39,1
40969,4214,1000.00,20000.00,21000.00,6531.02,13468.98,0.08,1
40970,4214,1000.00,21000.00,22000.00,0.00,21000.00,0.23,1
40971,4215,-1000.00,-1000.00,0.00,0.00,1000.00,0.08,0
40972,4216,1000.00,1000.00,2000.00,154.84,822.90,0.41,1
40973,4216,1000.00,2000.00,3000.00,0.00,2000.00,0.21,1
40974,4216,1000.00,3000.00,4000.00,814.87,2185.13,0.34,1
40975,4216,1000.00,4000.00,5000.00,0.00,4000.00,0.00,1
40976,4216,1000.00,5000.00,6000.00,0.00,5000.00,0.14,1
40977,4216,1000.00,6000.00,7000.00,0.00,6000.00,0.03,1
40978,4216,-1000.00,5000.00,6000.00,3630.50,1788.32,0.15,0
40979,4216,1000.00,6000.00,7000.00,0.00,3168.85,0.31,1
40980,4216,1000.00,7000.00,8000.00,0.00,7000.00,0.37,1
40981,4216,1000.00,8000.00,9000.00,401.42,7598.58,0.39,1
40982,4216,1000.00,9000.00,10000.00,0.00,9000.00,0.19,1
40983,4216,1000.00,10000.00,11000.00,2749.73,7250.27,0.36,1
40984,4216,-1000.00,9000.00,10000.00,6731.31,4268.69,0.05,0
40985,4216,1000.00,10000.00,11000.00,0.00,5570.81,0.32,1
40986,4216,1000.00,11000.00,12000.00,2553.51,8446.49,0.25,1
40987,4216,-1000.00,10000.00,11000.00,4634.50,1828.54,0.13,0
40988,4216,1000.00,11000.00,12000.00,1487.58,9512.42,0.24,1
40989,4216,1000.00,12000.00,13000.00,4162.98,7837.02,0.24,1
40990,4216,1000.00,13000.00,14000.00,0.00,13000.00,0.31,1
40991,4216,1000.00,14000.00,15000.00,0.00,14000.00,0.23,1
40992,4216,0.00,14000.00,15000.00,0.00,0.00,0.05,0
40993,4216,1000.00,15000.00,16000.00,0.00,6058.69,0.26,1
40994,4216,1000.00,16000.00,17000.00,694.83,15305.17,0.44,1
40995,4216,-1000.00,15000.00,16000.00,13781.87,3218.13,0.06,0
40996,4216,1000.00,16000.00,17000.00,0.00,16000.00,0.19,1
40997,4216,1000.00,17000.00,18000.00,0.00,17000.00,0.29,1
40998,4216,-1000.00,16000.00,17000.00,10685.36,7314.64,0.13,0
40999,4216,1000.00,17000.00,18000.00,1253.46,11417.14,0.38,1
41000,4216,1000.00,18000.00,19000.00,0.00,18000.00,0.23,1
41001,4216,1000.00,19000.00,20000.00,0.00,19000.00,0.23,1
41002,4216,1000.00,20000.00,21000.00,5554.50,10806.64,0.30,1
41003,4216,1000.00,21000.00,22000.00,0.00,11375.92,0.30,1
41004,4216,-1000.00,20000.00,21000.00,16674.79,0.00,0.08,0
41005,4216,1000.00,21000.00,22000.00,0.00,14756.05,0.30,1
41006,4216,1000.00,22000.00,23000.00,0.00,20998.13,0.05,1
41007,4216,1000.00,23000.00,24000.00,0.00,19917.55,0.23,1
41008,4217,-1000.00,-1000.00,0.00,597.64,402.36,0.09,0
41009,4218,1000.00,1000.00,2000.00,231.44,114.85,0.41,1
41010,4218,0.00,1000.00,2000.00,0.00,0.00,0.24,0
41011,4218,-1000.00,0.00,1000.00,519.05,1094.95,0.37,0
41012,4218,-887.01,-887.01,112.99,0.00,887.01,0.05,0
41013,4218,-112.99,-1000.00,0.00,15.23,97.76,0.18,0
41014,4219,1000.00,1000.00,2000.00,500.00,500.00,0.01,1
41015,4219,1000.00,2000.00,3000.00,13.33,1986.67,0.40,1
41016,4219,1000.00,3000.00,4000.00,0.00,3000.00,0.29,1
41017,4219,1000.00,4000.00,5000.00,1362.79,2637.21,0.22,1
41018,4219,1000.00,5000.00,6000.00,0.00,5000.00,0.26,1
41019,4219,-1000.00,4000.00,5000.00,4730.86,1269.14,0.05,0
41020,4219,-1000.00,3000.00,4000.00,2975.22,2024.78,0.01,0
41021,4219,1000.00,4000.00,5000.00,8.29,3449.36,0.43,1
41022,4219,1000.00,5000.00,6000.00,0.00,5000.00,0.41,1
41023,4219,1000.00,6000.00,7000.00,0.00,6000.00,0.27,1
41024,4219,1000.00,7000.00,8000.00,0.00,2588.49,0.06,1
41025,4219,1000.00,8000.00,9000.00,0.00,8000.00,0.24,1
41026,4219,1000.00,9000.00,10000.00,1701.21,7298.79,0.40,1
41027,4219,1000.00,10000.00,11000.00,1880.70,4475.28,0.28,1
41028,4219,1000.00,11000.00,12000.00,0.00,11000.00,0.15,1
41029,4219,1000.00,12000.00,13000.00,0.00,6510.90,0.18,1
41030,4219,-1000.00,11000.00,12000.00,7568.40,5431.60,0.16,0
41031,4219,1000.00,12000.00,13000.00,0.00,12000.00,0.38,1
41032,4219,-1000.00,11000.00,12000.00,5248.84,0.00,0.07,0
41033,4219,1000.00,12000.00,13000.00,4399.59,7600.41,0.27,1
41034,4219,-303.14,11696.86,12696.86,303.14,0.00,0.10,0
41035,4219,-1000.00,10696.86,11696.86,4907.44,1619.98,0.12,0
41036,4219,1000.00,11696.86,12696.86,0.00,8312.68,0.15,1
41037,4219,1000.00,12696.86,13696.86,0.00,4127.08,0.14,1
41038,4219,-1000.00,11696.86,12696.86,2037.44,11659.43,0.06,0
41039,4219,-1000.00,10696.86,11696.86,3621.14,6801.91,0.35,0
41040,4219,-1000.00,9696.86,10696.86,0.00,11696.86,0.38,0
41041,4219,-1000.00,8696.86,9696.86,2860.52,7836.35,0.11,0
41042,4219,-1000.00,7696.86,8696.86,1932.06,7764.80,0.40,0
41043,4219,-1000.00,6696.86,7696.86,234.33,8462.53,0.28,0
41044,4219,-1000.00,5696.86,6696.86,3712.79,3984.07,0.11,0
41045,4219,-1000.00,4696.86,5696.86,0.00,4402.48,0.15,0
41046,4219,-1000.00,3696.86,4696.86,2367.82,3329.04,0.15,0
41047,4219,0.00,3696.86,4696.86,0.00,0.00,0.03,0
41048,4219,-1000.00,2696.86,3696.86,1612.07,3084.80,0.33,0
41049,4219,-1000.00,1696.86,2696.86,0.00,3696.86,0.36,0
41050,4219,-1000.00,696.86,1696.86,913.49,1783.38,0.07,0
41051,4219,-1000.00,-303.14,696.86,369.67,1327.20,0.26,0
41052,4219,-1000.00,-1303.14,-303.14,696.86,0.00,0.02,0
41053,4220,-1000.00,-1000.00,0.00,99.31,0.00,0.29,0
41054,4221,-1000.00,-1000.00,0.00,163.83,836.17,0.42,0
41055,4222,-1000.00,-1000.00,0.00,251.95,748.05,0.18,0
41056,4223,-864.59,-864.59,135.41,179.29,685.30,0.37,0
41057,4223,-1000.00,-1864.59,-864.59,58.17,49.73,0.20,0
41058,4224,-938.46,-938.46,61.54,0.00,938.46,0.17,0
41059,4224,-55.61,-994.07,5.93,0.00,55.61,0.44,0
41060,4224,-1.46,-995.52,4.48,0.00,1.46,0.17,0
41061,4224,-4.48,-1000.00,0.00,0.00,4.48,0.35,0
41062,4225,-1000.00,-1000.00,0.00,0.00,1000.00,0.03,0
41063,4226,-1000.00,-1000.00,0.00,0.00,1000.00,0.10,0
41064,4227,0.00,0.00,1000.00,0.00,0.00,0.06,0
41065,4227,1000.00,1000.00,2000.00,38.11,911.94,0.44,1
41066,4227,-1000.00,0.00,1000.00,1256.89,743.11,0.06,0
41067,4227,1000.00,1000.00,2000.00,0.00,1000.00,0.21,1
41068,4227,1000.00,2000.00,3000.00,0.00,143.57,0.10,1
41069,4227,1000.00,3000.00,4000.00,1028.73,1971.27,0.30,1
41070,4227,1000.00,4000.00,5000.00,0.00,3796.29,0.39,1
41071,4227,1000.00,5000.00,6000.00,1721.52,3278.48,0.23,1
41072,4227,-1000.00,4000.00,5000.00,3117.87,2024.80,0.17,0
41073,4227,1000.00,5000.00,6000.00,0.00,1885.25,0.12,1
41074,4227,1000.00,6000.00,7000.00,2472.66,3527.34,0.28,1
41075,4227,1000.00,7000.00,8000.00,0.00,4434.55,0.37,1
41076,4227,1000.00,8000.00,9000.00,0.00,4450.64,0.11,1
41077,4227,1000.00,9000.00,10000.00,0.00,9000.00,0.04,1
41078,4227,1000.00,10000.00,11000.00,1465.67,8534.33,0.28,1
41079,4227,-1000.00,9000.00,10000.00,6441.73,4558.27,0.17,0
41080,4227,1000.00,10000.00,11000.00,4694.88,5305.12,0.10,1
41081,4227,1000.00,11000.00,12000.00,952.57,10047.43,0.43,1
41082,4227,1000.00,12000.00,13000.00,369.17,6480.19,0.33,1
41083,4227,1000.00,13000.00,14000.00,0.00,13000.00,0.08,1
41084,4227,1000.00,14000.00,15000.00,0.00,13531.06,0.16,1
41085,4227,1000.00,15000.00,16000.00,7500.00,7500.00,0.06,1
41086,4227,1000.00,16000.00,17000.00,0.00,2564.71,0.17,1
41087,4227,1000.00,17000.00,18000.00,7527.55,9472.45,0.26,1
41088,4227,1000.00,18000.00,19000.00,5342.65,12657.35,0.30,1
41089,4227,-1000.00,17000.00,18000.00,11114.95,7885.05,0.06,0
41090,4227,1000.00,18000.00,19000.00,0.00,18000.00,0.05,1
41091,4227,1000.00,19000.00,20000.00,0.00,19000.00,0.21,1
41092,4227,-1000.00,18000.00,19000.00,12812.04,7187.96,0.32,0
41093,4227,1000.00,19000.00,20000.00,7494.93,11505.07,0.24,1
41094,4227,1000.00,20000.00,21000.00,5165.46,14834.54,0.26,1
41095,4227,1000.00,21000.00,22000.00,8668.68,12331.32,0.05,1
41096,4227,1000.00,22000.00,23000.00,0.00,22000.00,0.04,1
41097,4227,1000.00,23000.00,24000.00,3129.68,19870.32,0.20,1
41098,4227,1000.00,24000.00,25000.00,0.00,24000.00,0.31,1
41099,4227,1000.00,25000.00,26000.00,0.00,25000.00,0.35,1
41100,4227,1000.00,26000.00,27000.00,0.00,26000.00,0.24,1
41101,4227,1000.00,27000.00,28000.00,0.00,27000.00,0.14,1
41102,4227,-1000.00,26000.00,27000.00,9833.92,816.23,0.10,0
41103,4228,0.00,0.00,1000.00,0.00,0.00,0.09,0
41104,4228,0.00,0.00,1000.00,0.00,0.00,0.28,0
41105,4228,-317.94,-317.94,682.06,317.94,0.00,0.16,0
41106,4228,-267.20,-585.14,414.86,155.75,111.46,0.41,0
41107,4228,-1000.00,-1585.14,-585.14,0.00,414.86,0.11,0
41108,4229,1000.00,1000.00,2000.00,0.00,500.87,0.26,1
41109,4229,1000.00,2000.00,3000.00,635.29,1364.71,0.34,1
41110,4229,1000.00,3000.00,4000.00,1163.98,1836.02,0.25,1
41111,4229,1000.00,4000.00,5000.00,0.00,4000.00,0.12,1
41112,4229,1000.00,5000.00,6000.00,1247.24,3752.76,0.18,1
41113,4229,1000.00,6000.00,7000.00,273.42,5726.58,0.44,1
41114,4229,1000.00,7000.00,8000.00,0.00,6111.21,0.06,1
41115,4229,1000.00,8000.00,9000.00,0.00,8000.00,0.37,1
41116,4229,1000.00,9000.00,10000.00,2632.18,6367.82,0.34,1
41117,4229,1000.00,10000.00,11000.00,0.00,6511.32,0.25,1
41118,4229,1000.00,11000.00,12000.00,386.34,9497.10,0.42,1
41119,4229,1000.00,12000.00,13000.00,4856.56,7143.44,0.21,1
41120,4229,-1000.00,11000.00,12000.00,8094.11,0.00,0.02,0
41121,4229,1000.00,12000.00,13000.00,2579.39,9420.61,0.39,1
41122,4229,1000.00,13000.00,14000.00,0.00,9444.76,0.26,1
41123,4229,1000.00,14000.00,15000.00,0.00,13422.01,0.30,1
41124,4229,1000.00,15000.00,16000.00,0.00,15000.00,0.06,1
41125,4229,1000.00,16000.00,17000.00,4105.85,11894.15,0.38,1
41126,4229,-1000.00,15000.00,16000.00,9975.43,5592.69,0.19,0
41127,4229,-1000.00,14000.00,15000.00,3937.62,5424.96,0.24,0
41128,4229,-1000.00,13000.00,14000.00,0.00,15000.00,0.44,0
41129,4229,-1000.00,12000.00,13000.00,0.00,11904.77,0.29,0
41130,4229,-1000.00,11000.00,12000.00,6500.00,6500.00,0.10,0
41131,4229,-1000.00,10000.00,11000.00,7875.18,4124.82,0.12,0
41132,4229,-1000.00,9000.00,10000.00,2693.53,5993.54,0.31,0
41133,4229,-1000.00,8000.00,9000.00,4468.88,4718.42,0.23,0
41134,4229,-1000.00,7000.00,8000.00,0.00,7924.28,0.43,0
41135,4229,-1000.00,6000.00,7000.00,5581.62,2418.38,0.02,0
41136,4229,-1000.00,5000.00,6000.00,0.00,5714.31,0.40,0
41137,4229,-1000.00,4000.00,5000.00,3793.86,1385.10,0.11,0
41138,4229,-1000.00,3000.00,4000.00,602.46,4397.54,0.43,0
41139,4229,0.00,3000.00,4000.00,0.00,0.00,0.10,0
41140,4229,-1000.00,2000.00,3000.00,1664.71,2335.29,0.22,0
41141,4229,-1000.00,1000.00,2000.00,129.65,0.00,0.04,0
41142,4229,-1000.00,0.00,1000.00,472.98,1527.02,0.39,0
41143,4229,-1000.00,-1000.00,0.00,220.13,779.87,0.31,0
41144,4230,-1000.00,-1000.00,0.00,301.93,68.67,0.22,0
41145,4231,-864.79,-864.79,135.21,0.00,864.79,0.33,0
41146,4231,-135.21,-1000.00,0.00,0.00,135.21,0.32,0
41147,4232,-1000.00,-1000.00,0.00,0.00,1000.00,0.05,0
41148,4233,1000.00,1000.00,2000.00,0.00,331.14,0.08,1
41149,4233,1000.00,2000.00,3000.00,190.47,1809.53,0.23,1
41150,4233,-1000.00,1000.00,2000.00,2800.23,93.88,0.04,0
41151,4233,1000.00,2000.00,3000.00,522.74,756.16,0.24,1
41152,4233,1000.00,3000.00,4000.00,0.00,3000.00,0.11,1
41153,4233,1000.00,4000.00,5000.00,0.00,4000.00,0.01,1
41154,4233,1000.00,5000.00,6000.00,1611.88,3388.12,0.23,1
41155,4233,1000.00,6000.00,7000.00,2256.62,3743.38,0.25,1
41156,4233,1000.00,7000.00,8000.00,1643.75,5356.25,0.39,1
41157,4233,1000.00,8000.00,9000.00,0.00,8000.00,0.34,1
41158,4233,1000.00,9000.00,10000.00,0.00,9000.00,0.39,1
41159,4233,1000.00,10000.00,11000.00,440.60,9559.40,0.43,1
41160,4233,1000.00,11000.00,12000.00,3687.49,7312.51,0.26,1
41161,4233,1000.00,12000.00,13000.00,1107.07,10892.93,0.13,1
41162,4233,1000.00,13000.00,14000.00,1260.64,1604.98,0.15,1
41163,4233,1000.00,14000.00,15000.00,0.00,3722.76,0.20,1
41164,4233,1000.00,15000.00,16000.00,0.00,12855.65,0.34,1
41165,4233,1000.00,16000.00,17000.00,0.00,13667.95,0.18,1
41166,4233,1000.00,17000.00,18000.00,497.19,4100.14,0.20,1
41167,4233,1000.00,18000.00,19000.00,3426.58,8998.17,0.30,1
41168,4233,-1000.00,17000.00,18000.00,9500.00,9500.00,0.13,0
41169,4233,-1000.00,16000.00,17000.00,4544.19,13455.81,0.32,0
41170,4233,-1000.00,15000.00,16000.00,0.00,2928.57,0.14,0
41171,4233,-1000.00,14000.00,15000.00,0.00,16000.00,0.13,0
41172,4233,-1000.00,13000.00,14000.00,92.89,14907.11,0.28,0
41173,4233,-1000.00,12000.00,13000.00,0.00,14000.00,0.14,0
41174,4233,-1000.00,11000.00,12000.00,0.00,11939.27,0.43,0
41175,4233,-1000.00,10000.00,11000.00,797.36,11202.64,0.05,0
41176,4233,-1000.00,9000.00,10000.00,0.00,11000.00,0.17,0
41177,4233,-1000.00,8000.00,9000.00,0.00,10000.00,0.05,0
41178,4233,-1000.00,7000.00,8000.00,0.00,7653.23,0.43,0
41179,4233,-1000.00,6000.00,7000.00,3118.33,4881.67,0.23,0
41180,4233,-1000.00,5000.00,6000.00,0.00,3248.31,0.27,0
41181,4233,-1000.00,4000.00,5000.00,0.00,6000.00,0.18,0
41182,4233,-1000.00,3000.00,4000.00,0.00,5000.00,0.30,0
41183,4233,-1000.00,2000.00,3000.00,1585.90,2414.10,0.26,0
41184,4233,-210.16,1789.84,2789.84,0.00,210.16,0.11,0
41185,4233,-1000.00,789.84,1789.84,0.00,2789.84,0.09,0
41186,4233,-1000.00,-210.16,789.84,0.00,1789.84,0.07,0
41187,4233,-769.77,-979.93,20.07,0.00,769.77,0.12,0
41188,4233,1000.00,20.07,1020.07,0.00,15.51,0.38,1
41189,4233,1000.00,1020.07,2020.07,0.00,680.84,0.43,1
41190,4233,1000.00,2020.07,3020.07,0.00,2020.07,0.38,1
41191,4233,1000.00,3020.07,4020.07,1510.03,1510.03,0.01,1
41192,4233,1000.00,4020.07,5020.07,1742.58,2277.49,0.16,1
41193,4233,1000.00,5020.07,6020.07,0.00,5020.07,0.21,1
41194,4233,1000.00,6020.07,7020.07,0.00,6020.07,0.01,1
41195,4233,1000.00,7020.07,8020.07,0.00,2747.26,0.12,1
41196,4233,1000.00,8020.07,9020.07,1387.10,6632.97,0.39,1
41197,4233,1000.00,9020.07,10020.07,4510.03,4510.03,0.03,1
41198,4233,1000.00,10020.07,11020.07,0.00,7679.73,0.23,1
41199,4233,1000.00,11020.07,12020.07,2663.96,8356.10,0.39,1
41200,4233,1000.00,12020.07,13020.07,185.62,1000.79,0.14,1
41201,4233,1000.00,13020.07,14020.07,0.00,10336.42,0.35,1
41202,4233,1000.00,14020.07,15020.07,0.00,14020.07,0.28,1
41203,4233,1000.00,15020.07,16020.07,0.00,13811.88,0.44,1
41204,4233,1000.00,16020.07,17020.07,2900.74,13119.33,0.41,1
41205,4233,1000.00,17020.07,18020.07,0.00,14889.94,0.23,1
41206,4233,1000.00,18020.07,19020.07,3811.85,14208.22,0.13,1
41207,4233,1000.00,19020.07,20020.07,5155.75,13864.31,0.37,1
41208,4233,-1000.00,18020.07,19020.07,9168.34,5535.61,0.16,0
41209,4233,1000.00,19020.07,20020.07,9510.03,9510.03,0.06,1
41210,4233,0.00,19020.07,20020.07,0.00,0.00,0.05,0
41211,4233,1000.00,20020.07,21020.07,5896.61,14123.46,0.34,1
41212,4234,-1000.00,-1000.00,0.00,618.79,381.21,0.14,0
41213,4235,-742.68,-742.68,257.32,0.00,742.68,0.40,0
41214,4235,-1000.00,-1742.68,-742.68,116.46,8.98,0.09,0
41215,4236,1000.00,1000.00,2000.00,0.00,1000.00,0.40,1
41216,4236,1000.00,2000.00,3000.00,991.78,1008.22,0.13,1
41217,4236,1000.00,3000.00,4000.00,0.00,3000.00,0.10,1
41218,4236,1000.00,4000.00,5000.00,0.00,4000.00,0.30,1
41219,4236,1000.00,5000.00,6000.00,0.00,4397.23,0.14,1
41220,4236,1000.00,6000.00,7000.00,0.00,5812.66,0.40,1
41221,4236,-1000.00,5000.00,6000.00,1034.07,716.35,0.14,0
41222,4236,1000.00,6000.00,7000.00,0.00,2072.15,0.18,1
41223,4236,-1000.00,5000.00,6000.00,5142.65,1857.35,0.09,0
41224,4236,1000.00,6000.00,7000.00,0.00,445.95,0.08,1
41225,4236,1000.00,7000.00,8000.00,0.00,2744.55,0.08,1
41226,4236,1000.00,8000.00,9000.00,0.00,3574.93,0.27,1
41227,4236,-1000.00,7000.00,8000.00,4892.82,4107.18,0.15,0
41228,4236,1000.00,8000.00,9000.00,0.00,8000.00,0.36,1
41229,4236,1000.00,9000.00,10000.00,0.00,9000.00,0.05,1
41230,4236,1000.00,10000.00,11000.00,0.00,8854.30,0.36,1
41231,4236,1000.00,11000.00,12000.00,0.00,11000.00,0.01,1
41232,4236,1000.00,12000.00,13000.00,4764.07,7235.93,0.11,1
41233,4236,1000.00,13000.00,14000.00,3508.43,9491.57,0.07,1
41234,4236,1000.00,14000.00,15000.00,0.00,11298.72,0.23,1
41235,4236,0.00,14000.00,15000.00,0.00,0.00,0.10,0
41236,4236,1000.00,15000.00,16000.00,0.00,15000.00,0.42,1
41237,4236,-1000.00,14000.00,15000.00,12911.53,3088.47,0.05,0
41238,4236,1000.00,15000.00,16000.00,6556.28,8443.72,0.21,1
41239,4236,-1000.00,14000.00,15000.00,10460.16,5539.84,0.28,0
41240,4236,-1000.00,13000.00,14000.00,4455.31,10544.69,0.29,0
41241,4236,-1000.00,12000.00,13000.00,5398.88,8057.86,0.28,0
41242,4236,-1000.00,11000.00,12000.00,3004.82,8354.91,0.34,0
41243,4236,-1000.00,10000.00,11000.00,5466.18,6533.82,0.11,0
41244,4236,-1000.00,9000.00,10000.00,0.00,10604.89,0.43,0
41245,4236,-1000.00,8000.00,9000.00,0.00,5969.32,0.31,0
41246,4236,-1000.00,7000.00,8000.00,2960.65,6039.35,0.32,0
41247,4236,-1000.00,6000.00,7000.00,0.00,8000.00,0.32,0
41248,4236,-1000.00,5000.00,6000.00,886.79,5327.66,0.40,0
41249,4236,-1000.00,4000.00,5000.00,0.00,6000.00,0.33,0
41250,4236,-1000.00,3000.00,4000.00,1127.05,3872.95,0.26,0
41251,4236,-1000.00,2000.00,3000.00,0.00,4000.00,0.17,0
41252,4236,-1000.00,1000.00,2000.00,0.00,2811.04,0.41,0
41253,4236,-486.15,513.85,1513.85,0.00,486.15,0.18,0
41254,4236,-1000.00,-486.15,513.85,0.00,1513.85,0.30,0
41255,4236,-391.06,-877.21,122.79,0.00,391.06,0.41,0
41256,4236,-122.79,-1000.00,0.00,0.00,122.79,0.11,0
41257,4237,-1000.00,-1000.00,0.00,500.00,500.00,0.03,0
41258,4238,1000.00,1000.00,2000.00,0.00,1000.00,0.23,1
41259,4238,-260.40,739.60,1739.60,260.40,0.00,0.06,0
41260,4238,-1000.00,-260.40,739.60,957.02,782.58,0.19,0
41261,4238,1000.00,739.60,1739.60,362.35,377.25,0.41,1
41262,4238,1000.00,1739.60,2739.60,0.00,482.19,0.20,1
41263,4238,1000.00,2739.60,3739.60,0.00,2739.60,0.36,1
41264,4238,1000.00,3739.60,4739.60,0.00,3739.60,0.34,1
41265,4238,-1000.00,2739.60,3739.60,2680.58,2059.02,0.36,0
41266,4238,1000.00,3739.60,4739.60,1035.49,2704.11,0.37,1
41267,4238,1000.00,4739.60,5739.60,1273.17,3466.43,0.37,1
41268,4238,-1000.00,3739.60,4739.60,1991.13,661.98,0.15,0
41269,4238,1000.00,4739.60,5739.60,255.75,3691.34,0.41,1
41270,4238,-1000.00,3739.60,4739.60,3822.63,1916.97,0.16,0
41271,4238,1000.00,4739.60,5739.60,0.00,3229.69,0.36,1
41272,4238,1000.00,5739.60,6739.60,1694.27,4045.33,0.13,1
41273,4238,1000.00,6739.60,7739.60,1643.71,5095.89,0.38,1
41274,4238,1000.00,7739.60,8739.60,0.00,3546.64,0.23,1
41275,4238,1000.00,8739.60,9739.60,0.00,3082.42,0.21,1
41276,4238,1000.00,9739.60,10739.60,2069.02,7670.58,0.40,1
41277,4238,1000.00,10739.60,11739.60,886.68,9852.92,0.43,1
41278,4238,1000.00,11739.60,12739.60,5580.59,6159.01,0.04,1
41279,4238,1000.00,12739.60,13739.60,6369.80,6369.80,0.03,1
41280,4238,1000.00,13739.60,14739.60,0.00,13739.60,0.42,1
41281,4238,1000.00,14739.60,15739.60,3446.68,8411.66,0.32,1
41282,4238,1000.00,15739.60,16739.60,0.00,12755.79,0.04,1
41283,4238,-1000.00,14739.60,15739.60,10113.27,6203.38,0.15,0
41284,4238,1000.00,15739.60,16739.60,0.00,15739.60,0.13,1
41285,4238,1000.00,16739.60,17739.60,0.00,16739.60,0.39,1
41286,4238,1000.00,17739.60,18739.60,0.00,13824.03,0.13,1
41287,4238,1000.00,18739.60,19739.60,4320.36,14419.24,0.34,1
41288,4238,1000.00,19739.60,20739.60,0.00,19739.60,0.39,1
41289,4238,0.00,19739.60,20739.60,0.00,0.00,0.02,0
41290,4238,1000.00,20739.60,21739.60,0.00,5824.40,0.20,1
41291,4238,1000.00,21739.60,22739.60,0.00,21739.60,0.18,1
41292,4238,1000.00,22739.60,23739.60,0.00,22739.60,0.36,1
41293,4238,1000.00,23739.60,24739.60,6020.92,17718.68,0.15,1
41294,4238,1000.00,24739.60,25739.60,12369.80,12369.80,0.04,1
41295,4238,1000.00,25739.60,26739.60,0.00,11440.63,0.26,1
41296,4238,1000.00,26739.60,27739.60,308.65,20759.59,0.41,1
41297,4238,1000.00,27739.60,28739.60,13869.80,13869.80,0.06,1
41298,4238,1000.00,28739.60,29739.60,0.00,28739.60,0.42,1
41299,4238,0.00,28739.60,29739.60,0.00,0.00,0.02,0
41300,4238,1000.00,29739.60,30739.60,11734.60,18005.00,0.02,1
41301,4238,1000.00,30739.60,31739.60,0.00,30739.60,0.41,1
41302,4238,-1000.00,29739.60,30739.60,22441.77,9297.83,0.27,0
41303,4238,-1000.00,28739.60,29739.60,3720.16,21792.75,0.39,0
41304,4238,-1000.00,27739.60,28739.60,7045.12,22694.48,0.32,0
41305,4238,-1000.00,26739.60,27739.60,14369.80,14369.80,0.04,0
41306,4238,-1000.00,25739.60,26739.60,0.00,27739.60,0.10,0
41307,4238,-1000.00,24739.60,25739.60,0.00,4899.83,0.16,0
41308,4238,-1000.00,23739.60,24739.60,0.00,2401.59,0.08,0
41309,4238,-1000.00,22739.60,23739.60,2787.56,3192.45,0.15,0
41310,4238,-1000.00,21739.60,22739.60,1918.53,21821.07,0.08,0
41311,4238,-1000.00,20739.60,21739.60,1731.94,21007.66,0.24,0
41312,4238,-1000.00,19739.60,20739.60,8423.63,13315.97,0.06,0
41313,4238,-1000.00,18739.60,19739.60,4990.71,15748.90,0.23,0
41314,4238,-1000.00,17739.60,18739.60,2980.26,16759.34,0.42,0
41315,4238,-1000.00,16739.60,17739.60,0.00,18739.60,0.39,0
41316,4238,-1000.00,15739.60,16739.60,0.00,17739.60,0.22,0
41317,4238,-1000.00,14739.60,15739.60,5576.35,11163.25,0.36,0
41318,4238,-1000.00,13739.60,14739.60,0.00,15739.60,0.11,0
41319,4238,-1000.00,12739.60,13739.60,5940.51,8799.09,0.24,0
41320,4238,-1000.00,11739.60,12739.60,1695.67,12043.93,0.36,0
41321,4238,-1000.00,10739.60,11739.60,7439.96,5299.64,0.14,0
41322,4238,-1000.00,9739.60,10739.60,0.00,11739.60,0.16,0
41323,4238,-1000.00,8739.60,9739.60,0.00,10739.60,0.31,0
41324,4238,-1000.00,7739.60,8739.60,0.00,9739.60,0.27,0
41325,4238,-1000.00,6739.60,7739.60,0.00,8739.60,0.02,0
41326,4239,1000.00,1000.00,2000.00,0.00,789.57,0.38,1
41327,4239,1000.00,2000.00,3000.00,0.00,1940.44,0.42,1
41328,4239,1000.00,3000.00,4000.00,0.00,3000.00,0.16,1
41329,4239,1000.00,4000.00,5000.00,0.00,1068.85,0.09,1
41330,4239,1000.00,5000.00,6000.00,0.00,2496.80,0.13,1
41331,4239,1000.00,6000.00,7000.00,2239.10,3760.90,0.38,1
41332,4239,1000.00,7000.00,8000.00,0.00,7000.00,0.12,1
41333,4239,-1000.00,6000.00,7000.00,4416.01,3583.99,0.09,0
41334,4239,1000.00,7000.00,8000.00,0.00,7000.00,0.29,1
41335,4239,1000.00,8000.00,9000.00,693.56,7306.44,0.43,1
41336,4239,1000.00,9000.00,10000.00,2941.86,6058.14,0.34,1
41337,4239,1000.00,10000.00,11000.00,5000.00,5000.00,0.13,1
41338,4239,1000.00,11000.00,12000.00,0.00,11000.00,0.40,1
41339,4239,1000.00,12000.00,13000.00,0.00,7846.50,0.38,1
41340,4239,1000.00,13000.00,14000.00,0.00,13000.00,0.14,1
41341,4239,1000.00,14000.00,15000.00,4895.24,9092.42,0.31,1
41342,4239,-1000.00,13000.00,14000.00,7796.55,7203.45,0.16,0
41343,4239,1000.00,14000.00,15000.00,0.00,1234.15,0.08,1
41344,4239,1000.00,15000.00,16000.00,3716.10,11283.90,0.02,1
41345,4239,1000.00,16000.00,17000.00,6599.24,9400.76,0.15,1
41346,4239,-1000.00,15000.00,16000.00,9020.46,978.99,0.09,0
41347,4239,1000.00,16000.00,17000.00,0.00,16000.00,0.08,1
41348,4239,-1000.00,15000.00,16000.00,8276.01,8723.99,0.38,0
41349,4239,-1000.00,14000.00,15000.00,0.00,16000.00,0.29,0
41350,4239,-1000.00,13000.00,14000.00,3864.94,11135.06,0.37,0
41351,4239,-1000.00,12000.00,13000.00,2810.76,11189.24,0.41,0
41352,4239,-1000.00,11000.00,12000.00,4464.98,8535.02,0.32,0
41353,4239,-1000.00,10000.00,11000.00,1011.49,10123.64,0.42,0
41354,4239,-1000.00,9000.00,10000.00,0.00,9333.98,0.20,0
41355,4239,-1000.00,8000.00,9000.00,635.01,3009.46,0.22,0
41356,4239,-1000.00,7000.00,8000.00,3334.92,5665.08,0.30,0
41357,4239,-1000.00,6000.00,7000.00,0.00,8000.00,0.12,0
41358,4239,-1000.00,5000.00,6000.00,0.00,7000.00,0.38,0
41359,4239,-1000.00,4000.00,5000.00,0.00,5451.79,0.17,0
41360,4239,-1000.00,3000.00,4000.00,2313.13,2686.87,0.17,0
41361,4239,-1000.00,2000.00,3000.00,1568.75,2431.25,0.24,0
41362,4239,-1000.00,1000.00,2000.00,0.00,1215.40,0.12,0
41363,4239,-1000.00,0.00,1000.00,0.00,2000.00,0.38,0
41364,4239,-455.06,-455.06,544.94,0.00,455.06,0.06,0
41365,4239,-1000.00,-1455.06,-455.06,301.15,120.57,0.12,0
41366,4240,-1000.00,-1000.00,0.00,356.88,643.12,0.28,0
41367,4241,-1000.00,-1000.00,0.00,0.00,1000.00,0.36,0
41368,4242,-1000.00,-1000.00,0.00,0.00,1000.00,0.07,0
41369,4243,-258.62,-258.62,741.38,0.00,258.62,0.19,0
41370,4243,-741.38,-1000.00,0.00,0.00,741.38,0.36,0
41371,4244,-157.40,-157.40,842.60,157.40,0.00,0.38,0
41372,4244,-141.40,-298.81,701.19,141.40,0.00,0.38,0
41373,4244,-1000.00,-1298.81,-298.81,151.08,550.11,0.36,0
41374,4245,-1000.00,-1000.00,0.00,0.00,296.18,0.28,0
41375,4246,-424.17,-424.17,575.83,205.75,218.42,0.39,0
41376,4246,1000.00,575.83,1575.83,575.83,0.00,0.07,1
41377,4246,1000.00,1575.83,2575.83,109.13,0.00,0.15,1
41378,4246,1000.00,2575.83,3575.83,549.03,0.00,0.41,1
41379,4246,1000.00,3575.83,4575.83,2431.15,1144.69,0.14,1
41380,4246,-1000.00,2575.83,3575.83,284.00,952.63,0.41,0
41381,4246,0.00,2575.83,3575.83,0.00,0.00,0.15,0
41382,4246,0.00,2575.83,3575.83,0.00,0.00,0.33,0
41383,4246,0.00,2575.83,3575.83,0.00,0.00,0.34,0
41384,4246,-77.25,2498.58,3498.58,0.00,77.25,0.38,0
41385,4246,1000.00,3498.58,4498.58,3231.18,267.40,0.44,1
41386,4246,0.00,3498.58,4498.58,0.00,0.00,0.01,0
41387,4246,-1000.00,2498.58,3498.58,0.00,4498.58,0.00,0
41388,4246,-1000.00,1498.58,2498.58,1347.11,2151.48,0.21,0
41389,4246,-402.22,1096.36,2096.36,0.00,402.22,0.11,0
41390,4246,0.00,1096.36,2096.36,0.00,0.00,0.12,0
41391,4246,1000.00,2096.36,3096.36,969.87,931.84,0.25,1
41392,4246,1000.00,3096.36,4096.36,2294.30,0.00,0.12,1
41393,4246,0.00,3096.36,4096.36,0.00,0.00,0.39,0
41394,4246,1000.00,4096.36,5096.36,3433.87,0.00,0.17,1
41395,4246,-1000.00,3096.36,4096.36,0.00,5096.36,0.01,0
41396,4246,1000.00,4096.36,5096.36,18.53,0.00,0.05,1
41397,4246,1000.00,5096.36,6096.36,4152.32,0.00,0.13,1
41398,4246,1000.00,6096.36,7096.36,2940.26,0.00,0.32,1
41399,4246,0.00,6096.36,7096.36,0.00,0.00,0.03,0
41400,4246,-1000.00,5096.36,6096.36,0.00,312.18,0.44,0
41401,4246,-1000.00,4096.36,5096.36,0.00,1110.03,0.39,0
41402,4246,0.00,4096.36,5096.36,0.00,0.00,0.29,0
41403,4246,-1000.00,3096.36,4096.36,0.00,2629.97,0.17,0
41404,4246,0.00,3096.36,4096.36,0.00,0.00,0.03,0
41405,4246,-1000.00,2096.36,3096.36,2466.95,0.00,0.17,0
41406,4246,-1000.00,1096.36,2096.36,1480.03,1616.33,0.11,0
41407,4246,-1000.00,96.36,1096.36,354.44,1557.99,0.20,0
41408,4246,-1000.00,-903.64,96.36,504.77,591.59,0.16,0
41409,4246,-96.36,-1000.00,0.00,96.36,0.00,0.34,0
41410,4247,1000.00,1000.00,2000.00,332.72,667.28,0.10,1
41411,4247,1000.00,2000.00,3000.00,0.00,626.99,0.22,1
41412,4247,1000.00,3000.00,4000.00,0.00,3000.00,0.22,1
41413,4247,1000.00,4000.00,5000.00,0.00,3327.23,0.34,1
41414,4247,1000.00,5000.00,6000.00,2500.00,2500.00,0.23,1
41415,4247,1000.00,6000.00,7000.00,0.00,5005.50,0.34,1
41416,4247,1000.00,7000.00,8000.00,2533.40,4466.60,0.27,1
41417,4247,1000.00,8000.00,9000.00,1338.54,2370.66,0.21,1
41418,4247,1000.00,9000.00,10000.00,3294.53,5705.47,0.25,1
41419,4247,1000.00,10000.00,11000.00,0.00,10000.00,0.30,1
41420,4247,1000.00,11000.00,12000.00,0.00,10090.75,0.31,1
41421,4247,1000.00,12000.00,13000.00,0.00,12000.00,0.31,1
41422,4247,-1000.00,11000.00,12000.00,10211.75,2788.25,0.07,0
41423,4247,1000.00,12000.00,13000.00,0.00,12000.00,0.04,1
41424,4247,1000.00,13000.00,14000.00,3152.49,9847.51,0.41,1
41425,4247,-1000.00,12000.00,13000.00,11887.70,2112.30,0.01,0
41426,4247,1000.00,13000.00,14000.00,0.00,13000.00,0.22,1
41427,4247,1000.00,14000.00,15000.00,4806.78,5510.73,0.23,1
41428,4247,1000.00,15000.00,16000.00,0.00,15000.00,0.19,1
41429,4247,1000.00,16000.00,17000.00,0.00,11818.63,0.39,1
41430,4247,-1000.00,15000.00,16000.00,7791.69,2453.72,0.12,0
41431,4247,1000.00,16000.00,17000.00,0.00,16000.00,0.07,1
41432,4247,1000.00,17000.00,18000.00,0.00,17000.00,0.16,1
41433,4247,1000.00,18000.00,19000.00,0.00,18000.00,0.21,1
41434,4247,1000.00,19000.00,20000.00,0.00,9775.05,0.32,1
41435,4247,1000.00,20000.00,21000.00,6783.43,13216.57,0.24,1
41436,4247,1000.00,21000.00,22000.00,5026.71,15973.29,0.39,1
41437,4247,1000.00,22000.00,23000.00,8894.90,13105.10,0.10,1
41438,4247,1000.00,23000.00,24000.00,0.00,23000.00,0.28,1
41439,4247,1000.00,24000.00,25000.00,0.00,11365.37,0.26,1
41440,4247,1000.00,25000.00,26000.00,4639.77,20360.23,0.36,1
41441,4247,1000.00,26000.00,27000.00,6342.45,19657.55,0.39,1
41442,4247,1000.00,27000.00,28000.00,6672.30,20327.70,0.38,1
41443,4247,1000.00,28000.00,29000.00,1690.41,24551.51,0.43,1
41444,4247,1000.00,29000.00,30000.00,10275.92,18724.08,0.30,1
41445,4247,1000.00,30000.00,31000.00,0.00,30000.00,0.20,1
41446,4247,1000.00,31000.00,32000.00,12764.46,18235.54,0.28,1
41447,4247,1000.00,32000.00,33000.00,720.14,31279.86,0.37,1
41448,4247,1000.00,33000.00,34000.00,13275.11,19724.89,0.22,1
41449,4247,1000.00,34000.00,35000.00,0.00,34000.00,0.16,1
41450,4247,1000.00,35000.00,36000.00,4686.74,13874.55,0.26,1
41451,4247,1000.00,36000.00,37000.00,16477.56,19522.44,0.14,1
41452,4247,1000.00,37000.00,38000.00,12816.51,24183.49,0.32,1
41453,4247,1000.00,38000.00,39000.00,0.00,38000.00,0.36,1
41454,4247,1000.00,39000.00,40000.00,13114.38,25885.62,0.33,1
41455,4248,-1000.00,-1000.00,0.00,311.50,688.50,0.09,0
41456,4249,-599.71,-599.71,400.29,599.71,0.00,0.05,0
41457,4249,-1000.00,-1599.71,-599.71,0.00,400.29,0.23,0
41458,4250,-303.88,-303.88,696.12,303.88,0.00,0.38,0
41459,4250,-1000.00,-1303.88,-303.88,0.00,567.75,0.12,0
41460,4251,-1000.00,-1000.00,0.00,320.21,679.79,0.05,0
41461,4252,-1000.00,-1000.00,0.00,0.00,1000.00,0.17,0
41462,4253,1000.00,1000.00,2000.00,0.00,240.43,0.18,1
41463,4253,1000.00,2000.00,3000.00,0.00,2000.00,0.30,1
41464,4253,1000.00,3000.00,4000.00,798.94,2201.06,0.34,1
41465,4253,-1000.00,2000.00,3000.00,2730.94,1269.06,0.27,0
41466,4253,1000.00,3000.00,4000.00,0.00,1115.13,0.24,1
41467,4253,1000.00,4000.00,5000.00,0.00,1681.09,0.14,1
41468,4253,1000.00,5000.00,6000.00,2071.34,2928.66,0.19,1
41469,4253,1000.00,6000.00,7000.00,1090.48,4909.52,0.17,1
41470,4253,1000.00,7000.00,8000.00,0.00,7000.00,0.35,1
41471,4253,1000.00,8000.00,9000.00,0.00,5544.39,0.37,1
41472,4253,1000.00,9000.00,10000.00,0.00,9000.00,0.07,1
41473,4253,1000.00,10000.00,11000.00,0.00,10000.00,0.10,1
41474,4253,1000.00,11000.00,12000.00,1127.98,9872.02,0.35,1
41475,4253,1000.00,12000.00,13000.00,0.00,8341.48,0.36,1
41476,4253,1000.00,13000.00,14000.00,4054.95,8945.05,0.33,1
41477,4253,1000.00,14000.00,15000.00,0.00,14000.00,0.39,1
41478,4253,1000.00,15000.00,16000.00,0.00,8552.54,0.08,1
41479,4253,1000.00,16000.00,17000.00,0.00,826.86,0.09,1
41480,4253,1000.00,17000.00,18000.00,0.00,16041.45,0.31,1
41481,4253,1000.00,18000.00,19000.00,0.00,12256.44,0.09,1
41482,4253,1000.00,19000.00,20000.00,0.00,9605.78,0.31,1
41483,4253,-1000.00,18000.00,19000.00,11118.44,8881.56,0.07,0
41484,4253,1000.00,19000.00,20000.00,1184.78,5714.97,0.22,1
41485,4253,1000.00,20000.00,21000.00,0.00,13696.96,0.30,1
41486,4253,1000.00,21000.00,22000.00,5141.83,15858.17,0.37,1
41487,4253,1000.00,22000.00,23000.00,11000.00,11000.00,0.05,1
41488,4253,1000.00,23000.00,24000.00,6816.88,16183.12,0.27,1
41489,4253,1000.00,24000.00,25000.00,0.00,19375.44,0.41,1
41490,4253,1000.00,25000.00,26000.00,0.00,14938.77,0.05,1
41491,4253,1000.00,26000.00,27000.00,0.00,26000.00,0.10,1
41492,4253,1000.00,27000.00,28000.00,0.00,27000.00,0.02,1
41493,4253,1000.00,28000.00,29000.00,0.00,28000.00,0.31,1
41494,4253,1000.00,29000.00,30000.00,0.00,29000.00,0.41,1
41495,4253,1000.00,30000.00,31000.00,0.00,15415.86,0.25,1
41496,4253,1000.00,31000.00,32000.00,3893.59,27106.41,0.28,1
41497,4253,1000.00,32000.00,33000.00,454.33,31545.67,0.44,1
41498,4253,1000.00,33000.00,34000.00,0.00,17873.79,0.29,1
41499,4253,1000.00,34000.00,35000.00,0.00,34000.00,0.26,1
41500,4253,1000.00,35000.00,36000.00,0.00,35000.00,0.24,1
41501,4253,1000.00,36000.00,37000.00,0.00,36000.00,0.31,1
41502,4253,1000.00,37000.00,38000.00,0.00,18402.25,0.23,1
41503,4254,-1000.00,-1000.00,0.00,355.17,644.83,0.27,0
41504,4255,-1000.00,-1000.00,0.00,0.00,1000.00,0.29,0
41505,4256,-1000.00,-1000.00,0.00,271.27,728.73,0.29,0
41506,4257,-587.87,-587.87,412.13,518.81,69.06,0.09,0
41507,4257,1000.00,412.13,1412.13,49.81,116.03,0.21,1
41508,4257,1000.00,1412.13,2412.13,0.00,173.13,0.14,1
41509,4257,-1000.00,412.13,1412.13,1041.50,0.00,0.00,0
41510,4257,1000.00,1412.13,2412.13,0.00,1412.13,0.10,1
41511,4257,1000.00,2412.13,3412.13,0.00,1163.62,0.12,1
41512,4257,1000.00,3412.13,4412.13,0.00,3412.13,0.21,1
41513,4257,1000.00,4412.13,5412.13,0.00,4412.13,0.13,1
41514,4257,-1000.00,3412.13,4412.13,1468.83,1333.99,0.18,0
41515,4257,1000.00,4412.13,5412.13,0.00,2088.35,0.30,1
41516,4257,1000.00,5412.13,6412.13,2649.15,2762.98,0.04,1
41517,4257,1000.00,6412.13,7412.13,432.22,2090.03,0.23,1
41518,4257,1000.00,7412.13,8412.13,0.00,7412.13,0.08,1
41519,4257,1000.00,8412.13,9412.13,0.00,7197.64,0.40,1
41520,4257,1000.00,9412.13,10412.13,2376.64,7035.49,0.05,1
41521,4257,1000.00,10412.13,11412.13,0.00,10412.13,0.14,1
41522,4257,1000.00,11412.13,12412.13,3323.22,8088.91,0.11,1
41523,4257,1000.00,12412.13,13412.13,0.00,12412.13,0.33,1
41524,4257,1000.00,13412.13,14412.13,6149.35,7262.78,0.24,1
41525,4257,1000.00,14412.13,15412.13,0.00,14412.13,0.41,1
41526,4257,1000.00,15412.13,16412.13,0.00,15412.13,0.44,1
41527,4257,1000.00,16412.13,17412.13,0.00,16412.13,0.03,1
41528,4257,-1000.00,15412.13,16412.13,8706.06,8706.06,0.23,0
41529,4257,0.00,15412.13,16412.13,0.00,0.00,0.10,0
41530,4257,-1000.00,14412.13,15412.13,0.00,10687.28,0.12,0
41531,4257,-1000.00,13412.13,14412.13,6205.67,9206.46,0.15,0
41532,4257,-1000.00,12412.13,13412.13,5775.98,8636.15,0.25,0
41533,4257,-1000.00,11412.13,12412.13,0.00,12710.66,0.44,0
41534,4257,-1000.00,10412.13,11412.13,4689.90,7722.23,0.27,0
41535,4257,-1000.00,9412.13,10412.13,5706.06,5706.06,0.02,0
41536,4257,-1000.00,8412.13,9412.13,2320.03,8092.10,0.16,0
41537,4257,-1000.00,7412.13,8412.13,0.00,9412.13,0.17,0
41538,4257,-1000.00,6412.13,7412.13,0.00,3216.88,0.24,0
41539,4257,-1000.00,5412.13,6412.13,0.00,1238.85,0.17,0
41540,4257,-1000.00,4412.13,5412.13,3866.74,0.00,0.01,0
41541,4257,-1000.00,3412.13,4412.13,1645.27,3766.85,0.32,0
41542,4257,-1000.00,2412.13,3412.13,0.00,4412.13,0.37,0
41543,4257,-1000.00,1412.13,2412.13,0.00,3412.13,0.02,0
41544,4257,-1000.00,412.13,1412.13,1130.57,1281.56,0.07,0
41545,4257,-1000.00,-587.87,412.13,34.52,1377.61,0.15,0
41546,4257,-62.01,-649.88,350.12,0.00,62.01,0.16,0
41547,4257,-350.12,-1000.00,0.00,101.79,248.33,0.35,0
41548,4258,-344.34,-344.34,655.66,0.00,344.34,0.31,0
41549,4258,1000.00,655.66,1655.66,338.68,0.00,0.23,1
41550,4258,-371.92,283.75,1283.75,0.00,371.92,0.44,0
41551,4258,1000.00,1283.75,2283.75,628.05,0.00,0.07,1
41552,4258,1000.00,2283.75,3283.75,1223.80,919.92,0.24,1
41553,4258,1000.00,3283.75,4283.75,1374.84,0.00,0.25,1
41554,4258,0.00,3283.75,4283.75,0.00,0.00,0.20,0
41555,4258,1000.00,4283.75,5283.75,3937.76,0.00,0.11,1
41556,4258,-1000.00,3283.75,4283.75,38.21,5245.53,0.15,0
41557,4258,0.00,3283.75,4283.75,0.00,0.00,0.16,0
41558,4258,-1000.00,2283.75,3283.75,0.00,2020.41,0.27,0
41559,4258,0.00,2283.75,3283.75,0.00,0.00,0.34,0
41560,4258,0.00,2283.75,3283.75,0.00,0.00,0.22,0
41561,4258,0.00,2283.75,3283.75,0.00,0.00,0.23,0
41562,4258,0.00,2283.75,3283.75,0.00,0.00,0.43,0
41563,4258,0.00,2283.75,3283.75,0.00,0.00,0.04,0
41564,4258,-1000.00,1283.75,2283.75,1143.22,2140.53,0.08,0
41565,4258,-1000.00,283.75,1283.75,0.00,1210.54,0.33,0
41566,4258,0.00,283.75,1283.75,0.00,0.00,0.18,0
41567,4258,-1000.00,-716.25,283.75,0.00,1079.97,0.11,0
41568,4258,-1000.00,-1716.25,-716.25,0.00,231.93,0.37,0
41569,4259,-1000.00,-1000.00,0.00,510.82,489.18,0.23,0
41570,4260,1000.00,1000.00,2000.00,161.14,838.86,0.42,1
41571,4260,-1000.00,0.00,1000.00,1196.01,803.99,0.16,0
41572,4260,1000.00,1000.00,2000.00,0.00,1000.00,0.14,1
41573,4260,1000.00,2000.00,3000.00,0.00,2000.00,0.37,1
41574,4260,1000.00,3000.00,4000.00,979.09,2020.91,0.13,1
41575,4260,-1000.00,2000.00,3000.00,1718.71,1398.70,0.19,0
41576,4260,1000.00,3000.00,4000.00,1048.25,1951.75,0.12,1
41577,4260,1000.00,4000.00,5000.00,97.38,3902.62,0.23,1
41578,4260,1000.00,5000.00,6000.00,341.37,4658.63,0.23,1
41579,4260,1000.00,6000.00,7000.00,0.00,3843.10,0.03,1
41580,4260,1000.00,7000.00,8000.00,0.00,7000.00,0.00,1
41581,4260,1000.00,8000.00,9000.00,137.67,6472.57,0.42,1
41582,4260,1000.00,9000.00,10000.00,0.00,3605.17,0.06,1
41583,4260,1000.00,10000.00,11000.00,0.00,2842.40,0.00,1
41584,4260,1000.00,11000.00,12000.00,3114.39,5437.90,0.29,1
41585,4260,-1000.00,10000.00,11000.00,12000.00,0.00,0.04,0
41586,4260,-1000.00,9000.00,10000.00,5500.00,5500.00,0.10,0
41587,4260,0.00,9000.00,10000.00,0.00,0.00,0.02,0
41588,4260,-1000.00,8000.00,9000.00,4536.87,0.00,0.26,0
41589,4260,-1000.00,7000.00,8000.00,0.00,9000.00,0.23,0
41590,4260,0.00,7000.00,8000.00,0.00,0.00,0.09,0
41591,4260,-1000.00,6000.00,7000.00,0.00,7242.80,0.04,0
41592,4260,-1000.00,5000.00,6000.00,0.00,3951.68,0.25,0
41593,4260,-1000.00,4000.00,5000.00,1644.52,1168.29,0.18,0
41594,4260,-1000.00,3000.00,4000.00,2633.16,2366.84,0.09,0
41595,4260,-1000.00,2000.00,3000.00,1490.15,2509.85,0.29,0
41596,4260,-1000.00,1000.00,2000.00,0.00,727.54,0.17,0
41597,4260,-1000.00,0.00,1000.00,906.94,1093.06,0.16,0
41598,4260,-1000.00,-1000.00,0.00,121.81,157.32,0.16,0
41599,4261,-1000.00,-1000.00,0.00,155.84,844.16,0.42,0
41600,4262,-1000.00,-1000.00,0.00,154.16,430.64,0.28,0
41601,4263,1000.00,1000.00,2000.00,376.68,322.58,0.32,1
41602,4263,-1000.00,0.00,1000.00,0.00,1436.70,0.21,0
41603,4263,-751.54,-751.54,248.46,0.00,751.54,0.34,0
41604,4263,1000.00,248.46,1248.46,119.08,0.00,0.29,1
41605,4263,0.00,248.46,1248.46,0.00,0.00,0.10,0
41606,4263,0.00,248.46,1248.46,0.00,0.00,0.33,0
41607,4263,1000.00,1248.46,2248.46,1022.98,0.00,0.09,1
41608,4263,-691.02,557.44,1557.44,0.00,691.02,0.29,0
41609,4263,-1000.00,-442.56,557.44,0.00,1557.44,0.10,0
41610,4263,1000.00,557.44,1557.44,306.79,250.64,0.16,1
41611,4263,1000.00,1557.44,2557.44,833.58,0.00,0.04,1
41612,4263,-1000.00,557.44,1557.44,586.00,1971.43,0.37,0
41613,4263,-1000.00,-442.56,557.44,0.00,1205.29,0.02,0
41614,4263,0.00,-442.56,557.44,0.00,0.00,0.36,0
41615,4263,1000.00,557.44,1557.44,210.30,0.00,0.13,1
41616,4263,0.00,557.44,1557.44,0.00,0.00,0.29,0
41617,4263,-858.30,-300.86,699.14,0.00,858.30,0.23,0
41618,4263,0.00,-300.86,699.14,0.00,0.00,0.22,0
41619,4263,1000.00,699.14,1699.14,264.86,0.00,0.16,1
41620,4263,-260.27,438.87,1438.87,0.00,260.27,0.34,0
41621,4263,0.00,438.87,1438.87,0.00,0.00,0.10,0
41622,4263,-1000.00,-561.13,438.87,285.55,1153.32,0.19,0
41623,4263,1000.00,438.87,1438.87,226.15,0.00,0.04,1
41624,4263,-1000.00,-561.13,438.87,349.61,1089.26,0.14,0
41625,4263,1000.00,438.87,1438.87,299.65,0.00,0.21,1
41626,4263,-542.71,-103.84,896.16,0.00,542.71,0.15,0
41627,4263,0.00,-103.84,896.16,0.00,0.00,0.01,0
41628,4263,-886.25,-990.09,9.91,328.85,557.40,0.37,0
41629,4263,-9.91,-1000.00,0.00,0.12,9.79,0.17,0
41630,4264,-1000.00,-1000.00,0.00,618.50,381.50,0.15,0
41631,4265,0.00,0.00,1000.00,0.00,0.00,0.32,0
41632,4265,-1000.00,-1000.00,0.00,0.00,468.95,0.27,0
41633,4266,-1000.00,-1000.00,0.00,264.69,735.31,0.12,0
41634,4267,-944.99,-944.99,55.01,0.00,944.99,0.21,0
41635,4267,-55.01,-1000.00,0.00,0.15,54.86,0.16,0
41636,4268,-453.11,-453.11,546.89,453.11,0.00,0.15,0
41637,4268,-1000.00,-1453.11,-453.11,0.00,415.65,0.22,0
41638,4269,-490.58,-490.58,509.42,0.00,490.58,0.25,0
41639,4269,-1000.00,-1490.58,-490.58,195.39,112.10,0.15,0
41640,4270,-1000.00,-1000.00,0.00,1000.00,0.00,0.02,0
41641,4271,1000.00,1000.00,2000.00,625.67,353.07,0.22,1
41642,4271,-473.67,526.33,1526.33,0.00,473.67,0.40,0
41643,4271,1000.00,1526.33,2526.33,791.15,620.71,0.24,1
41644,4271,0.00,1526.33,2526.33,0.00,0.00,0.19,0
41645,4271,-1000.00,526.33,1526.33,660.25,1866.08,0.09,0
41646,4271,-788.65,-262.32,737.68,0.00,788.65,0.30,0
41647,4271,0.00,-262.32,737.68,0.00,0.00,0.38,0
41648,4271,0.00,-262.32,737.68,0.00,0.00,0.11,0
41649,4271,-684.71,-947.03,52.97,0.00,684.71,0.03,0
41650,4271,-52.97,-1000.00,0.00,8.34,44.62,0.04,0
41651,4272,-981.68,-981.68,18.32,728.01,253.67,0.16,0
41652,4272,754.41,-227.27,772.73,0.00,6.23,0.29,1
41653,4272,1000.00,772.73,1772.73,386.36,386.36,0.07,1
41654,4272,1000.00,1772.73,2772.73,592.54,1180.19,0.24,1
41655,4272,1000.00,2772.73,3772.73,0.00,2772.73,0.32,1
41656,4272,1000.00,3772.73,4772.73,0.00,3772.73,0.43,1
41657,4272,-1000.00,2772.73,3772.73,2461.60,1077.71,0.13,0
41658,4272,1000.00,3772.73,4772.73,0.00,3772.73,0.09,1
41659,4272,1000.00,4772.73,5772.73,0.00,4772.73,0.02,1
41660,4272,1000.00,5772.73,6772.73,525.58,5247.15,0.39,1
41661,4272,-1000.00,4772.73,5772.73,4542.46,2230.27,0.10,0
41662,4272,1000.00,5772.73,6772.73,2886.36,2886.36,0.01,1
41663,4272,1000.00,6772.73,7772.73,0.00,5474.24,0.08,1
41664,4272,1000.00,7772.73,8772.73,2733.93,5038.80,0.25,1
41665,4272,1000.00,8772.73,9772.73,0.00,8772.73,0.32,1
41666,4272,-1000.00,7772.73,8772.73,5079.85,4692.88,0.41,0
41667,4272,1000.00,8772.73,9772.73,2240.96,6531.77,0.28,1
41668,4272,1000.00,9772.73,10772.73,0.00,9772.73,0.32,1
41669,4272,1000.00,10772.73,11772.73,0.00,10772.73,0.22,1
41670,4272,-1000.00,9772.73,10772.73,6512.88,673.08,0.08,0
41671,4272,1000.00,10772.73,11772.73,1851.34,8921.39,0.36,1
41672,4272,1000.00,11772.73,12772.73,1999.56,9773.17,0.40,1
41673,4272,0.00,11772.73,12772.73,0.00,0.00,0.06,0
41674,4272,1000.00,12772.73,13772.73,1783.19,10989.54,0.36,1
41675,4272,1000.00,13772.73,14772.73,6886.36,6886.36,0.19,1
41676,4272,1000.00,14772.73,15772.73,0.00,8846.80,0.35,1
41677,4272,1000.00,15772.73,16772.73,0.00,15772.73,0.07,1
41678,4272,1000.00,16772.73,17772.73,5169.64,11603.09,0.35,1
41679,4272,-1000.00,15772.73,16772.73,11181.95,6590.78,0.07,0
41680,4272,1000.00,16772.73,17772.73,0.00,16772.73,0.26,1
41681,4272,1000.00,17772.73,18772.73,0.00,2617.65,0.16,1
41682,4272,-1000.00,16772.73,17772.73,7301.42,3807.91,0.15,0
41683,4272,1000.00,17772.73,18772.73,2742.97,15029.76,0.41,1
41684,4272,1000.00,18772.73,19772.73,5706.59,13066.14,0.33,1
41685,4272,1000.00,19772.73,20772.73,5342.44,14430.29,0.36,1
41686,4272,1000.00,20772.73,21772.73,3161.37,17611.36,0.42,1
41687,4272,1000.00,21772.73,22772.73,0.00,1604.58,0.12,1
41688,4272,1000.00,22772.73,23772.73,0.00,22772.73,0.43,1
41689,4272,1000.00,23772.73,24772.73,6863.54,16909.19,0.33,1
41690,4272,1000.00,24772.73,25772.73,0.00,24772.73,0.20,1
41691,4272,-1000.00,23772.73,24772.73,20193.47,0.00,0.05,0
41692,4273,-1000.00,-1000.00,0.00,0.00,1000.00,0.13,0
41693,4274,-879.48,-879.48,120.52,102.12,777.36,0.36,0
41694,4274,-64.71,-944.19,55.81,0.00,64.71,0.23,0
41695,4274,-32.18,-976.36,23.64,0.00,32.18,0.28,0
41696,4274,-0.95,-977.32,22.68,0.00,0.95,0.16,0
41697,4274,-22.68,-1000.00,0.00,5.39,17.29,0.38,0
41698,4275,-443.51,-443.51,556.49,110.88,0.00,0.00,0
41699,4275,-173.30,-616.81,383.19,0.00,173.30,0.20,0
41700,4275,-368.19,-985.00,15.00,0.00,368.19,0.12,0
41701,4275,0.00,-985.00,15.00,0.00,0.00,0.12,0
41702,4275,-4.94,-989.94,10.06,1.24,0.00,0.25,0
41703,4275,0.00,-989.94,10.06,0.00,0.00,0.40,0
41704,4275,-10.06,-1000.00,0.00,4.35,5.71,0.01,0
41705,4276,0.00,0.00,1000.00,0.00,0.00,0.18,0
41706,4276,0.00,0.00,1000.00,0.00,0.00,0.02,0
41707,4276,-1000.00,-1000.00,0.00,0.00,372.38,0.40,0
41708,4277,-250.97,-250.97,749.03,250.97,0.00,0.04,0
41709,4277,-1000.00,-1250.97,-250.97,0.00,513.94,0.26,0
41710,4278,-1000.00,-1000.00,0.00,543.11,456.89,0.04,0
41711,4279,-1000.00,-1000.00,0.00,0.00,1000.00,0.29,0
41712,4280,-627.61,-627.61,372.39,0.00,627.61,0.36,0
41713,4280,-167.83,-795.44,204.56,0.00,167.83,0.14,0
41714,4280,1000.00,204.56,1204.56,109.26,95.30,0.04,1
41715,4280,-1000.00,-795.44,204.56,474.72,729.84,0.07,0
41716,4280,-204.56,-1000.00,0.00,0.00,204.56,0.21,0
41717,4281,-411.63,-411.63,588.37,411.63,0.00,0.05,0
41718,4281,-1000.00,-1411.63,-411.63,0.00,566.41,0.08,0
41719,4282,-1000.00,-1000.00,0.00,1000.00,0.00,0.07,0
41720,4283,-1000.00,-1000.00,0.00,119.56,880.44,0.39,0
41721,4284,-1000.00,-1000.00,0.00,73.04,926.96,0.42,0
41722,4285,1000.00,1000.00,2000.00,0.00,1000.00,0.06,1
41723,4285,1000.00,2000.00,3000.00,738.96,1261.04,0.12,1
41724,4285,1000.00,3000.00,4000.00,0.00,3000.00,0.15,1
41725,4285,1000.00,4000.00,5000.00,1015.75,2984.25,0.08,1
41726,4285,1000.00,5000.00,6000.00,0.00,5000.00,0.39,1
41727,4285,1000.00,6000.00,7000.00,0.00,6000.00,0.23,1
41728,4285,-1000.00,5000.00,6000.00,3224.93,1383.68,0.13,0
41729,4285,1000.00,6000.00,7000.00,2321.21,3678.79,0.29,1
41730,4285,1000.00,7000.00,8000.00,0.00,7000.00,0.44,1
41731,4285,1000.00,8000.00,9000.00,73.60,7926.40,0.25,1
41732,4285,1000.00,9000.00,10000.00,0.00,5560.13,0.34,1
41733,4285,1000.00,10000.00,11000.00,0.00,10000.00,0.17,1
41734,4285,1000.00,11000.00,12000.00,0.00,7416.53,0.26,1
41735,4285,1000.00,12000.00,13000.00,0.00,12000.00,0.08,1
41736,4285,1000.00,13000.00,14000.00,0.00,10761.30,0.42,1
41737,4285,1000.00,14000.00,15000.00,108.13,13891.87,0.12,1
41738,4285,-1000.00,13000.00,14000.00,1041.99,0.00,0.04,0
41739,4285,-1000.00,12000.00,13000.00,7781.09,6218.91,0.05,0
41740,4285,1000.00,13000.00,14000.00,0.00,12165.93,0.42,1
41741,4285,-1000.00,12000.00,13000.00,7023.69,6976.31,0.43,0
41742,4285,-1000.00,11000.00,12000.00,2169.40,10830.60,0.42,0
41743,4285,-1000.00,10000.00,11000.00,0.00,9380.21,0.09,0
41744,4285,-1000.00,9000.00,10000.00,5499.10,5500.90,0.15,0
41745,4285,-1000.00,8000.00,9000.00,0.00,8309.79,0.39,0
41746,4285,-1000.00,7000.00,8000.00,0.00,9000.00,0.16,0
41747,4285,-1000.00,6000.00,7000.00,2957.91,3071.68,0.22,0
41748,4285,-1000.00,5000.00,6000.00,0.00,4352.90,0.14,0
41749,4285,-1000.00,4000.00,5000.00,157.13,4258.84,0.39,0
41750,4285,-1000.00,3000.00,4000.00,625.83,4374.17,0.27,0
41751,4285,-1000.00,2000.00,3000.00,3238.61,400.25,0.06,0
41752,4285,-1000.00,1000.00,2000.00,198.86,2065.87,0.38,0
41753,4285,-1000.00,0.00,1000.00,905.33,1094.67,0.10,0
41754,4285,-1000.00,-1000.00,0.00,311.01,688.99,0.33,0
41755,4286,1000.00,1000.00,2000.00,181.28,818.72,0.42,1
41756,4286,1000.00,2000.00,3000.00,0.00,2000.00,0.06,1
41757,4286,1000.00,3000.00,4000.00,1362.78,1637.22,0.01,1
41758,4286,-1000.00,2000.00,3000.00,2226.61,1773.39,0.13,0
41759,4286,1000.00,3000.00,4000.00,658.23,2341.77,0.35,1
41760,4286,1000.00,4000.00,5000.00,388.56,3611.44,0.40,1
41761,4286,-1000.00,3000.00,4000.00,1877.28,0.00,0.00,0
41762,4286,1000.00,4000.00,5000.00,687.95,3312.05,0.42,1
41763,4286,1000.00,5000.00,6000.00,2150.88,2849.12,0.24,1
41764,4286,1000.00,6000.00,7000.00,2137.01,3862.99,0.40,1
41765,4286,1000.00,7000.00,8000.00,0.00,2422.84,0.08,1
41766,4286,1000.00,8000.00,9000.00,3330.51,4669.49,0.13,1
41767,4286,-1000.00,7000.00,8000.00,5103.42,3896.58,0.30,0
41768,4286,-1000.00,6000.00,7000.00,4641.85,3358.15,0.09,0
41769,4286,-1000.00,5000.00,6000.00,0.00,3291.67,0.11,0
41770,4286,-1000.00,4000.00,5000.00,3482.52,2517.48,0.11,0
41771,4286,-1000.00,3000.00,4000.00,0.00,5000.00,0.09,0
41772,4286,-1000.00,2000.00,3000.00,0.00,3034.73,0.12,0
41773,4286,-1000.00,1000.00,2000.00,0.00,818.59,0.13,0
41774,4286,-1000.00,0.00,1000.00,0.00,1807.76,0.24,0
41775,4286,-1000.00,-1000.00,0.00,0.00,255.12,0.08,0
41776,4287,1000.00,1000.00,2000.00,122.61,877.39,0.39,1
41777,4287,1000.00,2000.00,3000.00,0.00,1375.61,0.36,1
41778,4287,-1000.00,1000.00,2000.00,1763.77,1236.23,0.14,0
41779,4287,0.00,1000.00,2000.00,0.00,0.00,0.00,0
41780,4287,1000.00,2000.00,3000.00,0.00,2000.00,0.19,1
41781,4287,1000.00,3000.00,4000.00,0.00,3000.00,0.19,1
41782,4287,1000.00,4000.00,5000.00,2000.00,2000.00,0.05,1
41783,4287,1000.00,5000.00,6000.00,0.00,5000.00,0.41,1
41784,4287,1000.00,6000.00,7000.00,0.00,5447.37,0.24,1
41785,4287,1000.00,7000.00,8000.00,1188.66,5811.34,0.41,1
41786,4287,0.00,7000.00,8000.00,0.00,0.00,0.06,0
41787,4287,1000.00,8000.00,9000.00,4000.00,4000.00,0.20,1
41788,4287,1000.00,9000.00,10000.00,0.00,7840.96,0.43,1
41789,4287,1000.00,10000.00,11000.00,0.00,10000.00,0.05,1
41790,4287,1000.00,11000.00,12000.00,5500.00,5500.00,0.01,1
41791,4287,1000.00,12000.00,13000.00,0.00,11787.37,0.25,1
41792,4287,1000.00,13000.00,14000.00,0.00,11189.44,0.06,1
41793,4287,1000.00,14000.00,15000.00,0.00,14000.00,0.09,1
41794,4287,1000.00,15000.00,16000.00,1178.26,13821.74,0.43,1
41795,4287,1000.00,16000.00,17000.00,0.00,3184.75,0.18,1
41796,4287,1000.00,17000.00,18000.00,7533.56,9466.44,0.16,1
41797,4287,-1000.00,16000.00,17000.00,2731.74,0.00,0.04,0
41798,4287,1000.00,17000.00,18000.00,8175.06,8824.94,0.24,1
41799,4287,1000.00,18000.00,19000.00,0.00,18000.00,0.26,1
41800,4287,1000.00,19000.00,20000.00,9486.95,9513.05,0.01,1
41801,4287,1000.00,20000.00,21000.00,2200.55,17799.45,0.29,1
41802,4287,1000.00,21000.00,22000.00,3909.37,17090.63,0.10,1
41803,4287,1000.00,22000.00,23000.00,0.00,21708.11,0.34,1
41804,4287,1000.00,23000.00,24000.00,0.00,23000.00,0.32,1
41805,4287,1000.00,24000.00,25000.00,0.00,23796.83,0.36,1
41806,4287,1000.00,25000.00,26000.00,0.00,16973.43,0.23,1
41807,4287,1000.00,26000.00,27000.00,2069.61,23930.39,0.03,1
41808,4287,1000.00,27000.00,28000.00,1715.67,2794.46,0.14,1
41809,4287,1000.00,28000.00,29000.00,0.00,28000.00,0.22,1
41810,4287,1000.00,29000.00,30000.00,8743.13,20255.47,0.34,1
41811,4287,1000.00,30000.00,31000.00,0.00,6536.05,0.18,1
41812,4287,1000.00,31000.00,32000.00,0.00,31000.00,0.30,1
41813,4287,1000.00,32000.00,33000.00,0.00,32000.00,0.39,1
41814,4287,1000.00,33000.00,34000.00,0.00,16406.22,0.12,1
41815,4287,1000.00,34000.00,35000.00,0.00,34000.00,0.35,1
41816,4287,1000.00,35000.00,36000.00,0.00,28063.80,0.25,1
41817,4287,1000.00,36000.00,37000.00,15613.29,20386.71,0.25,1
41818,4287,1000.00,37000.00,38000.00,0.00,14137.05,0.22,1
41819,4287,1000.00,38000.00,39000.00,0.00,38000.00,0.16,1
41820,4287,1000.00,39000.00,40000.00,1602.07,37397.93,0.17,1
41821,4287,1000.00,40000.00,41000.00,0.00,40000.00,0.39,1
41822,4288,-1000.00,-1000.00,0.00,1000.00,0.00,0.01,0
41823,4289,-387.24,-387.24,612.76,0.00,387.24,0.44,0
41824,4289,-482.01,-869.25,130.75,26.35,455.66,0.39,0
41825,4289,-126.04,-995.29,4.71,0.00,126.04,0.15,0
41826,4289,-2.84,-998.13,1.87,0.00,2.84,0.11,0
41827,4289,-1.87,-1000.00,0.00,0.92,0.95,0.20,0
41828,4290,-304.41,-304.41,695.59,80.48,223.93,0.24,0
41829,4290,-619.52,-923.92,76.08,0.00,619.52,0.12,0
41830,4290,-50.15,-974.07,25.93,0.00,50.15,0.32,0
41831,4290,-25.93,-1000.00,0.00,9.19,16.73,0.32,0
41832,4291,0.00,0.00,1000.00,0.00,0.00,0.27,0
41833,4291,-539.79,-539.79,460.21,37.80,501.98,0.44,0
41834,4291,-293.52,-833.31,166.69,59.29,234.24,0.33,0
41835,4291,-163.72,-997.03,2.97,0.00,163.72,0.03,0
41836,4291,-191.48,-1188.52,-188.52,1.37,1.31,0.22,0
41837,4292,1000.00,1000.00,2000.00,500.00,500.00,0.01,1
41838,4292,1000.00,2000.00,3000.00,0.00,284.54,0.02,1
41839,4292,1000.00,3000.00,4000.00,0.00,2207.72,0.24,1
41840,4292,1000.00,4000.00,5000.00,0.00,4000.00,0.05,1
41841,4292,1000.00,5000.00,6000.00,2394.37,2605.63,0.12,1
41842,4292,1000.00,6000.00,7000.00,1679.48,4320.52,0.16,1
41843,4292,-1000.00,5000.00,6000.00,4429.40,2570.60,0.09,0
41844,4292,1000.00,6000.00,7000.00,0.00,6000.00,0.05,1
41845,4292,1000.00,7000.00,8000.00,47.05,3693.58,0.32,1
41846,4292,1000.00,8000.00,9000.00,0.00,8000.00,0.08,1
41847,4292,1000.00,9000.00,10000.00,1201.15,7798.85,0.32,1
41848,4292,1000.00,10000.00,11000.00,0.00,10000.00,0.34,1
41849,4292,1000.00,11000.00,12000.00,2193.39,8806.61,0.40,1
41850,4292,1000.00,12000.00,13000.00,0.00,5669.89,0.24,1
41851,4292,1000.00,13000.00,14000.00,0.00,7519.66,0.32,1
41852,4292,1000.00,14000.00,15000.00,0.00,14000.00,0.32,1
41853,4292,1000.00,15000.00,16000.00,3110.09,11889.91,0.40,1
41854,4292,1000.00,16000.00,17000.00,8000.00,8000.00,0.19,1
41855,4292,1000.00,17000.00,18000.00,0.00,17000.00,0.36,1
41856,4292,1000.00,18000.00,19000.00,9000.00,9000.00,0.41,1
41857,4292,-1000.00,17000.00,18000.00,13729.11,5270.89,0.06,0
41858,4292,-1000.00,16000.00,17000.00,7934.64,10065.36,0.38,0
41859,4292,-1000.00,15000.00,16000.00,9630.43,7369.57,0.15,0
41860,4292,-1000.00,14000.00,15000.00,0.00,16000.00,0.21,0
41861,4292,-1000.00,13000.00,14000.00,0.00,6086.92,0.19,0
41862,4292,-1000.00,12000.00,13000.00,12929.14,1070.86,0.12,0
41863,4292,-1000.00,11000.00,12000.00,421.39,12578.61,0.32,0
41864,4292,0.00,11000.00,12000.00,0.00,0.00,0.01,0
41865,4292,-1000.00,10000.00,11000.00,6173.21,5826.79,0.11,0
41866,4292,-1000.00,9000.00,10000.00,0.00,7603.78,0.39,0
41867,4292,-1000.00,8000.00,9000.00,3443.33,6556.67,0.30,0
41868,4292,-1000.00,7000.00,8000.00,4098.07,4901.93,0.16,0
41869,4292,-1000.00,6000.00,7000.00,0.00,8000.00,0.01,0
41870,4292,-1000.00,5000.00,6000.00,0.00,7000.00,0.26,0
41871,4292,-1000.00,4000.00,5000.00,2691.08,3308.92,0.08,0
41872,4292,0.00,4000.00,5000.00,0.00,0.00,0.00,0
41873,4292,-1000.00,3000.00,4000.00,1256.21,3743.79,0.21,0
41874,4292,-1000.00,2000.00,3000.00,2000.00,2000.00,0.02,0
41875,4292,-1000.00,1000.00,2000.00,0.00,2630.65,0.41,0
41876,4292,-1000.00,0.00,1000.00,887.42,1112.58,0.16,0
41877,4292,-777.52,-777.52,222.48,0.00,777.52,0.24,0
41878,4292,-222.48,-1000.00,0.00,78.75,143.73,0.12,0
41879,4293,1000.00,1000.00,2000.00,0.00,1000.00,0.13,1
41880,4293,1000.00,2000.00,3000.00,496.77,1503.23,0.38,1
41881,4293,1000.00,3000.00,4000.00,0.00,3000.00,0.01,1
41882,4293,1000.00,4000.00,5000.00,0.00,4000.00,0.35,1
41883,4293,1000.00,5000.00,6000.00,1505.29,3494.71,0.20,1
41884,4293,1000.00,6000.00,7000.00,0.00,2239.10,0.06,1
41885,4293,1000.00,7000.00,8000.00,972.25,6027.75,0.35,1
41886,4293,1000.00,8000.00,9000.00,0.00,8000.00,0.19,1
41887,4293,1000.00,9000.00,10000.00,0.00,9000.00,0.34,1
41888,4293,1000.00,10000.00,11000.00,0.00,4225.53,0.17,1
41889,4293,1000.00,11000.00,12000.00,0.00,11000.00,0.12,1
41890,4293,1000.00,12000.00,13000.00,0.00,12000.00,0.06,1
41891,4293,1000.00,13000.00,14000.00,0.00,13000.00,0.34,1
41892,4293,1000.00,14000.00,15000.00,0.00,7968.43,0.23,1
41893,4293,1000.00,15000.00,16000.00,4762.25,10237.75,0.34,1
41894,4293,1000.00,16000.00,17000.00,0.00,16000.00,0.19,1
41895,4293,1000.00,17000.00,18000.00,3380.18,13619.82,0.16,1
41896,4293,1000.00,18000.00,19000.00,0.00,18000.00,0.15,1
41897,4293,1000.00,19000.00,20000.00,3349.10,15650.90,0.42,1
41898,4293,1000.00,20000.00,21000.00,0.00,1617.55,0.14,1
41899,4293,1000.00,21000.00,22000.00,8897.05,12102.95,0.17,1
41900,4293,1000.00,22000.00,23000.00,0.00,15887.19,0.21,1
41901,4293,1000.00,23000.00,24000.00,0.00,7194.35,0.21,1
41902,4293,1000.00,24000.00,25000.00,8620.52,15379.48,0.31,1
41903,4293,-1000.00,23000.00,24000.00,15467.69,951.09,0.07,0
41904,4293,-1000.00,22000.00,23000.00,0.00,24000.00,0.38,0
41905,4293,-1000.00,21000.00,22000.00,0.00,19577.97,0.16,0
41906,4293,-1000.00,20000.00,21000.00,0.00,22000.00,0.08,0
41907,4293,-1000.00,19000.00,20000.00,4838.55,16161.45,0.15,0
41908,4293,-1000.00,18000.00,19000.00,9630.01,10369.99,0.05,0
41909,4293,-1000.00,17000.00,18000.00,0.00,19000.00,0.05,0
41910,4293,-1000.00,16000.00,17000.00,0.00,15860.30,0.01,0
41911,4293,-1000.00,15000.00,16000.00,0.00,5444.74,0.17,0
41912,4293,-1000.00,14000.00,15000.00,0.00,10708.11,0.37,0
41913,4293,-1000.00,13000.00,14000.00,4159.56,10840.44,0.31,0
41914,4293,-1000.00,12000.00,13000.00,1598.90,12401.10,0.40,0
41915,4293,-1000.00,11000.00,12000.00,6500.00,6500.00,0.02,0
41916,4293,-1000.00,10000.00,11000.00,0.00,12000.00,0.07,0
41917,4293,-1000.00,9000.00,10000.00,0.00,11000.00,0.35,0
41918,4293,-1000.00,8000.00,9000.00,0.00,10000.00,0.42,0
41919,4293,-1000.00,7000.00,8000.00,6278.69,2474.95,0.11,0
41920,4293,-1000.00,6000.00,7000.00,1292.18,5493.95,0.38,0
41921,4293,-1000.00,5000.00,6000.00,3041.82,3958.18,0.23,0
41922,4293,-1000.00,4000.00,5000.00,0.00,2889.97,0.23,0
41923,4293,-1000.00,3000.00,4000.00,0.00,5000.00,0.05,0
41924,4293,-1000.00,2000.00,3000.00,0.00,4000.00,0.04,0
41925,4293,-1000.00,1000.00,2000.00,0.00,3000.00,0.30,0
41926,4293,-1000.00,0.00,1000.00,0.00,2000.00,0.36,0
41927,4293,-1000.00,-1000.00,0.00,0.00,1000.00,0.00,0
41928,4294,-1000.00,-1000.00,0.00,0.00,306.51,0.23,0
41929,4295,0.00,0.00,1000.00,0.00,0.00,0.02,0
41930,4295,-231.70,-231.70,768.30,0.00,231.70,0.20,0
41931,4295,-768.30,-1000.00,0.00,187.99,580.31,0.40,0
41932,4296,-1000.00,-1000.00,0.00,271.69,728.31,0.35,0
41933,4297,-1000.00,-1000.00,0.00,0.00,1000.00,0.27,0
41934,4298,-1000.00,-1000.00,0.00,307.33,0.00,0.29,0
41935,4299,1000.00,1000.00,2000.00,31.70,968.30,0.44,1
41936,4299,1000.00,2000.00,3000.00,199.31,1800.69,0.26,1
41937,4299,-1000.00,1000.00,2000.00,1684.81,1315.19,0.02,0
41938,4299,1000.00,2000.00,3000.00,309.07,1349.62,0.37,1
41939,4299,0.00,2000.00,3000.00,0.00,0.00,0.00,0
41940,4299,1000.00,3000.00,4000.00,520.54,2479.46,0.19,1
41941,4299,1000.00,4000.00,5000.00,0.00,3006.77,0.09,1
41942,4299,1000.00,5000.00,6000.00,2166.23,2833.77,0.18,1
41943,4299,1000.00,6000.00,7000.00,3000.00,3000.00,0.02,1
41944,4299,1000.00,7000.00,8000.00,3235.02,3764.98,0.14,1
41945,4299,1000.00,8000.00,9000.00,0.00,8000.00,0.33,1
41946,4299,1000.00,9000.00,10000.00,0.00,8148.72,0.42,1
41947,4299,1000.00,10000.00,11000.00,0.00,1626.83,0.16,1
41948,4299,1000.00,11000.00,12000.00,0.00,9100.22,0.26,1
41949,4299,1000.00,12000.00,13000.00,4337.10,7662.90,0.11,1
41950,4299,-1000.00,11000.00,12000.00,9504.16,2885.88,0.09,0
41951,4299,1000.00,12000.00,13000.00,2442.12,9557.88,0.38,1
41952,4299,1000.00,13000.00,14000.00,3738.86,9261.14,0.13,1
41953,4299,1000.00,14000.00,15000.00,5795.91,8204.09,0.21,1
41954,4299,1000.00,15000.00,16000.00,7500.00,7500.00,0.04,1
41955,4299,1000.00,16000.00,17000.00,206.24,15793.76,0.16,1
41956,4299,-1000.00,15000.00,16000.00,5060.28,11939.72,0.39,0
41957,4299,-1000.00,14000.00,15000.00,8000.00,8000.00,0.03,0
41958,4299,-1000.00,13000.00,14000.00,0.00,15000.00,0.10,0
41959,4299,-1000.00,12000.00,13000.00,2003.38,11996.62,0.43,0
41960,4299,-1000.00,11000.00,12000.00,6673.63,6326.37,0.14,0
41961,4299,-1000.00,10000.00,11000.00,1443.28,10528.53,0.42,0
41962,4299,-1000.00,9000.00,10000.00,0.00,11000.00,0.43,0
41963,4299,-1000.00,8000.00,9000.00,0.00,9024.65,0.42,0
41964,4299,-1000.00,7000.00,8000.00,1316.69,7683.31,0.24,0
41965,4299,-1000.00,6000.00,7000.00,0.00,4880.39,0.09,0
41966,4299,-1000.00,5000.00,6000.00,1279.58,5720.42,0.38,0
41967,4299,-1000.00,4000.00,5000.00,1574.83,4425.17,0.14,0
41968,4299,-1000.00,3000.00,4000.00,2982.00,2018.00,0.11,0
41969,4299,-1000.00,2000.00,3000.00,0.00,3351.17,0.21,0
41970,4299,-279.07,1720.93,2720.93,0.00,279.07,0.15,0
41971,4299,-1000.00,720.93,1720.93,0.00,2099.62,0.41,0
41972,4299,1000.00,1720.93,2720.93,860.46,860.46,0.04,1
41973,4299,1000.00,2720.93,3720.93,957.04,1763.89,0.25,1
41974,4299,1000.00,3720.93,4720.93,436.20,3284.72,0.19,1
41975,4299,1000.00,4720.93,5720.93,1151.83,3569.10,0.39,1
41976,4299,1000.00,5720.93,6720.93,2065.82,3655.11,0.08,1
41977,4299,-1000.00,4720.93,5720.93,3541.03,3140.12,0.20,0
41978,4299,1000.00,5720.93,6720.93,0.00,5720.93,0.18,1
41979,4299,1000.00,6720.93,7720.93,3360.46,3360.46,0.00,1
41980,4299,1000.00,7720.93,8720.93,665.54,1939.74,0.20,1
41981,4299,1000.00,8720.93,9720.93,4360.46,4360.46,0.01,1
41982,4299,-1000.00,7720.93,8720.93,4087.46,0.00,0.04,0
41983,4299,1000.00,8720.93,9720.93,608.01,6343.93,0.40,1
41984,4299,-1000.00,7720.93,8720.93,5947.54,3773.38,0.15,0
41985,4299,1000.00,8720.93,9720.93,0.00,4578.99,0.31,1
41986,4299,1000.00,9720.93,10720.93,2431.90,7289.03,0.23,1
41987,4299,1000.00,10720.93,11720.93,0.00,10720.93,0.21,1
41988,4299,-1000.00,9720.93,10720.93,7161.72,4559.21,0.33,0
41989,4299,1000.00,10720.93,11720.93,0.00,10720.93,0.27,1
41990,4299,1000.00,11720.93,12720.93,0.00,9738.14,0.36,1
41991,4299,1000.00,12720.93,13720.93,0.00,8280.91,0.05,1
41992,4299,1000.00,13720.93,14720.93,0.00,13720.93,0.05,1
41993,4299,1000.00,14720.93,15720.93,0.00,14720.93,0.26,1
41994,4300,-1000.00,-1000.00,0.00,0.00,83.08,0.30,0
41995,4301,-481.46,-481.46,518.54,0.00,481.46,0.26,0
41996,4301,-81.15,-562.61,437.39,0.00,81.15,0.42,0
41997,4301,1000.00,437.39,1437.39,27.80,0.00,0.42,1
41998,4301,-451.95,-14.55,985.45,0.00,451.95,0.03,0
41999,4301,1000.00,985.45,1985.45,547.82,0.00,0.23,1
42000,4301,-1000.00,-14.55,985.45,390.08,1595.37,0.08,0
42001,4301,-985.45,-1000.00,0.00,461.58,523.87,0.15,0
42002,4302,-1000.00,-1000.00,0.00,0.00,1000.00,0.26,0
42003,4303,-1000.00,-1000.00,0.00,294.59,705.41,0.33,0
42004,4304,-1000.00,-1000.00,0.00,66.32,0.00,0.09,0
42005,4305,1000.00,1000.00,2000.00,462.90,0.00,0.32,1
42006,4305,0.00,1000.00,2000.00,0.00,0.00,0.29,0
42007,4305,-1000.00,0.00,1000.00,60.98,1674.80,0.18,0
42008,4305,-206.35,-206.35,793.65,0.00,206.35,0.40,0
42009,4305,-555.06,-761.41,238.59,0.00,555.06,0.27,0
42010,4305,0.00,-761.41,238.59,0.00,0.00,0.29,0
42011,4305,1000.00,238.59,1238.59,171.50,67.10,0.16,1
42012,4305,-417.87,-179.28,820.72,0.00,417.87,0.33,0
42013,4305,0.00,-179.28,820.72,0.00,0.00,0.02,0
42014,4305,0.00,-179.28,820.72,0.00,0.00,0.23,0
42015,4305,1000.00,820.72,1820.72,509.72,311.00,0.15,1
42016,4305,1000.00,1820.72,2820.72,359.09,344.90,0.41,1
42017,4305,-1000.00,820.72,1820.72,68.65,1939.96,0.26,0
42018,4305,1000.00,1820.72,2820.72,733.23,0.00,0.32,1
42019,4305,-1000.00,820.72,1820.72,0.00,2820.72,0.04,0
42020,4305,1000.00,1820.72,2820.72,738.39,0.00,0.05,1
42021,4305,-1000.00,820.72,1820.72,0.00,1170.29,0.23,0
42022,4305,0.00,820.72,1820.72,0.00,0.00,0.38,0
42023,4305,-1000.00,-179.28,820.72,0.00,1656.74,0.05,0
42024,4305,0.00,-179.28,820.72,0.00,0.00,0.02,0
42025,4305,0.00,-179.28,820.72,0.00,0.00,0.21,0
42026,4305,-820.72,-1000.00,0.00,0.00,820.72,0.01,0
42027,4306,-1000.00,-1000.00,0.00,0.00,980.38,0.07,0
42028,4307,0.00,0.00,1000.00,0.00,0.00,0.18,0
42029,4307,-1000.00,-1000.00,0.00,1000.00,0.00,0.00,0
42030,4308,-476.46,-476.46,523.54,0.00,476.46,0.25,0
42031,4308,-189.46,-665.91,334.09,0.00,189.46,0.36,0
42032,4308,-334.09,-1000.00,0.00,138.96,195.13,0.27,0
42033,4309,-1000.00,-1000.00,0.00,250.60,508.09,0.40,0
42034,4310,-870.60,-870.60,129.40,0.00,870.60,0.21,0
42035,4310,-23.46,-894.06,105.94,0.00,23.46,0.41,0
42036,4310,-1000.00,-1894.06,-894.06,33.31,6.40,0.13,0
42037,4311,-638.24,-638.24,361.76,0.00,638.24,0.08,0
42038,4311,-292.31,-930.55,69.45,0.00,292.31,0.11,0
42039,4311,1000.00,69.45,1069.45,24.24,0.00,0.21,1
42040,4311,1000.00,1069.45,2069.45,587.99,481.46,0.01,1
42041,4311,1000.00,2069.45,3069.45,204.84,0.00,0.16,1
42042,4311,-1000.00,1069.45,2069.45,954.39,2115.07,0.18,0
42043,4311,-328.16,741.30,1741.30,0.00,328.16,0.10,0
42044,4311,-784.29,-42.99,957.01,0.00,784.29,0.29,0
42045,4311,-957.01,-1000.00,-0.00,430.87,526.13,0.17,0
42046,4312,-755.99,-755.99,244.01,61.73,694.26,0.39,0
42047,4312,-244.01,-1000.00,0.00,0.00,244.01,0.01,0
42048,4313,-58.34,-58.34,941.66,58.34,0.00,0.14,0
42049,4313,0.00,-58.34,941.66,0.00,0.00,0.02,0
42050,4313,1000.00,941.66,1941.66,0.00,418.80,0.01,1
42051,4313,1000.00,1941.66,2941.66,690.79,1250.88,0.28,1
42052,4313,1000.00,2941.66,3941.66,1186.36,1755.30,0.24,1
42053,4313,-1000.00,1941.66,2941.66,1888.13,41.26,0.08,0
42054,4313,1000.00,2941.66,3941.66,0.00,2360.96,0.35,1
42055,4313,1000.00,3941.66,4941.66,981.40,2960.27,0.03,1
42056,4313,1000.00,4941.66,5941.66,1671.68,3269.98,0.33,1
42057,4313,1000.00,5941.66,6941.66,0.00,2165.37,0.17,1
42058,4313,1000.00,6941.66,7941.66,0.00,3647.37,0.03,1
42059,4313,1000.00,7941.66,8941.66,0.00,7941.66,0.30,1
42060,4313,1000.00,8941.66,9941.66,41.19,8900.47,0.34,1
42061,4313,1000.00,9941.66,10941.66,1256.09,8685.57,0.15,1
42062,4313,1000.00,10941.66,11941.66,0.00,10941.66,0.22,1
42063,4313,-1000.00,9941.66,10941.66,8159.42,1783.64,0.23,0
42064,4313,1000.00,10941.66,11941.66,1592.80,9348.87,0.43,1
42065,4313,1000.00,11941.66,12941.66,4395.68,7545.98,0.27,1
42066,4313,1000.00,12941.66,13941.66,6260.77,6680.89,0.15,1
42067,4313,1000.00,13941.66,14941.66,6970.83,6970.83,0.42,1
42068,4313,-1000.00,12941.66,13941.66,8281.45,6660.21,0.12,0
42069,4314,1000.00,1000.00,2000.00,0.00,161.52,0.13,1
42070,4314,1000.00,2000.00,3000.00,408.84,1303.82,0.35,1
42071,4314,1000.00,3000.00,4000.00,667.01,2332.99,0.40,1
42072,4314,1000.00,4000.00,5000.00,844.35,3155.65,0.32,1
42073,4314,1000.00,5000.00,6000.00,0.00,2964.32,0.11,1
42074,4314,1000.00,6000.00,7000.00,2133.31,3866.69,0.28,1
42075,4314,1000.00,7000.00,8000.00,3482.59,3517.41,0.44,1
42076,4314,-1000.00,6000.00,7000.00,5724.26,2275.74,0.05,0
42077,4314,1000.00,7000.00,8000.00,0.00,7000.00,0.22,1
42078,4314,1000.00,8000.00,9000.00,0.00,8000.00,0.24,1
42079,4314,1000.00,9000.00,10000.00,2390.38,3749.72,0.25,1
42080,4314,1000.00,10000.00,11000.00,4699.53,5300.47,0.06,1
42081,4314,1000.00,11000.00,12000.00,0.00,11000.00,0.36,1
42082,4314,1000.00,12000.00,13000.00,1303.37,10696.63,0.43,1
42083,4314,1000.00,13000.00,14000.00,0.00,5411.90,0.35,1
42084,4314,1000.00,14000.00,15000.00,0.00,11242.10,0.39,1
42085,4314,1000.00,15000.00,16000.00,6173.57,8826.43,0.10,1
42086,4314,1000.00,16000.00,17000.00,2712.37,13287.63,0.38,1
42087,4314,1000.00,17000.00,18000.00,6367.72,10632.28,0.01,1
42088,4314,-1000.00,16000.00,17000.00,7794.76,10205.24,0.20,0
42089,4314,-1000.00,15000.00,16000.00,0.00,14136.63,0.27,0
42090,4314,-1000.00,14000.00,15000.00,0.00,16000.00,0.11,0
42091,4314,-1000.00,13000.00,14000.00,3365.58,11634.42,0.39,0
42092,4314,-1000.00,12000.00,13000.00,2886.10,11113.90,0.18,0
42093,4314,-1000.00,11000.00,12000.00,0.00,13000.00,0.25,0
42094,4314,-1000.00,10000.00,11000.00,12000.00,0.00,0.04,0
42095,4314,-1000.00,9000.00,10000.00,4486.46,6513.54,0.28,0
42096,4314,-1000.00,8000.00,9000.00,0.00,10000.00,0.08,0
42097,4314,-1000.00,7000.00,8000.00,0.00,4824.46,0.21,0
42098,4314,-1000.00,6000.00,7000.00,0.00,8000.00,0.05,0
42099,4314,-1000.00,5000.00,6000.00,0.00,5047.20,0.36,0
42100,4314,-1000.00,4000.00,5000.00,2792.90,3207.10,0.24,0
42101,4314,0.00,4000.00,5000.00,0.00,0.00,0.01,0
42102,4314,0.00,4000.00,5000.00,0.00,0.00,0.01,0
42103,4314,-1000.00,3000.00,4000.00,655.98,1250.35,0.20,0
42104,4314,-1000.00,2000.00,3000.00,1711.17,2288.83,0.11,0
42105,4314,-1000.00,1000.00,2000.00,0.00,1829.30,0.03,0
42106,4314,-1000.00,0.00,1000.00,0.00,1412.92,0.36,0
42107,4314,-1000.00,-1000.00,0.00,0.00,1000.00,0.33,0
42108,4315,-1000.00,-1000.00,0.00,0.00,1000.00,0.07,0
42109,4316,-1000.00,-1000.00,0.00,385.24,614.76,0.09,0
42110,4317,-1000.00,-1000.00,0.00,198.76,801.24,0.30,0
42111,4317,-0.00,-1000.00,0.00,0.00,0.00,0.20,0
42112,4317,-0.00,-1000.00,-0.00,0.00,0.00,0.11,0
42113,4318,-1000.00,-1000.00,0.00,0.00,1000.00,0.43,0
42114,4319,-453.65,-453.65,546.35,453.65,0.00,0.16,0
42115,4319,0.00,-453.65,546.35,0.00,0.00,0.40,0
42116,4319,-25.31,-478.97,521.03,25.31,0.00,0.33,0
42117,4319,-349.19,-828.16,171.84,290.78,58.41,0.28,0
42118,4319,-1000.00,-1828.16,-828.16,0.00,113.59,0.41,0
42119,4320,-1000.00,-1000.00,0.00,379.89,620.11,0.14,0
42120,4321,-666.44,-666.44,333.56,0.00,666.44,0.15,0
42121,4321,-333.56,-1000.00,0.00,93.41,240.15,0.09,0
42122,4322,1000.00,1000.00,2000.00,391.40,0.00,0.24,1
42123,4322,0.00,1000.00,2000.00,0.00,0.00,0.08,0
42124,4322,1000.00,2000.00,3000.00,5.02,0.00,0.17,1
42125,4322,1000.00,3000.00,4000.00,1794.20,1205.80,0.19,1
42126,4322,1000.00,4000.00,5000.00,1085.05,0.00,0.40,1
42127,4322,1000.00,5000.00,6000.00,5000.00,0.00,0.03,1
42128,4322,-1000.00,4000.00,5000.00,0.00,2178.70,0.28,0
42129,4322,-1000.00,3000.00,4000.00,0.00,4136.14,0.17,0
42130,4322,-1000.00,2000.00,3000.00,0.00,3761.68,0.11,0
42131,4322,1000.00,3000.00,4000.00,499.61,473.19,0.24,1
42132,4322,1000.00,4000.00,5000.00,255.78,0.00,0.33,1
42133,4322,-1000.00,3000.00,4000.00,0.00,4372.33,0.07,0
42134,4322,1000.00,4000.00,5000.00,1933.43,1509.10,0.27,1
42135,4322,-409.80,3590.20,4590.20,0.00,409.80,0.29,0
42136,4322,1000.00,4590.20,5590.20,2684.15,0.00,0.15,1
42137,4322,0.00,4590.20,5590.20,0.00,0.00,0.26,0
42138,4322,-1000.00,3590.20,4590.20,2795.10,2795.10,0.22,0
42139,4322,1000.00,4590.20,5590.20,1145.32,406.18,0.25,1
42140,4322,1000.00,5590.20,6590.20,3625.42,1964.78,0.20,1
42141,4322,-1000.00,4590.20,5590.20,0.00,4334.39,0.43,0
42142,4322,-1000.00,3590.20,4590.20,0.00,1075.41,0.15,0
42143,4322,-849.44,2740.76,3740.76,0.00,849.44,0.09,0
42144,4322,-1000.00,1740.76,2740.76,2426.28,1118.79,0.23,0
42145,4322,-1000.00,740.76,1740.76,0.00,1589.05,0.27,0
42146,4322,0.00,740.76,1740.76,0.00,0.00,0.03,0
42147,4322,-100.36,640.40,1640.40,100.36,0.00,0.35,0
42148,4322,0.00,640.40,1640.40,0.00,0.00,0.08,0
42149,4322,-1000.00,-359.60,640.40,795.63,396.81,0.30,0
42150,4322,0.00,-359.60,640.40,0.00,0.00,0.23,0
42151,4322,-1000.00,-1359.60,-359.60,237.27,282.14,0.28,0
42152,4323,-390.70,-390.70,609.30,390.70,0.00,0.26,0
42153,4323,0.00,-390.70,609.30,0.00,0.00,0.19,0
42154,4323,-1000.00,-1390.70,-390.70,0.00,587.02,0.41,0
42155,4324,-785.78,-785.78,214.22,0.00,785.78,0.41,0
42156,4324,-214.22,-1000.00,0.00,61.88,152.34,0.31,0
42157,4325,0.00,0.00,1000.00,0.00,0.00,0.36,0
42158,4325,1000.00,1000.00,2000.00,1000.00,0.00,0.04,1
42159,4325,1000.00,2000.00,3000.00,1131.72,868.28,0.22,1
42160,4325,0.00,2000.00,3000.00,0.00,0.00,0.22,0
42161,4325,1000.00,3000.00,4000.00,1892.03,1107.97,0.07,1
42162,4325,1000.00,4000.00,5000.00,1407.38,0.00,0.30,1
42163,4325,-275.79,3724.21,4724.21,0.00,275.79,0.16,0
42164,4325,0.00,3724.21,4724.21,0.00,0.00,0.04,0
42165,4325,0.00,3724.21,4724.21,0.00,0.00,0.08,0
42166,4325,1000.00,4724.21,5724.21,1938.42,0.00,0.23,1
42167,4325,0.00,4724.21,5724.21,0.00,0.00,0.01,0
42168,4325,-1000.00,3724.21,4724.21,0.00,5724.21,0.21,0
42169,4325,-1000.00,2724.21,3724.21,578.65,4145.56,0.09,0
42170,4325,1000.00,3724.21,4724.21,2064.68,51.15,0.29,1
42171,4325,0.00,3724.21,4724.21,0.00,0.00,0.01,0
42172,4325,-1000.00,2724.21,3724.21,0.00,3637.47,0.30,0
42173,4325,0.00,2724.21,3724.21,0.00,0.00,0.03,0
42174,4325,0.00,2724.21,3724.21,0.00,0.00,0.15,0
42175,4325,1000.00,3724.21,4724.21,1044.59,307.77,0.39,1
42176,4325,-1000.00,2724.21,3724.21,1155.82,3568.39,0.37,0
42177,4325,-1000.00,1724.21,2724.21,1302.41,2316.39,0.22,0
42178,4325,-1000.00,724.21,1724.21,0.00,2724.21,0.13,0
42179,4325,-1000.00,-275.79,724.21,0.00,1365.62,0.19,0
42180,4325,-724.21,-1000.00,0.00,239.77,484.44,0.31,0
42181,4326,-852.01,-852.01,147.99,330.01,522.00,0.26,0
42182,4326,-16.18,-868.19,131.81,0.00,16.18,0.28,0
42183,4326,-43.53,-911.72,88.28,0.00,43.53,0.12,0
42184,4326,0.00,-911.72,88.28,0.00,0.00,0.06,0
42185,4326,-88.28,-1000.00,0.00,44.14,44.14,0.01,0
42186,4327,-1000.00,-1000.00,0.00,430.00,570.00,0.18,0
42187,4328,-1000.00,-1000.00,0.00,0.00,1000.00,0.37,0
42188,4329,-1000.00,-1000.00,0.00,0.00,1000.00,0.38,0
42189,4330,0.00,0.00,1000.00,0.00,0.00,0.08,0
42190,4330,-1000.00,-1000.00,0.00,620.10,379.90,0.19,0
42191,4331,-1000.00,-1000.00,0.00,76.74,391.08,0.35,0
42192,4332,0.00,0.00,1000.00,0.00,0.00,0.42,0
42193,4332,0.00,0.00,1000.00,0.00,0.00,0.29,0
42194,4332,0.00,0.00,1000.00,0.00,0.00,0.42,0
42195,4332,0.00,0.00,1000.00,0.00,0.00,0.15,0
42196,4332,-1000.00,-1000.00,0.00,0.00,1000.00,0.05,0
42197,4333,-1000.00,-1000.00,0.00,0.00,1000.00,0.05,0
42198,4334,-491.08,-491.08,508.92,0.00,491.08,0.30,0
42199,4334,-508.92,-1000.00,0.00,0.00,508.92,0.16,0
42200,4335,-1000.00,-1000.00,0.00,0.00,403.62,0.26,0
42201,4336,-1000.00,-1000.00,0.00,387.88,612.12,0.35,0
42202,4337,1000.00,1000.00,2000.00,0.00,1000.00,0.08,1
42203,4337,1000.00,2000.00,3000.00,1000.00,1000.00,0.03,1
42204,4337,1000.00,3000.00,4000.00,0.00,2495.28,0.05,1
42205,4337,1000.00,4000.00,5000.00,878.86,3121.14,0.41,1
42206,4337,1000.00,5000.00,6000.00,2173.85,2534.39,0.24,1
42207,4337,-1000.00,4000.00,5000.00,3525.55,2474.45,0.08,0
42208,4337,1000.00,5000.00,6000.00,2412.77,2587.23,0.13,1
42209,4337,1000.00,6000.00,7000.00,0.00,6000.00,0.30,1
42210,4337,1000.00,7000.00,8000.00,0.00,7000.00,0.07,1
42211,4337,1000.00,8000.00,9000.00,757.83,4766.35,0.35,1
42212,4337,1000.00,9000.00,10000.00,0.00,9000.00,0.26,1
42213,4337,1000.00,10000.00,11000.00,3897.15,6102.85,0.12,1
42214,4337,0.00,10000.00,11000.00,0.00,0.00,0.02,0
42215,4337,1000.00,11000.00,12000.00,0.00,8121.59,0.26,1
42216,4337,1000.00,12000.00,13000.00,3668.77,8331.23,0.34,1
42217,4337,0.00,12000.00,13000.00,0.00,0.00,0.01,0
42218,4337,1000.00,13000.00,14000.00,6500.00,6500.00,0.33,1
42219,4337,1000.00,14000.00,15000.00,0.00,6100.41,0.21,1
42220,4337,1000.00,15000.00,16000.00,0.00,3202.07,0.19,1
42221,4337,0.00,15000.00,16000.00,0.00,0.00,0.01,0
42222,4337,1000.00,16000.00,17000.00,0.00,16000.00,0.41,1
42223,4337,1000.00,17000.00,18000.00,0.00,17000.00,0.13,1
42224,4337,1000.00,18000.00,19000.00,9000.00,9000.00,0.18,1
42225,4337,1000.00,19000.00,20000.00,7194.24,11805.76,0.30,1
42226,4337,1000.00,20000.00,21000.00,4673.74,15326.26,0.39,1
42227,4337,1000.00,21000.00,22000.00,4200.97,16799.03,0.41,1
42228,4337,1000.00,22000.00,23000.00,2081.30,19918.70,0.44,1
42229,4337,1000.00,23000.00,24000.00,4945.42,18054.58,0.39,1
42230,4337,1000.00,24000.00,25000.00,0.00,24000.00,0.05,1
42231,4337,1000.00,25000.00,26000.00,0.00,4929.58,0.18,1
42232,4337,1000.00,26000.00,27000.00,2750.07,23249.93,0.43,1
42233,4337,1000.00,27000.00,28000.00,13500.00,13500.00,0.00,1
42234,4337,1000.00,28000.00,29000.00,599.59,10897.89,0.26,1
42235,4337,1000.00,29000.00,30000.00,10180.48,18819.52,0.32,1
42236,4337,1000.00,30000.00,31000.00,0.00,30000.00,0.34,1
42237,4337,-1000.00,29000.00,30000.00,21173.92,9826.08,0.07,0
42238,4337,1000.00,30000.00,31000.00,1524.17,28475.83,0.07,1
42239,4337,1000.00,31000.00,32000.00,0.00,31000.00,0.30,1
42240,4337,1000.00,32000.00,33000.00,0.00,32000.00,0.24,1
42241,4337,1000.00,33000.00,34000.00,0.00,33000.00,0.35,1
42242,4337,1000.00,34000.00,35000.00,8916.41,16368.21,0.28,1
42243,4337,1000.00,35000.00,36000.00,2262.93,32737.07,0.44,1
42244,4337,1000.00,36000.00,37000.00,11336.78,24663.22,0.28,1
42245,4337,1000.00,37000.00,38000.00,0.00,37000.00,0.04,1
42246,4337,1000.00,38000.00,39000.00,0.00,38000.00,0.42,1
42247,4337,1000.00,39000.00,40000.00,11856.10,27143.90,0.02,1
42248,4338,1000.00,1000.00,2000.00,0.00,479.48,0.23,1
42249,4338,1000.00,2000.00,3000.00,0.00,2000.00,0.25,1
42250,4338,1000.00,3000.00,4000.00,272.76,356.90,0.15,1
42251,4338,1000.00,4000.00,5000.00,0.00,4000.00,0.28,1
42252,4338,1000.00,5000.00,6000.00,721.05,2827.57,0.33,1
42253,4338,1000.00,6000.00,7000.00,0.00,6000.00,0.11,1
42254,4338,-1000.00,5000.00,6000.00,3920.34,719.75,0.09,0
42255,4338,1000.00,6000.00,7000.00,1304.70,4695.30,0.11,1
42256,4338,1000.00,7000.00,8000.00,3235.81,3764.19,0.14,1
42257,4338,1000.00,8000.00,9000.00,2939.98,5060.02,0.21,1
42258,4338,1000.00,9000.00,10000.00,3203.98,3555.63,0.22,1
42259,4338,1000.00,10000.00,11000.00,3612.78,5267.43,0.27,1
42260,4338,1000.00,11000.00,12000.00,0.00,5981.29,0.33,1
42261,4338,1000.00,12000.00,13000.00,0.00,12000.00,0.14,1
42262,4338,1000.00,13000.00,14000.00,0.00,13000.00,0.22,1
42263,4338,1000.00,14000.00,15000.00,4856.80,9143.20,0.27,1
42264,4338,1000.00,15000.00,16000.00,6062.02,8937.98,0.19,1
42265,4338,1000.00,16000.00,17000.00,2498.63,13501.37,0.02,1
42266,4338,1000.00,17000.00,18000.00,0.00,17000.00,0.02,1
42267,4338,1000.00,18000.00,19000.00,0.00,18000.00,0.04,1
42268,4338,1000.00,19000.00,20000.00,0.00,5217.45,0.21,1
42269,4338,1000.00,20000.00,21000.00,5772.29,14227.71,0.26,1
42270,4338,1000.00,21000.00,22000.00,9816.43,11183.57,0.04,1
42271,4338,1000.00,22000.00,23000.00,0.00,17269.61,0.41,1
42272,4338,-1000.00,21000.00,22000.00,6461.36,16538.64,0.37,0
42273,4338,-1000.00,20000.00,21000.00,9334.77,12665.23,0.20,0
42274,4338,-1000.00,19000.00,20000.00,8165.16,9132.00,0.23,0
42275,4338,-1000.00,18000.00,19000.00,2570.82,17429.18,0.20,0
42276,4338,-1000.00,17000.00,18000.00,18279.59,0.00,0.02,0
42277,4338,-1000.00,16000.00,17000.00,0.00,14173.43,0.41,0
42278,4338,-1000.00,15000.00,16000.00,0.00,17000.00,0.05,0
42279,4338,-1000.00,14000.00,15000.00,0.00,16000.00,0.42,0
42280,4338,-1000.00,13000.00,14000.00,2691.04,12308.96,0.08,0
42281,4338,-1000.00,12000.00,13000.00,2464.07,11535.93,0.25,0
42282,4338,-1000.00,11000.00,12000.00,0.00,13000.00,0.01,0
42283,4338,0.00,11000.00,12000.00,0.00,0.00,0.08,0
42284,4338,-1000.00,10000.00,11000.00,0.00,12000.00,0.10,0
42285,4338,-1000.00,9000.00,10000.00,0.00,9129.15,0.42,0
42286,4338,-1000.00,8000.00,9000.00,0.00,10000.00,0.06,0
42287,4338,-1000.00,7000.00,8000.00,3640.04,5359.96,0.23,0
42288,4338,-1000.00,6000.00,7000.00,1699.16,6300.84,0.40,0
42289,4338,-1000.00,5000.00,6000.00,2174.81,2638.82,0.23,0
42290,4338,-1000.00,4000.00,5000.00,0.00,5204.15,0.06,0
42291,4338,-1000.00,3000.00,4000.00,0.00,5000.00,0.34,0
42292,4338,-1000.00,2000.00,3000.00,0.00,4000.00,0.08,0
42293,4339,-1000.00,-1000.00,0.00,173.34,826.66,0.15,0
42294,4340,0.00,0.00,1000.00,0.00,0.00,0.02,0
42295,4340,-1000.00,-1000.00,0.00,153.86,846.14,0.37,0
42296,4341,-1000.00,-1000.00,0.00,0.00,196.51,0.43,0
42297,4342,-1000.00,-1000.00,0.00,339.39,660.61,0.00,0
42298,4343,-419.33,-419.33,580.67,0.00,419.33,0.34,0
42299,4343,-6.36,-425.69,574.31,0.00,6.36,0.06,0
42300,4343,-490.27,-915.95,84.05,0.00,490.27,0.12,0
42301,4343,1000.00,84.05,1084.05,30.42,0.00,0.37,1
42302,4343,-737.80,-653.75,346.25,233.93,503.87,0.41,0
42303,4343,1000.00,346.25,1346.25,176.28,169.96,0.00,1
42304,4343,1000.00,1346.25,2346.25,103.78,0.00,0.43,1
42305,4343,0.00,1346.25,2346.25,0.00,0.00,0.13,0
42306,4343,0.00,1346.25,2346.25,0.00,0.00,0.21,0
42307,4343,-1000.00,346.25,1346.25,1160.23,1186.02,0.08,0
42308,4343,-1000.00,-653.75,346.25,529.28,816.96,0.23,0
42309,4343,-346.25,-1000.00,0.00,171.05,175.19,0.43,0
42310,4344,1000.00,1000.00,2000.00,649.51,350.49,0.20,1
42311,4344,0.00,1000.00,2000.00,0.00,0.00,0.19,0
42312,4344,0.00,1000.00,2000.00,0.00,0.00,0.23,0
42313,4344,1000.00,2000.00,3000.00,2000.00,0.00,0.03,1
42314,4344,1000.00,3000.00,4000.00,3000.00,0.00,0.03,1
42315,4344,-143.99,2856.01,3856.01,0.00,143.99,0.20,0
42316,4344,0.00,2856.01,3856.01,0.00,0.00,0.21,0
42317,4344,1000.00,3856.01,4856.01,2644.83,1211.18,0.20,1
42318,4344,-1000.00,2856.01,3856.01,832.56,3562.41,0.37,0
42319,4344,1000.00,3856.01,4856.01,2644.90,1211.11,0.08,1
42320,4344,1000.00,4856.01,5856.01,2453.32,0.00,0.17,1
42321,4344,-1000.00,3856.01,4856.01,0.00,2561.45,0.39,0
42322,4344,-1000.00,2856.01,3856.01,0.00,4856.01,0.40,0
42323,4344,1000.00,3856.01,4856.01,3171.62,338.43,0.17,1
42324,4344,0.00,3856.01,4856.01,0.00,0.00,0.16,0
42325,4344,-1000.00,2856.01,3856.01,0.00,3621.28,0.20,0
42326,4344,0.00,2856.01,3856.01,0.00,0.00,0.13,0
42327,4344,-1000.00,1856.01,2856.01,0.00,3856.01,0.15,0
42328,4344,-1000.00,856.01,1856.01,0.00,2203.78,0.32,0
42329,4344,-1000.00,-143.99,856.01,137.90,1718.11,0.44,0
42330,4344,-774.62,-918.62,81.38,657.35,117.28,0.19,0
42331,4344,-1000.00,-1918.62,-918.62,27.68,53.71,0.21,0
42332,4345,1000.00,1000.00,2000.00,856.72,0.00,0.15,1
42333,4345,1000.00,2000.00,3000.00,1240.57,759.43,0.08,1
42334,4345,-1000.00,1000.00,2000.00,0.00,2252.33,0.01,0
42335,4345,-1000.00,0.00,1000.00,0.00,1314.82,0.13,0
42336,4345,-105.04,-105.04,894.96,0.00,105.04,0.44,0
42337,4345,-894.96,-1000.00,0.00,356.63,538.34,0.27,0
42338,4346,-901.74,-901.74,98.26,0.00,901.74,0.43,0
42339,4346,-24.96,-926.70,73.30,0.00,24.96,0.13,0
42340,4346,-73.30,-1000.00,0.00,28.86,44.45,0.23,0
42341,4347,-1000.00,-1000.00,0.00,0.00,1000.00,0.31,0
42342,4348,-0.37,-0.37,999.63,0.00,0.37,0.43,0
42343,4348,-472.47,-472.85,527.15,158.90,313.58,0.37,0
42344,4348,-126.63,-599.47,400.53,29.18,97.44,0.42,0
42345,4348,-341.15,-940.62,59.38,0.00,341.15,0.43,0
42346,4348,-54.62,-995.24,4.76,23.03,31.59,0.25,0
42347,4348,-1.65,-996.88,3.12,0.28,1.36,0.44,0
42348,4348,-3.12,-1000.00,0.00,0.00,3.12,0.27,0
42349,4349,-1000.00,-1000.00,0.00,297.87,702.13,0.36,0
42350,4350,-1000.00,-1000.00,0.00,0.00,686.22,0.36,0
42351,4351,0.00,0.00,1000.00,0.00,0.00,0.07,0
42352,4351,-574.72,-574.72,425.28,0.00,574.72,0.32,0
42353,4351,-339.43,-914.15,85.85,0.00,339.43,0.40,0
42354,4351,-85.85,-1000.00,0.00,0.00,85.85,0.12,0
42355,4352,1000.00,1000.00,2000.00,589.75,71.12,0.27,1
42356,4352,1000.00,2000.00,3000.00,1356.35,0.00,0.22,1
42357,4352,1000.00,3000.00,4000.00,2726.53,273.47,0.10,1
42358,4352,-498.17,2501.83,3501.83,0.00,498.17,0.28,0
42359,4352,1000.00,3501.83,4501.83,1329.12,0.00,0.32,1
42360,4352,0.00,3501.83,4501.83,0.00,0.00,0.14,0
42361,4352,-1000.00,2501.83,3501.83,0.00,2493.28,0.26,0
42362,4352,-1000.00,1501.83,2501.83,1097.99,2403.84,0.32,0
42363,4352,1000.00,2501.83,3501.83,204.79,0.00,0.23,1
42364,4352,1000.00,3501.83,4501.83,2069.97,23.73,0.27,1
42365,4352,0.00,3501.83,4501.83,0.00,0.00,0.18,0
42366,4352,0.00,3501.83,4501.83,0.00,0.00,0.15,0
42367,4352,-1000.00,2501.83,3501.83,0.00,3531.35,0.41,0
42368,4352,-1000.00,1501.83,2501.83,0.00,1021.44,0.39,0
42369,4352,-1000.00,501.83,1501.83,0.00,2501.83,0.39,0
42370,4352,0.00,501.83,1501.83,0.00,0.00,0.26,0
42371,4352,-1000.00,-498.17,501.83,0.00,1082.13,0.11,0
42372,4352,-130.34,-628.50,371.50,0.00,130.34,0.13,0
42373,4352,1000.00,371.50,1371.50,277.68,0.00,0.01,1
42374,4352,-1000.00,-628.50,371.50,0.00,1371.50,0.12,0
42375,4352,-371.50,-1000.00,0.00,185.75,185.75,0.02,0
42376,4353,-1000.00,-1000.00,0.00,0.00,1000.00,0.11,0
42377,4354,-927.14,-927.14,72.86,54.28,872.85,0.18,0
42378,4354,-1000.00,-1927.14,-927.14,56.69,0.00,0.11,0
42379,4355,-1000.00,-1000.00,0.00,0.00,543.16,0.34,0
42380,4356,-1000.00,-1000.00,0.00,0.00,1000.00,0.10,0
42381,4357,-1000.00,-1000.00,0.00,69.74,930.26,0.08,0
42382,4357,-0.00,-1000.00,0.00,0.00,0.00,0.31,0
42383,4358,0.00,0.00,1000.00,0.00,0.00,0.07,0
42384,4358,0.00,0.00,1000.00,0.00,0.00,0.12,0
42385,4358,-1000.00,-1000.00,0.00,270.89,729.11,0.10,0
42386,4359,-1000.00,-1000.00,0.00,485.33,514.67,0.10,0
42387,4360,-985.39,-985.39,14.61,126.45,858.94,0.42,0
42388,4360,-1000.00,-1985.39,-985.39,7.31,7.30,0.22,0
42389,4361,-373.07,-373.07,626.93,373.07,0.00,0.36,0
42390,4361,-43.63,-416.70,583.30,43.63,0.00,0.37,0
42391,4361,-1000.00,-1416.70,-416.70,0.00,583.30,0.38,0
42392,4362,1000.00,1000.00,2000.00,0.00,716.56,0.26,1
42393,4362,0.00,1000.00,2000.00,0.00,0.00,0.11,0
42394,4362,1000.00,2000.00,3000.00,850.97,1149.03,0.28,1
42395,4362,-850.19,1149.81,2149.81,850.19,0.00,0.09,0
42396,4362,1000.00,2149.81,3149.81,485.60,1664.22,0.40,1
42397,4362,1000.00,3149.81,4149.81,0.00,1319.24,0.27,1
42398,4362,1000.00,4149.81,5149.81,0.00,2781.93,0.20,1
42399,4362,1000.00,5149.81,6149.81,2235.43,2914.38,0.05,1
42400,4362,1000.00,6149.81,7149.81,1439.56,4710.25,0.36,1
42401,4362,1000.00,7149.81,8149.81,0.00,5047.21,0.16,1
42402,4362,1000.00,8149.81,9149.81,2238.87,5910.94,0.36,1
42403,4362,1000.00,9149.81,10149.81,0.00,6776.77,0.07,1
42404,4362,1000.00,10149.81,11149.81,0.00,10149.81,0.43,1
42405,4362,-1000.00,9149.81,10149.81,4668.70,0.00,0.09,0
42406,4362,1000.00,10149.81,11149.81,2556.60,7593.21,0.37,1
42407,4362,1000.00,11149.81,12149.81,5293.22,5856.59,0.02,1
42408,4362,-1000.00,10149.81,11149.81,2188.49,0.00,0.06,0
42409,4362,1000.00,11149.81,12149.81,2792.93,8356.88,0.30,1
42410,4362,1000.00,12149.81,13149.81,0.00,12149.81,0.44,1
42411,4362,1000.00,13149.81,14149.81,597.71,12352.90,0.44,1
42412,4362,-1000.00,12149.81,13149.81,8557.51,3886.71,0.13,0
42413,4362,1000.00,13149.81,14149.81,0.00,13149.81,0.07,1
42414,4362,1000.00,14149.81,15149.81,0.00,10883.41,0.22,1
42415,4362,1000.00,15149.81,16149.81,0.00,15149.81,0.37,1
42416,4362,-1000.00,14149.81,15149.81,8074.91,8074.91,0.19,0
42417,4362,-1000.00,13149.81,14149.81,0.00,5593.31,0.06,0
42418,4362,-1000.00,12149.81,13149.81,0.00,4473.29,0.09,0
42419,4362,-1000.00,11149.81,12149.81,6574.91,6574.91,0.12,0
42420,4362,-1000.00,10149.81,11149.81,4679.83,7469.98,0.12,0
42421,4362,-1000.00,9149.81,10149.81,0.00,8260.72,0.01,0
42422,4362,-1000.00,8149.81,9149.81,6149.66,4000.15,0.15,0
42423,4362,-1000.00,7149.81,8149.81,0.00,8310.58,0.44,0
42424,4362,-1000.00,6149.81,7149.81,0.00,8149.81,0.23,0
42425,4362,-1000.00,5149.81,6149.81,1221.71,5928.10,0.30,0
42426,4362,-1000.00,4149.81,5149.81,2418.95,3730.86,0.29,0
42427,4362,-1000.00,3149.81,4149.81,0.00,3824.79,0.38,0
42428,4362,-1000.00,2149.81,3149.81,0.00,4149.81,0.12,0
42429,4362,-1000.00,1149.81,2149.81,1753.02,1396.79,0.13,0
42430,4362,-1000.00,149.81,1149.81,0.00,1579.55,0.17,0
42431,4362,-1000.00,-850.19,149.81,0.00,1149.81,0.05,0
42432,4362,0.00,-850.19,149.81,0.00,0.00,0.04,0
42433,4362,-149.81,-1000.00,0.00,0.00,149.81,0.16,0
42434,4363,-1000.00,-1000.00,0.00,0.00,1000.00,0.13,0
42435,4364,-786.87,-786.87,213.13,0.00,786.87,0.02,0
42436,4364,-75.91,-862.78,137.22,0.00,75.91,0.03,0
42437,4364,-1000.00,-1862.78,-862.78,77.06,60.15,0.17,0
42438,4365,0.00,0.00,1000.00,0.00,0.00,0.32,0
42439,4365,0.00,0.00,1000.00,0.00,0.00,0.43,0
42440,4365,1000.00,1000.00,2000.00,1000.00,0.00,0.03,1
42441,4365,-1000.00,0.00,1000.00,0.00,2000.00,0.06,0
42442,4365,-1000.00,-1000.00,0.00,139.61,860.39,0.43,0
42443,4366,1000.00,1000.00,2000.00,0.00,671.82,0.41,1
42444,4366,-776.47,223.53,1223.53,776.47,0.00,0.11,0
42445,4366,1000.00,1223.53,2223.53,0.00,1078.67,0.43,1
42446,4366,1000.00,2223.53,3223.53,0.00,43.35,0.09,1
42447,4366,1000.00,3223.53,4223.53,0.00,3223.53,0.07,1
42448,4366,1000.00,4223.53,5223.53,1667.59,2555.94,0.15,1
42449,4366,1000.00,5223.53,6223.53,1928.39,3295.14,0.31,1
42450,4366,1000.00,6223.53,7223.53,0.00,4441.55,0.17,1
42451,4366,-1000.00,5223.53,6223.53,4105.08,1413.84,0.11,0
42452,4366,1000.00,6223.53,7223.53,324.54,5898.99,0.31,1
42453,4366,1000.00,7223.53,8223.53,0.00,6805.79,0.43,1
42454,4366,-1000.00,6223.53,7223.53,2097.83,0.00,0.09,0
42455,4366,1000.00,7223.53,8223.53,3611.76,3611.76,0.03,1
42456,4366,-1000.00,6223.53,7223.53,2791.87,278.79,0.10,0
42457,4366,-1000.00,5223.53,6223.53,3655.65,3567.87,0.18,0
42458,4366,1000.00,6223.53,7223.53,1683.02,4540.51,0.31,1
42459,4366,1000.00,7223.53,8223.53,2405.73,4817.80,0.16,1
42460,4366,1000.00,8223.53,9223.53,0.00,6417.48,0.40,1
42461,4366,1000.00,9223.53,10223.53,3491.46,5732.07,0.14,1
42462,4366,1000.00,10223.53,11223.53,2987.82,7235.71,0.28,1
42463,4366,1000.00,11223.53,12223.53,2899.39,8324.14,0.38,1
42464,4366,1000.00,12223.53,13223.53,6111.76,6111.76,0.32,1
42465,4366,1000.00,13223.53,14223.53,0.00,4665.12,0.14,1
42466,4366,1000.00,14223.53,15223.53,3418.78,10804.75,0.23,1
42467,4366,0.00,14223.53,15223.53,0.00,0.00,0.01,0
42468,4366,-1000.00,13223.53,14223.53,10798.47,3425.25,0.10,0
42469,4366,1000.00,14223.53,15223.53,1391.03,12832.49,0.33,1
42470,4366,1000.00,15223.53,16223.53,0.00,10911.22,0.20,1
42471,4366,1000.00,16223.53,17223.53,6608.61,9614.92,0.09,1
42472,4366,-1000.00,15223.53,16223.53,8776.85,8446.68,0.21,0
42473,4366,-1000.00,14223.53,15223.53,12172.79,1444.58,0.06,0
42474,4366,1000.00,15223.53,16223.53,3093.75,12129.78,0.07,1
42475,4366,1000.00,16223.53,17223.53,7405.29,8818.24,0.19,1
42476,4366,1000.00,17223.53,18223.53,0.00,17223.53,0.39,1
42477,4366,1000.00,18223.53,19223.53,5457.35,10573.70,0.37,1
42478,4366,-1000.00,17223.53,18223.53,10588.00,0.00,0.02,0
42479,4366,1000.00,18223.53,19223.53,7884.80,10338.72,0.19,1
42480,4366,1000.00,19223.53,20223.53,8644.73,10578.80,0.13,1
42481,4366,-1000.00,18223.53,19223.53,14318.08,5905.45,0.07,0
42482,4366,1000.00,19223.53,20223.53,586.35,14622.04,0.41,1
42483,4366,1000.00,20223.53,21223.53,0.00,20223.53,0.17,1
42484,4366,1000.00,21223.53,22223.53,10194.33,11029.20,0.13,1
42485,4366,1000.00,22223.53,23223.53,9004.65,13218.87,0.23,1
42486,4366,1000.00,23223.53,24223.53,265.10,22958.43,0.44,1
42487,4366,1000.00,24223.53,25223.53,0.00,17974.13,0.40,1
42488,4366,1000.00,25223.53,26223.53,0.00,14167.55,0.34,1
42489,4366,1000.00,26223.53,27223.53,0.00,26223.53,0.19,1
42490,4366,1000.00,27223.53,28223.53,13611.76,13611.76,0.10,1
42491,4366,1000.00,28223.53,29223.53,0.00,24126.01,0.33,1
42492,4366,1000.00,29223.53,30223.53,0.00,29223.53,0.39,1
42493,4366,1000.00,30223.53,31223.53,0.00,28150.49,0.31,1
42494,4366,0.00,30223.53,31223.53,0.00,0.00,0.11,0
42495,4366,-1000.00,29223.53,30223.53,15898.54,15324.99,0.04,0
42496,4366,0.00,29223.53,30223.53,0.00,0.00,0.09,0
42497,4366,1000.00,30223.53,31223.53,0.00,11153.28,0.12,1
42498,4366,1000.00,31223.53,32223.53,15591.53,15632.00,0.07,1
42499,4366,1000.00,32223.53,33223.53,15175.26,17048.27,0.20,1
42500,4366,1000.00,33223.53,34223.53,9899.50,23324.03,0.27,1
42501,4366,1000.00,34223.53,35223.53,0.00,34223.53,0.06,1
42502,4366,1000.00,35223.53,36223.53,7954.64,27268.89,0.21,1
42503,4366,1000.00,36223.53,37223.53,0.00,35276.96,0.31,1
42504,4366,1000.00,37223.53,38223.53,7175.38,30048.14,0.11,1
42505,4366,-1000.00,36223.53,37223.53,23610.11,14613.41,0.06,0
42506,4366,1000.00,37223.53,38223.53,0.00,37223.53,0.06,1
42507,4366,1000.00,38223.53,39223.53,5969.04,21568.17,0.33,1
42508,4366,1000.00,39223.53,40223.53,0.00,39223.53,0.13,1
42509,4366,-1000.00,38223.53,39223.53,18513.34,14499.05,0.19,0
42510,4366,1000.00,39223.53,40223.53,8354.23,13195.16,0.23,1
42511,4366,1000.00,40223.53,41223.53,16043.94,24179.59,0.15,1
42512,4367,-1000.00,-1000.00,0.00,644.25,355.75,0.11,0
42513,4368,-1000.00,-1000.00,0.00,31.08,0.00,0.04,0
42514,4369,-991.10,-991.10,8.90,130.79,860.31,0.16,0
42515,4369,641.18,-349.92,650.08,5.09,3.81,0.03,1
42516,4369,1000.00,650.08,1650.08,305.75,261.35,0.27,1
42517,4369,-356.41,293.67,1293.67,0.00,356.41,0.41,0
42518,4369,-1000.00,-706.33,293.67,646.84,646.84,0.07,0
42519,4369,0.00,-706.33,293.67,0.00,0.00,0.28,0
42520,4369,1000.00,293.67,1293.67,34.82,0.00,0.32,1
42521,4369,0.00,293.67,1293.67,0.00,0.00,0.16,0
42522,4369,1000.00,1293.67,2293.67,169.81,0.00,0.10,1
42523,4369,-1000.00,293.67,1293.67,621.63,1672.04,0.35,0
42524,4369,-1000.00,-706.33,293.67,0.00,1293.67,0.18,0
42525,4369,0.00,-706.33,293.67,0.00,0.00,0.11,0
42526,4369,-293.67,-1000.00,0.00,93.98,199.69,0.34,0
42527,4370,-206.30,-206.30,793.70,0.00,206.30,0.15,0
42528,4370,-638.79,-845.09,154.91,0.00,638.79,0.35,0
42529,4370,-33.73,-878.82,121.18,16.70,17.03,0.14,0
42530,4370,-1000.00,-1878.82,-878.82,82.44,38.74,0.10,0
42531,4371,0.00,0.00,1000.00,0.00,0.00,0.10,0
42532,4371,-1000.00,-1000.00,0.00,0.00,1000.00,0.18,0
42533,4372,0.00,0.00,1000.00,0.00,0.00,0.37,0
42534,4372,0.00,0.00,1000.00,0.00,0.00,0.39,0
42535,4372,-1000.00,-1000.00,0.00,0.00,1000.00,0.30,0
42536,4373,-513.04,-513.04,486.96,0.00,513.04,0.36,0
42537,4373,0.00,-513.04,486.96,0.00,0.00,0.08,0
42538,4373,-486.96,-1000.00,0.00,199.61,287.36,0.18,0
42539,4374,-1000.00,-1000.00,0.00,516.38,483.62,0.07,0
42540,4375,0.00,0.00,1000.00,0.00,0.00,0.10,0
42541,4375,-888.00,-888.00,112.00,72.82,815.19,0.30,0
42542,4375,-91.58,-979.59,20.41,13.06,78.53,0.38,0
42543,4375,-20.41,-1000.00,0.00,0.00,20.41,0.11,0
42544,4376,-621.47,-621.47,378.53,561.67,59.80,0.28,0
42545,4376,0.00,-621.47,378.53,0.00,0.00,0.23,0
42546,4376,-1000.00,-1621.47,-621.47,0.00,309.38,0.14,0
42547,4377,-1000.00,-1000.00,0.00,225.53,774.47,0.11,0
42548,4378,-638.34,-638.34,361.66,367.65,270.69,0.18,0
42549,4378,1000.00,361.66,1361.66,162.76,198.89,0.14,1
42550,4378,1000.00,1361.66,2361.66,369.08,992.57,0.30,1
42551,4378,1000.00,2361.66,3361.66,0.00,2361.66,0.07,1
42552,4378,1000.00,3361.66,4361.66,1514.86,1846.80,0.08,1
42553,4378,1000.00,4361.66,5361.66,0.00,3559.41,0.29,1
42554,4378,1000.00,5361.66,6361.66,0.00,5361.66,0.38,1
42555,4378,1000.00,6361.66,7361.66,0.00,6361.66,0.16,1
42556,4378,1000.00,7361.66,8361.66,3680.83,3680.83,0.09,1
42557,4378,1000.00,8361.66,9361.66,0.00,8361.66,0.16,1
42558,4378,1000.00,9361.66,10361.66,0.00,5044.97,0.04,1
42559,4378,1000.00,10361.66,11361.66,0.00,10361.66,0.08,1
42560,4378,1000.00,11361.66,12361.66,4325.31,7036.35,0.16,1
42561,4378,1000.00,12361.66,13361.66,0.00,12361.66,0.37,1
42562,4378,1000.00,13361.66,14361.66,1721.12,3141.34,0.19,1
42563,4378,1000.00,14361.66,15361.66,0.00,14361.66,0.27,1
42564,4378,1000.00,15361.66,16361.66,6436.40,8925.26,0.20,1
42565,4378,1000.00,16361.66,17361.66,6378.22,9983.44,0.30,1
42566,4378,1000.00,17361.66,18361.66,0.00,17361.66,0.04,1
42567,4378,1000.00,18361.66,19361.66,2534.27,15827.39,0.43,1
42568,4378,1000.00,19361.66,20361.66,6077.64,13284.02,0.23,1
42569,4378,1000.00,20361.66,21361.66,4563.15,15798.50,0.08,1
42570,4378,1000.00,21361.66,22361.66,0.00,19121.32,0.24,1
42571,4378,1000.00,22361.66,23361.66,4769.36,17592.30,0.40,1
42572,4378,1000.00,23361.66,24361.66,0.00,23361.66,0.01,1
42573,4378,1000.00,24361.66,25361.66,12180.83,12180.83,0.23,1
42574,4378,1000.00,25361.66,26361.66,0.00,15338.47,0.06,1
42575,4378,1000.00,26361.66,27361.66,4192.44,9241.48,0.24,1
42576,4378,1000.00,27361.66,28361.66,0.00,27361.66,0.22,1
42577,4378,1000.00,28361.66,29361.66,0.00,16412.27,0.34,1
42578,4378,1000.00,29361.66,30361.66,0.00,5609.07,0.17,1
42579,4378,1000.00,30361.66,31361.66,3094.19,14114.56,0.29,1
42580,4378,-1000.00,29361.66,30361.66,19803.22,11558.44,0.23,0
42581,4378,1000.00,30361.66,31361.66,0.00,19262.98,0.09,1
42582,4378,1000.00,31361.66,32361.66,0.00,14536.49,0.28,1
42583,4378,1000.00,32361.66,33361.66,774.62,29259.63,0.44,1
42584,4378,1000.00,33361.66,34361.66,9004.80,24356.86,0.18,1
42585,4378,1000.00,34361.66,35361.66,0.00,14315.60,0.24,1
42586,4378,1000.00,35361.66,36361.66,0.00,35361.66,0.24,1
42587,4378,1000.00,36361.66,37361.66,0.00,36361.66,0.14,1
42588,4378,1000.00,37361.66,38361.66,167.48,37194.18,0.40,1
42589,4378,1000.00,38361.66,39361.66,0.00,31956.58,0.34,1
42590,4378,1000.00,39361.66,40361.66,8545.46,30816.20,0.28,1
42591,4379,-1000.00,-1000.00,0.00,0.00,1000.00,0.37,0
42592,4380,0.00,0.00,1000.00,0.00,0.00,0.16,0
42593,4380,-1000.00,-1000.00,0.00,207.18,792.82,0.14,0
42594,4381,-1000.00,-1000.00,0.00,1000.00,0.00,0.02,0
42595,4382,-1000.00,-1000.00,0.00,0.00,647.16,0.03,0
42596,4383,-1000.00,-1000.00,0.00,287.62,712.38,0.35,0
42597,4384,-1000.00,-1000.00,0.00,0.00,593.18,0.22,0
42598,4385,1000.00,1000.00,2000.00,0.00,661.10,0.29,1
42599,4385,1000.00,2000.00,3000.00,0.00,2000.00,0.26,1
42600,4385,1000.00,3000.00,4000.00,0.00,3000.00,0.30,1
42601,4385,1000.00,4000.00,5000.00,0.00,2995.31,0.40,1
42602,4385,1000.00,5000.00,6000.00,400.42,4599.58,0.40,1
42603,4385,1000.00,6000.00,7000.00,0.00,6000.00,0.05,1
42604,4385,1000.00,7000.00,8000.00,3500.00,3500.00,0.01,1
42605,4385,1000.00,8000.00,9000.00,552.38,3337.76,0.27,1
42606,4385,1000.00,9000.00,10000.00,2136.34,5373.11,0.33,1
42607,4385,1000.00,10000.00,11000.00,0.00,1269.08,0.02,1
42608,4385,1000.00,11000.00,12000.00,0.00,11000.00,0.35,1
42609,4385,1000.00,12000.00,13000.00,0.00,12000.00,0.29,1
42610,4385,0.00,12000.00,13000.00,0.00,0.00,0.03,0
42611,4385,-1000.00,11000.00,12000.00,7940.34,5059.66,0.14,0
42612,4385,1000.00,12000.00,13000.00,0.00,12000.00,0.01,1
42613,4385,1000.00,13000.00,14000.00,6500.00,6500.00,0.39,1
42614,4385,-1000.00,12000.00,13000.00,8374.79,5625.21,0.10,0
42615,4385,1000.00,13000.00,14000.00,4379.74,8620.26,0.23,1
42616,4385,1000.00,14000.00,15000.00,0.00,14000.00,0.28,1
42617,4385,-1000.00,13000.00,14000.00,8939.37,6060.63,0.36,0
42618,4385,1000.00,14000.00,15000.00,3135.91,10864.09,0.33,1
42619,4385,-1000.00,13000.00,14000.00,8238.87,6761.13,0.05,0
42620,4385,1000.00,14000.00,15000.00,2806.77,11193.23,0.21,1
42621,4385,1000.00,15000.00,16000.00,0.00,15000.00,0.39,1
42622,4385,1000.00,16000.00,17000.00,0.00,16000.00,0.31,1
42623,4385,0.00,16000.00,17000.00,0.00,0.00,0.00,0
42624,4385,1000.00,17000.00,18000.00,8500.00,8500.00,0.06,1
42625,4385,1000.00,18000.00,19000.00,0.00,15793.15,0.42,1
42626,4385,1000.00,19000.00,20000.00,9500.00,9500.00,0.01,1
42627,4385,1000.00,20000.00,21000.00,0.00,8880.78,0.27,1
42628,4385,1000.00,21000.00,22000.00,0.00,13635.37,0.09,1
42629,4385,-1000.00,20000.00,21000.00,12350.45,9649.55,0.11,0
42630,4385,-1000.00,19000.00,20000.00,1113.58,0.00,0.41,0
42631,4385,1000.00,20000.00,21000.00,4515.71,15484.29,0.33,1
42632,4385,1000.00,21000.00,22000.00,4342.28,16657.72,0.34,1
42633,4385,1000.00,22000.00,23000.00,3335.65,18664.35,0.33,1
42634,4385,1000.00,23000.00,24000.00,3035.73,19964.27,0.14,1
42635,4385,-1000.00,22000.00,23000.00,8368.36,7425.07,0.19,0
42636,4385,-1000.00,21000.00,22000.00,16309.09,6690.91,0.03,0
42637,4386,1000.00,1000.00,2000.00,284.18,715.82,0.34,1
42638,4386,1000.00,2000.00,3000.00,88.65,1911.35,0.43,1
42639,4386,-1000.00,1000.00,2000.00,1315.28,276.31,0.11,0
42640,4386,1000.00,2000.00,3000.00,0.00,2000.00,0.05,1
42641,4386,1000.00,3000.00,4000.00,0.00,1378.24,0.12,1
42642,4386,1000.00,4000.00,5000.00,259.50,3543.12,0.43,1
42643,4386,1000.00,5000.00,6000.00,0.00,3838.52,0.37,1
42644,4386,1000.00,6000.00,7000.00,3000.00,3000.00,0.01,1
42645,4386,1000.00,7000.00,8000.00,1453.62,5098.69,0.40,1
42646,4386,1000.00,8000.00,9000.00,526.48,4347.54,0.33,1
42647,4386,1000.00,9000.00,10000.00,0.00,8741.58,0.02,1
42648,4386,1000.00,10000.00,11000.00,4738.29,5261.71,0.05,1
42649,4386,-1000.00,9000.00,10000.00,7527.49,3472.51,0.15,0
42650,4386,1000.00,10000.00,11000.00,4044.97,5955.03,0.25,1
42651,4386,0.00,10000.00,11000.00,0.00,0.00,0.04,0
42652,4386,1000.00,11000.00,12000.00,0.00,10492.32,0.39,1
42653,4386,1000.00,12000.00,13000.00,0.00,12000.00,0.43,1
42654,4386,-1000.00,11000.00,12000.00,7698.07,5301.93,0.38,0
42655,4386,1000.00,12000.00,13000.00,2386.12,9613.88,0.41,1
42656,4386,1000.00,13000.00,14000.00,5580.22,7419.78,0.05,1
42657,4386,1000.00,14000.00,15000.00,3343.13,10656.87,0.38,1
42658,4386,1000.00,15000.00,16000.00,1171.93,13828.07,0.03,1
42659,4386,1000.00,16000.00,17000.00,8000.00,8000.00,0.10,1
42660,4386,-1000.00,15000.00,16000.00,5224.55,0.00,0.04,0
42661,4386,1000.00,16000.00,17000.00,4905.09,11094.91,0.29,1
42662,4386,1000.00,17000.00,18000.00,2330.42,5303.96,0.22,1
42663,4386,1000.00,18000.00,19000.00,0.00,18000.00,0.02,1
42664,4386,1000.00,19000.00,20000.00,0.00,18758.11,0.15,1
42665,4386,1000.00,20000.00,21000.00,5180.04,14819.96,0.37,1
42666,4386,-1000.00,19000.00,20000.00,17401.77,3598.23,0.02,0
42667,4386,1000.00,20000.00,21000.00,3981.02,16018.98,0.39,1
42668,4386,1000.00,21000.00,22000.00,0.00,18550.81,0.23,1
42669,4386,1000.00,22000.00,23000.00,0.00,22000.00,0.28,1
42670,4386,1000.00,23000.00,24000.00,7651.23,15348.77,0.21,1
42671,4386,1000.00,24000.00,25000.00,0.00,1951.29,0.01,1
42672,4386,-1000.00,23000.00,24000.00,1534.13,89.00,0.11,0
42673,4386,1000.00,24000.00,25000.00,4145.85,19854.15,0.42,1
42674,4386,1000.00,25000.00,26000.00,9206.31,15793.69,0.30,1
42675,4387,-1000.00,-1000.00,0.00,539.82,460.18,0.17,0
42676,4388,1000.00,1000.00,2000.00,0.00,1000.00,0.12,1
42677,4388,1000.00,2000.00,3000.00,0.00,1600.95,0.36,1
42678,4388,1000.00,3000.00,4000.00,0.00,3000.00,0.10,1
42679,4388,1000.00,4000.00,5000.00,1232.35,2583.47,0.33,1
42680,4388,1000.00,5000.00,6000.00,0.00,1820.33,0.09,1
42681,4388,1000.00,6000.00,7000.00,3000.00,3000.00,0.05,1
42682,4388,-1000.00,5000.00,6000.00,4536.44,2450.79,0.14,0
42683,4388,1000.00,6000.00,7000.00,0.00,3098.15,0.29,1
42684,4388,1000.00,7000.00,8000.00,0.00,223.94,0.10,1
42685,4388,1000.00,8000.00,9000.00,3826.16,4173.84,0.08,1
42686,4388,1000.00,9000.00,10000.00,1909.29,7090.71,0.01,1
42687,4388,1000.00,10000.00,11000.00,2404.89,7595.11,0.39,1
42688,4388,1000.00,11000.00,12000.00,0.00,4624.54,0.28,1
42689,4388,1000.00,12000.00,13000.00,0.00,3910.13,0.17,1
42690,4388,-1000.00,11000.00,12000.00,7518.20,5481.80,0.11,0
42691,4388,1000.00,12000.00,13000.00,5084.41,6915.59,0.39,1
42692,4388,-1000.00,11000.00,12000.00,3434.33,0.00,0.05,0
42693,4388,1000.00,12000.00,13000.00,0.00,12000.00,0.14,1
42694,4388,1000.00,13000.00,14000.00,0.00,13000.00,0.36,1
42695,4388,-1000.00,12000.00,13000.00,5029.05,8970.95,0.26,0
42696,4388,0.00,12000.00,13000.00,0.00,0.00,0.07,0
42697,4388,-1000.00,11000.00,12000.00,0.00,7410.42,0.34,0
42698,4388,-1000.00,10000.00,11000.00,0.00,12000.00,0.18,0
42699,4388,-1000.00,9000.00,10000.00,0.00,10122.82,0.37,0
42700,4388,-1000.00,8000.00,9000.00,5866.22,1509.57,0.10,0
42701,4388,-1000.00,7000.00,8000.00,0.00,9000.00,0.13,0
42702,4388,-1000.00,6000.00,7000.00,1331.06,6128.11,0.39,0
42703,4388,-1000.00,5000.00,6000.00,0.00,7000.00,0.03,0
42704,4388,-1000.00,4000.00,5000.00,2322.06,3677.94,0.28,0
42705,4388,-1000.00,3000.00,4000.00,0.00,2217.77,0.24,0
42706,4388,-877.46,2122.54,3122.54,0.00,877.46,0.15,0
42707,4388,-1000.00,1122.54,2122.54,0.00,1728.15,0.33,0
42708,4388,-1000.00,122.54,1122.54,0.00,1315.48,0.12,0
42709,4388,-1000.00,-877.46,122.54,487.94,53.31,0.10,0
42710,4388,-122.54,-1000.00,0.00,46.38,76.17,0.17,0
42711,4389,0.00,0.00,1000.00,0.00,0.00,0.02,0
42712,4389,0.00,0.00,1000.00,0.00,0.00,0.30,0
42713,4389,-128.84,-128.84,871.16,56.19,72.65,0.44,0
42714,4389,-342.09,-470.93,529.07,0.00,342.09,0.40,0
42715,4389,-407.51,-878.44,121.56,0.00,407.51,0.19,0
42716,4389,-93.52,-971.96,28.04,34.02,59.50,0.29,0
42717,4389,0.00,-971.96,28.04,0.00,0.00,0.04,0
42718,4389,0.00,-971.96,28.04,0.00,0.00,0.12,0
42719,4389,1000.00,28.04,1028.04,17.42,10.62,0.07,1
42720,4389,-0.09,27.95,1027.95,0.00,0.09,0.11,0
42721,4389,1000.00,1027.95,2027.95,889.77,0.00,0.15,1
42722,4389,1000.00,2027.95,3027.95,199.99,0.00,0.15,1
42723,4389,-658.19,1369.76,2369.76,0.00,658.19,0.10,0
42724,4389,1000.00,2369.76,3369.76,1365.27,249.35,0.28,1
42725,4389,1000.00,3369.76,4369.76,2231.95,0.00,0.20,1
42726,4389,1000.00,4369.76,5369.76,897.99,0.00,0.41,1
42727,4389,-1000.00,3369.76,4369.76,3089.38,2280.39,0.14,0
42728,4389,-1000.00,2369.76,3369.76,2470.01,0.00,0.19,0
42729,4389,-1000.00,1369.76,2369.76,2469.36,169.19,0.20,0
42730,4389,-1000.00,369.76,1369.76,1436.76,933.00,0.05,0
42731,4389,-1000.00,-630.24,369.76,711.15,658.62,0.27,0
42732,4389,-1000.00,-1630.24,-630.24,0.00,369.76,0.18,0
42733,4390,1000.00,1000.00,2000.00,317.62,682.38,0.24,1
42734,4390,1000.00,2000.00,3000.00,616.17,1383.83,0.19,1
42735,4390,1000.00,3000.00,4000.00,1500.00,1500.00,0.02,1
42736,4390,1000.00,4000.00,5000.00,0.00,1941.82,0.30,1
42737,4390,1000.00,5000.00,6000.00,0.00,5000.00,0.39,1
42738,4390,1000.00,6000.00,7000.00,2095.97,3904.03,0.08,1
42739,4390,1000.00,7000.00,8000.00,0.00,151.51,0.01,1
42740,4390,1000.00,8000.00,9000.00,0.00,8000.00,0.09,1
42741,4390,1000.00,9000.00,10000.00,0.00,9000.00,0.23,1
42742,4390,1000.00,10000.00,11000.00,2124.82,4001.24,0.25,1
42743,4390,-1000.00,9000.00,10000.00,6363.99,4636.01,0.12,0
42744,4390,-1000.00,8000.00,9000.00,6620.30,1068.68,0.13,0
42745,4390,-1000.00,7000.00,8000.00,2191.43,0.00,0.09,0
42746,4390,-1000.00,6000.00,7000.00,1474.84,456.02,0.12,0
42747,4390,-1000.00,5000.00,6000.00,3722.93,3277.07,0.23,0
42748,4390,-1000.00,4000.00,5000.00,2907.08,3092.92,0.42,0
42749,4390,-1000.00,3000.00,4000.00,2500.00,2500.00,0.03,0
42750,4390,-1000.00,2000.00,3000.00,0.00,2713.01,0.33,0
42751,4390,-1000.00,1000.00,2000.00,0.00,3000.00,0.02,0
42752,4390,-1000.00,0.00,1000.00,63.41,1795.20,0.44,0
42753,4390,-1000.00,-1000.00,0.00,0.00,1000.00,0.40,0
42754,4391,-1000.00,-1000.00,0.00,189.31,84.44,0.13,0
42755,4392,1000.00,1000.00,2000.00,537.69,309.09,0.26,1
42756,4392,-995.92,4.08,1004.08,0.00,995.92,0.31,0
42757,4392,1000.00,1004.08,2004.08,66.13,0.00,0.39,1
42758,4392,-1000.00,4.08,1004.08,0.00,1401.85,0.07,0
42759,4392,-957.88,-953.80,46.20,219.42,738.46,0.38,0
42760,4392,-46.20,-1000.00,0.00,12.27,33.93,0.26,0
42761,4393,-1000.00,-1000.00,0.00,484.76,515.24,0.15,0
42762,4394,-85.08,-85.08,914.92,85.08,0.00,0.33,0
42763,4394,-1000.00,-1085.08,-85.08,0.00,914.92,0.10,0
42764,4395,-1000.00,-1000.00,0.00,0.00,568.44,0.43,0
42765,4396,1000.00,1000.00,2000.00,0.00,1000.00,0.02,1
42766,4396,1000.00,2000.00,3000.00,931.55,1068.45,0.15,1
42767,4396,1000.00,3000.00,4000.00,910.63,2089.37,0.28,1
42768,4396,1000.00,4000.00,5000.00,468.13,2974.64,0.40,1
42769,4396,1000.00,5000.00,6000.00,728.88,2708.99,0.32,1
42770,4396,1000.00,6000.00,7000.00,1340.08,4659.92,0.16,1
42771,4396,1000.00,7000.00,8000.00,0.00,7000.00,0.11,1
42772,4396,1000.00,8000.00,9000.00,0.00,8000.00,0.27,1
42773,4396,1000.00,9000.00,10000.00,0.00,1346.16,0.12,1
42774,4396,1000.00,10000.00,11000.00,0.00,5761.57,0.05,1
42775,4396,1000.00,11000.00,12000.00,0.00,11000.00,0.05,1
42776,4396,1000.00,12000.00,13000.00,0.00,6498.77,0.21,1
42777,4396,1000.00,13000.00,14000.00,0.00,9059.13,0.17,1
42778,4396,1000.00,14000.00,15000.00,0.00,5187.59,0.11,1
42779,4396,1000.00,15000.00,16000.00,7500.00,7500.00,0.02,1
42780,4396,1000.00,16000.00,17000.00,0.00,8865.82,0.04,1
42781,4396,1000.00,17000.00,18000.00,0.00,13420.09,0.23,1
42782,4396,1000.00,18000.00,19000.00,0.00,13601.80,0.17,1
42783,4396,-1000.00,17000.00,18000.00,9830.22,9169.78,0.36,0
42784,4396,-1000.00,16000.00,17000.00,7865.73,10134.27,0.07,0
42785,4396,-1000.00,15000.00,16000.00,0.00,14635.65,0.31,0
42786,4396,-1000.00,14000.00,15000.00,0.00,15925.10,0.25,0
42787,4396,-1000.00,13000.00,14000.00,0.00,4512.29,0.22,0
42788,4396,-1000.00,12000.00,13000.00,3268.28,1261.51,0.13,0
42789,4396,-1000.00,11000.00,12000.00,1885.53,11114.47,0.30,0
42790,4396,-1000.00,10000.00,11000.00,7857.42,4075.61,0.13,0
42791,4396,-1000.00,9000.00,10000.00,943.49,8252.02,0.40,0
42792,4396,-1000.00,8000.00,9000.00,4007.10,5992.90,0.08,0
42793,4396,-1000.00,7000.00,8000.00,2661.77,6000.91,0.34,0
42794,4396,-1000.00,6000.00,7000.00,4036.82,3963.18,0.18,0
42795,4396,-1000.00,5000.00,6000.00,0.00,7000.00,0.31,0
42796,4396,-1000.00,4000.00,5000.00,998.71,5001.29,0.42,0
42797,4396,-1000.00,3000.00,4000.00,0.00,5000.00,0.39,0
42798,4396,-1000.00,2000.00,3000.00,602.68,3397.32,0.40,0
42799,4396,-1000.00,1000.00,2000.00,0.00,2460.53,0.42,0
42800,4396,-1000.00,0.00,1000.00,267.45,1732.55,0.40,0
42801,4396,-1000.00,-1000.00,0.00,365.65,634.35,0.29,0
42802,4397,-993.71,-993.71,6.29,0.00,993.71,0.39,0
42803,4397,-1000.00,-1993.71,-993.71,3.01,1.51,0.14,0
42804,4398,1000.00,1000.00,2000.00,0.00,568.10,0.27,1
42805,4398,1000.00,2000.00,3000.00,0.00,1351.77,0.33,1
42806,4398,1000.00,3000.00,4000.00,345.26,2654.74,0.38,1
42807,4398,1000.00,4000.00,5000.00,0.00,4000.00,0.25,1
42808,4398,1000.00,5000.00,6000.00,2412.54,2587.46,0.15,1
42809,4398,1000.00,6000.00,7000.00,0.00,6000.00,0.26,1
42810,4398,-1000.00,5000.00,6000.00,3772.41,3227.59,0.14,0
42811,4398,1000.00,6000.00,7000.00,1772.03,4227.97,0.08,1
42812,4398,1000.00,7000.00,8000.00,0.00,7000.00,0.04,1
42813,4398,1000.00,8000.00,9000.00,0.00,8000.00,0.43,1
42814,4398,1000.00,9000.00,10000.00,0.00,9000.00,0.29,1
42815,4398,1000.00,10000.00,11000.00,4000.65,5999.35,0.23,1
42816,4398,1000.00,11000.00,12000.00,0.00,10980.84,0.40,1
42817,4398,1000.00,12000.00,13000.00,0.00,12000.00,0.00,1
42818,4398,1000.00,13000.00,14000.00,0.00,13000.00,0.17,1
42819,4398,1000.00,14000.00,15000.00,0.00,8997.49,0.35,1
42820,4398,-1000.00,13000.00,14000.00,15000.00,0.00,0.02,0
42821,4398,1000.00,14000.00,15000.00,0.00,6769.48,0.25,1
42822,4398,1000.00,15000.00,16000.00,0.00,15000.00,0.09,1
42823,4398,1000.00,16000.00,17000.00,0.00,16000.00,0.03,1
42824,4398,-1000.00,15000.00,16000.00,8733.68,8266.32,0.42,0
42825,4398,1000.00,16000.00,17000.00,0.00,2444.47,0.11,1
42826,4398,-1000.00,15000.00,16000.00,9992.04,7007.96,0.14,0
42827,4398,-1000.00,14000.00,15000.00,3655.72,12344.28,0.36,0
42828,4398,-1000.00,13000.00,14000.00,0.00,1859.56,0.07,0
42829,4398,-1000.00,12000.00,13000.00,8374.26,5059.72,0.15,0
42830,4398,-1000.00,11000.00,12000.00,0.00,12434.59,0.24,0
42831,4398,-1000.00,10000.00,11000.00,4422.01,7577.99,0.29,0
42832,4398,-1000.00,9000.00,10000.00,3513.81,7486.19,0.31,0
42833,4398,-1000.00,8000.00,9000.00,0.00,4127.95,0.27,0
42834,4398,0.00,8000.00,9000.00,0.00,0.00,0.00,0
42835,4398,-1000.00,7000.00,8000.00,0.00,9000.00,0.26,0
42836,4398,-1000.00,6000.00,7000.00,4000.00,4000.00,0.07,0
42837,4398,-1000.00,5000.00,6000.00,1525.33,5474.67,0.29,0
42838,4398,-1000.00,4000.00,5000.00,0.00,3323.84,0.18,0
42839,4398,-1000.00,3000.00,4000.00,0.00,5000.00,0.22,0
42840,4398,-1000.00,2000.00,3000.00,1293.68,2706.32,0.16,0
42841,4398,-1000.00,1000.00,2000.00,0.00,2902.75,0.41,0
42842,4398,-1000.00,0.00,1000.00,466.41,1533.59,0.38,0
42843,4398,-1000.00,-1000.00,0.00,236.02,0.00,0.05,0
42844,4399,0.00,0.00,1000.00,0.00,0.00,0.18,0
42845,4399,-84.60,-84.60,915.40,84.60,0.00,0.20,0
42846,4399,-1000.00,-1084.60,-84.60,158.62,257.48,0.42,0
42847,4400,-1000.00,-1000.00,0.00,291.83,708.17,0.30,0
42848,4401,0.00,0.00,1000.00,0.00,0.00,0.12,0
42849,4401,-239.40,-239.40,760.60,239.40,0.00,0.34,0
42850,4401,1000.00,760.60,1760.60,0.00,596.20,0.40,1
42851,4401,1000.00,1760.60,2760.60,0.00,1568.46,0.16,1
42852,4401,-1000.00,760.60,1760.60,0.00,2760.60,0.40,0
42853,4401,-1000.00,-239.40,760.60,0.00,1760.60,0.25,0
42854,4401,-1000.00,-1239.40,-239.40,0.00,149.16,0.04,0
42855,4402,1000.00,1000.00,2000.00,129.77,870.23,0.26,1
42856,4402,1000.00,2000.00,3000.00,0.00,1638.73,0.41,1
42857,4402,1000.00,3000.00,4000.00,0.00,3000.00,0.37,1
42858,4402,1000.00,4000.00,5000.00,841.81,1238.36,0.21,1
42859,4402,1000.00,5000.00,6000.00,0.00,3330.38,0.09,1
42860,4402,1000.00,6000.00,7000.00,0.00,4743.27,0.36,1
42861,4402,1000.00,7000.00,8000.00,2571.44,4428.56,0.08,1
42862,4402,1000.00,8000.00,9000.00,3340.83,4659.17,0.18,1
42863,4402,1000.00,9000.00,10000.00,3603.15,5396.85,0.11,1
42864,4402,1000.00,10000.00,11000.00,0.00,9778.30,0.14,1
42865,4402,1000.00,11000.00,12000.00,1894.91,9105.09,0.33,1
42866,4402,1000.00,12000.00,13000.00,0.00,12000.00,0.12,1
42867,4402,1000.00,13000.00,14000.00,0.00,13000.00,0.17,1
42868,4402,1000.00,14000.00,15000.00,3890.13,4332.46,0.21,1
42869,4402,1000.00,15000.00,16000.00,3230.52,11769.48,0.37,1
42870,4402,1000.00,16000.00,17000.00,8000.00,8000.00,0.09,1
42871,4402,1000.00,17000.00,18000.00,0.00,17000.00,0.35,1
42872,4402,-1000.00,16000.00,17000.00,9001.57,8998.43,0.23,0
42873,4402,1000.00,17000.00,18000.00,0.00,17000.00,0.31,1
42874,4402,1000.00,18000.00,19000.00,8918.94,9081.06,0.44,1
42875,4402,1000.00,19000.00,20000.00,0.00,19000.00,0.15,1
42876,4402,-1000.00,18000.00,19000.00,14455.37,5544.63,0.26,0
42877,4402,1000.00,19000.00,20000.00,0.00,13692.46,0.26,1
42878,4402,1000.00,20000.00,21000.00,3700.90,16299.10,0.29,1
42879,4402,1000.00,21000.00,22000.00,0.00,21000.00,0.39,1
42880,4402,1000.00,22000.00,23000.00,0.00,13808.72,0.30,1
42881,4402,1000.00,23000.00,24000.00,0.00,23000.00,0.24,1
42882,4402,-1000.00,22000.00,23000.00,13979.07,6152.92,0.13,0
42883,4402,1000.00,23000.00,24000.00,581.08,22418.92,0.11,1
42884,4402,1000.00,24000.00,25000.00,0.00,14741.63,0.02,1
42885,4402,1000.00,25000.00,26000.00,0.00,25000.00,0.04,1
42886,4402,1000.00,26000.00,27000.00,0.00,26000.00,0.17,1
42887,4402,1000.00,27000.00,28000.00,0.00,17666.83,0.32,1
42888,4402,1000.00,28000.00,29000.00,1544.91,26455.09,0.43,1
42889,4402,1000.00,29000.00,30000.00,6896.96,22103.04,0.38,1
42890,4402,1000.00,30000.00,31000.00,0.00,30000.00,0.41,1
42891,4402,1000.00,31000.00,32000.00,11332.57,19667.43,0.31,1
42892,4402,1000.00,32000.00,33000.00,12716.12,19283.88,0.21,1
42893,4402,1000.00,33000.00,34000.00,0.00,18019.19,0.18,1
42894,4402,1000.00,34000.00,35000.00,0.00,15817.44,0.20,1
42895,4402,1000.00,35000.00,36000.00,0.00,2239.32,0.05,1
42896,4402,1000.00,36000.00,37000.00,14806.64,21193.36,0.17,1
42897,4402,1000.00,37000.00,38000.00,5149.81,31850.19,0.40,1
42898,4403,-284.23,-284.23,715.77,0.00,284.23,0.13,0
42899,4403,-715.77,-1000.00,0.00,147.30,568.47,0.32,0
42900,4404,-725.91,-725.91,274.09,0.00,725.91,0.18,0
42901,4404,1000.00,274.09,1274.09,72.40,0.00,0.14,1
42902,4404,0.00,274.09,1274.09,0.00,0.00,0.11,0
42903,4404,-1000.00,-725.91,274.09,300.87,973.21,0.18,0
42904,4404,1000.00,274.09,1274.09,89.71,32.76,0.38,1
42905,4404,-679.30,-405.21,594.79,57.86,621.43,0.44,0
42906,4404,-594.79,-1000.00,0.00,203.86,390.93,0.32,0
42907,4405,-1000.00,-1000.00,0.00,472.07,527.93,0.23,0
42908,4406,-1000.00,-1000.00,0.00,505.50,494.50,0.04,0
42909,4407,-1000.00,-1000.00,0.00,119.53,880.47,0.07,0
42910,4408,-266.77,-266.77,733.23,0.00,266.77,0.13,0
42911,4408,-733.23,-1000.00,0.00,235.74,497.50,0.29,0
42912,4409,-1000.00,-1000.00,0.00,0.00,631.46,0.17,0
42913,4410,-1000.00,-1000.00,0.00,380.51,0.00,0.29,0
42914,4411,-1000.00,-1000.00,0.00,503.48,496.52,0.01,0
42915,4412,-756.71,-756.71,243.29,0.00,756.71,0.32,0
42916,4412,-243.29,-1000.00,0.00,0.00,243.29,0.18,0
42917,4413,-1000.00,-1000.00,0.00,188.07,0.00,0.13,0
42918,4414,-1000.00,-1000.00,0.00,417.35,582.65,0.28,0
42919,4415,1000.00,1000.00,2000.00,0.00,1000.00,0.36,1
42920,4415,1000.00,2000.00,3000.00,0.00,2000.00,0.02,1
42921,4415,1000.00,3000.00,4000.00,0.00,2615.96,0.28,1
42922,4415,1000.00,4000.00,5000.00,871.75,3128.25,0.40,1
42923,4415,1000.00,5000.00,6000.00,1671.24,3328.76,0.28,1
42924,4415,1000.00,6000.00,7000.00,0.00,6000.00,0.36,1
42925,4415,1000.00,7000.00,8000.00,2987.34,4012.66,0.20,1
42926,4415,-1000.00,6000.00,7000.00,7800.55,199.45,0.03,0
42927,4415,1000.00,7000.00,8000.00,0.00,7000.00,0.08,1
42928,4415,1000.00,8000.00,9000.00,2384.59,5615.41,0.35,1
42929,4415,1000.00,9000.00,10000.00,3934.31,5065.69,0.19,1
42930,4415,1000.00,10000.00,11000.00,0.00,10000.00,0.21,1
42931,4415,1000.00,11000.00,12000.00,5500.00,5500.00,0.02,1
42932,4415,1000.00,12000.00,13000.00,0.00,9013.12,0.05,1
42933,4415,1000.00,13000.00,14000.00,0.00,13000.00,0.02,1
42934,4415,1000.00,14000.00,15000.00,1635.63,12364.37,0.40,1
42935,4415,1000.00,15000.00,16000.00,0.00,15000.00,0.41,1
42936,4415,1000.00,16000.00,17000.00,4309.44,11690.56,0.37,1
42937,4415,1000.00,17000.00,18000.00,0.00,17000.00,0.32,1
42938,4415,1000.00,18000.00,19000.00,0.00,11993.58,0.04,1
42939,4415,1000.00,19000.00,20000.00,4146.62,14853.38,0.34,1
42940,4415,1000.00,20000.00,21000.00,5147.52,14852.48,0.31,1
42941,4415,1000.00,21000.00,22000.00,9242.28,11757.72,0.16,1
42942,4415,1000.00,22000.00,23000.00,0.00,20816.27,0.40,1
42943,4415,-1000.00,21000.00,22000.00,15052.94,7947.06,0.25,0
42944,4415,1000.00,22000.00,23000.00,0.00,19191.74,0.42,1
42945,4415,1000.00,23000.00,24000.00,0.00,23000.00,0.12,1
42946,4415,1000.00,24000.00,25000.00,2777.08,21222.92,0.42,1
42947,4415,1000.00,25000.00,26000.00,7015.68,17984.32,0.17,1
42948,4415,1000.00,26000.00,27000.00,10889.04,15110.96,0.10,1
42949,4415,1000.00,27000.00,28000.00,12782.68,14217.32,0.12,1
42950,4415,1000.00,28000.00,29000.00,0.00,15319.54,0.25,1
42951,4415,1000.00,29000.00,30000.00,14030.36,14969.64,0.12,1
42952,4415,1000.00,30000.00,31000.00,0.00,30000.00,0.29,1
42953,4415,1000.00,31000.00,32000.00,0.00,31000.00,0.19,1
42954,4415,1000.00,32000.00,33000.00,8034.95,23965.05,0.08,1
42955,4415,1000.00,33000.00,34000.00,0.00,33000.00,0.12,1
42956,4415,1000.00,34000.00,35000.00,4632.20,29367.80,0.33,1
42957,4415,1000.00,35000.00,36000.00,17500.00,17500.00,0.00,1
42958,4415,1000.00,36000.00,37000.00,3050.15,20038.26,0.33,1
42959,4415,1000.00,37000.00,38000.00,0.00,37000.00,0.22,1
42960,4415,1000.00,38000.00,39000.00,0.00,32881.80,0.41,1
42961,4415,1000.00,39000.00,40000.00,0.00,39000.00,0.44,1
42962,4415,1000.00,40000.00,41000.00,0.00,26269.37,0.20,1
42963,4415,1000.00,41000.00,42000.00,0.00,41000.00,0.19,1
42964,4415,1000.00,42000.00,43000.00,0.00,30317.46,0.09,1
42965,4415,1000.00,43000.00,44000.00,6011.02,30909.64,0.39,1
42966,4415,1000.00,44000.00,45000.00,0.00,30604.87,0.37,1
42967,4415,-1000.00,43000.00,44000.00,3898.37,41101.63,0.34,0
42968,4415,-1000.00,42000.00,43000.00,0.00,18697.98,0.28,0
42969,4415,-1000.00,41000.00,42000.00,1171.44,41828.56,0.43,0
42970,4415,-1000.00,40000.00,41000.00,0.00,42000.00,0.10,0
42971,4415,-1000.00,39000.00,40000.00,18226.72,22773.28,0.14,0
42972,4415,-1000.00,38000.00,39000.00,0.00,40000.00,0.19,0
42973,4415,-1000.00,37000.00,38000.00,0.00,39000.00,0.44,0
42974,4415,-1000.00,36000.00,37000.00,13268.75,24731.25,0.28,0
42975,4415,-1000.00,35000.00,36000.00,2321.10,34678.90,0.38,0
42976,4415,-1000.00,34000.00,35000.00,0.00,36000.00,0.27,0
42977,4415,-1000.00,33000.00,34000.00,0.00,28820.62,0.41,0
42978,4415,-1000.00,32000.00,33000.00,0.00,34000.00,0.22,0
42979,4415,-1000.00,31000.00,32000.00,0.00,33000.00,0.32,0
42980,4415,-1000.00,30000.00,31000.00,0.00,20499.11,0.36,0
42981,4415,-1000.00,29000.00,30000.00,230.85,15768.75,0.32,0
42982,4415,-1000.00,28000.00,29000.00,0.00,18633.28,0.23,0
42983,4415,-1000.00,27000.00,28000.00,382.61,28617.39,0.44,0
42984,4415,-1000.00,26000.00,27000.00,14000.00,14000.00,0.04,0
42985,4415,-1000.00,25000.00,26000.00,0.00,27000.00,0.27,0
42986,4415,-1000.00,24000.00,25000.00,0.00,22583.41,0.37,0
42987,4415,-1000.00,23000.00,24000.00,0.00,21714.23,0.25,0
42988,4415,-1000.00,22000.00,23000.00,0.00,24000.00,0.21,0
42989,4415,-1000.00,21000.00,22000.00,3161.91,19838.09,0.42,0
42990,4416,1000.00,1000.00,2000.00,309.79,690.21,0.27,1
42991,4416,1000.00,2000.00,3000.00,497.21,1502.79,0.37,1
42992,4416,1000.00,3000.00,4000.00,0.00,1442.59,0.30,1
42993,4416,-1000.00,2000.00,3000.00,3124.96,258.81,0.06,0
42994,4416,1000.00,3000.00,4000.00,119.03,2880.97,0.17,1
42995,4416,1000.00,4000.00,5000.00,0.00,4000.00,0.25,1
42996,4416,1000.00,5000.00,6000.00,724.87,4275.13,0.24,1
42997,4416,1000.00,6000.00,7000.00,0.00,6000.00,0.40,1
42998,4416,1000.00,7000.00,8000.00,0.00,5719.38,0.29,1
42999,4416,1000.00,8000.00,9000.00,904.25,7095.75,0.43,1
43000,4416,1000.00,9000.00,10000.00,2575.54,6424.46,0.35,1
43001,4416,1000.00,10000.00,11000.00,0.00,10000.00,0.24,1
43002,4416,1000.00,11000.00,12000.00,2219.40,7908.93,0.37,1
43003,4416,1000.00,12000.00,13000.00,0.00,12000.00,0.06,1
43004,4416,1000.00,13000.00,14000.00,0.00,11011.25,0.40,1
43005,4416,1000.00,14000.00,15000.00,6746.45,7253.55,0.11,1
43006,4416,1000.00,15000.00,16000.00,1948.75,13051.25,0.42,1
43007,4416,1000.00,16000.00,17000.00,0.00,81.12,0.11,1
43008,4416,1000.00,17000.00,18000.00,0.00,2784.18,0.17,1
43009,4416,1000.00,18000.00,19000.00,0.00,2473.37,0.12,1
43010,4416,1000.00,19000.00,20000.00,0.00,19000.00,0.14,1
43011,4416,1000.00,20000.00,21000.00,3710.74,16289.26,0.32,1
43012,4416,1000.00,21000.00,22000.00,0.00,21000.00,0.23,1
43013,4416,1000.00,22000.00,23000.00,11000.00,11000.00,0.02,1
43014,4416,1000.00,23000.00,24000.00,0.00,23000.00,0.21,1
43015,4416,1000.00,24000.00,25000.00,0.00,17552.70,0.31,1
43016,4416,1000.00,25000.00,26000.00,9746.62,15253.38,0.28,1
43017,4416,1000.00,26000.00,27000.00,0.00,18653.36,0.13,1
43018,4416,1000.00,27000.00,28000.00,13500.00,13500.00,0.04,1
43019,4416,1000.00,28000.00,29000.00,0.00,7264.39,0.16,1
43020,4416,1000.00,29000.00,30000.00,0.00,28116.17,0.32,1
43021,4416,1000.00,30000.00,31000.00,854.22,9662.45,0.23,1
43022,4416,-1000.00,29000.00,30000.00,16940.83,2015.02,0.09,0
43023,4416,-1000.00,28000.00,29000.00,20120.98,6150.28,0.10,0
43024,4416,-1000.00,27000.00,28000.00,24670.20,4329.80,0.03,0
43025,4416,1000.00,28000.00,29000.00,0.00,19501.70,0.25,1
43026,4416,1000.00,29000.00,30000.00,3666.66,18053.28,0.36,1
43027,4416,1000.00,30000.00,31000.00,0.00,6192.57,0.02,1
43028,4416,1000.00,31000.00,32000.00,15500.00,15500.00,0.02,1
43029,4416,1000.00,32000.00,33000.00,10999.92,21000.08,0.30,1
43030,4416,1000.00,33000.00,34000.00,3861.20,21292.60,0.36,1
43031,4416,1000.00,34000.00,35000.00,0.00,19863.62,0.27,1
43032,4416,-1000.00,33000.00,34000.00,13718.41,10403.06,0.18,0
43033,4416,1000.00,34000.00,35000.00,0.00,34000.00,0.16,1
43034,4416,1000.00,35000.00,36000.00,0.00,31464.28,0.30,1
43035,4416,1000.00,36000.00,37000.00,11971.57,24028.43,0.33,1
43036,4416,1000.00,37000.00,38000.00,2685.90,34314.10,0.17,1
43037,4417,-1000.00,-1000.00,0.00,0.00,1000.00,0.30,0
43038,4418,-1000.00,-1000.00,0.00,542.74,457.26,0.19,0
43039,4419,-1000.00,-1000.00,0.00,0.00,385.56,0.41,0
43040,4420,1000.00,1000.00,2000.00,0.00,1000.00,0.14,1
43041,4420,1000.00,2000.00,3000.00,0.00,736.60,0.23,1
43042,4420,1000.00,3000.00,4000.00,1490.49,1509.51,0.22,1
43043,4420,1000.00,4000.00,5000.00,0.00,2821.15,0.34,1
43044,4420,1000.00,5000.00,6000.00,174.47,4825.53,0.43,1
43045,4420,-1000.00,4000.00,5000.00,3120.02,2879.98,0.17,0
43046,4420,1000.00,5000.00,6000.00,852.43,4147.57,0.34,1
43047,4420,1000.00,6000.00,7000.00,0.00,6000.00,0.39,1
43048,4420,1000.00,7000.00,8000.00,1253.49,5746.51,0.24,1
43049,4420,1000.00,8000.00,9000.00,0.00,7294.60,0.43,1
43050,4420,1000.00,9000.00,10000.00,1694.86,7305.14,0.36,1
43051,4420,1000.00,10000.00,11000.00,1596.28,3294.79,0.23,1
43052,4420,1000.00,11000.00,12000.00,2954.03,3665.34,0.23,1
43053,4420,1000.00,12000.00,13000.00,0.00,12000.00,0.15,1
43054,4420,1000.00,13000.00,14000.00,162.99,12837.01,0.20,1
43055,4420,1000.00,14000.00,15000.00,1289.23,12710.77,0.43,1
43056,4420,1000.00,15000.00,16000.00,4964.38,10035.62,0.30,1
43057,4420,1000.00,16000.00,17000.00,0.00,2409.01,0.14,1
43058,4420,1000.00,17000.00,18000.00,7038.98,9961.02,0.19,1
43059,4420,1000.00,18000.00,19000.00,0.00,17723.81,0.14,1
43060,4420,1000.00,19000.00,20000.00,632.12,9579.11,0.14,1
43061,4420,1000.00,20000.00,21000.00,0.00,20000.00,0.17,1
43062,4420,1000.00,21000.00,22000.00,4858.04,15156.26,0.37,1
43063,4420,1000.00,22000.00,23000.00,4333.08,17666.92,0.30,1
43064,4420,-1000.00,21000.00,22000.00,8945.89,6381.63,0.13,0
43065,4420,-1000.00,20000.00,21000.00,0.00,11018.71,0.18,0
43066,4420,0.00,20000.00,21000.00,0.00,0.00,0.07,0
43067,4420,0.00,20000.00,21000.00,0.00,0.00,0.01,0
43068,4420,-1000.00,19000.00,20000.00,0.00,16860.09,0.41,0
43069,4420,-1000.00,18000.00,19000.00,8218.95,11781.05,0.21,0
43070,4420,-1000.00,17000.00,18000.00,9367.84,9632.16,0.18,0
43071,4420,-1000.00,16000.00,17000.00,0.00,13361.53,0.40,0
43072,4420,-1000.00,15000.00,16000.00,0.00,17000.00,0.39,0
43073,4420,-1000.00,14000.00,15000.00,7984.73,8015.27,0.09,0
43074,4420,-1000.00,13000.00,14000.00,4215.34,10784.66,0.30,0
43075,4420,-1000.00,12000.00,13000.00,959.59,0.00,0.07,0
43076,4420,-1000.00,11000.00,12000.00,0.00,13000.00,0.24,0
43077,4420,-1000.00,10000.00,11000.00,854.56,8380.51,0.39,0
43078,4420,-1000.00,9000.00,10000.00,0.00,11000.00,0.27,0
43079,4420,-1000.00,8000.00,9000.00,0.00,8899.84,0.43,0
43080,4420,-1000.00,7000.00,8000.00,0.00,8525.12,0.01,0
43081,4420,-1000.00,6000.00,7000.00,0.00,7318.41,0.03,0
43082,4420,-772.18,5227.82,6227.82,0.00,772.18,0.09,0
43083,4420,-1000.00,4227.82,5227.82,0.00,2047.31,0.11,0
43084,4420,1000.00,5227.82,6227.82,1832.87,3394.95,0.32,1
43085,4420,1000.00,6227.82,7227.82,0.00,6227.82,0.29,1
43086,4420,-1000.00,5227.82,6227.82,3811.27,3416.55,0.04,0
43087,4420,1000.00,6227.82,7227.82,0.00,2055.74,0.14,1
43088,4420,1000.00,7227.82,8227.82,0.00,7227.82,0.16,1
43089,4420,1000.00,8227.82,9227.82,2111.88,6115.94,0.17,1
43090,4420,1000.00,9227.82,10227.82,109.17,4842.17,0.32,1
43091,4420,-1000.00,8227.82,9227.82,7789.08,2438.73,0.04,0
43092,4420,1000.00,9227.82,10227.82,0.00,2950.87,0.18,1
43093,4420,-1000.00,8227.82,9227.82,6322.86,3904.96,0.08,0
43094,4420,1000.00,9227.82,10227.82,693.70,8534.12,0.30,1
43095,4420,1000.00,10227.82,11227.82,2394.54,7833.27,0.40,1
43096,4420,1000.00,11227.82,12227.82,0.00,11227.82,0.24,1
43097,4420,1000.00,12227.82,13227.82,3149.61,9078.21,0.38,1
43098,4420,-1000.00,11227.82,12227.82,10413.04,2814.78,0.04,0
43099,4421,1000.00,1000.00,2000.00,0.00,699.45,0.33,1
43100,4421,1000.00,2000.00,3000.00,0.00,2000.00,0.01,1
43101,4421,1000.00,3000.00,4000.00,732.04,2267.96,0.38,1
43102,4421,1000.00,4000.00,5000.00,0.00,3342.90,0.42,1
43103,4421,1000.00,5000.00,6000.00,915.79,4084.21,0.39,1
43104,4421,1000.00,6000.00,7000.00,0.00,2980.40,0.28,1
43105,4421,-1000.00,5000.00,6000.00,4657.77,2342.23,0.12,0
43106,4421,1000.00,6000.00,7000.00,0.00,4254.47,0.15,1
43107,4421,-1000.00,5000.00,6000.00,4842.47,2157.53,0.06,0
43108,4421,1000.00,6000.00,7000.00,0.00,6000.00,0.28,1
43109,4421,1000.00,7000.00,8000.00,0.00,7000.00,0.23,1
43110,4421,1000.00,8000.00,9000.00,0.00,8000.00,0.40,1
43111,4421,-1000.00,7000.00,8000.00,9000.00,0.00,0.00,0
43112,4421,1000.00,8000.00,9000.00,0.00,6965.89,0.39,1
43113,4421,1000.00,9000.00,10000.00,0.00,4881.34,0.30,1
43114,4421,1000.00,10000.00,11000.00,3299.31,6700.69,0.31,1
43115,4421,1000.00,11000.00,12000.00,1529.67,5944.78,0.32,1
43116,4421,-1000.00,10000.00,11000.00,8601.32,3398.68,0.08,0
43117,4421,1000.00,11000.00,12000.00,4811.30,6188.70,0.25,1
43118,4421,1000.00,12000.00,13000.00,0.00,11174.10,0.41,1
43119,4421,-1000.00,11000.00,12000.00,6538.55,6461.45,0.04,0
43120,4421,1000.00,12000.00,13000.00,1654.32,10345.68,0.22,1
43121,4421,1000.00,13000.00,14000.00,4493.11,8506.89,0.28,1
43122,4421,1000.00,14000.00,15000.00,1923.37,12076.63,0.19,1
43123,4421,1000.00,15000.00,16000.00,2336.00,12664.00,0.43,1
43124,4421,1000.00,16000.00,17000.00,3870.40,12129.60,0.26,1
43125,4421,1000.00,17000.00,18000.00,5046.41,11953.59,0.02,1
43126,4421,1000.00,18000.00,19000.00,7554.06,10445.94,0.27,1
43127,4421,1000.00,19000.00,20000.00,0.00,19000.00,0.39,1
43128,4421,1000.00,20000.00,21000.00,0.00,20000.00,0.38,1
43129,4421,1000.00,21000.00,22000.00,0.00,20948.27,0.36,1
43130,4421,1000.00,22000.00,23000.00,7477.47,14522.53,0.28,1
43131,4421,1000.00,23000.00,24000.00,1900.45,14447.49,0.36,1
43132,4421,-1000.00,22000.00,23000.00,12490.73,11509.27,0.18,0
43133,4421,1000.00,23000.00,24000.00,5936.72,17063.28,0.10,1
43134,4421,1000.00,24000.00,25000.00,7903.82,15413.08,0.32,1
43135,4421,1000.00,25000.00,26000.00,10713.66,14286.34,0.09,1
43136,4421,1000.00,26000.00,27000.00,0.00,26000.00,0.12,1
43137,4421,1000.00,27000.00,28000.00,0.00,27000.00,0.05,1
43138,4421,1000.00,28000.00,29000.00,0.00,28000.00,0.08,1
43139,4421,1000.00,29000.00,30000.00,6970.18,22029.82,0.39,1
43140,4421,-1000.00,28000.00,29000.00,24269.18,5730.82,0.18,0
43141,4421,1000.00,29000.00,30000.00,3478.95,25521.05,0.07,1
43142,4421,1000.00,30000.00,31000.00,10034.62,19965.38,0.32,1
43143,4421,-1000.00,29000.00,30000.00,9738.57,0.00,0.07,0
43144,4421,1000.00,30000.00,31000.00,0.00,30000.00,0.26,1
43145,4421,1000.00,31000.00,32000.00,0.00,29179.26,0.18,1
43146,4421,-1000.00,30000.00,31000.00,8412.41,23587.59,0.24,0
43147,4421,0.00,30000.00,31000.00,0.00,0.00,0.02,0
43148,4421,-1000.00,29000.00,30000.00,0.00,31000.00,0.18,0
43149,4421,-1000.00,28000.00,29000.00,8667.51,21332.49,0.17,0
43150,4421,-1000.00,27000.00,28000.00,7026.66,21973.34,0.13,0
43151,4421,0.00,27000.00,28000.00,0.00,0.00,0.10,0
43152,4421,-1000.00,26000.00,27000.00,0.00,28000.00,0.39,0
43153,4421,-1000.00,25000.00,26000.00,10759.55,4389.38,0.13,0
43154,4421,-1000.00,24000.00,25000.00,6796.55,19203.45,0.38,0
43155,4421,-1000.00,23000.00,24000.00,11242.78,13757.22,0.17,0
43156,4421,-1000.00,22000.00,23000.00,13384.88,10615.12,0.17,0
43157,4421,0.00,22000.00,23000.00,0.00,0.00,0.02,0
43158,4421,-1000.00,21000.00,22000.00,9320.93,13679.07,0.08,0
43159,4421,-1000.00,20000.00,21000.00,5566.81,16433.19,0.38,0
43160,4421,-1000.00,19000.00,20000.00,0.00,21000.00,0.37,0
43161,4421,-1000.00,18000.00,19000.00,9949.11,10050.89,0.07,0
43162,4421,-1000.00,17000.00,18000.00,1047.52,3633.21,0.18,0
43163,4421,-1000.00,16000.00,17000.00,2417.81,15582.19,0.11,0
43164,4421,-1000.00,15000.00,16000.00,0.00,17000.00,0.18,0
43165,4421,-1000.00,14000.00,15000.00,802.57,15197.43,0.32,0
43166,4421,-1000.00,13000.00,14000.00,0.00,4839.45,0.14,0
43167,4422,1000.00,1000.00,2000.00,0.00,572.83,0.26,1
43168,4422,1000.00,2000.00,3000.00,874.69,1125.31,0.18,1
43169,4422,1000.00,3000.00,4000.00,549.82,2450.18,0.40,1
43170,4422,1000.00,4000.00,5000.00,0.00,631.89,0.06,1
43171,4422,1000.00,5000.00,6000.00,1941.72,3058.28,0.15,1
43172,4422,1000.00,6000.00,7000.00,0.00,6000.00,0.10,1
43173,4422,1000.00,7000.00,8000.00,1971.17,5028.83,0.12,1
43174,4422,1000.00,8000.00,9000.00,0.00,8000.00,0.03,1
43175,4422,-1000.00,7000.00,8000.00,2701.94,0.00,0.10,0
43176,4422,-1000.00,6000.00,7000.00,5746.84,324.22,0.06,0
43177,4422,1000.00,7000.00,8000.00,0.00,6341.53,0.01,1
43178,4422,1000.00,8000.00,9000.00,0.00,4696.11,0.34,1
43179,4422,1000.00,9000.00,10000.00,0.00,9000.00,0.25,1
43180,4422,1000.00,10000.00,11000.00,0.00,5657.83,0.44,1
43181,4422,1000.00,11000.00,12000.00,580.70,1528.96,0.16,1
43182,4422,1000.00,12000.00,13000.00,0.00,8966.08,0.31,1
43183,4422,1000.00,13000.00,14000.00,0.00,12340.08,0.08,1
43184,4422,1000.00,14000.00,15000.00,5531.74,8468.26,0.22,1
43185,4422,-1000.00,13000.00,14000.00,8031.29,6968.71,0.20,0
43186,4422,-1000.00,12000.00,13000.00,14000.00,0.00,0.02,0
43187,4422,1000.00,13000.00,14000.00,6500.00,6500.00,0.09,1
43188,4422,1000.00,14000.00,15000.00,7000.00,7000.00,0.02,1
43189,4422,1000.00,15000.00,16000.00,3559.48,11440.52,0.39,1
43190,4422,-1000.00,14000.00,15000.00,8277.38,7722.62,0.14,0
43191,4422,1000.00,15000.00,16000.00,7500.00,7500.00,0.18,1
43192,4422,1000.00,16000.00,17000.00,7197.47,8802.53,0.16,1
43193,4422,1000.00,17000.00,18000.00,0.00,2768.49,0.00,1
43194,4422,-1000.00,16000.00,17000.00,8854.13,7804.43,0.20,0
43195,4422,1000.00,17000.00,18000.00,360.96,16639.04,0.32,1
43196,4422,1000.00,18000.00,19000.00,0.00,18000.00,0.18,1
43197,4422,1000.00,19000.00,20000.00,0.00,13087.52,0.08,1
43198,4422,1000.00,20000.00,21000.00,3418.82,16581.18,0.21,1
43199,4422,1000.00,21000.00,22000.00,5705.89,15294.11,0.37,1
43200,4422,1000.00,22000.00,23000.00,2840.87,19132.18,0.42,1
43201,4422,1000.00,23000.00,24000.00,5976.71,17023.29,0.25,1
43202,4422,1000.00,24000.00,25000.00,0.00,24000.00,0.31,1
43203,4422,-1000.00,23000.00,24000.00,14170.85,10829.15,0.30,0
43204,4423,-1000.00,-1000.00,0.00,0.00,1000.00,0.15,0
43205,4424,-1000.00,-1000.00,0.00,0.00,423.48,0.24,0
43206,4425,-38.33,-38.33,961.67,0.00,38.33,0.38,0
43207,4425,0.00,-38.33,961.67,0.00,0.00,0.25,0
43208,4425,-961.67,-1000.00,0.00,205.51,756.16,0.28,0
43209,4425,-0.00,-1000.00,0.00,0.00,0.00,0.31,0
43210,4425,-0.00,-1000.00,0.00,0.00,0.00,0.36,0
43211,4426,-1000.00,-1000.00,0.00,500.00,500.00,0.03,0
43212,4427,-1000.00,-1000.00,0.00,511.95,488.05,0.16,0
43213,4428,-746.23,-746.23,253.77,116.03,630.20,0.36,0
43214,4428,-253.77,-1000.00,0.00,88.13,165.64,0.29,0
43215,4429,0.00,0.00,1000.00,0.00,0.00,0.25,0
43216,4429,0.00,0.00,1000.00,0.00,0.00,0.24,0
43217,4429,-1000.00,-1000.00,0.00,559.36,440.64,0.12,0
43218,4430,0.00,0.00,1000.00,0.00,0.00,0.16,0
43219,4430,-443.04,-443.04,556.96,293.19,149.84,0.39,0
43220,4430,-1000.00,-1443.04,-443.04,232.17,324.79,0.15,0
43221,4431,-33.95,-33.95,966.05,0.00,33.95,0.13,0
43222,4431,-1000.00,-1033.95,-33.95,426.40,129.71,0.34,0
43223,4432,-1000.00,-1000.00,0.00,0.00,1000.00,0.02,0
43224,4433,0.00,0.00,1000.00,0.00,0.00,0.22,0
43225,4433,-1000.00,-1000.00,0.00,0.00,191.28,0.35,0
43226,4434,-210.12,-210.12,789.88,0.00,210.12,0.37,0
43227,4434,0.00,-210.12,789.88,0.00,0.00,0.05,0
43228,4434,1000.00,789.88,1789.88,477.85,312.03,0.16,1
43229,4434,1000.00,1789.88,2789.88,890.76,0.00,0.10,1
43230,4434,1000.00,2789.88,3789.88,1960.01,0.00,0.21,1
43231,4434,-308.69,2481.19,3481.19,0.00,308.69,0.43,0
43232,4434,-4.91,2476.28,3476.28,0.00,4.91,0.09,0
43233,4434,-26.58,2449.70,3449.70,0.00,26.58,0.06,0
43234,4434,1000.00,3449.70,4449.70,2670.58,779.12,0.11,1
43235,4434,-676.27,2773.43,3773.43,0.00,676.27,0.21,0
43236,4434,0.00,2773.43,3773.43,0.00,0.00,0.29,0
43237,4434,-1000.00,1773.43,2773.43,127.71,2507.91,0.43,0
43238,4434,1000.00,2773.43,3773.43,474.73,0.00,0.27,1
43239,4434,-1000.00,1773.43,2773.43,1240.14,2533.29,0.09,0
43240,4434,1000.00,2773.43,3773.43,1370.79,0.00,0.31,1
43241,4434,1000.00,3773.43,4773.43,3688.76,0.00,0.11,1
43242,4434,-1000.00,2773.43,3773.43,2037.59,2735.84,0.40,0
43243,4434,1000.00,3773.43,4773.43,1436.06,0.00,0.09,1
43244,4434,1000.00,4773.43,5773.43,4773.43,0.00,0.06,1
43245,4434,1000.00,5773.43,6773.43,4641.55,1131.88,0.08,1
43246,4434,-1000.00,4773.43,5773.43,0.00,6773.43,0.32,0
43247,4434,1000.00,5773.43,6773.43,2267.12,0.00,0.32,1
43248,4434,-1000.00,4773.43,5773.43,4256.60,1909.55,0.25,0
43249,4434,0.00,4773.43,5773.43,0.00,0.00,0.06,0
43250,4434,-1000.00,3773.43,4773.43,4425.91,1347.52,0.11,0
43251,4434,-1000.00,2773.43,3773.43,1061.30,2211.58,0.31,0
43252,4434,-1000.00,1773.43,2773.43,0.00,1447.56,0.32,0
43253,4434,-761.16,1012.27,2012.27,761.16,0.00,0.35,0
43254,4434,-1000.00,12.27,1012.27,0.00,1378.31,0.04,0
43255,4434,-1000.00,-987.73,12.27,1012.27,0.00,0.10,0
43256,4434,-0.28,-988.01,11.99,0.28,0.00,0.09,0
43257,4434,-1000.00,-1988.01,-988.01,2.73,6.41,0.28,0
43258,4435,-1000.00,-1000.00,0.00,0.00,1000.00,0.16,0
43259,4436,1000.00,1000.00,2000.00,0.00,706.00,0.35,1
43260,4436,1000.00,2000.00,3000.00,0.00,1158.80,0.34,1
43261,4436,1000.00,3000.00,4000.00,1470.70,1529.30,0.12,1
43262,4436,1000.00,4000.00,5000.00,0.00,4000.00,0.34,1
43263,4436,0.00,4000.00,5000.00,0.00,0.00,0.07,0
43264,4436,1000.00,5000.00,6000.00,1698.04,3301.96,0.28,1
43265,4436,1000.00,6000.00,7000.00,905.50,5094.50,0.42,1
43266,4436,1000.00,7000.00,8000.00,0.00,7000.00,0.38,1
43267,4436,1000.00,8000.00,9000.00,0.00,8000.00,0.26,1
43268,4436,1000.00,9000.00,10000.00,0.00,9000.00,0.42,1
43269,4436,1000.00,10000.00,11000.00,0.00,10000.00,0.20,1
43270,4436,-1000.00,9000.00,10000.00,5997.57,5002.43,0.17,0
43271,4436,1000.00,10000.00,11000.00,0.00,67.46,0.10,1
43272,4436,1000.00,11000.00,12000.00,2082.88,8917.12,0.02,1
43273,4436,1000.00,12000.00,13000.00,0.00,11660.87,0.35,1
43274,4436,-1000.00,11000.00,12000.00,6791.67,6097.26,0.20,0
43275,4436,1000.00,12000.00,13000.00,3263.42,8736.58,0.27,1
43276,4436,1000.00,13000.00,14000.00,6170.88,6829.12,0.04,1
43277,4436,1000.00,14000.00,15000.00,1474.19,12525.81,0.43,1
43278,4436,-1000.00,13000.00,14000.00,10213.33,4786.67,0.08,0
43279,4436,1000.00,14000.00,15000.00,0.00,14000.00,0.29,1
43280,4436,1000.00,15000.00,16000.00,4656.83,10343.17,0.26,1
43281,4436,-1000.00,14000.00,15000.00,8645.11,7354.89,0.14,0
43282,4436,-1000.00,13000.00,14000.00,6392.19,0.00,0.07,0
43283,4436,1000.00,14000.00,15000.00,0.00,14000.00,0.33,1
43284,4436,1000.00,15000.00,16000.00,0.00,15000.00,0.31,1
43285,4436,1000.00,16000.00,17000.00,1597.16,14402.84,0.34,1
43286,4436,1000.00,17000.00,18000.00,6840.83,10159.17,0.37,1
43287,4436,1000.00,18000.00,19000.00,0.00,18000.00,0.01,1
43288,4436,1000.00,19000.00,20000.00,0.00,19000.00,0.32,1
43289,4436,-1000.00,18000.00,19000.00,10522.22,9477.78,0.14,0
43290,4436,1000.00,19000.00,20000.00,3683.29,8431.71,0.27,1
43291,4436,1000.00,20000.00,21000.00,0.00,13922.41,0.34,1
43292,4436,1000.00,21000.00,22000.00,9694.80,11305.20,0.24,1
43293,4436,-1000.00,20000.00,21000.00,18278.48,457.61,0.04,0
43294,4436,-1000.00,19000.00,20000.00,15826.34,4867.22,0.09,0
43295,4436,1000.00,20000.00,21000.00,2921.95,17078.05,0.05,1
43296,4436,1000.00,21000.00,22000.00,5661.23,15338.77,0.37,1
43297,4436,1000.00,22000.00,23000.00,2575.02,19424.98,0.05,1
43298,4436,1000.00,23000.00,24000.00,0.00,23000.00,0.18,1
43299,4436,1000.00,24000.00,25000.00,6956.32,17043.68,0.33,1
43300,4436,1000.00,25000.00,26000.00,0.00,23535.40,0.20,1
43301,4436,1000.00,26000.00,27000.00,0.00,25652.72,0.18,1
43302,4436,1000.00,27000.00,28000.00,0.00,27000.00,0.03,1
43303,4436,1000.00,28000.00,29000.00,0.00,18906.15,0.32,1
43304,4436,1000.00,29000.00,30000.00,13372.08,15627.92,0.05,1
43305,4437,0.00,0.00,1000.00,0.00,0.00,0.01,0
43306,4437,-1000.00,-1000.00,0.00,0.00,1000.00,0.11,0
43307,4438,0.00,0.00,1000.00,0.00,0.00,0.01,0
43308,4438,-65.30,-65.30,934.70,0.00,65.30,0.40,0
43309,4438,-934.70,-1000.00,0.00,297.28,637.42,0.38,0
43310,4439,-1000.00,-1000.00,0.00,500.00,500.00,0.05,0
43311,4440,-1000.00,-1000.00,0.00,552.31,160.22,0.11,0
43312,4441,-1000.00,-1000.00,0.00,0.00,1000.00,0.13,0
43313,4442,-1000.00,-1000.00,0.00,500.00,500.00,0.04,0
43314,4443,-1000.00,-1000.00,0.00,363.44,636.56,0.28,0
43315,4444,-405.87,-405.87,594.13,294.24,111.63,0.39,0
43316,4444,-1000.00,-1405.87,-405.87,126.36,433.98,0.20,0
43317,4445,-437.73,-437.73,562.27,0.00,437.73,0.40,0
43318,4445,-1000.00,-1437.73,-437.73,302.01,260.26,0.10,0
43319,4446,-954.08,-954.08,45.92,520.84,433.24,0.26,0
43320,4446,1000.00,45.92,1045.92,0.00,30.97,0.24,1
43321,4446,1000.00,1045.92,2045.92,0.00,1045.92,0.24,1
43322,4446,1000.00,2045.92,3045.92,0.00,2045.92,0.13,1
43323,4446,1000.00,3045.92,4045.92,1106.14,1939.78,0.26,1
43324,4446,1000.00,4045.92,5045.92,1652.15,2393.77,0.22,1
43325,4446,1000.00,5045.92,6045.92,0.00,1828.58,0.16,1
43326,4446,1000.00,6045.92,7045.92,2060.57,2449.50,0.24,1
43327,4446,-1000.00,5045.92,6045.92,3548.45,3497.47,0.11,0
43328,4446,1000.00,6045.92,7045.92,0.00,6045.92,0.17,1
43329,4446,1000.00,7045.92,8045.92,0.00,5116.46,0.38,1
43330,4446,1000.00,8045.92,9045.92,2805.11,5240.80,0.32,1
43331,4446,1000.00,9045.92,10045.92,1403.31,6789.35,0.43,1
43332,4446,1000.00,10045.92,11045.92,3167.89,6878.03,0.36,1
43333,4446,1000.00,11045.92,12045.92,4949.80,6096.12,0.24,1
43334,4446,1000.00,12045.92,13045.92,0.00,1495.19,0.36,1
43335,4446,1000.00,13045.92,14045.92,0.00,6249.76,0.19,1
43336,4446,1000.00,14045.92,15045.92,0.00,5403.68,0.15,1
43337,4446,1000.00,15045.92,16045.92,0.00,15045.92,0.23,1
43338,4446,-1000.00,14045.92,15045.92,9356.31,6689.61,0.35,0
43339,4446,1000.00,15045.92,16045.92,0.00,15045.92,0.29,1
43340,4447,1000.00,1000.00,2000.00,0.00,1000.00,0.03,1
43341,4447,1000.00,2000.00,3000.00,0.00,2000.00,0.22,1
43342,4447,-1000.00,1000.00,2000.00,1607.09,1392.91,0.10,0
43343,4447,1000.00,2000.00,3000.00,464.32,1535.68,0.20,1
43344,4447,1000.00,3000.00,4000.00,0.00,3000.00,0.30,1
43345,4447,1000.00,4000.00,5000.00,0.00,2934.85,0.04,1
43346,4447,1000.00,5000.00,6000.00,2179.49,2820.51,0.19,1
43347,4447,1000.00,6000.00,7000.00,1606.93,4324.74,0.36,1
43348,4447,0.00,6000.00,7000.00,0.00,0.00,0.03,0
43349,4447,1000.00,7000.00,8000.00,0.00,7000.00,0.11,1
43350,4447,1000.00,8000.00,9000.00,2615.48,5384.52,0.34,1
43351,4447,1000.00,9000.00,10000.00,0.00,5794.26,0.37,1
43352,4447,1000.00,10000.00,11000.00,0.00,807.48,0.11,1
43353,4447,1000.00,11000.00,12000.00,5009.99,5990.01,0.08,1
43354,4447,1000.00,12000.00,13000.00,0.00,9757.84,0.17,1
43355,4447,-1000.00,11000.00,12000.00,7678.92,5321.08,0.13,0
43356,4447,1000.00,12000.00,13000.00,144.79,11855.21,0.25,1
43357,4447,1000.00,13000.00,14000.00,0.00,13000.00,0.25,1
43358,4447,1000.00,14000.00,15000.00,751.41,13248.59,0.31,1
43359,4447,1000.00,15000.00,16000.00,0.00,8403.51,0.19,1
43360,4447,1000.00,16000.00,17000.00,0.00,6992.47,0.28,1
43361,4447,1000.00,17000.00,18000.00,0.00,17000.00,0.23,1
43362,4447,1000.00,18000.00,19000.00,4734.84,13265.16,0.19,1
43363,4447,-1000.00,17000.00,18000.00,9500.00,9500.00,0.43,0
43364,4447,-1000.00,16000.00,17000.00,7419.58,10580.42,0.12,0
43365,4447,-1000.00,15000.00,16000.00,0.00,10155.51,0.31,0
43366,4447,-1000.00,14000.00,15000.00,0.00,16000.00,0.37,0
43367,4447,-1000.00,13000.00,14000.00,0.00,12001.59,0.36,0
43368,4447,-1000.00,12000.00,13000.00,7094.78,6905.22,0.17,0
43369,4447,-1000.00,11000.00,12000.00,417.39,6736.78,0.32,0
43370,4447,-1000.00,10000.00,11000.00,0.00,12000.00,0.24,0
43371,4447,-1000.00,9000.00,10000.00,0.00,6573.37,0.28,0
43372,4447,-1000.00,8000.00,9000.00,3496.56,6503.44,0.32,0
43373,4447,-1000.00,7000.00,8000.00,0.00,9000.00,0.33,0
43374,4447,-1000.00,6000.00,7000.00,0.00,8000.00,0.18,0
43375,4447,-1000.00,5000.00,6000.00,1466.54,5533.46,0.33,0
43376,4447,0.00,5000.00,6000.00,0.00,0.00,0.07,0
43377,4447,-1000.00,4000.00,5000.00,0.00,1500.41,0.07,0
43378,4447,-1000.00,3000.00,4000.00,0.00,4468.22,0.38,0
43379,4447,-1000.00,2000.00,3000.00,2000.00,2000.00,0.00,0
43380,4447,-1000.00,1000.00,2000.00,0.00,2800.61,0.40,0
43381,4447,-147.08,852.92,1852.92,0.00,147.08,0.03,0
43382,4447,-1000.00,-147.08,852.92,0.00,1852.92,0.26,0
43383,4447,-852.92,-1000.00,0.00,139.18,713.75,0.27,0
43384,4448,1000.00,1000.00,2000.00,281.09,341.23,0.29,1
43385,4448,1000.00,2000.00,3000.00,0.00,936.02,0.37,1
43386,4448,1000.00,3000.00,4000.00,10.75,2989.25,0.16,1
43387,4448,1000.00,4000.00,5000.00,790.23,3209.77,0.36,1
43388,4448,1000.00,5000.00,6000.00,0.00,4672.18,0.42,1
43389,4448,-1000.00,4000.00,5000.00,3527.11,2472.89,0.14,0
43390,4448,0.00,4000.00,5000.00,0.00,0.00,0.04,0
43391,4448,1000.00,5000.00,6000.00,786.95,2276.08,0.28,1
43392,4448,1000.00,6000.00,7000.00,0.00,3982.65,0.37,1
43393,4448,1000.00,7000.00,8000.00,0.00,7000.00,0.02,1
43394,4448,0.00,7000.00,8000.00,0.00,0.00,0.01,0
43395,4448,-1000.00,6000.00,7000.00,4276.11,3723.89,0.42,0
43396,4448,1000.00,7000.00,8000.00,3500.00,3500.00,0.07,1
43397,4448,1000.00,8000.00,9000.00,3332.19,4667.81,0.25,1
43398,4448,1000.00,9000.00,10000.00,50.72,8949.28,0.02,1
43399,4448,1000.00,10000.00,11000.00,3135.61,6864.39,0.20,1
43400,4448,1000.00,11000.00,12000.00,239.20,10760.80,0.38,1
43401,4448,1000.00,12000.00,13000.00,0.00,12000.00,0.38,1
43402,4448,1000.00,13000.00,14000.00,2187.00,5990.32,0.28,1
43403,4448,1000.00,14000.00,15000.00,6235.40,7764.60,0.29,1
43404,4448,1000.00,15000.00,16000.00,401.66,8791.63,0.38,1
43405,4448,1000.00,16000.00,17000.00,0.00,4550.40,0.20,1
43406,4448,1000.00,17000.00,18000.00,414.04,16585.96,0.31,1
43407,4448,1000.00,18000.00,19000.00,0.00,18000.00,0.39,1
43408,4448,1000.00,19000.00,20000.00,4656.32,14343.68,0.37,1
43409,4448,-1000.00,18000.00,19000.00,11339.91,8660.09,0.17,0
43410,4448,1000.00,19000.00,20000.00,9425.36,9574.64,0.04,1
43411,4448,1000.00,20000.00,21000.00,1514.19,18485.81,0.41,1
43412,4448,1000.00,21000.00,22000.00,4638.57,16361.43,0.40,1
43413,4448,1000.00,22000.00,23000.00,516.61,21483.39,0.35,1
43414,4448,1000.00,23000.00,24000.00,0.00,6353.75,0.16,1
43415,4448,-1000.00,22000.00,23000.00,14628.38,9371.62,0.18,0
43416,4448,1000.00,23000.00,24000.00,0.00,9335.57,0.20,1
43417,4448,1000.00,24000.00,25000.00,2302.42,21697.58,0.31,1
43418,4448,-1000.00,23000.00,24000.00,13797.12,11202.88,0.15,0
43419,4448,1000.00,24000.00,25000.00,3743.31,20256.69,0.16,1
43420,4448,1000.00,25000.00,26000.00,9294.80,15705.20,0.25,1
43421,4448,1000.00,26000.00,27000.00,4771.09,21228.91,0.35,1
43422,4449,-1000.00,-1000.00,0.00,127.65,872.35,0.07,0
43423,4450,-1000.00,-1000.00,0.00,0.00,1000.00,0.42,0
43424,4451,1000.00,1000.00,2000.00,67.93,932.07,0.35,1
43425,4451,1000.00,2000.00,3000.00,72.75,1927.25,0.30,1
43426,4451,1000.00,3000.00,4000.00,579.56,2420.44,0.41,1
43427,4451,1000.00,4000.00,5000.00,447.58,3552.42,0.36,1
43428,4451,1000.00,5000.00,6000.00,186.28,4813.72,0.24,1
43429,4451,1000.00,6000.00,7000.00,3000.00,3000.00,0.04,1
43430,4451,1000.00,7000.00,8000.00,1579.11,5197.34,0.40,1
43431,4451,1000.00,8000.00,9000.00,0.00,8000.00,0.32,1
43432,4451,1000.00,9000.00,10000.00,3047.52,5952.48,0.25,1
43433,4451,1000.00,10000.00,11000.00,0.00,10000.00,0.29,1
43434,4451,-1000.00,9000.00,10000.00,5512.05,5487.95,0.21,0
43435,4451,1000.00,10000.00,11000.00,0.00,10000.00,0.30,1
43436,4451,-1000.00,9000.00,10000.00,7123.81,0.00,0.00,0
43437,4451,1000.00,10000.00,11000.00,2484.27,7515.73,0.34,1
43438,4451,1000.00,11000.00,12000.00,1360.12,9639.88,0.29,1
43439,4451,1000.00,12000.00,13000.00,0.00,4195.00,0.24,1
43440,4451,-1000.00,11000.00,12000.00,13000.00,0.00,0.01,0
43441,4451,0.00,11000.00,12000.00,0.00,0.00,0.08,0
43442,4451,1000.00,12000.00,13000.00,5395.12,6604.88,0.23,1
43443,4451,1000.00,13000.00,14000.00,0.00,8488.13,0.34,1
43444,4451,-1000.00,12000.00,13000.00,7000.00,7000.00,0.21,0
43445,4451,-1000.00,11000.00,12000.00,886.37,12113.63,0.02,0
43446,4451,-1000.00,10000.00,11000.00,5743.77,5167.74,0.21,0
43447,4451,-1000.00,9000.00,10000.00,3566.95,7433.05,0.32,0
43448,4451,-1000.00,8000.00,9000.00,263.90,6774.76,0.38,0
43449,4451,-1000.00,7000.00,8000.00,4129.50,4870.50,0.04,0
43450,4451,-1000.00,6000.00,7000.00,0.00,8000.00,0.25,0
43451,4451,-1000.00,5000.00,6000.00,0.00,7000.00,0.28,0
43452,4451,-1000.00,4000.00,5000.00,0.00,6000.00,0.05,0
43453,4451,-1000.00,3000.00,4000.00,2280.61,2719.39,0.18,0
43454,4451,-1000.00,2000.00,3000.00,1746.75,2253.25,0.24,0
43455,4451,-1000.00,1000.00,2000.00,0.00,3000.00,0.22,0
43456,4451,-1000.00,0.00,1000.00,0.00,2000.00,0.38,0
43457,4451,-1000.00,-1000.00,0.00,0.00,1000.00,0.42,0
43458,4452,-1000.00,-1000.00,0.00,1000.00,0.00,0.03,0
43459,4453,-575.06,-575.06,424.94,0.00,575.06,0.27,0
43460,4453,-420.80,-995.86,4.14,124.95,295.85,0.39,0
43461,4453,-301.69,-1297.56,-297.56,1.62,0.91,0.16,0
43462,4454,-1000.00,-1000.00,0.00,0.00,1000.00,0.32,0
43463,4455,0.00,0.00,1000.00,0.00,0.00,0.33,0
43464,4455,-373.56,-373.56,626.44,0.00,373.56,0.38,0
43465,4455,-535.95,-909.51,90.49,0.00,535.95,0.43,0
43466,4455,-90.49,-1000.00,0.00,44.01,46.48,0.06,0
43467,4456,-1000.00,-1000.00,0.00,256.58,488.44,0.29,0
43468,4457,1000.00,1000.00,2000.00,0.00,852.75,0.25,1
43469,4457,1000.00,2000.00,3000.00,217.03,1782.97,0.43,1
43470,4457,1000.00,3000.00,4000.00,647.33,2352.67,0.34,1
43471,4457,1000.00,4000.00,5000.00,0.00,116.89,0.12,1
43472,4457,1000.00,5000.00,6000.00,2323.81,2676.19,0.18,1
43473,4457,1000.00,6000.00,7000.00,1491.48,4508.52,0.33,1
43474,4457,1000.00,7000.00,8000.00,0.00,1429.94,0.07,1
43475,4457,1000.00,8000.00,9000.00,0.00,6677.11,0.42,1
43476,4457,1000.00,9000.00,10000.00,3136.18,5863.82,0.43,1
43477,4457,1000.00,10000.00,11000.00,4386.25,5613.75,0.18,1
43478,4457,1000.00,11000.00,12000.00,2627.32,8372.68,0.27,1
43479,4457,1000.00,12000.00,13000.00,0.00,116.68,0.11,1
43480,4457,1000.00,13000.00,14000.00,3927.29,9072.71,0.26,1
43481,4457,1000.00,14000.00,15000.00,0.00,14000.00,0.03,1
43482,4457,1000.00,15000.00,16000.00,0.00,14977.03,0.33,1
43483,4457,1000.00,16000.00,17000.00,0.00,11649.54,0.09,1
43484,4457,1000.00,17000.00,18000.00,0.00,12748.71,0.40,1
43485,4457,-1000.00,16000.00,17000.00,11858.64,6141.36,0.28,0
43486,4457,0.00,16000.00,17000.00,0.00,0.00,0.03,0
43487,4457,1000.00,17000.00,18000.00,4175.58,12824.42,0.11,1
43488,4457,1000.00,18000.00,19000.00,0.00,11100.64,0.36,1
43489,4457,1000.00,19000.00,20000.00,8987.69,10012.31,0.03,1
43490,4457,-1000.00,18000.00,19000.00,10516.25,9483.75,0.32,0
43491,4457,1000.00,19000.00,20000.00,4818.45,14181.55,0.32,1
43492,4457,1000.00,20000.00,21000.00,0.00,13278.02,0.19,1
43493,4457,1000.00,21000.00,22000.00,0.00,21000.00,0.02,1
43494,4457,1000.00,22000.00,23000.00,0.00,22000.00,0.28,1
43495,4457,-1000.00,21000.00,22000.00,21511.25,0.00,0.01,0
43496,4457,1000.00,22000.00,23000.00,8488.03,13511.97,0.25,1
43497,4457,0.00,22000.00,23000.00,0.00,0.00,0.08,0
43498,4457,1000.00,23000.00,24000.00,0.00,23000.00,0.19,1
43499,4457,-1000.00,22000.00,23000.00,12130.85,11869.15,0.28,0
43500,4457,1000.00,23000.00,24000.00,0.00,16508.82,0.36,1
43501,4457,1000.00,24000.00,25000.00,4236.08,19763.92,0.02,1
43502,4457,1000.00,25000.00,26000.00,0.00,12499.21,0.26,1
43503,4457,1000.00,26000.00,27000.00,3395.34,22604.66,0.40,1
43504,4457,1000.00,27000.00,28000.00,0.00,2637.71,0.08,1
43505,4457,-1000.00,26000.00,27000.00,14467.38,13532.62,0.18,0
43506,4458,1000.00,1000.00,2000.00,310.26,689.74,0.01,1
43507,4458,1000.00,2000.00,3000.00,0.00,2000.00,0.10,1
43508,4458,1000.00,3000.00,4000.00,1091.61,1908.39,0.10,1
43509,4458,1000.00,4000.00,5000.00,1291.36,2708.64,0.34,1
43510,4458,1000.00,5000.00,6000.00,1001.71,2300.87,0.28,1
43511,4458,1000.00,6000.00,7000.00,0.00,6000.00,0.43,1
43512,4458,1000.00,7000.00,8000.00,2947.10,4052.90,0.14,1
43513,4458,1000.00,8000.00,9000.00,0.00,2565.19,0.05,1
43514,4458,1000.00,9000.00,10000.00,99.38,8900.62,0.12,1
43515,4458,1000.00,10000.00,11000.00,1773.51,8226.49,0.37,1
43516,4458,1000.00,11000.00,12000.00,1143.45,9856.55,0.34,1
43517,4458,-1000.00,10000.00,11000.00,10285.16,0.00,0.09,0
43518,4458,1000.00,11000.00,12000.00,0.00,11000.00,0.40,1
43519,4458,1000.00,12000.00,13000.00,0.00,8598.00,0.08,1
43520,4458,1000.00,13000.00,14000.00,0.00,12114.11,0.32,1
43521,4458,1000.00,14000.00,15000.00,5549.24,8450.76,0.28,1
43522,4458,1000.00,15000.00,16000.00,6902.95,8097.05,0.11,1
43523,4458,1000.00,16000.00,17000.00,8000.00,8000.00,0.01,1
43524,4458,1000.00,17000.00,18000.00,6902.35,10097.65,0.12,1
43525,4458,1000.00,18000.00,19000.00,5864.97,12135.03,0.32,1
43526,4458,1000.00,19000.00,20000.00,1386.46,17613.54,0.40,1
43527,4458,1000.00,20000.00,21000.00,4218.00,15782.00,0.39,1
43528,4458,1000.00,21000.00,22000.00,10500.00,10500.00,0.09,1
43529,4458,1000.00,22000.00,23000.00,4628.36,17371.64,0.39,1
43530,4458,1000.00,23000.00,24000.00,0.00,23000.00,0.11,1
43531,4458,1000.00,24000.00,25000.00,0.00,21630.40,0.39,1
43532,4458,-1000.00,23000.00,24000.00,15766.46,457.38,0.07,0
43533,4458,1000.00,24000.00,25000.00,6086.17,17913.83,0.36,1
43534,4458,1000.00,25000.00,26000.00,6854.25,9636.65,0.24,1
43535,4458,1000.00,26000.00,27000.00,11567.52,14432.48,0.41,1
43536,4458,1000.00,27000.00,28000.00,0.00,27000.00,0.14,1
43537,4458,1000.00,28000.00,29000.00,11719.24,16280.76,0.12,1
43538,4458,1000.00,29000.00,30000.00,7008.65,21991.35,0.24,1
43539,4458,1000.00,30000.00,31000.00,0.00,8399.60,0.21,1
43540,4458,1000.00,31000.00,32000.00,0.00,31000.00,0.33,1
43541,4458,1000.00,32000.00,33000.00,0.00,32000.00,0.21,1
43542,4458,1000.00,33000.00,34000.00,13993.59,19006.41,0.23,1
43543,4458,-1000.00,32000.00,33000.00,20684.99,13315.01,0.27,0
43544,4458,1000.00,33000.00,34000.00,0.00,33000.00,0.39,1
43545,4458,-1000.00,32000.00,33000.00,21841.94,8340.77,0.11,0
43546,4458,1000.00,33000.00,34000.00,0.00,26521.57,0.42,1
43547,4459,1000.00,1000.00,2000.00,627.33,248.27,0.24,1
43548,4459,1000.00,2000.00,3000.00,1090.57,909.43,0.07,1
43549,4459,1000.00,3000.00,4000.00,2122.60,186.52,0.21,1
43550,4459,-1000.00,2000.00,3000.00,226.41,970.97,0.41,0
43551,4459,0.00,2000.00,3000.00,0.00,0.00,0.21,0
43552,4459,1000.00,3000.00,4000.00,2384.86,0.00,0.17,1
43553,4459,1000.00,4000.00,5000.00,3165.94,173.03,0.18,1
43554,4459,1000.00,5000.00,6000.00,2286.49,0.00,0.10,1
43555,4459,-1000.00,4000.00,5000.00,1107.28,3812.25,0.39,0
43556,4459,0.00,4000.00,5000.00,0.00,0.00,0.02,0
43557,4459,-1000.00,3000.00,4000.00,0.00,1495.58,0.34,0
43558,4459,-1000.00,2000.00,3000.00,0.00,4000.00,0.06,0
43559,4459,-558.41,1441.59,2441.59,0.00,558.41,0.36,0
43560,4459,1000.00,2441.59,3441.59,1284.06,1157.53,0.06,1
43561,4459,-323.74,2117.85,3117.85,0.00,323.74,0.08,0
43562,4459,-1000.00,1117.85,2117.85,327.52,2790.33,0.43,0
43563,4459,-1000.00,117.85,1117.85,0.00,2117.85,0.11,0
43564,4459,-1000.00,-882.15,117.85,0.00,1117.85,0.18,0
43565,4459,0.00,-882.15,117.85,0.00,0.00,0.08,0
43566,4459,-117.85,-1000.00,0.00,58.21,59.64,0.20,0
43567,4460,-273.56,-273.56,726.44,273.56,0.00,0.07,0
43568,4460,-1000.00,-1273.56,-273.56,0.00,610.56,0.11,0
43569,4461,-490.63,-490.63,509.37,0.00,490.63,0.21,0
43570,4461,-509.37,-1000.00,0.00,0.00,509.37,0.05,0
43571,4462,-889.73,-889.73,110.27,309.92,579.82,0.30,0
43572,4462,-110.27,-1000.00,0.00,44.59,65.67,0.12,0
43573,4463,-1000.00,-1000.00,0.00,171.85,828.15,0.42,0
43574,4464,1000.00,1000.00,2000.00,500.00,500.00,0.09,1
43575,4464,1000.00,2000.00,3000.00,0.00,2000.00,0.23,1
43576,4464,1000.00,3000.00,4000.00,0.00,3000.00,0.16,1
43577,4464,1000.00,4000.00,5000.00,1561.21,2438.79,0.30,1
43578,4464,1000.00,5000.00,6000.00,125.16,2986.16,0.35,1
43579,4464,1000.00,6000.00,7000.00,1350.04,4649.96,0.09,1
43580,4464,1000.00,7000.00,8000.00,1765.64,5234.36,0.15,1
43581,4464,1000.00,8000.00,9000.00,2294.02,5705.98,0.35,1
43582,4464,1000.00,9000.00,10000.00,3353.83,5646.17,0.30,1
43583,4464,1000.00,10000.00,11000.00,0.00,6467.21,0.24,1
43584,4464,1000.00,11000.00,12000.00,4851.69,6148.31,0.18,1
43585,4464,1000.00,12000.00,13000.00,0.00,11422.67,0.44,1
43586,4464,-1000.00,11000.00,12000.00,8792.52,4207.48,0.04,0
43587,4464,1000.00,12000.00,13000.00,4727.01,7272.99,0.29,1
43588,4464,1000.00,13000.00,14000.00,4265.66,8734.34,0.30,1
43589,4464,-1000.00,12000.00,13000.00,3290.44,771.01,0.12,0
43590,4464,1000.00,13000.00,14000.00,488.72,12511.28,0.44,1
43591,4464,1000.00,14000.00,15000.00,5430.43,8569.57,0.26,1
43592,4464,1000.00,15000.00,16000.00,0.00,12016.40,0.24,1
43593,4464,-1000.00,14000.00,15000.00,8000.00,8000.00,0.24,0
43594,4464,-1000.00,13000.00,14000.00,0.00,5647.15,0.18,0
43595,4464,-1000.00,12000.00,13000.00,5911.40,8088.60,0.26,0
43596,4464,-1000.00,11000.00,12000.00,0.00,8812.98,0.28,0
43597,4464,-1000.00,10000.00,11000.00,1936.14,10063.86,0.41,0
43598,4464,-1000.00,9000.00,10000.00,0.00,11000.00,0.21,0
43599,4464,-1000.00,8000.00,9000.00,5000.00,5000.00,0.31,0
43600,4464,-1000.00,7000.00,8000.00,2504.48,6495.52,0.34,0
43601,4464,-1000.00,6000.00,7000.00,3877.98,4122.02,0.19,0
43602,4464,-1000.00,5000.00,6000.00,953.69,3627.08,0.31,0
43603,4464,0.00,5000.00,6000.00,0.00,0.00,0.08,0
43604,4464,-1000.00,4000.00,5000.00,748.79,5251.21,0.21,0
43605,4464,-1000.00,3000.00,4000.00,381.91,4618.09,0.27,0
43606,4464,-1000.00,2000.00,3000.00,533.52,3466.48,0.32,0
43607,4464,-1000.00,1000.00,2000.00,0.00,2478.67,0.31,0
43608,4464,-982.91,17.09,1017.09,0.00,982.91,0.30,0
43609,4464,-1000.00,-982.91,17.09,780.72,200.29,0.08,0
43610,4464,-17.09,-1000.00,0.00,8.10,8.99,0.10,0
43611,4465,-1000.00,-1000.00,0.00,32.34,967.66,0.30,0
43612,4466,-571.84,-571.84,428.16,0.00,571.84,0.39,0
43613,4466,-428.16,-1000.00,0.00,21.52,406.64,0.18,0
43614,4467,-1000.00,-1000.00,0.00,483.89,516.11,0.21,0
43615,4468,-313.36,-313.36,686.64,0.00,313.36,0.38,0
43616,4468,1000.00,686.64,1686.64,181.51,135.86,0.38,1
43617,4468,0.00,686.64,1686.64,0.00,0.00,0.06,0
43618,4468,0.00,686.64,1686.64,0.00,0.00,0.27,0
43619,4468,-1000.00,-313.36,686.64,843.32,843.32,0.00,0
43620,4468,-250.44,-563.80,436.20,0.00,250.44,0.38,0
43621,4468,1000.00,436.20,1436.20,335.39,0.00,0.19,1
43622,4468,-1000.00,-563.80,436.20,417.02,1019.18,0.35,0
43623,4468,-436.20,-1000.00,0.00,0.00,436.20,0.12,0
43624,4469,-1000.00,-1000.00,0.00,0.00,1000.00,0.06,0
43625,4470,1000.00,1000.00,2000.00,334.47,613.29,0.36,1
43626,4470,1000.00,2000.00,3000.00,0.00,1653.19,0.37,1
43627,4470,1000.00,3000.00,4000.00,987.53,2012.47,0.25,1
43628,4470,1000.00,4000.00,5000.00,0.00,2451.69,0.27,1
43629,4470,1000.00,5000.00,6000.00,0.00,3607.21,0.11,1
43630,4470,1000.00,6000.00,7000.00,0.00,4204.65,0.16,1
43631,4470,1000.00,7000.00,8000.00,298.47,6701.53,0.44,1
43632,4470,1000.00,8000.00,9000.00,3904.01,4095.99,0.12,1
43633,4470,-1000.00,7000.00,8000.00,4129.03,0.00,0.02,0
43634,4470,1000.00,8000.00,9000.00,3253.65,4746.35,0.21,1
43635,4470,1000.00,9000.00,10000.00,0.00,9000.00,0.06,1
43636,4470,1000.00,10000.00,11000.00,2179.55,7820.45,0.19,1
43637,4470,-1000.00,9000.00,10000.00,11000.00,0.00,0.03,0
43638,4470,-1000.00,8000.00,9000.00,6747.41,2468.75,0.11,0
43639,4470,1000.00,9000.00,10000.00,0.00,9000.00,0.23,1
43640,4470,1000.00,10000.00,11000.00,3883.30,6116.70,0.27,1
43641,4470,1000.00,11000.00,12000.00,0.00,1879.85,0.17,1
43642,4470,1000.00,12000.00,13000.00,0.00,12000.00,0.19,1
43643,4470,1000.00,13000.00,14000.00,4559.82,8440.18,0.28,1
43644,4470,1000.00,14000.00,15000.00,3598.99,10401.01,0.37,1
43645,4470,1000.00,15000.00,16000.00,0.00,15000.00,0.20,1
43646,4470,1000.00,16000.00,17000.00,0.00,14154.60,0.43,1
43647,4470,1000.00,17000.00,18000.00,0.00,13869.44,0.39,1
43648,4470,1000.00,18000.00,19000.00,0.00,9144.07,0.27,1
43649,4470,-1000.00,17000.00,18000.00,5202.42,13797.58,0.21,0
43650,4470,-1000.00,16000.00,17000.00,0.00,14588.86,0.36,0
43651,4470,-1000.00,15000.00,16000.00,5502.44,11497.56,0.06,0
43652,4470,-1000.00,14000.00,15000.00,6855.91,9144.09,0.25,0
43653,4470,-1000.00,13000.00,14000.00,5988.50,9011.50,0.29,0
43654,4470,-1000.00,12000.00,13000.00,7245.88,6754.12,0.08,0
43655,4470,-1000.00,11000.00,12000.00,4299.92,6342.03,0.26,0
43656,4470,-1000.00,10000.00,11000.00,4980.01,7019.99,0.26,0
43657,4470,-1000.00,9000.00,10000.00,2806.93,8193.07,0.36,0
43658,4470,-1000.00,8000.00,9000.00,563.70,3516.45,0.25,0
43659,4470,-1000.00,7000.00,8000.00,0.00,9000.00,0.28,0
43660,4470,-1000.00,6000.00,7000.00,0.00,7367.83,0.19,0
43661,4470,-1000.00,5000.00,6000.00,3500.00,3500.00,0.10,0
43662,4470,-1000.00,4000.00,5000.00,0.00,6000.00,0.11,0
43663,4470,-1000.00,3000.00,4000.00,2733.08,2266.92,0.15,0
43664,4470,-1000.00,2000.00,3000.00,0.00,2728.50,0.37,0
43665,4470,-1000.00,1000.00,2000.00,1398.02,1601.98,0.11,0
43666,4470,-1000.00,0.00,1000.00,676.00,1324.00,0.31,0
43667,4470,-569.05,-569.05,430.95,0.00,569.05,0.06,0
43668,4470,-430.95,-1000.00,0.00,101.00,329.95,0.35,0
43669,4471,-433.82,-433.82,566.18,182.35,251.48,0.19,0
43670,4471,-1000.00,-1433.82,-433.82,264.13,39.78,0.10,0
43671,4472,1000.00,1000.00,2000.00,397.75,602.25,0.27,1
43672,4472,1000.00,2000.00,3000.00,775.49,1224.51,0.29,1
43673,4472,1000.00,3000.00,4000.00,835.69,2164.31,0.36,1
43674,4472,1000.00,4000.00,5000.00,0.00,4000.00,0.21,1
43675,4472,1000.00,5000.00,6000.00,2334.23,2665.77,0.14,1
43676,4472,1000.00,6000.00,7000.00,1369.17,4630.83,0.23,1
43677,4472,-1000.00,5000.00,6000.00,0.00,7000.00,0.00,0
43678,4472,-1000.00,4000.00,5000.00,0.00,6000.00,0.26,0
43679,4472,-1000.00,3000.00,4000.00,2361.42,2638.58,0.17,0
43680,4472,-1000.00,2000.00,3000.00,0.00,3338.76,0.33,0
43681,4472,-1000.00,1000.00,2000.00,1329.82,1670.18,0.21,0
43682,4472,-1000.00,0.00,1000.00,1522.04,0.00,0.02,0
43683,4472,-1000.00,-1000.00,0.00,170.16,618.61,0.35,0
43684,4473,-1000.00,-1000.00,0.00,467.83,532.17,0.04,0
43685,4474,1000.00,1000.00,2000.00,431.70,568.30,0.20,1
43686,4474,1000.00,2000.00,3000.00,0.00,920.94,0.20,1
43687,4474,1000.00,3000.00,4000.00,1261.22,1738.78,0.27,1
43688,4474,1000.00,4000.00,5000.00,702.30,3297.70,0.42,1
43689,4474,1000.00,5000.00,6000.00,0.00,3397.85,0.38,1
43690,4474,1000.00,6000.00,7000.00,0.00,3354.06,0.27,1
43691,4474,-1000.00,5000.00,6000.00,3695.85,3304.15,0.20,0
43692,4474,-1000.00,4000.00,5000.00,4511.03,1488.97,0.09,0
43693,4474,0.00,4000.00,5000.00,0.00,0.00,0.10,0
43694,4474,-534.51,3465.49,4465.49,534.51,0.00,0.10,0
43695,4474,-1000.00,2465.49,3465.49,2290.19,2175.30,0.19,0
43696,4474,1000.00,3465.49,4465.49,400.97,3064.52,0.23,1
43697,4474,1000.00,4465.49,5465.49,0.00,1623.16,0.05,1
43698,4474,1000.00,5465.49,6465.49,0.00,354.40,0.03,1
43699,4474,1000.00,6465.49,7465.49,0.00,6465.49,0.18,1
43700,4474,-1000.00,5465.49,6465.49,4460.52,3004.96,0.16,0
43701,4474,1000.00,6465.49,7465.49,0.00,6465.49,0.28,1
43702,4474,1000.00,7465.49,8465.49,1227.06,4385.00,0.34,1
43703,4474,-1000.00,6465.49,7465.49,2436.64,6028.85,0.15,0
43704,4474,-1000.00,5465.49,6465.49,0.00,5116.52,0.25,0
43705,4474,-1000.00,4465.49,5465.49,0.00,4249.67,0.38,0
43706,4474,-1000.00,3465.49,4465.49,2222.57,2245.76,0.35,0
43707,4474,-1000.00,2465.49,3465.49,1157.21,0.00,0.31,0
43708,4474,1000.00,3465.49,4465.49,1732.74,1732.74,0.23,1
43709,4474,1000.00,4465.49,5465.49,0.00,2722.88,0.17,1
43710,4474,1000.00,5465.49,6465.49,0.00,1844.08,0.16,1
43711,4474,1000.00,6465.49,7465.49,0.00,1456.18,0.14,1
43712,4474,1000.00,7465.49,8465.49,112.04,4769.66,0.37,1
43713,4474,1000.00,8465.49,9465.49,4081.15,4384.34,0.19,1
43714,4474,1000.00,9465.49,10465.49,0.00,9465.49,0.00,1
43715,4474,1000.00,10465.49,11465.49,0.00,10465.49,0.33,1
43716,4474,1000.00,11465.49,12465.49,0.00,2646.57,0.08,1
43717,4474,1000.00,12465.49,13465.49,829.35,11636.14,0.29,1
43718,4474,1000.00,13465.49,14465.49,0.00,13465.49,0.42,1
43719,4474,1000.00,14465.49,15465.49,0.00,14465.49,0.02,1
43720,4474,1000.00,15465.49,16465.49,0.00,13280.89,0.28,1
43721,4474,-1000.00,14465.49,15465.49,3689.03,855.11,0.12,0
43722,4474,1000.00,15465.49,16465.49,2659.69,12805.80,0.22,1
43723,4474,1000.00,16465.49,17465.49,0.00,16465.49,0.26,1
43724,4474,1000.00,17465.49,18465.49,0.00,17465.49,0.04,1
43725,4474,1000.00,18465.49,19465.49,0.00,18465.49,0.35,1
43726,4474,1000.00,19465.49,20465.49,0.00,18738.59,0.31,1
43727,4474,1000.00,20465.49,21465.49,4831.76,15633.73,0.25,1
43728,4474,1000.00,21465.49,22465.49,1235.20,5938.68,0.21,1
43729,4474,1000.00,22465.49,23465.49,3776.43,16653.99,0.39,1
43730,4474,1000.00,23465.49,24465.49,0.00,23465.49,0.37,1
43731,4474,1000.00,24465.49,25465.49,0.00,7445.57,0.14,1
43732,4475,1000.00,1000.00,2000.00,0.00,406.48,0.16,1
43733,4475,-1000.00,0.00,1000.00,1504.47,495.53,0.01,0
43734,4475,1000.00,1000.00,2000.00,272.41,727.59,0.37,1
43735,4475,0.00,1000.00,2000.00,0.00,0.00,0.01,0
43736,4475,1000.00,2000.00,3000.00,716.40,1283.60,0.11,1
43737,4475,1000.00,3000.00,4000.00,0.00,1336.27,0.20,1
43738,4475,1000.00,4000.00,5000.00,696.35,3303.65,0.41,1
43739,4475,1000.00,5000.00,6000.00,2116.11,2346.42,0.23,1
43740,4475,1000.00,6000.00,7000.00,0.00,5429.86,0.02,1
43741,4475,1000.00,7000.00,8000.00,1113.29,5886.71,0.42,1
43742,4475,1000.00,8000.00,9000.00,0.00,8000.00,0.29,1
43743,4475,1000.00,9000.00,10000.00,4395.75,4604.25,0.12,1
43744,4475,1000.00,10000.00,11000.00,2853.62,7146.38,0.22,1
43745,4475,1000.00,11000.00,12000.00,2080.77,8919.23,0.38,1
43746,4475,-1000.00,10000.00,11000.00,6476.83,5523.17,0.16,0
43747,4475,1000.00,11000.00,12000.00,5500.00,5500.00,0.35,1
43748,4475,1000.00,12000.00,13000.00,0.00,12000.00,0.35,1
43749,4475,1000.00,13000.00,14000.00,112.53,7036.89,0.33,1
43750,4475,1000.00,14000.00,15000.00,0.00,327.80,0.12,1
43751,4475,1000.00,15000.00,16000.00,4607.09,10392.91,0.35,1
43752,4475,1000.00,16000.00,17000.00,0.00,16000.00,0.02,1
43753,4475,1000.00,17000.00,18000.00,8500.00,8500.00,0.34,1
43754,4475,-1000.00,16000.00,17000.00,10530.82,7469.18,0.14,0
43755,4475,1000.00,17000.00,18000.00,0.00,15311.59,0.40,1
43756,4475,1000.00,18000.00,19000.00,8933.22,9066.78,0.20,1
43757,4475,1000.00,19000.00,20000.00,9500.00,9500.00,0.06,1
43758,4475,-1000.00,18000.00,19000.00,4503.88,0.00,0.09,0
43759,4475,1000.00,19000.00,20000.00,0.00,19000.00,0.16,1
43760,4475,1000.00,20000.00,21000.00,9389.05,10610.95,0.42,1
43761,4475,1000.00,21000.00,22000.00,436.78,20563.22,0.40,1
43762,4475,1000.00,22000.00,23000.00,6890.46,14653.12,0.36,1
43763,4475,1000.00,23000.00,24000.00,0.00,23000.00,0.08,1
43764,4475,1000.00,24000.00,25000.00,0.00,24000.00,0.07,1
43765,4475,1000.00,25000.00,26000.00,0.00,25000.00,0.39,1
43766,4475,1000.00,26000.00,27000.00,0.00,19040.53,0.27,1
43767,4475,1000.00,27000.00,28000.00,4414.42,22585.58,0.40,1
43768,4475,1000.00,28000.00,29000.00,5227.05,22772.95,0.34,1
43769,4475,1000.00,29000.00,30000.00,0.00,29000.00,0.09,1
43770,4475,1000.00,30000.00,31000.00,0.00,30000.00,0.34,1
43771,4476,-988.03,-988.03,11.97,412.49,575.54,0.27,0
43772,4476,-11.97,-1000.00,0.00,4.84,7.12,0.24,0
43773,4477,0.00,0.00,1000.00,0.00,0.00,0.07,0
43774,4477,1000.00,1000.00,2000.00,0.00,1000.00,0.38,1
43775,4477,1000.00,2000.00,3000.00,978.71,1021.29,0.05,1
43776,4477,1000.00,3000.00,4000.00,1239.04,1760.96,0.09,1
43777,4477,1000.00,4000.00,5000.00,0.00,4000.00,0.25,1
43778,4477,-1000.00,3000.00,4000.00,2876.24,387.93,0.09,0
43779,4477,1000.00,4000.00,5000.00,0.00,1296.40,0.22,1
43780,4477,-1000.00,3000.00,4000.00,2625.69,2374.31,0.03,0
43781,4477,1000.00,4000.00,5000.00,0.00,4000.00,0.38,1
43782,4477,1000.00,5000.00,6000.00,0.00,4933.02,0.02,1
43783,4477,1000.00,6000.00,7000.00,0.00,6000.00,0.06,1
43784,4477,1000.00,7000.00,8000.00,0.00,7000.00,0.35,1
43785,4477,1000.00,8000.00,9000.00,2066.23,5933.77,0.37,1
43786,4477,1000.00,9000.00,10000.00,0.00,9000.00,0.16,1
43787,4477,1000.00,10000.00,11000.00,3223.04,6776.96,0.41,1
43788,4477,1000.00,11000.00,12000.00,3100.09,7899.91,0.11,1
43789,4477,-1000.00,10000.00,11000.00,4621.64,0.00,0.08,0
43790,4477,1000.00,11000.00,12000.00,0.00,1008.46,0.05,1
43791,4477,-1000.00,10000.00,11000.00,9409.68,1484.84,0.06,0
43792,4477,-1000.00,9000.00,10000.00,7436.66,3563.34,0.24,0
43793,4477,1000.00,10000.00,11000.00,0.00,8195.50,0.20,1
43794,4477,1000.00,11000.00,12000.00,5500.00,5500.00,0.29,1
43795,4477,1000.00,12000.00,13000.00,0.00,12000.00,0.19,1
43796,4477,1000.00,13000.00,14000.00,4197.59,8802.41,0.31,1
43797,4477,1000.00,14000.00,15000.00,0.00,12321.90,0.42,1
43798,4477,1000.00,15000.00,16000.00,7252.53,7707.65,0.23,1
43799,4477,-1000.00,14000.00,15000.00,0.00,16000.00,0.14,0
43800,4477,-1000.00,13000.00,14000.00,0.00,8632.41,0.22,0
43801,4477,-1000.00,12000.00,13000.00,11585.97,0.00,0.07,0
43802,4477,-1000.00,11000.00,12000.00,2547.01,0.00,0.23,0
43803,4477,0.00,11000.00,12000.00,0.00,0.00,0.42,0
43804,4477,-1000.00,10000.00,11000.00,0.00,5595.21,0.32,0
43805,4477,0.00,10000.00,11000.00,0.00,0.00,0.19,0
43806,4477,-1000.00,9000.00,10000.00,2136.11,8863.89,0.10,0
43807,4477,-1000.00,8000.00,9000.00,514.45,3547.79,0.25,0
43808,4477,-1000.00,7000.00,8000.00,0.00,9000.00,0.28,0
43809,4477,-1000.00,6000.00,7000.00,1681.49,5029.58,0.34,0
43810,4477,-1000.00,5000.00,6000.00,0.00,561.48,0.09,0
43811,4477,-1000.00,4000.00,5000.00,4481.32,1518.68,0.22,0
43812,4477,-1000.00,3000.00,4000.00,0.00,5000.00,0.36,0
43813,4477,-1000.00,2000.00,3000.00,518.12,1836.01,0.29,0
43814,4477,-1000.00,1000.00,2000.00,0.00,1342.20,0.21,0
43815,4477,-1000.00,0.00,1000.00,160.59,1597.38,0.42,0
43816,4477,-80.72,-80.72,919.28,80.72,0.00,0.44,0
43817,4477,-906.65,-987.37,12.63,587.54,319.12,0.14,0
43818,4478,-1000.00,-1000.00,0.00,0.00,1000.00,0.24,0
43819,4479,1000.00,1000.00,2000.00,96.88,903.12,0.40,1
43820,4479,-1000.00,0.00,1000.00,1089.88,0.00,0.02,0
43821,4479,1000.00,1000.00,2000.00,500.00,500.00,0.02,1
43822,4479,1000.00,2000.00,3000.00,386.99,1613.01,0.26,1
43823,4479,1000.00,3000.00,4000.00,0.00,2999.95,0.22,1
43824,4479,1000.00,4000.00,5000.00,0.00,346.73,0.10,1
43825,4479,1000.00,5000.00,6000.00,0.00,4286.35,0.24,1
43826,4479,1000.00,6000.00,7000.00,0.00,6000.00,0.31,1
43827,4479,1000.00,7000.00,8000.00,0.00,6039.78,0.16,1
43828,4479,1000.00,8000.00,9000.00,0.00,8000.00,0.00,1
43829,4479,-1000.00,7000.00,8000.00,2364.69,1337.46,0.15,0
43830,4479,1000.00,8000.00,9000.00,544.16,7455.84,0.27,1
43831,4479,1000.00,9000.00,10000.00,0.00,6871.50,0.33,1
43832,4479,1000.00,10000.00,11000.00,0.00,10000.00,0.11,1
43833,4479,1000.00,11000.00,12000.00,0.00,8990.86,0.42,1
43834,4479,1000.00,12000.00,13000.00,3295.63,8704.37,0.37,1
43835,4479,1000.00,13000.00,14000.00,0.00,7228.05,0.00,1
43836,4479,1000.00,14000.00,15000.00,6387.10,7612.90,0.19,1
43837,4479,1000.00,15000.00,16000.00,791.50,14208.50,0.44,1
43838,4479,1000.00,16000.00,17000.00,0.00,8314.26,0.32,1
43839,4479,0.00,16000.00,17000.00,0.00,0.00,0.05,0
43840,4479,1000.00,17000.00,18000.00,0.00,13611.69,0.40,1
43841,4479,-1000.00,16000.00,17000.00,7194.90,3868.63,0.15,0
43842,4479,1000.00,17000.00,18000.00,7986.26,9013.74,0.24,1
43843,4479,-1000.00,16000.00,17000.00,3964.38,14035.62,0.21,0
43844,4479,-1000.00,15000.00,16000.00,0.00,17000.00,0.27,0
43845,4479,-1000.00,14000.00,15000.00,0.00,16000.00,0.19,0
43846,4479,-1000.00,13000.00,14000.00,4132.62,10867.38,0.37,0
43847,4479,-1000.00,12000.00,13000.00,0.00,8979.33,0.37,0
43848,4479,-1000.00,11000.00,12000.00,3394.14,2232.10,0.16,0
43849,4479,-1000.00,10000.00,11000.00,0.00,12000.00,0.15,0
43850,4479,-1000.00,9000.00,10000.00,4652.86,6347.14,0.11,0
43851,4479,-1000.00,8000.00,9000.00,0.00,8676.87,0.39,0
43852,4479,-1000.00,7000.00,8000.00,0.00,2833.35,0.21,0
43853,4479,-1000.00,6000.00,7000.00,3100.18,3324.82,0.24,0
43854,4479,-1000.00,5000.00,6000.00,33.63,1432.22,0.18,0
43855,4479,-1000.00,4000.00,5000.00,1408.21,4591.79,0.35,0
43856,4479,-1000.00,3000.00,4000.00,0.00,5000.00,0.31,0
43857,4479,-1000.00,2000.00,3000.00,0.00,4000.00,0.24,0
43858,4479,-1000.00,1000.00,2000.00,0.00,2317.10,0.40,0
43859,4479,-1000.00,0.00,1000.00,812.28,1187.72,0.23,0
43860,4479,-1000.00,-1000.00,0.00,156.92,0.00,0.08,0
43861,4480,-1000.00,-1000.00,0.00,0.00,1000.00,0.04,0
43862,4481,-795.28,-795.28,204.72,0.00,795.28,0.15,0
43863,4481,-204.72,-1000.00,0.00,81.66,123.06,0.29,0
43864,4482,-1000.00,-1000.00,0.00,525.44,376.79,0.18,0
43865,4483,-965.21,-965.21,34.79,0.00,965.21,0.34,0
43866,4483,-5.85,-971.06,28.94,0.00,5.85,0.17,0
43867,4483,-28.94,-1000.00,0.00,0.00,28.94,0.23,0
43868,4483,-0.00,-1000.00,-0.00,0.00,0.00,0.07,0
43869,4484,-889.87,-889.87,110.13,0.00,889.87,0.33,0
43870,4484,-110.13,-1000.00,0.00,35.94,74.19,0.35,0
43871,4485,-264.72,-264.72,735.28,264.72,0.00,0.39,0
43872,4485,0.00,-264.72,735.28,0.00,0.00,0.34,0
43873,4485,-1000.00,-1264.72,-264.72,271.96,463.32,0.31,0
43874,4486,-522.78,-522.78,477.22,438.11,84.67,0.24,0
43875,4486,-1000.00,-1522.78,-522.78,0.00,472.05,0.18,0
43876,4487,1000.00,1000.00,2000.00,58.33,941.67,0.44,1
43877,4487,1000.00,2000.00,3000.00,24.62,1070.35,0.33,1
43878,4487,1000.00,3000.00,4000.00,0.00,2750.21,0.31,1
43879,4487,1000.00,4000.00,5000.00,1018.92,1166.16,0.22,1
43880,4487,1000.00,5000.00,6000.00,2437.19,2562.81,0.12,1
43881,4487,1000.00,6000.00,7000.00,856.68,5143.32,0.43,1
43882,4487,1000.00,7000.00,8000.00,0.00,7000.00,0.06,1
43883,4487,1000.00,8000.00,9000.00,3014.58,4985.42,0.25,1
43884,4487,1000.00,9000.00,10000.00,0.00,9000.00,0.44,1
43885,4487,1000.00,10000.00,11000.00,0.00,5942.68,0.34,1
43886,4487,1000.00,11000.00,12000.00,0.00,11000.00,0.04,1
43887,4487,1000.00,12000.00,13000.00,5832.91,6167.09,0.13,1
43888,4487,1000.00,13000.00,14000.00,3378.56,9621.44,0.38,1
43889,4487,1000.00,14000.00,15000.00,0.00,14000.00,0.09,1
43890,4487,1000.00,15000.00,16000.00,0.00,15000.00,0.06,1
43891,4487,1000.00,16000.00,17000.00,0.00,16000.00,0.25,1
43892,4487,1000.00,17000.00,18000.00,4562.26,12437.74,0.02,1
43893,4487,1000.00,18000.00,19000.00,2222.48,15777.52,0.43,1
43894,4487,1000.00,19000.00,20000.00,0.00,19000.00,0.21,1
43895,4487,1000.00,20000.00,21000.00,6830.11,13169.89,0.26,1
43896,4487,1000.00,21000.00,22000.00,0.00,14680.07,0.16,1
43897,4487,-1000.00,20000.00,21000.00,22000.00,0.00,0.01,0
43898,4487,1000.00,21000.00,22000.00,9300.16,11699.84,0.23,1
43899,4487,-1000.00,20000.00,21000.00,14300.05,7699.95,0.13,0
43900,4487,-1000.00,19000.00,20000.00,7588.52,11782.76,0.28,0
43901,4487,-1000.00,18000.00,19000.00,10488.65,9511.35,0.03,0
43902,4487,-1000.00,17000.00,18000.00,5926.78,13073.22,0.02,0
43903,4487,-1000.00,16000.00,17000.00,0.00,6377.90,0.15,0
43904,4487,-1000.00,15000.00,16000.00,0.00,17000.00,0.35,0
43905,4487,-1000.00,14000.00,15000.00,0.00,10866.06,0.36,0
43906,4487,-1000.00,13000.00,14000.00,0.00,12138.23,0.40,0
43907,4487,-1000.00,12000.00,13000.00,5304.86,8695.14,0.30,0
43908,4487,-1000.00,11000.00,12000.00,1488.61,11511.39,0.43,0
43909,4487,-1000.00,10000.00,11000.00,873.16,8889.89,0.40,0
43910,4487,-1000.00,9000.00,10000.00,0.00,11000.00,0.27,0
43911,4487,-1000.00,8000.00,9000.00,2562.31,7437.69,0.34,0
43912,4487,-1000.00,7000.00,8000.00,4114.26,4885.74,0.16,0
43913,4487,-1000.00,6000.00,7000.00,819.93,7180.07,0.43,0
43914,4487,-1000.00,5000.00,6000.00,0.00,7000.00,0.08,0
43915,4487,-1000.00,4000.00,5000.00,221.22,4545.55,0.41,0
43916,4487,-1000.00,3000.00,4000.00,815.92,1501.21,0.22,0
43917,4487,-1000.00,2000.00,3000.00,0.00,1082.63,0.04,0
43918,4487,-1000.00,1000.00,2000.00,0.00,3000.00,0.03,0
43919,4487,-1000.00,0.00,1000.00,0.00,2000.00,0.11,0
43920,4487,-1000.00,-1000.00,0.00,266.74,733.26,0.30,0
43921,4488,-648.56,-648.56,351.44,89.26,559.30,0.29,0
43922,4488,1000.00,351.44,1351.44,45.19,24.64,0.43,1
43923,4488,-1000.00,-648.56,351.44,0.00,1351.44,0.08,0
43924,4488,-351.44,-1000.00,0.00,170.47,180.97,0.16,0
43925,4489,-1000.00,-1000.00,0.00,0.00,627.46,0.28,0
43926,4490,-1000.00,-1000.00,0.00,0.00,1000.00,0.35,0
43927,4491,-1000.00,-1000.00,0.00,0.00,102.82,0.34,0
43928,4492,1000.00,1000.00,2000.00,0.00,126.17,0.03,1
43929,4492,1000.00,2000.00,3000.00,827.39,1172.61,0.22,1
43930,4492,1000.00,3000.00,4000.00,342.23,1843.56,0.35,1
43931,4492,1000.00,4000.00,5000.00,1117.67,2882.33,0.23,1
43932,4492,1000.00,5000.00,6000.00,786.67,4213.33,0.39,1
43933,4492,1000.00,6000.00,7000.00,2509.52,3490.48,0.22,1
43934,4492,1000.00,7000.00,8000.00,0.00,3008.48,0.08,1
43935,4492,1000.00,8000.00,9000.00,87.21,7912.79,0.36,1
43936,4492,1000.00,9000.00,10000.00,0.00,9000.00,0.37,1
43937,4492,1000.00,10000.00,11000.00,0.00,9198.36,0.38,1
43938,4492,1000.00,11000.00,12000.00,5379.42,5620.58,0.18,1
43939,4492,1000.00,12000.00,13000.00,3316.61,8683.39,0.37,1
43940,4492,1000.00,13000.00,14000.00,4231.35,8768.65,0.32,1
43941,4492,1000.00,14000.00,15000.00,2506.62,11493.38,0.32,1
43942,4492,-1000.00,13000.00,14000.00,7990.69,7009.31,0.16,0
43943,4492,1000.00,14000.00,15000.00,0.00,14000.00,0.30,1
43944,4492,1000.00,15000.00,16000.00,0.00,10283.90,0.28,1
43945,4492,1000.00,16000.00,17000.00,4924.05,5407.37,0.21,1
43946,4492,1000.00,17000.00,18000.00,0.00,2035.89,0.04,1
43947,4492,1000.00,18000.00,19000.00,0.00,18000.00,0.22,1
43948,4492,1000.00,19000.00,20000.00,0.00,18211.66,0.02,1
43949,4492,1000.00,20000.00,21000.00,0.00,20000.00,0.02,1
43950,4492,1000.00,21000.00,22000.00,0.00,21000.00,0.30,1
43951,4492,-1000.00,20000.00,21000.00,11067.70,10932.30,0.05,0
43952,4492,1000.00,21000.00,22000.00,6945.45,14054.55,0.30,1
43953,4492,-1000.00,20000.00,21000.00,22000.00,0.00,0.02,0
43954,4492,1000.00,21000.00,22000.00,0.00,14990.85,0.39,1
43955,4492,1000.00,22000.00,23000.00,1125.14,20874.86,0.27,1
43956,4492,1000.00,23000.00,24000.00,0.00,11577.11,0.24,1
43957,4492,1000.00,24000.00,25000.00,0.00,10377.82,0.14,1
43958,4492,1000.00,25000.00,26000.00,9824.51,15175.49,0.25,1
43959,4492,1000.00,26000.00,27000.00,0.00,24353.51,0.29,1
43960,4492,1000.00,27000.00,28000.00,13500.00,13500.00,0.22,1
43961,4492,1000.00,28000.00,29000.00,0.00,28000.00,0.07,1
43962,4492,1000.00,29000.00,30000.00,11991.38,17008.62,0.22,1
43963,4492,1000.00,30000.00,31000.00,0.00,30000.00,0.32,1
43964,4492,1000.00,31000.00,32000.00,8735.83,22264.17,0.33,1
43965,4492,1000.00,32000.00,33000.00,0.00,32000.00,0.26,1
43966,4492,-1000.00,31000.00,32000.00,17443.12,15556.88,0.20,0
43967,4492,1000.00,32000.00,33000.00,0.00,19560.88,0.12,1
43968,4492,1000.00,33000.00,34000.00,0.00,33000.00,0.15,1
43969,4492,1000.00,34000.00,35000.00,0.00,34000.00,0.38,1
43970,4492,1000.00,35000.00,36000.00,17500.00,17500.00,0.01,1
43971,4493,0.00,0.00,1000.00,0.00,0.00,0.12,0
43972,4493,0.00,0.00,1000.00,0.00,0.00,0.33,0
43973,4493,-1000.00,-1000.00,0.00,147.59,852.41,0.11,0
43974,4494,-330.50,-330.50,669.50,0.00,330.50,0.28,0
43975,4494,-229.50,-560.00,440.00,0.00,229.50,0.27,0
43976,4494,1000.00,440.00,1440.00,233.95,0.00,0.23,1
43977,4494,-569.39,-129.39,870.61,0.00,569.39,0.25,0
43978,4494,-771.34,-900.73,99.27,18.35,752.99,0.42,0
43979,4494,-92.07,-992.80,7.20,0.00,92.07,0.42,0
43980,4494,-7.20,-1000.00,0.00,0.00,7.20,0.13,0
43981,4495,-1000.00,-1000.00,0.00,0.00,61.10,0.33,0
43982,4496,-1000.00,-1000.00,0.00,271.56,728.44,0.08,0
43983,4496,-0.00,-1000.00,-0.00,0.00,0.00,0.21,0
43984,4497,1000.00,1000.00,2000.00,263.97,736.03,0.38,1
43985,4497,1000.00,2000.00,3000.00,601.92,1398.08,0.35,1
43986,4497,1000.00,3000.00,4000.00,615.44,2384.56,0.00,1
43987,4497,1000.00,4000.00,5000.00,0.00,4000.00,0.41,1
43988,4497,-1000.00,3000.00,4000.00,3040.62,358.12,0.08,0
43989,4497,1000.00,4000.00,5000.00,0.00,4000.00,0.13,1
43990,4497,1000.00,5000.00,6000.00,2228.64,2771.36,0.17,1
43991,4497,-1000.00,4000.00,5000.00,3160.31,2839.69,0.09,0
43992,4497,1000.00,5000.00,6000.00,0.00,5000.00,0.10,1
43993,4497,1000.00,6000.00,7000.00,0.00,6000.00,0.30,1
43994,4497,1000.00,7000.00,8000.00,116.59,6883.41,0.41,1
43995,4497,1000.00,8000.00,9000.00,0.00,891.77,0.15,1
43996,4497,1000.00,9000.00,10000.00,254.66,8745.34,0.08,1
43997,4497,1000.00,10000.00,11000.00,0.00,7035.89,0.12,1
43998,4497,1000.00,11000.00,12000.00,0.00,11000.00,0.35,1
43999,4497,1000.00,12000.00,13000.00,0.00,12000.00,0.11,1
44000,4497,1000.00,13000.00,14000.00,3917.40,9082.60,0.41,1
44001,4497,1000.00,14000.00,15000.00,0.00,10661.22,0.37,1
44002,4497,1000.00,15000.00,16000.00,7500.00,7500.00,0.43,1
44003,4497,-1000.00,14000.00,15000.00,0.00,2899.38,0.02,0
44004,4497,-1000.00,13000.00,14000.00,0.00,15000.00,0.36,0
44005,4497,-1000.00,12000.00,13000.00,7024.38,6975.62,0.20,0
44006,4497,-1000.00,11000.00,12000.00,0.00,13000.00,0.21,0
44007,4497,-1000.00,10000.00,11000.00,0.00,12000.00,0.31,0
44008,4497,-1000.00,9000.00,10000.00,0.00,11000.00,0.19,0
44009,4497,-1000.00,8000.00,9000.00,4601.86,5398.14,0.25,0
44010,4497,-1000.00,7000.00,8000.00,1005.33,7994.67,0.29,0
44011,4497,-1000.00,6000.00,7000.00,0.00,8000.00,0.36,0
44012,4497,-1000.00,5000.00,6000.00,2438.44,4561.56,0.30,0
44013,4497,-1000.00,4000.00,5000.00,0.00,6000.00,0.28,0
44014,4497,-1000.00,3000.00,4000.00,2386.93,2613.07,0.11,0
44015,4497,-1000.00,2000.00,3000.00,1016.97,2280.18,0.31,0
44016,4497,-1000.00,1000.00,2000.00,0.00,3000.00,0.02,0
44017,4497,-183.30,816.70,1816.70,0.00,183.30,0.14,0
44018,4497,-713.89,102.81,1102.81,249.18,464.71,0.20,0
44019,4497,-1000.00,-897.19,102.81,352.49,750.32,0.31,0
44020,4497,0.00,-897.19,102.81,0.00,0.00,0.02,0
44021,4497,-93.87,-991.06,8.94,0.00,93.87,0.41,0
44022,4497,-5.12,-996.18,3.82,0.25,4.87,0.33,0
44023,4497,-3.82,-1000.00,0.00,1.49,2.33,0.22,0
44024,4498,-1000.00,-1000.00,0.00,700.77,299.23,0.00,0
44025,4499,-961.55,-961.55,38.45,0.00,961.55,0.07,0
44026,4499,-36.69,-998.25,1.75,0.00,36.69,0.06,0
44027,4499,-1.37,-999.62,0.38,0.14,1.23,0.40,0
44028,4499,-42.51,-1042.13,-42.13,0.28,0.00,0.04,0
44029,4500,1000.00,1000.00,2000.00,915.47,0.00,0.09,1
44030,4500,1000.00,2000.00,3000.00,780.01,376.13,0.34,1
44031,4500,0.00,2000.00,3000.00,0.00,0.00,0.11,0
44032,4500,0.00,2000.00,3000.00,0.00,0.00,0.01,0
44033,4500,0.00,2000.00,3000.00,0.00,0.00,0.13,0
44034,4500,1000.00,3000.00,4000.00,1170.75,778.97,0.35,1
44035,4500,-1000.00,2000.00,3000.00,0.00,4000.00,0.42,0
44036,4500,1000.00,3000.00,4000.00,1699.68,1300.32,0.25,1
44037,4500,0.00,3000.00,4000.00,0.00,0.00,0.11,0
44038,4500,-1000.00,2000.00,3000.00,2000.00,2000.00,0.10,0
44039,4500,1000.00,3000.00,4000.00,1809.71,1190.29,0.14,1
44040,4500,-1000.00,2000.00,3000.00,0.00,2999.60,0.23,0
44041,4500,-760.66,1239.34,2239.34,0.00,760.66,0.42,0
44042,4500,-1000.00,239.34,1239.34,0.00,1026.89,0.35,0
44043,4500,-393.14,-153.80,846.20,0.00,393.14,0.38,0
44044,4500,1000.00,846.20,1846.20,433.94,0.00,0.09,1
44045,4500,0.00,846.20,1846.20,0.00,0.00,0.28,0
44046,4500,-1000.00,-153.80,846.20,538.05,966.54,0.29,0
44047,4500,-805.19,-958.98,41.02,0.00,805.19,0.34,0
44048,4500,-41.02,-1000.00,0.00,9.75,31.26,0.07,0
44049,4501,-545.94,-545.94,454.06,0.00,545.94,0.00,0
44050,4501,1000.00,454.06,1454.06,82.64,0.00,0.07,1
44051,4501,0.00,454.06,1454.06,0.00,0.00,0.38,0
44052,4501,-893.49,-439.42,560.58,0.00,893.49,0.23,0
44053,4501,-560.58,-1000.00,0.00,158.71,401.87,0.10,0
44054,4502,0.00,0.00,1000.00,0.00,0.00,0.04,0
44055,4502,-532.11,-532.11,467.89,0.00,532.11,0.18,0
44056,4502,-467.89,-1000.00,0.00,195.68,272.21,0.22,0
44057,4503,-1000.00,-1000.00,0.00,0.00,241.88,0.21,0
44058,4504,0.00,0.00,1000.00,0.00,0.00,0.41,0
44059,4504,0.00,0.00,1000.00,0.00,0.00,0.36,0
44060,4504,-1000.00,-1000.00,0.00,0.00,1000.00,0.35,0
44061,4505,-1000.00,-1000.00,0.00,227.53,772.47,0.33,0
44062,4506,-834.31,-834.31,165.69,0.00,834.31,0.18,0
44063,4506,-5.24,-839.55,160.45,0.00,5.24,0.08,0
44064,4506,-138.56,-978.11,21.89,59.66,78.90,0.26,0
44065,4506,-1000.00,-1978.11,-978.11,11.47,10.42,0.21,0
44066,4507,1000.00,1000.00,2000.00,0.00,846.96,0.40,1
44067,4507,1000.00,2000.00,3000.00,0.00,1956.04,0.36,1
44068,4507,1000.00,3000.00,4000.00,475.57,2524.43,0.29,1
44069,4507,0.00,3000.00,4000.00,0.00,0.00,0.03,0
44070,4507,1000.00,4000.00,5000.00,0.00,1838.81,0.28,1
44071,4507,1000.00,5000.00,6000.00,1333.44,3666.56,0.33,1
44072,4507,1000.00,6000.00,7000.00,0.00,6000.00,0.24,1
44073,4507,1000.00,7000.00,8000.00,0.00,3379.97,0.09,1
44074,4507,1000.00,8000.00,9000.00,4000.00,4000.00,0.15,1
44075,4507,1000.00,9000.00,10000.00,0.00,7824.68,0.12,1
44076,4507,-1000.00,8000.00,9000.00,4580.52,4307.09,0.20,0
44077,4507,1000.00,9000.00,10000.00,0.00,9000.00,0.04,1
44078,4507,1000.00,10000.00,11000.00,658.82,9341.18,0.17,1
44079,4507,-1000.00,9000.00,10000.00,7706.26,529.59,0.06,0
44080,4507,1000.00,10000.00,11000.00,0.00,10000.00,0.36,1
44081,4507,1000.00,11000.00,12000.00,5355.38,5644.62,0.21,1
44082,4507,1000.00,12000.00,13000.00,3144.95,8855.05,0.02,1
44083,4507,1000.00,13000.00,14000.00,1967.17,5706.03,0.28,1
44084,4507,-1000.00,12000.00,13000.00,7000.00,7000.00,0.01,0
44085,4507,-1000.00,11000.00,12000.00,0.00,4119.01,0.11,0
44086,4507,-1000.00,10000.00,11000.00,0.00,6831.10,0.34,0
44087,4507,-1000.00,9000.00,10000.00,0.00,5440.24,0.31,0
44088,4507,-1000.00,8000.00,9000.00,0.00,10000.00,0.01,0
44089,4507,-1000.00,7000.00,8000.00,4260.38,4739.62,0.26,0
44090,4507,-1000.00,6000.00,7000.00,3485.51,831.73,0.11,0
44091,4507,-1000.00,5000.00,6000.00,2504.30,2421.98,0.20,0
44092,4507,-1000.00,4000.00,5000.00,3263.64,0.00,0.05,0
44093,4507,-1000.00,3000.00,4000.00,0.00,5000.00,0.31,0
44094,4507,-1000.00,2000.00,3000.00,1747.28,2252.72,0.06,0
44095,4507,-1000.00,1000.00,2000.00,1104.47,1895.53,0.27,0
44096,4507,-1000.00,0.00,1000.00,0.00,2000.00,0.40,0
44097,4507,-1000.00,-1000.00,0.00,500.00,500.00,0.01,0
44098,4508,-1000.00,-1000.00,0.00,0.00,1000.00,0.44,0
44099,4509,1000.00,1000.00,2000.00,0.00,514.47,0.26,1
44100,4509,1000.00,2000.00,3000.00,215.16,1784.84,0.43,1
44101,4509,1000.00,3000.00,4000.00,0.00,243.68,0.11,1
44102,4509,1000.00,4000.00,5000.00,1254.16,2745.84,0.32,1
44103,4509,1000.00,5000.00,6000.00,451.79,4548.21,0.41,1
44104,4509,1000.00,6000.00,7000.00,1193.13,4806.87,0.17,1
44105,4509,1000.00,7000.00,8000.00,0.00,4870.87,0.28,1
44106,4509,1000.00,8000.00,9000.00,348.65,7651.35,0.18,1
44107,4509,1000.00,9000.00,10000.00,0.00,3982.06,0.11,1
44108,4509,1000.00,10000.00,11000.00,3461.46,6538.54,0.17,1
44109,4509,1000.00,11000.00,12000.00,519.66,8864.00,0.42,1
44110,4509,1000.00,12000.00,13000.00,6000.00,6000.00,0.04,1
44111,4509,1000.00,13000.00,14000.00,0.00,1751.82,0.02,1
44112,4509,1000.00,14000.00,15000.00,0.00,12142.79,0.43,1
44113,4509,1000.00,15000.00,16000.00,0.00,14780.26,0.27,1
44114,4509,-1000.00,14000.00,15000.00,11337.07,0.00,0.05,0
44115,4509,-1000.00,13000.00,14000.00,10199.09,4800.91,0.10,0
44116,4509,1000.00,14000.00,15000.00,1472.73,5408.57,0.26,1
44117,4509,1000.00,15000.00,16000.00,0.00,15000.00,0.29,1
44118,4509,1000.00,16000.00,17000.00,7236.51,8763.49,0.17,1
44119,4509,1000.00,17000.00,18000.00,4135.83,12864.17,0.38,1
44120,4509,1000.00,18000.00,19000.00,9000.00,9000.00,0.03,1
44121,4509,1000.00,19000.00,20000.00,0.00,14379.74,0.39,1
44122,4509,-1000.00,18000.00,19000.00,8530.83,11469.17,0.07,0
44123,4509,-1000.00,17000.00,18000.00,8614.83,10385.17,0.12,0
44124,4509,-1000.00,16000.00,17000.00,0.00,15610.31,0.39,0
44125,4509,-1000.00,15000.00,16000.00,0.00,17000.00,0.13,0
44126,4509,-1000.00,14000.00,15000.00,0.00,16000.00,0.13,0
44127,4509,-1000.00,13000.00,14000.00,15000.00,0.00,0.01,0
44128,4509,-1000.00,12000.00,13000.00,0.00,14000.00,0.04,0
44129,4509,-1000.00,11000.00,12000.00,0.00,13000.00,0.08,0
44130,4509,-1000.00,10000.00,11000.00,3640.01,8359.99,0.01,0
44131,4509,-1000.00,9000.00,10000.00,0.00,2975.94,0.10,0
44132,4509,-1000.00,8000.00,9000.00,5088.57,0.00,0.04,0
44133,4509,-1000.00,7000.00,8000.00,0.00,9000.00,0.42,0
44134,4509,-1000.00,6000.00,7000.00,2664.08,5335.92,0.33,0
44135,4509,-1000.00,5000.00,6000.00,4019.95,2980.05,0.15,0
44136,4509,-1000.00,4000.00,5000.00,1538.75,4461.25,0.30,0
44137,4509,-1000.00,3000.00,4000.00,0.00,5000.00,0.20,0
44138,4509,-1000.00,2000.00,3000.00,0.00,4000.00,0.02,0
44139,4509,-1000.00,1000.00,2000.00,1416.55,254.26,0.10,0
44140,4509,-1000.00,0.00,1000.00,920.69,1079.31,0.38,0
44141,4509,-1000.00,-1000.00,0.00,0.00,1000.00,0.41,0
44142,4510,-1000.00,-1000.00,0.00,500.00,500.00,0.05,0
44143,4511,-1000.00,-1000.00,0.00,0.00,1000.00,0.40,0
44144,4512,-1000.00,-1000.00,0.00,369.52,630.48,0.10,0
44145,4512,-0.00,-1000.00,0.00,0.00,0.00,0.27,0
44146,4512,-0.00,-1000.00,0.00,0.00,0.00,0.15,0
44147,4512,-0.00,-1000.00,0.00,0.00,0.00,0.40,0
44148,4513,-1000.00,-1000.00,0.00,272.41,727.59,0.37,0
44149,4514,-1000.00,-1000.00,0.00,0.00,1000.00,0.24,0
44150,4515,-497.28,-497.28,502.72,497.28,0.00,0.12,0
44151,4515,-502.72,-1000.00,0.00,286.60,216.13,0.15,0
44152,4516,1000.00,1000.00,2000.00,0.00,699.21,0.24,1
44153,4516,1000.00,2000.00,3000.00,692.32,1307.68,0.12,1
44154,4516,-1000.00,1000.00,2000.00,1310.04,78.58,0.09,0
44155,4516,1000.00,2000.00,3000.00,634.87,1365.13,0.31,1
44156,4516,1000.00,3000.00,4000.00,0.00,3000.00,0.41,1
44157,4516,1000.00,4000.00,5000.00,588.62,3411.38,0.41,1
44158,4516,1000.00,5000.00,6000.00,2394.61,2605.39,0.10,1
44159,4516,1000.00,6000.00,7000.00,0.00,5306.86,0.37,1
44160,4516,1000.00,7000.00,8000.00,0.00,3259.55,0.28,1
44161,4516,1000.00,8000.00,9000.00,3530.78,4469.22,0.23,1
44162,4516,1000.00,9000.00,10000.00,0.00,5708.80,0.33,1
44163,4516,1000.00,10000.00,11000.00,4444.60,5555.40,0.26,1
44164,4516,1000.00,11000.00,12000.00,3379.98,7620.02,0.13,1
44165,4516,1000.00,12000.00,13000.00,4875.83,7124.17,0.07,1
44166,4516,1000.00,13000.00,14000.00,520.44,4592.67,0.25,1
44167,4516,-1000.00,12000.00,13000.00,7016.69,6983.31,0.19,0
44168,4516,1000.00,13000.00,14000.00,0.00,13000.00,0.15,1
44169,4516,1000.00,14000.00,15000.00,0.00,14000.00,0.16,1
44170,4516,1000.00,15000.00,16000.00,0.00,14396.19,0.37,1
44171,4516,-1000.00,14000.00,15000.00,4899.94,11100.06,0.29,0
44172,4516,-1000.00,13000.00,14000.00,1821.88,13178.12,0.41,0
44173,4516,-1000.00,12000.00,13000.00,0.00,13768.53,0.25,0
44174,4516,-1000.00,11000.00,12000.00,0.00,13000.00,0.34,0
44175,4516,-1000.00,10000.00,11000.00,2955.67,9044.33,0.38,0
44176,4516,-1000.00,9000.00,10000.00,5215.45,5784.55,0.05,0
44177,4516,-1000.00,8000.00,9000.00,0.00,6409.46,0.32,0
44178,4516,-1000.00,7000.00,8000.00,1029.73,1467.12,0.16,0
44179,4516,-1000.00,6000.00,7000.00,0.00,8000.00,0.38,0
44180,4516,-1000.00,5000.00,6000.00,0.00,7000.00,0.44,0
44181,4516,-1000.00,4000.00,5000.00,3005.99,2994.01,0.01,0
44182,4516,-1000.00,3000.00,4000.00,0.00,1298.17,0.07,0
44183,4516,-1000.00,2000.00,3000.00,0.00,1300.00,0.21,0
44184,4516,-1000.00,1000.00,2000.00,0.00,3000.00,0.21,0
44185,4516,-1000.00,0.00,1000.00,316.46,1683.54,0.42,0
44186,4516,-1000.00,-1000.00,0.00,0.00,1000.00,0.18,0
44187,4517,-1000.00,-1000.00,0.00,820.83,179.17,0.15,0
44188,4518,-1000.00,-1000.00,0.00,0.00,713.61,0.21,0
44189,4519,-1000.00,-1000.00,0.00,511.50,0.00,0.08,0
44190,4520,1000.00,1000.00,2000.00,305.62,694.38,0.35,1
44191,4520,1000.00,2000.00,3000.00,746.25,1253.75,0.06,1
44192,4520,1000.00,3000.00,4000.00,0.00,1226.98,0.24,1
44193,4520,1000.00,4000.00,5000.00,0.00,4000.00,0.05,1
44194,4520,1000.00,5000.00,6000.00,91.65,4908.35,0.13,1
44195,4520,1000.00,6000.00,7000.00,0.00,901.58,0.09,1
44196,4520,1000.00,7000.00,8000.00,3098.61,3901.39,0.17,1
44197,4520,1000.00,8000.00,9000.00,3860.57,4139.43,0.12,1
44198,4520,1000.00,9000.00,10000.00,3405.54,5594.46,0.13,1
44199,4520,1000.00,10000.00,11000.00,0.00,9554.41,0.25,1
44200,4520,1000.00,11000.00,12000.00,215.94,10784.06,0.26,1
44201,4520,1000.00,12000.00,13000.00,0.00,11452.79,0.30,1
44202,4520,1000.00,13000.00,14000.00,0.00,12197.45,0.44,1
44203,4520,1000.00,14000.00,15000.00,0.00,10876.48,0.07,1
44204,4520,-1000.00,13000.00,14000.00,10761.35,4238.65,0.01,0
44205,4520,1000.00,14000.00,15000.00,0.00,14000.00,0.42,1
44206,4520,1000.00,15000.00,16000.00,0.00,12593.53,0.42,1
44207,4520,1000.00,16000.00,17000.00,8000.00,8000.00,0.27,1
44208,4520,1000.00,17000.00,18000.00,3913.62,13086.38,0.08,1
44209,4520,1000.00,18000.00,19000.00,9000.00,9000.00,0.32,1
44210,4520,-1000.00,17000.00,18000.00,10886.15,8113.85,0.18,0
44211,4520,-1000.00,16000.00,17000.00,9000.00,9000.00,0.33,0
44212,4520,-1000.00,15000.00,16000.00,4254.11,12745.89,0.15,0
44213,4520,-1000.00,14000.00,15000.00,3207.51,12792.49,0.40,0
44214,4520,-1000.00,13000.00,14000.00,6902.28,8097.72,0.20,0
44215,4520,-1000.00,12000.00,13000.00,4519.93,9480.07,0.26,0
44216,4520,-1000.00,11000.00,12000.00,0.00,10264.69,0.15,0
44217,4520,-1000.00,10000.00,11000.00,0.00,5895.77,0.24,0
44218,4520,-1000.00,9000.00,10000.00,0.00,11000.00,0.40,0
44219,4520,-1000.00,8000.00,9000.00,6163.20,3836.80,0.07,0
44220,4520,-1000.00,7000.00,8000.00,2245.97,6754.03,0.38,0
44221,4520,-1000.00,6000.00,7000.00,2996.14,5003.86,0.12,0
44222,4520,-1000.00,5000.00,6000.00,0.00,6939.56,0.38,0
44223,4520,-1000.00,4000.00,5000.00,0.00,3833.36,0.20,0
44224,4520,-1000.00,3000.00,4000.00,0.00,5000.00,0.39,0
44225,4520,-84.54,2915.46,3915.46,0.00,84.54,0.11,0
44226,4520,-1000.00,1915.46,2915.46,1957.73,1957.73,0.09,0
44227,4520,-338.22,1577.24,2577.24,0.00,338.22,0.14,0
44228,4520,-1000.00,577.24,1577.24,197.75,2348.90,0.43,0
44229,4520,-575.77,1.48,1001.48,0.00,575.77,0.24,0
44230,4520,-1000.00,-998.52,1.48,570.62,430.86,0.12,0
44231,4520,-1.48,-1000.00,0.00,0.00,1.48,0.17,0
44232,4521,-1000.00,-1000.00,0.00,0.00,273.21,0.13,0
44233,4522,-1000.00,-1000.00,0.00,551.46,448.54,0.17,0
44234,4523,-275.82,-275.82,724.18,0.00,275.82,0.19,0
44235,4523,-724.18,-1000.00,0.00,0.00,724.18,0.11,0
44236,4524,-1000.00,-1000.00,0.00,315.82,684.18,0.33,0
44237,4524,-0.00,-1000.00,0.00,0.00,0.00,0.34,0
44238,4524,-0.00,-1000.00,0.00,0.00,0.00,0.29,0
44239,4524,-0.00,-1000.00,0.00,0.00,0.00,0.23,0
44240,4525,-1000.00,-1000.00,0.00,228.00,772.00,0.33,0
44241,4526,-793.59,-793.59,206.41,0.00,793.59,0.22,0
44242,4526,-109.72,-903.31,96.69,0.00,109.72,0.32,0
44243,4526,-1000.00,-1903.31,-903.31,54.77,41.92,0.16,0
44244,4527,-1000.00,-1000.00,0.00,0.00,1000.00,0.21,0
44245,4528,1000.00,1000.00,2000.00,181.98,694.63,0.37,1
44246,4528,1000.00,2000.00,3000.00,752.65,1247.35,0.30,1
44247,4528,-1000.00,1000.00,2000.00,1624.50,1375.50,0.31,0
44248,4528,1000.00,2000.00,3000.00,0.00,2000.00,0.12,1
44249,4528,-1000.00,1000.00,2000.00,2829.55,0.00,0.03,0
44250,4528,1000.00,2000.00,3000.00,0.00,2000.00,0.02,1
44251,4528,1000.00,3000.00,4000.00,1500.00,1500.00,0.04,1
44252,4528,1000.00,4000.00,5000.00,1316.37,2683.63,0.02,1
44253,4528,1000.00,5000.00,6000.00,0.00,5000.00,0.07,1
44254,4528,1000.00,6000.00,7000.00,1799.69,4200.31,0.29,1
44255,4528,1000.00,7000.00,8000.00,0.00,6952.04,0.34,1
44256,4528,1000.00,8000.00,9000.00,0.00,8000.00,0.08,1
44257,4528,-1000.00,7000.00,8000.00,6033.43,2966.57,0.08,0
44258,4528,1000.00,8000.00,9000.00,2352.12,5647.88,0.35,1
44259,4528,1000.00,9000.00,10000.00,3401.04,5598.96,0.22,1
44260,4528,1000.00,10000.00,11000.00,440.36,9559.64,0.23,1
44261,4528,1000.00,11000.00,12000.00,0.00,11000.00,0.28,1
44262,4528,-1000.00,10000.00,11000.00,4319.80,7680.20,0.33,0
44263,4528,-1000.00,9000.00,10000.00,0.00,11000.00,0.22,0
44264,4528,-1000.00,8000.00,9000.00,1152.04,2044.58,0.18,0
44265,4528,-1000.00,7000.00,8000.00,2420.15,6579.85,0.35,0
44266,4528,-1000.00,6000.00,7000.00,0.00,8000.00,0.40,0
44267,4528,-1000.00,5000.00,6000.00,723.11,6276.89,0.36,0
44268,4528,-1000.00,4000.00,5000.00,0.00,6000.00,0.40,0
44269,4528,-1000.00,3000.00,4000.00,2341.85,2658.15,0.16,0
44270,4528,-1000.00,2000.00,3000.00,0.00,2255.61,0.21,0
44271,4528,-1000.00,1000.00,2000.00,0.00,3000.00,0.14,0
44272,4528,-1000.00,0.00,1000.00,0.00,2000.00,0.38,0
44273,4528,-802.71,-802.71,197.29,0.00,802.71,0.41,0
44274,4528,-1000.00,-1802.71,-802.71,113.81,83.48,0.10,0
44275,4529,-1000.00,-1000.00,0.00,448.15,551.85,0.17,0
44276,4530,-299.17,-299.17,700.83,299.17,0.00,0.09,0
44277,4530,1000.00,700.83,1700.83,218.69,482.14,0.35,1
44278,4530,-1000.00,-299.17,700.83,1157.15,294.61,0.09,0
44279,4530,1000.00,700.83,1700.83,110.42,491.65,0.38,1
44280,4530,-762.88,-62.05,937.95,762.88,0.00,0.07,0
44281,4530,1000.00,937.95,1937.95,0.00,85.75,0.28,1
44282,4530,1000.00,1937.95,2937.95,0.00,1428.56,0.06,1
44283,4530,1000.00,2937.95,3937.95,1468.98,1468.98,0.07,1
44284,4530,1000.00,3937.95,4937.95,0.00,2881.20,0.18,1
44285,4530,1000.00,4937.95,5937.95,2376.11,2561.84,0.18,1
44286,4530,1000.00,5937.95,6937.95,0.00,2385.46,0.04,1
44287,4530,-1000.00,4937.95,5937.95,5078.74,1859.21,0.08,0
44288,4530,1000.00,5937.95,6937.95,0.00,1244.61,0.15,1
44289,4530,1000.00,6937.95,7937.95,0.00,6937.95,0.08,1
44290,4530,1000.00,7937.95,8937.95,3968.98,3968.98,0.14,1
44291,4530,1000.00,8937.95,9937.95,4261.31,4676.64,0.11,1
44292,4530,-1000.00,7937.95,8937.95,7340.75,2597.21,0.24,0
44293,4530,1000.00,8937.95,9937.95,3541.55,5396.40,0.11,1
44294,4530,-1000.00,7937.95,8937.95,6431.72,3506.23,0.05,0
44295,4530,-1000.00,6937.95,7937.95,1635.84,7302.11,0.21,0
44296,4530,-1000.00,5937.95,6937.95,3513.87,4424.08,0.01,0
44297,4530,-1000.00,4937.95,5937.95,4258.54,2679.41,0.15,0
44298,4530,-1000.00,3937.95,4937.95,2327.41,3610.54,0.30,0
44299,4530,-1000.00,2937.95,3937.95,3133.85,1804.10,0.06,0
44300,4530,-1000.00,1937.95,2937.95,407.79,511.36,0.43,0
44301,4530,-1000.00,937.95,1937.95,0.00,715.31,0.27,0
44302,4530,-1000.00,-62.05,937.95,0.00,1506.80,0.41,0
44303,4530,-1000.00,-1062.05,-62.05,298.35,320.22,0.27,0
44304,4531,-833.30,-833.30,166.70,0.00,833.30,0.00,0
44305,4531,-136.59,-969.89,30.11,45.18,91.41,0.30,0
44306,4531,-30.11,-1000.00,0.00,14.78,15.33,0.38,0
44307,4532,-1000.00,-1000.00,0.00,291.93,708.07,0.09,0
44308,4533,-1000.00,-1000.00,0.00,0.00,1000.00,0.18,0
44309,4534,-1000.00,-1000.00,0.00,0.00,1000.00,0.17,0
44310,4535,0.00,0.00,1000.00,0.00,0.00,0.05,0
44311,4535,1000.00,1000.00,2000.00,272.87,727.13,0.20,1
44312,4535,1000.00,2000.00,3000.00,0.00,2000.00,0.28,1
44313,4535,-1000.00,1000.00,2000.00,1688.03,0.00,0.06,0
44314,4535,1000.00,2000.00,3000.00,0.00,969.16,0.26,1
44315,4535,1000.00,3000.00,4000.00,167.65,494.27,0.17,1
44316,4535,1000.00,4000.00,5000.00,785.36,3214.64,0.41,1
44317,4535,1000.00,5000.00,6000.00,0.00,5000.00,0.15,1
44318,4535,1000.00,6000.00,7000.00,0.00,6000.00,0.22,1
44319,4535,1000.00,7000.00,8000.00,740.33,2526.16,0.25,1
44320,4535,1000.00,8000.00,9000.00,0.00,8000.00,0.40,1
44321,4535,1000.00,9000.00,10000.00,0.00,9000.00,0.30,1
44322,4535,1000.00,10000.00,11000.00,0.00,10000.00,0.31,1
44323,4535,1000.00,11000.00,12000.00,1341.14,9658.86,0.28,1
44324,4535,1000.00,12000.00,13000.00,3371.01,8628.99,0.35,1
44325,4535,1000.00,13000.00,14000.00,0.00,13000.00,0.04,1
44326,4535,1000.00,14000.00,15000.00,471.93,13528.07,0.43,1
44327,4535,-1000.00,13000.00,14000.00,7745.12,7254.88,0.19,0
44328,4535,1000.00,14000.00,15000.00,0.00,8498.47,0.35,1
44329,4535,1000.00,15000.00,16000.00,0.00,15000.00,0.32,1
44330,4535,1000.00,16000.00,17000.00,0.00,11051.46,0.39,1
44331,4535,1000.00,17000.00,18000.00,0.00,17000.00,0.17,1
44332,4535,1000.00,18000.00,19000.00,0.00,16398.93,0.43,1
44333,4535,1000.00,19000.00,20000.00,0.00,14576.00,0.39,1
44334,4535,-1000.00,18000.00,19000.00,5157.53,14842.47,0.33,0
44335,4535,-1000.00,17000.00,18000.00,3490.08,11303.62,0.34,0
44336,4535,-1000.00,16000.00,17000.00,5416.13,12583.87,0.32,0
44337,4535,-1000.00,15000.00,16000.00,3314.31,13685.69,0.01,0
44338,4535,-1000.00,14000.00,15000.00,1625.21,14374.79,0.17,0
44339,4535,-1000.00,13000.00,14000.00,1881.80,13118.20,0.40,0
44340,4535,0.00,13000.00,14000.00,0.00,0.00,0.02,0
44341,4535,-1000.00,12000.00,13000.00,3290.21,10709.79,0.38,0
44342,4535,-1000.00,11000.00,12000.00,0.00,13000.00,0.10,0
44343,4535,-1000.00,10000.00,11000.00,0.00,12000.00,0.42,0
44344,4535,-1000.00,9000.00,10000.00,0.00,11000.00,0.22,0
44345,4535,-1000.00,8000.00,9000.00,0.00,9056.42,0.30,0
44346,4535,-1000.00,7000.00,8000.00,5246.14,3753.86,0.17,0
44347,4535,-1000.00,6000.00,7000.00,4585.59,3414.41,0.13,0
44348,4535,-1000.00,5000.00,6000.00,0.00,7000.00,0.27,0
44349,4535,-1000.00,4000.00,5000.00,233.61,0.00,0.08,0
44350,4535,-1000.00,3000.00,4000.00,373.58,4626.42,0.42,0
44351,4535,-304.98,2695.02,3695.02,0.00,304.98,0.13,0
44352,4535,-1000.00,1695.02,2695.02,0.00,3695.02,0.10,0
44353,4535,-1000.00,695.02,1695.02,315.82,2232.99,0.42,0
44354,4535,-1000.00,-304.98,695.02,0.00,1695.02,0.16,0
44355,4535,-681.24,-986.22,13.78,0.00,681.24,0.25,0
44356,4535,-7.59,-993.81,6.19,0.00,7.59,0.32,0
44357,4535,-2.42,-996.23,3.77,0.00,2.42,0.24,0
44358,4535,-3.77,-1000.00,0.00,0.00,3.77,0.19,0
44359,4536,-1000.00,-1000.00,0.00,503.31,496.69,0.02,0
44360,4537,-1000.00,-1000.00,0.00,0.00,1000.00,0.13,0
44361,4538,-1000.00,-1000.00,0.00,169.31,830.69,0.42,0
44362,4539,-195.56,-195.56,804.44,48.81,146.76,0.16,0
44363,4539,-804.44,-1000.00,0.00,0.00,804.44,0.41,0
44364,4540,-1000.00,-1000.00,0.00,522.57,477.43,0.12,0
44365,4541,-127.80,-127.80,872.20,127.80,0.00,0.08,0
44366,4541,-201.90,-329.69,670.31,188.08,13.82,0.11,0
44367,4541,1000.00,670.31,1670.31,0.00,670.31,0.03,1
44368,4541,1000.00,1670.31,2670.31,808.52,861.79,0.23,1
44369,4541,-1000.00,670.31,1670.31,1939.23,731.08,0.02,0
44370,4541,1000.00,1670.31,2670.31,0.00,1021.52,0.36,1
44371,4541,-400.60,1269.71,2269.71,400.60,0.00,0.10,0
44372,4541,1000.00,2269.71,3269.71,0.00,2269.71,0.26,1
44373,4541,1000.00,3269.71,4269.71,0.00,1170.48,0.25,1
44374,4541,1000.00,4269.71,5269.71,0.00,1347.48,0.19,1
44375,4541,1000.00,5269.71,6269.71,2526.17,2743.55,0.16,1
44376,4541,1000.00,6269.71,7269.71,0.00,4970.06,0.22,1
44377,4541,1000.00,7269.71,8269.71,3093.46,4176.25,0.14,1
44378,4541,1000.00,8269.71,9269.71,0.00,5178.08,0.31,1
44379,4541,1000.00,9269.71,10269.71,1276.28,5823.53,0.36,1
44380,4541,1000.00,10269.71,11269.71,0.00,6763.25,0.23,1
44381,4541,1000.00,11269.71,12269.71,3274.84,7994.87,0.35,1
44382,4541,1000.00,12269.71,13269.71,0.00,12269.71,0.37,1
44383,4541,1000.00,13269.71,14269.71,6634.86,6634.86,0.07,1
44384,4541,1000.00,14269.71,15269.71,5623.87,8645.84,0.04,1
44385,4541,1000.00,15269.71,16269.71,3195.39,3561.13,0.18,1
44386,4541,1000.00,16269.71,17269.71,0.00,16269.71,0.06,1
44387,4541,-1000.00,15269.71,16269.71,8634.86,8634.86,0.40,0
44388,4541,-1000.00,14269.71,15269.71,1551.56,8974.10,0.33,0
44389,4541,-1000.00,13269.71,14269.71,0.00,15269.71,0.12,0
44390,4541,-1000.00,12269.71,13269.71,0.00,14269.71,0.19,0
44391,4541,-1000.00,11269.71,12269.71,0.00,6977.72,0.29,0
44392,4541,-1000.00,10269.71,11269.71,0.00,12269.71,0.38,0
44393,4541,-1000.00,9269.71,10269.71,0.00,1955.40,0.10,0
44394,4541,-1000.00,8269.71,9269.71,2455.01,7814.71,0.38,0
44395,4541,-1000.00,7269.71,8269.71,4581.86,2730.34,0.16,0
44396,4541,-1000.00,6269.71,7269.71,504.93,7764.78,0.44,0
44397,4541,-1000.00,5269.71,6269.71,0.00,7269.71,0.36,0
44398,4541,-1000.00,4269.71,5269.71,0.00,6269.71,0.19,0
44399,4541,-1000.00,3269.71,4269.71,2634.86,2634.86,0.03,0
44400,4541,-1000.00,2269.71,3269.71,0.00,3122.84,0.35,0
44401,4541,-1000.00,1269.71,2269.71,0.00,1173.49,0.25,0
44402,4541,-1000.00,269.71,1269.71,0.00,2269.71,0.05,0
44403,4541,-1000.00,-730.29,269.71,228.83,1040.88,0.09,0
44404,4541,-269.71,-1000.00,0.00,0.00,269.71,0.33,0
44405,4542,1000.00,1000.00,2000.00,0.00,1000.00,0.38,1
44406,4542,1000.00,2000.00,3000.00,767.75,1232.25,0.23,1
44407,4542,1000.00,3000.00,4000.00,964.46,2035.54,0.27,1
44408,4542,1000.00,4000.00,5000.00,0.00,4000.00,0.31,1
44409,4542,1000.00,5000.00,6000.00,818.82,4181.18,0.38,1
44410,4542,1000.00,6000.00,7000.00,1776.88,4223.12,0.31,1
44411,4542,1000.00,7000.00,8000.00,1876.64,5123.36,0.34,1
44412,4542,1000.00,8000.00,9000.00,0.00,8000.00,0.29,1
44413,4542,1000.00,9000.00,10000.00,0.00,5534.03,0.36,1
44414,4542,1000.00,10000.00,11000.00,372.63,6558.45,0.37,1
44415,4542,1000.00,11000.00,12000.00,4651.55,6348.45,0.15,1
44416,4542,1000.00,12000.00,13000.00,6000.00,6000.00,0.04,1
44417,4542,1000.00,13000.00,14000.00,0.00,13000.00,0.31,1
44418,4542,1000.00,14000.00,15000.00,0.00,3086.41,0.19,1
44419,4542,1000.00,15000.00,16000.00,0.00,4183.82,0.20,1
44420,4542,-1000.00,14000.00,15000.00,9203.32,6796.68,0.12,0
44421,4542,1000.00,15000.00,16000.00,3873.07,11126.93,0.37,1
44422,4542,1000.00,16000.00,17000.00,881.92,15118.08,0.14,1
44423,4542,1000.00,17000.00,18000.00,3519.09,13480.91,0.38,1
44424,4542,1000.00,18000.00,19000.00,5809.86,12190.14,0.34,1
44425,4542,1000.00,19000.00,20000.00,0.00,18954.09,0.08,1
44426,4542,1000.00,20000.00,21000.00,0.00,16454.41,0.22,1
44427,4542,1000.00,21000.00,22000.00,2534.00,11322.29,0.32,1
44428,4542,1000.00,22000.00,23000.00,2920.90,19079.10,0.11,1
44429,4542,-1000.00,21000.00,22000.00,23000.00,0.00,0.04,0
44430,4542,1000.00,22000.00,23000.00,6590.16,15409.84,0.34,1
44431,4542,1000.00,23000.00,24000.00,0.00,23000.00,0.26,1
44432,4542,1000.00,24000.00,25000.00,2191.68,21808.32,0.41,1
44433,4542,1000.00,25000.00,26000.00,0.00,25000.00,0.15,1
44434,4542,1000.00,26000.00,27000.00,2282.82,13014.56,0.31,1
44435,4542,1000.00,27000.00,28000.00,8069.22,18930.78,0.35,1
44436,4542,1000.00,28000.00,29000.00,12697.09,15302.91,0.09,1
44437,4542,1000.00,29000.00,30000.00,2425.52,26574.48,0.24,1
44438,4542,1000.00,30000.00,31000.00,10254.24,19745.76,0.07,1
44439,4542,1000.00,31000.00,32000.00,0.00,21828.09,0.15,1
44440,4542,1000.00,32000.00,33000.00,0.00,3966.23,0.05,1
44441,4542,1000.00,33000.00,34000.00,0.00,33000.00,0.33,1
44442,4542,1000.00,34000.00,35000.00,0.00,32202.08,0.39,1
44443,4542,1000.00,35000.00,36000.00,6639.81,28360.19,0.26,1
44444,4542,1000.00,36000.00,37000.00,1739.39,10741.34,0.22,1
44445,4542,1000.00,37000.00,38000.00,0.00,37000.00,0.20,1
44446,4542,1000.00,38000.00,39000.00,4935.43,33064.57,0.11,1
44447,4542,0.00,38000.00,39000.00,0.00,0.00,0.06,0
44448,4542,-1000.00,37000.00,38000.00,19564.34,13274.91,0.17,0
44449,4542,1000.00,38000.00,39000.00,18960.76,19039.24,0.12,1
44450,4542,1000.00,39000.00,40000.00,14269.91,24730.09,0.26,1
44451,4542,1000.00,40000.00,41000.00,7570.90,32429.10,0.37,1
44452,4542,-1000.00,39000.00,40000.00,16868.38,24131.62,0.34,0
44453,4542,-1000.00,38000.00,39000.00,19749.80,18776.88,0.21,0
44454,4542,-1000.00,37000.00,38000.00,0.00,28579.94,0.14,0
44455,4542,0.00,37000.00,38000.00,0.00,0.00,0.04,0
44456,4542,-1000.00,36000.00,37000.00,0.00,38000.00,0.11,0
44457,4542,-1000.00,35000.00,36000.00,7652.97,17243.34,0.28,0
44458,4542,-1000.00,34000.00,35000.00,0.00,1557.16,0.12,0
44459,4542,-1000.00,33000.00,34000.00,0.00,35000.00,0.21,0
44460,4542,-1000.00,32000.00,33000.00,0.00,29251.24,0.42,0
44461,4542,-1000.00,31000.00,32000.00,16500.00,16500.00,0.05,0
44462,4542,-1000.00,30000.00,31000.00,5221.41,26778.59,0.42,0
44463,4542,-1000.00,29000.00,30000.00,0.00,31000.00,0.21,0
44464,4542,-1000.00,28000.00,29000.00,0.00,21991.83,0.26,0
44465,4542,-1000.00,27000.00,28000.00,19679.33,9320.67,0.06,0
44466,4542,-1000.00,26000.00,27000.00,0.00,28000.00,0.25,0
44467,4542,-1000.00,25000.00,26000.00,0.00,27000.00,0.35,0
44468,4542,-1000.00,24000.00,25000.00,0.00,2103.04,0.08,0
44469,4542,-1000.00,23000.00,24000.00,0.00,12000.58,0.27,0
44470,4542,-1000.00,22000.00,23000.00,454.16,23545.84,0.32,0
44471,4542,-1000.00,21000.00,22000.00,0.00,23000.00,0.02,0
44472,4542,-1000.00,20000.00,21000.00,0.00,22000.00,0.32,0
44473,4543,1000.00,1000.00,2000.00,0.00,491.85,0.28,1
44474,4543,-1000.00,0.00,1000.00,1158.29,841.71,0.13,0
44475,4543,1000.00,1000.00,2000.00,0.00,1000.00,0.21,1
44476,4543,1000.00,2000.00,3000.00,458.16,1541.84,0.39,1
44477,4543,1000.00,3000.00,4000.00,0.00,3000.00,0.37,1
44478,4543,1000.00,4000.00,5000.00,0.00,3131.96,0.41,1
44479,4543,1000.00,5000.00,6000.00,0.00,1516.73,0.21,1
44480,4543,1000.00,6000.00,7000.00,0.00,5382.70,0.43,1
44481,4543,1000.00,7000.00,8000.00,0.00,7000.00,0.07,1
44482,4543,1000.00,8000.00,9000.00,0.00,8000.00,0.28,1
44483,4543,1000.00,9000.00,10000.00,1589.61,7410.39,0.40,1
44484,4543,-1000.00,8000.00,9000.00,8004.12,607.05,0.05,0
44485,4543,1000.00,9000.00,10000.00,0.00,2657.72,0.20,1
44486,4543,-1000.00,8000.00,9000.00,2774.00,2209.80,0.17,0
44487,4543,1000.00,9000.00,10000.00,0.00,5520.72,0.36,1
44488,4543,1000.00,10000.00,11000.00,360.47,3358.42,0.24,1
44489,4543,1000.00,11000.00,12000.00,0.00,11000.00,0.32,1
44490,4543,1000.00,12000.00,13000.00,0.00,9457.73,0.23,1
44491,4543,1000.00,13000.00,14000.00,0.00,13000.00,0.18,1
44492,4543,1000.00,14000.00,15000.00,0.00,14000.00,0.00,1
44493,4543,1000.00,15000.00,16000.00,6353.10,8646.90,0.40,1
44494,4543,-1000.00,14000.00,15000.00,7557.33,3007.90,0.13,0
44495,4543,-1000.00,13000.00,14000.00,4536.57,1508.75,0.13,0
44496,4543,-1000.00,12000.00,13000.00,2552.73,3326.32,0.19,0
44497,4543,-1000.00,11000.00,12000.00,5136.25,2314.41,0.14,0
44498,4543,-1000.00,10000.00,11000.00,0.00,3879.97,0.21,0
44499,4543,-1000.00,9000.00,10000.00,0.00,11000.00,0.32,0
44500,4543,-1000.00,8000.00,9000.00,4234.43,5765.57,0.27,0
44501,4543,-1000.00,7000.00,8000.00,0.00,9000.00,0.06,0
44502,4543,-1000.00,6000.00,7000.00,0.00,2400.95,0.09,0
44503,4543,-1000.00,5000.00,6000.00,1005.99,5994.01,0.39,0
44504,4543,-1000.00,4000.00,5000.00,2902.47,3097.53,0.09,0
44505,4543,-1000.00,3000.00,4000.00,743.40,4256.60,0.00,0
44506,4543,-1000.00,2000.00,3000.00,0.00,2288.34,0.32,0
44507,4543,-212.41,1787.59,2787.59,0.00,212.41,0.06,0
44508,4543,-650.81,1136.78,2136.78,0.00,650.81,0.08,0
44509,4543,-1000.00,136.78,1136.78,1143.77,993.01,0.10,0
44510,4543,-526.20,-389.42,610.58,0.00,526.20,0.13,0
44511,4543,-583.15,-972.57,27.43,0.00,583.15,0.30,0
44512,4543,0.00,-972.57,27.43,0.00,0.00,0.01,0
44513,4543,-19.17,-991.74,8.26,0.00,19.17,0.25,0
44514,4543,-8.26,-1000.00,0.00,0.00,8.26,0.35,0
44515,4544,-1000.00,-1000.00,0.00,0.00,1000.00,0.10,0
44516,4545,0.00,0.00,1000.00,0.00,0.00,0.29,0
44517,4545,-743.88,-743.88,256.12,219.22,524.66,0.33,0
44518,4545,1000.00,256.12,1256.12,145.28,110.84,0.15,1
44519,4545,0.00,256.12,1256.12,0.00,0.00,0.19,0
44520,4545,-558.20,-302.09,697.91,0.00,558.20,0.16,0
44521,4545,-697.91,-1000.00,0.00,323.14,374.77,0.05,0
44522,4546,1000.00,1000.00,2000.00,0.00,1000.00,0.10,1
44523,4546,1000.00,2000.00,3000.00,0.00,1218.47,0.16,1
44524,4546,1000.00,3000.00,4000.00,1500.00,1500.00,0.07,1
44525,4546,1000.00,4000.00,5000.00,0.00,4000.00,0.20,1
44526,4546,-1000.00,3000.00,4000.00,3222.27,1777.73,0.30,0
44527,4546,-1000.00,2000.00,3000.00,3080.48,919.52,0.02,0
44528,4546,1000.00,3000.00,4000.00,49.61,2950.39,0.43,1
44529,4546,1000.00,4000.00,5000.00,0.00,1559.17,0.06,1
44530,4546,1000.00,5000.00,6000.00,0.00,2137.87,0.12,1
44531,4546,1000.00,6000.00,7000.00,0.00,4680.79,0.23,1
44532,4546,1000.00,7000.00,8000.00,2315.31,4684.69,0.20,1
44533,4546,1000.00,8000.00,9000.00,0.00,8000.00,0.06,1
44534,4546,1000.00,9000.00,10000.00,4284.50,4715.50,0.16,1
44535,4546,1000.00,10000.00,11000.00,0.00,10000.00,0.37,1
44536,4546,1000.00,11000.00,12000.00,4714.82,6285.18,0.43,1
44537,4546,1000.00,12000.00,13000.00,3916.16,8083.84,0.38,1
44538,4546,1000.00,13000.00,14000.00,2725.06,9142.26,0.37,1
44539,4546,1000.00,14000.00,15000.00,3257.77,10742.23,0.15,1
44540,4546,-1000.00,13000.00,14000.00,8239.09,6760.91,0.10,0
44541,4546,1000.00,14000.00,15000.00,0.00,12045.31,0.40,1
44542,4546,1000.00,15000.00,16000.00,0.00,3590.56,0.10,1
44543,4546,-1000.00,14000.00,15000.00,7407.85,1151.30,0.11,0
44544,4546,1000.00,15000.00,16000.00,7429.93,7570.07,0.16,1
44545,4546,1000.00,16000.00,17000.00,7857.92,8142.08,0.11,1
44546,4546,1000.00,17000.00,18000.00,0.00,17000.00,0.24,1
44547,4546,1000.00,18000.00,19000.00,0.00,17278.47,0.04,1
44548,4546,1000.00,19000.00,20000.00,0.00,12869.17,0.25,1
44549,4546,1000.00,20000.00,21000.00,0.00,20000.00,0.08,1
44550,4546,1000.00,21000.00,22000.00,0.00,19061.26,0.23,1
44551,4546,1000.00,22000.00,23000.00,6228.19,15771.81,0.05,1
44552,4546,1000.00,23000.00,24000.00,10309.78,12690.22,0.15,1
44553,4546,1000.00,24000.00,25000.00,6403.66,17596.34,0.38,1
44554,4546,1000.00,25000.00,26000.00,0.00,25000.00,0.14,1
44555,4546,1000.00,26000.00,27000.00,0.00,6668.77,0.13,1
44556,4546,-1000.00,25000.00,26000.00,6583.20,1160.35,0.11,0
44557,4546,1000.00,26000.00,27000.00,5569.43,20430.57,0.43,1
44558,4546,1000.00,27000.00,28000.00,0.00,17658.17,0.37,1
44559,4546,1000.00,28000.00,29000.00,3026.79,3349.51,0.14,1
44560,4546,1000.00,29000.00,30000.00,0.00,22717.73,0.33,1
44561,4546,1000.00,30000.00,31000.00,14599.51,15400.49,0.23,1
44562,4546,1000.00,31000.00,32000.00,0.00,31000.00,0.38,1
44563,4546,1000.00,32000.00,33000.00,3155.99,28844.01,0.26,1
44564,4546,-1000.00,31000.00,32000.00,19125.48,13874.52,0.17,0
44565,4546,1000.00,32000.00,33000.00,0.00,9341.40,0.09,1
44566,4546,1000.00,33000.00,34000.00,8099.57,24900.43,0.39,1
44567,4547,-362.55,-362.55,637.45,291.69,70.86,0.12,0
44568,4547,-1000.00,-1362.55,-362.55,176.65,460.80,0.31,0
44569,4548,-1000.00,-1000.00,0.00,0.00,1000.00,0.29,0
44570,4549,1000.00,1000.00,2000.00,301.44,698.56,0.35,1
44571,4549,1000.00,2000.00,3000.00,0.00,2000.00,0.26,1
44572,4549,1000.00,3000.00,4000.00,0.00,199.35,0.02,1
44573,4549,1000.00,4000.00,5000.00,1277.47,2722.53,0.33,1
44574,4549,1000.00,5000.00,6000.00,1911.26,3088.74,0.26,1
44575,4549,-1000.00,4000.00,5000.00,3027.19,2972.81,0.05,0
44576,4549,1000.00,5000.00,6000.00,0.00,5000.00,0.18,1
44577,4549,1000.00,6000.00,7000.00,203.59,4537.99,0.41,1
44578,4549,1000.00,7000.00,8000.00,1581.12,5418.88,0.12,1
44579,4549,1000.00,8000.00,9000.00,0.00,8000.00,0.35,1
44580,4549,1000.00,9000.00,10000.00,0.00,5744.98,0.32,1
44581,4549,1000.00,10000.00,11000.00,1491.27,8508.73,0.42,1
44582,4549,-1000.00,9000.00,10000.00,8229.63,2770.37,0.06,0
44583,4549,1000.00,10000.00,11000.00,1573.19,8426.81,0.24,1
44584,4549,1000.00,11000.00,12000.00,2615.52,8384.48,0.10,1
44585,4549,1000.00,12000.00,13000.00,893.14,11106.86,0.34,1
44586,4549,-1000.00,11000.00,12000.00,7419.40,5580.60,0.39,0
44587,4549,1000.00,12000.00,13000.00,0.00,12000.00,0.08,1
44588,4549,1000.00,13000.00,14000.00,0.00,13000.00,0.01,1
44589,4549,1000.00,14000.00,15000.00,0.00,14000.00,0.12,1
44590,4549,-1000.00,13000.00,14000.00,3863.35,0.00,0.08,0
44591,4549,1000.00,14000.00,15000.00,6831.03,7168.97,0.16,1
44592,4549,1000.00,15000.00,16000.00,0.00,15000.00,0.33,1
44593,4549,1000.00,16000.00,17000.00,0.00,13875.13,0.42,1
44594,4549,1000.00,17000.00,18000.00,8479.92,8520.08,0.13,1
44595,4549,1000.00,18000.00,19000.00,0.00,11470.13,0.36,1
44596,4549,1000.00,19000.00,20000.00,0.00,4075.68,0.13,1
44597,4549,-1000.00,18000.00,19000.00,13170.13,6829.87,0.02,0
44598,4549,1000.00,19000.00,20000.00,0.00,19000.00,0.42,1
44599,4549,1000.00,20000.00,21000.00,1011.56,18988.44,0.02,1
44600,4549,1000.00,21000.00,22000.00,0.00,17249.96,0.18,1
44601,4549,1000.00,22000.00,23000.00,9810.45,12189.55,0.05,1
44602,4549,1000.00,23000.00,24000.00,0.00,20344.23,0.31,1
44603,4549,-775.07,22224.93,23224.93,775.07,0.00,0.03,0
44604,4549,1000.00,23224.93,24224.93,0.00,15372.89,0.36,1
44605,4549,1000.00,24224.93,25224.93,0.00,18882.83,0.41,1
44606,4549,1000.00,25224.93,26224.93,8085.40,17139.53,0.30,1
44607,4549,1000.00,26224.93,27224.93,13112.47,13112.47,0.26,1
44608,4549,1000.00,27224.93,28224.93,0.00,27224.93,0.18,1
44609,4549,1000.00,28224.93,29224.93,2235.09,18565.70,0.37,1
44610,4549,1000.00,29224.93,30224.93,0.00,8971.06,0.22,1
44611,4550,0.00,0.00,1000.00,0.00,0.00,0.38,0
44612,4550,-835.42,-835.42,164.58,325.98,509.44,0.27,0
44613,4550,0.00,-835.42,164.58,0.00,0.00,0.07,0
44614,4550,-164.58,-1000.00,0.00,82.29,82.29,0.02,0
44615,4551,-1000.00,-1000.00,0.00,494.80,505.20,0.02,0
44616,4552,1000.00,1000.00,2000.00,97.84,902.16,0.14,1
44617,4552,1000.00,2000.00,3000.00,0.00,1421.11,0.38,1
44618,4552,1000.00,3000.00,4000.00,1500.00,1500.00,0.01,1
44619,4552,1000.00,4000.00,5000.00,170.78,1969.59,0.31,1
44620,4552,1000.00,5000.00,6000.00,0.00,3564.97,0.27,1
44621,4552,1000.00,6000.00,7000.00,1156.85,4843.15,0.37,1
44622,4552,1000.00,7000.00,8000.00,0.00,3804.14,0.13,1
44623,4552,1000.00,8000.00,9000.00,0.00,8000.00,0.07,1
44624,4552,1000.00,9000.00,10000.00,0.00,7650.57,0.43,1
44625,4552,1000.00,10000.00,11000.00,0.00,5553.78,0.26,1
44626,4552,1000.00,11000.00,12000.00,0.00,2823.50,0.15,1
44627,4552,1000.00,12000.00,13000.00,0.00,8946.69,0.21,1
44628,4552,1000.00,13000.00,14000.00,0.00,13000.00,0.35,1
44629,4552,1000.00,14000.00,15000.00,2580.47,11414.83,0.40,1
44630,4552,1000.00,15000.00,16000.00,7195.94,7804.06,0.17,1
44631,4552,1000.00,16000.00,17000.00,997.12,6547.31,0.27,1
44632,4552,-1000.00,15000.00,16000.00,10046.26,6953.74,0.34,0
44633,4552,0.00,15000.00,16000.00,0.00,0.00,0.04,0
44634,4552,-1000.00,14000.00,15000.00,3730.81,0.00,0.09,0
44635,4552,1000.00,15000.00,16000.00,6202.42,8797.58,0.05,1
44636,4552,1000.00,16000.00,17000.00,8000.00,8000.00,0.03,1
44637,4552,1000.00,17000.00,18000.00,6628.30,10371.70,0.15,1
44638,4552,1000.00,18000.00,19000.00,2308.70,15691.30,0.43,1
44639,4552,1000.00,19000.00,20000.00,0.00,8773.13,0.18,1
44640,4552,-1000.00,18000.00,19000.00,11459.72,8540.28,0.11,0
44641,4552,-1000.00,17000.00,18000.00,0.00,10188.28,0.31,0
44642,4552,-1000.00,16000.00,17000.00,0.00,18000.00,0.10,0
44643,4552,0.00,16000.00,17000.00,0.00,0.00,0.01,0
44644,4552,-1000.00,15000.00,16000.00,4275.58,5084.26,0.20,0
44645,4552,-1000.00,14000.00,15000.00,934.62,15065.38,0.16,0
44646,4552,-1000.00,13000.00,14000.00,4289.55,10710.45,0.13,0
44647,4552,-1000.00,12000.00,13000.00,0.00,13640.76,0.44,0
44648,4552,-1000.00,11000.00,12000.00,4589.10,8410.90,0.28,0
44649,4552,-1000.00,10000.00,11000.00,0.00,12000.00,0.13,0
44650,4552,-1000.00,9000.00,10000.00,0.00,11000.00,0.36,0
44651,4552,-1000.00,8000.00,9000.00,0.00,9430.86,0.44,0
44652,4552,-1000.00,7000.00,8000.00,0.00,4440.34,0.26,0
44653,4552,-1000.00,6000.00,7000.00,0.00,6653.71,0.42,0
44654,4552,-1000.00,5000.00,6000.00,141.26,5452.11,0.41,0
44655,4552,-1000.00,4000.00,5000.00,485.24,4689.37,0.41,0
44656,4552,-1000.00,3000.00,4000.00,624.65,4375.35,0.35,0
44657,4553,-989.25,-989.25,10.75,83.11,906.14,0.44,0
44658,4553,-846.49,-1835.75,-835.75,5.53,5.22,0.22,0
44659,4554,1000.00,1000.00,2000.00,309.53,690.47,0.34,1
44660,4554,1000.00,2000.00,3000.00,0.00,2000.00,0.08,1
44661,4554,1000.00,3000.00,4000.00,0.00,3000.00,0.22,1
44662,4554,1000.00,4000.00,5000.00,0.00,4000.00,0.43,1
44663,4554,1000.00,5000.00,6000.00,0.00,5000.00,0.44,1
44664,4554,1000.00,6000.00,7000.00,2236.74,3763.26,0.26,1
44665,4554,1000.00,7000.00,8000.00,2455.19,4544.81,0.32,1
44666,4554,1000.00,8000.00,9000.00,0.00,6567.80,0.41,1
44667,4554,1000.00,9000.00,10000.00,754.48,8245.52,0.38,1
44668,4554,1000.00,10000.00,11000.00,0.00,6723.02,0.25,1
44669,4554,-1000.00,9000.00,10000.00,3764.06,0.00,0.02,0
44670,4554,1000.00,10000.00,11000.00,1991.36,6034.63,0.34,1
44671,4554,1000.00,11000.00,12000.00,0.00,442.70,0.09,1
44672,4554,1000.00,12000.00,13000.00,0.00,5551.30,0.12,1
44673,4554,1000.00,13000.00,14000.00,3064.14,9935.86,0.09,1
44674,4554,1000.00,14000.00,15000.00,6729.70,7270.30,0.06,1
44675,4554,1000.00,15000.00,16000.00,6662.36,8337.64,0.29,1
44676,4554,1000.00,16000.00,17000.00,0.00,14497.82,0.43,1
44677,4554,1000.00,17000.00,18000.00,0.00,16721.24,0.37,1
44678,4554,1000.00,18000.00,19000.00,0.00,12319.84,0.37,1
44679,4554,1000.00,19000.00,20000.00,0.00,14064.77,0.39,1
44680,4554,1000.00,20000.00,21000.00,5754.02,14245.98,0.15,1
44681,4554,-1000.00,19000.00,20000.00,7753.79,13246.21,0.13,0
44682,4554,-1000.00,18000.00,19000.00,5747.24,10464.18,0.29,0
44683,4554,-1000.00,17000.00,18000.00,0.00,16740.60,0.40,0
44684,4554,-1000.00,16000.00,17000.00,0.00,18000.00,0.13,0
44685,4554,-1000.00,15000.00,16000.00,0.00,15127.16,0.33,0
44686,4554,-1000.00,14000.00,15000.00,1183.77,12105.77,0.40,0
44687,4554,-1000.00,13000.00,14000.00,0.00,13353.56,0.19,0
44688,4554,-1000.00,12000.00,13000.00,6888.44,7111.56,0.08,0
44689,4554,-1000.00,11000.00,12000.00,0.00,8673.39,0.35,0
44690,4554,-1000.00,10000.00,11000.00,0.00,12000.00,0.14,0
44691,4554,-1000.00,9000.00,10000.00,5500.00,5500.00,0.02,0
44692,4554,-1000.00,8000.00,9000.00,2802.45,1880.21,0.18,0
44693,4554,-1000.00,7000.00,8000.00,42.43,8957.57,0.41,0
44694,4554,-1000.00,6000.00,7000.00,0.00,8000.00,0.03,0
44695,4554,-1000.00,5000.00,6000.00,2559.07,4440.93,0.31,0
44696,4554,-1000.00,4000.00,5000.00,590.71,5312.26,0.43,0
44697,4554,-1000.00,3000.00,4000.00,1169.60,3830.40,0.38,0
44698,4554,-1000.00,2000.00,3000.00,373.47,3626.53,0.43,0
44699,4554,-1000.00,1000.00,2000.00,507.89,2492.11,0.09,0
44700,4554,-1000.00,0.00,1000.00,0.00,2000.00,0.10,0
44701,4554,1000.00,1000.00,2000.00,0.00,335.41,0.24,1
44702,4554,1000.00,2000.00,3000.00,349.73,1650.27,0.22,1
44703,4554,1000.00,3000.00,4000.00,759.70,2240.30,0.17,1
44704,4554,-1000.00,2000.00,3000.00,1570.34,2429.66,0.25,0
44705,4554,-1000.00,1000.00,2000.00,1378.43,578.86,0.31,0
44706,4554,-912.11,87.89,1087.89,912.11,0.00,0.26,0
44707,4554,0.00,87.89,1087.89,0.00,0.00,0.23,0
44708,4554,0.00,87.89,1087.89,0.00,0.00,0.15,0
44709,4554,-1000.00,-912.11,87.89,13.29,711.33,0.24,0
44710,4554,1000.00,87.89,1087.89,24.00,63.89,0.36,1
44711,4554,1000.00,1087.89,2087.89,543.95,543.95,0.36,1
44712,4554,1000.00,2087.89,3087.89,387.17,590.86,0.21,1
44713,4554,1000.00,3087.89,4087.89,747.27,2340.62,0.07,1
44714,4554,1000.00,4087.89,5087.89,1975.52,2112.37,0.04,1
44715,4554,1000.00,5087.89,6087.89,0.00,5087.89,0.42,1
44716,4554,1000.00,6087.89,7087.89,2619.63,3468.26,0.19,1
44717,4554,1000.00,7087.89,8087.89,0.00,7087.89,0.26,1
44718,4554,1000.00,8087.89,9087.89,0.00,8087.89,0.19,1
44719,4554,1000.00,9087.89,10087.89,0.00,9087.89,0.17,1
44720,4554,-1000.00,8087.89,9087.89,5677.65,4410.24,0.23,0
44721,4554,1000.00,9087.89,10087.89,0.00,8819.38,0.37,1
44722,4554,1000.00,10087.89,11087.89,0.00,7144.08,0.33,1
44723,4555,-1000.00,-1000.00,0.00,335.55,664.45,0.22,0
44724,4556,-1000.00,-1000.00,0.00,0.00,683.54,0.14,0
44725,4557,1000.00,1000.00,2000.00,0.00,655.88,0.19,1
44726,4557,0.00,1000.00,2000.00,0.00,0.00,0.00,0
44727,4557,1000.00,2000.00,3000.00,0.00,2000.00,0.13,1
44728,4557,1000.00,3000.00,4000.00,334.50,782.38,0.36,1
44729,4557,1000.00,4000.00,5000.00,0.00,3750.06,0.22,1
44730,4557,1000.00,5000.00,6000.00,1969.99,3030.01,0.28,1
44731,4557,1000.00,6000.00,7000.00,1963.34,4036.66,0.22,1
44732,4557,1000.00,7000.00,8000.00,662.90,6113.81,0.37,1
44733,4557,1000.00,8000.00,9000.00,3163.93,4836.07,0.24,1
44734,4557,1000.00,9000.00,10000.00,0.00,1388.65,0.35,1
44735,4557,1000.00,10000.00,11000.00,0.00,10000.00,0.01,1
44736,4557,0.00,10000.00,11000.00,0.00,0.00,0.16,0
44737,4557,1000.00,11000.00,12000.00,0.00,11000.00,0.12,1
44738,4557,1000.00,12000.00,13000.00,2822.49,9177.51,0.39,1
44739,4557,1000.00,13000.00,14000.00,0.00,5160.08,0.35,1
44740,4557,0.00,13000.00,14000.00,0.00,0.00,0.39,0
44741,4557,-1000.00,12000.00,13000.00,11844.93,0.00,0.04,0
44742,4557,1000.00,13000.00,14000.00,6500.00,6500.00,0.06,1
44743,4557,1000.00,14000.00,15000.00,5668.57,8331.43,0.10,1
44744,4557,1000.00,15000.00,16000.00,0.00,15000.00,0.24,1
44745,4557,1000.00,16000.00,17000.00,0.00,12838.07,0.21,1
44746,4557,1000.00,17000.00,18000.00,4886.04,10152.59,0.31,1
44747,4557,1000.00,18000.00,19000.00,8147.60,9852.40,0.11,1
44748,4557,-1000.00,17000.00,18000.00,7373.32,0.00,0.10,0
44749,4557,-1000.00,16000.00,17000.00,12628.66,0.00,0.00,0
44750,4557,1000.00,17000.00,18000.00,2471.08,14103.76,0.42,1
44751,4557,1000.00,18000.00,19000.00,0.00,15722.70,0.26,1
44752,4557,1000.00,19000.00,20000.00,0.00,19000.00,0.42,1
44753,4557,1000.00,20000.00,21000.00,0.00,1738.98,0.14,1
44754,4557,-1000.00,19000.00,20000.00,15286.45,5713.55,0.05,0
44755,4557,1000.00,20000.00,21000.00,4702.95,15297.05,0.22,1
44756,4557,1000.00,21000.00,22000.00,7866.50,13133.50,0.15,1
44757,4557,1000.00,22000.00,23000.00,5713.23,16286.77,0.22,1
44758,4557,1000.00,23000.00,24000.00,0.00,7417.22,0.22,1
44759,4557,1000.00,24000.00,25000.00,1133.13,15828.23,0.38,1
44760,4557,1000.00,25000.00,26000.00,12500.00,12500.00,0.03,1
44761,4557,1000.00,26000.00,27000.00,0.00,26000.00,0.29,1
44762,4557,1000.00,27000.00,28000.00,5735.18,20743.37,0.39,1
44763,4557,1000.00,28000.00,29000.00,14000.00,14000.00,0.18,1
44764,4557,1000.00,29000.00,30000.00,7109.06,21890.94,0.37,1
44765,4557,1000.00,30000.00,31000.00,15000.00,15000.00,0.35,1
44766,4557,1000.00,31000.00,32000.00,13789.45,17210.55,0.04,1
44767,4557,1000.00,32000.00,33000.00,3012.35,23161.81,0.39,1
44768,4558,0.00,0.00,1000.00,0.00,0.00,0.05,0
44769,4558,-845.22,-845.22,154.78,0.00,845.22,0.36,0
44770,4558,-154.78,-1000.00,0.00,45.01,109.77,0.35,0
44771,4559,-1000.00,-1000.00,0.00,178.43,821.57,0.41,0
44772,4560,1000.00,1000.00,2000.00,769.78,230.22,0.09,1
44773,4560,-1000.00,0.00,1000.00,831.59,1168.41,0.28,0
44774,4560,1000.00,1000.00,2000.00,377.94,0.00,0.02,1
44775,4560,-1000.00,0.00,1000.00,497.05,1502.95,0.27,0
44776,4560,1000.00,1000.00,2000.00,585.46,414.54,0.16,1
44777,4560,-1000.00,0.00,1000.00,0.00,1728.27,0.35,0
44778,4560,-1000.00,-1000.00,0.00,320.43,679.57,0.28,0
44779,4561,1000.00,1000.00,2000.00,28.35,772.31,0.41,1
44780,4561,1000.00,2000.00,3000.00,0.00,2000.00,0.08,1
44781,4561,1000.00,3000.00,4000.00,1500.00,1500.00,0.03,1
44782,4561,1000.00,4000.00,5000.00,0.00,4000.00,0.05,1
44783,4561,1000.00,5000.00,6000.00,2500.00,2500.00,0.27,1
44784,4561,1000.00,6000.00,7000.00,0.00,1002.09,0.01,1
44785,4561,1000.00,7000.00,8000.00,1838.86,5161.14,0.33,1
44786,4561,1000.00,8000.00,9000.00,0.00,8000.00,0.25,1
44787,4561,1000.00,9000.00,10000.00,0.00,1505.57,0.17,1
44788,4561,1000.00,10000.00,11000.00,0.00,10000.00,0.15,1
44789,4561,1000.00,11000.00,12000.00,0.00,11000.00,0.01,1
44790,4561,1000.00,12000.00,13000.00,0.00,7713.54,0.23,1
44791,4561,1000.00,13000.00,14000.00,3752.44,3935.28,0.20,1
44792,4561,1000.00,14000.00,15000.00,1876.71,12123.29,0.43,1
44793,4561,1000.00,15000.00,16000.00,0.00,6348.60,0.14,1
44794,4561,1000.00,16000.00,17000.00,797.54,15202.46,0.29,1
44795,4561,1000.00,17000.00,18000.00,0.00,12654.96,0.13,1
44796,4561,1000.00,18000.00,19000.00,958.99,12055.43,0.14,1
44797,4561,1000.00,19000.00,20000.00,0.00,19000.00,0.14,1
44798,4561,1000.00,20000.00,21000.00,0.00,20000.00,0.28,1
44799,4561,1000.00,21000.00,22000.00,0.00,21000.00,0.28,1
44800,4561,-1000.00,20000.00,21000.00,11624.38,10375.62,0.09,0
44801,4561,-1000.00,19000.00,20000.00,9244.66,11755.34,0.11,0
44802,4561,-1000.00,18000.00,19000.00,0.00,20000.00,0.16,0
44803,4561,-1000.00,17000.00,18000.00,3406.74,15593.26,0.41,0
44804,4561,-1000.00,16000.00,17000.00,0.00,18000.00,0.22,0
44805,4561,-1000.00,15000.00,16000.00,0.00,9127.26,0.33,0
44806,4561,-1000.00,14000.00,15000.00,624.12,14958.28,0.44,0
44807,4561,-1000.00,13000.00,14000.00,5503.39,9496.61,0.23,0
44808,4561,-1000.00,12000.00,13000.00,5800.26,5347.54,0.20,0
44809,4561,-1000.00,11000.00,12000.00,0.00,7679.67,0.24,0
44810,4561,-1000.00,10000.00,11000.00,0.00,12000.00,0.17,0
44811,4561,-1000.00,9000.00,10000.00,0.00,11000.00,0.23,0
44812,4561,-1000.00,8000.00,9000.00,2713.42,0.00,0.04,0
44813,4561,-1000.00,7000.00,8000.00,0.00,5485.48,0.36,0
44814,4561,-1000.00,6000.00,7000.00,3019.20,4980.80,0.26,0
44815,4561,-1000.00,5000.00,6000.00,457.59,6542.41,0.41,0
44816,4561,-1000.00,4000.00,5000.00,1216.68,4783.32,0.25,0
44817,4561,-1000.00,3000.00,4000.00,0.00,5000.00,0.16,0
44818,4561,-1000.00,2000.00,3000.00,1571.36,2428.64,0.18,0
44819,4561,0.00,2000.00,3000.00,0.00,0.00,0.03,0
44820,4561,-1000.00,1000.00,2000.00,1500.00,1500.00,0.34,0
44821,4561,-1000.00,0.00,1000.00,939.41,1060.59,0.14,0
44822,4561,-1000.00,-1000.00,0.00,0.00,1000.00,0.05,0
44823,4562,1000.00,1000.00,2000.00,0.00,1000.00,0.18,1
44824,4562,1000.00,2000.00,3000.00,533.02,1466.98,0.18,1
44825,4562,1000.00,3000.00,4000.00,0.00,3000.00,0.11,1
44826,4562,1000.00,4000.00,5000.00,0.00,4000.00,0.28,1
44827,4562,1000.00,5000.00,6000.00,0.00,5000.00,0.43,1
44828,4562,1000.00,6000.00,7000.00,0.00,2568.34,0.28,1
44829,4562,1000.00,7000.00,8000.00,1061.35,5776.02,0.41,1
44830,4562,1000.00,8000.00,9000.00,0.00,8000.00,0.02,1
44831,4562,1000.00,9000.00,10000.00,0.00,3305.35,0.15,1
44832,4562,1000.00,10000.00,11000.00,0.00,9334.92,0.10,1
44833,4562,1000.00,11000.00,12000.00,3115.62,5167.67,0.27,1
44834,4562,1000.00,12000.00,13000.00,0.00,11570.81,0.41,1
44835,4562,1000.00,13000.00,14000.00,2280.32,10719.68,0.34,1
44836,4562,1000.00,14000.00,15000.00,3966.78,10033.22,0.02,1
44837,4562,1000.00,15000.00,16000.00,0.00,11201.61,0.26,1
44838,4562,1000.00,16000.00,17000.00,0.00,587.88,0.06,1
44839,4562,1000.00,17000.00,18000.00,0.00,15626.15,0.44,1
44840,4562,1000.00,18000.00,19000.00,0.00,18000.00,0.13,1
44841,4562,1000.00,19000.00,20000.00,251.68,18748.32,0.21,1
44842,4562,1000.00,20000.00,21000.00,1495.38,18504.62,0.42,1
44843,4562,1000.00,21000.00,22000.00,8918.57,12081.43,0.04,1
44844,4562,1000.00,22000.00,23000.00,0.00,22000.00,0.28,1
44845,4562,1000.00,23000.00,24000.00,7273.48,15726.52,0.30,1
44846,4562,1000.00,24000.00,25000.00,7850.49,16149.51,0.32,1
44847,4562,-1000.00,23000.00,24000.00,14880.41,10119.59,0.15,0
44848,4562,-1000.00,22000.00,23000.00,24000.00,0.00,0.00,0
44849,4562,-1000.00,21000.00,22000.00,0.00,23000.00,0.17,0
44850,4562,-1000.00,20000.00,21000.00,5974.24,14415.88,0.34,0
44851,4562,-1000.00,19000.00,20000.00,9992.86,5355.37,0.15,0
44852,4562,-1000.00,18000.00,19000.00,0.00,17381.58,0.19,0
44853,4562,-1000.00,17000.00,18000.00,0.00,19000.00,0.31,0
44854,4562,-1000.00,16000.00,17000.00,0.00,11510.91,0.37,0
44855,4562,-1000.00,15000.00,16000.00,8083.45,8916.55,0.22,0
44856,4562,-1000.00,14000.00,15000.00,0.00,16000.00,0.11,0
44857,4562,-1000.00,13000.00,14000.00,373.22,9890.41,0.38,0
44858,4562,-1000.00,12000.00,13000.00,1443.79,12556.21,0.11,0
44859,4562,-1000.00,11000.00,12000.00,0.00,9444.27,0.31,0
44860,4562,-1000.00,10000.00,11000.00,0.00,12000.00,0.14,0
44861,4562,-1000.00,9000.00,10000.00,6430.87,4569.13,0.12,0
44862,4562,-1000.00,8000.00,9000.00,0.00,4142.22,0.26,0
44863,4562,-1000.00,7000.00,8000.00,0.00,9000.00,0.26,0
44864,4562,-1000.00,6000.00,7000.00,1837.00,6163.00,0.06,0
44865,4562,-1000.00,5000.00,6000.00,0.00,7000.00,0.26,0
44866,4562,-1000.00,4000.00,5000.00,1262.61,3532.05,0.33,0
44867,4562,-1000.00,3000.00,4000.00,0.00,4606.94,0.41,0
44868,4563,-1000.00,-1000.00,0.00,0.00,1000.00,0.06,0
44869,4564,-1000.00,-1000.00,0.00,0.00,1000.00,0.11,0
44870,4565,0.00,0.00,1000.00,0.00,0.00,0.39,0
44871,4565,-403.20,-403.20,596.80,0.00,403.20,0.03,0
44872,4565,0.00,-403.20,596.80,0.00,0.00,0.42,0
44873,4565,0.00,-403.20,596.80,0.00,0.00,0.22,0
44874,4565,-596.80,-1000.00,0.00,138.91,457.89,0.11,0
44875,4566,1000.00,1000.00,2000.00,337.45,615.77,0.34,1
44876,4566,1000.00,2000.00,3000.00,0.00,1048.66,0.33,1
44877,4566,1000.00,3000.00,4000.00,0.00,3000.00,0.38,1
44878,4566,1000.00,4000.00,5000.00,484.93,3023.59,0.40,1
44879,4566,1000.00,5000.00,6000.00,1867.19,3132.81,0.26,1
44880,4566,1000.00,6000.00,7000.00,1438.45,4561.55,0.23,1
44881,4566,1000.00,7000.00,8000.00,108.91,6891.09,0.40,1
44882,4566,1000.00,8000.00,9000.00,0.00,8000.00,0.26,1
44883,4566,1000.00,9000.00,10000.00,4195.29,4804.71,0.14,1
44884,4566,1000.00,10000.00,11000.00,1647.78,8352.22,0.37,1
44885,4566,1000.00,11000.00,12000.00,0.00,11000.00,0.02,1
44886,4566,1000.00,12000.00,13000.00,0.00,12000.00,0.24,1
44887,4566,-1000.00,11000.00,12000.00,6973.02,6026.98,0.10,0
44888,4566,1000.00,12000.00,13000.00,0.00,12000.00,0.44,1
44889,4566,1000.00,13000.00,14000.00,1168.16,11831.84,0.39,1
44890,4566,1000.00,14000.00,15000.00,2903.68,11096.32,0.29,1
44891,4566,1000.00,15000.00,16000.00,6503.83,8496.17,0.26,1
44892,4566,1000.00,16000.00,17000.00,6023.02,9976.98,0.27,1
44893,4566,1000.00,17000.00,18000.00,2900.33,8852.92,0.31,1
44894,4566,1000.00,18000.00,19000.00,0.00,18000.00,0.27,1
44895,4566,1000.00,19000.00,20000.00,0.00,19000.00,0.38,1
44896,4566,1000.00,20000.00,21000.00,10000.00,10000.00,0.11,1
44897,4566,1000.00,21000.00,22000.00,2859.96,18140.04,0.21,1
44898,4566,-1000.00,20000.00,21000.00,10679.38,0.00,0.03,0
44899,4566,1000.00,21000.00,22000.00,0.00,21000.00,0.04,1
44900,4566,1000.00,22000.00,23000.00,0.00,9645.93,0.14,1
44901,4566,1000.00,23000.00,24000.00,8958.64,14041.36,0.27,1
44902,4566,1000.00,24000.00,25000.00,0.00,4674.47,0.14,1
44903,4566,1000.00,25000.00,26000.00,0.00,25000.00,0.38,1
44904,4566,1000.00,26000.00,27000.00,0.00,26000.00,0.42,1
44905,4566,1000.00,27000.00,28000.00,7078.71,19921.29,0.07,1
44906,4566,1000.00,28000.00,29000.00,11447.58,16552.42,0.17,1
44907,4566,1000.00,29000.00,30000.00,8182.29,20817.71,0.15,1
44908,4566,-1000.00,28000.00,29000.00,15668.06,10154.13,0.16,0
44909,4566,1000.00,29000.00,30000.00,8394.85,20605.15,0.22,1
44910,4566,1000.00,30000.00,31000.00,0.00,27390.16,0.31,1
44911,4566,1000.00,31000.00,32000.00,0.00,9022.77,0.22,1
44912,4566,1000.00,32000.00,33000.00,0.00,32000.00,0.13,1
44913,4566,1000.00,33000.00,34000.00,0.00,21423.70,0.28,1
44914,4566,1000.00,34000.00,35000.00,1202.73,23156.22,0.38,1
44915,4566,1000.00,35000.00,36000.00,0.00,35000.00,0.23,1
44916,4566,1000.00,36000.00,37000.00,1071.37,24440.31,0.38,1
44917,4566,1000.00,37000.00,38000.00,1948.05,35051.95,0.13,1
44918,4566,1000.00,38000.00,39000.00,3522.05,12590.29,0.23,1
44919,4566,-1000.00,37000.00,38000.00,39000.00,0.00,0.00,0
44920,4566,-1000.00,36000.00,37000.00,19893.46,18106.54,0.05,0
44921,4566,1000.00,37000.00,38000.00,16998.45,20001.55,0.16,1
44922,4566,1000.00,38000.00,39000.00,1698.83,36301.17,0.03,1
44923,4566,1000.00,39000.00,40000.00,0.00,11016.94,0.02,1
44924,4566,-1000.00,38000.00,39000.00,21912.43,7893.34,0.12,0
44925,4566,1000.00,39000.00,40000.00,0.00,34886.36,0.17,1
44926,4566,1000.00,40000.00,41000.00,0.00,40000.00,0.42,1
44927,4566,1000.00,41000.00,42000.00,0.00,25963.49,0.27,1
44928,4566,1000.00,42000.00,43000.00,468.56,41531.44,0.43,1
44929,4566,1000.00,43000.00,44000.00,19102.14,23897.86,0.18,1
44930,4566,1000.00,44000.00,45000.00,0.00,19456.39,0.05,1
44931,4566,1000.00,45000.00,46000.00,0.00,29223.38,0.23,1
44932,4566,1000.00,46000.00,47000.00,0.00,46000.00,0.38,1
44933,4566,1000.00,47000.00,48000.00,16087.38,30912.62,0.29,1
44934,4566,-1000.00,46000.00,47000.00,20628.21,18031.06,0.20,0
44935,4566,1000.00,47000.00,48000.00,4627.02,42372.98,0.43,1
44936,4566,1000.00,48000.00,49000.00,19859.42,24796.89,0.25,1
44937,4566,1000.00,49000.00,50000.00,0.00,49000.00,0.40,1
44938,4566,1000.00,50000.00,51000.00,18147.25,31852.75,0.27,1
44939,4566,1000.00,51000.00,52000.00,0.00,27661.43,0.06,1
44940,4566,-1000.00,50000.00,51000.00,27584.30,24139.41,0.20,0
44941,4566,1000.00,51000.00,52000.00,0.00,51000.00,0.32,1
44942,4566,-1000.00,50000.00,51000.00,4361.00,0.00,0.04,0
44943,4566,1000.00,51000.00,52000.00,0.00,51000.00,0.15,1
44944,4567,-1000.00,-1000.00,0.00,0.00,972.52,0.12,0
44945,4568,-774.05,-774.05,225.95,0.00,774.05,0.39,0
44946,4568,-225.95,-1000.00,0.00,0.00,225.95,0.33,0
44947,4569,-1000.00,-1000.00,0.00,0.00,1000.00,0.25,0
44948,4570,-1000.00,-1000.00,0.00,467.28,532.72,0.25,0
44949,4571,-1000.00,-1000.00,0.00,0.00,370.76,0.12,0
44950,4572,-1000.00,-1000.00,0.00,377.03,622.97,0.19,0
44951,4573,-1000.00,-1000.00,0.00,500.00,500.00,0.08,0
44952,4574,-1000.00,-1000.00,0.00,0.00,1000.00,0.36,0
44953,4575,-1000.00,-1000.00,0.00,0.00,51.94,0.44,0
44954,4576,0.00,0.00,1000.00,0.00,0.00,0.28,0
44955,4576,-161.55,-161.55,838.45,0.00,161.55,0.19,0
44956,4576,0.00,-161.55,838.45,0.00,0.00,0.43,0
44957,4576,-458.47,-620.02,379.98,0.00,458.47,0.20,0
44958,4576,-379.98,-1000.00,0.00,103.96,276.03,0.36,0
44959,4577,-1000.00,-1000.00,0.00,154.30,0.00,0.10,0
44960,4578,1000.00,1000.00,2000.00,0.00,292.04,0.18,1
44961,4578,1000.00,2000.00,3000.00,230.26,1769.74,0.38,1
44962,4578,1000.00,3000.00,4000.00,0.00,1973.25,0.22,1
44963,4578,-1000.00,2000.00,3000.00,3331.60,668.40,0.11,0
44964,4578,1000.00,3000.00,4000.00,26.04,2973.96,0.32,1
44965,4578,1000.00,4000.00,5000.00,0.00,3443.82,0.24,1
44966,4578,-1000.00,3000.00,4000.00,2760.57,1216.28,0.17,0
44967,4578,1000.00,4000.00,5000.00,0.00,4000.00,0.33,1
44968,4578,1000.00,5000.00,6000.00,376.27,4623.73,0.00,1
44969,4578,1000.00,6000.00,7000.00,0.00,6000.00,0.10,1
44970,4578,1000.00,7000.00,8000.00,0.00,7000.00,0.29,1
44971,4578,1000.00,8000.00,9000.00,1832.53,6167.47,0.23,1
44972,4578,1000.00,9000.00,10000.00,3232.08,5767.92,0.17,1
44973,4578,1000.00,10000.00,11000.00,2861.40,7138.60,0.14,1
44974,4578,1000.00,11000.00,12000.00,0.00,11000.00,0.06,1
44975,4578,1000.00,12000.00,13000.00,0.00,12000.00,0.00,1
44976,4578,1000.00,13000.00,14000.00,0.00,8731.62,0.10,1
44977,4578,1000.00,14000.00,15000.00,0.00,14000.00,0.23,1
44978,4578,1000.00,15000.00,16000.00,0.00,15000.00,0.37,1
44979,4578,1000.00,16000.00,17000.00,6088.30,9911.70,0.26,1
44980,4578,1000.00,17000.00,18000.00,2462.09,2781.72,0.16,1
44981,4578,-1000.00,16000.00,17000.00,13516.26,1503.39,0.06,0
44982,4578,1000.00,17000.00,18000.00,7952.30,9047.70,0.22,1
44983,4578,1000.00,18000.00,19000.00,0.00,18000.00,0.44,1
44984,4578,1000.00,19000.00,20000.00,2393.72,12203.74,0.36,1
44985,4578,-1000.00,18000.00,19000.00,12288.36,7711.64,0.04,0
44986,4578,1000.00,19000.00,20000.00,8356.60,10643.40,0.18,1
44987,4578,1000.00,20000.00,21000.00,4617.25,15382.75,0.22,1
44988,4578,1000.00,21000.00,22000.00,0.00,14359.42,0.32,1
44989,4578,1000.00,22000.00,23000.00,0.00,18495.02,0.25,1
44990,4578,1000.00,23000.00,24000.00,10688.02,12311.98,0.02,1
44991,4578,1000.00,24000.00,25000.00,0.00,8839.86,0.24,1
44992,4578,1000.00,25000.00,26000.00,0.00,5360.56,0.17,1
44993,4578,-1000.00,24000.00,25000.00,17807.33,8192.67,0.09,0
44994,4578,1000.00,25000.00,26000.00,1353.21,23646.79,0.44,1
44995,4578,1000.00,26000.00,27000.00,0.00,26000.00,0.08,1
44996,4578,-1000.00,25000.00,26000.00,15107.57,8642.27,0.15,0
44997,4578,1000.00,26000.00,27000.00,1685.78,7384.17,0.22,1
44998,4578,1000.00,27000.00,28000.00,11880.21,15119.79,0.17,1
44999,4578,-1000.00,26000.00,27000.00,18452.08,9547.92,0.26,0
45000,4578,1000.00,27000.00,28000.00,0.00,16178.08,0.23,1
45001,4579,-1000.00,-1000.00,0.00,0.00,481.86,0.04,0
45002,4580,1000.00,1000.00,2000.00,438.15,561.85,0.14,1
45003,4580,1000.00,2000.00,3000.00,0.00,2000.00,0.25,1
45004,4580,1000.00,3000.00,4000.00,0.00,1293.74,0.18,1
45005,4580,1000.00,4000.00,5000.00,1725.06,2274.94,0.19,1
45006,4580,1000.00,5000.00,6000.00,0.00,4048.80,0.28,1
45007,4580,1000.00,6000.00,7000.00,1671.63,4328.37,0.07,1
45008,4580,-1000.00,5000.00,6000.00,3880.85,2419.17,0.16,0
45009,4580,-963.64,4036.36,5036.36,579.95,383.69,0.13,0
45010,4580,1000.00,5036.36,6036.36,0.00,2953.83,0.24,1
45011,4580,1000.00,6036.36,7036.36,0.00,4206.89,0.37,1
45012,4580,1000.00,7036.36,8036.36,569.67,6231.05,0.43,1
45013,4580,1000.00,8036.36,9036.36,2105.37,5930.99,0.26,1
45014,4580,1000.00,9036.36,10036.36,0.00,9036.36,0.18,1
45015,4580,1000.00,10036.36,11036.36,0.00,1328.98,0.09,1
45016,4580,1000.00,11036.36,12036.36,671.65,6752.72,0.36,1
45017,4580,-1000.00,10036.36,11036.36,7513.41,0.00,0.06,0
45018,4580,1000.00,11036.36,12036.36,5518.18,5518.18,0.06,1
45019,4580,1000.00,12036.36,13036.36,6018.18,6018.18,0.00,1
45020,4580,-1000.00,11036.36,12036.36,4528.20,0.00,0.04,0
45021,4580,1000.00,12036.36,13036.36,4455.54,7580.83,0.27,1
45022,4580,1000.00,13036.36,14036.36,4199.00,8837.36,0.26,1
45023,4580,1000.00,14036.36,15036.36,1148.59,2304.23,0.17,1
45024,4580,1000.00,15036.36,16036.36,1992.17,13044.19,0.41,1
45025,4580,1000.00,16036.36,17036.36,8018.18,8018.18,0.12,1
45026,4580,-1000.00,15036.36,16036.36,7149.59,9886.78,0.16,0
45027,4580,-1000.00,14036.36,15036.36,271.66,15764.71,0.06,0
45028,4580,-1000.00,13036.36,14036.36,0.00,2490.27,0.17,0
45029,4580,-1000.00,12036.36,13036.36,0.00,14036.36,0.38,0
45030,4580,-1000.00,11036.36,12036.36,0.00,13036.36,0.24,0
45031,4580,-1000.00,10036.36,11036.36,2377.28,9659.08,0.38,0
45032,4580,-1000.00,9036.36,10036.36,6541.09,4495.27,0.14,0
45033,4580,-1000.00,8036.36,9036.36,4277.67,5758.69,0.18,0
45034,4580,-1000.00,7036.36,8036.36,0.00,5559.93,0.28,0
45035,4580,-1000.00,6036.36,7036.36,3746.50,4289.87,0.15,0
45036,4580,-1000.00,5036.36,6036.36,896.68,4720.79,0.38,0
45037,4580,-1000.00,4036.36,5036.36,1941.53,4094.84,0.27,0
45038,4580,-1000.00,3036.36,4036.36,1443.96,3592.40,0.17,0
45039,4580,0.00,3036.36,4036.36,0.00,0.00,0.08,0
45040,4580,-1000.00,2036.36,3036.36,1304.13,2732.24,0.22,0
45041,4580,-1000.00,1036.36,2036.36,0.00,3036.36,0.41,0
45042,4580,-1000.00,36.36,1036.36,0.00,2036.36,0.06,0
45043,4580,-383.51,-347.15,652.85,0.00,383.51,0.21,0
45044,4580,-652.85,-1000.00,0.00,219.05,433.80,0.24,0
45045,4581,-754.09,-754.09,245.91,0.00,754.09,0.37,0
45046,4581,-245.91,-1000.00,0.00,65.10,180.81,0.34,0
45047,4582,-1000.00,-1000.00,0.00,312.20,687.80,0.07,0
45048,4583,-1000.00,-1000.00,0.00,0.00,683.95,0.33,0
45049,4584,-790.25,-790.25,209.75,234.07,556.18,0.27,0
45050,4584,-151.95,-942.20,57.80,0.00,151.95,0.20,0
45051,4584,0.00,-942.20,57.80,0.00,0.00,0.13,0
45052,4584,-34.45,-976.65,23.35,0.00,34.45,0.24,0
45053,4584,1000.00,23.35,1023.35,13.80,9.55,0.25,1
45054,4584,0.00,23.35,1023.35,0.00,0.00,0.09,0
45055,4584,-909.22,-885.86,114.14,352.23,556.99,0.26,0
45056,4584,-2.34,-888.20,111.80,0.00,2.34,0.41,0
45057,4584,-111.80,-1000.00,0.00,37.25,74.55,0.08,0
45058,4585,-1000.00,-1000.00,0.00,305.51,694.49,0.11,0
45059,4586,1000.00,1000.00,2000.00,352.07,477.97,0.25,1
45060,4586,-733.75,266.25,1266.25,733.75,0.00,0.03,0
45061,4586,-1000.00,-733.75,266.25,402.97,758.96,0.31,0
45062,4586,-1000.00,-1733.75,-733.75,41.80,224.45,0.42,0
45063,4587,-416.63,-416.63,583.37,293.11,123.53,0.14,0
45064,4587,1000.00,583.37,1583.37,0.00,583.37,0.02,1
45065,4587,-709.65,-126.29,873.71,401.26,308.40,0.16,0
45066,4587,1000.00,873.71,1873.71,0.00,474.70,0.29,1
45067,4587,1000.00,1873.71,2873.71,208.26,1665.45,0.40,1
45068,4587,1000.00,2873.71,3873.71,0.00,2873.71,0.04,1
45069,4587,1000.00,3873.71,4873.71,674.20,3199.52,0.35,1
45070,4587,1000.00,4873.71,5873.71,0.00,4873.71,0.14,1
45071,4587,-1000.00,3873.71,4873.71,4505.09,1019.67,0.08,0
45072,4587,1000.00,4873.71,5873.71,927.67,3946.05,0.37,1
45073,4587,1000.00,5873.71,6873.71,0.00,1252.84,0.01,1
45074,4587,1000.00,6873.71,7873.71,1064.86,5808.85,0.38,1
45075,4587,1000.00,7873.71,8873.71,0.00,7873.71,0.16,1
45076,4587,1000.00,8873.71,9873.71,0.00,7469.79,0.36,1
45077,4587,1000.00,9873.71,10873.71,0.00,9873.71,0.38,1
45078,4587,1000.00,10873.71,11873.71,0.00,10873.71,0.43,1
45079,4587,-1000.00,9873.71,10873.71,6582.99,5290.72,0.19,0
45080,4587,1000.00,10873.71,11873.71,0.00,5123.91,0.15,1
45081,4587,-1000.00,9873.71,10873.71,7520.17,2844.20,0.11,0
45082,4587,1000.00,10873.71,11873.71,0.00,8919.82,0.36,1
45083,4587,1000.00,11873.71,12873.71,0.00,8177.68,0.22,1
45084,4587,1000.00,12873.71,13873.71,0.00,5104.43,0.24,1
45085,4587,1000.00,13873.71,14873.71,0.00,13873.71,0.26,1
45086,4587,-1000.00,12873.71,13873.71,8493.73,6379.98,0.40,0
45087,4587,1000.00,13873.71,14873.71,6151.90,7721.81,0.08,1
45088,4587,-1000.00,12873.71,13873.71,7865.52,7008.19,0.43,0
45089,4587,1000.00,13873.71,14873.71,0.00,4588.06,0.23,1
45090,4587,-1000.00,12873.71,13873.71,8702.81,2755.82,0.11,0
45091,4587,1000.00,13873.71,14873.71,6226.87,7646.85,0.28,1
45092,4587,1000.00,14873.71,15873.71,0.00,14873.71,0.02,1
45093,4587,1000.00,15873.71,16873.71,793.64,15080.07,0.12,1
45094,4587,1000.00,16873.71,17873.71,0.00,12781.08,0.36,1
45095,4587,-1000.00,15873.71,16873.71,9181.36,8466.05,0.29,0
45096,4587,1000.00,16873.71,17873.71,0.00,16873.71,0.35,1
45097,4587,1000.00,17873.71,18873.71,3202.69,14671.02,0.41,1
45098,4587,1000.00,18873.71,19873.71,9164.07,9709.64,0.18,1
45099,4587,1000.00,19873.71,20873.71,0.00,13800.30,0.38,1
45100,4587,1000.00,20873.71,21873.71,0.00,2961.35,0.10,1
45101,4587,-1000.00,19873.71,20873.71,8979.62,0.00,0.04,0
45102,4587,1000.00,20873.71,21873.71,0.00,20873.71,0.35,1
45103,4587,1000.00,21873.71,22873.71,0.00,18566.97,0.38,1
45104,4587,1000.00,22873.71,23873.71,0.00,22873.71,0.23,1
45105,4587,1000.00,23873.71,24873.71,0.00,11645.83,0.13,1
45106,4587,1000.00,24873.71,25873.71,0.00,24873.71,0.01,1
45107,4587,1000.00,25873.71,26873.71,12899.81,12973.90,0.25,1
45108,4588,-1000.00,-1000.00,0.00,190.54,809.46,0.22,0
45109,4589,-1000.00,-1000.00,0.00,408.96,591.04,0.21,0
45110,4590,1000.00,1000.00,2000.00,500.00,500.00,0.07,1
45111,4590,1000.00,2000.00,3000.00,298.86,1701.14,0.12,1
45112,4590,-1000.00,1000.00,2000.00,1283.53,769.02,0.16,0
45113,4590,1000.00,2000.00,3000.00,0.00,1797.30,0.02,1
45114,4590,1000.00,3000.00,4000.00,428.13,2571.87,0.36,1
45115,4590,1000.00,4000.00,5000.00,103.58,2521.54,0.36,1
45116,4590,-1000.00,3000.00,4000.00,3719.57,1280.43,0.05,0
45117,4590,1000.00,4000.00,5000.00,2000.00,2000.00,0.04,1
45118,4590,1000.00,5000.00,6000.00,0.00,1884.97,0.17,1
45119,4590,1000.00,6000.00,7000.00,638.82,5361.18,0.04,1
45120,4590,1000.00,7000.00,8000.00,0.00,7000.00,0.20,1
45121,4590,1000.00,8000.00,9000.00,0.00,694.52,0.08,1
45122,4590,1000.00,9000.00,10000.00,0.00,5426.26,0.24,1
45123,4590,1000.00,10000.00,11000.00,0.00,10000.00,0.18,1
45124,4590,1000.00,11000.00,12000.00,758.60,6178.60,0.34,1
45125,4590,1000.00,12000.00,13000.00,5071.61,6928.39,0.20,1
45126,4590,1000.00,13000.00,14000.00,392.91,9459.84,0.40,1
45127,4590,1000.00,14000.00,15000.00,2070.03,11929.97,0.42,1
45128,4590,1000.00,15000.00,16000.00,5668.03,9331.97,0.15,1
45129,4590,1000.00,16000.00,17000.00,0.00,12614.57,0.20,1
45130,4590,1000.00,17000.00,18000.00,0.00,7800.60,0.16,1
45131,4590,-1000.00,16000.00,17000.00,8896.69,1627.61,0.10,0
45132,4590,-1000.00,15000.00,16000.00,8556.63,8443.37,0.22,0
45133,4590,1000.00,16000.00,17000.00,2007.87,13992.13,0.16,1
45134,4590,1000.00,17000.00,18000.00,0.00,5197.21,0.17,1
45135,4590,1000.00,18000.00,19000.00,3318.67,14681.33,0.23,1
45136,4590,0.00,18000.00,19000.00,0.00,0.00,0.04,0
45137,4590,1000.00,19000.00,20000.00,1411.19,17588.81,0.34,1
45138,4590,1000.00,20000.00,21000.00,0.00,20000.00,0.21,1
45139,4590,1000.00,21000.00,22000.00,10318.00,10682.00,0.21,1
45140,4590,1000.00,22000.00,23000.00,1287.83,20712.17,0.18,1
45141,4590,1000.00,23000.00,24000.00,11500.00,11500.00,0.08,1
45142,4590,1000.00,24000.00,25000.00,4703.30,19296.70,0.29,1
45143,4590,1000.00,25000.00,26000.00,710.21,23908.94,0.44,1
45144,4590,1000.00,26000.00,27000.00,1586.36,24413.64,0.14,1
45145,4590,1000.00,27000.00,28000.00,0.00,27000.00,0.31,1
45146,4590,-1000.00,26000.00,27000.00,8015.94,0.00,0.06,0
45147,4590,1000.00,27000.00,28000.00,909.17,1721.23,0.13,1
45148,4590,1000.00,28000.00,29000.00,0.00,25447.22,0.08,1
45149,4590,1000.00,29000.00,30000.00,12341.93,16658.07,0.20,1
45150,4590,1000.00,30000.00,31000.00,0.00,30000.00,0.07,1
45151,4590,1000.00,31000.00,32000.00,0.00,31000.00,0.11,1
45152,4590,1000.00,32000.00,33000.00,0.00,21302.39,0.38,1
45153,4590,1000.00,33000.00,34000.00,0.00,33000.00,0.02,1
45154,4590,1000.00,34000.00,35000.00,0.00,34000.00,0.35,1
45155,4590,1000.00,35000.00,36000.00,12237.08,22762.92,0.29,1
45156,4590,1000.00,36000.00,37000.00,0.00,36000.00,0.06,1
45157,4591,-1000.00,-1000.00,0.00,0.00,1000.00,0.27,0
45158,4592,-755.09,-755.09,244.91,0.00,755.09,0.40,0
45159,4592,-244.91,-1000.00,0.00,0.00,244.91,0.29,0
45160,4593,-551.29,-551.29,448.71,551.29,0.00,0.24,0
45161,4593,0.00,-551.29,448.71,0.00,0.00,0.22,0
45162,4593,-355.93,-907.23,92.77,355.93,0.00,0.10,0
45163,4593,-1000.00,-1907.23,-907.23,0.00,92.77,0.38,0
45164,4594,-1000.00,-1000.00,0.00,0.00,1000.00,0.21,0
45165,4595,-927.66,-927.66,72.34,0.00,927.66,0.22,0
45166,4595,-72.34,-1000.00,0.00,0.00,72.34,0.29,0
45167,4596,-1000.00,-1000.00,0.00,377.36,622.64,0.26,0
45168,4597,1000.00,1000.00,2000.00,662.08,337.92,0.07,1
45169,4597,1000.00,2000.00,3000.00,1003.73,996.27,0.07,1
45170,4597,-1000.00,1000.00,2000.00,0.00,3000.00,0.39,0
45171,4597,-469.17,530.83,1530.83,0.00,469.17,0.06,0
45172,4597,-1000.00,-469.17,530.83,667.87,862.95,0.32,0
45173,4597,-313.20,-782.37,217.63,0.00,313.20,0.29,0
45174,4597,-143.33,-925.70,74.30,58.57,84.76,0.24,0
45175,4597,-53.18,-978.88,21.12,23.88,29.29,0.23,0
45176,4597,-21.12,-1000.00,0.00,8.67,12.45,0.03,0
45177,4598,1000.00,1000.00,2000.00,0.00,1000.00,0.39,1
45178,4598,-1000.00,0.00,1000.00,1144.33,175.85,0.09,0
45179,4598,1000.00,1000.00,2000.00,0.00,1000.00,0.29,1
45180,4598,1000.00,2000.00,3000.00,0.00,1760.03,0.41,1
45181,4598,1000.00,3000.00,4000.00,0.00,2331.79,0.11,1
45182,4598,1000.00,4000.00,5000.00,0.00,4000.00,0.34,1
45183,4598,1000.00,5000.00,6000.00,0.00,5000.00,0.12,1
45184,4598,1000.00,6000.00,7000.00,1716.15,4283.85,0.36,1
45185,4598,1000.00,7000.00,8000.00,0.00,7000.00,0.07,1
45186,4598,1000.00,8000.00,9000.00,867.94,7132.06,0.43,1
45187,4598,1000.00,9000.00,10000.00,0.00,9000.00,0.13,1
45188,4598,1000.00,10000.00,11000.00,4668.98,5331.02,0.07,1
45189,4598,1000.00,11000.00,12000.00,0.00,1708.17,0.02,1
45190,4598,1000.00,12000.00,13000.00,0.00,3511.94,0.19,1
45191,4598,1000.00,13000.00,14000.00,0.00,13000.00,0.32,1
45192,4598,1000.00,14000.00,15000.00,3353.63,5575.23,0.25,1
45193,4598,-1000.00,13000.00,14000.00,15000.00,0.00,0.07,0
45194,4598,1000.00,14000.00,15000.00,0.00,9888.71,0.18,1
45195,4598,1000.00,15000.00,16000.00,298.42,6541.75,0.28,1
45196,4598,1000.00,16000.00,17000.00,0.00,9289.48,0.34,1
45197,4598,1000.00,17000.00,18000.00,7757.31,9242.69,0.22,1
45198,4598,1000.00,18000.00,19000.00,0.00,18000.00,0.12,1
45199,4598,-1000.00,17000.00,18000.00,8392.89,0.00,0.04,0
45200,4598,1000.00,18000.00,19000.00,0.00,2435.19,0.06,1
45201,4598,0.00,18000.00,19000.00,0.00,0.00,0.06,0
45202,4598,-1000.00,17000.00,18000.00,2094.53,16905.47,0.20,0
45203,4598,-1000.00,16000.00,17000.00,0.00,13103.07,0.35,0
45204,4598,-1000.00,15000.00,16000.00,0.00,17000.00,0.16,0
45205,4598,-1000.00,14000.00,15000.00,0.00,11632.15,0.40,0
45206,4598,-1000.00,13000.00,14000.00,0.00,7306.04,0.12,0
45207,4598,0.00,13000.00,14000.00,0.00,0.00,0.04,0
45208,4598,-1000.00,12000.00,13000.00,0.00,9844.87,0.39,0
45209,4598,-1000.00,11000.00,12000.00,13000.00,0.00,0.00,0
45210,4598,-1000.00,10000.00,11000.00,0.00,2786.90,0.16,0
45211,4598,-1000.00,9000.00,10000.00,0.00,8416.53,0.27,0
45212,4598,-1000.00,8000.00,9000.00,0.00,10000.00,0.19,0
45213,4598,-1000.00,7000.00,8000.00,0.00,9000.00,0.12,0
45214,4598,-1000.00,6000.00,7000.00,0.00,8000.00,0.13,0
45215,4598,-1000.00,5000.00,6000.00,0.00,7000.00,0.04,0
45216,4598,-1000.00,4000.00,5000.00,130.11,5869.89,0.40,0
45217,4598,-1000.00,3000.00,4000.00,0.00,5000.00,0.21,0
45218,4598,-1000.00,2000.00,3000.00,1213.50,2750.43,0.34,0
45219,4598,-1000.00,1000.00,2000.00,1118.54,1332.10,0.24,0
45220,4598,-1000.00,0.00,1000.00,0.00,2000.00,0.06,0
45221,4598,-1000.00,-1000.00,0.00,0.00,1000.00,0.27,0
45222,4599,1000.00,1000.00,2000.00,0.00,1000.00,0.01,1
45223,4599,1000.00,2000.00,3000.00,0.00,2000.00,0.11,1
45224,4599,1000.00,3000.00,4000.00,0.00,3000.00,0.24,1
45225,4599,0.00,3000.00,4000.00,0.00,0.00,0.03,0
45226,4599,1000.00,4000.00,5000.00,0.00,4000.00,0.22,1
45227,4599,1000.00,5000.00,6000.00,2372.95,2627.05,0.18,1
45228,4599,1000.00,6000.00,7000.00,0.00,6000.00,0.43,1
45229,4599,1000.00,7000.00,8000.00,3500.00,3500.00,0.07,1
45230,4599,1000.00,8000.00,9000.00,0.00,8000.00,0.03,1
45231,4599,1000.00,9000.00,10000.00,0.00,7933.36,0.28,1
45232,4599,1000.00,10000.00,11000.00,0.00,9486.35,0.05,1
45233,4599,1000.00,11000.00,12000.00,5500.00,5500.00,0.04,1
45234,4599,1000.00,12000.00,13000.00,5397.84,6602.16,0.26,1
45235,4599,1000.00,13000.00,14000.00,0.00,7767.01,0.35,1
45236,4599,1000.00,14000.00,15000.00,0.00,13838.92,0.15,1
45237,4599,1000.00,15000.00,16000.00,0.00,6769.52,0.28,1
45238,4599,1000.00,16000.00,17000.00,3981.40,12018.60,0.33,1
45239,4599,1000.00,17000.00,18000.00,8500.00,8500.00,0.03,1
45240,4599,1000.00,18000.00,19000.00,0.00,15032.91,0.43,1
45241,4599,1000.00,19000.00,20000.00,4679.41,14320.59,0.16,1
45242,4599,1000.00,20000.00,21000.00,0.00,14721.24,0.19,1
45243,4599,1000.00,21000.00,22000.00,10386.57,10613.43,0.43,1
45244,4599,1000.00,22000.00,23000.00,0.00,22000.00,0.30,1
45245,4599,1000.00,23000.00,24000.00,7692.02,15307.98,0.08,1
45246,4599,1000.00,24000.00,25000.00,0.00,24000.00,0.22,1
45247,4599,1000.00,25000.00,26000.00,4331.49,20668.51,0.41,1
45248,4599,1000.00,26000.00,27000.00,0.00,19762.97,0.40,1
45249,4599,1000.00,27000.00,28000.00,6846.60,6976.05,0.19,1
45250,4599,1000.00,28000.00,29000.00,7016.70,20983.30,0.31,1
45251,4599,1000.00,29000.00,30000.00,6907.24,22092.76,0.11,1
45252,4599,1000.00,30000.00,31000.00,0.00,2129.93,0.13,1
45253,4599,1000.00,31000.00,32000.00,647.83,26534.15,0.43,1
45254,4599,-1000.00,30000.00,31000.00,19415.52,12584.48,0.12,0
45255,4599,-1000.00,29000.00,30000.00,14992.40,9584.62,0.17,0
45256,4599,1000.00,30000.00,31000.00,0.00,30000.00,0.00,1
45257,4599,1000.00,31000.00,32000.00,0.00,31000.00,0.12,1
45258,4599,-1000.00,30000.00,31000.00,19724.59,12275.41,0.09,0
45259,4599,1000.00,31000.00,32000.00,12509.95,18490.05,0.09,1
45260,4599,1000.00,32000.00,33000.00,0.00,19673.02,0.32,1
45261,4599,1000.00,33000.00,34000.00,0.00,33000.00,0.00,1
45262,4599,1000.00,34000.00,35000.00,0.00,31895.13,0.41,1
45263,4599,1000.00,35000.00,36000.00,3302.62,31697.38,0.18,1
45264,4599,1000.00,36000.00,37000.00,0.00,31906.77,0.41,1
45265,4599,1000.00,37000.00,38000.00,18469.06,18530.94,0.08,1
45266,4599,-1000.00,36000.00,37000.00,21468.70,16531.30,0.10,0
45267,4599,-1000.00,35000.00,36000.00,0.00,20906.57,0.31,0
45268,4599,-1000.00,34000.00,35000.00,0.00,2410.93,0.14,0
45269,4599,-1000.00,33000.00,34000.00,14962.88,20037.12,0.20,0
45270,4599,-1000.00,32000.00,33000.00,12458.30,21541.70,0.18,0
45271,4599,-1000.00,31000.00,32000.00,0.00,33000.00,0.30,0
45272,4599,-1000.00,30000.00,31000.00,0.00,32000.00,0.34,0
45273,4599,-1000.00,29000.00,30000.00,0.00,3901.63,0.12,0
45274,4599,-1000.00,28000.00,29000.00,0.00,30000.00,0.04,0
45275,4599,-1000.00,27000.00,28000.00,0.00,28082.35,0.12,0
45276,4599,-1000.00,26000.00,27000.00,0.00,28000.00,0.32,0
45277,4599,-1000.00,25000.00,26000.00,10331.30,16668.70,0.22,0
45278,4599,-1000.00,24000.00,25000.00,13000.00,13000.00,0.22,0
45279,4599,-1000.00,23000.00,24000.00,3096.30,21903.70,0.05,0
45280,4599,-1000.00,22000.00,23000.00,11934.16,0.00,0.19,0
45281,4599,-1000.00,21000.00,22000.00,11640.63,11359.37,0.15,0
45282,4599,-1000.00,20000.00,21000.00,13341.10,8658.90,0.06,0
45283,4599,-1000.00,19000.00,20000.00,0.00,18576.60,0.26,0
45284,4599,-1000.00,18000.00,19000.00,9235.61,10764.39,0.23,0
45285,4599,-1000.00,17000.00,18000.00,0.00,15593.61,0.33,0
45286,4600,1000.00,1000.00,2000.00,266.84,607.80,0.32,1
45287,4600,-1000.00,0.00,1000.00,1481.08,518.92,0.05,0
45288,4600,1000.00,1000.00,2000.00,0.00,1000.00,0.04,1
45289,4600,1000.00,2000.00,3000.00,0.00,977.26,0.26,1
45290,4600,1000.00,3000.00,4000.00,0.00,2763.47,0.34,1
45291,4600,1000.00,4000.00,5000.00,0.00,4000.00,0.42,1
45292,4600,1000.00,5000.00,6000.00,2369.45,2630.55,0.24,1
45293,4600,1000.00,6000.00,7000.00,0.00,6000.00,0.37,1
45294,4600,1000.00,7000.00,8000.00,2722.99,4277.01,0.28,1
45295,4600,1000.00,8000.00,9000.00,2781.29,5218.71,0.29,1
45296,4600,1000.00,9000.00,10000.00,0.00,5573.90,0.36,1
45297,4600,1000.00,10000.00,11000.00,0.00,10000.00,0.10,1
45298,4600,1000.00,11000.00,12000.00,0.00,3272.84,0.11,1
45299,4600,1000.00,12000.00,13000.00,6000.00,6000.00,0.03,1
45300,4600,1000.00,13000.00,14000.00,6500.00,6500.00,0.07,1
45301,4600,1000.00,14000.00,15000.00,0.00,14000.00,0.23,1
45302,4600,1000.00,15000.00,16000.00,2651.47,12348.53,0.41,1
45303,4600,1000.00,16000.00,17000.00,0.00,2285.32,0.16,1
45304,4600,1000.00,17000.00,18000.00,4933.74,12066.26,0.34,1
45305,4600,-1000.00,16000.00,17000.00,10844.45,7155.55,0.08,0
45306,4600,1000.00,17000.00,18000.00,5739.38,11260.62,0.30,1
45307,4600,1000.00,18000.00,19000.00,9000.00,9000.00,0.09,1
45308,4600,1000.00,19000.00,20000.00,0.00,17773.90,0.25,1
45309,4600,-1000.00,18000.00,19000.00,11046.30,8953.70,0.25,0
45310,4600,1000.00,19000.00,20000.00,5783.62,9117.38,0.27,1
45311,4600,1000.00,20000.00,21000.00,0.00,6721.10,0.16,1
45312,4600,1000.00,21000.00,22000.00,0.00,21000.00,0.42,1
45313,4600,1000.00,22000.00,23000.00,0.00,22000.00,0.37,1
45314,4600,-1000.00,21000.00,22000.00,8690.63,1452.83,0.11,0
45315,4600,1000.00,22000.00,23000.00,0.00,22000.00,0.28,1
45316,4600,1000.00,23000.00,24000.00,5365.50,17634.50,0.18,1
45317,4600,1000.00,24000.00,25000.00,12000.00,12000.00,0.01,1
45318,4600,1000.00,25000.00,26000.00,0.00,17171.58,0.39,1
45319,4600,1000.00,26000.00,27000.00,10853.75,15146.25,0.37,1
45320,4600,1000.00,27000.00,28000.00,6493.05,20506.95,0.15,1
45321,4600,1000.00,28000.00,29000.00,0.00,16487.59,0.30,1
45322,4600,1000.00,29000.00,30000.00,1910.65,27089.35,0.42,1
45323,4600,1000.00,30000.00,31000.00,13365.47,16634.53,0.42,1
45324,4600,1000.00,31000.00,32000.00,7403.60,23596.40,0.37,1
45325,4600,1000.00,32000.00,33000.00,1851.34,30148.66,0.38,1
45326,4601,-1000.00,-1000.00,0.00,0.00,1000.00,0.00,0
45327,4602,1000.00,1000.00,2000.00,0.00,1000.00,0.19,1
45328,4602,1000.00,2000.00,3000.00,471.06,1528.94,0.06,1
45329,4602,1000.00,3000.00,4000.00,0.00,1500.43,0.30,1
45330,4602,1000.00,4000.00,5000.00,0.00,3339.71,0.42,1
45331,4602,1000.00,5000.00,6000.00,0.00,5000.00,0.13,1
45332,4602,1000.00,6000.00,7000.00,0.00,5668.91,0.23,1
45333,4602,-1000.00,5000.00,6000.00,5140.72,1859.28,0.02,0
45334,4602,1000.00,6000.00,7000.00,2114.76,3885.24,0.32,1
45335,4602,1000.00,7000.00,8000.00,80.49,3388.73,0.31,1
45336,4602,1000.00,8000.00,9000.00,2863.37,5136.63,0.25,1
45337,4602,1000.00,9000.00,10000.00,1432.04,4897.62,0.32,1
45338,4602,1000.00,10000.00,11000.00,3448.44,6551.56,0.13,1
45339,4602,1000.00,11000.00,12000.00,4208.01,6791.99,0.20,1
45340,4602,1000.00,12000.00,13000.00,4174.92,7825.08,0.08,1
45341,4602,1000.00,13000.00,14000.00,2172.79,10827.21,0.42,1
45342,4602,1000.00,14000.00,15000.00,4051.82,9948.18,0.36,1
45343,4602,1000.00,15000.00,16000.00,7310.68,7689.32,0.04,1
45344,4602,-1000.00,14000.00,15000.00,16000.00,0.00,0.03,0
45345,4602,1000.00,15000.00,16000.00,5190.77,9809.23,0.34,1
45346,4602,1000.00,16000.00,17000.00,0.00,16000.00,0.28,1
45347,4602,1000.00,17000.00,18000.00,0.00,17000.00,0.33,1
45348,4602,1000.00,18000.00,19000.00,8009.62,9990.38,0.04,1
45349,4602,1000.00,19000.00,20000.00,2625.67,16374.33,0.39,1
45350,4602,1000.00,20000.00,21000.00,3029.33,16271.41,0.41,1
45351,4602,1000.00,21000.00,22000.00,9242.94,11757.06,0.16,1
45352,4602,1000.00,22000.00,23000.00,4235.21,17764.79,0.39,1
45353,4602,1000.00,23000.00,24000.00,0.00,23000.00,0.34,1
45354,4602,-1000.00,22000.00,23000.00,1960.47,159.66,0.11,0
45355,4602,1000.00,23000.00,24000.00,8828.57,14171.43,0.28,1
45356,4602,1000.00,24000.00,25000.00,0.00,24000.00,0.23,1
45357,4602,1000.00,25000.00,26000.00,0.00,25000.00,0.38,1
45358,4602,1000.00,26000.00,27000.00,7327.19,18672.81,0.35,1
45359,4602,1000.00,27000.00,28000.00,13500.00,13500.00,0.39,1
45360,4602,1000.00,28000.00,29000.00,0.00,11444.35,0.16,1
45361,4602,1000.00,29000.00,30000.00,10715.44,18284.56,0.17,1
45362,4602,1000.00,30000.00,31000.00,0.00,548.19,0.05,1
45363,4603,1000.00,1000.00,2000.00,152.50,847.50,0.42,1
45364,4603,0.00,1000.00,2000.00,0.00,0.00,0.06,0
45365,4603,1000.00,2000.00,3000.00,656.34,1343.66,0.29,1
45366,4603,1000.00,3000.00,4000.00,0.00,3000.00,0.41,1
45367,4603,1000.00,4000.00,5000.00,657.04,917.78,0.19,1
45368,4603,1000.00,5000.00,6000.00,0.00,2207.12,0.23,1
45369,4603,1000.00,6000.00,7000.00,0.00,5745.33,0.34,1
45370,4603,1000.00,7000.00,8000.00,0.00,5927.07,0.42,1
45371,4603,1000.00,8000.00,9000.00,2479.03,5520.97,0.22,1
45372,4603,1000.00,9000.00,10000.00,0.00,5955.64,0.36,1
45373,4603,1000.00,10000.00,11000.00,0.00,1557.60,0.12,1
45374,4603,1000.00,11000.00,12000.00,0.00,6235.05,0.33,1
45375,4603,-1000.00,10000.00,11000.00,4080.75,7919.25,0.33,0
45376,4603,-1000.00,9000.00,10000.00,0.00,8322.10,0.16,0
45377,4603,-1000.00,8000.00,9000.00,1233.74,8766.26,0.21,0
45378,4603,-1000.00,7000.00,8000.00,0.00,671.32,0.09,0
45379,4603,-1000.00,6000.00,7000.00,0.00,6065.68,0.33,0
45380,4603,-1000.00,5000.00,6000.00,3615.64,3384.36,0.38,0
45381,4603,-842.68,4157.32,5157.32,842.68,0.00,0.12,0
45382,4603,0.00,4157.32,5157.32,0.00,0.00,0.15,0
45383,4603,-1000.00,3157.32,4157.32,2578.66,2578.66,0.28,0
45384,4603,-1000.00,2157.32,3157.32,2078.66,2078.66,0.33,0
45385,4603,1000.00,3157.32,4157.32,49.16,0.00,0.14,1
45386,4603,0.00,3157.32,4157.32,0.00,0.00,0.23,0
45387,4603,0.00,3157.32,4157.32,0.00,0.00,0.32,0
45388,4603,-1000.00,2157.32,3157.32,0.00,4157.32,0.31,0
45389,4603,-1000.00,1157.32,2157.32,738.46,2418.87,0.20,0
45390,4603,-1000.00,157.32,1157.32,1078.66,1078.66,0.05,0
45391,4603,-734.69,-577.37,422.63,187.97,546.72,0.29,0
45392,4603,-248.81,-826.17,173.83,0.00,248.81,0.33,0
45393,4603,-173.83,-1000.00,0.00,0.00,173.83,0.39,0
45394,4604,-576.89,-576.89,423.11,576.89,0.00,0.07,0
45395,4604,1000.00,423.11,1423.11,0.00,423.11,0.37,1
45396,4604,1000.00,1423.11,2423.11,605.34,817.77,0.19,1
45397,4604,1000.00,2423.11,3423.11,0.00,2423.11,0.35,1
45398,4604,-1000.00,1423.11,2423.11,1746.70,1676.40,0.43,0
45399,4604,1000.00,2423.11,3423.11,574.54,1848.57,0.22,1
45400,4604,0.00,2423.11,3423.11,0.00,0.00,0.03,0
45401,4604,-1000.00,1423.11,2423.11,0.00,1484.79,0.27,0
45402,4604,-1000.00,423.11,1423.11,2354.15,0.00,0.12,0
45403,4604,-1000.00,-576.89,423.11,0.00,435.74,0.16,0
45404,4604,-1000.00,-1576.89,-576.89,0.00,67.04,0.28,0
45405,4605,-402.25,-402.25,597.75,0.00,402.25,0.05,0
45406,4605,-1000.00,-1402.25,-402.25,119.52,0.00,0.16,0
45407,4606,-1000.00,-1000.00,0.00,178.76,821.24,0.34,0
45408,4607,0.00,0.00,1000.00,0.00,0.00,0.04,0
45409,4607,-1000.00,-1000.00,0.00,126.97,873.03,0.29,0
45410,4608,-1000.00,-1000.00,0.00,17.27,982.73,0.10,0
45411,4609,-1000.00,-1000.00,0.00,0.00,1000.00,0.01,0
45412,4610,-1000.00,-1000.00,0.00,0.00,138.75,0.01,0
45413,4611,0.00,0.00,1000.00,0.00,0.00,0.02,0
45414,4611,-626.89,-626.89,373.11,626.89,0.00,0.11,0
45415,4611,-1000.00,-1626.89,-626.89,173.95,199.16,0.44,0
45416,4612,-559.62,-559.62,440.38,0.00,559.62,0.29,0
45417,4612,-440.38,-1000.00,0.00,170.72,269.66,0.21,0
45418,4613,-1000.00,-1000.00,0.00,0.00,45.56,0.27,0
45419,4614,-1000.00,-1000.00,0.00,0.00,33.28,0.32,0
45420,4615,1000.00,1000.00,2000.00,0.00,90.05,0.12,1
45421,4615,1000.00,2000.00,3000.00,302.50,1284.71,0.36,1
45422,4615,1000.00,3000.00,4000.00,397.17,2602.83,0.41,1
45423,4615,-1000.00,2000.00,3000.00,928.64,423.84,0.14,0
45424,4615,1000.00,3000.00,4000.00,0.00,2621.08,0.43,1
45425,4615,0.00,3000.00,4000.00,0.00,0.00,0.01,0
45426,4615,1000.00,4000.00,5000.00,0.00,4000.00,0.00,1
45427,4615,1000.00,5000.00,6000.00,0.00,643.90,0.15,1
45428,4615,-1000.00,4000.00,5000.00,3005.71,2444.44,0.19,0
45429,4615,1000.00,5000.00,6000.00,832.46,4167.54,0.42,1
45430,4615,1000.00,6000.00,7000.00,0.00,6000.00,0.06,1
45431,4615,1000.00,7000.00,8000.00,0.00,3398.02,0.26,1
45432,4615,1000.00,8000.00,9000.00,0.00,2209.00,0.21,1
45433,4615,1000.00,9000.00,10000.00,1167.99,7832.01,0.43,1
45434,4615,1000.00,10000.00,11000.00,0.00,4364.42,0.27,1
45435,4615,1000.00,11000.00,12000.00,0.00,11000.00,0.18,1
45436,4615,1000.00,12000.00,13000.00,0.00,12000.00,0.27,1
45437,4615,1000.00,13000.00,14000.00,0.00,11702.74,0.21,1
45438,4615,1000.00,14000.00,15000.00,5321.42,5389.76,0.26,1
45439,4615,1000.00,15000.00,16000.00,0.00,15000.00,0.30,1
45440,4615,1000.00,16000.00,17000.00,0.00,10464.51,0.01,1
45441,4615,1000.00,17000.00,18000.00,0.00,12699.67,0.38,1
45442,4615,1000.00,18000.00,19000.00,0.00,18000.00,0.31,1
45443,4615,1000.00,19000.00,20000.00,6709.24,6749.35,0.21,1
45444,4615,1000.00,20000.00,21000.00,0.00,20000.00,0.42,1
45445,4615,-1000.00,19000.00,20000.00,15100.03,5899.97,0.04,0
45446,4615,1000.00,20000.00,21000.00,0.00,18678.09,0.09,1
45447,4615,1000.00,21000.00,22000.00,5897.03,15102.97,0.01,1
45448,4615,1000.00,22000.00,23000.00,10961.27,11038.73,0.32,1
45449,4615,1000.00,23000.00,24000.00,10226.22,12773.78,0.20,1
45450,4615,-1000.00,22000.00,23000.00,13456.11,10543.89,0.09,0
45451,4615,-1000.00,21000.00,22000.00,0.00,16905.45,0.09,0
45452,4615,-1000.00,20000.00,21000.00,0.00,10430.35,0.17,0
45453,4615,0.00,20000.00,21000.00,0.00,0.00,0.04,0
45454,4615,-1000.00,19000.00,20000.00,11313.31,7464.88,0.18,0
45455,4615,-1000.00,18000.00,19000.00,2998.46,0.00,0.08,0
45456,4615,-1000.00,17000.00,18000.00,9226.37,9773.63,0.05,0
45457,4615,-1000.00,16000.00,17000.00,11240.05,276.54,0.07,0
45458,4615,0.00,16000.00,17000.00,0.00,0.00,0.01,0
45459,4615,-1000.00,15000.00,16000.00,5955.47,0.00,0.35,0
45460,4615,-1000.00,14000.00,15000.00,8522.80,7477.20,0.08,0
45461,4616,1000.00,1000.00,2000.00,105.85,290.45,0.22,1
45462,4616,1000.00,2000.00,3000.00,0.00,2000.00,0.29,1
45463,4616,1000.00,3000.00,4000.00,674.75,2325.25,0.37,1
45464,4616,1000.00,4000.00,5000.00,1074.24,2925.76,0.12,1
45465,4616,-761.86,3238.14,4238.14,761.86,0.00,0.07,0
45466,4616,1000.00,4238.14,5238.14,0.00,3404.26,0.41,1
45467,4616,1000.00,5238.14,6238.14,0.00,5200.32,0.34,1
45468,4616,1000.00,6238.14,7238.14,0.00,6238.14,0.00,1
45469,4616,1000.00,7238.14,8238.14,0.00,7238.14,0.33,1
45470,4616,1000.00,8238.14,9238.14,0.00,7111.09,0.39,1
45471,4616,1000.00,9238.14,10238.14,0.00,9.38,0.07,1
45472,4616,1000.00,10238.14,11238.14,0.00,7620.11,0.11,1
45473,4616,1000.00,11238.14,12238.14,2590.27,8647.87,0.35,1
45474,4616,-1000.00,10238.14,11238.14,8772.10,0.00,0.02,0
45475,4616,1000.00,11238.14,12238.14,3511.83,7726.31,0.33,1
45476,4616,-1000.00,10238.14,11238.14,4990.68,1569.50,0.12,0
45477,4616,1000.00,11238.14,12238.14,4348.48,6889.66,0.25,1
45478,4616,1000.00,12238.14,13238.14,0.00,12238.14,0.05,1
45479,4616,1000.00,13238.14,14238.14,0.00,6606.48,0.20,1
45480,4616,1000.00,14238.14,15238.14,7119.07,7119.07,0.16,1
45481,4616,0.00,14238.14,15238.14,0.00,0.00,0.00,0
45482,4616,1000.00,15238.14,16238.14,0.00,10275.97,0.36,1
45483,4616,1000.00,16238.14,17238.14,0.00,11923.43,0.23,1
45484,4616,1000.00,17238.14,18238.14,0.00,15078.93,0.06,1
45485,4616,1000.00,18238.14,19238.14,2970.52,15267.62,0.18,1
45486,4616,1000.00,19238.14,20238.14,0.00,19238.14,0.42,1
45487,4616,1000.00,20238.14,21238.14,0.00,20238.14,0.01,1
45488,4616,-1000.00,19238.14,20238.14,12034.92,9203.21,0.18,0
45489,4616,-1000.00,18238.14,19238.14,11410.96,8827.17,0.12,0
45490,4616,1000.00,19238.14,20238.14,5141.92,9593.73,0.28,1
45491,4616,1000.00,20238.14,21238.14,0.00,20238.14,0.38,1
45492,4616,-1000.00,19238.14,20238.14,4451.63,3096.95,0.15,0
45493,4616,1000.00,20238.14,21238.14,1778.94,18459.20,0.32,1
45494,4616,1000.00,21238.14,22238.14,0.00,21238.14,0.22,1
45495,4616,1000.00,22238.14,23238.14,0.00,13049.61,0.34,1
45496,4616,1000.00,23238.14,24238.14,5299.97,17938.17,0.09,1
45497,4616,-1000.00,22238.14,23238.14,11819.32,12418.82,0.35,0
45498,4617,-1000.00,-1000.00,0.00,290.45,709.55,0.10,0
45499,4618,-1000.00,-1000.00,0.00,71.00,929.00,0.02,0
45500,4619,-1000.00,-1000.00,0.00,0.00,691.61,0.39,0
45501,4620,-1000.00,-1000.00,0.00,381.71,618.29,0.11,0
45502,4621,-1000.00,-1000.00,0.00,500.00,500.00,0.01,0
45503,4622,-1000.00,-1000.00,0.00,344.29,655.71,0.18,0
45504,4623,-1000.00,-1000.00,0.00,0.00,783.38,0.20,0
45505,4624,1000.00,1000.00,2000.00,837.34,0.00,0.17,1
45506,4624,1000.00,2000.00,3000.00,1619.93,380.07,0.15,1
45507,4624,-913.72,1086.28,2086.28,0.00,913.72,0.33,0
45508,4624,-1000.00,86.28,1086.28,42.16,2044.13,0.17,0
45509,4624,-1000.00,-913.72,86.28,0.00,1086.28,0.23,0
45510,4624,0.00,-913.72,86.28,0.00,0.00,0.04,0
45511,4624,1000.00,86.28,1086.28,55.31,0.00,0.24,1
45512,4624,-962.73,-876.45,123.55,251.07,711.66,0.24,0
45513,4624,-123.55,-1000.00,0.00,10.21,113.34,0.25,0
45514,4625,-1000.00,-1000.00,0.00,352.63,647.37,0.18,0
45515,4626,-798.05,-798.05,201.95,0.00,798.05,0.16,0
45516,4626,-200.34,-998.39,1.61,0.00,200.34,0.41,0
45517,4626,-1.61,-1000.00,0.00,0.52,1.09,0.20,0
45518,4627,-1000.00,-1000.00,0.00,96.92,903.08,0.43,0
45519,4628,-967.31,-967.31,32.69,0.00,967.31,0.05,0
45520,4628,-32.69,-1000.00,0.00,16.34,16.34,0.02,0
45521,4629,-1000.00,-1000.00,0.00,500.00,500.00,0.03,0
45522,4630,-1000.00,-1000.00,0.00,0.00,1000.00,0.17,0
45523,4631,-1000.00,-1000.00,0.00,369.69,630.31,0.13,0
45524,4632,-875.19,-875.19,124.81,312.31,562.88,0.30,0
45525,4632,-124.81,-1000.00,0.00,0.00,124.81,0.27,0
45526,4633,-1000.00,-1000.00,0.00,0.00,804.08,0.03,0
45527,4634,-218.70,-218.70,781.30,0.00,218.70,0.02,0
45528,4634,-300.74,-519.44,480.56,0.00,300.74,0.12,0
45529,4634,0.00,-519.44,480.56,0.00,0.00,0.07,0
45530,4634,-480.56,-1000.00,0.00,0.00,480.56,0.15,0
45531,4635,-587.54,-587.54,412.46,0.00,587.54,0.33,0
45532,4635,-144.86,-732.40,267.60,0.00,144.86,0.27,0
45533,4635,-267.60,-1000.00,0.00,116.47,151.13,0.20,0
45534,4636,-492.91,-492.91,507.09,0.00,492.91,0.30,0
45535,4636,-476.99,-969.90,30.10,0.00,476.99,0.39,0
45536,4636,-26.41,-996.32,3.68,0.00,26.41,0.41,0
45537,4636,-3.68,-1000.00,0.00,0.00,3.68,0.03,0
45538,4637,-1000.00,-1000.00,0.00,500.00,500.00,0.09,0
45539,4638,-1000.00,-1000.00,0.00,0.00,1000.00,0.40,0
45540,4639,-737.14,-737.14,262.86,0.00,737.14,0.25,0
45541,4639,-1000.00,-1737.14,-737.14,152.59,110.27,0.15,0
45542,4640,-972.29,-972.29,27.71,364.41,607.87,0.30,0
45543,4640,-26.58,-998.87,1.13,7.70,18.88,0.34,0
45544,4640,-0.89,-999.76,0.24,0.00,0.89,0.32,0
45545,4640,-0.24,-1000.00,0.00,0.07,0.18,0.34,0
45546,4641,1000.00,1000.00,2000.00,0.00,1000.00,0.28,1
45547,4641,1000.00,2000.00,3000.00,1000.00,1000.00,0.02,1
45548,4641,1000.00,3000.00,4000.00,243.20,2756.80,0.44,1
45549,4641,1000.00,4000.00,5000.00,555.09,3444.91,0.26,1
45550,4641,1000.00,5000.00,6000.00,0.00,5000.00,0.39,1
45551,4641,1000.00,6000.00,7000.00,0.00,6000.00,0.42,1
45552,4641,1000.00,7000.00,8000.00,2541.37,4458.63,0.21,1
45553,4641,1000.00,8000.00,9000.00,0.00,8000.00,0.05,1
45554,4641,1000.00,9000.00,10000.00,0.00,5176.34,0.24,1
45555,4641,1000.00,10000.00,11000.00,0.00,10000.00,0.27,1
45556,4641,1000.00,11000.00,12000.00,0.00,11000.00,0.40,1
45557,4641,1000.00,12000.00,13000.00,837.90,11162.10,0.10,1
45558,4641,1000.00,13000.00,14000.00,0.00,1662.01,0.11,1
45559,4641,1000.00,14000.00,15000.00,0.00,14000.00,0.37,1
45560,4641,1000.00,15000.00,16000.00,6663.10,8336.90,0.22,1
45561,4641,1000.00,16000.00,17000.00,7582.53,8417.47,0.39,1
45562,4641,-1000.00,15000.00,16000.00,8500.00,8500.00,0.28,0
45563,4641,-1000.00,14000.00,15000.00,5400.66,10599.34,0.03,0
45564,4641,-1000.00,13000.00,14000.00,5784.84,3068.56,0.36,0
45565,4641,-1000.00,12000.00,13000.00,1680.96,12319.04,0.32,0
45566,4641,-1000.00,11000.00,12000.00,0.00,13000.00,0.39,0
45567,4641,-1000.00,10000.00,11000.00,0.00,2812.93,0.09,0
45568,4641,-1000.00,9000.00,10000.00,0.00,11000.00,0.10,0
45569,4641,-1000.00,8000.00,9000.00,0.00,2631.79,0.15,0
45570,4641,-1000.00,7000.00,8000.00,0.00,6421.85,0.15,0
45571,4641,-1000.00,6000.00,7000.00,0.00,8000.00,0.41,0
45572,4641,-1000.00,5000.00,6000.00,0.00,115.03,0.12,0
45573,4641,-1000.00,4000.00,5000.00,1735.41,4264.59,0.36,0
45574,4641,-1000.00,3000.00,4000.00,1142.58,3857.42,0.04,0
45575,4641,-1000.00,2000.00,3000.00,0.00,1442.40,0.13,0
45576,4641,-1000.00,1000.00,2000.00,0.00,3000.00,0.10,0
45577,4641,-1000.00,0.00,1000.00,0.00,1033.69,0.28,0
45578,4641,-124.33,-124.33,875.67,124.33,0.00,0.02,0
45579,4641,-1000.00,-1124.33,-124.33,437.83,437.83,0.00,0
45580,4642,-1000.00,-1000.00,0.00,0.00,241.28,0.36,0
45581,4643,0.00,0.00,1000.00,0.00,0.00,0.22,0
45582,4643,1000.00,1000.00,2000.00,0.00,924.56,0.26,1
45583,4643,1000.00,2000.00,3000.00,18.44,1981.56,0.37,1
45584,4643,1000.00,3000.00,4000.00,152.25,2847.75,0.44,1
45585,4643,1000.00,4000.00,5000.00,0.00,4000.00,0.00,1
45586,4643,1000.00,5000.00,6000.00,0.00,3927.07,0.41,1
45587,4643,1000.00,6000.00,7000.00,0.00,6000.00,0.05,1
45588,4643,1000.00,7000.00,8000.00,0.00,7000.00,0.15,1
45589,4643,-1000.00,6000.00,7000.00,4942.00,3058.00,0.13,0
45590,4643,1000.00,7000.00,8000.00,2508.22,4491.78,0.31,1
45591,4643,1000.00,8000.00,9000.00,428.01,3714.34,0.30,1
45592,4643,1000.00,9000.00,10000.00,4500.00,4500.00,0.07,1
45593,4643,1000.00,10000.00,11000.00,1747.29,4231.23,0.27,1
45594,4643,1000.00,11000.00,12000.00,168.42,9631.47,0.43,1
45595,4643,1000.00,12000.00,13000.00,5478.73,6521.27,0.09,1
45596,4643,1000.00,13000.00,14000.00,6500.00,6500.00,0.30,1
45597,4643,1000.00,14000.00,15000.00,0.00,14000.00,0.36,1
45598,4643,1000.00,15000.00,16000.00,2154.06,12845.94,0.19,1
45599,4643,1000.00,16000.00,17000.00,0.00,9547.84,0.09,1
45600,4643,1000.00,17000.00,18000.00,0.00,16452.49,0.43,1
45601,4643,1000.00,18000.00,19000.00,3582.15,14417.85,0.34,1
45602,4643,1000.00,19000.00,20000.00,8489.33,10510.67,0.11,1
45603,4643,1000.00,20000.00,21000.00,0.00,20000.00,0.05,1
45604,4643,1000.00,21000.00,22000.00,0.00,21000.00,0.12,1
45605,4643,1000.00,22000.00,23000.00,4018.35,17981.65,0.12,1
45606,4643,1000.00,23000.00,24000.00,0.00,23000.00,0.24,1
45607,4643,1000.00,24000.00,25000.00,0.00,24000.00,0.11,1
45608,4643,1000.00,25000.00,26000.00,7960.84,17039.16,0.20,1
45609,4643,1000.00,26000.00,27000.00,0.00,26000.00,0.22,1
45610,4643,1000.00,27000.00,28000.00,1209.70,8533.59,0.23,1
45611,4643,1000.00,28000.00,29000.00,9073.51,18926.49,0.28,1
45612,4643,1000.00,29000.00,30000.00,0.00,23910.02,0.36,1
45613,4643,1000.00,30000.00,31000.00,12278.45,17721.55,0.15,1
45614,4643,1000.00,31000.00,32000.00,96.87,30903.13,0.41,1
45615,4643,1000.00,32000.00,33000.00,0.00,32000.00,0.34,1
45616,4643,-1000.00,31000.00,32000.00,16804.83,16195.17,0.20,0
45617,4643,1000.00,32000.00,33000.00,0.00,32000.00,0.24,1
45618,4643,1000.00,33000.00,34000.00,0.00,33000.00,0.11,1
45619,4643,1000.00,34000.00,35000.00,5856.65,26449.21,0.40,1
45620,4643,1000.00,35000.00,36000.00,0.00,35000.00,0.37,1
45621,4643,1000.00,36000.00,37000.00,0.00,36000.00,0.42,1
45622,4643,1000.00,37000.00,38000.00,13302.28,23697.72,0.28,1
45623,4643,1000.00,38000.00,39000.00,13566.75,24433.25,0.30,1
45624,4643,1000.00,39000.00,40000.00,17336.69,21663.31,0.28,1
45625,4644,-589.49,-589.49,410.51,589.49,0.00,0.09,0
45626,4644,-1000.00,-1589.49,-589.49,0.00,74.89,0.02,0
45627,4645,-973.42,-973.42,26.58,0.00,973.42,0.07,0
45628,4645,-16.42,-989.84,10.16,0.00,16.42,0.09,0
45629,4645,-0.08,-989.92,10.08,0.00,0.08,0.22,0
45630,4645,-7.16,-997.08,2.92,0.65,6.51,0.34,0
45631,4645,-2.92,-1000.00,0.00,0.98,1.95,0.25,0
45632,4646,0.00,0.00,1000.00,0.00,0.00,0.16,0
45633,4646,-1000.00,-1000.00,0.00,0.00,21.02,0.30,0
45634,4647,-1000.00,-1000.00,0.00,548.68,451.32,0.03,0
45635,4648,0.00,0.00,1000.00,0.00,0.00,0.10,0
45636,4648,1000.00,1000.00,2000.00,0.00,262.81,0.24,1
45637,4648,1000.00,2000.00,3000.00,134.44,1077.70,0.34,1
45638,4648,-1000.00,1000.00,2000.00,1511.22,1488.78,0.10,0
45639,4648,1000.00,2000.00,3000.00,985.30,1014.70,0.21,1
45640,4648,1000.00,3000.00,4000.00,1263.56,1736.44,0.19,1
45641,4648,1000.00,4000.00,5000.00,0.00,4000.00,0.11,1
45642,4648,1000.00,5000.00,6000.00,1772.24,3227.76,0.12,1
45643,4648,1000.00,6000.00,7000.00,290.08,5709.92,0.39,1
45644,4648,1000.00,7000.00,8000.00,2791.68,4208.32,0.29,1
45645,4648,0.00,7000.00,8000.00,0.00,0.00,0.00,0
45646,4648,1000.00,8000.00,9000.00,0.00,5843.21,0.18,1
45647,4648,1000.00,9000.00,10000.00,2549.58,6450.42,0.32,1
45648,4648,1000.00,10000.00,11000.00,3968.98,6031.02,0.22,1
45649,4648,1000.00,11000.00,12000.00,0.00,7099.61,0.36,1
45650,4648,1000.00,12000.00,13000.00,755.26,11244.74,0.21,1
45651,4648,1000.00,13000.00,14000.00,0.00,10270.98,0.23,1
45652,4648,1000.00,14000.00,15000.00,0.00,14000.00,0.12,1
45653,4648,1000.00,15000.00,16000.00,0.00,4670.82,0.11,1
45654,4648,1000.00,16000.00,17000.00,0.00,11386.04,0.26,1
45655,4648,1000.00,17000.00,18000.00,0.00,17000.00,0.28,1
45656,4648,1000.00,18000.00,19000.00,6859.84,11140.16,0.06,1
45657,4648,1000.00,19000.00,20000.00,0.00,19000.00,0.22,1
45658,4648,1000.00,20000.00,21000.00,3815.80,4835.72,0.19,1
45659,4648,-1000.00,19000.00,20000.00,10500.00,10500.00,0.24,0
45660,4648,-1000.00,18000.00,19000.00,4930.17,15069.83,0.38,0
45661,4648,-1000.00,17000.00,18000.00,2557.69,11512.33,0.35,0
45662,4648,-1000.00,16000.00,17000.00,4584.45,13415.55,0.03,0
45663,4648,-1000.00,15000.00,16000.00,0.00,16477.81,0.42,0
45664,4648,-1000.00,14000.00,15000.00,0.00,16000.00,0.25,0
45665,4648,-1000.00,13000.00,14000.00,0.00,15000.00,0.05,0
45666,4648,-1000.00,12000.00,13000.00,764.56,9558.30,0.38,0
45667,4648,-1000.00,11000.00,12000.00,0.00,5365.21,0.24,0
45668,4648,-1000.00,10000.00,11000.00,0.00,5268.07,0.27,0
45669,4648,-1000.00,9000.00,10000.00,2215.51,8784.49,0.35,0
45670,4648,-1000.00,8000.00,9000.00,5000.00,5000.00,0.07,0
45671,4648,-1000.00,7000.00,8000.00,3773.61,5226.39,0.01,0
45672,4648,-1000.00,6000.00,7000.00,3337.50,4662.50,0.19,0
45673,4648,-1000.00,5000.00,6000.00,0.00,7000.00,0.32,0
45674,4648,-1000.00,4000.00,5000.00,3577.92,2422.08,0.10,0
45675,4648,-1000.00,3000.00,4000.00,1283.83,1211.77,0.18,0
45676,4648,-1000.00,2000.00,3000.00,0.00,4000.00,0.05,0
45677,4648,-1000.00,1000.00,2000.00,1443.14,1556.86,0.20,0
45678,4648,-1000.00,0.00,1000.00,930.79,1069.21,0.15,0
45679,4648,-1000.00,-1000.00,0.00,198.64,144.13,0.15,0
45680,4649,-840.26,-840.26,159.74,189.26,651.00,0.33,0
45681,4649,-1000.00,-1840.26,-840.26,97.07,62.67,0.08,0
45682,4650,-1000.00,-1000.00,0.00,424.51,575.49,0.30,0
45683,4651,-586.11,-586.11,413.89,159.61,426.50,0.33,0
45684,4651,1000.00,413.89,1413.89,408.98,0.00,0.11,1
45685,4651,-564.67,-150.78,849.22,0.00,564.67,0.41,0
45686,4651,-438.22,-589.00,411.00,0.00,438.22,0.34,0
45687,4651,-411.00,-1000.00,0.00,68.67,342.32,0.22,0
45688,4652,-581.15,-581.15,418.85,110.82,470.33,0.32,0
45689,4652,-246.42,-827.56,172.44,0.00,246.42,0.27,0
45690,4652,1000.00,172.44,1172.44,7.58,0.00,0.09,1
45691,4652,1000.00,1172.44,2172.44,927.68,0.00,0.08,1
45692,4652,-1000.00,172.44,1172.44,81.58,945.13,0.38,0
45693,4652,-1000.00,-827.56,172.44,105.05,942.52,0.18,0
45694,4652,-172.44,-1000.00,0.00,85.42,87.02,0.03,0
45695,4653,-76.90,-76.90,923.10,76.90,0.00,0.26,0
45696,4653,-583.20,-660.09,339.91,583.20,0.00,0.23,0
45697,4653,-339.91,-1000.00,0.00,184.56,155.35,0.09,0
45698,4654,-1000.00,-1000.00,0.00,0.00,697.42,0.24,0
45699,4655,-1000.00,-1000.00,0.00,0.00,209.94,0.35,0
45700,4656,1000.00,1000.00,2000.00,381.62,0.00,0.32,1
45701,4656,1000.00,2000.00,3000.00,61.65,0.00,0.11,1
45702,4656,-1000.00,1000.00,2000.00,0.00,2630.14,0.22,0
45703,4656,-1000.00,0.00,1000.00,237.65,940.70,0.37,0
45704,4656,-814.03,-814.03,185.97,360.35,453.67,0.36,0
45705,4656,-185.97,-1000.00,0.00,36.84,149.14,0.12,0
45706,4657,1000.00,1000.00,2000.00,0.00,516.82,0.32,1
45707,4657,1000.00,2000.00,3000.00,0.00,2000.00,0.27,1
45708,4657,1000.00,3000.00,4000.00,0.00,3000.00,0.29,1
45709,4657,1000.00,4000.00,5000.00,0.00,4000.00,0.19,1
45710,4657,1000.00,5000.00,6000.00,1364.40,3635.60,0.33,1
45711,4657,1000.00,6000.00,7000.00,0.00,3873.65,0.30,1
45712,4657,1000.00,7000.00,8000.00,2446.19,4553.81,0.31,1
45713,4657,1000.00,8000.00,9000.00,2265.16,2647.73,0.21,1
45714,4657,1000.00,9000.00,10000.00,0.00,351.37,0.12,1
45715,4657,-1000.00,8000.00,9000.00,6253.63,1547.13,0.10,0
45716,4657,1000.00,9000.00,10000.00,0.00,8683.22,0.17,1
45717,4657,1000.00,10000.00,11000.00,0.00,10000.00,0.13,1
45718,4657,1000.00,11000.00,12000.00,0.00,11000.00,0.42,1
45719,4657,-1000.00,10000.00,11000.00,7244.18,0.00,0.13,0
45720,4657,1000.00,11000.00,12000.00,0.00,10992.68,0.32,1
45721,4657,1000.00,12000.00,13000.00,0.00,12000.00,0.36,1
45722,4657,1000.00,13000.00,14000.00,0.00,8051.82,0.31,1
45723,4657,1000.00,14000.00,15000.00,4267.94,9732.06,0.11,1
45724,4657,1000.00,15000.00,16000.00,7500.00,7500.00,0.09,1
45725,4657,1000.00,16000.00,17000.00,1975.08,6104.71,0.25,1
45726,4657,1000.00,17000.00,18000.00,0.00,15787.47,0.04,1
45727,4657,1000.00,18000.00,19000.00,4366.04,7372.90,0.25,1
45728,4657,1000.00,19000.00,20000.00,0.00,19000.00,0.30,1
45729,4657,1000.00,20000.00,21000.00,0.00,20000.00,0.19,1
45730,4657,-1000.00,19000.00,20000.00,3133.64,0.00,0.01,0
45731,4657,1000.00,20000.00,21000.00,10000.00,10000.00,0.05,1
45732,4657,1000.00,21000.00,22000.00,3771.89,17228.11,0.14,1
45733,4657,1000.00,22000.00,23000.00,240.36,15903.38,0.40,1
45734,4657,1000.00,23000.00,24000.00,2718.32,20281.68,0.35,1
45735,4657,-1000.00,22000.00,23000.00,13500.73,10499.27,0.12,0
45736,4657,1000.00,23000.00,24000.00,9304.99,13695.01,0.28,1
45737,4657,1000.00,24000.00,25000.00,0.00,7793.11,0.01,1
45738,4657,1000.00,25000.00,26000.00,7694.48,17305.52,0.35,1
45739,4657,1000.00,26000.00,27000.00,7611.51,18388.49,0.22,1
45740,4657,1000.00,27000.00,28000.00,0.00,27000.00,0.17,1
45741,4657,1000.00,28000.00,29000.00,0.00,3165.87,0.12,1
45742,4657,1000.00,29000.00,30000.00,2469.19,24686.68,0.42,1
45743,4657,1000.00,30000.00,31000.00,0.00,21848.85,0.38,1
45744,4657,-1000.00,29000.00,30000.00,16027.29,14972.71,0.21,0
45745,4657,1000.00,30000.00,31000.00,0.00,30000.00,0.40,1
45746,4657,1000.00,31000.00,32000.00,12957.50,18042.50,0.28,1
45747,4657,1000.00,32000.00,33000.00,12948.33,19051.67,0.13,1
45748,4657,1000.00,33000.00,34000.00,9249.33,23750.67,0.36,1
45749,4657,1000.00,34000.00,35000.00,16096.84,17903.16,0.13,1
45750,4657,-1000.00,33000.00,34000.00,31661.98,3338.02,0.05,0
45751,4657,1000.00,34000.00,35000.00,1837.38,32162.62,0.29,1
45752,4657,-1000.00,33000.00,34000.00,21189.84,0.00,0.06,0
45753,4657,1000.00,34000.00,35000.00,13899.86,20100.14,0.20,1
45754,4657,-1000.00,33000.00,34000.00,0.00,35000.00,0.04,0
45755,4657,-1000.00,32000.00,33000.00,5368.45,28631.55,0.41,0
45756,4657,-1000.00,31000.00,32000.00,0.00,7706.66,0.16,0
45757,4657,-1000.00,30000.00,31000.00,0.00,28397.28,0.31,0
45758,4657,-1000.00,29000.00,30000.00,8646.99,22353.01,0.26,0
45759,4657,0.00,29000.00,30000.00,0.00,0.00,0.03,0
45760,4657,-1000.00,28000.00,29000.00,8430.12,14094.06,0.27,0
45761,4657,-1000.00,27000.00,28000.00,0.00,12392.41,0.20,0
45762,4657,-1000.00,26000.00,27000.00,0.00,28000.00,0.13,0
45763,4657,-1000.00,25000.00,26000.00,624.95,3192.17,0.15,0
45764,4657,-1000.00,24000.00,25000.00,8211.87,17788.13,0.30,0
45765,4657,-1000.00,23000.00,24000.00,0.00,4594.52,0.18,0
45766,4657,-1000.00,22000.00,23000.00,5765.08,15783.19,0.35,0
45767,4657,-1000.00,21000.00,22000.00,5324.53,17675.47,0.35,0
45768,4657,-1000.00,20000.00,21000.00,0.00,20332.98,0.42,0
45769,4657,-1000.00,19000.00,20000.00,0.00,13824.38,0.37,0
45770,4657,-1000.00,18000.00,19000.00,0.00,20000.00,0.29,0
45771,4657,-1000.00,17000.00,18000.00,9500.00,9500.00,0.03,0
45772,4657,-1000.00,16000.00,17000.00,434.54,15514.96,0.43,0
45773,4657,-1000.00,15000.00,16000.00,0.00,17000.00,0.41,0
45774,4657,-1000.00,14000.00,15000.00,11290.85,4709.15,0.06,0
45775,4657,-1000.00,13000.00,14000.00,0.00,15000.00,0.10,0
45776,4657,-1000.00,12000.00,13000.00,0.00,7153.47,0.30,0
45777,4658,-142.18,-142.18,857.82,128.76,13.42,0.43,0
45778,4658,-1000.00,-1142.18,-142.18,268.13,589.69,0.16,0
45779,4659,1000.00,1000.00,2000.00,0.00,1000.00,0.09,1
45780,4659,1000.00,2000.00,3000.00,0.00,1912.35,0.44,1
45781,4659,1000.00,3000.00,4000.00,85.85,2537.05,0.43,1
45782,4659,-1000.00,2000.00,3000.00,2065.36,1934.64,0.05,0
45783,4659,1000.00,3000.00,4000.00,0.00,3000.00,0.28,1
45784,4659,0.00,3000.00,4000.00,0.00,0.00,0.01,0
45785,4659,1000.00,4000.00,5000.00,0.00,4000.00,0.30,1
45786,4659,1000.00,5000.00,6000.00,1236.64,3763.36,0.30,1
45787,4659,1000.00,6000.00,7000.00,0.00,6000.00,0.39,1
45788,4659,1000.00,7000.00,8000.00,0.00,7000.00,0.00,1
45789,4659,1000.00,8000.00,9000.00,0.00,8000.00,0.07,1
45790,4659,1000.00,9000.00,10000.00,0.00,9000.00,0.04,1
45791,4659,1000.00,10000.00,11000.00,0.00,6895.55,0.24,1
45792,4659,1000.00,11000.00,12000.00,4701.89,6298.11,0.10,1
45793,4659,-1000.00,10000.00,11000.00,6416.80,5583.20,0.13,0
45794,4659,1000.00,11000.00,12000.00,3110.97,7889.03,0.15,1
45795,4659,1000.00,12000.00,13000.00,0.00,12000.00,0.15,1
45796,4659,1000.00,13000.00,14000.00,2643.55,10356.45,0.20,1
45797,4659,1000.00,14000.00,15000.00,0.00,9598.07,0.34,1
45798,4659,1000.00,15000.00,16000.00,7500.00,7500.00,0.02,1
45799,4659,-1000.00,14000.00,15000.00,7677.24,8322.76,0.29,0
45800,4659,-1000.00,13000.00,14000.00,0.00,14575.82,0.23,0
45801,4659,-1000.00,12000.00,13000.00,0.00,14000.00,0.13,0
45802,4659,-1000.00,11000.00,12000.00,0.00,13000.00,0.15,0
45803,4659,-1000.00,10000.00,11000.00,0.00,11868.77,0.36,0
45804,4659,-1000.00,9000.00,10000.00,1363.24,9636.76,0.42,0
45805,4659,0.00,9000.00,10000.00,0.00,0.00,0.00,0
45806,4659,-1000.00,8000.00,9000.00,2018.41,7981.59,0.32,0
45807,4659,-1000.00,7000.00,8000.00,0.00,3727.95,0.08,0
45808,4659,-1000.00,6000.00,7000.00,4000.00,4000.00,0.06,0
45809,4659,-1000.00,5000.00,6000.00,4419.61,0.00,0.00,0
45810,4659,-1000.00,4000.00,5000.00,0.00,5779.50,0.44,0
45811,4659,-1000.00,3000.00,4000.00,819.86,3735.89,0.39,0
45812,4659,-1000.00,2000.00,3000.00,617.46,3382.54,0.40,0
45813,4659,-1000.00,1000.00,2000.00,266.01,2733.99,0.40,0
45814,4659,-1000.00,0.00,1000.00,1273.26,726.74,0.15,0
45815,4659,-1000.00,-1000.00,0.00,0.00,1000.00,0.16,0
45816,4660,-883.76,-883.76,116.24,830.13,53.63,0.17,0
45817,4660,-13.53,-897.29,102.71,0.00,0.12,0.36,0
45818,4660,-1000.00,-1897.29,-897.29,1.25,101.46,0.06,0
45819,4661,1000.00,1000.00,2000.00,674.22,325.78,0.06,1
45820,4661,-1000.00,0.00,1000.00,567.10,1228.71,0.23,0
45821,4661,-982.31,-982.31,17.69,343.11,639.20,0.21,0
45822,4661,-1.56,-983.86,16.14,0.00,1.56,0.43,0
45823,4661,0.00,-983.86,16.14,0.00,0.00,0.06,0
45824,4661,0.00,-983.86,16.14,0.00,0.00,0.34,0
45825,4661,1000.00,16.14,1016.14,12.15,2.10,0.20,1
45826,4661,-691.27,-675.14,324.86,0.00,691.27,0.36,0
45827,4661,0.00,-675.14,324.86,0.00,0.00,0.16,0
45828,4661,-103.80,-778.93,221.07,0.00,103.80,0.16,0
45829,4661,-221.07,-1000.00,0.00,110.53,110.53,0.01,0
45830,4662,-1000.00,-1000.00,0.00,578.69,421.31,0.14,0
45831,4663,889.90,889.90,1889.90,0.00,8.99,0.08,1
45832,4663,1000.00,1889.90,2889.90,0.00,1889.90,0.38,1
45833,4663,1000.00,2889.90,3889.90,0.00,1971.59,0.36,1
45834,4663,1000.00,3889.90,4889.90,0.00,3549.87,0.42,1
45835,4663,1000.00,4889.90,5889.90,0.00,3167.64,0.09,1
45836,4663,-1000.00,3889.90,4889.90,5281.15,608.75,0.01,0
45837,4663,1000.00,4889.90,5889.90,1352.84,3537.06,0.15,1
45838,4663,-1000.00,3889.90,4889.90,3419.09,0.00,0.06,0
45839,4663,1000.00,4889.90,5889.90,362.02,4527.88,0.44,1
45840,4663,1000.00,5889.90,6889.90,0.00,746.53,0.15,1
45841,4663,1000.00,6889.90,7889.90,1315.23,5574.67,0.30,1
45842,4663,1000.00,7889.90,8889.90,0.00,2902.30,0.22,1
45843,4663,1000.00,8889.90,9889.90,653.76,8236.15,0.09,1
45844,4663,1000.00,9889.90,10889.90,0.00,9889.90,0.13,1
45845,4663,-1000.00,8889.90,9889.90,5293.57,4287.16,0.24,0
45846,4663,1000.00,9889.90,10889.90,3225.18,6664.73,0.02,1
45847,4663,1000.00,10889.90,11889.90,0.00,6757.23,0.05,1
45848,4663,1000.00,11889.90,12889.90,5567.72,6322.18,0.09,1
45849,4663,1000.00,12889.90,13889.90,0.00,12889.90,0.03,1
45850,4663,1000.00,13889.90,14889.90,735.65,12007.93,0.43,1
45851,4663,1000.00,14889.90,15889.90,7095.18,7794.72,0.13,1
45852,4663,1000.00,15889.90,16889.90,0.00,15889.90,0.11,1
45853,4663,-1000.00,14889.90,15889.90,9574.40,7315.50,0.33,0
45854,4663,-1000.00,13889.90,14889.90,0.00,5467.10,0.29,0
45855,4663,-1000.00,12889.90,13889.90,5524.72,9365.18,0.30,0
45856,4663,-1000.00,11889.90,12889.90,2842.47,11047.43,0.10,0
45857,4663,-1000.00,10889.90,11889.90,8066.03,4823.87,0.02,0
45858,4663,-1000.00,9889.90,10889.90,0.00,11889.90,0.18,0
45859,4663,-1000.00,8889.90,9889.90,0.00,10889.90,0.17,0
45860,4663,-1000.00,7889.90,8889.90,3703.93,6185.97,0.34,0
45861,4663,-1000.00,6889.90,7889.90,4444.95,4444.95,0.01,0
45862,4663,-1000.00,5889.90,6889.90,3238.34,4651.56,0.22,0
45863,4663,-1000.00,4889.90,5889.90,928.22,5961.68,0.43,0
45864,4663,-1000.00,3889.90,4889.90,937.85,4952.05,0.14,0
45865,4663,-1000.00,2889.90,3889.90,0.00,3949.63,0.17,0
45866,4663,-1000.00,1889.90,2889.90,0.00,3889.90,0.20,0
45867,4663,-508.24,1381.66,2381.66,0.00,508.24,0.04,0
45868,4663,-1000.00,381.66,1381.66,0.00,2381.66,0.24,0
45869,4663,-1000.00,-618.34,381.66,292.46,1089.20,0.40,0
45870,4663,-1000.00,-1618.34,-618.34,201.36,180.30,0.20,0
45871,4664,1000.00,1000.00,2000.00,611.62,388.38,0.08,1
45872,4664,0.00,1000.00,2000.00,0.00,0.00,0.10,0
45873,4664,1000.00,2000.00,3000.00,230.80,0.00,0.09,1
45874,4664,1000.00,3000.00,4000.00,1482.27,1054.17,0.28,1
45875,4664,-1000.00,2000.00,3000.00,0.00,4000.00,0.43,0
45876,4664,-1000.00,1000.00,2000.00,0.00,3000.00,0.42,0
45877,4664,1000.00,2000.00,3000.00,1175.53,309.86,0.25,1
45878,4664,-1000.00,1000.00,2000.00,0.00,2926.91,0.22,0
45879,4664,0.00,1000.00,2000.00,0.00,0.00,0.03,0
45880,4664,-1000.00,0.00,1000.00,0.00,2000.00,0.15,0
45881,4664,-1000.00,-1000.00,0.00,0.00,1000.00,0.00,0
45882,4665,-1000.00,-1000.00,0.00,500.00,500.00,0.08,0
45883,4666,-381.06,-381.06,618.94,139.14,241.92,0.43,0
45884,4666,-618.94,-1000.00,0.00,0.00,618.94,0.02,0
45885,4667,-234.79,-234.79,765.21,0.00,234.79,0.12,0
45886,4667,-758.64,-993.42,6.58,0.00,758.64,0.09,0
45887,4667,-6.58,-1000.00,0.00,2.83,3.74,0.02,0
45888,4668,-1000.00,-1000.00,0.00,406.84,593.16,0.21,0
45889,4669,-1000.00,-1000.00,0.00,400.67,599.33,0.09,0
45890,4670,-1000.00,-1000.00,0.00,241.34,758.66,0.38,0
45891,4671,-1000.00,-1000.00,0.00,538.87,461.13,0.15,0
45892,4672,-126.70,-126.70,873.30,126.70,0.00,0.27,0
45893,4672,-873.30,-1000.00,0.00,561.91,311.39,0.13,0
45894,4673,-1000.00,-1000.00,0.00,202.12,797.88,0.12,0
45895,4674,-988.37,-988.37,11.63,765.90,222.48,0.18,0
45896,4674,0.00,-988.37,11.63,0.00,0.00,0.24,0
45897,4674,-1000.00,-1988.37,-988.37,3.29,8.34,0.26,0
45898,4675,0.00,0.00,1000.00,0.00,0.00,0.19,0
45899,4675,-1000.00,-1000.00,0.00,0.00,33.72,0.37,0
45900,4676,-110.51,-110.51,889.49,110.51,0.00,0.42,0
45901,4676,-543.67,-654.18,345.82,423.78,119.90,0.32,0
45902,4676,-214.55,-868.73,131.27,112.34,102.21,0.19,0
45903,4676,-1000.00,-1868.73,-868.73,0.00,63.97,0.10,0
45904,4677,1000.00,1000.00,2000.00,852.49,0.00,0.16,1
45905,4677,1000.00,2000.00,3000.00,701.93,0.00,0.36,1
45906,4677,1000.00,3000.00,4000.00,1090.55,329.08,0.36,1
45907,4677,-1000.00,2000.00,3000.00,1241.42,2758.58,0.04,0
45908,4677,1000.00,3000.00,4000.00,1683.79,0.00,0.28,1
45909,4677,-1000.00,2000.00,3000.00,0.00,2578.30,0.20,0
45910,4677,-1000.00,1000.00,2000.00,1442.13,1557.87,0.07,0
45911,4677,-1000.00,0.00,1000.00,310.66,1250.79,0.32,0
45912,4677,-461.97,-461.97,538.03,0.00,461.97,0.19,0
45913,4677,-538.03,-1000.00,0.00,0.00,538.03,0.18,0
45914,4678,0.00,0.00,1000.00,0.00,0.00,0.01,0
45915,4678,-1000.00,-1000.00,0.00,85.35,914.65,0.06,0
45916,4679,-1000.00,-1000.00,0.00,765.76,234.24,0.05,0
45917,4680,-1000.00,-1000.00,0.00,0.00,1000.00,0.18,0
45918,4681,1000.00,1000.00,2000.00,0.00,410.75,0.14,1
45919,4681,1000.00,2000.00,3000.00,0.00,1846.23,0.43,1
45920,4681,1000.00,3000.00,4000.00,0.00,3000.00,0.07,1
45921,4681,1000.00,4000.00,5000.00,0.00,4000.00,0.12,1
45922,4681,1000.00,5000.00,6000.00,0.00,1892.25,0.22,1
45923,4681,1000.00,6000.00,7000.00,0.00,6000.00,0.03,1
45924,4681,1000.00,7000.00,8000.00,1250.08,5749.92,0.41,1
45925,4681,1000.00,8000.00,9000.00,0.00,8000.00,0.29,1
45926,4681,1000.00,9000.00,10000.00,0.00,7752.23,0.29,1
45927,4681,1000.00,10000.00,11000.00,1846.85,5646.11,0.32,1
45928,4681,1000.00,11000.00,12000.00,0.00,11000.00,0.21,1
45929,4681,1000.00,12000.00,13000.00,0.00,10198.75,0.40,1
45930,4681,1000.00,13000.00,14000.00,3276.30,9723.70,0.35,1
45931,4681,-1000.00,12000.00,13000.00,8760.18,3912.57,0.12,0
45932,4681,-1000.00,11000.00,12000.00,13000.00,0.00,0.02,0
45933,4681,1000.00,12000.00,13000.00,1785.28,10214.72,0.39,1
45934,4681,1000.00,13000.00,14000.00,0.00,13000.00,0.10,1
45935,4681,1000.00,14000.00,15000.00,0.00,7954.02,0.27,1
45936,4681,1000.00,15000.00,16000.00,0.00,1543.98,0.15,1
45937,4681,1000.00,16000.00,17000.00,0.00,16000.00,0.11,1
45938,4681,1000.00,17000.00,18000.00,0.00,12292.31,0.11,1
45939,4681,-1000.00,16000.00,17000.00,8781.90,9218.10,0.40,0
45940,4681,-1000.00,15000.00,16000.00,669.52,6236.67,0.30,0
45941,4681,-1000.00,14000.00,15000.00,8000.00,8000.00,0.01,0
45942,4681,-1000.00,13000.00,14000.00,0.00,6804.36,0.27,0
45943,4681,-1000.00,12000.00,13000.00,6770.27,7229.73,0.17,0
45944,4681,-1000.00,11000.00,12000.00,4390.54,6186.89,0.26,0
45945,4681,-1000.00,10000.00,11000.00,3918.18,7952.39,0.33,0
45946,4681,-1000.00,9000.00,10000.00,448.90,5175.74,0.30,0
45947,4681,-1000.00,8000.00,9000.00,0.00,10000.00,0.10,0
45948,4681,-1000.00,7000.00,8000.00,0.00,9000.00,0.10,0
45949,4681,-1000.00,6000.00,7000.00,171.18,6480.23,0.42,0
45950,4681,-1000.00,5000.00,6000.00,0.00,4075.93,0.16,0
45951,4681,-1000.00,4000.00,5000.00,0.00,3863.48,0.13,0
45952,4681,-1000.00,3000.00,4000.00,1086.78,3913.22,0.21,0
45953,4681,-1000.00,2000.00,3000.00,0.00,4000.00,0.10,0
45954,4681,-1000.00,1000.00,2000.00,0.00,3000.00,0.23,0
45955,4681,1000.00,2000.00,3000.00,0.00,872.88,0.26,1
45956,4681,1000.00,3000.00,4000.00,975.96,2024.04,0.16,1
45957,4681,1000.00,4000.00,5000.00,0.00,4000.00,0.25,1
45958,4681,1000.00,5000.00,6000.00,0.00,3921.83,0.30,1
45959,4681,1000.00,6000.00,7000.00,0.00,1896.73,0.14,1
45960,4681,1000.00,7000.00,8000.00,1255.25,5744.75,0.40,1
45961,4681,-1000.00,6000.00,7000.00,1716.67,1093.37,0.15,0
45962,4681,1000.00,7000.00,8000.00,0.00,7000.00,0.39,1
45963,4681,1000.00,8000.00,9000.00,1650.53,6349.47,0.37,1
45964,4681,1000.00,9000.00,10000.00,3900.90,5099.10,0.11,1
45965,4681,1000.00,10000.00,11000.00,0.00,8396.13,0.37,1
45966,4681,1000.00,11000.00,12000.00,0.00,3780.98,0.10,1
45967,4681,1000.00,12000.00,13000.00,4638.43,7361.57,0.30,1
45968,4681,1000.00,13000.00,14000.00,6177.78,6822.22,0.24,1
45969,4681,-1000.00,12000.00,13000.00,11467.25,0.00,0.01,0
45970,4681,1000.00,13000.00,14000.00,6500.00,6500.00,0.09,1
45971,4681,1000.00,14000.00,15000.00,7000.00,7000.00,0.05,1
45972,4681,1000.00,15000.00,16000.00,6653.19,8346.81,0.18,1
45973,4681,1000.00,16000.00,17000.00,0.00,16000.00,0.10,1
45974,4681,1000.00,17000.00,18000.00,0.00,17000.00,0.04,1
45975,4681,1000.00,18000.00,19000.00,7391.19,10608.81,0.22,1
45976,4681,1000.00,19000.00,20000.00,7787.39,11212.61,0.27,1
45977,4682,1000.00,1000.00,2000.00,0.00,1000.00,0.04,1
45978,4682,1000.00,2000.00,3000.00,0.00,983.52,0.31,1
45979,4682,1000.00,3000.00,4000.00,795.06,2204.94,0.36,1
45980,4682,1000.00,4000.00,5000.00,1977.40,2022.60,0.40,1
45981,4682,1000.00,5000.00,6000.00,120.14,3409.33,0.38,1
45982,4682,1000.00,6000.00,7000.00,0.00,3015.88,0.15,1
45983,4682,1000.00,7000.00,8000.00,0.00,7000.00,0.35,1
45984,4682,1000.00,8000.00,9000.00,0.00,4299.17,0.11,1
45985,4682,-1000.00,7000.00,8000.00,5692.44,3307.56,0.08,0
45986,4682,1000.00,8000.00,9000.00,0.00,5818.52,0.18,1
45987,4682,1000.00,9000.00,10000.00,0.00,7551.46,0.20,1
45988,4682,1000.00,10000.00,11000.00,1734.48,8265.52,0.18,1
45989,4682,1000.00,11000.00,12000.00,0.00,7269.37,0.20,1
45990,4682,1000.00,12000.00,13000.00,3921.63,8078.37,0.19,1
45991,4682,1000.00,13000.00,14000.00,0.00,4073.89,0.23,1
45992,4682,-1000.00,12000.00,13000.00,12894.54,1105.46,0.13,0
45993,4682,-1000.00,11000.00,12000.00,602.52,4116.66,0.24,0
45994,4682,-1000.00,10000.00,11000.00,876.74,5694.25,0.30,0
45995,4682,-1000.00,9000.00,10000.00,0.00,11000.00,0.12,0
45996,4682,-1000.00,8000.00,9000.00,0.00,3179.99,0.20,0
45997,4682,-1000.00,7000.00,8000.00,0.00,6172.78,0.36,0
45998,4682,-1000.00,6000.00,7000.00,0.00,4673.23,0.33,0
45999,4682,-1000.00,5000.00,6000.00,1678.21,5321.79,0.38,0
46000,4682,-1000.00,4000.00,5000.00,2429.00,3571.00,0.28,0
46001,4682,-1000.00,3000.00,4000.00,0.00,4317.24,0.21,0
46002,4682,-1000.00,2000.00,3000.00,0.00,4000.00,0.10,0
46003,4682,-1000.00,1000.00,2000.00,0.00,3000.00,0.05,0
46004,4682,-1000.00,0.00,1000.00,0.00,2000.00,0.24,0
46005,4682,-1000.00,-1000.00,0.00,716.40,121.91,0.21,0
46006,4683,-341.25,-341.25,658.75,341.25,0.00,0.21,0
46007,4683,-340.61,-681.86,318.14,340.61,0.00,0.09,0
46008,4683,0.00,-681.86,318.14,0.00,0.00,0.00,0
46009,4683,-1000.00,-1681.86,-681.86,44.26,216.16,0.28,0
46010,4684,-535.00,-535.00,465.00,0.00,535.00,0.23,0
46011,4684,-457.38,-992.38,7.62,0.00,457.38,0.14,0
46012,4684,-4.25,-996.63,3.37,0.00,4.25,0.21,0
46013,4684,-3.05,-999.68,0.32,0.00,3.05,0.01,0
46014,4684,-0.32,-1000.00,0.00,0.04,0.29,0.26,0
46015,4685,1000.00,1000.00,2000.00,664.00,0.00,0.15,1
46016,4685,1000.00,2000.00,3000.00,1281.88,0.00,0.20,1
46017,4685,-1000.00,1000.00,2000.00,1049.77,1210.71,0.36,0
46018,4685,0.00,1000.00,2000.00,0.00,0.00,0.29,0
46019,4685,-722.74,277.26,1277.26,0.00,722.74,0.35,0
46020,4685,0.00,277.26,1277.26,0.00,0.00,0.02,0
46021,4685,1000.00,1277.26,2277.26,733.66,543.60,0.09,1
46022,4685,-920.46,356.81,1356.81,0.00,920.46,0.24,0
46023,4685,0.00,356.81,1356.81,0.00,0.00,0.06,0
46024,4685,-848.09,-491.29,508.71,81.55,766.54,0.34,0
46025,4685,-417.39,-908.68,91.32,0.00,417.39,0.07,0
46026,4685,-1.29,-909.97,90.03,0.00,1.29,0.10,0
46027,4685,-44.41,-954.38,45.62,0.00,44.41,0.29,0
46028,4685,-45.62,-1000.00,0.00,21.54,24.08,0.24,0
46029,4686,1000.00,1000.00,2000.00,516.48,483.52,0.04,1
46030,4686,-1000.00,0.00,1000.00,655.62,1344.38,0.33,0
46031,4686,1000.00,1000.00,2000.00,364.61,125.39,0.13,1
46032,4686,-1000.00,0.00,1000.00,865.79,1134.21,0.26,0
46033,4686,-926.57,-926.57,73.43,461.68,464.89,0.22,0
46034,4686,-72.69,-999.26,0.74,0.00,72.69,0.35,0
46035,4686,-0.74,-1000.00,0.00,0.18,0.55,0.33,0
46036,4687,1000.00,1000.00,2000.00,0.00,701.00,0.39,1
46037,4687,1000.00,2000.00,3000.00,0.00,1472.78,0.37,1
46038,4687,1000.00,3000.00,4000.00,1321.64,1678.36,0.18,1
46039,4687,1000.00,4000.00,5000.00,0.00,1515.50,0.20,1
46040,4687,1000.00,5000.00,6000.00,0.00,5000.00,0.17,1
46041,4687,1000.00,6000.00,7000.00,1019.58,4980.42,0.41,1
46042,4687,-994.45,5005.55,6005.55,994.45,0.00,0.07,0
46043,4687,-1000.00,4005.55,5005.55,3848.50,2157.04,0.10,0
46044,4687,1000.00,5005.55,6005.55,1270.77,3734.78,0.37,1
46045,4687,1000.00,6005.55,7005.55,2333.82,3671.73,0.29,1
46046,4687,-1000.00,5005.55,6005.55,2939.23,1191.97,0.13,0
46047,4687,-1000.00,4005.55,5005.55,5396.50,0.00,0.01,0
46048,4687,1000.00,5005.55,6005.55,1076.67,3928.87,0.23,1
46049,4687,1000.00,6005.55,7005.55,0.00,4331.26,0.34,1
46050,4687,1000.00,7005.55,8005.55,0.00,7005.55,0.34,1
46051,4687,1000.00,8005.55,9005.55,0.00,890.68,0.04,1
46052,4687,1000.00,9005.55,10005.55,0.00,9005.55,0.21,1
46053,4687,1000.00,10005.55,11005.55,0.00,10005.55,0.24,1
46054,4687,1000.00,11005.55,12005.55,1397.76,9607.78,0.39,1
46055,4687,1000.00,12005.55,13005.55,3041.75,8963.80,0.38,1
46056,4687,-1000.00,11005.55,12005.55,9988.24,0.00,0.09,0
46057,4687,1000.00,12005.55,13005.55,0.00,12005.55,0.02,1
46058,4687,1000.00,13005.55,14005.55,1373.08,11632.46,0.42,1
46059,4687,1000.00,14005.55,15005.55,0.00,14005.55,0.26,1
46060,4687,1000.00,15005.55,16005.55,7041.60,7963.95,0.23,1
46061,4687,1000.00,16005.55,17005.55,0.00,8624.41,0.32,1
46062,4687,1000.00,17005.55,18005.55,0.00,17005.55,0.10,1
46063,4687,1000.00,18005.55,19005.55,0.00,7678.42,0.23,1
46064,4687,1000.00,19005.55,20005.55,3308.17,15697.38,0.17,1
46065,4687,1000.00,20005.55,21005.55,9526.65,10478.89,0.14,1
46066,4687,1000.00,21005.55,22005.55,9227.09,11778.46,0.15,1
46067,4687,1000.00,22005.55,23005.55,0.00,22005.55,0.33,1
46068,4687,1000.00,23005.55,24005.55,0.00,10392.07,0.25,1
46069,4687,1000.00,24005.55,25005.55,0.00,7182.93,0.21,1
46070,4687,1000.00,25005.55,26005.55,0.00,14075.01,0.33,1
46071,4687,1000.00,26005.55,27005.55,1029.28,13357.65,0.32,1
46072,4687,1000.00,27005.55,28005.55,0.00,27005.55,0.01,1
46073,4687,-1000.00,26005.55,27005.55,13170.03,6.28,0.08,0
46074,4687,-1000.00,25005.55,26005.55,25659.52,1346.03,0.01,0
46075,4687,1000.00,26005.55,27005.55,1936.03,24069.52,0.43,1
46076,4687,1000.00,27005.55,28005.55,4435.50,22570.05,0.42,1
46077,4687,1000.00,28005.55,29005.55,1821.13,26184.42,0.05,1
46078,4687,1000.00,29005.55,30005.55,14002.40,15003.15,0.11,1
46079,4687,1000.00,30005.55,31005.55,1350.89,28654.66,0.32,1
46080,4687,-1000.00,29005.55,30005.55,6748.57,24256.98,0.11,0
46081,4687,-1000.00,28005.55,29005.55,0.00,30005.55,0.13,0
46082,4687,-1000.00,27005.55,28005.55,10001.02,19004.53,0.09,0
46083,4687,-1000.00,26005.55,27005.55,14002.77,14002.77,0.16,0
46084,4687,-1000.00,25005.55,26005.55,11284.25,15721.30,0.27,0
46085,4687,-1000.00,24005.55,25005.55,0.00,18499.94,0.37,0
46086,4687,-1000.00,23005.55,24005.55,4566.83,20438.71,0.37,0
46087,4687,-1000.00,22005.55,23005.55,9000.25,15005.29,0.31,0
46088,4687,-1000.00,21005.55,22005.55,0.00,23005.55,0.04,0
46089,4687,-1000.00,20005.55,21005.55,0.00,14757.59,0.18,0
46090,4687,-1000.00,19005.55,20005.55,366.61,0.00,0.04,0
46091,4687,-1000.00,18005.55,19005.55,0.00,3365.76,0.12,0
46092,4687,0.00,18005.55,19005.55,0.00,0.00,0.02,0
46093,4687,-1000.00,17005.55,18005.55,9502.77,9502.77,0.01,0
46094,4687,-1000.00,16005.55,17005.55,2340.45,15665.10,0.01,0
46095,4687,-1000.00,15005.55,16005.55,8502.77,8502.77,0.26,0
46096,4687,-1000.00,14005.55,15005.55,0.00,3768.83,0.04,0
46097,4687,-1000.00,13005.55,14005.55,1219.08,6740.04,0.29,0
46098,4687,-1000.00,12005.55,13005.55,7876.61,6128.94,0.03,0
46099,4687,-1000.00,11005.55,12005.55,0.00,13005.55,0.06,0
46100,4687,-1000.00,10005.55,11005.55,0.00,12005.55,0.36,0
46101,4687,-1000.00,9005.55,10005.55,0.00,11005.55,0.05,0
46102,4687,-1000.00,8005.55,9005.55,4166.04,5839.51,0.04,0
46103,4687,-1000.00,7005.55,8005.55,0.00,5030.52,0.31,0
46104,4688,0.00,0.00,1000.00,0.00,0.00,0.08,0
46105,4688,1000.00,1000.00,2000.00,109.15,535.53,0.32,1
46106,4688,1000.00,2000.00,3000.00,906.10,1093.90,0.03,1
46107,4688,1000.00,3000.00,4000.00,0.00,3000.00,0.33,1
46108,4688,1000.00,4000.00,5000.00,992.39,2787.90,0.36,1
46109,4688,1000.00,5000.00,6000.00,0.00,2342.20,0.16,1
46110,4688,1000.00,6000.00,7000.00,2917.34,3082.66,0.13,1
46111,4688,1000.00,7000.00,8000.00,0.00,5809.53,0.31,1
46112,4688,-1000.00,6000.00,7000.00,4749.06,3250.94,0.09,0
46113,4688,1000.00,7000.00,8000.00,1664.57,5335.43,0.14,1
46114,4688,1000.00,8000.00,9000.00,0.00,1626.19,0.09,1
46115,4688,1000.00,9000.00,10000.00,2341.47,6658.53,0.37,1
46116,4688,1000.00,10000.00,11000.00,0.00,10000.00,0.05,1
46117,4688,1000.00,11000.00,12000.00,0.00,10199.60,0.43,1
46118,4688,0.00,11000.00,12000.00,0.00,0.00,0.01,0
46119,4688,-1000.00,10000.00,11000.00,6989.43,5010.57,0.20,0
46120,4688,1000.00,11000.00,12000.00,2023.76,8976.24,0.36,1
46121,4688,1000.00,12000.00,13000.00,0.00,12000.00,0.12,1
46122,4688,-1000.00,11000.00,12000.00,3775.29,888.75,0.12,0
46123,4688,1000.00,12000.00,13000.00,0.00,12000.00,0.16,1
46124,4688,-1000.00,11000.00,12000.00,4358.23,4236.79,0.20,0
46125,4688,1000.00,12000.00,13000.00,4594.47,7405.53,0.02,1
46126,4688,1000.00,13000.00,14000.00,1310.27,11689.73,0.43,1
46127,4688,1000.00,14000.00,15000.00,5316.78,8683.22,0.23,1
46128,4688,-1000.00,13000.00,14000.00,7500.00,7500.00,0.00,0
46129,4688,-1000.00,12000.00,13000.00,8521.24,2110.76,0.26,0
46130,4688,-1000.00,11000.00,12000.00,0.00,13000.00,0.08,0
46131,4688,0.00,11000.00,12000.00,0.00,0.00,0.25,0
46132,4688,-1000.00,10000.00,11000.00,0.00,988.67,0.43,0
46133,4688,-1000.00,9000.00,10000.00,9276.47,0.00,0.14,0
46134,4688,-761.99,8238.01,9238.01,761.99,0.00,0.35,0
46135,4688,0.00,8238.01,9238.01,0.00,0.00,0.16,0
46136,4688,-1000.00,7238.01,8238.01,4619.01,4619.01,0.12,0
46137,4688,-1000.00,6238.01,7238.01,0.00,8238.01,0.23,0
46138,4689,1000.00,1000.00,2000.00,216.37,0.00,0.19,1
46139,4689,1000.00,2000.00,3000.00,1327.46,0.00,0.14,1
46140,4689,-1000.00,1000.00,2000.00,0.00,2428.98,0.12,0
46141,4689,0.00,1000.00,2000.00,0.00,0.00,0.06,0
46142,4689,-1000.00,0.00,1000.00,0.00,2000.00,0.12,0
46143,4689,0.00,0.00,1000.00,0.00,0.00,0.08,0
46144,4689,-408.86,-408.86,591.14,0.00,408.86,0.12,0
46145,4689,0.00,-408.86,591.14,0.00,0.00,0.20,0
46146,4689,0.00,-408.86,591.14,0.00,0.00,0.23,0
46147,4689,-591.14,-1000.00,0.00,295.57,295.57,0.07,0
46148,4690,-1000.00,-1000.00,0.00,253.02,91.91,0.13,0
46149,4691,-1000.00,-1000.00,0.00,236.29,476.51,0.37,0
46150,4692,-1000.00,-1000.00,0.00,0.00,176.18,0.42,0
46151,4693,-1000.00,-1000.00,0.00,0.00,188.91,0.42,0
46152,4694,-1000.00,-1000.00,0.00,36.64,0.00,0.31,0
46153,4695,-1000.00,-1000.00,0.00,0.00,1000.00,0.19,0
46154,4696,-952.79,-952.79,47.21,0.00,952.79,0.31,0
46155,4696,-47.21,-1000.00,0.00,0.00,47.21,0.11,0
46156,4697,-1000.00,-1000.00,0.00,0.00,1000.00,0.34,0
46157,4698,-1000.00,-1000.00,0.00,355.93,644.07,0.19,0
46158,4699,1000.00,1000.00,2000.00,461.23,292.86,0.32,1
46159,4699,-347.39,652.61,1652.61,0.00,347.39,0.37,0
46160,4699,1000.00,1652.61,2652.61,35.59,0.00,0.38,1
46161,4699,-1000.00,652.61,1652.61,473.18,2179.43,0.30,0
46162,4699,-1000.00,-347.39,652.61,0.00,1641.36,0.19,0
46163,4699,-652.61,-1000.00,0.00,0.00,652.61,0.05,0
46164,4700,-1000.00,-1000.00,0.00,621.48,0.00,0.09,0
46165,4701,1000.00,1000.00,2000.00,0.00,1000.00,0.11,1
46166,4701,-1000.00,0.00,1000.00,1103.77,896.23,0.17,0
46167,4701,1000.00,1000.00,2000.00,0.00,1000.00,0.42,1
46168,4701,1000.00,2000.00,3000.00,0.00,2000.00,0.43,1
46169,4701,1000.00,3000.00,4000.00,197.52,840.73,0.21,1
46170,4701,-1000.00,2000.00,3000.00,2971.96,1028.04,0.22,0
46171,4701,1000.00,3000.00,4000.00,0.00,3000.00,0.16,1
46172,4701,-1000.00,2000.00,3000.00,2826.56,1173.44,0.06,0
46173,4701,1000.00,3000.00,4000.00,1309.84,1690.16,0.10,1
46174,4701,1000.00,4000.00,5000.00,105.54,185.92,0.12,1
46175,4701,-559.60,3440.40,4440.40,559.60,0.00,0.07,0
46176,4701,1000.00,4440.40,5440.40,0.00,3602.10,0.34,1
46177,4701,1000.00,5440.40,6440.40,0.00,5440.40,0.22,1
46178,4701,1000.00,6440.40,7440.40,0.00,6440.40,0.28,1
46179,4701,1000.00,7440.40,8440.40,218.47,7221.94,0.02,1
46180,4701,1000.00,8440.40,9440.40,4220.20,4220.20,0.04,1
46181,4701,1000.00,9440.40,10440.40,4720.20,4720.20,0.36,1
46182,4701,-1000.00,8440.40,9440.40,6119.57,4320.84,0.08,0
46183,4701,1000.00,9440.40,10440.40,1073.32,6698.87,0.39,1
46184,4701,1000.00,10440.40,11440.40,3018.18,7422.23,0.35,1
46185,4701,1000.00,11440.40,12440.40,3487.72,7952.69,0.35,1
46186,4701,1000.00,12440.40,13440.40,2498.83,9941.57,0.38,1
46187,4701,-1000.00,11440.40,12440.40,6720.20,6720.20,0.09,0
46188,4701,-1000.00,10440.40,11440.40,0.00,8296.51,0.08,0
46189,4701,-1000.00,9440.40,10440.40,5720.20,5720.20,0.03,0
46190,4701,-1000.00,8440.40,9440.40,0.00,10440.40,0.05,0
46191,4701,-1000.00,7440.40,8440.40,2619.82,6820.58,0.26,0
46192,4701,-1000.00,6440.40,7440.40,0.00,8440.40,0.30,0
46193,4701,-1000.00,5440.40,6440.40,1009.57,4162.96,0.34,0
46194,4701,-1000.00,4440.40,5440.40,3355.06,3085.35,0.26,0
46195,4701,-1000.00,3440.40,4440.40,0.00,3042.95,0.33,0
46196,4701,-1000.00,2440.40,3440.40,3727.20,713.20,0.05,0
46197,4701,-1000.00,1440.40,2440.40,0.00,2372.37,0.35,0
46198,4701,-1000.00,440.40,1440.40,207.37,0.00,0.10,0
46199,4701,-1000.00,-559.60,440.40,307.66,1132.74,0.40,0
46200,4701,-1000.00,-1559.60,-559.60,352.34,0.00,0.04,0
46201,4702,-1000.00,-1000.00,0.00,0.00,1000.00,0.40,0
46202,4703,-1000.00,-1000.00,0.00,402.87,597.13,0.20,0
46203,4704,0.00,0.00,1000.00,0.00,0.00,0.38,0
46204,4704,0.00,0.00,1000.00,0.00,0.00,0.30,0
46205,4704,-1000.00,-1000.00,0.00,462.15,537.85,0.21,0
46206,4705,-1000.00,-1000.00,0.00,271.35,728.65,0.15,0
46207,4706,-1000.00,-1000.00,0.00,352.51,647.49,0.31,0
46208,4707,-1000.00,-1000.00,0.00,717.20,282.80,0.09,0
46209,4708,-222.25,-222.25,777.75,222.25,0.00,0.35,0
46210,4708,0.00,-222.25,777.75,0.00,0.00,0.06,0
46211,4708,-390.61,-612.86,387.14,390.61,0.00,0.04,0
46212,4708,-1000.00,-1612.86,-612.86,0.00,387.14,0.30,0
46213,4709,-113.68,-113.68,886.32,113.68,0.00,0.37,0
46214,4709,0.00,-113.68,886.32,0.00,0.00,0.36,0
46215,4709,1000.00,886.32,1886.32,443.16,443.16,0.04,1
46216,4709,-1000.00,-113.68,886.32,1155.70,162.59,0.08,0
46217,4709,1000.00,886.32,1886.32,0.00,886.32,0.43,1
46218,4709,1000.00,1886.32,2886.32,0.00,1886.32,0.31,1
46219,4709,0.00,1886.32,2886.32,0.00,0.00,0.02,0
46220,4709,1000.00,2886.32,3886.32,566.90,2319.42,0.12,1
46221,4709,1000.00,3886.32,4886.32,0.00,3886.32,0.11,1
46222,4709,-1000.00,2886.32,3886.32,2851.35,2034.97,0.28,0
46223,4709,1000.00,3886.32,4886.32,343.61,3542.71,0.38,1
46224,4709,1000.00,4886.32,5886.32,261.26,3469.77,0.39,1
46225,4709,1000.00,5886.32,6886.32,2943.16,2943.16,0.05,1
46226,4709,1000.00,6886.32,7886.32,3037.32,3849.00,0.08,1
46227,4709,1000.00,7886.32,8886.32,1447.50,6438.83,0.23,1
46228,4709,1000.00,8886.32,9886.32,2703.73,6182.59,0.34,1
46229,4709,-1000.00,7886.32,8886.32,4187.24,0.00,0.02,0
46230,4709,1000.00,8886.32,9886.32,3212.75,5673.57,0.13,1
46231,4709,1000.00,9886.32,10886.32,0.00,9886.32,0.29,1
46232,4709,1000.00,10886.32,11886.32,0.00,7703.00,0.17,1
46233,4709,1000.00,11886.32,12886.32,0.00,11886.32,0.42,1
46234,4709,-1000.00,10886.32,11886.32,6443.16,6443.16,0.08,0
46235,4709,-1000.00,9886.32,10886.32,0.00,11886.32,0.33,0
46236,4709,-1000.00,8886.32,9886.32,0.00,10886.32,0.02,0
46237,4709,-1000.00,7886.32,8886.32,692.79,9193.54,0.05,0
46238,4709,-1000.00,6886.32,7886.32,0.00,7329.03,0.27,0
46239,4709,-1000.00,5886.32,6886.32,0.00,7886.32,0.27,0
46240,4709,-1000.00,4886.32,5886.32,0.00,2336.88,0.14,0
46241,4709,-1000.00,3886.32,4886.32,0.00,5886.32,0.20,0
46242,4709,-1000.00,2886.32,3886.32,0.00,4886.32,0.08,0
46243,4709,-1000.00,1886.32,2886.32,784.16,3102.17,0.05,0
46244,4709,-1000.00,886.32,1886.32,0.00,2735.14,0.25,0
46245,4709,-1000.00,-113.68,886.32,1150.11,736.21,0.02,0
46246,4709,-886.32,-1000.00,0.00,315.59,570.74,0.04,0
46247,4710,-778.18,-778.18,221.82,0.00,778.18,0.24,0
46248,4710,-221.82,-1000.00,0.00,73.67,148.15,0.31,0
46249,4711,-1000.00,-1000.00,0.00,850.90,0.00,0.01,0
46250,4712,1000.00,1000.00,2000.00,0.00,561.80,0.43,1
46251,4712,1000.00,2000.00,3000.00,0.00,2000.00,0.05,1
46252,4712,-1000.00,1000.00,2000.00,1947.57,1052.43,0.07,0
46253,4712,1000.00,2000.00,3000.00,635.72,1364.28,0.21,1
46254,4712,1000.00,3000.00,4000.00,0.00,3000.00,0.26,1
46255,4712,1000.00,4000.00,5000.00,0.00,2864.31,0.22,1
46256,4712,1000.00,5000.00,6000.00,0.00,5000.00,0.24,1
46257,4712,1000.00,6000.00,7000.00,1370.43,4629.57,0.13,1
46258,4712,1000.00,7000.00,8000.00,0.00,967.30,0.08,1
46259,4712,1000.00,8000.00,9000.00,3935.33,4064.67,0.20,1
46260,4712,-1000.00,7000.00,8000.00,4696.83,4303.17,0.08,0
46261,4712,0.00,7000.00,8000.00,0.00,0.00,0.10,0
46262,4712,1000.00,8000.00,9000.00,0.00,8000.00,0.02,1
46263,4712,-1000.00,7000.00,8000.00,9000.00,0.00,0.00,0
46264,4712,1000.00,8000.00,9000.00,0.00,7435.88,0.25,1
46265,4712,1000.00,9000.00,10000.00,4500.00,4500.00,0.17,1
46266,4712,1000.00,10000.00,11000.00,0.00,10000.00,0.32,1
46267,4712,1000.00,11000.00,12000.00,157.02,2702.70,0.20,1
46268,4712,1000.00,12000.00,13000.00,0.00,7630.99,0.07,1
46269,4712,1000.00,13000.00,14000.00,0.00,13000.00,0.33,1
46270,4712,1000.00,14000.00,15000.00,0.00,14000.00,0.22,1
46271,4712,-1000.00,13000.00,14000.00,8292.25,6707.75,0.12,0
46272,4712,-1000.00,12000.00,13000.00,10557.58,3442.42,0.08,0
46273,4712,1000.00,13000.00,14000.00,0.00,905.44,0.06,1
46274,4712,1000.00,14000.00,15000.00,3773.13,10226.87,0.25,1
46275,4712,-1000.00,13000.00,14000.00,4095.35,1969.23,0.14,0
46276,4712,1000.00,14000.00,15000.00,6050.97,7949.03,0.15,1
46277,4712,1000.00,15000.00,16000.00,5483.15,9516.85,0.31,1
46278,4712,1000.00,16000.00,17000.00,0.00,13594.73,0.43,1
46279,4712,1000.00,17000.00,18000.00,6910.90,10089.10,0.28,1
46280,4712,1000.00,18000.00,19000.00,5752.78,12247.22,0.34,1
46281,4712,1000.00,19000.00,20000.00,1932.35,17067.65,0.43,1
46282,4712,0.00,19000.00,20000.00,0.00,0.00,0.04,0
46283,4712,-1000.00,18000.00,19000.00,14223.86,1471.58,0.07,0
46284,4712,1000.00,19000.00,20000.00,0.00,19000.00,0.14,1
46285,4712,1000.00,20000.00,21000.00,0.00,4651.17,0.08,1
46286,4712,1000.00,21000.00,22000.00,0.00,21000.00,0.38,1
46287,4712,1000.00,22000.00,23000.00,0.00,22000.00,0.37,1
46288,4712,1000.00,23000.00,24000.00,8518.14,14481.86,0.30,1
46289,4712,1000.00,24000.00,25000.00,8240.86,15759.14,0.13,1
46290,4712,1000.00,25000.00,26000.00,11929.27,13070.73,0.25,1
46291,4713,-1000.00,-1000.00,0.00,274.25,725.75,0.13,0
46292,4714,-928.77,-928.77,71.23,26.05,902.71,0.44,0
46293,4714,-71.23,-1000.00,0.00,0.00,71.23,0.11,0
46294,4715,0.00,0.00,1000.00,0.00,0.00,0.43,0
46295,4715,-704.62,-704.62,295.38,0.00,704.62,0.05,0
46296,4715,-295.38,-1000.00,0.00,14.38,281.00,0.25,0
46297,4716,-1000.00,-1000.00,0.00,169.02,0.00,0.05,0
46298,4717,-631.82,-631.82,368.18,560.66,71.16,0.28,0
46299,4717,-1000.00,-1631.82,-631.82,0.00,368.18,0.04,0
46300,4718,-1000.00,-1000.00,0.00,0.00,1000.00,0.36,0
46301,4719,-1000.00,-1000.00,0.00,0.00,378.56,0.09,0
46302,4720,-1000.00,-1000.00,0.00,163.37,836.63,0.30,0
46303,4721,-1000.00,-1000.00,0.00,790.38,209.62,0.15,0
46304,4722,1000.00,1000.00,2000.00,0.00,474.61,0.19,1
46305,4722,0.00,1000.00,2000.00,0.00,0.00,0.04,0
46306,4722,1000.00,2000.00,3000.00,283.93,1468.38,0.39,1
46307,4722,1000.00,3000.00,4000.00,0.00,2338.74,0.09,1
46308,4722,1000.00,4000.00,5000.00,1842.93,2157.07,0.08,1
46309,4722,1000.00,5000.00,6000.00,0.00,5000.00,0.07,1
46310,4722,0.00,5000.00,6000.00,0.00,0.00,0.02,0
46311,4722,1000.00,6000.00,7000.00,0.00,6000.00,0.25,1
46312,4722,1000.00,7000.00,8000.00,2808.32,4191.68,0.02,1
46313,4722,1000.00,8000.00,9000.00,0.00,2803.95,0.11,1
46314,4722,1000.00,9000.00,10000.00,0.00,4828.94,0.31,1
46315,4722,1000.00,10000.00,11000.00,4345.01,5654.99,0.34,1
46316,4722,1000.00,11000.00,12000.00,3013.59,7986.41,0.37,1
46317,4722,-1000.00,10000.00,11000.00,5991.53,2086.32,0.12,0
46318,4722,1000.00,11000.00,12000.00,0.00,5694.18,0.03,1
46319,4722,1000.00,12000.00,13000.00,0.00,12000.00,0.16,1
46320,4722,-1000.00,11000.00,12000.00,4239.71,0.00,0.06,0
46321,4722,1000.00,12000.00,13000.00,650.06,6811.78,0.34,1
46322,4722,0.00,12000.00,13000.00,0.00,0.00,0.02,0
46323,4722,1000.00,13000.00,14000.00,3929.59,9070.41,0.27,1
46324,4722,1000.00,14000.00,15000.00,5108.58,8891.42,0.27,1
46325,4722,-1000.00,13000.00,14000.00,4798.14,1208.72,0.12,0
46326,4722,1000.00,14000.00,15000.00,4633.07,9366.93,0.27,1
46327,4722,1000.00,15000.00,16000.00,0.00,15000.00,0.41,1
46328,4722,1000.00,16000.00,17000.00,0.00,9436.33,0.03,1
46329,4722,1000.00,17000.00,18000.00,0.00,17000.00,0.17,1
46330,4722,1000.00,18000.00,19000.00,0.00,9076.75,0.25,1
46331,4722,1000.00,19000.00,20000.00,0.00,19000.00,0.11,1
46332,4722,1000.00,20000.00,21000.00,0.00,20000.00,0.20,1
46333,4722,1000.00,21000.00,22000.00,9869.73,11130.27,0.43,1
46334,4722,1000.00,22000.00,23000.00,8845.59,13154.41,0.22,1
46335,4722,1000.00,23000.00,24000.00,11104.62,11895.38,0.44,1
46336,4722,1000.00,24000.00,25000.00,0.00,24000.00,0.34,1
46337,4722,1000.00,25000.00,26000.00,5061.94,19938.06,0.18,1
46338,4722,1000.00,26000.00,27000.00,13000.00,13000.00,0.00,1
46339,4722,1000.00,27000.00,28000.00,885.21,26114.79,0.34,1
46340,4722,1000.00,28000.00,29000.00,0.00,22757.33,0.42,1
46341,4722,1000.00,29000.00,30000.00,0.00,24626.95,0.30,1
46342,4722,1000.00,30000.00,31000.00,7548.55,22451.45,0.38,1
46343,4722,1000.00,31000.00,32000.00,5721.43,25278.57,0.19,1
46344,4722,1000.00,32000.00,33000.00,11552.49,20447.51,0.11,1
46345,4723,0.00,0.00,1000.00,110.35,889.65,0.33,0
46346,4723,0.00,0.00,1000.00,0.00,519.99,0.44,0
46347,4723,0.00,0.00,1000.00,0.00,136.07,0.14,0
46348,4723,0.00,0.00,1000.00,401.34,598.66,0.01,0
46349,4723,0.00,0.00,1000.00,0.00,834.76,0.41,0
46350,4723,0.00,0.00,1000.00,83.33,916.67,0.01,0
46351,4723,0.00,0.00,1000.00,395.15,604.85,0.28,0
46352,4723,0.00,0.00,1000.00,0.00,823.56,0.31,0
46353,4723,0.00,0.00,1000.00,0.00,270.54,0.09,0
46354,4723,0.00,0.00,1000.00,155.05,844.95,0.41,0
46355,4723,0.00,0.00,1000.00,0.00,1000.00,0.40,0
46356,4723,0.00,0.00,1000.00,0.00,1000.00,0.39,0
46357,4723,-662.21,-662.21,337.79,614.50,47.71,0.07,0
46358,4723,0.00,-662.21,337.79,0.00,324.66,0.34,0
46359,4723,0.00,-662.21,337.79,0.00,258.72,0.10,0
46360,4723,0.00,-662.21,337.79,0.00,199.19,0.35,0
46361,4723,-337.79,-1000.00,0.00,183.51,154.28,0.23,0
46362,4724,-773.57,-773.57,226.43,358.00,415.56,0.33,0
46363,4724,-226.43,-1000.00,0.00,113.22,113.22,0.03,0
46364,4725,-1000.00,-1000.00,0.00,0.00,457.00,0.32,0
46365,4726,-1000.00,-1000.00,0.00,527.08,472.92,0.18,0
46366,4726,0.00,-1000.00,0.00,0.00,0.00,0.35,1
46367,4726,0.00,-1000.00,0.00,0.00,0.00,0.04,1
46368,4726,0.00,-1000.00,0.00,0.00,0.00,0.24,1
46369,4726,0.00,-1000.00,0.00,0.00,0.00,0.27,1
46370,4726,0.00,-1000.00,0.00,0.00,0.00,0.41,1
46371,4726,0.00,-1000.00,0.00,0.00,0.00,0.00,0
46372,4726,0.10,-999.90,0.10,0.00,0.00,0.38,1
46373,4726,16.33,-983.57,16.43,0.00,0.10,0.14,1
46374,4726,1000.00,16.43,1016.43,2.00,14.42,0.43,1
46375,4726,1000.00,1016.43,2016.43,0.00,1016.43,0.33,1
46376,4726,1000.00,2016.43,3016.43,0.00,2016.43,0.18,1
46377,4726,1000.00,3016.43,4016.43,191.40,809.38,0.21,1
46378,4726,1000.00,4016.43,5016.43,1671.74,2344.68,0.22,1
46379,4726,1000.00,5016.43,6016.43,0.00,5016.43,0.09,1
46380,4726,1000.00,6016.43,7016.43,0.00,5304.76,0.27,1
46381,4726,1000.00,7016.43,8016.43,0.00,7016.43,0.22,1
46382,4726,1000.00,8016.43,9016.43,0.00,1438.89,0.10,1
46383,4726,1000.00,9016.43,10016.43,1860.80,4797.30,0.31,1
46384,4726,1000.00,10016.43,11016.43,0.00,10016.43,0.03,1
46385,4726,1000.00,11016.43,12016.43,2648.80,8367.63,0.19,1
46386,4726,-676.53,10339.90,11339.90,505.47,171.06,0.11,0
46387,4726,1000.00,11339.90,12339.90,1864.30,6621.16,0.33,1
46388,4726,1000.00,12339.90,13339.90,0.00,536.13,0.12,1
46389,4726,1000.00,13339.90,14339.90,6408.40,6931.50,0.21,1
46390,4726,1000.00,14339.90,15339.90,0.00,11480.91,0.42,1
46391,4726,1000.00,15339.90,16339.90,0.00,15339.90,0.03,1
46392,4726,1000.00,16339.90,17339.90,0.00,16339.90,0.28,1
46393,4726,1000.00,17339.90,18339.90,848.92,7858.22,0.29,1
46394,4726,1000.00,18339.90,19339.90,0.00,18339.90,0.35,1
46395,4726,1000.00,19339.90,20339.90,1356.27,16311.37,0.42,1
46396,4726,1000.00,20339.90,21339.90,5341.04,14998.86,0.34,1
46397,4726,1000.00,21339.90,22339.90,0.00,21339.90,0.17,1
46398,4726,1000.00,22339.90,23339.90,10009.30,12330.60,0.25,1
46399,4726,1000.00,23339.90,24339.90,4302.16,19037.74,0.22,1
46400,4726,1000.00,24339.90,25339.90,0.00,24339.90,0.23,1
46401,4726,1000.00,25339.90,26339.90,5806.49,19533.41,0.31,1
46402,4726,1000.00,26339.90,27339.90,7583.91,8243.62,0.20,1
46403,4726,-1000.00,25339.90,26339.90,18754.76,8585.14,0.10,0
46404,4726,-1000.00,24339.90,25339.90,26339.90,0.00,0.07,0
46405,4726,1000.00,25339.90,26339.90,0.00,19795.05,0.27,1
46406,4726,1000.00,26339.90,27339.90,6104.11,20235.79,0.31,1
46407,4726,-1000.00,25339.90,26339.90,5844.55,0.00,0.08,0
46408,4726,-1000.00,24339.90,25339.90,9376.55,0.00,0.08,0
46409,4726,1000.00,25339.90,26339.90,0.00,25339.90,0.32,1
46410,4726,-1000.00,24339.90,25339.90,12019.56,6790.38,0.21,0
46411,4726,1000.00,25339.90,26339.90,0.00,25339.90,0.29,1
46412,4726,-1000.00,24339.90,25339.90,11450.21,0.00,0.05,0
46413,4726,-1000.00,23339.90,24339.90,11567.47,13772.42,0.14,0
46414,4726,-1000.00,22339.90,23339.90,6054.97,15515.85,0.34,0
46415,4726,-1000.00,21339.90,22339.90,3516.84,19823.05,0.35,0
46416,4726,0.00,21339.90,22339.90,0.00,0.00,0.01,0
46417,4726,-1000.00,20339.90,21339.90,0.00,1080.57,0.09,0
46418,4726,-1000.00,19339.90,20339.90,0.00,3725.84,0.14,0
46419,4726,-1000.00,18339.90,19339.90,304.97,20034.93,0.36,0
46420,4726,-1000.00,17339.90,18339.90,4634.41,3265.17,0.16,0
46421,4726,-1000.00,16339.90,17339.90,1791.03,16548.87,0.42,0
46422,4726,-1000.00,15339.90,16339.90,0.00,15948.31,0.35,0
46423,4726,-1000.00,14339.90,15339.90,2926.03,12984.62,0.40,0
46424,4726,-1000.00,13339.90,14339.90,2592.08,12747.82,0.40,0
46425,4726,-1000.00,12339.90,13339.90,6793.16,0.00,0.07,0
46426,4726,-1000.00,11339.90,12339.90,6669.95,6669.95,0.06,0
46427,4726,-1000.00,10339.90,11339.90,4769.62,7570.28,0.23,0
46428,4726,-1000.00,9339.90,10339.90,4586.15,6753.75,0.26,0
46429,4726,-1000.00,8339.90,9339.90,5454.81,4885.09,0.17,0
46430,4726,-1000.00,7339.90,8339.90,2152.39,7187.51,0.39,0
46431,4726,-1000.00,6339.90,7339.90,3222.87,5117.03,0.25,0
46432,4727,-1000.00,-1000.00,0.00,77.86,922.14,0.44,0
46433,4728,-889.46,-889.46,110.54,0.00,889.46,0.33,0
46434,4728,-107.57,-997.03,2.97,8.99,98.59,0.43,0
46435,4728,-2.97,-1000.00,0.00,0.00,2.97,0.02,0
46436,4729,1000.00,1000.00,2000.00,0.00,503.65,0.11,1
46437,4729,1000.00,2000.00,3000.00,0.00,2000.00,0.10,1
46438,4729,1000.00,3000.00,4000.00,634.32,2365.68,0.18,1
46439,4729,1000.00,4000.00,5000.00,0.00,3803.06,0.26,1
46440,4729,1000.00,5000.00,6000.00,0.00,5000.00,0.11,1
46441,4729,-729.88,4270.12,5270.12,686.14,43.74,0.11,0
46442,4729,1000.00,5270.12,6270.12,0.00,2936.45,0.07,1
46443,4729,1000.00,6270.12,7270.12,2161.59,3518.57,0.29,1
46444,4729,1000.00,7270.12,8270.12,3086.09,4184.04,0.23,1
46445,4729,1000.00,8270.12,9270.12,0.00,3759.14,0.11,1
46446,4729,1000.00,9270.12,10270.12,0.00,3660.53,0.24,1
46447,4729,1000.00,10270.12,11270.12,0.00,10270.12,0.39,1
46448,4729,-1000.00,9270.12,10270.12,9501.23,1768.90,0.08,0
46449,4729,1000.00,10270.12,11270.12,4171.37,6098.75,0.16,1
46450,4729,1000.00,11270.12,12270.12,0.00,8795.89,0.31,1
46451,4729,1000.00,12270.12,13270.12,5695.59,6574.53,0.08,1
46452,4729,1000.00,13270.12,14270.12,0.00,9182.74,0.24,1
46453,4729,1000.00,14270.12,15270.12,0.00,7193.91,0.30,1
46454,4729,1000.00,15270.12,16270.12,0.00,10486.59,0.11,1
46455,4729,1000.00,16270.12,17270.12,0.00,16270.12,0.18,1
46456,4729,-1000.00,15270.12,16270.12,11575.65,5694.48,0.27,0
46457,4729,0.00,15270.12,16270.12,0.00,0.00,0.01,0
46458,4729,1000.00,16270.12,17270.12,0.00,16270.12,0.42,1
46459,4729,1000.00,17270.12,18270.12,0.00,1511.45,0.02,1
46460,4729,-1000.00,16270.12,17270.12,8506.22,9763.91,0.03,0
46461,4729,-1000.00,15270.12,16270.12,0.00,11526.98,0.32,0
46462,4729,-1000.00,14270.12,15270.12,0.00,13747.73,0.43,0
46463,4729,-1000.00,13270.12,14270.12,0.00,8719.24,0.34,0
46464,4729,-1000.00,12270.12,13270.12,0.00,4930.29,0.13,0
46465,4729,-1000.00,11270.12,12270.12,8386.86,4883.27,0.10,0
46466,4729,-1000.00,10270.12,11270.12,0.00,3573.63,0.04,0
46467,4729,-1000.00,9270.12,10270.12,6049.86,5220.27,0.14,0
46468,4729,-1000.00,8270.12,9270.12,0.00,10270.12,0.34,0
46469,4729,-1000.00,7270.12,8270.12,0.00,9270.12,0.18,0
46470,4729,-1000.00,6270.12,7270.12,0.00,8270.12,0.14,0
46471,4729,-1000.00,5270.12,6270.12,2299.76,1234.99,0.15,0
46472,4729,-1000.00,4270.12,5270.12,252.59,6017.54,0.40,0
46473,4729,-1000.00,3270.12,4270.12,4297.14,0.00,0.04,0
46474,4729,-1000.00,2270.12,3270.12,0.00,2827.72,0.33,0
46475,4729,-1000.00,1270.12,2270.12,395.39,2874.73,0.35,0
46476,4729,-1000.00,270.12,1270.12,0.00,1338.92,0.19,0
46477,4729,-1000.00,-729.88,270.12,541.19,728.94,0.27,0
46478,4729,-128.77,-858.64,141.36,44.56,84.20,0.22,0
46479,4729,-141.36,-1000.00,0.00,16.21,125.15,0.40,0
46480,4730,1000.00,1000.00,2000.00,0.00,863.79,0.29,1
46481,4730,1000.00,2000.00,3000.00,940.41,1059.59,0.04,1
46482,4730,-1000.00,1000.00,2000.00,1948.25,0.00,0.05,0
46483,4730,1000.00,2000.00,3000.00,649.61,1350.39,0.30,1
46484,4730,1000.00,3000.00,4000.00,0.00,3000.00,0.00,1
46485,4730,1000.00,4000.00,5000.00,0.00,4000.00,0.02,1
46486,4730,1000.00,5000.00,6000.00,0.00,1833.22,0.25,1
46487,4730,1000.00,6000.00,7000.00,908.17,5091.83,0.16,1
46488,4730,1000.00,7000.00,8000.00,0.00,7000.00,0.22,1
46489,4730,1000.00,8000.00,9000.00,0.00,5194.78,0.22,1
46490,4730,-1000.00,7000.00,8000.00,4244.68,0.00,0.08,0
46491,4730,1000.00,8000.00,9000.00,0.00,8000.00,0.11,1
46492,4730,1000.00,9000.00,10000.00,1723.43,6754.68,0.39,1
46493,4730,-1000.00,8000.00,9000.00,3552.47,0.00,0.13,0
46494,4730,1000.00,9000.00,10000.00,0.00,9000.00,0.09,1
46495,4730,1000.00,10000.00,11000.00,805.91,8032.08,0.42,1
46496,4730,1000.00,11000.00,12000.00,5098.75,5901.25,0.09,1
46497,4730,1000.00,12000.00,13000.00,0.00,10633.24,0.24,1
46498,4730,1000.00,13000.00,14000.00,0.00,13000.00,0.41,1
46499,4730,1000.00,14000.00,15000.00,0.00,14000.00,0.12,1
46500,4730,1000.00,15000.00,16000.00,0.00,15000.00,0.39,1
46501,4730,1000.00,16000.00,17000.00,7298.76,8701.24,0.01,1
46502,4730,1000.00,17000.00,18000.00,2177.49,13951.05,0.41,1
46503,4730,1000.00,18000.00,19000.00,5672.01,12327.99,0.32,1
46504,4730,1000.00,19000.00,20000.00,0.00,19000.00,0.36,1
46505,4730,1000.00,20000.00,21000.00,4292.61,15707.39,0.25,1
46506,4730,1000.00,21000.00,22000.00,0.00,15443.20,0.15,1
46507,4730,1000.00,22000.00,23000.00,0.00,22000.00,0.16,1
46508,4730,1000.00,23000.00,24000.00,0.00,16203.94,0.30,1
46509,4730,1000.00,24000.00,25000.00,459.16,21826.85,0.44,1
46510,4730,1000.00,25000.00,26000.00,0.00,25000.00,0.36,1
46511,4730,1000.00,26000.00,27000.00,0.00,13281.79,0.28,1
46512,4730,1000.00,27000.00,28000.00,0.00,27000.00,0.09,1
46513,4730,1000.00,28000.00,29000.00,4750.21,23249.79,0.19,1
46514,4730,1000.00,29000.00,30000.00,13762.45,15237.55,0.20,1
46515,4730,1000.00,30000.00,31000.00,11749.77,18250.23,0.25,1
46516,4730,1000.00,31000.00,32000.00,0.00,31000.00,0.01,1
46517,4730,1000.00,32000.00,33000.00,3087.58,28912.42,0.28,1
46518,4730,-1000.00,31000.00,32000.00,12445.24,131.94,0.09,0
46519,4730,1000.00,32000.00,33000.00,0.00,32000.00,0.23,1
46520,4730,1000.00,33000.00,34000.00,16500.00,16500.00,0.08,1
46521,4730,1000.00,34000.00,35000.00,0.00,34000.00,0.21,1
46522,4730,1000.00,35000.00,36000.00,0.00,13480.51,0.19,1
46523,4730,1000.00,36000.00,37000.00,0.00,36000.00,0.12,1
46524,4730,1000.00,37000.00,38000.00,0.00,37000.00,0.09,1
46525,4730,1000.00,38000.00,39000.00,0.00,7252.73,0.04,1
46526,4730,1000.00,39000.00,40000.00,0.00,3837.34,0.04,1
46527,4730,-1000.00,38000.00,39000.00,21789.19,18210.81,0.38,0
46528,4730,-1000.00,37000.00,38000.00,0.00,16649.17,0.07,0
46529,4730,-1000.00,36000.00,37000.00,21774.96,15066.17,0.26,0
46530,4730,-1000.00,35000.00,36000.00,25707.25,11292.75,0.09,0
46531,4730,-1000.00,34000.00,35000.00,11699.89,24300.11,0.35,0
46532,4730,0.00,34000.00,35000.00,0.00,0.00,0.06,0
46533,4730,-1000.00,33000.00,34000.00,0.00,16386.33,0.24,0
46534,4730,-1000.00,32000.00,33000.00,10021.76,23978.24,0.29,0
46535,4730,-1000.00,31000.00,32000.00,0.00,27115.72,0.39,0
46536,4730,-1000.00,30000.00,31000.00,6124.96,25875.04,0.41,0
46537,4730,-1000.00,29000.00,30000.00,6403.58,24596.42,0.39,0
46538,4730,-1000.00,28000.00,29000.00,1162.01,28837.99,0.30,0
46539,4730,-1000.00,27000.00,28000.00,0.00,16617.20,0.31,0
46540,4730,-1000.00,26000.00,27000.00,0.00,28000.00,0.10,0
46541,4730,-1000.00,25000.00,26000.00,0.00,27000.00,0.16,0
46542,4730,-1000.00,24000.00,25000.00,0.00,24374.67,0.33,0
46543,4730,-1000.00,23000.00,24000.00,0.00,25000.00,0.30,0
46544,4730,-1000.00,22000.00,23000.00,0.00,24000.00,0.32,0
46545,4730,-1000.00,21000.00,22000.00,0.00,23000.00,0.04,0
46546,4730,-1000.00,20000.00,21000.00,0.00,8152.90,0.20,0
46547,4730,-1000.00,19000.00,20000.00,8002.03,12997.97,0.21,0
46548,4730,-1000.00,18000.00,19000.00,0.00,20000.00,0.01,0
46549,4730,-1000.00,17000.00,18000.00,9432.39,9567.61,0.31,0
46550,4730,-1000.00,16000.00,17000.00,6111.94,11888.06,0.25,0
46551,4730,-1000.00,15000.00,16000.00,2139.97,14860.03,0.36,0
46552,4730,-1000.00,14000.00,15000.00,4208.25,11791.75,0.05,0
46553,4730,-1000.00,13000.00,14000.00,0.00,10581.35,0.37,0
46554,4730,-1000.00,12000.00,13000.00,0.00,11689.81,0.41,0
46555,4730,-1000.00,11000.00,12000.00,0.00,9690.76,0.35,0
46556,4730,-1000.00,10000.00,11000.00,0.00,1261.13,0.10,0
46557,4730,-1000.00,9000.00,10000.00,4719.76,6280.24,0.26,0
46558,4730,-1000.00,8000.00,9000.00,0.00,8300.05,0.40,0
46559,4730,-1000.00,7000.00,8000.00,4127.43,4872.57,0.08,0
46560,4730,-1000.00,6000.00,7000.00,0.00,8000.00,0.33,0
46561,4730,-1000.00,5000.00,6000.00,0.00,5109.06,0.32,0
46562,4730,-1000.00,4000.00,5000.00,0.00,6000.00,0.37,0
46563,4730,-1000.00,3000.00,4000.00,0.00,5000.00,0.04,0
46564,4730,0.00,3000.00,4000.00,0.00,0.00,0.00,0
46565,4730,-1000.00,2000.00,3000.00,0.00,4000.00,0.24,0
46566,4730,-1000.00,1000.00,2000.00,0.00,1289.46,0.28,0
46567,4730,-1000.00,0.00,1000.00,252.78,1593.48,0.41,0
46568,4730,-1000.00,-1000.00,0.00,736.17,0.00,0.10,0
46569,4731,-507.21,-507.21,492.79,0.00,507.21,0.20,0
46570,4731,-1000.00,-1507.21,-507.21,343.15,143.90,0.11,0
46571,4732,-1000.00,-1000.00,0.00,483.69,516.31,0.21,0
46572,4733,1000.00,1000.00,2000.00,1000.00,0.00,0.03,1
46573,4733,1000.00,2000.00,3000.00,222.68,0.00,0.29,1
46574,4733,1000.00,3000.00,4000.00,673.16,0.00,0.38,1
46575,4733,-1000.00,2000.00,3000.00,0.00,4000.00,0.01,0
46576,4733,-1000.00,1000.00,2000.00,0.00,3000.00,0.20,0
46577,4733,0.00,1000.00,2000.00,0.00,0.00,0.20,0
46578,4733,-1000.00,0.00,1000.00,855.55,1144.45,0.29,0
46579,4733,-1000.00,-1000.00,0.00,0.00,1000.00,0.13,0
46580,4734,-318.87,-318.87,681.13,88.42,230.45,0.41,0
46581,4734,0.00,-318.87,681.13,0.00,0.00,0.09,0
46582,4734,-1000.00,-1318.87,-318.87,508.10,40.31,0.20,0
46583,4735,-1000.00,-1000.00,0.00,624.65,375.35,0.12,0
46584,4736,-1000.00,-1000.00,0.00,0.00,54.46,0.10,0
46585,4737,-1000.00,-1000.00,0.00,0.00,243.78,0.36,0
46586,4738,-1000.00,-1000.00,0.00,0.00,1000.00,0.05,0
46587,4739,-1000.00,-1000.00,0.00,0.00,1000.00,0.41,0
46588,4740,-870.21,-870.21,129.79,0.00,870.21,0.16,0
46589,4740,-1000.00,-1870.21,-870.21,39.87,0.00,0.12,0
46590,4741,1000.00,1000.00,2000.00,0.00,1000.00,0.01,1
46591,4741,1000.00,2000.00,3000.00,0.00,1007.63,0.30,1
46592,4741,1000.00,3000.00,4000.00,0.00,3000.00,0.25,1
46593,4741,-1000.00,2000.00,3000.00,2174.78,1825.22,0.24,0
46594,4741,1000.00,3000.00,4000.00,0.00,2140.93,0.38,1
46595,4741,1000.00,4000.00,5000.00,1381.12,2618.88,0.32,1
46596,4741,1000.00,5000.00,6000.00,0.00,3629.04,0.28,1
46597,4741,1000.00,6000.00,7000.00,1204.93,4795.07,0.12,1
46598,4741,1000.00,7000.00,8000.00,0.00,7000.00,0.24,1
46599,4741,1000.00,8000.00,9000.00,4000.00,4000.00,0.13,1
46600,4741,1000.00,9000.00,10000.00,0.00,1307.53,0.16,1
46601,4741,1000.00,10000.00,11000.00,0.00,6813.84,0.38,1
46602,4741,1000.00,11000.00,12000.00,0.00,8442.05,0.17,1
46603,4741,1000.00,12000.00,13000.00,4455.65,7544.35,0.16,1
46604,4741,1000.00,13000.00,14000.00,0.00,28.80,0.05,1
46605,4741,1000.00,14000.00,15000.00,0.00,10130.57,0.31,1
46606,4741,1000.00,15000.00,16000.00,7435.12,7564.88,0.22,1
46607,4741,1000.00,16000.00,17000.00,5124.22,10875.78,0.34,1
46608,4741,1000.00,17000.00,18000.00,2179.72,14820.28,0.17,1
46609,4741,1000.00,18000.00,19000.00,0.00,4989.90,0.15,1
46610,4741,1000.00,19000.00,20000.00,0.00,17983.94,0.41,1
46611,4741,-1000.00,18000.00,19000.00,11659.98,8340.02,0.03,0
46612,4741,-1000.00,17000.00,18000.00,0.00,3691.69,0.17,0
46613,4741,-1000.00,16000.00,17000.00,0.00,18000.00,0.33,0
46614,4741,-1000.00,15000.00,16000.00,0.00,8714.14,0.31,0
46615,4741,-1000.00,14000.00,15000.00,0.00,13714.22,0.29,0
46616,4741,-1000.00,13000.00,14000.00,0.00,15000.00,0.12,0
46617,4741,-1000.00,12000.00,13000.00,317.02,0.00,0.06,0
46618,4741,-1000.00,11000.00,12000.00,0.00,13000.00,0.33,0
46619,4741,-1000.00,10000.00,11000.00,0.00,7897.52,0.05,0
46620,4741,-1000.00,9000.00,10000.00,0.00,4564.27,0.25,0
46621,4741,-1000.00,8000.00,9000.00,0.00,10000.00,0.17,0
46622,4741,-1000.00,7000.00,8000.00,4911.63,4088.37,0.13,0
46623,4741,-1000.00,6000.00,7000.00,0.00,8000.00,0.41,0
46624,4741,-1000.00,5000.00,6000.00,0.00,7000.00,0.43,0
46625,4741,-1000.00,4000.00,5000.00,0.00,4794.85,0.40,0
46626,4741,-1000.00,3000.00,4000.00,2679.79,2320.21,0.18,0
46627,4741,1000.00,4000.00,5000.00,1366.53,2633.47,0.33,1
46628,4741,1000.00,5000.00,6000.00,1206.49,3793.51,0.28,1
46629,4741,-1000.00,4000.00,5000.00,6000.00,0.00,0.05,0
46630,4741,1000.00,5000.00,6000.00,689.65,3187.51,0.36,1
46631,4741,1000.00,6000.00,7000.00,0.00,6000.00,0.23,1
46632,4741,1000.00,7000.00,8000.00,1697.40,5302.60,0.39,1
46633,4741,1000.00,8000.00,9000.00,1103.27,6896.73,0.43,1
46634,4741,1000.00,9000.00,10000.00,2747.62,6252.38,0.19,1
46635,4741,1000.00,10000.00,11000.00,3580.28,6419.72,0.29,1
46636,4741,1000.00,11000.00,12000.00,0.00,9875.19,0.33,1
46637,4741,1000.00,12000.00,13000.00,0.00,10320.85,0.43,1
46638,4741,1000.00,13000.00,14000.00,0.00,9892.91,0.41,1
46639,4741,1000.00,14000.00,15000.00,7000.00,7000.00,0.01,1
46640,4741,1000.00,15000.00,16000.00,0.00,15000.00,0.36,1
46641,4741,1000.00,16000.00,17000.00,7706.00,8294.00,0.21,1
46642,4741,1000.00,17000.00,18000.00,0.00,17000.00,0.17,1
46643,4742,0.00,0.00,1000.00,0.00,0.00,0.04,0
46644,4742,-721.29,-721.29,278.71,608.01,113.29,0.26,0
46645,4742,-1000.00,-1721.29,-721.29,130.68,148.03,0.23,0
46646,4743,0.00,0.00,1000.00,0.00,0.00,0.32,0
46647,4743,0.00,0.00,1000.00,0.00,0.00,0.26,0
46648,4743,-1000.00,-1000.00,0.00,0.00,209.68,0.42,0
46649,4744,1000.00,1000.00,2000.00,8.41,753.78,0.42,1
46650,4744,-1000.00,0.00,1000.00,1154.82,845.18,0.03,0
46651,4744,1000.00,1000.00,2000.00,432.56,567.44,0.20,1
46652,4744,1000.00,2000.00,3000.00,1000.00,1000.00,0.08,1
46653,4744,-1000.00,1000.00,2000.00,1084.19,736.79,0.17,0
46654,4744,-1000.00,0.00,1000.00,1093.64,0.00,0.03,0
46655,4744,1000.00,1000.00,2000.00,63.42,936.58,0.17,1
46656,4744,1000.00,2000.00,3000.00,533.90,1466.10,0.36,1
46657,4744,1000.00,3000.00,4000.00,0.00,3000.00,0.39,1
46658,4744,1000.00,4000.00,5000.00,0.00,3009.90,0.22,1
46659,4744,1000.00,5000.00,6000.00,2466.12,2533.88,0.16,1
46660,4744,1000.00,6000.00,7000.00,1884.17,4115.83,0.35,1
46661,4744,-1000.00,5000.00,6000.00,4442.83,2557.17,0.09,0
46662,4744,1000.00,6000.00,7000.00,1555.49,1736.91,0.20,1
46663,4744,-1000.00,5000.00,6000.00,1989.16,43.91,0.10,0
46664,4744,1000.00,6000.00,7000.00,0.00,2068.96,0.04,1
46665,4744,-1000.00,5000.00,6000.00,6021.11,978.89,0.14,0
46666,4744,1000.00,6000.00,7000.00,0.00,3929.44,0.34,1
46667,4744,1000.00,7000.00,8000.00,0.00,2387.91,0.18,1
46668,4744,1000.00,8000.00,9000.00,2528.42,5471.58,0.00,1
46669,4744,-1000.00,7000.00,8000.00,6032.71,2967.29,0.12,0
46670,4744,1000.00,8000.00,9000.00,3239.72,4760.28,0.12,1
46671,4744,0.00,8000.00,9000.00,0.00,0.00,0.01,0
46672,4744,1000.00,9000.00,10000.00,0.00,3586.86,0.19,1
46673,4744,1000.00,10000.00,11000.00,1039.84,8960.16,0.40,1
46674,4744,-1000.00,9000.00,10000.00,8739.49,0.00,0.08,0
46675,4744,1000.00,10000.00,11000.00,0.00,10000.00,0.21,1
46676,4744,1000.00,11000.00,12000.00,0.00,11000.00,0.21,1
46677,4744,1000.00,12000.00,13000.00,0.00,12000.00,0.19,1
46678,4744,1000.00,13000.00,14000.00,0.00,13000.00,0.04,1
46679,4744,1000.00,14000.00,15000.00,1395.94,12604.06,0.15,1
46680,4744,-1000.00,13000.00,14000.00,8337.80,6441.03,0.18,0
46681,4744,-1000.00,12000.00,13000.00,12618.26,1381.74,0.03,0
46682,4744,-1000.00,11000.00,12000.00,4504.76,0.00,0.01,0
46683,4744,1000.00,12000.00,13000.00,3219.83,6505.88,0.30,1
46684,4744,1000.00,13000.00,14000.00,0.00,13000.00,0.10,1
46685,4744,1000.00,14000.00,15000.00,4022.19,9977.81,0.22,1
46686,4744,1000.00,15000.00,16000.00,0.00,15000.00,0.17,1
46687,4744,1000.00,16000.00,17000.00,0.00,16000.00,0.44,1
46688,4744,-1000.00,15000.00,16000.00,12352.40,4647.60,0.08,0
46689,4744,1000.00,16000.00,17000.00,0.00,16000.00,0.39,1
46690,4744,1000.00,17000.00,18000.00,2552.12,14447.88,0.02,1
46691,4744,1000.00,18000.00,19000.00,0.00,15724.89,0.31,1
46692,4744,1000.00,19000.00,20000.00,9500.00,9500.00,0.01,1
46693,4744,1000.00,20000.00,21000.00,0.00,9811.11,0.12,1
46694,4744,-1000.00,19000.00,20000.00,11586.48,9413.52,0.07,0
46695,4744,1000.00,20000.00,21000.00,0.00,20000.00,0.36,1
46696,4744,-1000.00,19000.00,20000.00,5651.04,0.00,0.03,0
46697,4744,-1000.00,18000.00,19000.00,7002.09,12997.91,0.28,0
46698,4744,-1000.00,17000.00,18000.00,0.00,19000.00,0.24,0
46699,4744,-1000.00,16000.00,17000.00,0.00,18000.00,0.05,0
46700,4744,-1000.00,15000.00,16000.00,0.00,17000.00,0.41,0
46701,4744,-1000.00,14000.00,15000.00,0.00,16000.00,0.22,0
46702,4744,-1000.00,13000.00,14000.00,0.00,12967.76,0.18,0
46703,4744,-1000.00,12000.00,13000.00,7290.88,6709.12,0.13,0
46704,4744,-1000.00,11000.00,12000.00,0.00,13000.00,0.43,0
46705,4744,-1000.00,10000.00,11000.00,6051.79,5948.21,0.09,0
46706,4744,-1000.00,9000.00,10000.00,4357.01,6642.99,0.24,0
46707,4744,-1000.00,8000.00,9000.00,0.00,10000.00,0.05,0
46708,4744,-1000.00,7000.00,8000.00,0.00,9000.00,0.05,0
46709,4744,-1000.00,6000.00,7000.00,0.00,7995.14,0.05,0
46710,4744,-1000.00,5000.00,6000.00,1210.55,5789.45,0.34,0
46711,4744,-1000.00,4000.00,5000.00,0.00,2899.83,0.31,0
46712,4744,-1000.00,3000.00,4000.00,0.00,5000.00,0.06,0
46713,4744,-1000.00,2000.00,3000.00,1674.44,2325.56,0.27,0
46714,4744,-1000.00,1000.00,2000.00,0.00,3000.00,0.44,0
46715,4744,-1000.00,0.00,1000.00,357.87,1642.13,0.04,0
46716,4744,-1000.00,-1000.00,0.00,729.71,270.29,0.04,0
46717,4745,0.00,0.00,1000.00,0.00,0.00,0.04,0
46718,4745,-1000.00,-1000.00,0.00,831.70,168.30,0.00,0
46719,4746,-405.76,-405.76,594.24,0.00,405.76,0.18,0
46720,4746,-594.24,-1000.00,0.00,281.97,312.27,0.14,0
46721,4747,-1000.00,-1000.00,0.00,0.00,1000.00,0.37,0
46722,4748,-1000.00,-1000.00,0.00,0.00,1000.00,0.20,0
46723,4749,-679.75,-679.75,320.25,0.00,679.75,0.14,0
46724,4749,-320.25,-1000.00,0.00,147.00,173.26,0.03,0
46725,4750,-1000.00,-1000.00,0.00,387.67,612.33,0.05,0
46726,4751,0.00,0.00,1000.00,0.00,0.00,0.15,0
46727,4751,-1000.00,-1000.00,0.00,973.33,0.00,0.08,0
46728,4752,-906.83,-906.83,93.17,906.83,0.00,0.05,0
46729,4752,-92.37,-999.21,0.79,92.37,0.00,0.11,0
46730,4752,0.00,-999.21,0.79,0.00,0.00,0.11,0
46731,4752,0.00,-999.21,0.79,0.00,0.00,0.03,0
46732,4752,-0.10,-999.31,0.69,0.07,0.03,0.21,0
46733,4752,-0.05,-999.36,0.64,0.05,0.00,0.39,0
46734,4752,0.00,-999.36,0.64,0.00,0.00,0.08,0
46735,4752,-0.51,-999.87,0.13,0.51,0.00,0.18,0
46736,4752,-0.04,-999.91,0.09,0.04,0.00,0.32,0
46737,4752,-25.29,-1025.20,-25.20,0.01,0.05,0.29,0
46738,4753,-833.69,-833.69,166.31,0.00,833.69,0.21,0
46739,4753,-166.31,-1000.00,0.00,80.57,85.74,0.13,0
46740,4754,1000.00,1000.00,2000.00,0.00,1000.00,0.11,1
46741,4754,-1000.00,0.00,1000.00,1124.20,875.80,0.02,0
46742,4754,1000.00,1000.00,2000.00,264.55,548.50,0.30,1
46743,4754,1000.00,2000.00,3000.00,676.29,1323.71,0.31,1
46744,4754,-1000.00,1000.00,2000.00,1515.96,0.00,0.09,0
46745,4754,-1000.00,0.00,1000.00,1218.35,781.65,0.11,0
46746,4754,1000.00,1000.00,2000.00,430.10,569.90,0.20,1
46747,4754,1000.00,2000.00,3000.00,0.00,1805.37,0.30,1
46748,4754,1000.00,3000.00,4000.00,165.76,1161.00,0.26,1
46749,4754,1000.00,4000.00,5000.00,1396.47,1674.98,0.23,1
46750,4754,1000.00,5000.00,6000.00,1287.38,3100.63,0.33,1
46751,4754,1000.00,6000.00,7000.00,0.00,6000.00,0.01,1
46752,4754,1000.00,7000.00,8000.00,0.00,3475.93,0.31,1
46753,4754,1000.00,8000.00,9000.00,3214.37,4785.63,0.29,1
46754,4754,1000.00,9000.00,10000.00,2382.54,6617.46,0.27,1
46755,4754,-1000.00,8000.00,9000.00,2898.24,0.00,0.07,0
46756,4754,1000.00,9000.00,10000.00,0.00,7078.95,0.38,1
46757,4754,1000.00,10000.00,11000.00,4712.21,5287.79,0.01,1
46758,4754,1000.00,11000.00,12000.00,951.79,10048.21,0.43,1
46759,4754,1000.00,12000.00,13000.00,6000.00,6000.00,0.29,1
46760,4754,-1000.00,11000.00,12000.00,3635.06,3484.81,0.19,0
46761,4754,-1000.00,10000.00,11000.00,3700.44,74.70,0.06,0
46762,4754,1000.00,11000.00,12000.00,0.00,11000.00,0.40,1
46763,4754,1000.00,12000.00,13000.00,3616.81,8383.19,0.34,1
46764,4754,1000.00,13000.00,14000.00,0.00,5706.13,0.11,1
46765,4754,-1000.00,12000.00,13000.00,7437.54,6562.46,0.18,0
46766,4754,1000.00,13000.00,14000.00,0.00,685.69,0.12,1
46767,4754,1000.00,14000.00,15000.00,6955.63,7044.37,0.21,1
46768,4754,1000.00,15000.00,16000.00,0.00,15000.00,0.10,1
46769,4754,0.00,15000.00,16000.00,0.00,0.00,0.02,0
46770,4754,1000.00,16000.00,17000.00,5103.35,10896.65,0.32,1
46771,4754,1000.00,17000.00,18000.00,806.61,5110.49,0.22,1
46772,4754,0.00,17000.00,18000.00,0.00,0.00,0.03,0
46773,4754,1000.00,18000.00,19000.00,0.00,17188.52,0.15,1
46774,4754,1000.00,19000.00,20000.00,307.48,12321.93,0.37,1
46775,4754,1000.00,20000.00,21000.00,8717.75,11282.25,0.18,1
46776,4754,1000.00,21000.00,22000.00,0.00,21000.00,0.08,1
46777,4754,1000.00,22000.00,23000.00,9611.16,12388.84,0.11,1
46778,4754,1000.00,23000.00,24000.00,0.00,7074.06,0.22,1
46779,4754,-1000.00,22000.00,23000.00,16613.55,7386.45,0.10,0
46780,4754,1000.00,23000.00,24000.00,8445.94,14554.06,0.28,1
46781,4754,1000.00,24000.00,25000.00,3668.49,20331.51,0.42,1
46782,4754,-1000.00,23000.00,24000.00,14712.75,4889.32,0.11,0
46783,4755,-721.85,-721.85,278.15,0.00,721.85,0.28,0
46784,4755,-149.75,-871.59,128.41,2.09,147.66,0.33,0
46785,4755,-117.51,-989.10,10.90,0.00,117.51,0.35,0
46786,4755,-10.90,-1000.00,0.00,0.00,10.90,0.36,0
46787,4756,1000.00,1000.00,2000.00,0.00,429.16,0.17,1
46788,4756,1000.00,2000.00,3000.00,0.00,2000.00,0.05,1
46789,4756,1000.00,3000.00,4000.00,0.00,2337.99,0.31,1
46790,4756,1000.00,4000.00,5000.00,0.00,4000.00,0.07,1
46791,4756,1000.00,5000.00,6000.00,0.00,1149.10,0.01,1
46792,4756,1000.00,6000.00,7000.00,0.00,3594.11,0.33,1
46793,4756,1000.00,7000.00,8000.00,1774.87,5225.13,0.38,1
46794,4756,1000.00,8000.00,9000.00,1017.07,5653.68,0.38,1
46795,4756,-1000.00,7000.00,8000.00,5448.64,3551.36,0.28,0
46796,4756,-1000.00,6000.00,7000.00,4217.45,3782.55,0.17,0
46797,4756,-1000.00,5000.00,6000.00,2447.81,1449.64,0.16,0
46798,4756,1000.00,6000.00,7000.00,0.00,3978.01,0.17,1
46799,4756,1000.00,7000.00,8000.00,526.89,2190.04,0.07,1
46800,4756,1000.00,8000.00,9000.00,0.00,8000.00,0.35,1
46801,4756,1000.00,9000.00,10000.00,1884.58,7115.42,0.40,1
46802,4756,1000.00,10000.00,11000.00,0.00,3933.22,0.24,1
46803,4756,1000.00,11000.00,12000.00,3306.81,7693.19,0.34,1
46804,4756,1000.00,12000.00,13000.00,0.00,12000.00,0.31,1
46805,4756,-1000.00,11000.00,12000.00,11027.57,1972.43,0.17,0
46806,4756,1000.00,12000.00,13000.00,5910.38,6089.62,0.10,1
46807,4756,1000.00,13000.00,14000.00,0.00,13000.00,0.08,1
46808,4756,1000.00,14000.00,15000.00,0.00,14000.00,0.00,1
46809,4756,1000.00,15000.00,16000.00,6593.71,8406.29,0.39,1
46810,4756,1000.00,16000.00,17000.00,5918.36,10081.64,0.27,1
46811,4756,-1000.00,15000.00,16000.00,10419.19,0.00,0.05,0
46812,4756,1000.00,16000.00,17000.00,0.00,10555.64,0.38,1
46813,4756,1000.00,17000.00,18000.00,0.00,15812.80,0.38,1
46814,4756,1000.00,18000.00,19000.00,0.00,18000.00,0.43,1
46815,4756,1000.00,19000.00,20000.00,8044.13,8381.64,0.22,1
46816,4756,1000.00,20000.00,21000.00,3832.67,16167.33,0.23,1
46817,4756,-1000.00,19000.00,20000.00,12094.60,8905.40,0.37,0
46818,4756,1000.00,20000.00,21000.00,0.00,20000.00,0.09,1
46819,4757,1000.00,1000.00,2000.00,477.56,504.33,0.23,1
46820,4757,1000.00,2000.00,3000.00,0.00,2000.00,0.02,1
46821,4757,1000.00,3000.00,4000.00,0.00,2823.61,0.33,1
46822,4757,-1000.00,2000.00,3000.00,1448.05,1219.89,0.19,0
46823,4757,1000.00,3000.00,4000.00,0.00,3000.00,0.25,1
46824,4757,1000.00,4000.00,5000.00,0.00,3518.17,0.33,1
46825,4757,1000.00,5000.00,6000.00,0.00,3499.18,0.39,1
46826,4757,1000.00,6000.00,7000.00,2069.52,3930.48,0.22,1
46827,4757,1000.00,7000.00,8000.00,0.00,7000.00,0.20,1
46828,4757,-1000.00,6000.00,7000.00,4189.19,3810.81,0.05,0
46829,4757,1000.00,7000.00,8000.00,2413.30,4586.70,0.20,1
46830,4757,1000.00,8000.00,9000.00,0.00,8000.00,0.15,1
46831,4757,1000.00,9000.00,10000.00,652.07,5482.86,0.36,1
46832,4757,-1000.00,8000.00,9000.00,5999.28,4000.72,0.03,0
46833,4757,1000.00,9000.00,10000.00,2988.85,6011.15,0.04,1
46834,4757,1000.00,10000.00,11000.00,5000.00,5000.00,0.11,1
46835,4757,1000.00,11000.00,12000.00,0.00,7031.56,0.36,1
46836,4757,1000.00,12000.00,13000.00,0.00,12000.00,0.41,1
46837,4757,-1000.00,11000.00,12000.00,7713.41,5286.59,0.16,0
46838,4757,1000.00,12000.00,13000.00,5117.11,6882.89,0.13,1
46839,4757,1000.00,13000.00,14000.00,0.00,9473.70,0.38,1
46840,4757,0.00,13000.00,14000.00,0.00,0.00,0.07,0
46841,4757,-1000.00,12000.00,13000.00,5155.10,8844.90,0.11,0
46842,4757,-1000.00,11000.00,12000.00,0.00,12052.72,0.36,0
46843,4757,-1000.00,10000.00,11000.00,0.00,12000.00,0.01,0
46844,4757,-1000.00,9000.00,10000.00,0.00,9235.44,0.42,0
46845,4757,-1000.00,8000.00,9000.00,0.00,10000.00,0.37,0
46846,4757,-1000.00,7000.00,8000.00,0.00,9000.00,0.43,0
46847,4757,-1000.00,6000.00,7000.00,3369.95,4630.05,0.11,0
46848,4757,-1000.00,5000.00,6000.00,2630.31,4369.69,0.27,0
46849,4757,-1000.00,4000.00,5000.00,437.32,5562.68,0.11,0
46850,4757,-1000.00,3000.00,4000.00,1365.96,3634.04,0.37,0
46851,4757,-1000.00,2000.00,3000.00,0.00,4000.00,0.27,0
46852,4757,-1000.00,1000.00,2000.00,235.22,2344.53,0.41,0
46853,4757,-1000.00,0.00,1000.00,0.00,1884.19,0.31,0
46854,4757,-381.86,-381.86,618.14,0.00,381.86,0.22,0
46855,4757,-581.89,-963.75,36.25,47.50,534.39,0.43,0
46856,4757,-28.81,-992.56,7.44,0.00,28.81,0.30,0
46857,4757,-7.44,-1000.00,0.00,0.00,7.44,0.42,0
46858,4757,-0.00,-1000.00,0.00,0.00,0.00,0.27,0
46859,4757,-0.00,-1000.00,0.00,0.00,0.00,0.37,0
46860,4757,-0.00,-1000.00,0.00,0.00,0.00,0.42,0
46861,4758,1000.00,1000.00,2000.00,0.00,1000.00,0.40,1
46862,4758,1000.00,2000.00,3000.00,461.74,1538.26,0.25,1
46863,4758,1000.00,3000.00,4000.00,1368.78,1631.22,0.24,1
46864,4758,1000.00,4000.00,5000.00,0.00,1494.70,0.25,1
46865,4758,1000.00,5000.00,6000.00,0.00,5000.00,0.04,1
46866,4758,1000.00,6000.00,7000.00,899.25,5100.75,0.39,1
46867,4758,1000.00,7000.00,8000.00,0.00,476.16,0.12,1
46868,4758,1000.00,8000.00,9000.00,0.00,8000.00,0.29,1
46869,4758,1000.00,9000.00,10000.00,0.00,7890.92,0.10,1
46870,4758,1000.00,10000.00,11000.00,4884.73,5115.27,0.11,1
46871,4758,-1000.00,9000.00,10000.00,5554.78,5445.22,0.12,0
46872,4758,1000.00,10000.00,11000.00,5000.00,5000.00,0.07,1
46873,4758,1000.00,11000.00,12000.00,401.38,10598.62,0.36,1
46874,4758,1000.00,12000.00,13000.00,0.00,8583.68,0.38,1
46875,4758,-1000.00,11000.00,12000.00,2190.79,0.00,0.08,0
46876,4758,-1000.00,10000.00,11000.00,9497.50,2502.50,0.01,0
46877,4758,1000.00,11000.00,12000.00,1220.72,4294.88,0.26,1
46878,4758,1000.00,12000.00,13000.00,2047.40,9952.60,0.31,1
46879,4758,1000.00,13000.00,14000.00,3706.02,7687.76,0.31,1
46880,4758,-1000.00,12000.00,13000.00,0.00,11123.44,0.36,0
46881,4758,-1000.00,11000.00,12000.00,8520.90,1606.10,0.08,0
46882,4758,-1000.00,10000.00,11000.00,6000.00,6000.00,0.04,0
46883,4758,-1000.00,9000.00,10000.00,0.00,11000.00,0.19,0
46884,4758,-1000.00,8000.00,9000.00,4149.31,5850.69,0.28,0
46885,4758,-1000.00,7000.00,8000.00,0.00,6087.86,0.33,0
46886,4758,-1000.00,6000.00,7000.00,0.00,8000.00,0.12,0
46887,4758,-1000.00,5000.00,6000.00,0.00,5703.50,0.28,0
46888,4758,-1000.00,4000.00,5000.00,0.00,6000.00,0.37,0
46889,4758,-1000.00,3000.00,4000.00,0.00,3517.08,0.21,0
46890,4758,-1000.00,2000.00,3000.00,504.87,3495.13,0.43,0
46891,4758,-1000.00,1000.00,2000.00,0.00,2367.51,0.39,0
46892,4758,-1000.00,0.00,1000.00,0.00,2000.00,0.13,0
46893,4758,-1000.00,-1000.00,0.00,534.46,465.54,0.20,0
46894,4759,-1000.00,-1000.00,0.00,0.00,1000.00,0.33,0
46895,4760,-1000.00,-1000.00,0.00,428.97,358.31,0.34,0
46896,4761,-999.64,-999.64,0.36,0.00,999.64,0.33,0
46897,4761,-0.36,-1000.00,0.00,0.00,0.36,0.04,0
46898,4762,-253.39,-253.39,746.61,187.46,65.93,0.42,0
46899,4762,0.00,-253.39,746.61,0.00,0.00,0.04,0
46900,4762,1000.00,746.61,1746.61,186.36,560.25,0.34,1
46901,4762,1000.00,1746.61,2746.61,0.00,1552.73,0.23,1
46902,4762,1000.00,2746.61,3746.61,0.00,714.28,0.20,1
46903,4762,1000.00,3746.61,4746.61,0.00,763.12,0.20,1
46904,4762,1000.00,4746.61,5746.61,1060.78,3685.83,0.39,1
46905,4762,1000.00,5746.61,6746.61,0.00,5746.61,0.28,1
46906,4762,1000.00,6746.61,7746.61,0.00,6746.61,0.09,1
46907,4762,1000.00,7746.61,8746.61,0.00,3278.00,0.26,1
46908,4762,-1000.00,6746.61,7746.61,6424.12,2322.49,0.00,0
46909,4762,1000.00,7746.61,8746.61,3050.26,4696.35,0.29,1
46910,4762,-34.25,7712.36,8712.36,34.25,0.00,0.06,0
46911,4762,1000.00,8712.36,9712.36,2760.65,5951.70,0.17,1
46912,4762,1000.00,9712.36,10712.36,4856.18,4856.18,0.20,1
46913,4762,-1000.00,8712.36,9712.36,6614.83,4097.53,0.01,0
46914,4762,1000.00,9712.36,10712.36,0.00,6889.81,0.39,1
46915,4762,1000.00,10712.36,11712.36,2771.71,7940.64,0.31,1
46916,4762,1000.00,11712.36,12712.36,0.00,4785.66,0.26,1
46917,4762,-1000.00,10712.36,11712.36,11771.54,0.00,0.00,0
46918,4762,1000.00,11712.36,12712.36,4457.08,7255.27,0.12,1
46919,4762,1000.00,12712.36,13712.36,5549.32,7163.04,0.26,1
46920,4762,1000.00,13712.36,14712.36,4115.48,9008.50,0.33,1
46921,4762,1000.00,14712.36,15712.36,7356.18,7356.18,0.10,1
46922,4762,-1000.00,13712.36,14712.36,10458.02,5254.34,0.29,0
46923,4762,-1000.00,12712.36,13712.36,0.00,2291.46,0.27,0
46924,4762,-1000.00,11712.36,12712.36,0.00,13712.36,0.32,0
46925,4762,-1000.00,10712.36,11712.36,8423.52,4288.84,0.08,0
46926,4762,-1000.00,9712.36,10712.36,2.90,6534.45,0.34,0
46927,4762,-1000.00,8712.36,9712.36,0.00,10712.36,0.07,0
46928,4762,-1000.00,7712.36,8712.36,0.00,9712.36,0.27,0
46929,4762,-1000.00,6712.36,7712.36,5894.28,0.00,0.03,0
46930,4762,-1000.00,5712.36,6712.36,0.00,6019.92,0.39,0
46931,4762,-1000.00,4712.36,5712.36,3547.73,0.00,0.04,0
46932,4762,-1000.00,3712.36,4712.36,1349.28,4363.08,0.28,0
46933,4762,-1000.00,2712.36,3712.36,0.00,2150.11,0.26,0
46934,4762,-1000.00,1712.36,2712.36,1076.26,2636.10,0.36,0
46935,4762,-1000.00,712.36,1712.36,919.61,1792.74,0.35,0
46936,4762,0.00,712.36,1712.36,0.00,0.00,0.38,0
46937,4762,-1000.00,-287.64,712.36,0.00,1286.07,0.33,0
46938,4762,-8.83,-296.47,703.53,0.00,8.83,0.10,0
46939,4762,0.00,-296.47,703.53,0.00,0.00,0.35,0
46940,4762,0.00,-296.47,703.53,0.00,0.00,0.10,0
46941,4763,-735.28,-735.28,264.72,0.00,735.28,0.37,0
46942,4763,-264.72,-1000.00,0.00,0.00,264.72,0.42,0
46943,4764,-1000.00,-1000.00,0.00,283.34,716.66,0.36,0
46944,4765,-145.41,-145.41,854.59,0.00,145.41,0.06,0
46945,4765,-276.19,-421.61,578.39,0.00,276.19,0.11,0
46946,4765,-578.39,-1000.00,0.00,267.11,311.28,0.16,0
46947,4766,-1000.00,-1000.00,0.00,0.00,1000.00,0.04,0
46948,4767,-854.08,-854.08,145.92,579.36,274.72,0.13,0
46949,4767,1000.00,145.92,1145.92,5.60,140.33,0.38,1
46950,4767,1000.00,1145.92,2145.92,0.00,1145.92,0.00,1
46951,4767,1000.00,2145.92,3145.92,0.00,1769.53,0.41,1
46952,4767,1000.00,3145.92,4145.92,0.00,3145.92,0.27,1
46953,4767,1000.00,4145.92,5145.92,0.00,4145.92,0.30,1
46954,4767,1000.00,5145.92,6145.92,0.00,5145.92,0.10,1
46955,4767,1000.00,6145.92,7145.92,382.39,2845.37,0.29,1
46956,4767,1000.00,7145.92,8145.92,1927.11,5218.81,0.11,1
46957,4767,1000.00,8145.92,9145.92,4072.96,4072.96,0.11,1
46958,4767,1000.00,9145.92,10145.92,0.00,9145.92,0.22,1
46959,4767,1000.00,10145.92,11145.92,1556.32,8589.61,0.30,1
46960,4767,1000.00,11145.92,12145.92,0.00,11145.92,0.00,1
46961,4767,1000.00,12145.92,13145.92,2773.30,9106.08,0.38,1
46962,4767,1000.00,13145.92,14145.92,4803.55,7599.83,0.29,1
46963,4767,1000.00,14145.92,15145.92,7072.96,7072.96,0.29,1
46964,4767,1000.00,15145.92,16145.92,2143.09,13002.83,0.15,1
46965,4767,-1000.00,14145.92,15145.92,14432.16,1713.77,0.14,0
46966,4767,1000.00,15145.92,16145.92,0.00,14440.30,0.44,1
46967,4767,-1000.00,14145.92,15145.92,13587.35,2558.57,0.14,0
46968,4767,0.00,14145.92,15145.92,0.00,0.00,0.03,0
46969,4767,1000.00,15145.92,16145.92,0.00,15145.92,0.35,1
46970,4767,1000.00,16145.92,17145.92,0.00,16145.92,0.15,1
46971,4767,1000.00,17145.92,18145.92,6385.88,10760.04,0.01,1
46972,4767,1000.00,18145.92,19145.92,0.00,6302.28,0.14,1
46973,4767,-1000.00,17145.92,18145.92,10381.29,8764.64,0.13,0
46974,4767,-1000.00,16145.92,17145.92,10657.06,7488.87,0.17,0
46975,4767,1000.00,17145.92,18145.92,7581.35,9564.57,0.13,1
46976,4767,1000.00,18145.92,19145.92,0.00,18145.92,0.38,1
46977,4767,1000.00,19145.92,20145.92,1547.12,17598.81,0.44,1
46978,4767,1000.00,20145.92,21145.92,3152.09,16993.83,0.41,1
46979,4767,1000.00,21145.92,22145.92,0.00,17902.71,0.22,1
46980,4767,1000.00,22145.92,23145.92,681.39,2998.31,0.43,1
46981,4767,-1000.00,21145.92,22145.92,12704.50,5368.58,0.28,0
46982,4767,1000.00,22145.92,23145.92,0.00,13518.54,0.08,1
46983,4767,1000.00,23145.92,24145.92,0.00,16460.26,0.27,1
46984,4767,1000.00,24145.92,25145.92,0.00,24145.92,0.00,1
46985,4767,1000.00,25145.92,26145.92,5818.70,19327.23,0.14,1
46986,4767,1000.00,26145.92,27145.92,0.00,24478.09,0.44,1
46987,4768,0.00,0.00,1000.00,0.00,0.00,0.42,0
46988,4768,-1000.00,-1000.00,0.00,0.00,174.53,0.42,0
46989,4769,-1000.00,-1000.00,0.00,131.79,868.21,0.33,0
46990,4770,1000.00,1000.00,2000.00,102.97,897.03,0.21,1
46991,4770,1000.00,2000.00,3000.00,0.00,2000.00,0.18,1
46992,4770,1000.00,3000.00,4000.00,0.00,3000.00,0.32,1
46993,4770,1000.00,4000.00,5000.00,0.00,4000.00,0.17,1
46994,4770,1000.00,5000.00,6000.00,139.38,4860.62,0.10,1
46995,4770,-1000.00,4000.00,5000.00,3564.39,2435.61,0.10,0
46996,4770,1000.00,5000.00,6000.00,1751.96,3248.04,0.32,1
46997,4770,1000.00,6000.00,7000.00,219.61,4182.00,0.39,1
46998,4770,1000.00,7000.00,8000.00,0.00,7000.00,0.31,1
46999,4770,1000.00,8000.00,9000.00,0.00,6244.27,0.18,1
47000,4770,1000.00,9000.00,10000.00,4.37,8995.63,0.39,1
47001,4770,1000.00,10000.00,11000.00,2016.61,7983.39,0.31,1
47002,4770,1000.00,11000.00,12000.00,5377.06,5622.94,0.09,1
47003,4770,-1000.00,10000.00,11000.00,7379.75,4580.74,0.15,0
47004,4770,1000.00,11000.00,12000.00,4445.74,6554.26,0.16,1
47005,4770,-1000.00,10000.00,11000.00,2280.33,0.00,0.04,0
47006,4770,1000.00,11000.00,12000.00,0.00,9534.84,0.43,1
47007,4770,-1000.00,10000.00,11000.00,6771.99,5228.01,0.17,0
47008,4770,1000.00,11000.00,12000.00,5500.00,5500.00,0.02,1
47009,4770,1000.00,12000.00,13000.00,2637.94,9362.06,0.38,1
47010,4770,1000.00,13000.00,14000.00,5751.42,7248.58,0.26,1
47011,4770,1000.00,14000.00,15000.00,0.00,14000.00,0.41,1
47012,4770,1000.00,15000.00,16000.00,7474.66,7525.34,0.40,1
47013,4770,1000.00,16000.00,17000.00,0.00,16000.00,0.17,1
47014,4770,1000.00,17000.00,18000.00,0.00,10364.71,0.33,1
47015,4770,1000.00,18000.00,19000.00,6428.96,11571.04,0.28,1
47016,4770,1000.00,19000.00,20000.00,0.00,6687.39,0.11,1
47017,4770,0.00,19000.00,20000.00,0.00,0.00,0.01,0
47018,4770,1000.00,20000.00,21000.00,0.00,20000.00,0.38,1
47019,4770,1000.00,21000.00,22000.00,8334.88,12665.12,0.41,1
47020,4770,1000.00,22000.00,23000.00,0.00,13754.21,0.35,1
47021,4770,-1000.00,21000.00,22000.00,12052.71,10947.29,0.37,0
47022,4770,1000.00,22000.00,23000.00,0.00,22000.00,0.39,1
47023,4770,1000.00,23000.00,24000.00,5937.62,17062.38,0.38,1
47024,4770,-1000.00,22000.00,23000.00,6940.84,2599.96,0.13,0
47025,4770,1000.00,23000.00,24000.00,0.00,23000.00,0.06,1
47026,4770,-1000.00,22000.00,23000.00,21545.25,0.00,0.03,0
47027,4770,-1000.00,21000.00,22000.00,13103.33,9896.67,0.12,0
47028,4770,-1000.00,20000.00,21000.00,6821.15,3273.51,0.14,0
47029,4770,-1000.00,19000.00,20000.00,11274.84,9725.16,0.11,0
47030,4770,-1000.00,18000.00,19000.00,6388.12,604.81,0.10,0
47031,4770,1000.00,19000.00,20000.00,2163.54,11787.70,0.36,1
47032,4770,1000.00,20000.00,21000.00,6606.33,13393.67,0.29,1
47033,4770,-1000.00,19000.00,20000.00,14201.64,4379.32,0.10,0
47034,4770,1000.00,20000.00,21000.00,0.00,20000.00,0.16,1
47035,4770,1000.00,21000.00,22000.00,9901.76,11098.24,0.23,1
47036,4771,-1000.00,-1000.00,0.00,165.67,0.00,0.08,0
47037,4772,-1000.00,-1000.00,0.00,101.61,898.39,0.41,0
47038,4773,-1000.00,-1000.00,0.00,45.12,445.31,0.33,0
47039,4774,-1000.00,-1000.00,0.00,0.00,1000.00,0.25,0
47040,4775,-1000.00,-1000.00,0.00,305.33,228.08,0.17,0
47041,4776,0.00,0.00,1000.00,0.00,0.00,0.02,0
47042,4776,1000.00,1000.00,2000.00,209.09,790.91,0.33,1
47043,4776,1000.00,2000.00,3000.00,0.00,2000.00,0.20,1
47044,4776,1000.00,3000.00,4000.00,827.40,2172.60,0.22,1
47045,4776,1000.00,4000.00,5000.00,1134.90,2865.10,0.36,1
47046,4776,1000.00,5000.00,6000.00,0.00,2313.86,0.18,1
47047,4776,1000.00,6000.00,7000.00,0.00,6000.00,0.05,1
47048,4776,1000.00,7000.00,8000.00,2143.87,2875.07,0.24,1
47049,4776,1000.00,8000.00,9000.00,489.50,1319.55,0.17,1
47050,4776,1000.00,9000.00,10000.00,0.00,9000.00,0.28,1
47051,4776,1000.00,10000.00,11000.00,0.00,10000.00,0.01,1
47052,4776,1000.00,11000.00,12000.00,1035.44,9964.56,0.31,1
47053,4776,1000.00,12000.00,13000.00,4109.22,7890.78,0.29,1
47054,4776,1000.00,13000.00,14000.00,0.00,13000.00,0.03,1
47055,4776,1000.00,14000.00,15000.00,5247.21,8752.79,0.20,1
47056,4776,1000.00,15000.00,16000.00,0.00,13701.97,0.18,1
47057,4776,1000.00,16000.00,17000.00,0.00,14229.93,0.04,1
47058,4776,1000.00,17000.00,18000.00,0.00,17000.00,0.14,1
47059,4776,-1000.00,16000.00,17000.00,3532.59,145.64,0.11,0
47060,4776,1000.00,17000.00,18000.00,0.00,17000.00,0.38,1
47061,4776,1000.00,18000.00,19000.00,325.90,16839.36,0.44,1
47062,4776,1000.00,19000.00,20000.00,0.00,10274.54,0.25,1
47063,4776,-1000.00,18000.00,19000.00,10000.00,10000.00,0.14,0
47064,4776,-1000.00,17000.00,18000.00,0.00,6105.56,0.11,0
47065,4776,-1000.00,16000.00,17000.00,9000.00,9000.00,0.01,0
47066,4776,-1000.00,15000.00,16000.00,2674.46,14325.54,0.31,0
47067,4776,-1000.00,14000.00,15000.00,0.00,16000.00,0.15,0
47068,4776,-1000.00,13000.00,14000.00,0.00,15000.00,0.32,0
47069,4776,-1000.00,12000.00,13000.00,0.00,14000.00,0.26,0
47070,4776,-1000.00,11000.00,12000.00,5916.49,7083.51,0.17,0
47071,4776,-1000.00,10000.00,11000.00,2528.34,9471.66,0.39,0
47072,4776,-1000.00,9000.00,10000.00,0.00,11000.00,0.34,0
47073,4776,-1000.00,8000.00,9000.00,3020.74,6979.26,0.35,0
47074,4776,-1000.00,7000.00,8000.00,6205.90,1731.30,0.09,0
47075,4776,-1000.00,6000.00,7000.00,2099.31,5766.10,0.36,0
47076,4776,-1000.00,5000.00,6000.00,0.00,7000.00,0.13,0
47077,4776,-1000.00,4000.00,5000.00,2434.44,3565.56,0.22,0
47078,4776,-1000.00,3000.00,4000.00,2500.00,2500.00,0.10,0
47079,4776,-1000.00,2000.00,3000.00,0.00,4000.00,0.10,0
47080,4776,-1000.00,1000.00,2000.00,1712.90,1287.10,0.04,0
47081,4776,0.00,1000.00,2000.00,0.00,0.00,0.01,0
47082,4776,-1000.00,0.00,1000.00,0.00,2000.00,0.26,0
47083,4776,-531.48,-531.48,468.52,0.00,531.48,0.33,0
47084,4776,-468.52,-1000.00,0.00,0.00,468.52,0.39,0
47085,4777,-1000.00,-1000.00,0.00,322.78,677.22,0.31,0
47086,4778,-1000.00,-1000.00,0.00,815.34,184.66,0.06,0
47087,4779,-1000.00,-1000.00,0.00,0.00,1000.00,0.02,0
47088,4780,-1000.00,-1000.00,0.00,384.23,615.77,0.23,0
47089,4781,0.00,0.00,1000.00,0.00,0.00,0.01,0
47090,4781,-1000.00,-1000.00,0.00,0.00,475.29,0.26,0
47091,4782,0.00,0.00,1000.00,0.00,0.00,0.15,0
47092,4782,1000.00,1000.00,2000.00,549.79,450.21,0.15,1
47093,4782,-1000.00,0.00,1000.00,1000.00,1000.00,0.26,0
47094,4782,1000.00,1000.00,2000.00,64.41,10.93,0.11,1
47095,4782,-1000.00,0.00,1000.00,925.35,1074.65,0.22,0
47096,4782,1000.00,1000.00,2000.00,684.64,315.36,0.29,1
47097,4782,-1000.00,0.00,1000.00,699.11,1300.89,0.12,0
47098,4782,-1000.00,-1000.00,0.00,0.86,999.14,0.23,0
47099,4783,-545.61,-545.61,454.39,0.00,545.61,0.31,0
47100,4783,-454.39,-1000.00,0.00,126.90,327.49,0.32,0
47101,4784,0.00,0.00,1000.00,0.00,0.00,0.17,0
47102,4784,0.00,0.00,1000.00,0.00,0.00,0.02,0
47103,4784,1000.00,1000.00,2000.00,660.58,339.42,0.11,1
47104,4784,-947.35,52.65,1052.65,0.00,947.35,0.37,0
47105,4784,-507.99,-455.34,544.66,0.00,507.99,0.31,0
47106,4784,-544.66,-1000.00,0.00,0.00,544.66,0.21,0
47107,4785,-1000.00,-1000.00,0.00,644.25,355.75,0.03,0
47108,4786,-1000.00,-1000.00,0.00,389.68,0.00,0.08,0
47109,4787,-1000.00,-1000.00,0.00,0.00,1000.00,0.10,0
47110,4788,-1000.00,-1000.00,0.00,0.00,1000.00,0.11,0
47111,4789,-957.47,-957.47,42.53,210.90,746.57,0.38,0
47112,4789,-1000.00,-1957.47,-957.47,33.03,9.50,0.01,0
47113,4790,1000.00,1000.00,2000.00,0.00,1000.00,0.08,1
47114,4790,1000.00,2000.00,3000.00,0.00,2000.00,0.22,1
47115,4790,1000.00,3000.00,4000.00,0.00,2718.41,0.32,1
47116,4790,1000.00,4000.00,5000.00,0.00,1735.27,0.25,1
47117,4790,1000.00,5000.00,6000.00,1813.50,3186.50,0.10,1
47118,4790,-1000.00,4000.00,5000.00,3317.52,2682.48,0.14,0
47119,4790,1000.00,5000.00,6000.00,705.42,4294.58,0.40,1
47120,4790,1000.00,6000.00,7000.00,2768.57,3231.43,0.23,1
47121,4790,-1000.00,5000.00,6000.00,1438.53,593.23,0.13,0
47122,4790,1000.00,6000.00,7000.00,2954.44,3045.56,0.21,1
47123,4790,-1000.00,5000.00,6000.00,3910.39,3089.61,0.06,0
47124,4790,-1000.00,4000.00,5000.00,3696.73,2303.27,0.03,0
47125,4790,-1000.00,3000.00,4000.00,0.00,5000.00,0.03,0
47126,4790,-1000.00,2000.00,3000.00,0.00,4000.00,0.12,0
47127,4790,-1000.00,1000.00,2000.00,43.86,1904.30,0.39,0
47128,4790,-1000.00,0.00,1000.00,1021.05,978.95,0.29,0
47129,4790,-1000.00,-1000.00,0.00,240.36,759.64,0.39,0
47130,4791,1000.00,1000.00,2000.00,0.00,366.72,0.01,1
47131,4791,-1000.00,0.00,1000.00,1246.78,0.00,0.24,0
47132,4791,1000.00,1000.00,2000.00,0.00,1000.00,0.23,1
47133,4791,-1000.00,0.00,1000.00,1163.73,836.27,0.12,0
47134,4791,-1000.00,-1000.00,0.00,358.50,641.50,0.29,0
47135,4792,0.00,0.00,1000.00,0.00,0.00,0.37,0
47136,4792,0.00,0.00,1000.00,0.00,0.00,0.24,0
47137,4792,-349.77,-349.77,650.23,0.00,349.77,0.16,0
47138,4792,-357.53,-707.30,292.70,0.00,357.53,0.29,0
47139,4792,-248.98,-956.28,43.72,124.35,124.63,0.28,0
47140,4792,-2.19,-958.47,41.53,0.00,2.19,0.33,0
47141,4792,-40.41,-998.88,1.12,0.00,40.41,0.11,0
47142,4792,-0.58,-999.46,0.54,0.00,0.58,0.26,0
47143,4792,92.96,-906.50,93.50,0.40,0.00,0.20,1
47144,4792,-65.89,-972.39,27.61,0.00,65.89,0.11,0
47145,4792,-2.10,-974.49,25.51,0.00,2.10,0.22,0
47146,4792,1000.00,25.51,1025.51,9.70,0.00,0.28,1
47147,4792,-1000.00,-974.49,25.51,0.00,1025.51,0.20,0
47148,4792,1000.00,25.51,1025.51,21.03,0.00,0.05,1
47149,4792,1000.00,1025.51,2025.51,779.44,179.36,0.16,1
47150,4792,0.00,1025.51,2025.51,0.00,0.00,0.21,0
47151,4792,0.00,1025.51,2025.51,0.00,0.00,0.42,0
47152,4792,-1000.00,25.51,1025.51,455.61,1569.91,0.10,0
47153,4792,1000.00,1025.51,2025.51,445.69,168.78,0.32,1
47154,4792,0.00,1025.51,2025.51,0.00,0.00,0.24,0
47155,4792,1000.00,2025.51,3025.51,954.22,0.00,0.05,1
47156,4792,-1000.00,1025.51,2025.51,766.04,977.89,0.35,0
47157,4792,1000.00,2025.51,3025.51,393.79,0.00,0.42,1
47158,4792,-1000.00,1025.51,2025.51,0.00,2296.50,0.11,0
47159,4792,0.00,1025.51,2025.51,0.00,0.00,0.23,0
47160,4792,-721.15,304.36,1304.36,0.00,721.15,0.34,0
47161,4792,1000.00,1304.36,2304.36,337.12,317.85,0.37,1
47162,4792,-1000.00,304.36,1304.36,0.00,1207.29,0.28,0
47163,4792,0.00,304.36,1304.36,0.00,0.00,0.18,0
47164,4792,0.00,304.36,1304.36,0.00,0.00,0.06,0
47165,4792,-1000.00,-695.64,304.36,296.76,1007.59,0.04,0
47166,4792,1000.00,304.36,1304.36,97.71,0.00,0.01,1
47167,4792,-744.83,-440.47,559.53,0.00,744.83,0.17,0
47168,4792,-422.32,-862.79,137.21,0.00,422.32,0.04,0
47169,4792,0.00,-862.79,137.21,0.00,0.00,0.08,0
47170,4793,-1000.00,-1000.00,0.00,380.71,0.00,0.14,0
47171,4794,1000.00,1000.00,2000.00,0.00,708.95,0.39,1
47172,4794,1000.00,2000.00,3000.00,0.00,1929.15,0.12,1
47173,4794,1000.00,3000.00,4000.00,1264.65,1735.35,0.20,1
47174,4794,-1000.00,2000.00,3000.00,1571.93,0.00,0.06,0
47175,4794,1000.00,3000.00,4000.00,1472.62,1527.38,0.10,1
47176,4794,1000.00,4000.00,5000.00,0.00,4000.00,0.07,1
47177,4794,1000.00,5000.00,6000.00,430.15,4569.85,0.32,1
47178,4794,1000.00,6000.00,7000.00,33.46,5966.54,0.36,1
47179,4794,1000.00,7000.00,8000.00,2269.55,4730.45,0.32,1
47180,4794,1000.00,8000.00,9000.00,3338.85,4661.15,0.09,1
47181,4794,1000.00,9000.00,10000.00,4500.00,4500.00,0.11,1
47182,4794,1000.00,10000.00,11000.00,0.00,5210.77,0.31,1
47183,4794,1000.00,11000.00,12000.00,0.00,10975.60,0.35,1
47184,4794,1000.00,12000.00,13000.00,0.00,12000.00,0.28,1
47185,4794,1000.00,13000.00,14000.00,6368.18,6631.82,0.43,1
47186,4794,1000.00,14000.00,15000.00,0.00,7238.17,0.32,1
47187,4794,-1000.00,13000.00,14000.00,9786.15,4644.29,0.13,0
47188,4794,1000.00,14000.00,15000.00,3027.41,10972.59,0.40,1
47189,4794,-1000.00,13000.00,14000.00,6301.21,8698.79,0.37,0
47190,4794,-1000.00,12000.00,13000.00,0.00,10668.86,0.28,0
47191,4794,0.00,12000.00,13000.00,0.00,0.00,0.03,0
47192,4794,-1000.00,11000.00,12000.00,761.08,12238.92,0.26,0
47193,4794,-1000.00,10000.00,11000.00,0.00,12000.00,0.23,0
47194,4794,-1000.00,9000.00,10000.00,1012.85,9047.76,0.42,0
47195,4794,-1000.00,8000.00,9000.00,0.00,6970.58,0.28,0
47196,4794,-1000.00,7000.00,8000.00,0.00,9000.00,0.17,0
47197,4794,-1000.00,6000.00,7000.00,0.00,8000.00,0.09,0
47198,4794,-1000.00,5000.00,6000.00,0.00,7000.00,0.04,0
47199,4794,-1000.00,4000.00,5000.00,0.00,6000.00,0.15,0
47200,4794,-1000.00,3000.00,4000.00,0.00,5000.00,0.20,0
47201,4794,-1000.00,2000.00,3000.00,0.00,3906.86,0.37,0
47202,4794,-1000.00,1000.00,2000.00,110.65,2889.35,0.38,0
47203,4794,-1000.00,0.00,1000.00,880.68,1119.32,0.20,0
47204,4794,-352.73,-352.73,647.27,0.00,352.73,0.04,0
47205,4794,-647.27,-1000.00,0.00,196.09,451.19,0.35,0
47206,4795,-624.39,-624.39,375.61,372.93,251.46,0.17,0
47207,4795,0.00,-624.39,375.61,0.00,0.00,0.02,0
47208,4795,1000.00,375.61,1375.61,27.01,348.60,0.41,1
47209,4795,1000.00,1375.61,2375.61,687.80,687.80,0.16,1
47210,4795,1000.00,2375.61,3375.61,254.44,1471.08,0.36,1
47211,4795,1000.00,3375.61,4375.61,0.00,3375.61,0.32,1
47212,4795,1000.00,4375.61,5375.61,1996.39,2379.21,0.09,1
47213,4795,1000.00,5375.61,6375.61,0.00,2424.48,0.18,1
47214,4795,1000.00,6375.61,7375.61,692.87,5682.73,0.02,1
47215,4795,1000.00,7375.61,8375.61,0.00,6851.35,0.32,1
47216,4795,0.00,7375.61,8375.61,0.00,0.00,0.02,0
47217,4795,0.00,7375.61,8375.61,0.00,0.00,0.05,0
47218,4795,1000.00,8375.61,9375.61,0.00,8375.61,0.40,1
47219,4795,1000.00,9375.61,10375.61,0.00,8423.77,0.10,1
47220,4795,1000.00,10375.61,11375.61,0.00,10375.61,0.41,1
47221,4795,1000.00,11375.61,12375.61,0.00,6320.53,0.24,1
47222,4795,1000.00,12375.61,13375.61,5159.84,7215.77,0.21,1
47223,4795,1000.00,13375.61,14375.61,648.67,12726.94,0.40,1
47224,4795,1000.00,14375.61,15375.61,0.00,14375.61,0.24,1
47225,4795,1000.00,15375.61,16375.61,6654.79,8720.82,0.27,1
47226,4795,1000.00,16375.61,17375.61,0.00,13584.39,0.42,1
47227,4795,1000.00,17375.61,18375.61,2299.90,14009.94,0.41,1
47228,4795,1000.00,18375.61,19375.61,6967.44,11408.17,0.26,1
47229,4795,0.00,18375.61,19375.61,0.00,0.00,0.07,0
47230,4795,1000.00,19375.61,20375.61,1509.13,12515.78,0.37,1
47231,4795,-1000.00,18375.61,19375.61,7814.06,0.00,0.16,0
47232,4795,1000.00,19375.61,20375.61,0.00,15552.58,0.08,1
47233,4795,1000.00,20375.61,21375.61,0.00,13331.06,0.30,1
47234,4795,1000.00,21375.61,22375.61,10687.80,10687.80,0.29,1
47235,4795,0.00,21375.61,22375.61,0.00,0.00,0.24,0
47236,4795,1000.00,22375.61,23375.61,1926.83,20448.78,0.44,1
47237,4795,1000.00,23375.61,24375.61,0.00,23375.61,0.26,1
47238,4795,1000.00,24375.61,25375.61,0.00,23006.34,0.44,1
47239,4795,1000.00,25375.61,26375.61,12687.80,12687.80,0.04,1
47240,4795,1000.00,26375.61,27375.61,0.00,18978.38,0.37,1
47241,4795,1000.00,27375.61,28375.61,0.00,27375.61,0.42,1
47242,4795,1000.00,28375.61,29375.61,0.00,25857.80,0.38,1
47243,4795,1000.00,29375.61,30375.61,0.00,26588.67,0.35,1
47244,4795,1000.00,30375.61,31375.61,0.00,30375.61,0.35,1
47245,4795,1000.00,31375.61,32375.61,0.00,3737.40,0.05,1
47246,4795,1000.00,32375.61,33375.61,16187.80,16187.80,0.08,1
47247,4795,1000.00,33375.61,34375.61,16687.80,16687.80,0.07,1
47248,4795,1000.00,34375.61,35375.61,291.25,17029.76,0.31,1
47249,4795,1000.00,35375.61,36375.61,0.00,35375.61,0.31,1
47250,4795,1000.00,36375.61,37375.61,0.00,22222.54,0.35,1
47251,4795,1000.00,37375.61,38375.61,0.00,37375.61,0.30,1
47252,4795,1000.00,38375.61,39375.61,0.00,38375.61,0.01,1
47253,4795,1000.00,39375.61,40375.61,0.00,22886.67,0.31,1
47254,4796,1000.00,1000.00,2000.00,0.00,1000.00,0.43,1
47255,4796,1000.00,2000.00,3000.00,0.00,933.59,0.23,1
47256,4796,1000.00,3000.00,4000.00,0.00,449.87,0.10,1
47257,4796,1000.00,4000.00,5000.00,0.00,4000.00,0.44,1
47258,4796,1000.00,5000.00,6000.00,912.16,4087.84,0.21,1
47259,4796,1000.00,6000.00,7000.00,0.00,6000.00,0.13,1
47260,4796,1000.00,7000.00,8000.00,0.00,7000.00,0.01,1
47261,4796,0.00,7000.00,8000.00,0.00,0.00,0.02,0
47262,4796,1000.00,8000.00,9000.00,0.00,8000.00,0.25,1
47263,4796,1000.00,9000.00,10000.00,0.00,8054.98,0.33,1
47264,4796,1000.00,10000.00,11000.00,887.73,9112.27,0.35,1
47265,4796,1000.00,11000.00,12000.00,0.00,6820.29,0.28,1
47266,4796,1000.00,12000.00,13000.00,1694.60,10305.40,0.37,1
47267,4796,1000.00,13000.00,14000.00,4418.00,8582.00,0.30,1
47268,4796,1000.00,14000.00,15000.00,0.00,14000.00,0.34,1
47269,4796,1000.00,15000.00,16000.00,409.53,14590.47,0.37,1
47270,4796,1000.00,16000.00,17000.00,345.30,15654.70,0.37,1
47271,4796,1000.00,17000.00,18000.00,0.00,8594.76,0.27,1
47272,4796,1000.00,18000.00,19000.00,564.41,17435.59,0.26,1
47273,4796,1000.00,19000.00,20000.00,4634.28,7964.51,0.25,1
47274,4796,1000.00,20000.00,21000.00,9670.85,10329.15,0.37,1
47275,4796,-1000.00,19000.00,20000.00,10416.48,8967.00,0.20,0
47276,4796,1000.00,20000.00,21000.00,8605.58,11394.42,0.28,1
47277,4796,1000.00,21000.00,22000.00,0.00,2042.79,0.13,1
47278,4796,-1000.00,20000.00,21000.00,0.00,22000.00,0.14,0
47279,4796,-1000.00,19000.00,20000.00,4628.06,0.00,0.36,0
47280,4796,-1000.00,18000.00,19000.00,0.00,12975.04,0.23,0
47281,4796,-1000.00,17000.00,18000.00,271.34,6604.92,0.24,0
47282,4796,-1000.00,16000.00,17000.00,0.00,18000.00,0.20,0
47283,4796,-1000.00,15000.00,16000.00,4944.71,12055.29,0.36,0
47284,4796,-1000.00,14000.00,15000.00,0.00,9879.16,0.30,0
47285,4796,-1000.00,13000.00,14000.00,0.00,7083.35,0.24,0
47286,4796,-1000.00,12000.00,13000.00,910.53,8402.91,0.35,0
47287,4796,-1000.00,11000.00,12000.00,6273.49,6726.51,0.29,0
47288,4796,-1000.00,10000.00,11000.00,0.00,8311.31,0.40,0
47289,4796,-1000.00,9000.00,10000.00,11000.00,0.00,0.09,0
47290,4796,-1000.00,8000.00,9000.00,0.00,2067.51,0.15,0
47291,4796,0.00,8000.00,9000.00,0.00,0.00,0.18,0
47292,4796,-1000.00,7000.00,8000.00,4387.25,4612.75,0.13,0
47293,4796,-1000.00,6000.00,7000.00,0.00,6978.87,0.42,0
47294,4796,-1000.00,5000.00,6000.00,0.00,7000.00,0.09,0
47295,4796,-1000.00,4000.00,5000.00,0.00,4195.08,0.04,0
47296,4796,-1000.00,3000.00,4000.00,0.00,4560.04,0.31,0
47297,4796,-1000.00,2000.00,3000.00,450.65,3549.35,0.31,0
47298,4796,-1000.00,1000.00,2000.00,0.00,1057.63,0.19,0
47299,4797,1000.00,1000.00,2000.00,0.00,1000.00,0.17,1
47300,4797,1000.00,2000.00,3000.00,0.00,2000.00,0.07,1
47301,4797,1000.00,3000.00,4000.00,1111.84,1888.16,0.31,1
47302,4797,1000.00,4000.00,5000.00,0.00,2198.37,0.31,1
47303,4797,1000.00,5000.00,6000.00,0.00,5000.00,0.12,1
47304,4797,1000.00,6000.00,7000.00,0.00,6000.00,0.22,1
47305,4797,1000.00,7000.00,8000.00,0.00,2375.23,0.18,1
47306,4797,1000.00,8000.00,9000.00,3207.87,4792.13,0.15,1
47307,4797,1000.00,9000.00,10000.00,0.00,7636.86,0.30,1
47308,4797,1000.00,10000.00,11000.00,0.00,8209.95,0.37,1
47309,4797,0.00,10000.00,11000.00,0.00,0.00,0.00,0
47310,4797,1000.00,11000.00,12000.00,4799.17,6200.83,0.35,1
47311,4797,1000.00,12000.00,13000.00,1068.63,10931.37,0.44,1
47312,4797,1000.00,13000.00,14000.00,0.00,11548.51,0.33,1
47313,4797,1000.00,14000.00,15000.00,4628.60,9371.40,0.06,1
47314,4797,-1000.00,13000.00,14000.00,7500.00,7500.00,0.16,0
47315,4797,-1000.00,12000.00,13000.00,0.00,14000.00,0.28,0
47316,4797,1000.00,13000.00,14000.00,6378.61,3716.24,0.16,1
47317,4797,-1000.00,12000.00,13000.00,0.00,14000.00,0.11,0
47318,4797,-1000.00,11000.00,12000.00,0.00,11648.50,0.09,0
47319,4797,1000.00,12000.00,13000.00,1178.27,0.00,0.02,1
47320,4797,-1000.00,11000.00,12000.00,644.53,11624.58,0.43,0
47321,4797,-1000.00,10000.00,11000.00,0.00,12000.00,0.34,0
47322,4797,-1000.00,9000.00,10000.00,0.00,11000.00,0.07,0
47323,4797,-1000.00,8000.00,9000.00,0.00,10000.00,0.24,0
47324,4797,-1000.00,7000.00,8000.00,0.00,2199.37,0.09,0
47325,4797,-1000.00,6000.00,7000.00,3879.06,4120.94,0.13,0
47326,4797,1000.00,7000.00,8000.00,3595.04,3404.96,0.12,1
47327,4797,-1000.00,6000.00,7000.00,0.00,8000.00,0.02,0
47328,4797,-1000.00,5000.00,6000.00,0.00,7000.00,0.16,0
47329,4797,-1000.00,4000.00,5000.00,1580.41,4419.59,0.30,0
47330,4797,1000.00,5000.00,6000.00,3521.40,1384.09,0.11,1
47331,4797,-1000.00,4000.00,5000.00,0.00,6000.00,0.25,0
47332,4797,-1000.00,3000.00,4000.00,0.00,5000.00,0.30,0
47333,4797,-1000.00,2000.00,3000.00,445.54,3554.46,0.09,0
47334,4797,-1000.00,1000.00,2000.00,672.95,1058.95,0.23,0
47335,4797,-1000.00,0.00,1000.00,0.00,2000.00,0.17,0
47336,4797,-922.96,-922.96,77.04,0.00,922.96,0.25,0
47337,4797,1000.00,77.04,1077.04,0.00,38.73,0.19,1
47338,4797,1000.00,1077.04,2077.04,501.55,575.49,0.09,1
47339,4797,1000.00,2077.04,3077.04,337.52,1739.51,0.05,1
47340,4797,-1000.00,1077.04,2077.04,3047.99,29.05,0.02,0
47341,4797,-1000.00,77.04,1077.04,1583.63,219.27,0.06,0
47342,4797,1000.00,1077.04,2077.04,0.00,1077.04,0.25,1
47343,4797,1000.00,2077.04,3077.04,0.00,2077.04,0.27,1
47344,4797,1000.00,3077.04,4077.04,1099.65,1977.38,0.23,1
47345,4797,1000.00,4077.04,5077.04,1856.01,2221.02,0.16,1
47346,4797,1000.00,5077.04,6077.04,0.00,5045.80,0.16,1
47347,4797,1000.00,6077.04,7077.04,276.71,4788.46,0.41,1
47348,4797,1000.00,7077.04,8077.04,3375.83,3701.21,0.09,1
47349,4797,1000.00,8077.04,9077.04,2246.13,5830.91,0.06,1
47350,4797,1000.00,9077.04,10077.04,1990.47,7086.57,0.38,1
47351,4797,1000.00,10077.04,11077.04,0.00,10077.04,0.02,1
47352,4797,-1000.00,9077.04,10077.04,8561.45,2515.58,0.08,0
47353,4797,1000.00,10077.04,11077.04,3946.99,6130.05,0.25,1
47354,4797,1000.00,11077.04,12077.04,0.00,11077.04,0.01,1
47355,4798,0.00,0.00,1000.00,0.00,0.00,0.10,0
47356,4798,-1000.00,-1000.00,0.00,0.00,812.32,0.18,0
47357,4799,-356.40,-356.40,643.60,239.43,116.96,0.23,0
47358,4799,1000.00,643.60,1643.60,11.44,621.02,0.42,1
47359,4799,1000.00,1643.60,2643.60,0.00,1643.60,0.18,1
47360,4799,1000.00,2643.60,3643.60,394.44,2249.17,0.41,1
47361,4799,1000.00,3643.60,4643.60,0.00,3628.18,0.42,1
47362,4799,1000.00,4643.60,5643.60,1524.08,3119.52,0.24,1
47363,4799,1000.00,5643.60,6643.60,0.00,5643.60,0.30,1
47364,4799,1000.00,6643.60,7643.60,185.28,6458.33,0.36,1
47365,4799,1000.00,7643.60,8643.60,0.00,7643.60,0.11,1
47366,4799,1000.00,8643.60,9643.60,0.00,8643.60,0.43,1
47367,4799,1000.00,9643.60,10643.60,1192.18,8451.42,0.36,1
47368,4799,1000.00,10643.60,11643.60,0.00,6567.74,0.04,1
47369,4799,1000.00,11643.60,12643.60,0.00,11643.60,0.21,1
47370,4799,-1000.00,10643.60,11643.60,1559.29,0.00,0.05,0
47371,4799,1000.00,11643.60,12643.60,0.00,2806.21,0.18,1
47372,4799,1000.00,12643.60,13643.60,0.00,12643.60,0.36,1
47373,4799,1000.00,13643.60,14643.60,0.00,13643.60,0.42,1
47374,4799,1000.00,14643.60,15643.60,0.00,14643.60,0.37,1
47375,4799,-1000.00,13643.60,14643.60,10406.35,5237.25,0.12,0
47376,4799,1000.00,14643.60,15643.60,2671.58,11972.02,0.39,1
47377,4799,1000.00,15643.60,16643.60,0.00,1698.34,0.13,1
47378,4799,1000.00,16643.60,17643.60,8321.80,8321.80,0.43,1
47379,4799,1000.00,17643.60,18643.60,0.00,17643.60,0.25,1
47380,4799,1000.00,18643.60,19643.60,0.00,10846.10,0.24,1
47381,4799,1000.00,19643.60,20643.60,6320.20,13323.41,0.33,1
47382,4799,1000.00,20643.60,21643.60,0.00,20221.08,0.27,1
47383,4799,-1000.00,19643.60,20643.60,18014.05,3129.70,0.06,0
47384,4799,1000.00,20643.60,21643.60,0.00,20643.60,0.31,1
47385,4799,1000.00,21643.60,22643.60,5650.48,15993.12,0.34,1
47386,4799,1000.00,22643.60,23643.60,0.00,22643.60,0.15,1
47387,4799,1000.00,23643.60,24643.60,0.00,23643.60,0.05,1
47388,4799,1000.00,24643.60,25643.60,0.00,24643.60,0.40,1
47389,4799,1000.00,25643.60,26643.60,0.00,25643.60,0.00,1
47390,4799,-1000.00,24643.60,25643.60,13698.89,12944.71,0.07,0
47391,4799,1000.00,25643.60,26643.60,0.00,25643.60,0.22,1
47392,4799,1000.00,26643.60,27643.60,0.00,12184.04,0.29,1
47393,4799,1000.00,27643.60,28643.60,0.00,11877.53,0.28,1
47394,4799,1000.00,28643.60,29643.60,0.00,28643.60,0.36,1
47395,4799,1000.00,29643.60,30643.60,0.00,20258.46,0.25,1
47396,4799,1000.00,30643.60,31643.60,0.00,30643.60,0.11,1
47397,4799,1000.00,31643.60,32643.60,0.00,31643.60,0.39,1
47398,4799,1000.00,32643.60,33643.60,14911.78,17731.82,0.24,1
47399,4799,-1000.00,31643.60,32643.60,17149.92,16493.68,0.23,0
47400,4799,1000.00,32643.60,33643.60,0.00,14501.80,0.16,1
47401,4799,1000.00,33643.60,34643.60,6247.99,13443.58,0.26,1
47402,4799,1000.00,34643.60,35643.60,0.00,16540.79,0.01,1
47403,4799,1000.00,35643.60,36643.60,8435.16,27208.45,0.30,1
47404,4799,1000.00,36643.60,37643.60,0.00,3517.79,0.09,1
47405,4799,1000.00,37643.60,38643.60,0.00,16782.73,0.29,1
47406,4799,-1000.00,36643.60,37643.60,26010.89,0.00,0.02,0
47407,4799,1000.00,37643.60,38643.60,15187.23,22456.37,0.22,1
47408,4799,1000.00,38643.60,39643.60,0.00,9334.35,0.02,1
47409,4799,1000.00,39643.60,40643.60,0.00,8105.17,0.10,1
47410,4799,1000.00,40643.60,41643.60,0.00,40643.60,0.18,1
47411,4799,1000.00,41643.60,42643.60,11616.80,24545.60,0.31,1
47412,4799,1000.00,42643.60,43643.60,9399.96,33243.65,0.37,1
47413,4799,1000.00,43643.60,44643.60,0.00,9976.66,0.08,1
47414,4799,1000.00,44643.60,45643.60,0.00,44643.60,0.33,1
47415,4799,1000.00,45643.60,46643.60,0.00,28695.20,0.35,1
47416,4799,1000.00,46643.60,47643.60,11690.98,29591.48,0.34,1
47417,4799,1000.00,47643.60,48643.60,5611.68,42031.92,0.34,1
47418,4799,-1000.00,46643.60,47643.60,15560.79,0.00,0.01,0
47419,4799,1000.00,47643.60,48643.60,0.00,45012.85,0.43,1
47420,4799,1000.00,48643.60,49643.60,18109.70,30533.91,0.31,1
47421,4799,1000.00,49643.60,50643.60,0.00,9356.30,0.01,1
47422,4799,1000.00,50643.60,51643.60,0.00,50643.60,0.38,1
47423,4799,1000.00,51643.60,52643.60,0.00,4374.66,0.01,1
47424,4799,1000.00,52643.60,53643.60,5186.81,47456.79,0.36,1
47425,4799,-1000.00,51643.60,52643.60,37116.09,16527.51,0.02,0
47426,4800,1000.00,1000.00,2000.00,0.00,1000.00,0.35,1
47427,4800,1000.00,2000.00,3000.00,0.00,1407.93,0.09,1
47428,4800,1000.00,3000.00,4000.00,0.00,3000.00,0.25,1
47429,4800,1000.00,4000.00,5000.00,0.00,3058.51,0.11,1
47430,4800,1000.00,5000.00,6000.00,0.00,5000.00,0.23,1
47431,4800,1000.00,6000.00,7000.00,0.00,3540.02,0.19,1
47432,4800,1000.00,7000.00,8000.00,1143.86,5856.14,0.40,1
47433,4800,1000.00,8000.00,9000.00,3496.63,4503.37,0.29,1
47434,4800,1000.00,9000.00,10000.00,1445.97,3756.38,0.27,1
47435,4800,1000.00,10000.00,11000.00,4636.93,5363.07,0.33,1
47436,4800,1000.00,11000.00,12000.00,0.00,11000.00,0.14,1
47437,4800,1000.00,12000.00,13000.00,4763.55,7236.45,0.23,1
47438,4800,1000.00,13000.00,14000.00,674.27,9930.20,0.41,1
47439,4800,0.00,13000.00,14000.00,0.00,0.00,0.02,0
47440,4800,1000.00,14000.00,15000.00,7000.00,7000.00,0.38,1
47441,4800,1000.00,15000.00,16000.00,0.00,15000.00,0.28,1
47442,4800,1000.00,16000.00,17000.00,0.00,16000.00,0.30,1
47443,4800,1000.00,17000.00,18000.00,7961.23,9038.77,0.13,1
47444,4800,-1000.00,16000.00,17000.00,17013.46,986.54,0.05,0
47445,4800,-1000.00,15000.00,16000.00,8147.66,8852.34,0.00,0
47446,4800,-1000.00,14000.00,15000.00,0.00,4987.95,0.24,0
47447,4800,-1000.00,13000.00,14000.00,0.00,14883.47,0.41,0
47448,4800,-1000.00,12000.00,13000.00,0.00,14000.00,0.17,0
47449,4800,-1000.00,11000.00,12000.00,0.00,10949.19,0.42,0
47450,4800,-1000.00,10000.00,11000.00,6401.62,3597.55,0.15,0
47451,4800,-1000.00,9000.00,10000.00,5500.00,5500.00,0.02,0
47452,4800,-1000.00,8000.00,9000.00,0.00,6991.64,0.35,0
47453,4800,-1000.00,7000.00,8000.00,0.00,4838.26,0.32,0
47454,4800,-1000.00,6000.00,7000.00,2259.16,5740.84,0.15,0
47455,4800,-1000.00,5000.00,6000.00,0.00,6500.28,0.34,0
47456,4800,-1000.00,4000.00,5000.00,0.00,6000.00,0.10,0
47457,4800,-1000.00,3000.00,4000.00,2491.17,2508.83,0.11,0
47458,4800,-1000.00,2000.00,3000.00,3532.56,218.45,0.04,0
47459,4800,-1000.00,1000.00,2000.00,0.00,3000.00,0.20,0
47460,4800,-1000.00,0.00,1000.00,659.10,1340.90,0.26,0
47461,4800,-1000.00,-1000.00,0.00,0.00,1000.00,0.04,0
47462,4801,-1000.00,-1000.00,0.00,0.00,183.04,0.22,0
47463,4802,-1000.00,-1000.00,0.00,484.73,204.97,0.31,0
47464,4803,-747.59,-747.59,252.41,0.00,747.59,0.31,0
47465,4803,-252.41,-1000.00,0.00,86.61,165.80,0.30,0
47466,4803,-0.00,-1000.00,0.00,0.00,0.00,0.41,0
47467,4804,-1000.00,-1000.00,0.00,343.76,656.24,0.01,0
47468,4805,1000.00,1000.00,2000.00,0.00,538.23,0.14,1
47469,4805,0.00,1000.00,2000.00,0.00,0.00,0.06,0
47470,4805,1000.00,2000.00,3000.00,0.00,2000.00,0.21,1
47471,4805,1000.00,3000.00,4000.00,0.00,1426.63,0.28,1
47472,4805,0.00,3000.00,4000.00,0.00,0.00,0.10,0
47473,4805,1000.00,4000.00,5000.00,1194.40,2805.60,0.31,1
47474,4805,-1000.00,3000.00,4000.00,3911.90,801.30,0.07,0
47475,4805,1000.00,4000.00,5000.00,1085.65,2914.35,0.37,1
47476,4805,1000.00,5000.00,6000.00,2104.46,2895.54,0.24,1
47477,4805,1000.00,6000.00,7000.00,0.00,4332.39,0.11,1
47478,4805,1000.00,7000.00,8000.00,1925.11,5074.89,0.37,1
47479,4805,1000.00,8000.00,9000.00,0.00,4197.41,0.14,1
47480,4805,1000.00,9000.00,10000.00,1085.63,7914.37,0.43,1
47481,4805,1000.00,10000.00,11000.00,0.00,9002.33,0.42,1
47482,4805,1000.00,11000.00,12000.00,0.00,411.01,0.07,1
47483,4805,1000.00,12000.00,13000.00,0.00,10770.01,0.44,1
47484,4805,-1000.00,11000.00,12000.00,8109.57,4890.43,0.33,0
47485,4805,1000.00,12000.00,13000.00,292.64,8576.87,0.39,1
47486,4805,1000.00,13000.00,14000.00,0.00,13000.00,0.03,1
47487,4805,1000.00,14000.00,15000.00,571.95,13428.05,0.30,1
47488,4805,1000.00,15000.00,16000.00,5024.71,9975.29,0.24,1
47489,4805,1000.00,16000.00,17000.00,3077.93,12922.07,0.15,1
47490,4805,1000.00,17000.00,18000.00,2653.58,5605.30,0.23,1
47491,4805,1000.00,18000.00,19000.00,5693.51,12306.49,0.33,1
47492,4805,-1000.00,17000.00,18000.00,4468.79,14531.21,0.40,0
47493,4805,-1000.00,16000.00,17000.00,1032.73,1126.27,0.36,0
47494,4805,-1000.00,15000.00,16000.00,673.47,11242.27,0.39,0
47495,4805,-1000.00,14000.00,15000.00,0.00,16000.00,0.22,0
47496,4805,-1000.00,13000.00,14000.00,2061.13,10938.03,0.39,0
47497,4805,-1000.00,12000.00,13000.00,1678.12,12321.88,0.24,0
47498,4805,-1000.00,11000.00,12000.00,5820.86,7179.14,0.11,0
47499,4805,-1000.00,10000.00,11000.00,3794.01,6887.27,0.30,0
47500,4805,-135.82,9864.18,10864.18,0.00,135.82,0.09,0
47501,4805,-1000.00,8864.18,9864.18,2211.15,8653.04,0.14,0
47502,4805,-1000.00,7864.18,8864.18,2557.24,7306.94,0.15,0
47503,4805,-1000.00,6864.18,7864.18,2146.94,6717.24,0.23,0
47504,4805,-1000.00,5864.18,6864.18,1525.35,2553.73,0.22,0
47505,4805,-1000.00,4864.18,5864.18,0.00,6864.18,0.11,0
47506,4805,-1000.00,3864.18,4864.18,0.00,5864.18,0.32,0
47507,4805,-1000.00,2864.18,3864.18,0.00,4864.18,0.05,0
47508,4805,-1000.00,1864.18,2864.18,500.20,3363.98,0.24,0
47509,4805,-1000.00,864.18,1864.18,0.00,2864.18,0.04,0
47510,4805,-659.79,204.40,1204.40,80.13,579.66,0.23,0
47511,4805,-1000.00,-795.60,204.40,475.71,647.44,0.27,0
47512,4805,-204.40,-1000.00,0.00,29.52,174.88,0.33,0
47513,4806,1000.00,1000.00,2000.00,0.00,1000.00,0.25,1
47514,4806,1000.00,2000.00,3000.00,0.00,1169.83,0.34,1
47515,4806,1000.00,3000.00,4000.00,0.00,3000.00,0.01,1
47516,4806,1000.00,4000.00,5000.00,0.00,4000.00,0.13,1
47517,4806,1000.00,5000.00,6000.00,0.00,5000.00,0.19,1
47518,4806,1000.00,6000.00,7000.00,0.00,6000.00,0.44,1
47519,4806,1000.00,7000.00,8000.00,3500.00,3500.00,0.00,1
47520,4806,1000.00,8000.00,9000.00,0.00,4451.95,0.32,1
47521,4806,1000.00,9000.00,10000.00,0.00,9000.00,0.25,1
47522,4806,1000.00,10000.00,11000.00,0.00,1484.66,0.16,1
47523,4806,1000.00,11000.00,12000.00,0.00,1472.79,0.12,1
47524,4806,1000.00,12000.00,13000.00,0.00,3464.10,0.06,1
47525,4806,1000.00,13000.00,14000.00,5033.74,7966.26,0.27,1
47526,4806,1000.00,14000.00,15000.00,0.00,14000.00,0.03,1
47527,4806,1000.00,15000.00,16000.00,3547.85,11452.15,0.28,1
47528,4806,1000.00,16000.00,17000.00,0.00,16000.00,0.11,1
47529,4806,1000.00,17000.00,18000.00,0.00,2468.92,0.11,1
47530,4806,1000.00,18000.00,19000.00,0.00,18000.00,0.36,1
47531,4806,1000.00,19000.00,20000.00,2883.90,11095.28,0.34,1
47532,4806,-1000.00,18000.00,19000.00,10000.00,10000.00,0.32,0
47533,4806,-1000.00,17000.00,18000.00,0.00,19000.00,0.02,0
47534,4806,-1000.00,16000.00,17000.00,5399.44,12600.56,0.33,0
47535,4806,-1000.00,15000.00,16000.00,0.00,1744.05,0.08,0
47536,4806,-1000.00,14000.00,15000.00,4595.94,11404.06,0.29,0
47537,4806,-1000.00,13000.00,14000.00,3239.26,11760.74,0.37,0
47538,4806,-1000.00,12000.00,13000.00,0.00,14000.00,0.40,0
47539,4806,-1000.00,11000.00,12000.00,3512.42,9487.58,0.20,0
47540,4806,-1000.00,10000.00,11000.00,0.00,11923.51,0.22,0
47541,4806,-1000.00,9000.00,10000.00,1785.10,9214.90,0.31,0
47542,4806,-1000.00,8000.00,9000.00,5000.00,5000.00,0.01,0
47543,4806,-1000.00,7000.00,8000.00,0.00,9000.00,0.39,0
47544,4806,-1000.00,6000.00,7000.00,3617.56,4382.44,0.10,0
47545,4806,-1000.00,5000.00,6000.00,0.00,4912.61,0.25,0
47546,4806,-1000.00,4000.00,5000.00,0.00,6000.00,0.09,0
47547,4806,-1000.00,3000.00,4000.00,552.63,4447.37,0.30,0
47548,4806,-1000.00,2000.00,3000.00,1071.77,2928.23,0.36,0
47549,4806,-1000.00,1000.00,2000.00,0.00,1699.86,0.11,0
47550,4806,-1000.00,0.00,1000.00,1116.20,883.80,0.12,0
47551,4806,-1000.00,-1000.00,0.00,794.68,78.66,0.06,0
47552,4807,-1000.00,-1000.00,0.00,0.00,240.36,0.34,0
47553,4808,-1000.00,-1000.00,0.00,0.00,1000.00,0.16,0
47554,4809,1000.00,1000.00,2000.00,518.17,481.83,0.13,1
47555,4809,-1000.00,0.00,1000.00,0.00,1358.06,0.24,0
47556,4809,-888.04,-888.04,111.96,0.00,888.04,0.43,0
47557,4809,0.00,-888.04,111.96,0.00,0.00,0.02,0
47558,4809,-111.96,-1000.00,0.00,0.00,111.96,0.18,0
47559,4810,1000.00,1000.00,2000.00,0.00,1000.00,0.01,1
47560,4810,1000.00,2000.00,3000.00,974.11,1025.89,0.15,1
47561,4810,1000.00,3000.00,4000.00,0.00,3000.00,0.13,1
47562,4810,1000.00,4000.00,5000.00,124.55,3472.52,0.43,1
47563,4810,1000.00,5000.00,6000.00,0.00,5000.00,0.03,1
47564,4810,1000.00,6000.00,7000.00,2740.08,3259.92,0.10,1
47565,4810,-1000.00,5000.00,6000.00,4074.38,2925.62,0.16,0
47566,4810,1000.00,6000.00,7000.00,0.00,6000.00,0.35,1
47567,4810,1000.00,7000.00,8000.00,2886.91,4113.09,0.23,1
47568,4810,1000.00,8000.00,9000.00,313.30,7686.70,0.27,1
47569,4810,1000.00,9000.00,10000.00,0.00,9000.00,0.22,1
47570,4810,-1000.00,8000.00,9000.00,4901.64,2929.25,0.16,0
47571,4810,1000.00,9000.00,10000.00,2644.19,6355.81,0.33,1
47572,4810,1000.00,10000.00,11000.00,1872.08,3320.84,0.23,1
47573,4810,1000.00,11000.00,12000.00,3089.15,7910.85,0.35,1
47574,4810,-1000.00,10000.00,11000.00,6237.96,5762.04,0.41,0
47575,4810,-1000.00,9000.00,10000.00,7160.63,3839.37,0.10,0
47576,4810,1000.00,10000.00,11000.00,0.00,2996.15,0.21,1
47577,4810,0.00,10000.00,11000.00,0.00,0.00,0.03,0
47578,4810,1000.00,11000.00,12000.00,3422.45,7577.55,0.34,1
47579,4810,1000.00,12000.00,13000.00,5064.05,6935.95,0.20,1
47580,4810,1000.00,13000.00,14000.00,6500.00,6500.00,0.44,1
47581,4810,-1000.00,12000.00,13000.00,3303.37,3283.56,0.19,0
47582,4810,1000.00,13000.00,14000.00,6500.00,6500.00,0.08,1
47583,4810,1000.00,14000.00,15000.00,2088.35,11911.65,0.30,1
47584,4810,1000.00,15000.00,16000.00,0.00,8787.05,0.06,1
47585,4810,1000.00,16000.00,17000.00,4818.89,8246.56,0.28,1
47586,4810,1000.00,17000.00,18000.00,0.00,10529.64,0.36,1
47587,4810,-1000.00,16000.00,17000.00,12055.75,5944.25,0.25,0
47588,4810,1000.00,17000.00,18000.00,0.00,11035.71,0.23,1
47589,4810,1000.00,18000.00,19000.00,0.00,18000.00,0.12,1
47590,4810,1000.00,19000.00,20000.00,1464.59,17535.41,0.44,1
47591,4810,1000.00,20000.00,21000.00,8959.00,11041.00,0.22,1
47592,4810,1000.00,21000.00,22000.00,0.00,21000.00,0.42,1
47593,4810,1000.00,22000.00,23000.00,0.00,9191.26,0.27,1
47594,4810,1000.00,23000.00,24000.00,0.00,21409.54,0.38,1
47595,4810,1000.00,24000.00,25000.00,4130.55,19869.45,0.42,1
47596,4810,1000.00,25000.00,26000.00,0.00,25000.00,0.15,1
47597,4810,1000.00,26000.00,27000.00,12828.62,13171.38,0.12,1
47598,4811,1000.00,1000.00,2000.00,0.00,921.59,0.40,1
47599,4811,1000.00,2000.00,3000.00,333.92,1666.08,0.42,1
47600,4811,1000.00,3000.00,4000.00,0.00,1197.94,0.25,1
47601,4811,1000.00,4000.00,5000.00,1838.52,2161.48,0.25,1
47602,4811,1000.00,5000.00,6000.00,744.74,4255.26,0.11,1
47603,4811,1000.00,6000.00,7000.00,0.00,5417.97,0.30,1
47604,4811,1000.00,7000.00,8000.00,0.00,7000.00,0.15,1
47605,4811,0.00,7000.00,8000.00,0.00,0.00,0.01,0
47606,4811,1000.00,8000.00,9000.00,0.00,8000.00,0.32,1
47607,4811,1000.00,9000.00,10000.00,0.00,9000.00,0.14,1
47608,4811,1000.00,10000.00,11000.00,0.00,9640.64,0.40,1
47609,4811,-1000.00,9000.00,10000.00,7241.78,3758.22,0.12,0
47610,4811,1000.00,10000.00,11000.00,0.00,10000.00,0.22,1
47611,4811,1000.00,11000.00,12000.00,0.00,11000.00,0.31,1
47612,4811,1000.00,12000.00,13000.00,3431.84,8568.16,0.20,1
47613,4811,1000.00,13000.00,14000.00,0.00,11366.47,0.08,1
47614,4811,1000.00,14000.00,15000.00,0.00,14000.00,0.39,1
47615,4811,-1000.00,13000.00,14000.00,9697.64,5302.36,0.09,0
47616,4811,1000.00,14000.00,15000.00,0.00,14000.00,0.26,1
47617,4811,-1000.00,13000.00,14000.00,5014.54,0.00,0.04,0
47618,4811,1000.00,14000.00,15000.00,0.00,9020.36,0.29,1
47619,4811,1000.00,15000.00,16000.00,0.00,15000.00,0.21,1
47620,4811,1000.00,16000.00,17000.00,0.00,16000.00,0.41,1
47621,4811,1000.00,17000.00,18000.00,2083.78,14916.22,0.29,1
47622,4811,-1000.00,16000.00,17000.00,4220.69,13779.31,0.39,0
47623,4811,-1000.00,15000.00,16000.00,0.00,17000.00,0.05,0
47624,4811,-1000.00,14000.00,15000.00,0.00,8121.35,0.04,0
47625,4811,-1000.00,13000.00,14000.00,0.00,15000.00,0.21,0
47626,4811,-1000.00,12000.00,13000.00,8326.17,5673.83,0.01,0
47627,4811,-1000.00,11000.00,12000.00,6854.10,6145.90,0.06,0
47628,4811,-1000.00,10000.00,11000.00,0.00,7083.35,0.12,0
47629,4811,-1000.00,9000.00,10000.00,0.00,11000.00,0.33,0
47630,4811,-1000.00,8000.00,9000.00,4316.46,5683.54,0.24,0
47631,4811,-1000.00,7000.00,8000.00,3684.29,5315.71,0.20,0
47632,4811,-1000.00,6000.00,7000.00,0.00,8000.00,0.27,0
47633,4811,-1000.00,5000.00,6000.00,0.00,3804.11,0.31,0
47634,4811,-1000.00,4000.00,5000.00,0.00,6000.00,0.31,0
47635,4811,-1000.00,3000.00,4000.00,0.00,1369.85,0.09,0
47636,4811,-1000.00,2000.00,3000.00,788.12,3211.88,0.05,0
47637,4811,-1000.00,1000.00,2000.00,0.00,2413.75,0.39,0
47638,4811,-1000.00,0.00,1000.00,740.26,1259.74,0.18,0
47639,4811,-1000.00,-1000.00,0.00,602.53,397.47,0.09,0
47640,4812,-153.98,-153.98,846.02,0.00,153.98,0.38,0
47641,4812,-1000.00,-1153.98,-153.98,573.82,0.00,0.06,0
47642,4813,-126.11,-126.11,873.89,0.00,126.11,0.39,0
47643,4813,-873.89,-1000.00,0.00,0.00,873.89,0.03,0
47644,4814,-505.81,-505.81,494.19,505.81,0.00,0.04,0
47645,4814,1000.00,494.19,1494.19,0.00,494.19,0.20,1
47646,4814,1000.00,1494.19,2494.19,362.92,1131.26,0.29,1
47647,4814,1000.00,2494.19,3494.19,0.00,1650.22,0.18,1
47648,4814,1000.00,3494.19,4494.19,0.00,3494.19,0.31,1
47649,4814,0.00,3494.19,4494.19,0.00,0.00,0.03,0
47650,4814,1000.00,4494.19,5494.19,0.00,4494.19,0.28,1
47651,4814,1000.00,5494.19,6494.19,0.00,4884.81,0.14,1
47652,4814,1000.00,6494.19,7494.19,428.77,4203.58,0.37,1
47653,4814,1000.00,7494.19,8494.19,192.89,7301.30,0.40,1
47654,4814,1000.00,8494.19,9494.19,0.00,8474.87,0.42,1
47655,4814,1000.00,9494.19,10494.19,4194.44,5299.75,0.26,1
47656,4814,1000.00,10494.19,11494.19,2261.27,8232.92,0.32,1
47657,4814,1000.00,11494.19,12494.19,0.00,11494.19,0.22,1
47658,4814,1000.00,12494.19,13494.19,0.00,12006.62,0.42,1
47659,4814,1000.00,13494.19,14494.19,0.00,5135.78,0.05,1
47660,4814,1000.00,14494.19,15494.19,5890.66,8603.53,0.29,1
47661,4814,1000.00,15494.19,16494.19,0.00,15494.19,0.06,1
47662,4814,1000.00,16494.19,17494.19,0.00,7204.16,0.20,1
47663,4814,1000.00,17494.19,18494.19,0.00,17494.19,0.22,1
47664,4814,1000.00,18494.19,19494.19,300.69,18193.49,0.20,1
47665,4814,0.00,18494.19,19494.19,0.00,0.00,0.04,0
47666,4814,-1000.00,17494.19,18494.19,9747.09,9747.09,0.27,0
47667,4814,-1000.00,16494.19,17494.19,0.00,18494.19,0.01,0
47668,4814,-1000.00,15494.19,16494.19,6737.92,10756.27,0.14,0
47669,4814,-1000.00,14494.19,15494.19,3174.94,8338.06,0.30,0
47670,4814,-1000.00,13494.19,14494.19,0.00,1095.83,0.02,0
47671,4814,-1000.00,12494.19,13494.19,0.00,14494.19,0.31,0
47672,4814,-1000.00,11494.19,12494.19,5287.60,8206.58,0.25,0
47673,4814,-1000.00,10494.19,11494.19,3923.29,8570.90,0.10,0
47674,4814,-1000.00,9494.19,10494.19,0.00,11494.19,0.11,0
47675,4814,-1000.00,8494.19,9494.19,2695.18,7799.01,0.37,0
47676,4814,-1000.00,7494.19,8494.19,5469.51,4024.68,0.18,0
47677,4814,0.00,7494.19,8494.19,0.00,0.00,0.08,0
47678,4814,0.00,7494.19,8494.19,0.00,0.00,0.02,0
47679,4814,-1000.00,6494.19,7494.19,0.00,8494.19,0.19,0
47680,4814,-1000.00,5494.19,6494.19,0.00,3188.97,0.11,0
47681,4814,-1000.00,4494.19,5494.19,89.76,6404.43,0.26,0
47682,4814,-1000.00,3494.19,4494.19,0.00,5494.19,0.28,0
47683,4814,-1000.00,2494.19,3494.19,0.00,4494.19,0.06,0
47684,4814,-1000.00,1494.19,2494.19,0.00,3494.19,0.32,0
47685,4814,-1000.00,494.19,1494.19,381.05,2113.14,0.28,0
47686,4814,1000.00,1494.19,2494.19,0.00,868.12,0.14,1
47687,4814,1000.00,2494.19,3494.19,179.92,2314.27,0.32,1
47688,4814,1000.00,3494.19,4494.19,773.60,2720.59,0.39,1
47689,4814,-1000.00,2494.19,3494.19,2229.41,2264.78,0.16,0
47690,4814,-1000.00,1494.19,2494.19,412.99,3081.20,0.03,0
47691,4814,-1000.00,494.19,1494.19,0.00,2257.88,0.14,0
47692,4814,-1000.00,-505.81,494.19,0.00,569.79,0.33,0
47693,4814,-1000.00,-1505.81,-505.81,0.00,333.43,0.20,0
47694,4815,-1000.00,-1000.00,0.00,113.90,886.10,0.32,0
47695,4816,-989.29,-989.29,10.71,619.01,370.28,0.15,0
47696,4816,1000.00,10.71,1010.71,0.00,10.71,0.40,1
47697,4816,1000.00,1010.71,2010.71,0.00,380.34,0.19,1
47698,4816,1000.00,2010.71,3010.71,520.82,1489.89,0.38,1
47699,4816,-1000.00,1010.71,2010.71,1712.59,1298.12,0.07,0
47700,4816,1000.00,2010.71,3010.71,544.74,1465.96,0.37,1
47701,4816,1000.00,3010.71,4010.71,0.00,3010.71,0.03,1
47702,4816,1000.00,4010.71,5010.71,655.49,3355.22,0.13,1
47703,4816,1000.00,5010.71,6010.71,0.00,5010.71,0.37,1
47704,4816,1000.00,6010.71,7010.71,0.00,3824.47,0.34,1
47705,4816,1000.00,7010.71,8010.71,0.00,7010.71,0.01,1
47706,4816,1000.00,8010.71,9010.71,3148.59,4862.12,0.19,1
47707,4816,1000.00,9010.71,10010.71,4505.35,4505.35,0.07,1
47708,4816,-1000.00,8010.71,9010.71,6478.22,0.00,0.03,0
47709,4816,1000.00,9010.71,10010.71,0.00,6213.21,0.14,1
47710,4816,1000.00,10010.71,11010.71,5005.35,5005.35,0.02,1
47711,4816,1000.00,11010.71,12010.71,4818.57,6192.14,0.17,1
47712,4816,1000.00,12010.71,13010.71,3560.28,8450.43,0.35,1
47713,4816,-1000.00,11010.71,12010.71,11292.61,1718.09,0.03,0
47714,4816,1000.00,12010.71,13010.71,0.00,12010.71,0.26,1
47715,4816,1000.00,13010.71,14010.71,1765.20,11245.50,0.43,1
47716,4816,1000.00,14010.71,15010.71,6545.48,7465.23,0.14,1
47717,4816,1000.00,15010.71,16010.71,0.00,15010.71,0.18,1
47718,4816,1000.00,16010.71,17010.71,2488.60,13522.11,0.21,1
47719,4816,1000.00,17010.71,18010.71,0.00,609.06,0.06,1
47720,4816,1000.00,18010.71,19010.71,0.00,18010.71,0.33,1
47721,4816,1000.00,19010.71,20010.71,9099.19,9911.52,0.12,1
47722,4816,1000.00,20010.71,21010.71,6222.21,13788.50,0.34,1
47723,4816,1000.00,21010.71,22010.71,1957.91,19052.79,0.42,1
47724,4816,1000.00,22010.71,23010.71,8738.75,13271.96,0.37,1
47725,4816,1000.00,23010.71,24010.71,11505.35,11505.35,0.06,1
47726,4816,1000.00,24010.71,25010.71,2511.29,21499.41,0.35,1
47727,4816,1000.00,25010.71,26010.71,0.00,25010.71,0.35,1
47728,4816,-1000.00,24010.71,25010.71,8602.17,0.00,0.03,0
47729,4816,1000.00,25010.71,26010.71,0.00,23341.50,0.43,1
47730,4816,1000.00,26010.71,27010.71,0.00,8595.14,0.17,1
47731,4816,1000.00,27010.71,28010.71,0.00,1626.27,0.13,1
47732,4816,1000.00,28010.71,29010.71,7585.97,17552.73,0.18,1
47733,4816,1000.00,29010.71,30010.71,0.00,10397.73,0.08,1
47734,4816,1000.00,30010.71,31010.71,413.65,29597.05,0.25,1
47735,4816,1000.00,31010.71,32010.71,0.00,31010.71,0.07,1
47736,4817,-1000.00,-1000.00,0.00,0.00,1000.00,0.07,0
47737,4818,0.00,0.00,1000.00,0.00,0.00,0.04,0
47738,4818,-955.87,-955.87,44.13,0.00,955.87,0.38,0
47739,4818,-44.13,-1000.00,0.00,2.73,41.40,0.41,0
47740,4819,-1000.00,-1000.00,0.00,186.52,813.48,0.18,0
47741,4820,0.00,0.00,1000.00,0.00,0.00,0.05,0
47742,4820,1000.00,1000.00,2000.00,0.00,1000.00,0.21,1
47743,4820,1000.00,2000.00,3000.00,0.00,1638.39,0.37,1
47744,4820,1000.00,3000.00,4000.00,290.07,2709.93,0.41,1
47745,4820,1000.00,4000.00,5000.00,1356.10,2643.90,0.30,1
47746,4820,1000.00,5000.00,6000.00,0.00,5000.00,0.44,1
47747,4820,1000.00,6000.00,7000.00,0.00,5274.93,0.20,1
47748,4820,1000.00,7000.00,8000.00,727.67,6272.33,0.05,1
47749,4820,1000.00,8000.00,9000.00,0.00,142.70,0.11,1
47750,4820,1000.00,9000.00,10000.00,0.00,9000.00,0.33,1
47751,4820,1000.00,10000.00,11000.00,0.00,5706.67,0.15,1
47752,4820,1000.00,11000.00,12000.00,4322.76,6677.24,0.29,1
47753,4820,0.00,11000.00,12000.00,0.00,0.00,0.05,0
47754,4820,-1000.00,10000.00,11000.00,10069.98,1930.02,0.04,0
47755,4820,1000.00,11000.00,12000.00,0.00,6283.66,0.26,1
47756,4820,1000.00,12000.00,13000.00,3287.06,8712.94,0.22,1
47757,4820,1000.00,13000.00,14000.00,0.00,13000.00,0.07,1
47758,4820,-1000.00,12000.00,13000.00,5928.88,2342.14,0.13,0
47759,4820,1000.00,13000.00,14000.00,0.00,13000.00,0.10,1
47760,4820,1000.00,14000.00,15000.00,0.00,7895.43,0.30,1
47761,4820,1000.00,15000.00,16000.00,5919.91,9080.09,0.29,1
47762,4820,1000.00,16000.00,17000.00,3317.53,12682.47,0.40,1
47763,4820,-1000.00,15000.00,16000.00,0.00,5601.38,0.23,0
47764,4820,-1000.00,14000.00,15000.00,4938.88,11061.12,0.34,0
47765,4820,-1000.00,13000.00,14000.00,0.00,13281.72,0.20,0
47766,4820,-1000.00,12000.00,13000.00,0.00,14000.00,0.11,0
47767,4820,-1000.00,11000.00,12000.00,0.00,13000.00,0.07,0
47768,4820,-1000.00,10000.00,11000.00,3624.40,8375.60,0.16,0
47769,4820,-1000.00,9000.00,10000.00,2409.77,8590.23,0.37,0
47770,4820,-1000.00,8000.00,9000.00,0.00,1913.40,0.17,0
47771,4820,-1000.00,7000.00,8000.00,0.00,8676.08,0.07,0
47772,4820,-1000.00,6000.00,7000.00,0.00,5865.28,0.40,0
47773,4820,-1000.00,5000.00,6000.00,2083.79,4916.21,0.34,0
47774,4820,-1000.00,4000.00,5000.00,0.00,6000.00,0.30,0
47775,4820,-1000.00,3000.00,4000.00,0.00,5000.00,0.11,0
47776,4820,-1000.00,2000.00,3000.00,0.00,4000.00,0.05,0
47777,4820,-1000.00,1000.00,2000.00,968.66,2031.34,0.34,0
47778,4820,-1000.00,0.00,1000.00,468.38,1531.62,0.38,0
47779,4820,0.00,0.00,1000.00,0.00,0.00,0.04,0
47780,4820,-1000.00,-1000.00,0.00,394.50,605.50,0.24,0
47781,4821,-1000.00,-1000.00,0.00,563.59,436.41,0.16,0
47782,4822,1000.00,1000.00,2000.00,0.00,887.92,0.10,1
47783,4822,1000.00,2000.00,3000.00,282.30,1394.07,0.38,1
47784,4822,-1000.00,1000.00,2000.00,1206.32,1172.14,0.21,0
47785,4822,1000.00,2000.00,3000.00,0.00,712.55,0.10,1
47786,4822,1000.00,3000.00,4000.00,0.00,3000.00,0.44,1
47787,4822,1000.00,4000.00,5000.00,128.26,3871.74,0.20,1
47788,4822,1000.00,5000.00,6000.00,0.00,5000.00,0.21,1
47789,4822,1000.00,6000.00,7000.00,0.00,5313.15,0.10,1
47790,4822,1000.00,7000.00,8000.00,0.00,1958.53,0.21,1
47791,4822,-1000.00,6000.00,7000.00,4437.72,3562.28,0.16,0
47792,4822,1000.00,7000.00,8000.00,3500.00,3500.00,0.07,1
47793,4822,1000.00,8000.00,9000.00,3122.90,4877.10,0.05,1
47794,4822,1000.00,9000.00,10000.00,2584.47,6415.53,0.38,1
47795,4822,1000.00,10000.00,11000.00,1736.57,8263.43,0.36,1
47796,4822,1000.00,11000.00,12000.00,4930.62,6069.38,0.25,1
47797,4822,1000.00,12000.00,13000.00,0.00,10570.35,0.17,1
47798,4822,1000.00,13000.00,14000.00,0.00,8535.37,0.33,1
47799,4822,1000.00,14000.00,15000.00,6940.52,7059.48,0.11,1
47800,4822,-1000.00,13000.00,14000.00,5739.50,0.00,0.06,0
47801,4822,1000.00,14000.00,15000.00,3050.48,10949.52,0.28,1
47802,4822,1000.00,15000.00,16000.00,0.00,15000.00,0.08,1
47803,4822,1000.00,16000.00,17000.00,0.00,16000.00,0.34,1
47804,4822,-1000.00,15000.00,16000.00,12139.14,4860.86,0.10,0
47805,4822,1000.00,16000.00,17000.00,0.00,16000.00,0.16,1
47806,4822,1000.00,17000.00,18000.00,0.00,17000.00,0.33,1
47807,4822,1000.00,18000.00,19000.00,8350.45,9649.55,0.43,1
47808,4822,1000.00,19000.00,20000.00,0.00,13547.31,0.39,1
47809,4822,1000.00,20000.00,21000.00,0.00,11114.54,0.31,1
47810,4822,1000.00,21000.00,22000.00,5970.01,15029.99,0.10,1
47811,4822,1000.00,22000.00,23000.00,3277.69,18722.31,0.28,1
47812,4822,1000.00,23000.00,24000.00,0.00,23000.00,0.44,1
47813,4822,1000.00,24000.00,25000.00,5024.80,18975.20,0.39,1
47814,4822,1000.00,25000.00,26000.00,12500.00,12500.00,0.02,1
47815,4822,1000.00,26000.00,27000.00,12871.95,13128.05,0.11,1
47816,4822,1000.00,27000.00,28000.00,0.00,27000.00,0.26,1
47817,4822,1000.00,28000.00,29000.00,0.00,28000.00,0.15,1
47818,4822,-1000.00,27000.00,28000.00,4869.52,2621.20,0.13,0
47819,4822,1000.00,28000.00,29000.00,0.00,28000.00,0.21,1
47820,4822,1000.00,29000.00,30000.00,0.00,20782.10,0.33,1
47821,4822,1000.00,30000.00,31000.00,9395.80,20604.20,0.25,1
47822,4822,1000.00,31000.00,32000.00,15012.69,15987.31,0.13,1
47823,4822,1000.00,32000.00,33000.00,0.00,32000.00,0.21,1
47824,4822,1000.00,33000.00,34000.00,1460.29,31539.71,0.43,1
47825,4823,-654.06,-654.06,345.94,654.06,0.00,0.01,0
47826,4823,-1000.00,-1654.06,-654.06,0.00,345.94,0.21,0
47827,4824,-298.19,-298.19,701.81,0.00,298.19,0.21,0
47828,4824,-1000.00,-1298.19,-298.19,207.19,84.53,0.36,0
47829,4825,-1000.00,-1000.00,0.00,125.60,874.40,0.30,0
47830,4826,-473.37,-473.37,526.63,461.59,11.78,0.33,0
47831,4826,-1000.00,-1473.37,-473.37,108.37,418.26,0.17,0
47832,4827,-3.45,-3.45,996.55,0.00,3.45,0.39,0
47833,4827,1000.00,996.55,1996.55,496.94,93.85,0.31,1
47834,4827,0.00,996.55,1996.55,0.00,0.00,0.32,0
47835,4827,1000.00,1996.55,2996.55,749.52,0.00,0.18,1
47836,4827,-278.17,1718.38,2718.38,0.00,278.17,0.36,0
47837,4827,-1000.00,718.38,1718.38,819.61,1898.77,0.15,0
47838,4827,-1000.00,-281.62,718.38,595.42,1122.96,0.17,0
47839,4827,-60.11,-341.73,658.27,0.00,60.11,0.42,0
47840,4827,0.00,-341.73,658.27,0.00,0.00,0.08,0
47841,4827,0.00,-341.73,658.27,0.00,0.00,0.17,0
47842,4827,0.00,-341.73,658.27,0.00,0.00,0.44,0
47843,4827,-166.90,-508.63,491.37,0.00,166.90,0.20,0
47844,4827,0.00,-508.63,491.37,0.00,0.00,0.25,0
47845,4827,0.00,-508.63,491.37,0.00,0.00,0.06,0
47846,4827,-62.95,-571.58,428.42,0.00,62.95,0.37,0
47847,4827,0.00,-571.58,428.42,0.00,0.00,0.18,0
47848,4827,-1000.00,-1571.58,-571.58,0.00,132.19,0.39,0
47849,4828,-1000.00,-1000.00,0.00,0.00,912.87,0.10,0
47850,4829,-1000.00,-1000.00,0.00,95.75,719.73,0.40,0
47851,4830,-762.83,-762.83,237.17,66.11,696.72,0.22,0
47852,4830,-87.09,-849.92,150.08,0.00,87.09,0.26,0
47853,4830,-16.59,-866.50,133.50,0.00,16.59,0.18,0
47854,4830,-2.58,-869.08,130.92,0.00,2.58,0.43,0
47855,4830,-100.75,-969.84,30.16,39.83,60.93,0.27,0
47856,4830,-1.26,-971.10,28.90,0.00,1.26,0.36,0
47857,4830,1000.00,28.90,1028.90,8.62,0.00,0.35,1
47858,4830,-544.27,-515.37,484.63,0.00,544.27,0.34,0
47859,4830,-484.63,-1000.00,0.00,161.26,323.37,0.34,0
47860,4831,1000.00,1000.00,2000.00,309.29,135.35,0.38,1
47861,4831,-1000.00,0.00,1000.00,757.13,1242.87,0.05,0
47862,4831,-1000.00,-1000.00,0.00,217.59,782.41,0.18,0
47863,4831,-0.00,-1000.00,0.00,0.00,0.00,0.01,0
47864,4832,-1000.00,-1000.00,0.00,878.61,121.39,0.02,0
47865,4833,-798.83,-798.83,201.17,0.00,798.83,0.35,0
47866,4833,-201.17,-1000.00,0.00,74.13,127.04,0.01,0
47867,4834,-1000.00,-1000.00,0.00,637.97,362.03,0.12,0
47868,4835,-1000.00,-1000.00,0.00,479.39,520.61,0.22,0
47869,4836,-1000.00,-1000.00,0.00,110.74,258.06,0.40,0
47870,4837,-560.42,-560.42,439.58,0.00,560.42,0.28,0
47871,4837,1000.00,439.58,1439.58,234.25,205.33,0.17,1
47872,4837,-1000.00,-560.42,439.58,0.00,1168.71,0.15,0
47873,4837,-245.26,-805.68,194.32,0.00,245.26,0.31,0
47874,4837,-194.32,-1000.00,0.00,16.94,177.38,0.09,0
47875,4838,-1000.00,-1000.00,0.00,0.00,1000.00,0.37,0
47876,4839,-107.90,-107.90,892.10,107.90,0.00,0.42,0
47877,4839,-1000.00,-1107.90,-107.90,0.00,720.36,0.16,0
47878,4840,-1000.00,-1000.00,0.00,654.56,345.44,0.14,0
47879,4841,0.00,0.00,1000.00,0.00,0.00,0.14,0
47880,4841,-629.43,-629.43,370.57,0.00,629.43,0.12,0
47881,4841,0.00,-629.43,370.57,0.00,0.00,0.37,0
47882,4841,0.00,-629.43,370.57,0.00,0.00,0.06,0
47883,4841,-370.57,-1000.00,0.00,158.26,212.31,0.05,0
47884,4842,-1000.00,-1000.00,0.00,275.72,724.28,0.34,0
47885,4843,1000.00,1000.00,2000.00,0.00,534.41,0.05,1
47886,4843,-1000.00,0.00,1000.00,1605.13,394.87,0.05,0
47887,4843,1000.00,1000.00,2000.00,0.00,497.87,0.30,1
47888,4843,1000.00,2000.00,3000.00,0.00,2000.00,0.13,1
47889,4843,0.00,2000.00,3000.00,0.00,0.00,0.07,0
47890,4843,1000.00,3000.00,4000.00,0.00,3000.00,0.03,1
47891,4843,1000.00,4000.00,5000.00,129.73,3870.27,0.35,1
47892,4843,1000.00,5000.00,6000.00,443.45,4556.55,0.43,1
47893,4843,1000.00,6000.00,7000.00,0.00,1480.35,0.20,1
47894,4843,1000.00,7000.00,8000.00,1567.25,5432.75,0.26,1
47895,4843,1000.00,8000.00,9000.00,0.00,8000.00,0.13,1
47896,4843,1000.00,9000.00,10000.00,0.00,9000.00,0.17,1
47897,4843,1000.00,10000.00,11000.00,91.78,2519.22,0.20,1
47898,4843,1000.00,11000.00,12000.00,818.21,10181.79,0.35,1
47899,4843,0.00,11000.00,12000.00,0.00,0.00,0.03,0
47900,4843,1000.00,12000.00,13000.00,0.00,12000.00,0.05,1
47901,4843,1000.00,13000.00,14000.00,3493.41,9506.59,0.32,1
47902,4843,1000.00,14000.00,15000.00,4020.00,9980.00,0.02,1
47903,4843,1000.00,15000.00,16000.00,7500.00,7500.00,0.05,1
47904,4843,1000.00,16000.00,17000.00,1920.31,14079.69,0.21,1
47905,4843,1000.00,17000.00,18000.00,8500.00,8500.00,0.33,1
47906,4843,1000.00,18000.00,19000.00,9000.00,9000.00,0.09,1
47907,4843,1000.00,19000.00,20000.00,6061.47,12938.53,0.28,1
47908,4843,-1000.00,18000.00,19000.00,20000.00,0.00,0.01,0
47909,4843,-1000.00,17000.00,18000.00,0.00,19000.00,0.32,0
47910,4843,-1000.00,16000.00,17000.00,0.00,15859.42,0.43,0
47911,4843,0.00,16000.00,17000.00,0.00,0.00,0.06,0
47912,4843,-1000.00,15000.00,16000.00,3011.55,3863.76,0.19,0
47913,4843,0.00,15000.00,16000.00,0.00,0.00,0.00,0
47914,4843,-1000.00,14000.00,15000.00,3118.52,12881.48,0.40,0
47915,4843,-1000.00,13000.00,14000.00,3253.74,11746.26,0.40,0
47916,4843,-1000.00,12000.00,13000.00,5289.51,8710.49,0.30,0
47917,4843,-1000.00,11000.00,12000.00,6028.11,0.00,0.06,0
47918,4843,-1000.00,10000.00,11000.00,0.00,12000.00,0.03,0
47919,4843,-1000.00,9000.00,10000.00,0.00,11000.00,0.38,0
47920,4843,-1000.00,8000.00,9000.00,0.00,6336.86,0.21,0
47921,4843,-1000.00,7000.00,8000.00,5089.51,3910.49,0.06,0
47922,4843,-1000.00,6000.00,7000.00,6219.80,1780.20,0.05,0
47923,4843,-1000.00,5000.00,6000.00,0.00,7000.00,0.28,0
47924,4843,-1000.00,4000.00,5000.00,0.00,6000.00,0.42,0
47925,4843,-1000.00,3000.00,4000.00,0.00,4151.85,0.25,0
47926,4843,-1000.00,2000.00,3000.00,0.00,4000.00,0.30,0
47927,4843,-1000.00,1000.00,2000.00,1724.90,1275.10,0.12,0
47928,4843,-1000.00,0.00,1000.00,0.00,2000.00,0.35,0
47929,4843,0.00,0.00,1000.00,0.00,0.00,0.01,0
47930,4843,-1000.00,-1000.00,0.00,0.00,1000.00,0.03,0
47931,4844,1000.00,1000.00,2000.00,13.90,679.64,0.38,1
47932,4844,1000.00,2000.00,3000.00,57.97,1617.22,0.42,1
47933,4844,1000.00,3000.00,4000.00,0.00,2120.57,0.36,1
47934,4844,1000.00,4000.00,5000.00,0.00,2432.95,0.23,1
47935,4844,1000.00,5000.00,6000.00,0.00,2440.20,0.31,1
47936,4844,1000.00,6000.00,7000.00,0.00,6000.00,0.14,1
47937,4844,1000.00,7000.00,8000.00,1638.02,5361.98,0.35,1
47938,4844,1000.00,8000.00,9000.00,2144.65,5855.35,0.37,1
47939,4844,1000.00,9000.00,10000.00,0.00,4866.11,0.31,1
47940,4844,-1000.00,8000.00,9000.00,3232.99,0.00,0.06,0
47941,4844,1000.00,9000.00,10000.00,2230.19,6769.81,0.08,1
47942,4844,-1000.00,8000.00,9000.00,5006.54,4993.46,0.02,0
47943,4844,1000.00,9000.00,10000.00,520.99,8479.01,0.27,1
47944,4844,1000.00,10000.00,11000.00,1444.55,8555.45,0.42,1
47945,4844,1000.00,11000.00,12000.00,0.00,11000.00,0.39,1
47946,4844,-1000.00,10000.00,11000.00,1730.19,1607.31,0.15,0
47947,4844,1000.00,11000.00,12000.00,2422.71,8577.29,0.35,1
47948,4844,1000.00,12000.00,13000.00,6000.00,6000.00,0.03,1
47949,4844,-1000.00,11000.00,12000.00,0.00,13000.00,0.14,0
47950,4844,-1000.00,10000.00,11000.00,0.00,12000.00,0.17,0
47951,4844,-1000.00,9000.00,10000.00,3658.50,7341.50,0.34,0
47952,4844,-1000.00,8000.00,9000.00,0.00,7613.07,0.04,0
47953,4844,0.00,8000.00,9000.00,0.00,0.00,0.04,0
47954,4844,1000.00,9000.00,10000.00,325.90,3440.00,0.07,1
47955,4844,-1000.00,8000.00,9000.00,2111.13,0.00,0.03,0
47956,4844,1000.00,9000.00,10000.00,0.00,9000.00,0.07,1
47957,4844,1000.00,10000.00,11000.00,0.00,4359.06,0.26,1
47958,4844,1000.00,11000.00,12000.00,0.00,11000.00,0.30,1
47959,4844,1000.00,12000.00,13000.00,0.00,12000.00,0.33,1
47960,4844,1000.00,13000.00,14000.00,2652.21,10347.79,0.32,1
47961,4844,1000.00,14000.00,15000.00,1854.05,12145.95,0.21,1
47962,4844,1000.00,15000.00,16000.00,0.00,15000.00,0.07,1
47963,4844,1000.00,16000.00,17000.00,2714.31,13285.69,0.39,1
47964,4844,1000.00,17000.00,18000.00,211.84,13460.47,0.42,1
47965,4844,-1000.00,16000.00,17000.00,9483.74,8516.26,0.16,0
47966,4844,1000.00,17000.00,18000.00,0.00,17000.00,0.10,1
47967,4844,1000.00,18000.00,19000.00,1785.00,16215.00,0.36,1
47968,4844,1000.00,19000.00,20000.00,0.00,19000.00,0.39,1
47969,4844,1000.00,20000.00,21000.00,0.00,18640.46,0.40,1
47970,4844,1000.00,21000.00,22000.00,0.00,7564.72,0.18,1
47971,4844,1000.00,22000.00,23000.00,0.00,22000.00,0.04,1
47972,4844,-1000.00,21000.00,22000.00,13269.86,9730.14,0.10,0
47973,4844,1000.00,22000.00,23000.00,0.00,22000.00,0.26,1
47974,4844,1000.00,23000.00,24000.00,0.00,23000.00,0.27,1
47975,4844,1000.00,24000.00,25000.00,6893.10,17106.90,0.36,1
47976,4844,1000.00,25000.00,26000.00,3020.54,11891.65,0.30,1
47977,4844,1000.00,26000.00,27000.00,2343.68,23656.32,0.40,1
47978,4845,-1000.00,-1000.00,0.00,284.82,715.18,0.34,0
47979,4846,1000.00,1000.00,2000.00,939.69,60.31,0.03,1
47980,4846,0.00,1000.00,2000.00,0.00,0.00,0.25,0
47981,4846,0.00,1000.00,2000.00,0.00,0.00,0.35,0
47982,4846,1000.00,2000.00,3000.00,1047.42,952.58,0.17,1
47983,4846,-1000.00,1000.00,2000.00,1500.00,1500.00,0.04,0
47984,4846,1000.00,2000.00,3000.00,822.74,602.31,0.31,1
47985,4846,-1000.00,1000.00,2000.00,263.97,2736.03,0.41,0
47986,4846,-1000.00,0.00,1000.00,494.88,1505.12,0.16,0
47987,4846,1000.00,1000.00,2000.00,793.25,0.00,0.06,1
47988,4846,-1000.00,0.00,1000.00,511.73,1488.27,0.38,0
47989,4846,-362.78,-362.78,637.22,119.18,243.59,0.41,0
47990,4846,-637.22,-1000.00,0.00,0.00,637.22,0.41,0
47991,4847,1000.00,1000.00,2000.00,0.00,1000.00,0.04,1
47992,4847,-1000.00,0.00,1000.00,1429.51,240.94,0.20,0
47993,4847,1000.00,1000.00,2000.00,391.90,608.10,0.25,1
47994,4847,1000.00,2000.00,3000.00,0.00,2000.00,0.24,1
47995,4847,1000.00,3000.00,4000.00,0.00,3000.00,0.15,1
47996,4847,1000.00,4000.00,5000.00,0.00,271.98,0.04,1
47997,4847,1000.00,5000.00,6000.00,0.00,5000.00,0.25,1
47998,4847,1000.00,6000.00,7000.00,0.00,2982.63,0.27,1
47999,4847,1000.00,7000.00,8000.00,1715.33,5284.67,0.17,1
48000,4847,1000.00,8000.00,9000.00,2005.08,5994.92,0.01,1
48001,4847,-1000.00,7000.00,8000.00,3795.27,2903.20,0.18,0
48002,4847,1000.00,8000.00,9000.00,0.00,2741.50,0.21,1
48003,4847,1000.00,9000.00,10000.00,1799.48,7200.52,0.30,1
48004,4847,-409.71,8590.29,9590.29,409.71,0.00,0.05,0
48005,4847,1000.00,9590.29,10590.29,0.00,9590.29,0.11,1
48006,4847,-1000.00,8590.29,9590.29,8503.34,2086.94,0.07,0
48007,4847,1000.00,9590.29,10590.29,2504.01,7086.27,0.21,1
48008,4847,1000.00,10590.29,11590.29,4751.44,5838.84,0.13,1
48009,4847,1000.00,11590.29,12590.29,0.00,11590.29,0.27,1
48010,4847,1000.00,12590.29,13590.29,4071.14,8519.15,0.30,1
48011,4847,1000.00,13590.29,14590.29,0.00,13590.29,0.44,1
48012,4848,-1000.00,-1000.00,0.00,500.00,500.00,0.00,0
48013,4849,-1000.00,-1000.00,0.00,348.61,651.39,0.08,0
48014,4850,1000.00,1000.00,2000.00,0.00,186.97,0.12,1
48015,4850,1000.00,2000.00,3000.00,1000.00,1000.00,0.08,1
48016,4850,1000.00,3000.00,4000.00,186.60,1335.11,0.29,1
48017,4850,1000.00,4000.00,5000.00,0.00,3500.86,0.43,1
48018,4850,1000.00,5000.00,6000.00,0.00,2471.49,0.30,1
48019,4850,1000.00,6000.00,7000.00,321.39,4725.02,0.26,1
48020,4850,0.00,6000.00,7000.00,0.00,0.00,0.01,0
48021,4850,1000.00,7000.00,8000.00,1220.59,5779.41,0.39,1
48022,4850,1000.00,8000.00,9000.00,0.00,7733.32,0.13,1
48023,4850,1000.00,9000.00,10000.00,532.75,8467.25,0.44,1
48024,4850,1000.00,10000.00,11000.00,0.00,10000.00,0.12,1
48025,4850,1000.00,11000.00,12000.00,137.47,10862.53,0.44,1
48026,4850,1000.00,12000.00,13000.00,4868.07,7131.93,0.15,1
48027,4850,-1000.00,11000.00,12000.00,6707.58,1777.89,0.21,0
48028,4850,1000.00,12000.00,13000.00,0.00,9203.51,0.27,1
48029,4850,1000.00,13000.00,14000.00,0.00,8001.58,0.27,1
48030,4850,-1000.00,12000.00,13000.00,9786.20,4213.80,0.15,0
48031,4850,1000.00,13000.00,14000.00,1946.34,5675.73,0.29,1
48032,4850,1000.00,14000.00,15000.00,0.00,4023.95,0.07,1
48033,4850,-1000.00,13000.00,14000.00,9273.06,5726.94,0.02,0
48034,4850,-1000.00,12000.00,13000.00,9517.24,4482.76,0.07,0
48035,4850,1000.00,13000.00,14000.00,3493.99,9506.01,0.05,1
48036,4850,-1000.00,12000.00,13000.00,4071.74,9928.26,0.26,0
48037,4850,-1000.00,11000.00,12000.00,6920.42,6079.58,0.15,0
48038,4850,-1000.00,10000.00,11000.00,0.00,9402.50,0.12,0
48039,4850,-1000.00,9000.00,10000.00,0.00,11000.00,0.01,0
48040,4850,-1000.00,8000.00,9000.00,4288.88,5711.12,0.16,0
48041,4850,-1000.00,7000.00,8000.00,4500.00,4500.00,0.03,0
48042,4850,-1000.00,6000.00,7000.00,3816.73,4183.27,0.13,0
48043,4850,-1000.00,5000.00,6000.00,2758.65,4241.35,0.04,0
48044,4850,-1000.00,4000.00,5000.00,5805.83,36.77,0.03,0
48045,4850,-1000.00,3000.00,4000.00,1828.31,3171.69,0.31,0
48046,4850,-1000.00,2000.00,3000.00,0.00,4000.00,0.31,0
48047,4850,-1000.00,1000.00,2000.00,628.96,2371.04,0.21,0
48048,4850,-1000.00,0.00,1000.00,984.76,1015.24,0.07,0
48049,4850,-1000.00,-1000.00,0.00,446.08,242.59,0.15,0
48050,4851,1000.00,1000.00,2000.00,0.00,1000.00,0.42,1
48051,4851,1000.00,2000.00,3000.00,760.89,1239.11,0.06,1
48052,4851,-1000.00,1000.00,2000.00,2174.68,738.32,0.10,0
48053,4851,1000.00,2000.00,3000.00,124.59,1069.85,0.33,1
48054,4851,1000.00,3000.00,4000.00,969.36,2030.64,0.26,1
48055,4851,1000.00,4000.00,5000.00,0.00,4000.00,0.31,1
48056,4851,1000.00,5000.00,6000.00,1197.39,3802.61,0.39,1
48057,4851,-1000.00,4000.00,5000.00,3776.51,1326.09,0.11,0
48058,4851,1000.00,5000.00,6000.00,0.00,2609.13,0.32,1
48059,4851,-1000.00,4000.00,5000.00,3500.82,2499.18,0.06,0
48060,4851,1000.00,5000.00,6000.00,0.00,4537.64,0.24,1
48061,4851,1000.00,6000.00,7000.00,0.00,6000.00,0.15,1
48062,4851,1000.00,7000.00,8000.00,0.00,5862.57,0.34,1
48063,4851,1000.00,8000.00,9000.00,0.00,6743.98,0.34,1
48064,4851,1000.00,9000.00,10000.00,0.00,7463.55,0.40,1
48065,4851,1000.00,10000.00,11000.00,4467.39,5532.61,0.24,1
48066,4851,1000.00,11000.00,12000.00,1149.52,9850.48,0.42,1
48067,4851,1000.00,12000.00,13000.00,4676.53,7212.48,0.29,1
48068,4851,1000.00,13000.00,14000.00,4598.95,8401.05,0.32,1
48069,4851,-1000.00,12000.00,13000.00,9209.11,4790.89,0.04,0
48070,4851,1000.00,13000.00,14000.00,937.78,12062.22,0.41,1
48071,4851,-1000.00,12000.00,13000.00,13505.25,494.75,0.03,0
48072,4851,-1000.00,11000.00,12000.00,0.00,10786.99,0.41,0
48073,4851,-1000.00,10000.00,11000.00,3251.73,8748.27,0.37,0
48074,4851,-1000.00,9000.00,10000.00,0.00,11000.00,0.25,0
48075,4851,-1000.00,8000.00,9000.00,1748.30,8251.70,0.20,0
48076,4851,-1000.00,7000.00,8000.00,0.00,6073.08,0.37,0
48077,4851,-1000.00,6000.00,7000.00,0.00,8000.00,0.17,0
48078,4851,-1000.00,5000.00,6000.00,0.00,5514.80,0.13,0
48079,4851,-1000.00,4000.00,5000.00,827.13,5172.87,0.41,0
48080,4851,-1000.00,3000.00,4000.00,2278.99,2721.01,0.18,0
48081,4851,-1000.00,2000.00,3000.00,0.00,4000.00,0.20,0
48082,4851,-1000.00,1000.00,2000.00,0.00,3000.00,0.33,0
48083,4851,-1000.00,0.00,1000.00,65.99,1934.01,0.44,0
48084,4851,-1000.00,-1000.00,0.00,0.00,1000.00,0.21,0
48085,4852,1000.00,1000.00,2000.00,195.01,804.99,0.12,1
48086,4852,-1000.00,0.00,1000.00,354.63,1645.37,0.34,0
48087,4852,-1000.00,-1000.00,0.00,0.00,531.25,0.21,0
48088,4853,1000.00,1000.00,2000.00,325.46,674.54,0.24,1
48089,4853,1000.00,2000.00,3000.00,993.56,1006.44,0.16,1
48090,4853,1000.00,3000.00,4000.00,0.00,3000.00,0.01,1
48091,4853,0.00,3000.00,4000.00,0.00,0.00,0.03,0
48092,4853,-396.03,2603.97,3603.97,396.03,0.00,0.03,0
48093,4853,-1000.00,1603.97,2603.97,2473.95,513.15,0.08,0
48094,4853,1000.00,2603.97,3603.97,0.00,2519.16,0.27,1
48095,4853,1000.00,3603.97,4603.97,0.00,3074.42,0.38,1
48096,4853,1000.00,4603.97,5603.97,1892.77,2711.20,0.22,1
48097,4853,1000.00,5603.97,6603.97,0.00,4596.93,0.13,1
48098,4853,1000.00,6603.97,7603.97,0.00,6603.97,0.07,1
48099,4853,1000.00,7603.97,8603.97,2497.27,5106.70,0.12,1
48100,4853,1000.00,8603.97,9603.97,0.00,6801.03,0.24,1
48101,4853,1000.00,9603.97,10603.97,0.00,9603.97,0.20,1
48102,4853,1000.00,10603.97,11603.97,1233.85,7721.97,0.39,1
48103,4853,1000.00,11603.97,12603.97,0.00,11603.97,0.29,1
48104,4853,-1000.00,10603.97,11603.97,10650.02,1953.95,0.01,0
48105,4853,1000.00,11603.97,12603.97,362.45,11241.52,0.18,1
48106,4853,1000.00,12603.97,13603.97,2344.90,2527.93,0.17,1
48107,4853,1000.00,13603.97,14603.97,0.00,12337.97,0.44,1
48108,4853,1000.00,14603.97,15603.97,0.00,13555.79,0.31,1
48109,4853,1000.00,15603.97,16603.97,0.00,8270.56,0.29,1
48110,4853,1000.00,16603.97,17603.97,7445.68,9158.29,0.24,1
48111,4853,1000.00,17603.97,18603.97,4179.90,13424.07,0.04,1
48112,4853,1000.00,18603.97,19603.97,4620.08,13748.56,0.40,1
48113,4853,1000.00,19603.97,20603.97,8675.75,10928.22,0.44,1
48114,4853,1000.00,20603.97,21603.97,0.00,5825.23,0.21,1
48115,4853,1000.00,21603.97,22603.97,0.00,21603.97,0.20,1
48116,4853,1000.00,22603.97,23603.97,11301.98,11301.98,0.00,1
48117,4853,1000.00,23603.97,24603.97,3670.77,19933.20,0.27,1
48118,4853,1000.00,24603.97,25603.97,12190.98,12412.99,0.31,1
48119,4853,1000.00,25603.97,26603.97,213.45,25254.84,0.44,1
48120,4853,1000.00,26603.97,27603.97,4632.11,21971.86,0.05,1
48121,4853,1000.00,27603.97,28603.97,0.00,27603.97,0.37,1
48122,4853,1000.00,28603.97,29603.97,0.00,28603.97,0.44,1
48123,4853,1000.00,29603.97,30603.97,0.00,28613.59,0.41,1
48124,4853,1000.00,30603.97,31603.97,0.00,30603.97,0.25,1
48125,4853,1000.00,31603.97,32603.97,12182.97,19421.00,0.01,1
48126,4853,-1000.00,30603.97,31603.97,16929.93,15674.04,0.21,0
48127,4853,1000.00,31603.97,32603.97,0.00,27892.45,0.18,1
48128,4853,1000.00,32603.97,33603.97,0.00,32603.97,0.25,1
48129,4853,1000.00,33603.97,34603.97,16801.98,16801.98,0.10,1
48130,4853,1000.00,34603.97,35603.97,13349.83,21254.14,0.16,1
48131,4853,1000.00,35603.97,36603.97,0.00,35603.97,0.43,1
48132,4853,1000.00,36603.97,37603.97,14760.69,21843.28,0.33,1
48133,4854,-114.28,-114.28,885.72,114.28,0.00,0.01,0
48134,4854,1000.00,885.72,1885.72,0.00,885.72,0.27,1
48135,4854,1000.00,1885.72,2885.72,0.00,247.97,0.08,1
48136,4854,1000.00,2885.72,3885.72,0.00,2051.12,0.30,1
48137,4854,1000.00,3885.72,4885.72,0.00,2163.47,0.24,1
48138,4854,1000.00,4885.72,5885.72,0.00,675.87,0.16,1
48139,4854,1000.00,5885.72,6885.72,1025.13,2396.92,0.26,1
48140,4854,-1000.00,4885.72,5885.72,6885.72,0.00,0.01,0
48141,4854,1000.00,5885.72,6885.72,0.00,5885.72,0.33,1
48142,4854,1000.00,6885.72,7885.72,1533.17,5352.55,0.28,1
48143,4854,1000.00,7885.72,8885.72,3560.29,4325.42,0.35,1
48144,4854,1000.00,8885.72,9885.72,0.00,8885.72,0.05,1
48145,4854,-1000.00,7885.72,8885.72,7397.82,2487.89,0.13,0
48146,4854,1000.00,8885.72,9885.72,0.00,4120.09,0.00,1
48147,4854,-648.76,8236.95,9236.95,648.76,0.00,0.07,0
48148,4854,1000.00,9236.95,10236.95,4618.48,4618.48,0.04,1
48149,4854,1000.00,10236.95,11236.95,0.00,10236.95,0.34,1
48150,4854,0.00,10236.95,11236.95,0.00,0.00,0.07,0
48151,4854,-1000.00,9236.95,10236.95,11236.95,0.00,0.02,0
48152,4854,1000.00,10236.95,11236.95,1771.51,8465.44,0.41,1
48153,4854,1000.00,11236.95,12236.95,4897.85,6339.10,0.17,1
48154,4854,1000.00,12236.95,13236.95,0.00,12236.95,0.37,1
48155,4854,1000.00,13236.95,14236.95,6195.40,7041.55,0.14,1
48156,4854,1000.00,14236.95,15236.95,0.00,14236.95,0.33,1
48157,4854,0.00,14236.95,15236.95,0.00,0.00,0.00,0
48158,4854,-1000.00,13236.95,14236.95,14080.12,1156.84,0.03,0
48159,4854,1000.00,14236.95,15236.95,846.94,6984.53,0.31,1
48160,4854,1000.00,15236.95,16236.95,0.00,7627.86,0.29,1
48161,4854,-1000.00,14236.95,15236.95,10031.65,0.00,0.01,0
48162,4854,1000.00,15236.95,16236.95,0.00,15236.95,0.11,1
48163,4854,1000.00,16236.95,17236.95,0.00,16236.95,0.16,1
48164,4854,1000.00,17236.95,18236.95,0.00,17236.95,0.06,1
48165,4854,1000.00,18236.95,19236.95,0.00,18236.95,0.42,1
48166,4854,-1000.00,17236.95,18236.95,11280.44,7481.81,0.16,0
48167,4854,1000.00,18236.95,19236.95,1830.18,16406.77,0.04,1
48168,4854,-1000.00,17236.95,18236.95,11114.73,8122.23,0.07,0
48169,4854,1000.00,18236.95,19236.95,3261.98,10369.86,0.33,1
48170,4854,1000.00,19236.95,20236.95,3839.56,15397.40,0.27,1
48171,4854,1000.00,20236.95,21236.95,7879.87,12357.09,0.18,1
48172,4854,1000.00,21236.95,22236.95,0.00,5111.79,0.09,1
48173,4854,1000.00,22236.95,23236.95,10027.38,12209.58,0.15,1
48174,4854,1000.00,23236.95,24236.95,0.00,23236.95,0.06,1
48175,4854,1000.00,24236.95,25236.95,0.00,9907.44,0.27,1
48176,4854,1000.00,25236.95,26236.95,0.00,6571.68,0.16,1
48177,4854,-1000.00,24236.95,25236.95,13118.48,13118.48,0.39,0
48178,4854,-1000.00,23236.95,24236.95,0.00,22319.67,0.30,0
48179,4854,-1000.00,22236.95,23236.95,0.00,24236.95,0.32,0
48180,4854,-1000.00,21236.95,22236.95,9821.69,13415.27,0.19,0
48181,4854,-1000.00,20236.95,21236.95,6793.03,15443.92,0.31,0
48182,4854,-1000.00,19236.95,20236.95,0.00,21236.95,0.18,0
48183,4854,-1000.00,18236.95,19236.95,7316.67,12920.28,0.28,0
48184,4854,-1000.00,17236.95,18236.95,1505.41,17731.55,0.42,0
48185,4854,-1000.00,16236.95,17236.95,5618.22,12618.74,0.10,0
48186,4854,-1000.00,15236.95,16236.95,6250.74,10986.21,0.20,0
48187,4854,-1000.00,14236.95,15236.95,3006.53,9101.74,0.32,0
48188,4854,-1000.00,13236.95,14236.95,6663.68,8573.27,0.18,0
48189,4854,-1000.00,12236.95,13236.95,5775.60,8461.36,0.08,0
48190,4854,-1000.00,11236.95,12236.95,0.00,13236.95,0.17,0
48191,4854,-1000.00,10236.95,11236.95,0.00,12236.95,0.03,0
48192,4854,-1000.00,9236.95,10236.95,6949.57,4287.38,0.34,0
48193,4854,-1000.00,8236.95,9236.95,3683.34,6553.62,0.28,0
48194,4854,-1000.00,7236.95,8236.95,0.00,8050.06,0.43,0
48195,4854,-1000.00,6236.95,7236.95,0.00,8236.95,0.39,0
48196,4854,-1000.00,5236.95,6236.95,2665.69,274.45,0.10,0
48197,4854,-1000.00,4236.95,5236.95,0.00,3302.61,0.29,0
48198,4854,-1000.00,3236.95,4236.95,1769.31,3467.64,0.14,0
48199,4854,-1000.00,2236.95,3236.95,547.83,990.86,0.19,0
48200,4854,-1000.00,1236.95,2236.95,0.00,3174.76,0.41,0
48201,4855,0.00,0.00,1000.00,0.00,0.00,0.44,0
48202,4855,-423.04,-423.04,576.96,423.04,0.00,0.20,0
48203,4855,-1000.00,-1423.04,-423.04,59.05,517.92,0.33,0
48204,4856,1000.00,1000.00,2000.00,409.46,590.54,0.23,1
48205,4856,1000.00,2000.00,3000.00,722.99,1277.01,0.27,1
48206,4856,1000.00,3000.00,4000.00,381.18,2618.82,0.42,1
48207,4856,1000.00,4000.00,5000.00,0.00,1008.67,0.20,1
48208,4856,0.00,4000.00,5000.00,0.00,0.00,0.02,0
48209,4856,1000.00,5000.00,6000.00,0.00,4283.98,0.42,1
48210,4856,1000.00,6000.00,7000.00,0.00,57.56,0.10,1
48211,4856,1000.00,7000.00,8000.00,2450.54,4549.46,0.32,1
48212,4856,1000.00,8000.00,9000.00,3030.23,4969.77,0.30,1
48213,4856,1000.00,9000.00,10000.00,1296.74,7703.26,0.18,1
48214,4856,1000.00,10000.00,11000.00,0.00,10000.00,0.29,1
48215,4856,1000.00,11000.00,12000.00,0.00,7452.15,0.37,1
48216,4856,-1000.00,10000.00,11000.00,4323.70,1775.31,0.13,0
48217,4856,0.00,10000.00,11000.00,0.00,0.00,0.07,0
48218,4856,-1000.00,9000.00,10000.00,5276.35,992.24,0.10,0
48219,4856,1000.00,10000.00,11000.00,4123.57,5876.43,0.25,1
48220,4856,1000.00,11000.00,12000.00,5138.66,5861.34,0.05,1
48221,4856,1000.00,12000.00,13000.00,6000.00,6000.00,0.22,1
48222,4856,-1000.00,11000.00,12000.00,7315.67,0.00,0.07,0
48223,4856,1000.00,12000.00,13000.00,0.00,12000.00,0.01,1
48224,4856,1000.00,13000.00,14000.00,4593.99,8406.01,0.14,1
48225,4856,-1000.00,12000.00,13000.00,790.13,13209.87,0.09,0
48226,4856,-1000.00,11000.00,12000.00,4718.95,8281.05,0.17,0
48227,4856,-1000.00,10000.00,11000.00,0.00,3601.92,0.22,0
48228,4856,-1000.00,9000.00,10000.00,946.41,9042.47,0.42,0
48229,4856,-1000.00,8000.00,9000.00,4618.77,5381.23,0.41,0
48230,4856,-1000.00,7000.00,8000.00,0.00,9000.00,0.10,0
48231,4856,-1000.00,6000.00,7000.00,0.00,7917.81,0.42,0
48232,4856,-1000.00,5000.00,6000.00,0.00,7000.00,0.16,0
48233,4856,-1000.00,4000.00,5000.00,2641.23,3358.77,0.26,0
48234,4856,-1000.00,3000.00,4000.00,0.00,5000.00,0.42,0
48235,4856,-1000.00,2000.00,3000.00,0.00,1817.71,0.26,0
48236,4856,-1000.00,1000.00,2000.00,1375.74,1624.26,0.06,0
48237,4856,-1000.00,0.00,1000.00,0.00,2000.00,0.17,0
48238,4856,-1000.00,-1000.00,0.00,0.00,1000.00,0.31,0
48239,4857,-1000.00,-1000.00,0.00,0.00,1000.00,0.43,0
48240,4858,-1000.00,-1000.00,0.00,329.06,306.28,0.19,0
48241,4859,0.00,0.00,1000.00,0.00,0.00,0.32,0
48242,4859,-1000.00,-1000.00,0.00,106.57,0.00,0.07,0
48243,4860,-258.08,-258.08,741.92,0.00,258.08,0.40,0
48244,4860,-17.17,-275.25,724.75,0.00,17.17,0.43,0
48245,4860,-303.96,-579.21,420.79,0.00,303.96,0.35,0
48246,4860,-393.85,-973.07,26.93,48.55,345.31,0.42,0
48247,4860,-26.93,-1000.00,0.00,0.00,26.93,0.09,0
48248,4861,-598.80,-598.80,401.20,598.80,0.00,0.23,0
48249,4861,-387.37,-986.17,13.83,387.37,0.00,0.09,0
48250,4861,-2.76,-988.93,11.07,2.76,0.00,0.42,0
48251,4861,-1000.00,-1988.93,-988.93,1.49,9.59,0.07,0
48252,4862,0.00,0.00,1000.00,0.00,0.00,0.33,0
48253,4862,-930.95,-930.95,69.05,0.00,930.95,0.12,0
48254,4862,-16.36,-947.31,52.69,0.00,16.36,0.07,0
48255,4862,13.58,-933.72,66.28,0.04,0.00,0.28,1
48256,4862,-66.28,-1000.00,0.00,0.00,66.28,0.15,0
48257,4863,-959.22,-959.22,40.78,0.00,959.22,0.09,0
48258,4863,-40.78,-1000.00,0.00,17.76,23.01,0.17,0
48259,4864,-1000.00,-1000.00,0.00,691.02,308.98,0.15,0
48260,4865,-1000.00,-1000.00,0.00,455.18,544.82,0.17,0
48261,4866,-758.23,-758.23,241.77,758.23,0.00,0.04,0
48262,4866,-1000.00,-1758.23,-758.23,0.00,91.19,0.28,0
48263,4867,-559.74,-559.74,440.26,0.00,559.74,0.37,0
48264,4867,-162.18,-721.92,278.08,0.00,162.18,0.29,0
48265,4867,-278.08,-1000.00,0.00,124.06,154.01,0.21,0
48266,4868,1000.00,1000.00,2000.00,500.00,500.00,0.01,1
48267,4868,1000.00,2000.00,3000.00,189.41,1810.59,0.35,1
48268,4868,1000.00,3000.00,4000.00,0.00,3000.00,0.21,1
48269,4868,-1000.00,2000.00,3000.00,3259.96,0.00,0.04,0
48270,4868,1000.00,3000.00,4000.00,0.00,3000.00,0.41,1
48271,4868,0.00,3000.00,4000.00,0.00,0.00,0.04,0
48272,4868,1000.00,4000.00,5000.00,1485.68,2514.32,0.25,1
48273,4868,-1000.00,3000.00,4000.00,2951.82,2048.18,0.14,0
48274,4868,1000.00,4000.00,5000.00,1462.56,2537.44,0.31,1
48275,4868,1000.00,5000.00,6000.00,2384.45,2615.55,0.04,1
48276,4868,1000.00,6000.00,7000.00,0.00,971.73,0.08,1
48277,4868,1000.00,7000.00,8000.00,0.00,81.46,0.09,1
48278,4868,-1000.00,6000.00,7000.00,4375.59,3624.41,0.18,0
48279,4868,1000.00,7000.00,8000.00,0.00,1396.06,0.14,1
48280,4868,1000.00,8000.00,9000.00,0.00,7809.74,0.19,1
48281,4868,1000.00,9000.00,10000.00,0.00,856.18,0.11,1
48282,4868,1000.00,10000.00,11000.00,3879.35,6120.65,0.28,1
48283,4868,1000.00,11000.00,12000.00,3783.83,7193.97,0.32,1
48284,4868,1000.00,12000.00,13000.00,0.00,41.90,0.00,1
48285,4868,1000.00,13000.00,14000.00,1030.49,7608.05,0.35,1
48286,4868,1000.00,14000.00,15000.00,3096.00,10904.00,0.39,1
48287,4868,-1000.00,13000.00,14000.00,9648.07,0.00,0.05,0
48288,4868,1000.00,14000.00,15000.00,0.00,11185.75,0.03,1
48289,4868,1000.00,15000.00,16000.00,5120.32,8231.72,0.28,1
48290,4868,1000.00,16000.00,17000.00,0.00,12192.63,0.33,1
48291,4868,1000.00,17000.00,18000.00,0.00,13634.54,0.33,1
48292,4868,1000.00,18000.00,19000.00,0.00,16707.49,0.36,1
48293,4868,1000.00,19000.00,20000.00,3794.69,11764.22,0.34,1
48294,4868,-1000.00,18000.00,19000.00,7102.04,0.00,0.02,0
48295,4868,1000.00,19000.00,20000.00,5283.91,5428.38,0.20,1
48296,4868,1000.00,20000.00,21000.00,9774.10,10225.90,0.21,1
48297,4868,-1000.00,19000.00,20000.00,0.00,21000.00,0.27,0
48298,4868,-1000.00,18000.00,19000.00,0.00,911.99,0.07,0
48299,4868,-1000.00,17000.00,18000.00,7477.89,11522.11,0.27,0
48300,4868,-1000.00,16000.00,17000.00,7937.12,10062.88,0.40,0
48301,4868,-1000.00,15000.00,16000.00,6114.83,10885.17,0.32,0
48302,4868,-1000.00,14000.00,15000.00,1202.36,0.00,0.30,0
48303,4868,-1000.00,13000.00,14000.00,8418.49,0.00,0.02,0
48304,4868,-1000.00,12000.00,13000.00,0.00,10615.36,0.03,0
48305,4868,-1000.00,11000.00,12000.00,0.00,8933.10,0.25,0
48306,4868,-1000.00,10000.00,11000.00,8343.61,3656.39,0.11,0
48307,4869,-1000.00,-1000.00,0.00,0.00,830.12,0.10,0
48308,4870,-1000.00,-1000.00,0.00,188.36,0.00,0.19,0
48309,4871,-1000.00,-1000.00,0.00,739.89,260.11,0.17,0
48310,4872,-296.74,-296.74,703.26,49.76,246.98,0.23,0
48311,4872,-690.94,-987.68,12.32,0.00,690.94,0.17,0
48312,4872,-12.32,-1000.00,0.00,0.00,12.32,0.32,0
48313,4873,-1000.00,-1000.00,0.00,762.71,237.29,0.02,0
48314,4874,-241.21,-241.21,758.79,108.13,133.08,0.15,0
48315,4874,-758.79,-1000.00,0.00,0.00,758.79,0.01,0
48316,4875,-1000.00,-1000.00,0.00,0.00,1000.00,0.08,0
48317,4876,1000.00,1000.00,2000.00,0.00,1000.00,0.39,1
48318,4876,1000.00,2000.00,3000.00,530.94,1469.06,0.09,1
48319,4876,1000.00,3000.00,4000.00,1088.91,1911.09,0.15,1
48320,4876,1000.00,4000.00,5000.00,1434.13,2565.87,0.25,1
48321,4876,1000.00,5000.00,6000.00,1924.71,3075.29,0.29,1
48322,4876,1000.00,6000.00,7000.00,3000.00,3000.00,0.04,1
48323,4876,1000.00,7000.00,8000.00,2742.46,4257.54,0.37,1
48324,4876,1000.00,8000.00,9000.00,0.00,3573.55,0.07,1
48325,4876,1000.00,9000.00,10000.00,0.00,9000.00,0.43,1
48326,4876,1000.00,10000.00,11000.00,2991.60,7008.40,0.31,1
48327,4876,1000.00,11000.00,12000.00,5287.69,5712.31,0.18,1
48328,4876,1000.00,12000.00,13000.00,0.00,12000.00,0.11,1
48329,4876,1000.00,13000.00,14000.00,0.00,6652.13,0.25,1
48330,4876,1000.00,14000.00,15000.00,0.00,7439.89,0.30,1
48331,4876,1000.00,15000.00,16000.00,1702.04,13297.96,0.43,1
48332,4876,1000.00,16000.00,17000.00,0.00,9714.80,0.19,1
48333,4876,1000.00,17000.00,18000.00,7190.60,9809.40,0.26,1
48334,4876,1000.00,18000.00,19000.00,0.00,8447.10,0.14,1
48335,4876,1000.00,19000.00,20000.00,0.00,14051.07,0.40,1
48336,4876,-1000.00,18000.00,19000.00,10000.00,10000.00,0.34,0
48337,4876,-1000.00,17000.00,18000.00,8979.53,10020.47,0.05,0
48338,4876,-1000.00,16000.00,17000.00,539.31,17460.69,0.44,0
48339,4876,-1000.00,15000.00,16000.00,0.00,17000.00,0.04,0
48340,4876,-1000.00,14000.00,15000.00,6918.59,9081.41,0.24,0
48341,4876,-1000.00,13000.00,14000.00,2651.41,6686.94,0.28,0
48342,4876,-1000.00,12000.00,13000.00,7208.86,6791.14,0.41,0
48343,4876,-1000.00,11000.00,12000.00,0.00,13000.00,0.17,0
48344,4876,-1000.00,10000.00,11000.00,2411.43,4944.09,0.26,0
48345,4876,-1000.00,9000.00,10000.00,0.00,7887.40,0.27,0
48346,4876,-1000.00,8000.00,9000.00,2243.18,7756.82,0.14,0
48347,4876,-1000.00,7000.00,8000.00,0.00,5620.55,0.23,0
48348,4876,-1000.00,6000.00,7000.00,0.00,8000.00,0.16,0
48349,4876,-1000.00,5000.00,6000.00,1513.53,5486.47,0.39,0
48350,4876,-1000.00,4000.00,5000.00,0.00,1900.43,0.22,0
48351,4876,-1000.00,3000.00,4000.00,0.00,5000.00,0.41,0
48352,4876,-1000.00,2000.00,3000.00,2330.39,1669.61,0.12,0
48353,4876,-1000.00,1000.00,2000.00,0.00,2218.10,0.40,0
48354,4876,-1000.00,0.00,1000.00,384.20,106.40,0.12,0
48355,4876,-315.95,-315.95,684.05,0.00,315.95,0.23,0
48356,4876,-684.05,-1000.00,0.00,0.00,684.05,0.15,0
48357,4877,1000.00,1000.00,2000.00,0.00,972.93,0.41,1
48358,4877,1000.00,2000.00,3000.00,0.00,2000.00,0.31,1
48359,4877,1000.00,3000.00,4000.00,0.00,1144.83,0.25,1
48360,4877,1000.00,4000.00,5000.00,973.15,3026.85,0.36,1
48361,4877,1000.00,5000.00,6000.00,432.62,1000.69,0.18,1
48362,4877,-1000.00,4000.00,5000.00,5488.49,0.00,0.00,0
48363,4877,-1000.00,3000.00,4000.00,2870.80,2129.20,0.09,0
48364,4877,1000.00,4000.00,5000.00,393.26,1148.78,0.22,1
48365,4877,1000.00,5000.00,6000.00,1605.27,3394.73,0.34,1
48366,4877,1000.00,6000.00,7000.00,2764.35,3177.05,0.24,1
48367,4877,1000.00,7000.00,8000.00,0.00,7000.00,0.01,1
48368,4877,1000.00,8000.00,9000.00,1014.19,6985.81,0.20,1
48369,4877,1000.00,9000.00,10000.00,0.00,9000.00,0.40,1
48370,4877,-1000.00,8000.00,9000.00,5379.94,4620.06,0.20,0
48371,4877,1000.00,9000.00,10000.00,0.00,9000.00,0.19,1
48372,4877,1000.00,10000.00,11000.00,2380.39,7619.61,0.38,1
48373,4877,1000.00,11000.00,12000.00,3250.54,7749.46,0.24,1
48374,4877,1000.00,12000.00,13000.00,0.00,4301.57,0.12,1
48375,4877,1000.00,13000.00,14000.00,0.00,10338.29,0.39,1
48376,4877,1000.00,14000.00,15000.00,1482.40,12517.60,0.42,1
48377,4877,1000.00,15000.00,16000.00,4339.38,10660.62,0.26,1
48378,4877,1000.00,16000.00,17000.00,0.00,7310.96,0.03,1
48379,4877,1000.00,17000.00,18000.00,0.00,17000.00,0.43,1
48380,4877,1000.00,18000.00,19000.00,3986.60,14013.40,0.39,1
48381,4877,-1000.00,17000.00,18000.00,9939.95,9060.05,0.17,0
48382,4877,-1000.00,16000.00,17000.00,5936.98,0.00,0.08,0
48383,4877,1000.00,17000.00,18000.00,5416.84,11583.16,0.31,1
48384,4877,1000.00,18000.00,19000.00,1544.27,14723.39,0.42,1
48385,4877,1000.00,19000.00,20000.00,4645.27,14354.73,0.38,1
48386,4877,1000.00,20000.00,21000.00,3349.72,16650.28,0.42,1
48387,4877,1000.00,21000.00,22000.00,0.00,14797.49,0.22,1
48388,4877,1000.00,22000.00,23000.00,0.00,22000.00,0.32,1
48389,4877,1000.00,23000.00,24000.00,10286.75,12713.25,0.02,1
48390,4877,1000.00,24000.00,25000.00,0.00,24000.00,0.44,1
48391,4877,1000.00,25000.00,26000.00,8711.73,16288.27,0.32,1
48392,4877,0.00,25000.00,26000.00,0.00,0.00,0.04,0
48393,4877,1000.00,26000.00,27000.00,0.00,26000.00,0.39,1
48394,4877,1000.00,27000.00,28000.00,0.00,17476.22,0.32,1
48395,4877,1000.00,28000.00,29000.00,12693.84,15306.16,0.12,1
48396,4877,1000.00,29000.00,30000.00,10748.71,18251.29,0.30,1
48397,4877,1000.00,30000.00,31000.00,0.00,19499.07,0.33,1
48398,4877,1000.00,31000.00,32000.00,9788.16,21211.84,0.31,1
48399,4877,1000.00,32000.00,33000.00,0.00,32000.00,0.16,1
48400,4877,1000.00,33000.00,34000.00,0.00,33000.00,0.05,1
48401,4877,-1000.00,32000.00,33000.00,8208.90,5469.56,0.15,0
48402,4877,1000.00,33000.00,34000.00,0.00,33000.00,0.37,1
48403,4877,1000.00,34000.00,35000.00,0.00,34000.00,0.37,1
48404,4877,1000.00,35000.00,36000.00,3522.48,16444.32,0.30,1
48405,4877,-1000.00,34000.00,35000.00,15222.04,20777.96,0.26,0
48406,4877,-1000.00,33000.00,34000.00,0.00,35000.00,0.11,0
48407,4877,-1000.00,32000.00,33000.00,0.00,34000.00,0.44,0
48408,4877,-1000.00,31000.00,32000.00,0.00,33000.00,0.28,0
48409,4877,-1000.00,30000.00,31000.00,0.00,32000.00,0.43,0
48410,4877,-1000.00,29000.00,30000.00,10210.86,20789.14,0.17,0
48411,4877,-1000.00,28000.00,29000.00,4669.17,19472.23,0.36,0
48412,4877,-1000.00,27000.00,28000.00,14126.08,14873.92,0.13,0
48413,4877,-1000.00,26000.00,27000.00,0.00,7970.21,0.21,0
48414,4877,0.00,26000.00,27000.00,0.00,0.00,0.02,0
48415,4877,-1000.00,25000.00,26000.00,0.00,26235.09,0.00,0
48416,4877,0.00,25000.00,26000.00,0.00,0.00,0.09,0
48417,4877,-1000.00,24000.00,25000.00,4894.40,21105.60,0.08,0
48418,4877,-1000.00,23000.00,24000.00,0.00,25000.00,0.31,0
48419,4877,-1000.00,22000.00,23000.00,12067.35,11932.65,0.18,0
48420,4877,-1000.00,21000.00,22000.00,1687.89,21312.11,0.38,0
48421,4877,-1000.00,20000.00,21000.00,0.00,22000.00,0.29,0
48422,4877,-1000.00,19000.00,20000.00,6684.39,4357.45,0.16,0
48423,4877,-1000.00,18000.00,19000.00,2489.53,17244.78,0.42,0
48424,4877,-1000.00,17000.00,18000.00,7496.45,0.00,0.08,0
48425,4877,-1000.00,16000.00,17000.00,0.00,18000.00,0.32,0
48426,4877,-1000.00,15000.00,16000.00,0.00,17000.00,0.21,0
48427,4877,-1000.00,14000.00,15000.00,0.00,16000.00,0.16,0
48428,4878,-956.32,-956.32,43.68,0.00,956.32,0.32,0
48429,4878,-24.42,-980.74,19.26,0.00,24.42,0.43,0
48430,4878,-18.77,-999.52,0.48,0.00,18.77,0.44,0
48431,4878,-0.48,-1000.00,0.00,0.08,0.41,0.39,0
48432,4879,-1000.00,-1000.00,0.00,617.93,382.07,0.04,0
48433,4880,-469.56,-469.56,530.44,0.00,469.56,0.28,0
48434,4880,-530.44,-1000.00,0.00,0.00,530.44,0.22,0
48435,4881,-1000.00,-1000.00,0.00,289.77,710.23,0.32,0
48436,4881,-0.00,-1000.00,-0.00,0.00,0.00,0.04,0
48437,4882,1000.00,1000.00,2000.00,575.41,424.59,0.00,1
48438,4882,-77.83,922.17,1922.17,0.00,77.83,0.32,0
48439,4882,-1000.00,-77.83,922.17,0.00,1120.53,0.35,0
48440,4882,-302.20,-380.02,619.98,0.00,302.20,0.22,0
48441,4882,-280.74,-660.76,339.24,0.00,280.74,0.30,0
48442,4882,-339.24,-1000.00,0.00,0.00,339.24,0.06,0
48443,4883,1000.00,1000.00,2000.00,0.00,450.90,0.28,1
48444,4883,-1000.00,0.00,1000.00,1092.25,907.75,0.18,0
48445,4883,1000.00,1000.00,2000.00,273.22,726.78,0.36,1
48446,4883,1000.00,2000.00,3000.00,36.63,1963.37,0.24,1
48447,4883,1000.00,3000.00,4000.00,483.69,2065.75,0.37,1
48448,4883,1000.00,4000.00,5000.00,1173.77,2826.23,0.28,1
48449,4883,1000.00,5000.00,6000.00,2380.98,2619.02,0.24,1
48450,4883,1000.00,6000.00,7000.00,0.00,6000.00,0.39,1
48451,4883,1000.00,7000.00,8000.00,0.00,7000.00,0.05,1
48452,4883,1000.00,8000.00,9000.00,2227.67,5772.33,0.31,1
48453,4883,-1000.00,7000.00,8000.00,7740.00,0.00,0.02,0
48454,4883,-1000.00,6000.00,7000.00,3243.40,2541.51,0.18,0
48455,4883,1000.00,7000.00,8000.00,2276.71,4723.29,0.05,1
48456,4883,1000.00,8000.00,9000.00,4000.00,4000.00,0.02,1
48457,4883,1000.00,9000.00,10000.00,1917.47,7082.53,0.23,1
48458,4883,1000.00,10000.00,11000.00,0.00,9827.61,0.38,1
48459,4883,1000.00,11000.00,12000.00,0.00,11000.00,0.00,1
48460,4883,1000.00,12000.00,13000.00,0.00,12000.00,0.16,1
48461,4883,1000.00,13000.00,14000.00,4168.43,8831.57,0.32,1
48462,4883,1000.00,14000.00,15000.00,890.86,1458.88,0.14,1
48463,4883,1000.00,15000.00,16000.00,4356.88,10585.68,0.38,1
48464,4883,-1000.00,14000.00,15000.00,11620.36,4379.64,0.16,0
48465,4883,1000.00,15000.00,16000.00,0.00,15000.00,0.06,1
48466,4883,1000.00,16000.00,17000.00,376.01,9368.08,0.35,1
48467,4883,-1000.00,15000.00,16000.00,0.00,17000.00,0.10,0
48468,4883,-1000.00,14000.00,15000.00,0.00,7533.53,0.02,0
48469,4883,-1000.00,13000.00,14000.00,4307.20,0.00,0.04,0
48470,4883,-1000.00,12000.00,13000.00,2719.48,11280.52,0.39,0
48471,4883,-1000.00,11000.00,12000.00,1222.21,8940.23,0.38,0
48472,4883,-1000.00,10000.00,11000.00,0.00,12000.00,0.24,0
48473,4883,-1000.00,9000.00,10000.00,1039.15,9960.85,0.29,0
48474,4883,-1000.00,8000.00,9000.00,0.00,6232.97,0.36,0
48475,4883,-1000.00,7000.00,8000.00,0.00,8132.58,0.13,0
48476,4883,-1000.00,6000.00,7000.00,0.00,2625.04,0.30,0
48477,4883,-1000.00,5000.00,6000.00,118.08,3697.91,0.33,0
48478,4883,-1000.00,4000.00,5000.00,0.00,492.56,0.34,0
48479,4883,-1000.00,3000.00,4000.00,2500.00,2500.00,0.03,0
48480,4883,-1000.00,2000.00,3000.00,0.00,4000.00,0.05,0
48481,4883,-1000.00,1000.00,2000.00,0.00,2801.95,0.39,0
48482,4883,-1000.00,0.00,1000.00,0.00,2000.00,0.23,0
48483,4883,-1000.00,-1000.00,0.00,11.72,988.28,0.13,0
48484,4884,-1000.00,-1000.00,0.00,381.34,618.66,0.13,0
48485,4885,1000.00,1000.00,2000.00,225.48,774.52,0.39,1
48486,4885,1000.00,2000.00,3000.00,719.50,1280.50,0.26,1
48487,4885,1000.00,3000.00,4000.00,0.00,59.95,0.12,1
48488,4885,-1000.00,2000.00,3000.00,2104.71,1895.29,0.09,0
48489,4885,1000.00,3000.00,4000.00,610.46,2389.54,0.12,1
48490,4885,1000.00,4000.00,5000.00,0.00,4000.00,0.37,1
48491,4885,-1000.00,3000.00,4000.00,0.00,5000.00,0.39,0
48492,4885,-1000.00,2000.00,3000.00,1896.84,2103.16,0.18,0
48493,4885,-1000.00,1000.00,2000.00,1445.61,1554.39,0.13,0
48494,4885,-1000.00,0.00,1000.00,967.08,1032.92,0.16,0
48495,4885,-1000.00,-1000.00,0.00,219.44,780.56,0.24,0
48496,4886,1000.00,1000.00,2000.00,0.00,899.18,0.44,1
48497,4886,1000.00,2000.00,3000.00,0.00,569.08,0.08,1
48498,4886,1000.00,3000.00,4000.00,0.00,1638.56,0.26,1
48499,4886,1000.00,4000.00,5000.00,341.04,3658.96,0.26,1
48500,4886,1000.00,5000.00,6000.00,2072.50,2927.50,0.18,1
48501,4886,1000.00,6000.00,7000.00,0.00,6000.00,0.09,1
48502,4886,1000.00,7000.00,8000.00,0.00,3864.45,0.23,1
48503,4886,1000.00,8000.00,9000.00,2820.41,5179.59,0.32,1
48504,4886,0.00,8000.00,9000.00,0.00,0.00,0.04,0
48505,4886,1000.00,9000.00,10000.00,0.00,9000.00,0.21,1
48506,4886,1000.00,10000.00,11000.00,0.00,1451.73,0.14,1
48507,4886,1000.00,11000.00,12000.00,4664.25,6335.75,0.26,1
48508,4886,1000.00,12000.00,13000.00,4687.82,7312.18,0.24,1
48509,4886,1000.00,13000.00,14000.00,2829.98,10170.02,0.15,1
48510,4886,1000.00,14000.00,15000.00,1583.26,8428.35,0.35,1
48511,4886,1000.00,15000.00,16000.00,3806.50,11193.50,0.37,1
48512,4886,1000.00,16000.00,17000.00,8000.00,8000.00,0.13,1
48513,4886,1000.00,17000.00,18000.00,5580.38,11419.62,0.29,1
48514,4886,-1000.00,16000.00,17000.00,8953.07,4446.94,0.14,0
48515,4886,1000.00,17000.00,18000.00,0.00,11006.96,0.30,1
48516,4886,1000.00,18000.00,19000.00,1948.16,6280.28,0.24,1
48517,4886,1000.00,19000.00,20000.00,0.00,19000.00,0.15,1
48518,4886,-1000.00,18000.00,19000.00,18423.52,1576.48,0.13,0
48519,4886,1000.00,19000.00,20000.00,0.00,11181.02,0.34,1
48520,4886,1000.00,20000.00,21000.00,2818.29,12944.07,0.36,1
48521,4886,1000.00,21000.00,22000.00,0.00,19484.89,0.43,1
48522,4886,1000.00,22000.00,23000.00,0.00,3933.73,0.03,1
48523,4886,1000.00,23000.00,24000.00,5602.52,17397.48,0.15,1
48524,4886,1000.00,24000.00,25000.00,4078.82,11900.51,0.30,1
48525,4886,1000.00,25000.00,26000.00,9214.07,15785.93,0.20,1
48526,4886,1000.00,26000.00,27000.00,8658.21,15372.99,0.30,1
48527,4886,1000.00,27000.00,28000.00,8170.46,18829.54,0.31,1
48528,4886,1000.00,28000.00,29000.00,5184.07,22814.37,0.40,1
48529,4886,1000.00,29000.00,30000.00,10773.15,18226.85,0.30,1
48530,4886,0.00,29000.00,30000.00,0.00,0.00,0.10,0
48531,4886,1000.00,30000.00,31000.00,15000.00,15000.00,0.01,1
48532,4886,1000.00,31000.00,32000.00,13122.11,17877.89,0.21,1
48533,4886,1000.00,32000.00,33000.00,0.00,12845.58,0.12,1
48534,4886,0.00,32000.00,33000.00,0.00,0.00,0.06,0
48535,4886,1000.00,33000.00,34000.00,6846.09,26153.91,0.40,1
48536,4886,1000.00,34000.00,35000.00,0.00,20012.19,0.04,1
48537,4886,1000.00,35000.00,36000.00,9990.01,25009.99,0.35,1
48538,4886,1000.00,36000.00,37000.00,0.00,36000.00,0.38,1
48539,4886,1000.00,37000.00,38000.00,0.00,29219.42,0.37,1
48540,4886,1000.00,38000.00,39000.00,0.00,38000.00,0.08,1
48541,4886,1000.00,39000.00,40000.00,0.00,39000.00,0.27,1
48542,4887,-312.27,-312.27,687.73,0.00,312.27,0.35,0
48543,4887,-687.73,-1000.00,0.00,0.00,687.73,0.16,0
48544,4888,1000.00,1000.00,2000.00,465.88,534.12,0.17,1
48545,4888,-1000.00,0.00,1000.00,1180.95,819.05,0.17,0
48546,4888,1000.00,1000.00,2000.00,0.00,1000.00,0.30,1
48547,4888,1000.00,2000.00,3000.00,621.68,1165.18,0.34,1
48548,4888,1000.00,3000.00,4000.00,0.00,3000.00,0.42,1
48549,4888,1000.00,4000.00,5000.00,0.00,3070.12,0.19,1
48550,4888,1000.00,5000.00,6000.00,0.00,5000.00,0.13,1
48551,4888,-1000.00,4000.00,5000.00,2603.08,1834.15,0.17,0
48552,4888,1000.00,5000.00,6000.00,2254.04,2745.96,0.22,1
48553,4888,1000.00,6000.00,7000.00,2411.33,3588.67,0.36,1
48554,4888,-1000.00,5000.00,6000.00,4045.83,2954.17,0.17,0
48555,4888,1000.00,6000.00,7000.00,0.00,3489.50,0.33,1
48556,4888,1000.00,7000.00,8000.00,0.00,3729.25,0.24,1
48557,4888,1000.00,8000.00,9000.00,0.00,8000.00,0.34,1
48558,4888,1000.00,9000.00,10000.00,0.00,9000.00,0.36,1
48559,4888,1000.00,10000.00,11000.00,0.00,10000.00,0.32,1
48560,4888,1000.00,11000.00,12000.00,3208.73,7791.27,0.17,1
48561,4888,1000.00,12000.00,13000.00,5842.20,6157.80,0.21,1
48562,4888,-1000.00,11000.00,12000.00,2627.03,0.00,0.09,0
48563,4888,-1000.00,10000.00,11000.00,3078.41,1998.02,0.15,0
48564,4888,1000.00,11000.00,12000.00,2286.61,8713.39,0.40,1
48565,4888,1000.00,12000.00,13000.00,1453.06,10546.94,0.16,1
48566,4888,-1000.00,11000.00,12000.00,7934.54,5065.46,0.12,0
48567,4888,-1000.00,10000.00,11000.00,4921.29,6177.00,0.25,0
48568,4888,-1000.00,9000.00,10000.00,5365.23,5634.77,0.12,0
48569,4888,-1000.00,8000.00,9000.00,49.64,9950.36,0.18,0
48570,4888,-1000.00,7000.00,8000.00,0.00,9000.00,0.19,0
48571,4888,-1000.00,6000.00,7000.00,0.00,8000.00,0.39,0
48572,4888,-1000.00,5000.00,6000.00,2817.27,4182.73,0.29,0
48573,4888,-1000.00,4000.00,5000.00,0.00,6000.00,0.16,0
48574,4888,-1000.00,3000.00,4000.00,627.87,4372.13,0.30,0
48575,4888,-1000.00,2000.00,3000.00,610.26,0.00,0.07,0
48576,4888,-1000.00,1000.00,2000.00,0.00,3000.00,0.09,0
48577,4888,-1000.00,0.00,1000.00,0.00,2000.00,0.41,0
48578,4888,-619.26,-619.26,380.74,0.00,619.26,0.19,0
48579,4888,-380.74,-1000.00,0.00,134.14,246.60,0.29,0
48580,4889,1000.00,1000.00,2000.00,225.97,0.00,0.15,1
48581,4889,0.00,1000.00,2000.00,0.00,0.00,0.11,0
48582,4889,-155.25,844.75,1844.75,0.00,155.25,0.29,0
48583,4889,1000.00,1844.75,2844.75,64.98,0.00,0.03,1
48584,4889,-1000.00,844.75,1844.75,1397.43,1447.32,0.09,0
48585,4889,1000.00,1844.75,2844.75,792.74,0.00,0.09,1
48586,4889,1000.00,2844.75,3844.75,970.97,0.00,0.32,1
48587,4889,-1000.00,1844.75,2844.75,0.00,2543.82,0.24,0
48588,4889,-1000.00,844.75,1844.75,834.31,2010.43,0.15,0
48589,4889,-1000.00,-155.25,844.75,0.00,1844.75,0.05,0
48590,4889,1000.00,844.75,1844.75,436.61,408.14,0.12,1
48591,4889,1000.00,1844.75,2844.75,1278.07,566.68,0.02,1
48592,4889,-1000.00,844.75,1844.75,0.00,2545.12,0.39,0
48593,4889,0.00,844.75,1844.75,0.00,0.00,0.42,0
48594,4889,1000.00,1844.75,2844.75,1377.58,467.17,0.16,1
48595,4889,-1000.00,844.75,1844.75,0.00,1960.88,0.09,0
48596,4889,-1000.00,-155.25,844.75,0.00,1844.75,0.14,0
48597,4889,-194.68,-349.93,650.07,0.00,194.68,0.28,0
48598,4889,-124.63,-474.56,525.44,0.00,124.63,0.13,0
48599,4889,-381.41,-855.97,144.03,165.79,215.62,0.34,0
48600,4889,-140.91,-996.88,3.12,0.00,140.91,0.31,0
48601,4889,-2.87,-999.75,0.25,0.99,1.88,0.31,0
48602,4889,-0.04,-999.79,0.21,0.00,0.04,0.14,0
48603,4889,-0.21,-1000.00,0.00,0.09,0.12,0.10,0
48604,4889,-0.00,-1000.00,0.00,0.00,0.00,0.37,0
48605,4889,-0.00,-1000.00,0.00,0.00,0.00,0.06,0
48606,4890,-1000.00,-1000.00,0.00,0.00,1000.00,0.13,0
48607,4891,-1000.00,-1000.00,0.00,434.29,565.71,0.05,0
48608,4891,-0.00,-1000.00,0.00,0.00,0.00,0.33,0
48609,4892,-1000.00,-1000.00,0.00,0.00,1000.00,0.33,0
48610,4893,-1000.00,-1000.00,0.00,1000.00,0.00,0.02,0
48611,4894,-1000.00,-1000.00,0.00,309.55,690.45,0.22,0
48612,4895,-780.58,-780.58,219.42,553.72,226.86,0.27,0
48613,4895,-46.12,-826.70,173.30,46.12,0.00,0.32,0
48614,4895,-1000.00,-1826.70,-826.70,0.00,162.72,0.18,0
48615,4896,0.00,0.00,1000.00,0.00,0.00,0.38,0
48616,4896,-75.47,-75.47,924.53,0.00,75.47,0.07,0
48617,4896,1000.00,924.53,1924.53,490.11,394.94,0.26,1
48618,4896,0.00,924.53,1924.53,0.00,0.00,0.39,0
48619,4896,1000.00,1924.53,2924.53,172.97,0.00,0.40,1
48620,4896,0.00,1924.53,2924.53,0.00,0.00,0.28,0
48621,4896,1000.00,2924.53,3924.53,2526.78,0.00,0.04,1
48622,4896,1000.00,3924.53,4924.53,2072.20,1852.34,0.04,1
48623,4896,-1000.00,2924.53,3924.53,891.80,4032.74,0.41,0
48624,4896,-699.06,2225.48,3225.48,0.00,699.06,0.28,0
48625,4896,-1000.00,1225.48,2225.48,0.00,2247.89,0.39,0
48626,4896,-539.17,686.31,1686.31,0.00,539.17,0.21,0
48627,4896,1000.00,1686.31,2686.31,418.08,0.00,0.21,1
48628,4896,-1000.00,686.31,1686.31,0.00,2686.31,0.12,0
48629,4896,-1000.00,-313.69,686.31,0.00,1686.31,0.30,0
48630,4896,1000.00,686.31,1686.31,413.27,273.04,0.02,1
48631,4896,-1000.00,-313.69,686.31,297.12,1389.19,0.41,0
48632,4896,-1000.00,-1313.69,-313.69,0.00,686.31,0.09,0
48633,4897,-675.45,-675.45,324.55,0.00,675.45,0.32,0
48634,4897,-324.55,-1000.00,0.00,21.87,302.68,0.32,0
48635,4897,-0.00,-1000.00,0.00,0.00,0.00,0.20,0
48636,4898,-1000.00,-1000.00,0.00,608.41,391.59,0.11,0
48637,4899,0.00,0.00,1000.00,0.00,0.00,0.23,0
48638,4899,-1000.00,-1000.00,0.00,0.00,966.74,0.06,0
48639,4900,-742.28,-742.28,257.72,0.00,742.28,0.27,0
48640,4900,-257.72,-1000.00,0.00,82.71,175.01,0.08,0
48641,4901,1000.00,1000.00,2000.00,0.00,362.21,0.11,1
48642,4901,-1000.00,0.00,1000.00,1047.65,952.35,0.21,0
48643,4901,1000.00,1000.00,2000.00,0.00,1000.00,0.28,1
48644,4901,1000.00,2000.00,3000.00,674.57,1325.43,0.06,1
48645,4901,-1000.00,1000.00,2000.00,2123.76,876.24,0.03,0
48646,4901,-1000.00,0.00,1000.00,1143.99,856.01,0.09,0
48647,4901,1000.00,1000.00,2000.00,0.00,170.63,0.17,1
48648,4901,1000.00,2000.00,3000.00,0.00,801.84,0.26,1
48649,4901,1000.00,3000.00,4000.00,0.00,366.85,0.15,1
48650,4901,1000.00,4000.00,5000.00,660.91,1803.48,0.29,1
48651,4901,1000.00,5000.00,6000.00,2500.00,2500.00,0.05,1
48652,4901,1000.00,6000.00,7000.00,3000.00,3000.00,0.33,1
48653,4901,-1000.00,5000.00,6000.00,3500.00,3500.00,0.02,0
48654,4901,-1000.00,4000.00,5000.00,1035.12,4253.29,0.38,0
48655,4901,-1000.00,3000.00,4000.00,2500.00,2500.00,0.00,0
48656,4901,-1000.00,2000.00,3000.00,2789.07,1210.93,0.12,0
48657,4901,-1000.00,1000.00,2000.00,0.00,3000.00,0.30,0
48658,4901,-1000.00,0.00,1000.00,178.03,1467.93,0.40,0
48659,4901,-1000.00,-1000.00,0.00,0.00,883.60,0.33,0
48660,4902,-1000.00,-1000.00,0.00,228.17,771.83,0.06,0
48661,4903,0.00,0.00,1000.00,0.00,0.00,0.13,0
48662,4903,1000.00,1000.00,2000.00,942.34,0.00,0.10,1
48663,4903,1000.00,2000.00,3000.00,114.46,0.00,0.42,1
48664,4903,0.00,2000.00,3000.00,0.00,0.00,0.11,0
48665,4903,1000.00,3000.00,4000.00,1086.71,0.00,0.24,1
48666,4903,1000.00,4000.00,5000.00,1220.44,0.00,0.19,1
48667,4903,-1000.00,3000.00,4000.00,0.00,1471.72,0.23,0
48668,4903,1000.00,4000.00,5000.00,1685.79,0.00,0.32,1
48669,4903,-738.62,3261.38,4261.38,0.00,738.62,0.43,0
48670,4903,-1000.00,2261.38,3261.38,0.00,4261.38,0.09,0
48671,4903,1000.00,3261.38,4261.38,2522.75,715.81,0.18,1
48672,4903,-1000.00,2261.38,3261.38,0.00,3560.15,0.16,0
48673,4903,1000.00,3261.38,4261.38,1800.12,0.00,0.04,1
48674,4903,-1000.00,2261.38,3261.38,0.00,1766.11,0.26,0
48675,4903,0.00,2261.38,3261.38,0.00,0.00,0.40,0
48676,4903,-851.72,1409.66,2409.66,0.00,851.72,0.40,0
48677,4903,-1000.00,409.66,1409.66,0.00,2409.66,0.02,0
48678,4903,0.00,409.66,1409.66,0.00,0.00,0.16,0
48679,4903,1000.00,1409.66,2409.66,844.68,278.85,0.25,1
48680,4903,1000.00,2409.66,3409.66,103.67,0.00,0.37,1
48681,4903,-161.95,2247.70,3247.70,161.95,0.00,0.29,0
48682,4903,0.00,2247.70,3247.70,0.00,0.00,0.13,0
48683,4903,0.00,2247.70,3247.70,0.00,0.00,0.41,0
48684,4903,-1000.00,1247.70,2247.70,10.54,153.55,0.44,0
48685,4903,-1000.00,247.70,1247.70,200.45,1741.25,0.19,0
48686,4903,0.00,247.70,1247.70,0.00,0.00,0.19,0
48687,4903,0.00,247.70,1247.70,0.00,0.00,0.12,0
48688,4903,-1000.00,-752.30,247.70,1011.95,235.76,0.01,0
48689,4903,-1000.00,-1752.30,-752.30,0.00,196.15,0.05,0
48690,4904,1000.00,1000.00,2000.00,524.23,475.77,0.04,1
48691,4904,0.00,1000.00,2000.00,0.00,0.00,0.07,0
48692,4904,0.00,1000.00,2000.00,0.00,0.00,0.04,0
48693,4904,-1000.00,0.00,1000.00,232.08,1767.92,0.42,0
48694,4904,1000.00,1000.00,2000.00,554.13,445.87,0.07,1
48695,4904,-1000.00,0.00,1000.00,383.95,1616.05,0.30,0
48696,4904,-219.23,-219.23,780.77,0.00,219.23,0.42,0
48697,4904,0.00,-219.23,780.77,0.00,0.00,0.11,0
48698,4904,-780.77,-1000.00,0.00,0.00,780.77,0.14,0
48699,4905,-361.29,-361.29,638.71,0.00,361.29,0.37,0
48700,4905,1000.00,638.71,1638.71,384.42,0.00,0.20,1
48701,4905,1000.00,1638.71,2638.71,1279.40,359.31,0.06,1
48702,4905,-1000.00,638.71,1638.71,0.00,2638.71,0.17,0
48703,4905,-963.90,-325.19,674.81,0.00,963.90,0.30,0
48704,4905,-674.81,-1000.00,0.00,337.40,337.40,0.21,0
48705,4906,-1000.00,-1000.00,0.00,848.46,151.54,0.04,0
48706,4907,-873.79,-873.79,126.21,279.17,594.63,0.32,0
48707,4907,-126.21,-1000.00,0.00,0.00,126.21,0.00,0
48708,4908,-1000.00,-1000.00,0.00,835.88,164.12,0.03,0
48709,4909,-1000.00,-1000.00,0.00,0.00,1000.00,0.11,0
48710,4910,1000.00,1000.00,2000.00,357.44,0.00,0.09,1
48711,4910,1000.00,2000.00,3000.00,1093.68,906.32,0.17,1
48712,4910,-953.58,1046.42,2046.42,0.00,953.58,0.32,0
48713,4910,-1000.00,46.42,1046.42,0.00,2046.42,0.12,0
48714,4910,-1000.00,-953.58,46.42,0.00,1046.42,0.17,0
48715,4910,-22.27,-975.84,24.16,0.00,22.27,0.07,0
48716,4910,-11.85,-987.69,12.31,0.00,11.85,0.22,0
48717,4910,-12.31,-1000.00,0.00,0.00,12.31,0.23,0
48718,4911,0.00,0.00,1000.00,0.00,0.00,0.04,0
48719,4911,-956.92,-956.92,43.08,0.00,956.92,0.10,0
48720,4911,-43.08,-1000.00,0.00,21.23,21.84,0.23,0
48721,4912,-1000.00,-1000.00,0.00,500.00,500.00,0.01,0
48722,4913,1000.00,1000.00,2000.00,374.74,625.26,0.27,1
48723,4913,1000.00,2000.00,3000.00,365.79,1634.21,0.38,1
48724,4913,1000.00,3000.00,4000.00,1125.88,1874.12,0.14,1
48725,4913,1000.00,4000.00,5000.00,0.00,4000.00,0.37,1
48726,4913,1000.00,5000.00,6000.00,2096.00,2904.00,0.26,1
48727,4913,1000.00,6000.00,7000.00,0.00,6000.00,0.22,1
48728,4913,1000.00,7000.00,8000.00,1261.26,5738.74,0.27,1
48729,4913,-1000.00,6000.00,7000.00,4060.31,3939.69,0.06,0
48730,4913,1000.00,7000.00,8000.00,0.00,7000.00,0.31,1
48731,4913,-1000.00,6000.00,7000.00,945.20,669.91,0.14,0
48732,4913,1000.00,7000.00,8000.00,0.00,7000.00,0.02,1
48733,4913,1000.00,8000.00,9000.00,0.00,2097.81,0.13,1
48734,4913,1000.00,9000.00,10000.00,0.00,4217.41,0.30,1
48735,4913,1000.00,10000.00,11000.00,0.00,6121.98,0.04,1
48736,4913,1000.00,11000.00,12000.00,0.00,10592.40,0.44,1
48737,4913,1000.00,12000.00,13000.00,0.00,12000.00,0.24,1
48738,4913,1000.00,13000.00,14000.00,0.00,5140.71,0.09,1
48739,4913,1000.00,14000.00,15000.00,6462.20,7537.80,0.18,1
48740,4913,1000.00,15000.00,16000.00,0.00,1890.67,0.02,1
48741,4913,1000.00,16000.00,17000.00,0.00,3707.90,0.09,1
48742,4913,1000.00,17000.00,18000.00,827.53,14535.92,0.43,1
48743,4913,1000.00,18000.00,19000.00,9000.00,9000.00,0.01,1
48744,4913,1000.00,19000.00,20000.00,0.00,8666.73,0.29,1
48745,4913,1000.00,20000.00,21000.00,0.00,6769.57,0.24,1
48746,4913,-1000.00,19000.00,20000.00,9543.49,11456.51,0.06,0
48747,4913,-1000.00,18000.00,19000.00,5285.31,14714.69,0.37,0
48748,4913,-1000.00,17000.00,18000.00,0.00,19000.00,0.03,0
48749,4913,-1000.00,16000.00,17000.00,0.00,14705.90,0.42,0
48750,4913,-1000.00,15000.00,16000.00,3630.10,13369.90,0.40,0
48751,4913,-1000.00,14000.00,15000.00,3353.26,12646.74,0.38,0
48752,4913,-1000.00,13000.00,14000.00,6435.29,8564.71,0.25,0
48753,4913,-1000.00,12000.00,13000.00,6058.61,0.00,0.07,0
48754,4913,0.00,12000.00,13000.00,0.00,0.00,0.07,0
48755,4913,-1000.00,11000.00,12000.00,1186.30,11813.70,0.37,0
48756,4913,-1000.00,10000.00,11000.00,3115.14,8884.86,0.38,0
48757,4913,-1000.00,9000.00,10000.00,4763.45,6236.55,0.18,0
48758,4913,-1000.00,8000.00,9000.00,1762.90,8237.10,0.25,0
48759,4913,-1000.00,7000.00,8000.00,3975.88,0.00,0.04,0
48760,4913,-1000.00,6000.00,7000.00,0.00,8000.00,0.20,0
48761,4913,-1000.00,5000.00,6000.00,0.00,6109.93,0.36,0
48762,4913,-1000.00,4000.00,5000.00,0.00,3433.19,0.30,0
48763,4913,-1000.00,3000.00,4000.00,1622.38,3377.62,0.23,0
48764,4913,-1000.00,2000.00,3000.00,0.00,4000.00,0.25,0
48765,4913,-1000.00,1000.00,2000.00,870.76,2129.24,0.24,0
48766,4913,-419.93,580.07,1580.07,0.00,419.93,0.18,0
48767,4914,-1000.00,-1000.00,0.00,0.00,1000.00,0.40,0
48768,4915,-1000.00,-1000.00,0.00,500.00,500.00,0.02,0
48769,4916,-1000.00,-1000.00,0.00,442.88,557.12,0.25,0
48770,4917,-1000.00,-1000.00,0.00,0.00,1000.00,0.02,0
48771,4918,-1000.00,-1000.00,0.00,0.00,66.49,0.42,0
48772,4919,-992.87,-992.87,7.13,0.00,992.87,0.40,0
48773,4919,-7.13,-1000.00,0.00,0.88,6.25,0.43,0
48774,4920,-1000.00,-1000.00,0.00,0.00,918.38,0.10,0
48775,4921,-207.31,-207.31,792.69,207.31,0.00,0.41,0
48776,4921,-638.46,-845.77,154.23,638.46,0.00,0.08,0
48777,4921,1000.00,154.23,1154.23,29.50,124.73,0.04,1
48778,4921,-569.49,-415.26,584.74,529.55,39.94,0.28,0
48779,4921,1000.00,584.74,1584.74,237.30,347.44,0.28,1
48780,4921,-1000.00,-415.26,584.74,891.21,693.53,0.17,0
48781,4921,1000.00,584.74,1584.74,0.00,584.74,0.02,1
48782,4921,1000.00,1584.74,2584.74,590.09,994.65,0.27,1
48783,4921,1000.00,2584.74,3584.74,0.00,367.19,0.13,1
48784,4921,1000.00,3584.74,4584.74,0.00,3515.18,0.15,1
48785,4921,1000.00,4584.74,5584.74,2292.37,2292.37,0.13,1
48786,4921,1000.00,5584.74,6584.74,516.74,5068.00,0.37,1
48787,4921,1000.00,6584.74,7584.74,2440.82,4143.93,0.20,1
48788,4921,1000.00,7584.74,8584.74,298.87,7285.87,0.43,1
48789,4921,1000.00,8584.74,9584.74,0.00,8584.74,0.09,1
48790,4921,1000.00,9584.74,10584.74,0.00,9584.74,0.00,1
48791,4921,1000.00,10584.74,11584.74,4955.01,5629.74,0.14,1
48792,4921,1000.00,11584.74,12584.74,0.00,11584.74,0.25,1
48793,4921,-1000.00,10584.74,11584.74,9746.23,2838.52,0.07,0
48794,4921,-1000.00,9584.74,10584.74,6202.10,3075.36,0.14,0
48795,4921,1000.00,10584.74,11584.74,0.00,10584.74,0.39,1
48796,4921,-1000.00,9584.74,10584.74,8395.19,275.18,0.06,0
48797,4921,1000.00,10584.74,11584.74,0.00,10584.74,0.25,1
48798,4921,1000.00,11584.74,12584.74,0.00,11584.74,0.18,1
48799,4921,-1000.00,10584.74,11584.74,5648.57,5822.10,0.29,0
48800,4921,-1000.00,9584.74,10584.74,0.00,9772.42,0.15,0
48801,4921,-1000.00,8584.74,9584.74,2766.92,7817.83,0.27,0
48802,4921,-1000.00,7584.74,8584.74,1952.11,7632.63,0.40,0
48803,4921,-1000.00,6584.74,7584.74,3701.62,4883.12,0.25,0
48804,4921,-1000.00,5584.74,6584.74,6260.34,1324.40,0.05,0
48805,4921,-1000.00,4584.74,5584.74,0.00,6584.74,0.01,0
48806,4921,-1000.00,3584.74,4584.74,212.47,5372.27,0.44,0
48807,4921,0.00,3584.74,4584.74,0.00,0.00,0.03,0
48808,4921,-1000.00,2584.74,3584.74,1206.46,3378.28,0.38,0
48809,4921,-1000.00,1584.74,2584.74,1792.37,1792.37,0.03,0
48810,4921,-1000.00,584.74,1584.74,496.57,2088.17,0.34,0
48811,4921,-1000.00,-415.26,584.74,698.64,886.10,0.19,0
48812,4921,-375.88,-791.14,208.86,0.00,375.88,0.13,0
48813,4921,-1000.00,-1791.14,-791.14,141.26,0.00,0.17,0
48814,4922,-1000.00,-1000.00,0.00,0.00,1000.00,0.12,0
48815,4923,-1000.00,-1000.00,0.00,0.00,1000.00,0.29,0
48816,4924,-804.61,-804.61,195.39,706.71,97.90,0.22,0
48817,4924,-1000.00,-1804.61,-804.61,0.00,37.24,0.20,0
48818,4925,-1000.00,-1000.00,0.00,498.64,501.36,0.16,0
48819,4926,-869.76,-869.76,130.24,390.54,479.22,0.36,0
48820,4926,-65.17,-934.92,65.08,2.14,63.02,0.44,0
48821,4926,-65.08,-1000.00,0.00,0.00,65.08,0.15,0
48822,4927,1000.00,1000.00,2000.00,446.34,553.66,0.26,1
48823,4927,1000.00,2000.00,3000.00,0.00,268.38,0.16,1
48824,4927,1000.00,3000.00,4000.00,1466.09,1533.91,0.09,1
48825,4927,1000.00,4000.00,5000.00,0.00,3563.27,0.32,1
48826,4927,1000.00,5000.00,6000.00,0.00,5000.00,0.20,1
48827,4927,1000.00,6000.00,7000.00,0.00,953.46,0.13,1
48828,4927,1000.00,7000.00,8000.00,0.00,4101.35,0.20,1
48829,4927,1000.00,8000.00,9000.00,0.00,8000.00,0.14,1
48830,4927,1000.00,9000.00,10000.00,0.00,2327.76,0.19,1
48831,4927,1000.00,10000.00,11000.00,0.00,10000.00,0.41,1
48832,4927,1000.00,11000.00,12000.00,0.00,11000.00,0.24,1
48833,4927,1000.00,12000.00,13000.00,0.00,11978.27,0.01,1
48834,4927,-1000.00,11000.00,12000.00,7007.24,5992.76,0.09,0
48835,4927,1000.00,12000.00,13000.00,0.00,12000.00,0.04,1
48836,4927,1000.00,13000.00,14000.00,6393.60,6606.40,0.23,1
48837,4927,1000.00,14000.00,15000.00,2750.54,11249.46,0.41,1
48838,4927,1000.00,15000.00,16000.00,4743.88,10256.12,0.24,1
48839,4927,1000.00,16000.00,17000.00,0.00,11504.43,0.10,1
48840,4927,1000.00,17000.00,18000.00,6288.51,10711.49,0.27,1
48841,4927,0.00,17000.00,18000.00,0.00,0.00,0.06,0
48842,4927,-1000.00,16000.00,17000.00,5223.76,12776.24,0.13,0
48843,4927,-1000.00,15000.00,16000.00,3400.30,6575.83,0.25,0
48844,4927,-1000.00,14000.00,15000.00,6877.29,9122.71,0.27,0
48845,4927,-1000.00,13000.00,14000.00,7179.34,7820.66,0.22,0
48846,4927,-1000.00,12000.00,13000.00,0.00,2449.81,0.41,0
48847,4927,-1000.00,11000.00,12000.00,6296.46,6703.54,0.12,0
48848,4927,-1000.00,10000.00,11000.00,0.00,12000.00,0.06,0
48849,4927,-1000.00,9000.00,10000.00,1526.24,9473.76,0.33,0
48850,4927,-1000.00,8000.00,9000.00,4975.87,5024.13,0.11,0
48851,4927,-1000.00,7000.00,8000.00,1967.30,6670.98,0.38,0
48852,4927,-1000.00,6000.00,7000.00,0.00,8000.00,0.42,0
48853,4927,-1000.00,5000.00,6000.00,0.00,3161.39,0.29,0
48854,4927,-1000.00,4000.00,5000.00,2650.89,3349.11,0.12,0
48855,4927,-1000.00,3000.00,4000.00,0.00,4808.48,0.44,0
48856,4927,-1000.00,2000.00,3000.00,1067.04,2932.96,0.37,0
48857,4927,-1000.00,1000.00,2000.00,743.25,2256.75,0.22,0
48858,4927,-1000.00,0.00,1000.00,0.00,1132.32,0.25,0
48859,4927,-1000.00,-1000.00,0.00,383.21,616.79,0.25,0
48860,4928,1000.00,1000.00,2000.00,0.00,855.21,0.26,1
48861,4928,-1000.00,0.00,1000.00,1293.29,232.06,0.08,0
48862,4928,1000.00,1000.00,2000.00,480.58,519.42,0.11,1
48863,4928,0.00,1000.00,2000.00,0.00,0.00,0.04,0
48864,4928,1000.00,2000.00,3000.00,207.30,820.54,0.27,1
48865,4928,1000.00,3000.00,4000.00,622.87,2377.13,0.40,1
48866,4928,1000.00,4000.00,5000.00,640.03,1081.71,0.20,1
48867,4928,1000.00,5000.00,6000.00,186.91,4813.09,0.12,1
48868,4928,1000.00,6000.00,7000.00,0.00,6000.00,0.42,1
48869,4928,1000.00,7000.00,8000.00,154.19,1788.41,0.20,1
48870,4928,1000.00,8000.00,9000.00,0.00,451.65,0.12,1
48871,4928,-1000.00,7000.00,8000.00,4949.72,4050.28,0.13,0
48872,4928,0.00,7000.00,8000.00,0.00,0.00,0.07,0
48873,4928,1000.00,8000.00,9000.00,0.00,8000.00,0.27,1
48874,4928,1000.00,9000.00,10000.00,0.00,8424.21,0.26,1
48875,4928,-1000.00,8000.00,9000.00,357.38,9642.62,0.05,0
48876,4928,-1000.00,7000.00,8000.00,2858.78,6141.22,0.30,0
48877,4928,-1000.00,6000.00,7000.00,1627.70,6372.30,0.41,0
48878,4928,-1000.00,5000.00,6000.00,3411.08,3588.92,0.03,0
48879,4928,-1000.00,4000.00,5000.00,0.00,2670.93,0.21,0
48880,4928,-1000.00,3000.00,4000.00,0.00,4485.58,0.40,0
48881,4928,-1000.00,2000.00,3000.00,0.00,4000.00,0.06,0
48882,4928,-1000.00,1000.00,2000.00,659.34,2340.66,0.21,0
48883,4928,-879.00,121.00,1121.00,0.00,879.00,0.09,0
48884,4928,-806.54,-685.54,314.46,0.00,806.54,0.19,0
48885,4928,-239.18,-924.72,75.28,5.09,234.09,0.40,0
48886,4928,1000.00,75.28,1075.28,43.57,31.71,0.17,1
48887,4928,-946.85,-871.57,128.43,6.81,940.04,0.43,0
48888,4928,-128.43,-1000.00,0.00,62.49,65.94,0.13,0
48889,4929,-984.82,-984.82,15.18,984.82,0.00,0.11,0
48890,4929,-1.46,-986.29,13.71,1.46,0.00,0.23,0
48891,4929,-1000.00,-1986.29,-986.29,4.33,9.38,0.26,0
48892,4930,0.00,0.00,1000.00,0.00,0.00,0.09,0
48893,4930,-1000.00,-1000.00,0.00,137.27,862.73,0.36,0
48894,4931,-1000.00,-1000.00,0.00,0.00,77.31,0.29,0
48895,4932,-1000.00,-1000.00,0.00,722.84,0.00,0.17,0
48896,4933,1000.00,1000.00,2000.00,0.00,1000.00,0.13,1
48897,4933,1000.00,2000.00,3000.00,513.82,1486.18,0.37,1
48898,4933,1000.00,3000.00,4000.00,692.77,2307.23,0.14,1
48899,4933,1000.00,4000.00,5000.00,0.00,4000.00,0.40,1
48900,4933,1000.00,5000.00,6000.00,0.00,5000.00,0.24,1
48901,4933,1000.00,6000.00,7000.00,0.00,6000.00,0.12,1
48902,4933,1000.00,7000.00,8000.00,1835.23,4256.63,0.32,1
48903,4933,1000.00,8000.00,9000.00,0.00,3707.86,0.29,1
48904,4933,1000.00,9000.00,10000.00,0.00,9000.00,0.08,1
48905,4933,1000.00,10000.00,11000.00,0.00,5025.28,0.20,1
48906,4933,-1000.00,9000.00,10000.00,5649.53,4762.99,0.20,0
48907,4933,1000.00,10000.00,11000.00,2383.37,7616.63,0.11,1
48908,4933,-1000.00,9000.00,10000.00,6868.96,1763.18,0.11,0
48909,4933,1000.00,10000.00,11000.00,3467.53,6532.47,0.24,1
48910,4933,1000.00,11000.00,12000.00,0.00,6426.57,0.37,1
48911,4933,1000.00,12000.00,13000.00,0.00,8260.17,0.23,1
48912,4933,-1000.00,11000.00,12000.00,7348.94,1890.05,0.10,0
48913,4933,1000.00,12000.00,13000.00,3197.36,8802.64,0.37,1
48914,4933,-1000.00,11000.00,12000.00,10625.81,0.00,0.01,0
48915,4933,1000.00,12000.00,13000.00,2364.90,9635.10,0.13,1
48916,4933,-1000.00,11000.00,12000.00,5657.60,5193.84,0.21,0
48917,4933,1000.00,12000.00,13000.00,5054.59,6945.41,0.13,1
48918,4933,-1000.00,11000.00,12000.00,6655.18,6344.82,0.41,0
48919,4933,-1000.00,10000.00,11000.00,0.00,5333.82,0.42,0
48920,4933,-1000.00,9000.00,10000.00,5500.00,5500.00,0.06,0
48921,4933,-1000.00,8000.00,9000.00,4456.14,5543.86,0.18,0
48922,4933,-1000.00,7000.00,8000.00,0.00,4958.15,0.20,0
48923,4933,-1000.00,6000.00,7000.00,3595.79,4404.21,0.02,0
48924,4933,-1000.00,5000.00,6000.00,938.50,6061.50,0.40,0
48925,4933,-1000.00,4000.00,5000.00,2984.20,3015.80,0.07,0
48926,4933,-1000.00,3000.00,4000.00,0.00,5000.00,0.03,0
48927,4933,-1000.00,2000.00,3000.00,0.00,4000.00,0.16,0
48928,4933,-1000.00,1000.00,2000.00,1249.03,1750.97,0.28,0
48929,4933,-1000.00,0.00,1000.00,723.75,1276.25,0.01,0
48930,4933,-476.43,-476.43,523.57,0.00,476.43,0.26,0
48931,4933,-1000.00,-1476.43,-476.43,501.46,22.12,0.02,0
48932,4934,-1000.00,-1000.00,0.00,230.17,638.76,0.34,0
48933,4935,1000.00,1000.00,2000.00,0.00,351.72,0.07,1
48934,4935,-873.34,126.66,1126.66,809.22,64.12,0.10,0
48935,4935,1000.00,1126.66,2126.66,309.15,817.51,0.37,1
48936,4935,1000.00,2126.66,3126.66,0.00,2126.66,0.32,1
48937,4935,1000.00,3126.66,4126.66,652.04,2474.62,0.40,1
48938,4935,1000.00,4126.66,5126.66,0.00,4126.66,0.12,1
48939,4935,1000.00,5126.66,6126.66,0.00,2845.82,0.22,1
48940,4935,1000.00,6126.66,7126.66,2566.95,3559.71,0.17,1
48941,4935,1000.00,7126.66,8126.66,0.00,6065.56,0.40,1
48942,4935,1000.00,8126.66,9126.66,3111.98,5014.68,0.25,1
48943,4935,1000.00,9126.66,10126.66,1165.96,7960.70,0.27,1
48944,4935,1000.00,10126.66,11126.66,2737.47,7389.19,0.04,1
48945,4935,1000.00,11126.66,12126.66,21.12,9928.33,0.44,1
48946,4935,1000.00,12126.66,13126.66,0.00,12126.66,0.30,1
48947,4935,1000.00,13126.66,14126.66,0.00,13126.66,0.15,1
48948,4935,1000.00,14126.66,15126.66,3598.37,10528.29,0.22,1
48949,4935,1000.00,15126.66,16126.66,0.00,15126.66,0.30,1
48950,4935,1000.00,16126.66,17126.66,0.00,13581.28,0.38,1
48951,4935,-1000.00,15126.66,16126.66,8664.93,8461.73,0.34,0
48952,4935,1000.00,16126.66,17126.66,0.00,16126.66,0.23,1
48953,4935,1000.00,17126.66,18126.66,2464.17,14662.49,0.41,1
48954,4935,1000.00,18126.66,19126.66,0.00,8298.69,0.12,1
48955,4935,1000.00,19126.66,20126.66,34.90,19091.76,0.27,1
48956,4935,1000.00,20126.66,21126.66,3274.50,15710.44,0.40,1
48957,4935,1000.00,21126.66,22126.66,7008.14,14118.52,0.13,1
48958,4935,1000.00,22126.66,23126.66,11063.33,11063.33,0.07,1
48959,4935,1000.00,23126.66,24126.66,0.00,23126.66,0.39,1
48960,4935,1000.00,24126.66,25126.66,10034.59,14092.07,0.15,1
48961,4935,1000.00,25126.66,26126.66,0.00,15861.23,0.36,1
48962,4935,1000.00,26126.66,27126.66,558.45,25568.21,0.17,1
48963,4935,1000.00,27126.66,28126.66,7788.48,19338.18,0.34,1
48964,4935,1000.00,28126.66,29126.66,4416.09,20938.50,0.39,1
48965,4935,-1000.00,27126.66,28126.66,18195.56,4278.09,0.09,0
48966,4935,1000.00,28126.66,29126.66,0.00,20515.10,0.35,1
48967,4935,1000.00,29126.66,30126.66,7496.07,21630.59,0.38,1
48968,4935,1000.00,30126.66,31126.66,458.90,23496.56,0.41,1
48969,4935,1000.00,31126.66,32126.66,0.00,31126.66,0.16,1
48970,4935,1000.00,32126.66,33126.66,6712.48,25414.18,0.19,1
48971,4935,-1000.00,31126.66,32126.66,17436.62,4116.21,0.10,0
48972,4935,1000.00,32126.66,33126.66,2544.93,29581.73,0.43,1
48973,4935,1000.00,33126.66,34126.66,1231.16,31895.50,0.36,1
48974,4936,-1000.00,-1000.00,0.00,0.00,1000.00,0.19,0
48975,4937,-175.41,-175.41,824.59,0.00,175.41,0.17,0
48976,4937,0.00,-175.41,824.59,0.00,0.00,0.04,0
48977,4937,-824.59,-1000.00,0.00,0.00,824.59,0.22,0
48978,4938,-1000.00,-1000.00,0.00,433.62,566.38,0.23,0
48979,4939,0.00,0.00,1000.00,0.00,0.00,0.12,0
48980,4939,0.00,0.00,1000.00,0.00,0.00,0.32,0
48981,4939,0.00,0.00,1000.00,0.00,0.00,0.25,0
48982,4939,-1000.00,-1000.00,0.00,347.69,624.49,0.37,0
48983,4940,-227.43,-227.43,772.57,0.00,227.43,0.18,0
48984,4940,-772.57,-1000.00,0.00,0.00,772.57,0.30,0
48985,4941,-820.55,-820.55,179.45,0.00,820.55,0.40,0
48986,4941,-179.45,-1000.00,0.00,0.00,179.45,0.43,0
48987,4942,-1000.00,-1000.00,0.00,0.00,1000.00,0.33,0
48988,4943,-1000.00,-1000.00,0.00,219.44,780.56,0.40,0
48989,4944,-1000.00,-1000.00,0.00,0.00,1000.00,0.10,0
48990,4945,-1000.00,-1000.00,0.00,0.00,1000.00,0.25,0
48991,4946,-1000.00,-1000.00,0.00,0.00,723.45,0.21,0
48992,4947,-192.36,-192.36,807.64,0.00,192.36,0.07,0
48993,4947,-1000.00,-1192.36,-192.36,473.08,307.42,0.16,0
48994,4948,-1000.00,-1000.00,0.00,418.97,581.03,0.21,0
48995,4949,-630.38,-630.38,369.62,0.00,630.38,0.30,0
48996,4949,-117.16,-747.55,252.45,0.00,117.16,0.23,0
48997,4949,-237.12,-984.67,15.33,40.11,197.01,0.40,0
48998,4949,0.00,-984.67,15.33,0.00,0.00,0.00,0
48999,4949,-1000.00,-1984.67,-984.67,15.33,0.00,0.00,0
49000,4950,-1000.00,-1000.00,0.00,601.04,398.96,0.04,0
49001,4951,-696.66,-696.66,303.34,376.20,320.46,0.19,0
49002,4951,-1000.00,-1696.66,-696.66,91.54,211.79,0.33,0
49003,4952,-1000.00,-1000.00,0.00,666.52,0.00,0.16,0
49004,4953,0.00,0.00,1000.00,0.00,0.00,0.23,0
49005,4953,-104.08,-104.08,895.92,104.08,0.00,0.29,0
49006,4953,-1000.00,-1104.08,-104.08,140.56,755.36,0.42,0
49007,4954,-1000.00,-1000.00,0.00,0.00,1000.00,0.04,0
49008,4955,-1000.00,-1000.00,0.00,0.00,1000.00,0.35,0
49009,4956,-1000.00,-1000.00,0.00,232.47,767.53,0.14,0
49010,4957,1000.00,1000.00,2000.00,524.68,0.00,0.02,1
49011,4957,0.00,1000.00,2000.00,0.00,0.00,0.25,0
49012,4957,0.00,1000.00,2000.00,0.00,0.00,0.38,0
49013,4957,-1000.00,0.00,1000.00,0.00,2000.00,0.42,0
49014,4957,0.00,0.00,1000.00,0.00,0.00,0.15,0
49015,4957,-716.92,-716.92,283.08,119.22,597.70,0.43,0
49016,4957,-283.08,-1000.00,0.00,0.00,283.08,0.33,0
49017,4958,0.00,0.00,1000.00,0.00,0.00,0.13,0
49018,4958,0.00,0.00,1000.00,0.00,0.00,0.24,0
49019,4958,1000.00,1000.00,2000.00,290.55,0.00,0.09,1
49020,4958,1000.00,2000.00,3000.00,715.95,0.00,0.19,1
49021,4958,0.00,2000.00,3000.00,0.00,0.00,0.43,0
49022,4958,1000.00,3000.00,4000.00,1342.09,0.00,0.21,1
49023,4958,-163.25,2836.75,3836.75,15.97,147.28,0.44,0
49024,4958,1000.00,3836.75,4836.75,2040.22,1796.53,0.04,1
49025,4958,0.00,3836.75,4836.75,0.00,0.00,0.00,0
49026,4958,0.00,3836.75,4836.75,0.00,0.00,0.23,0
49027,4958,-1000.00,2836.75,3836.75,0.00,2165.58,0.28,0
49028,4958,1000.00,3836.75,4836.75,2361.71,1475.03,0.06,1
49029,4958,1000.00,4836.75,5836.75,2693.42,2143.33,0.01,1
49030,4958,1000.00,5836.75,6836.75,2929.10,2907.65,0.08,1
49031,4958,-1000.00,4836.75,5836.75,2819.18,4017.57,0.21,0
49032,4958,-1000.00,3836.75,4836.75,442.35,2825.33,0.32,0
49033,4958,1000.00,4836.75,5836.75,1075.25,0.00,0.38,1
49034,4958,1000.00,5836.75,6836.75,831.06,0.00,0.42,1
49035,4958,0.00,5836.75,6836.75,0.00,0.00,0.27,0
49036,4958,-1000.00,4836.75,5836.75,2676.30,3639.24,0.44,0
49037,4958,-1000.00,3836.75,4836.75,2918.37,2918.37,0.30,0
49038,4958,0.00,3836.75,4836.75,0.00,0.00,0.11,0
49039,4958,-1000.00,2836.75,3836.75,2398.55,2438.20,0.39,0
49040,4958,0.00,2836.75,3836.75,0.00,0.00,0.22,0
49041,4958,-1000.00,1836.75,2836.75,0.00,1761.09,0.30,0
49042,4958,1000.00,2836.75,3836.75,2740.36,0.00,0.11,1
49043,4958,1000.00,3836.75,4836.75,1916.05,0.00,0.28,1
49044,4958,-459.49,3377.25,4377.25,0.00,459.49,0.38,0
49045,4958,1000.00,4377.25,5377.25,2138.81,1371.79,0.28,1
49046,4958,-1000.00,3377.25,4377.25,0.00,3280.92,0.12,0
49047,4958,-1000.00,2377.25,3377.25,800.62,1036.09,0.39,0
49048,4958,0.00,2377.25,3377.25,0.00,0.00,0.39,0
49049,4959,-1000.00,-1000.00,0.00,0.00,1000.00,0.07,0
49050,4960,-1000.00,-1000.00,0.00,0.00,893.39,0.10,0
49051,4961,1000.00,1000.00,2000.00,1000.00,0.00,0.01,1
49052,4961,1000.00,2000.00,3000.00,1073.44,926.56,0.04,1
49053,4961,1000.00,3000.00,4000.00,3000.00,0.00,0.05,1
49054,4961,-1000.00,2000.00,3000.00,1619.88,1858.79,0.24,0
49055,4961,-1000.00,1000.00,2000.00,936.21,2063.79,0.33,0
49056,4961,-1000.00,0.00,1000.00,0.00,2000.00,0.29,0
49057,4961,-1000.00,-1000.00,0.00,0.00,1000.00,0.32,0
49058,4962,1000.00,1000.00,2000.00,99.03,900.97,0.14,1
49059,4962,1000.00,2000.00,3000.00,0.00,2000.00,0.03,1
49060,4962,1000.00,3000.00,4000.00,0.00,2421.94,0.30,1
49061,4962,1000.00,4000.00,5000.00,0.00,4000.00,0.19,1
49062,4962,-996.71,3003.29,4003.29,996.71,0.00,0.09,0
49063,4962,-1000.00,2003.29,3003.29,2906.10,1097.19,0.07,0
49064,4962,1000.00,3003.29,4003.29,0.00,3003.29,0.27,1
49065,4962,1000.00,4003.29,5003.29,0.00,3065.86,0.41,1
49066,4962,1000.00,5003.29,6003.29,0.00,5003.29,0.19,1
49067,4962,0.00,5003.29,6003.29,0.00,0.00,0.02,0
49068,4962,1000.00,6003.29,7003.29,0.00,2229.35,0.23,1
49069,4962,1000.00,7003.29,8003.29,0.00,7003.29,0.36,1
49070,4962,1000.00,8003.29,9003.29,525.95,7477.34,0.35,1
49071,4962,1000.00,9003.29,10003.29,0.00,3343.03,0.24,1
49072,4962,1000.00,10003.29,11003.29,0.00,10003.29,0.34,1
49073,4962,1000.00,11003.29,12003.29,3670.61,7332.68,0.29,1
49074,4962,-1000.00,10003.29,11003.29,6001.65,6001.65,0.41,0
49075,4962,-1000.00,9003.29,10003.29,6572.44,0.00,0.05,0
49076,4962,-1000.00,8003.29,9003.29,0.00,10003.29,0.09,0
49077,4962,-1000.00,7003.29,8003.29,3062.10,3310.47,0.22,0
49078,4962,-1000.00,6003.29,7003.29,760.22,7243.07,0.34,0
49079,4962,-1000.00,5003.29,6003.29,3036.14,3967.15,0.28,0
49080,4962,-1000.00,4003.29,5003.29,2781.62,3221.68,0.24,0
49081,4962,-1000.00,3003.29,4003.29,0.00,5003.29,0.14,0
49082,4962,-1000.00,2003.29,3003.29,0.00,4003.29,0.15,0
49083,4962,-1000.00,1003.29,2003.29,1501.65,1501.65,0.06,0
49084,4962,-1000.00,3.29,1003.29,0.00,1229.70,0.35,0
49085,4962,-1000.00,-996.71,3.29,38.29,693.98,0.39,0
49086,4962,-305.53,-1302.24,-302.24,1.41,1.89,0.19,0
49087,4963,-1000.00,-1000.00,0.00,0.00,1000.00,0.19,0
49088,4964,-1000.00,-1000.00,0.00,403.53,596.47,0.23,0
49089,4965,1000.00,1000.00,2000.00,0.00,677.81,0.34,1
49090,4965,1000.00,2000.00,3000.00,55.49,1944.51,0.33,1
49091,4965,0.00,2000.00,3000.00,0.00,0.00,0.01,0
49092,4965,1000.00,3000.00,4000.00,0.00,2158.64,0.25,1
49093,4965,1000.00,4000.00,5000.00,570.39,3429.61,0.14,1
49094,4965,1000.00,5000.00,6000.00,0.00,2522.01,0.18,1
49095,4965,1000.00,6000.00,7000.00,0.00,6000.00,0.40,1
49096,4965,1000.00,7000.00,8000.00,0.00,7000.00,0.01,1
49097,4965,0.00,7000.00,8000.00,0.00,0.00,0.03,0
49098,4965,1000.00,8000.00,9000.00,0.00,8000.00,0.09,1
49099,4965,-1000.00,7000.00,8000.00,4860.16,4139.84,0.04,0
49100,4965,1000.00,8000.00,9000.00,0.00,4978.55,0.14,1
49101,4965,1000.00,9000.00,10000.00,0.00,9000.00,0.08,1
49102,4965,1000.00,10000.00,11000.00,0.00,10000.00,0.28,1
49103,4965,1000.00,11000.00,12000.00,100.58,10899.42,0.39,1
49104,4965,1000.00,12000.00,13000.00,0.00,574.23,0.06,1
49105,4965,1000.00,13000.00,14000.00,3727.66,9272.34,0.10,1
49106,4965,1000.00,14000.00,15000.00,0.00,13851.13,0.04,1
49107,4965,1000.00,15000.00,16000.00,6113.40,8886.60,0.28,1
49108,4965,1000.00,16000.00,17000.00,8000.00,8000.00,0.23,1
49109,4965,1000.00,17000.00,18000.00,7754.82,9245.18,0.21,1
49110,4965,1000.00,18000.00,19000.00,0.00,18000.00,0.24,1
49111,4965,1000.00,19000.00,20000.00,0.00,19000.00,0.37,1
49112,4965,1000.00,20000.00,21000.00,0.00,19297.61,0.08,1
49113,4965,-1000.00,19000.00,20000.00,12915.35,8084.65,0.32,0
49114,4965,1000.00,20000.00,21000.00,2167.17,17832.83,0.29,1
49115,4965,1000.00,21000.00,22000.00,3900.63,17099.37,0.05,1
49116,4965,1000.00,22000.00,23000.00,8254.71,13745.29,0.29,1
49117,4965,1000.00,23000.00,24000.00,2543.33,20456.67,0.08,1
49118,4965,1000.00,24000.00,25000.00,11995.44,12004.56,0.13,1
49119,4965,1000.00,25000.00,26000.00,0.00,18182.92,0.34,1
49120,4965,1000.00,26000.00,27000.00,2353.14,23646.86,0.41,1
49121,4965,1000.00,27000.00,28000.00,9454.08,17545.92,0.29,1
49122,4965,1000.00,28000.00,29000.00,0.00,28000.00,0.32,1
49123,4965,1000.00,29000.00,30000.00,0.00,17271.13,0.27,1
49124,4965,1000.00,30000.00,31000.00,5153.27,24846.73,0.36,1
49125,4965,-1000.00,29000.00,30000.00,12456.02,0.00,0.04,0
49126,4966,-1000.00,-1000.00,0.00,0.00,1000.00,0.39,0
49127,4967,1000.00,1000.00,2000.00,129.14,870.86,0.01,1
49128,4967,1000.00,2000.00,3000.00,634.51,1365.49,0.32,1
49129,4967,1000.00,3000.00,4000.00,1400.96,1599.04,0.23,1
49130,4967,1000.00,4000.00,5000.00,0.00,4000.00,0.05,1
49131,4967,-1000.00,3000.00,4000.00,3103.69,1896.31,0.08,0
49132,4967,1000.00,4000.00,5000.00,438.56,2887.90,0.39,1
49133,4967,1000.00,5000.00,6000.00,409.01,1801.45,0.25,1
49134,4967,1000.00,6000.00,7000.00,3000.00,3000.00,0.03,1
49135,4967,1000.00,7000.00,8000.00,3497.01,3502.99,0.22,1
49136,4967,1000.00,8000.00,9000.00,2437.18,5562.82,0.13,1
49137,4967,1000.00,9000.00,10000.00,0.00,3788.43,0.26,1
49138,4967,1000.00,10000.00,11000.00,629.60,6680.02,0.38,1
49139,4967,-1000.00,9000.00,10000.00,5527.08,5472.92,0.12,0
49140,4967,1000.00,10000.00,11000.00,3212.59,6787.41,0.34,1
49141,4967,-1000.00,9000.00,10000.00,7376.33,2990.13,0.11,0
49142,4967,1000.00,10000.00,11000.00,3890.27,6109.73,0.25,1
49143,4967,1000.00,11000.00,12000.00,916.54,7371.14,0.38,1
49144,4967,-1000.00,10000.00,11000.00,5837.50,1706.16,0.11,0
49145,4967,1000.00,11000.00,12000.00,1407.89,9592.11,0.34,1
49146,4967,1000.00,12000.00,13000.00,3637.88,8362.12,0.13,1
49147,4967,-1000.00,11000.00,12000.00,7941.14,5058.86,0.37,0
49148,4967,-1000.00,10000.00,11000.00,0.00,12000.00,0.15,0
49149,4967,-1000.00,9000.00,10000.00,2490.30,8509.70,0.19,0
49150,4967,-1000.00,8000.00,9000.00,526.66,9473.34,0.39,0
49151,4967,-1000.00,7000.00,8000.00,0.00,2825.41,0.13,0
49152,4967,-1000.00,6000.00,7000.00,0.00,8000.00,0.39,0
49153,4967,-1000.00,5000.00,6000.00,2799.21,4200.79,0.08,0
49154,4967,-1000.00,4000.00,5000.00,2182.76,3817.24,0.10,0
49155,4967,-1000.00,3000.00,4000.00,0.00,3961.32,0.42,0
49156,4967,-1000.00,2000.00,3000.00,1216.79,2277.95,0.30,0
49157,4967,-1000.00,1000.00,2000.00,0.00,3000.00,0.15,0
49158,4967,-1000.00,0.00,1000.00,0.00,2000.00,0.37,0
49159,4967,-322.72,-322.72,677.28,0.00,322.72,0.13,0
49160,4967,-87.59,-410.31,589.69,0.00,87.59,0.15,0
49161,4967,-589.69,-1000.00,0.00,173.93,415.76,0.36,0
49162,4968,-1000.00,-1000.00,0.00,0.00,383.48,0.10,0
49163,4969,-1000.00,-1000.00,0.00,467.12,532.88,0.11,0
49164,4970,-1000.00,-1000.00,0.00,803.36,196.64,0.05,0
49165,4971,-287.24,-287.24,712.76,0.00,287.24,0.21,0
49166,4971,-282.32,-569.56,430.44,0.00,282.32,0.27,0
49167,4971,-91.52,-661.08,338.92,0.00,91.52,0.17,0
49168,4971,-42.93,-704.01,295.99,0.00,42.93,0.12,0
49169,4971,-1000.00,-1704.01,-704.01,179.68,101.30,0.15,0
49170,4972,-1000.00,-1000.00,0.00,534.43,464.72,0.27,0
49171,4973,-1000.00,-1000.00,0.00,556.10,443.90,0.11,0
49172,4974,-1000.00,-1000.00,0.00,545.16,454.84,0.15,0
49173,4975,-1000.00,-1000.00,0.00,0.00,494.61,0.10,0
49174,4976,-1000.00,-1000.00,0.00,491.31,508.69,0.11,0
49175,4977,1000.00,1000.00,2000.00,0.00,1000.00,0.13,1
49176,4977,1000.00,2000.00,3000.00,0.00,2000.00,0.11,1
49177,4977,1000.00,3000.00,4000.00,631.62,2368.38,0.39,1
49178,4977,1000.00,4000.00,5000.00,2000.00,2000.00,0.20,1
49179,4977,1000.00,5000.00,6000.00,0.00,311.49,0.07,1
49180,4977,-1000.00,4000.00,5000.00,3456.60,2543.40,0.17,0
49181,4977,1000.00,5000.00,6000.00,1099.89,3900.11,0.21,1
49182,4977,1000.00,6000.00,7000.00,1199.50,4800.50,0.14,1
49183,4977,1000.00,7000.00,8000.00,0.00,1493.29,0.16,1
49184,4977,1000.00,8000.00,9000.00,2528.46,5471.54,0.21,1
49185,4977,1000.00,9000.00,10000.00,0.00,9000.00,0.30,1
49186,4977,1000.00,10000.00,11000.00,3650.23,6349.77,0.31,1
49187,4977,1000.00,11000.00,12000.00,0.00,11000.00,0.41,1
49188,4977,1000.00,12000.00,13000.00,0.00,12000.00,0.07,1
49189,4977,1000.00,13000.00,14000.00,296.94,12155.43,0.44,1
49190,4977,1000.00,14000.00,15000.00,6977.82,7022.18,0.13,1
49191,4977,1000.00,15000.00,16000.00,0.00,15000.00,0.30,1
49192,4977,1000.00,16000.00,17000.00,7371.07,8628.93,0.16,1
49193,4977,1000.00,17000.00,18000.00,4703.89,12296.11,0.31,1
49194,4977,1000.00,18000.00,19000.00,7613.99,10386.01,0.07,1
49195,4977,-1000.00,17000.00,18000.00,9500.00,9500.00,0.43,0
49196,4977,-1000.00,16000.00,17000.00,2227.78,2687.28,0.42,0
49197,4977,-1000.00,15000.00,16000.00,0.00,17000.00,0.04,0
49198,4977,-1000.00,14000.00,15000.00,502.68,15497.32,0.35,0
49199,4977,-1000.00,13000.00,14000.00,0.00,11854.13,0.37,0
49200,4977,-1000.00,12000.00,13000.00,0.00,14000.00,0.38,0
49201,4977,-1000.00,11000.00,12000.00,0.00,7946.26,0.11,0
49202,4977,-1000.00,10000.00,11000.00,7307.78,4692.22,0.07,0
49203,4977,-1000.00,9000.00,10000.00,5500.00,5500.00,0.10,0
49204,4977,-1000.00,8000.00,9000.00,0.00,10000.00,0.25,0
49205,4977,-1000.00,7000.00,8000.00,425.95,8574.05,0.44,0
49206,4977,-1000.00,6000.00,7000.00,3504.99,4495.01,0.21,0
49207,4977,-933.85,5066.15,6066.15,0.00,933.85,0.15,0
49208,4977,-1000.00,4066.15,5066.15,0.00,6066.15,0.06,0
49209,4977,-1000.00,3066.15,4066.15,1372.54,3693.60,0.37,0
49210,4977,-1000.00,2066.15,3066.15,1149.97,1627.70,0.24,0
49211,4977,-1000.00,1066.15,2066.15,641.93,2424.22,0.40,0
49212,4977,-1000.00,66.15,1066.15,626.36,1439.78,0.22,0
49213,4977,1000.00,1066.15,2066.15,484.87,581.28,0.12,1
49214,4977,1000.00,2066.15,3066.15,236.63,673.27,0.38,1
49215,4977,1000.00,3066.15,4066.15,0.00,2856.37,0.33,1
49216,4977,1000.00,4066.15,5066.15,1649.86,2416.28,0.01,1
49217,4977,1000.00,5066.15,6066.15,0.00,5066.15,0.35,1
49218,4977,1000.00,6066.15,7066.15,0.00,6066.15,0.06,1
49219,4977,1000.00,7066.15,8066.15,416.44,6649.70,0.44,1
49220,4977,-1000.00,6066.15,7066.15,0.00,6864.09,0.36,0
49221,4977,-1000.00,5066.15,6066.15,0.00,3198.31,0.29,0
49222,4977,-1000.00,4066.15,5066.15,0.00,5938.41,0.35,0
49223,4977,-1000.00,3066.15,4066.15,1246.75,3819.39,0.27,0
49224,4977,-1000.00,2066.15,3066.15,0.00,4066.15,0.22,0
49225,4977,-1000.00,1066.15,2066.15,143.83,2633.97,0.43,0
49226,4977,-1000.00,66.15,1066.15,0.00,1945.00,0.28,0
49227,4977,-765.60,-699.46,300.54,458.50,307.11,0.17,0
49228,4977,-300.54,-1000.00,0.00,183.91,116.64,0.21,0
49229,4978,-1000.00,-1000.00,0.00,0.00,1000.00,0.05,0
49230,4979,-1000.00,-1000.00,0.00,454.26,545.74,0.25,0
49231,4980,-1000.00,-1000.00,0.00,0.00,461.23,0.24,0
49232,4981,-1000.00,-1000.00,0.00,449.21,550.79,0.13,0
49233,4982,-501.29,-501.29,498.71,501.29,0.00,0.11,0
49234,4982,-1000.00,-1501.29,-501.29,0.00,15.13,0.07,0
49235,4983,1000.00,1000.00,2000.00,668.25,0.00,0.03,1
49236,4983,1000.00,2000.00,3000.00,1533.30,0.00,0.06,1
49237,4983,-1000.00,1000.00,2000.00,1183.52,1816.48,0.10,0
49238,4983,0.00,1000.00,2000.00,0.00,0.00,0.25,0
49239,4983,-1000.00,0.00,1000.00,1000.00,1000.00,0.14,0
49240,4983,1000.00,1000.00,2000.00,71.01,0.00,0.35,1
49241,4983,-1000.00,0.00,1000.00,422.88,1577.12,0.39,0
49242,4983,0.00,0.00,1000.00,0.00,0.00,0.22,0
49243,4983,-422.23,-422.23,577.77,0.00,422.23,0.05,0
49244,4983,-40.71,-462.94,537.06,0.00,40.71,0.18,0
49245,4983,-145.18,-608.12,391.88,0.00,145.18,0.05,0
49246,4983,-391.88,-1000.00,-0.00,41.77,350.11,0.28,0
49247,4984,-1000.00,-1000.00,0.00,0.00,1000.00,0.20,0
49248,4985,-220.66,-220.66,779.34,0.00,220.66,0.39,0
49249,4985,-582.21,-802.87,197.13,0.00,582.21,0.10,0
49250,4985,1000.00,197.13,1197.13,102.00,0.00,0.23,1
49251,4985,-1000.00,-802.87,197.13,0.00,1197.13,0.18,0
49252,4985,-126.89,-929.76,70.24,0.00,126.89,0.18,0
49253,4985,-70.24,-1000.00,0.00,0.00,70.24,0.12,0
49254,4986,-271.80,-271.80,728.20,0.00,271.80,0.23,0
49255,4986,-606.78,-878.58,121.42,0.00,606.78,0.34,0
49256,4986,-1000.00,-1878.58,-878.58,62.54,37.49,0.16,0
49257,4987,-1000.00,-1000.00,0.00,452.19,547.81,0.24,0
49258,4988,-209.97,-209.97,790.03,0.00,209.97,0.12,0
49259,4988,-790.03,-1000.00,0.00,257.45,532.57,0.24,0
49260,4989,-1000.00,-1000.00,0.00,0.00,1000.00,0.30,0
49261,4990,-126.42,-126.42,873.58,0.00,126.42,0.40,0
49262,4990,1000.00,873.58,1873.58,182.94,0.00,0.22,1
49263,4990,1000.00,1873.58,2873.58,999.73,0.00,0.18,1
49264,4990,1000.00,2873.58,3873.58,1178.66,0.00,0.14,1
49265,4990,-1000.00,1873.58,2873.58,1571.08,2302.50,0.05,0
49266,4990,1000.00,2873.58,3873.58,2685.31,188.27,0.07,1
49267,4990,0.00,2873.58,3873.58,0.00,0.00,0.26,0
49268,4990,-1000.00,1873.58,2873.58,1719.70,2153.88,0.25,0
49269,4990,1000.00,2873.58,3873.58,2206.06,0.00,0.17,1
49270,4990,0.00,2873.58,3873.58,0.00,0.00,0.34,0
49271,4990,1000.00,3873.58,4873.58,1539.77,0.00,0.35,1
49272,4990,-352.52,3521.06,4521.06,0.00,352.52,0.37,0
49273,4990,-1000.00,2521.06,3521.06,0.00,4521.06,0.29,0
49274,4990,1000.00,3521.06,4521.06,2939.75,581.30,0.11,1
49275,4990,-1000.00,2521.06,3521.06,2084.25,2436.80,0.05,0
49276,4990,1000.00,3521.06,4521.06,1802.81,1718.25,0.22,1
49277,4990,1000.00,4521.06,5521.06,3462.39,0.00,0.15,1
49278,4990,1000.00,5521.06,6521.06,3836.44,0.00,0.22,1
49279,4990,-1000.00,4521.06,5521.06,1018.65,5502.41,0.19,0
49280,4990,0.00,4521.06,5521.06,0.00,0.00,0.11,0
49281,4990,0.00,4521.06,5521.06,0.00,0.00,0.34,0
49282,4990,-1000.00,3521.06,4521.06,1155.81,4365.24,0.06,0
49283,4990,1000.00,4521.06,5521.06,564.97,46.81,0.43,1
49284,4990,-1000.00,3521.06,4521.06,753.28,1848.44,0.37,0
49285,4990,-1000.00,2521.06,3521.06,0.00,1501.41,0.24,0
49286,4990,1000.00,3521.06,4521.06,1034.26,0.00,0.13,1
49287,4990,-1000.00,2521.06,3521.06,0.00,1444.68,0.38,0
49288,4990,-1000.00,1521.06,2521.06,179.08,3007.29,0.43,0
49289,4990,0.00,1521.06,2521.06,0.00,0.00,0.14,0
49290,4990,1000.00,2521.06,3521.06,1838.68,301.17,0.11,1
49291,4990,-1000.00,1521.06,2521.06,0.00,3521.06,0.21,0
49292,4990,1000.00,2521.06,3521.06,1432.66,1062.45,0.18,1
49293,4990,0.00,2521.06,3521.06,0.00,0.00,0.00,0
49294,4990,1000.00,3521.06,4521.06,1625.13,484.62,0.32,1
49295,4990,0.00,3521.06,4521.06,0.00,0.00,0.08,0
49296,4991,0.00,0.00,1000.00,442.11,557.89,0.15,0
49297,4991,0.00,0.00,1000.00,0.00,542.81,0.36,0
49298,4991,0.00,0.00,1000.00,0.00,1000.00,0.14,0
49299,4991,0.00,0.00,1000.00,308.41,691.59,0.39,0
49300,4991,0.00,0.00,1000.00,0.00,1000.00,0.40,0
49301,4991,0.00,0.00,1000.00,0.00,1000.00,0.07,0
49302,4991,0.00,0.00,1000.00,0.00,995.09,0.18,0
49303,4991,0.00,0.00,1000.00,141.63,858.37,0.06,0
49304,4991,0.00,0.00,1000.00,359.69,640.31,0.29,0
49305,4991,0.00,0.00,1000.00,0.00,1000.00,0.12,0
49306,4991,0.00,0.00,1000.00,0.00,512.74,0.03,0
49307,4991,0.00,0.00,1000.00,0.00,1000.00,0.09,0
49308,4991,0.00,0.00,1000.00,48.51,101.00,0.14,0
49309,4991,0.00,0.00,1000.00,340.86,659.14,0.20,0
49310,4991,0.00,0.00,1000.00,0.00,1000.00,0.08,0
49311,4991,0.00,0.00,1000.00,336.23,663.77,0.32,0
49312,4991,0.00,0.00,1000.00,436.26,563.74,0.40,0
49313,4991,0.00,0.00,1000.00,0.00,776.58,0.24,0
49314,4991,0.00,0.00,1000.00,431.36,568.64,0.28,0
49315,4991,0.00,0.00,1000.00,0.00,527.52,0.33,0
49316,4991,0.00,0.00,1000.00,0.00,229.21,0.09,0
49317,4991,0.00,0.00,1000.00,0.00,912.01,0.29,0
49318,4991,0.00,0.00,1000.00,0.00,773.78,0.14,0
49319,4991,-1000.00,-1000.00,0.00,589.36,410.64,0.18,0
49320,4992,-1000.00,-1000.00,0.00,0.00,1000.00,0.11,0
49321,4993,-570.79,-570.79,429.21,570.79,0.00,0.28,0
49322,4993,-1000.00,-1570.79,-570.79,91.13,193.31,0.31,0
49323,4994,-1000.00,-1000.00,0.00,0.00,1000.00,0.41,0
49324,4995,-1000.00,-1000.00,0.00,0.00,1000.00,0.19,0
49325,4996,-1000.00,-1000.00,0.00,0.00,1000.00,0.03,0
49326,4997,-1000.00,-1000.00,0.00,312.66,687.34,0.18,0
49327,4998,1000.00,1000.00,2000.00,0.00,1000.00,0.10,1
49328,4998,-1000.00,0.00,1000.00,1016.93,983.07,0.14,0
49329,4998,1000.00,1000.00,2000.00,0.00,1000.00,0.13,1
49330,4998,-1000.00,0.00,1000.00,2000.00,0.00,0.00,0
49331,4998,1000.00,1000.00,2000.00,43.32,956.68,0.24,1
49332,4998,1000.00,2000.00,3000.00,0.00,2000.00,0.42,1
49333,4998,1000.00,3000.00,4000.00,0.00,3000.00,0.36,1
49334,4998,-1000.00,2000.00,3000.00,2035.27,1964.73,0.20,0
49335,4998,1000.00,3000.00,4000.00,0.00,1195.90,0.25,1
49336,4998,1000.00,4000.00,5000.00,1242.16,2757.84,0.32,1
49337,4998,1000.00,5000.00,6000.00,1386.59,3613.41,0.29,1
49338,4998,1000.00,6000.00,7000.00,1356.83,4643.17,0.17,1
49339,4998,1000.00,7000.00,8000.00,377.41,5406.44,0.41,1
49340,4998,1000.00,8000.00,9000.00,0.00,6470.20,0.37,1
49341,4998,1000.00,9000.00,10000.00,0.00,6576.58,0.40,1
49342,4998,1000.00,10000.00,11000.00,0.00,10000.00,0.42,1
49343,4998,1000.00,11000.00,12000.00,0.00,11000.00,0.14,1
49344,4998,1000.00,12000.00,13000.00,0.00,9514.23,0.23,1
49345,4998,1000.00,13000.00,14000.00,5186.97,7813.03,0.37,1
49346,4998,-1000.00,12000.00,13000.00,7000.00,7000.00,0.40,0
49347,4998,-1000.00,11000.00,12000.00,0.00,13000.00,0.22,0
49348,4998,-1000.00,10000.00,11000.00,0.00,12000.00,0.41,0
49349,4998,-1000.00,9000.00,10000.00,0.00,7703.87,0.43,0
49350,4998,-1000.00,8000.00,9000.00,0.00,8031.12,0.35,0
49351,4998,-1000.00,7000.00,8000.00,507.93,8492.07,0.44,0
49352,4998,-1000.00,6000.00,7000.00,0.00,6439.93,0.29,0
49353,4998,-1000.00,5000.00,6000.00,1828.81,5171.19,0.38,0
49354,4998,-1000.00,4000.00,5000.00,3275.50,1962.15,0.16,0
49355,4998,-1000.00,3000.00,4000.00,2052.60,2947.40,0.21,0
49356,4998,-1000.00,2000.00,3000.00,1211.11,2788.89,0.07,0
49357,4998,-1000.00,1000.00,2000.00,589.49,2410.51,0.00,0
49358,4998,0.00,1000.00,2000.00,0.00,0.00,0.01,0
49359,4998,-1000.00,0.00,1000.00,105.86,1894.14,0.21,0
49360,4998,-329.47,-329.47,670.53,30.68,298.78,0.22,0
49361,4998,-670.53,-1000.00,0.00,272.48,398.05,0.28,0
49362,4999,0.00,0.00,1000.00,0.00,0.00,0.37,0
49363,4999,0.00,0.00,1000.00,0.00,0.00,0.36,0
49364,4999,1000.00,1000.00,2000.00,93.24,0.00,0.03,1
49365,4999,1000.00,2000.00,3000.00,600.62,0.00,0.24,1
49366,4999,1000.00,3000.00,4000.00,1621.55,1378.45,0.14,1
49367,4999,1000.00,4000.00,5000.00,1589.35,0.00,0.27,1
49368,4999,0.00,4000.00,5000.00,0.00,0.00,0.09,0
49369,4999,-1000.00,3000.00,4000.00,1521.07,3478.93,0.35,0
49370,4999,0.00,3000.00,4000.00,0.00,0.00,0.08,0
49371,4999,-1000.00,2000.00,3000.00,0.00,1586.66,0.24,0
49372,4999,-1000.00,1000.00,2000.00,654.75,2345.25,0.33,0
49373,4999,-1000.00,0.00,1000.00,724.19,1275.81,0.31,0
49374,4999,-1000.00,-1000.00,0.00,49.21,950.79,0.31,0
49375,5000,-1000.00,-1000.00,0.00,0.00,406.30,0.21,0
49376,5001,1000.00,1000.00,2000.00,0.00,1000.00,0.16,1
49377,5001,1000.00,2000.00,3000.00,514.31,1485.69,0.04,1
49378,5001,1000.00,3000.00,4000.00,0.00,2574.00,0.13,1
49379,5001,1000.00,4000.00,5000.00,362.82,3637.18,0.34,1
49380,5001,1000.00,5000.00,6000.00,1255.17,2766.97,0.31,1
49381,5001,1000.00,6000.00,7000.00,1497.63,4502.37,0.31,1
49382,5001,1000.00,7000.00,8000.00,0.00,5659.65,0.04,1
49383,5001,1000.00,8000.00,9000.00,0.00,7509.42,0.31,1
49384,5001,1000.00,9000.00,10000.00,0.00,9000.00,0.01,1
49385,5001,1000.00,10000.00,11000.00,0.00,10000.00,0.31,1
49386,5001,1000.00,11000.00,12000.00,3726.86,7273.14,0.26,1
49387,5001,-1000.00,10000.00,11000.00,6506.85,5493.15,0.04,0
49388,5001,1000.00,11000.00,12000.00,0.00,11000.00,0.29,1
49389,5001,1000.00,12000.00,13000.00,5099.99,6900.01,0.27,1
49390,5001,1000.00,13000.00,14000.00,4202.80,7942.47,0.31,1
49391,5001,-1000.00,12000.00,13000.00,7992.31,6007.69,0.09,0
49392,5001,1000.00,13000.00,14000.00,0.00,13000.00,0.20,1
49393,5001,1000.00,14000.00,15000.00,0.00,12090.22,0.33,1
49394,5001,1000.00,15000.00,16000.00,0.00,15000.00,0.25,1
49395,5001,1000.00,16000.00,17000.00,1739.22,14260.78,0.40,1
49396,5001,1000.00,17000.00,18000.00,4687.73,12312.27,0.09,1
49397,5001,-1000.00,16000.00,17000.00,11803.27,281.22,0.06,0
49398,5001,1000.00,17000.00,18000.00,7106.86,9893.14,0.22,1
49399,5001,1000.00,18000.00,19000.00,0.00,18000.00,0.42,1
49400,5001,1000.00,19000.00,20000.00,9500.00,9500.00,0.00,1
49401,5001,1000.00,20000.00,21000.00,180.16,16728.12,0.43,1
49402,5001,1000.00,21000.00,22000.00,0.00,13004.22,0.30,1
49403,5001,1000.00,22000.00,23000.00,1158.85,20841.15,0.26,1
49404,5001,1000.00,23000.00,24000.00,0.00,23000.00,0.40,1
49405,5001,1000.00,24000.00,25000.00,8143.24,15856.76,0.15,1
49406,5001,1000.00,25000.00,26000.00,4708.85,20291.15,0.40,1
49407,5001,1000.00,26000.00,27000.00,0.00,10926.61,0.15,1
49408,5001,1000.00,27000.00,28000.00,8794.29,18205.71,0.31,1
49409,5001,1000.00,28000.00,29000.00,0.00,26570.56,0.44,1
49410,5001,1000.00,29000.00,30000.00,4896.62,9987.16,0.23,1
49411,5001,1000.00,30000.00,31000.00,0.00,22831.84,0.25,1
49412,5001,1000.00,31000.00,32000.00,4773.43,24286.07,0.40,1
49413,5001,1000.00,32000.00,33000.00,626.90,31373.10,0.38,1
49414,5001,1000.00,33000.00,34000.00,0.00,27260.42,0.42,1
49415,5001,1000.00,34000.00,35000.00,10484.78,23515.22,0.14,1
49416,5001,1000.00,35000.00,36000.00,0.00,20471.40,0.35,1
49417,5001,1000.00,36000.00,37000.00,0.00,29417.87,0.42,1
49418,5001,1000.00,37000.00,38000.00,0.00,30191.88,0.22,1
49419,5001,1000.00,38000.00,39000.00,8823.23,29176.77,0.32,1
49420,5001,1000.00,39000.00,40000.00,6226.34,32773.66,0.15,1
49421,5001,1000.00,40000.00,41000.00,0.00,40000.00,0.18,1
49422,5001,1000.00,41000.00,42000.00,0.00,30718.31,0.18,1
49423,5001,-1000.00,40000.00,41000.00,29673.64,12326.36,0.09,0
49424,5001,-1000.00,39000.00,40000.00,0.00,41000.00,0.43,0
49425,5001,-1000.00,38000.00,39000.00,0.00,39098.35,0.43,0
49426,5001,-1000.00,37000.00,38000.00,4280.41,34719.59,0.10,0
49427,5001,-1000.00,36000.00,37000.00,0.00,17905.63,0.24,0
49428,5001,-1000.00,35000.00,36000.00,9413.14,27586.86,0.32,0
49429,5001,-1000.00,34000.00,35000.00,9768.55,26231.45,0.23,0
49430,5001,-1000.00,33000.00,34000.00,0.00,20341.04,0.28,0
49431,5001,-1000.00,32000.00,33000.00,0.00,34000.00,0.14,0
49432,5001,-1000.00,31000.00,32000.00,0.00,31328.39,0.31,0
49433,5001,-1000.00,30000.00,31000.00,20594.74,2934.57,0.08,0
49434,5001,-1000.00,29000.00,30000.00,0.00,25243.26,0.06,0
49435,5001,-1000.00,28000.00,29000.00,0.00,30000.00,0.01,0
49436,5001,-1000.00,27000.00,28000.00,0.00,29000.00,0.42,0
49437,5001,-1000.00,26000.00,27000.00,0.00,28000.00,0.34,0
49438,5001,-1000.00,25000.00,26000.00,0.00,27000.00,0.01,0
49439,5001,-1000.00,24000.00,25000.00,10602.45,15397.55,0.28,0
49440,5001,-1000.00,23000.00,24000.00,472.64,24527.36,0.44,0
49441,5001,-1000.00,22000.00,23000.00,0.00,24000.00,0.35,0
49442,5001,-1000.00,21000.00,22000.00,0.00,12242.11,0.27,0
49443,5001,-1000.00,20000.00,21000.00,7969.48,13672.36,0.30,0
49444,5001,-1000.00,19000.00,20000.00,14150.88,6849.12,0.25,0
49445,5001,-1000.00,18000.00,19000.00,2261.29,17738.71,0.43,0
49446,5002,1000.00,1000.00,2000.00,127.11,357.68,0.24,1
49447,5002,1000.00,2000.00,3000.00,890.89,1109.11,0.14,1
49448,5002,-1000.00,1000.00,2000.00,1541.02,1458.98,0.14,0
49449,5002,1000.00,2000.00,3000.00,487.86,1512.14,0.23,1
49450,5002,-1000.00,1000.00,2000.00,1711.37,1288.63,0.09,0
49451,5002,1000.00,2000.00,3000.00,995.22,1004.78,0.18,1
49452,5002,1000.00,3000.00,4000.00,0.00,3000.00,0.14,1
49453,5002,1000.00,4000.00,5000.00,1835.64,2164.36,0.18,1
49454,5002,1000.00,5000.00,6000.00,593.94,3430.61,0.38,1
49455,5002,1000.00,6000.00,7000.00,2156.55,3843.45,0.23,1
49456,5002,1000.00,7000.00,8000.00,0.00,1845.41,0.18,1
49457,5002,1000.00,8000.00,9000.00,0.00,4592.97,0.22,1
49458,5002,1000.00,9000.00,10000.00,0.00,9000.00,0.12,1
49459,5002,1000.00,10000.00,11000.00,2646.84,7353.16,0.38,1
49460,5002,1000.00,11000.00,12000.00,0.00,11000.00,0.23,1
49461,5002,1000.00,12000.00,13000.00,0.00,10127.07,0.26,1
49462,5002,1000.00,13000.00,14000.00,0.00,13000.00,0.09,1
49463,5002,1000.00,14000.00,15000.00,4486.34,9513.66,0.17,1
49464,5002,-1000.00,13000.00,14000.00,11064.73,3935.27,0.09,0
49465,5002,1000.00,14000.00,15000.00,4222.32,8457.66,0.31,1
49466,5002,1000.00,15000.00,16000.00,0.00,14034.82,0.24,1
49467,5002,1000.00,16000.00,17000.00,0.00,16000.00,0.39,1
49468,5002,1000.00,17000.00,18000.00,0.00,17000.00,0.05,1
49469,5002,1000.00,18000.00,19000.00,3813.90,14186.10,0.28,1
49470,5002,1000.00,19000.00,20000.00,0.00,15240.49,0.36,1
49471,5002,1000.00,20000.00,21000.00,0.00,20000.00,0.17,1
49472,5002,-1000.00,19000.00,20000.00,13318.86,7681.14,0.14,0
49473,5002,1000.00,20000.00,21000.00,2601.57,17398.43,0.37,1
49474,5002,1000.00,21000.00,22000.00,0.00,21000.00,0.19,1
49475,5002,1000.00,22000.00,23000.00,0.00,22000.00,0.06,1
49476,5002,1000.00,23000.00,24000.00,0.00,23000.00,0.21,1
49477,5002,1000.00,24000.00,25000.00,0.00,24000.00,0.36,1
49478,5002,1000.00,25000.00,26000.00,2145.79,22854.21,0.31,1
49479,5002,-1000.00,24000.00,25000.00,13365.15,12634.85,0.10,0
49480,5002,1000.00,25000.00,26000.00,0.00,25000.00,0.15,1
49481,5002,1000.00,26000.00,27000.00,11568.83,14431.17,0.18,1
49482,5002,1000.00,27000.00,28000.00,0.00,25840.39,0.40,1
49483,5002,1000.00,28000.00,29000.00,9558.76,18441.24,0.17,1
49484,5002,1000.00,29000.00,30000.00,0.00,29000.00,0.10,1
49485,5002,1000.00,30000.00,31000.00,0.00,30000.00,0.29,1
49486,5002,1000.00,31000.00,32000.00,0.00,28486.02,0.42,1
49487,5003,-1000.00,-1000.00,0.00,592.28,407.72,0.09,0
49488,5004,0.00,0.00,1000.00,0.00,0.00,0.03,0
49489,5004,-267.36,-267.36,732.64,0.00,267.36,0.21,0
49490,5004,-66.35,-333.71,666.29,0.00,66.35,0.05,0
49491,5004,-330.20,-663.92,336.08,0.00,330.20,0.09,0
49492,5004,-1000.00,-1663.92,-663.92,38.80,5.52,0.11,0
49493,5005,-1000.00,-1000.00,0.00,154.28,845.72,0.42,0
49494,5006,-573.41,-573.41,426.59,573.41,0.00,0.27,0
49495,5006,-1000.00,-1573.41,-573.41,203.27,223.32,0.12,0
49496,5007,1000.00,1000.00,2000.00,536.80,463.20,0.20,1
49497,5007,-1000.00,0.00,1000.00,0.00,2000.00,0.17,0
49498,5007,-75.45,-75.45,924.55,0.00,75.45,0.43,0
49499,5007,-741.13,-816.58,183.42,143.51,597.62,0.25,0
49500,5007,1000.00,183.42,1183.42,44.39,0.00,0.04,1
49501,5007,-283.43,-100.01,899.99,0.00,283.43,0.42,0
49502,5007,-161.01,-261.02,738.98,0.00,161.01,0.44,0
49503,5007,-738.98,-1000.00,-0.00,17.29,721.69,0.44,0
49504,5008,-947.45,-947.45,52.55,468.81,478.64,0.22,0
49505,5008,-1000.00,-1947.45,-947.45,30.80,21.75,0.12,0
49506,5009,-1000.00,-1000.00,0.00,139.61,860.39,0.08,0
49507,5009,-0.00,-1000.00,0.00,0.00,0.00,0.05,0
49508,5010,0.00,0.00,1000.00,0.00,0.00,0.10,0
49509,5010,1000.00,1000.00,2000.00,0.00,477.34,0.07,1
49510,5010,1000.00,2000.00,3000.00,0.00,2000.00,0.01,1
49511,5010,1000.00,3000.00,4000.00,0.00,1484.60,0.29,1
49512,5010,1000.00,4000.00,5000.00,19.94,3980.06,0.32,1
49513,5010,-1000.00,3000.00,4000.00,3043.50,1383.40,0.13,0
49514,5010,1000.00,4000.00,5000.00,0.00,4000.00,0.03,1
49515,5010,1000.00,5000.00,6000.00,0.00,4686.51,0.44,1
49516,5010,1000.00,6000.00,7000.00,0.00,4500.85,0.09,1
49517,5010,-1000.00,5000.00,6000.00,4190.62,2809.38,0.16,0
49518,5010,1000.00,6000.00,7000.00,189.52,5810.48,0.44,1
49519,5010,-1000.00,5000.00,6000.00,4565.86,282.38,0.07,0
49520,5010,-1000.00,4000.00,5000.00,3592.55,2407.45,0.29,0
49521,5010,1000.00,5000.00,6000.00,1844.26,2435.87,0.25,1
49522,5010,1000.00,6000.00,7000.00,0.00,2115.68,0.20,1
49523,5010,-1000.00,5000.00,6000.00,3971.88,1254.20,0.11,0
49524,5010,1000.00,6000.00,7000.00,1980.86,4019.14,0.11,1
49525,5010,1000.00,7000.00,8000.00,0.00,4162.37,0.03,1
49526,5010,-1000.00,6000.00,7000.00,3546.80,3447.51,0.21,0
49527,5010,1000.00,7000.00,8000.00,1585.23,5126.60,0.37,1
49528,5010,1000.00,8000.00,9000.00,0.00,8000.00,0.42,1
49529,5010,1000.00,9000.00,10000.00,2249.23,6750.77,0.38,1
49530,5010,1000.00,10000.00,11000.00,0.00,4614.37,0.03,1
49531,5010,-1000.00,9000.00,10000.00,6520.08,4479.92,0.15,0
49532,5010,-1000.00,8000.00,9000.00,3277.48,6722.52,0.02,0
49533,5010,-1000.00,7000.00,8000.00,0.00,7039.49,0.16,0
49534,5010,-1000.00,6000.00,7000.00,2037.80,5962.20,0.37,0
49535,5010,0.00,6000.00,7000.00,0.00,0.00,0.05,0
49536,5010,-1000.00,5000.00,6000.00,1038.61,4129.11,0.34,0
49537,5010,-1000.00,4000.00,5000.00,227.60,5772.40,0.32,0
49538,5010,-1000.00,3000.00,4000.00,0.00,4269.88,0.21,0
49539,5010,-1000.00,2000.00,3000.00,2354.84,1645.16,0.07,0
49540,5010,-1000.00,1000.00,2000.00,0.00,1242.39,0.27,0
49541,5010,-1000.00,0.00,1000.00,1020.99,0.00,0.01,0
49542,5010,-1000.00,-1000.00,0.00,0.00,1000.00,0.08,0
49543,5011,-1000.00,-1000.00,0.00,0.00,848.94,0.39,0
49544,5012,-534.10,-534.10,465.90,0.00,534.10,0.29,0
49545,5012,-80.70,-614.79,385.21,0.00,80.70,0.02,0
49546,5012,-272.92,-887.72,112.28,0.00,272.92,0.19,0
49547,5012,-112.28,-1000.00,0.00,0.00,112.28,0.31,0
49548,5013,1000.00,1000.00,2000.00,912.25,87.75,0.05,1
49549,5013,-531.56,468.44,1468.44,0.00,531.56,0.02,0
49550,5013,1000.00,1468.44,2468.44,815.74,468.52,0.25,1
49551,5013,1000.00,2468.44,3468.44,2021.92,446.52,0.06,1
49552,5013,1000.00,3468.44,4468.44,2293.70,1174.74,0.13,1
49553,5013,-688.02,2780.42,3780.42,343.36,344.66,0.44,0
49554,5013,1000.00,3780.42,4780.42,2676.12,1104.29,0.10,1
49555,5013,-1000.00,2780.42,3780.42,0.00,4780.42,0.06,0
49556,5013,-1000.00,1780.42,2780.42,0.00,3703.15,0.01,0
49557,5013,-1000.00,780.42,1780.42,0.00,2092.12,0.22,0
49558,5013,-1000.00,-219.58,780.42,16.71,1083.15,0.39,0
49559,5013,-704.69,-924.28,75.72,18.06,686.63,0.43,0
49560,5013,-75.72,-1000.00,0.00,20.92,54.80,0.17,0
49561,5014,0.00,0.00,1000.00,0.00,0.00,0.17,0
49562,5014,0.00,0.00,1000.00,0.00,0.00,0.18,0
49563,5014,-1000.00,-1000.00,0.00,0.00,932.78,0.37,0
49564,5015,-786.32,-786.32,213.68,286.39,499.93,0.29,0
49565,5015,-213.68,-1000.00,0.00,54.87,158.81,0.14,0
49566,5016,1000.00,1000.00,2000.00,0.00,816.60,0.16,1
49567,5016,1000.00,2000.00,3000.00,0.00,1564.84,0.39,1
49568,5016,1000.00,3000.00,4000.00,0.00,3000.00,0.29,1
49569,5016,1000.00,4000.00,5000.00,0.00,4000.00,0.41,1
49570,5016,1000.00,5000.00,6000.00,2500.00,2500.00,0.06,1
49571,5016,1000.00,6000.00,7000.00,2084.62,3915.38,0.01,1
49572,5016,1000.00,7000.00,8000.00,2299.43,4700.57,0.29,1
49573,5016,1000.00,8000.00,9000.00,2499.55,5500.45,0.31,1
49574,5016,1000.00,9000.00,10000.00,424.45,8575.55,0.44,1
49575,5016,1000.00,10000.00,11000.00,0.00,10000.00,0.09,1
49576,5016,1000.00,11000.00,12000.00,0.00,11000.00,0.39,1
49577,5016,1000.00,12000.00,13000.00,2173.92,9826.08,0.29,1
49578,5016,1000.00,13000.00,14000.00,1641.79,11358.21,0.16,1
49579,5016,1000.00,14000.00,15000.00,0.00,13563.41,0.44,1
49580,5016,1000.00,15000.00,16000.00,0.00,15000.00,0.12,1
49581,5016,1000.00,16000.00,17000.00,0.00,3626.48,0.19,1
49582,5016,1000.00,17000.00,18000.00,0.00,17000.00,0.43,1
49583,5016,-1000.00,16000.00,17000.00,9752.45,8247.55,0.27,0
49584,5016,1000.00,17000.00,18000.00,0.00,17000.00,0.09,1
49585,5016,1000.00,18000.00,19000.00,331.85,17668.15,0.42,1
49586,5016,1000.00,19000.00,20000.00,0.00,19000.00,0.24,1
49587,5016,-1000.00,18000.00,19000.00,13110.45,6889.55,0.13,0
49588,5016,1000.00,19000.00,20000.00,0.00,6378.97,0.22,1
49589,5016,1000.00,20000.00,21000.00,0.00,13140.74,0.15,1
49590,5016,1000.00,21000.00,22000.00,7539.85,9403.97,0.24,1
49591,5016,-1000.00,20000.00,21000.00,11051.71,10948.29,0.22,0
49592,5016,1000.00,21000.00,22000.00,0.00,21000.00,0.09,1
49593,5016,1000.00,22000.00,23000.00,0.00,13097.70,0.32,1
49594,5016,1000.00,23000.00,24000.00,1629.18,11837.99,0.32,1
49595,5016,-1000.00,22000.00,23000.00,13120.90,10879.10,0.19,0
49596,5016,1000.00,23000.00,24000.00,0.00,23000.00,0.10,1
49597,5016,1000.00,24000.00,25000.00,0.00,24000.00,0.06,1
49598,5016,-1000.00,23000.00,24000.00,14130.57,10869.43,0.36,0
49599,5016,1000.00,24000.00,25000.00,0.00,24000.00,0.08,1
49600,5016,-1000.00,23000.00,24000.00,18362.19,0.00,0.04,0
49601,5016,1000.00,24000.00,25000.00,0.00,9106.33,0.17,1
49602,5017,1000.00,1000.00,2000.00,118.32,731.52,0.39,1
49603,5017,1000.00,2000.00,3000.00,0.00,1238.18,0.09,1
49604,5017,1000.00,3000.00,4000.00,191.19,277.82,0.14,1
49605,5017,1000.00,4000.00,5000.00,1892.01,2107.99,0.08,1
49606,5017,0.00,4000.00,5000.00,0.00,0.00,0.05,0
49607,5017,0.00,4000.00,5000.00,0.00,0.00,0.11,0
49608,5017,-1000.00,3000.00,4000.00,3564.38,1435.62,0.08,0
49609,5017,1000.00,4000.00,5000.00,0.00,1793.16,0.17,1
49610,5017,1000.00,5000.00,6000.00,2329.09,2670.91,0.13,1
49611,5017,1000.00,6000.00,7000.00,2548.53,3451.47,0.04,1
49612,5017,1000.00,7000.00,8000.00,0.00,7000.00,0.23,1
49613,5017,1000.00,8000.00,9000.00,2195.45,5804.55,0.06,1
49614,5017,1000.00,9000.00,10000.00,487.30,8512.70,0.43,1
49615,5017,1000.00,10000.00,11000.00,0.00,10000.00,0.34,1
49616,5017,1000.00,11000.00,12000.00,0.00,5607.33,0.17,1
49617,5017,1000.00,12000.00,13000.00,0.00,5494.85,0.25,1
49618,5017,1000.00,13000.00,14000.00,4142.17,8857.83,0.34,1
49619,5017,1000.00,14000.00,15000.00,5126.61,8873.39,0.28,1
49620,5017,1000.00,15000.00,16000.00,6448.83,8551.17,0.26,1
49621,5017,1000.00,16000.00,17000.00,0.00,643.64,0.08,1
49622,5017,1000.00,17000.00,18000.00,0.00,17000.00,0.21,1
49623,5017,1000.00,18000.00,19000.00,7657.54,10342.46,0.14,1
49624,5017,1000.00,19000.00,20000.00,2597.62,16402.38,0.30,1
49625,5017,-1000.00,18000.00,19000.00,10079.75,9920.25,0.08,0
49626,5017,-1000.00,17000.00,18000.00,0.00,19000.00,0.10,0
49627,5017,-1000.00,16000.00,17000.00,11129.80,6870.20,0.12,0
49628,5017,-1000.00,15000.00,16000.00,5003.09,11996.91,0.16,0
49629,5017,-1000.00,14000.00,15000.00,8435.39,7564.61,0.01,0
49630,5017,-1000.00,13000.00,14000.00,3549.78,11450.22,0.28,0
49631,5017,-1000.00,12000.00,13000.00,0.00,14000.00,0.19,0
49632,5017,-1000.00,11000.00,12000.00,8345.47,4654.53,0.06,0
49633,5017,-1000.00,10000.00,11000.00,0.00,12000.00,0.29,0
49634,5017,-1000.00,9000.00,10000.00,0.00,11000.00,0.37,0
49635,5017,-1000.00,8000.00,9000.00,1891.49,8108.51,0.29,0
49636,5017,-1000.00,7000.00,8000.00,0.00,5995.64,0.37,0
49637,5017,-1000.00,6000.00,7000.00,698.41,7301.59,0.43,0
49638,5017,-1000.00,5000.00,6000.00,2195.39,4804.61,0.32,0
49639,5017,-1000.00,4000.00,5000.00,0.00,6000.00,0.35,0
49640,5017,-1000.00,3000.00,4000.00,1756.30,3243.70,0.27,0
49641,5017,-1000.00,2000.00,3000.00,0.00,4000.00,0.18,0
49642,5017,-1000.00,1000.00,2000.00,0.00,1911.58,0.32,0
49643,5017,-1000.00,0.00,1000.00,122.12,1877.88,0.41,0
49644,5017,-918.86,-918.86,81.14,392.73,526.13,0.26,0
49645,5017,-63.30,-982.16,17.84,0.00,63.30,0.37,0
49646,5017,-17.84,-1000.00,0.00,1.24,16.60,0.15,0
49647,5018,0.00,0.00,1000.00,0.00,0.00,0.01,0
49648,5018,0.00,0.00,1000.00,0.00,0.00,0.41,0
49649,5018,-91.54,-91.54,908.46,0.00,91.54,0.42,0
49650,5018,1000.00,908.46,1908.46,504.82,403.64,0.21,1
49651,5018,-1000.00,-91.54,908.46,635.22,1273.24,0.34,0
49652,5018,-908.46,-1000.00,0.00,95.07,813.39,0.17,0
49653,5019,1000.00,1000.00,2000.00,391.51,608.49,0.13,1
49654,5019,-1000.00,0.00,1000.00,694.58,586.43,0.27,0
49655,5019,1000.00,1000.00,2000.00,0.00,1000.00,0.33,1
49656,5019,1000.00,2000.00,3000.00,505.88,1494.12,0.31,1
49657,5019,1000.00,3000.00,4000.00,908.26,2091.74,0.35,1
49658,5019,1000.00,4000.00,5000.00,0.00,535.41,0.11,1
49659,5019,1000.00,5000.00,6000.00,385.96,4614.04,0.44,1
49660,5019,1000.00,6000.00,7000.00,1741.56,4258.44,0.33,1
49661,5019,1000.00,7000.00,8000.00,0.00,3983.99,0.28,1
49662,5019,1000.00,8000.00,9000.00,19.48,7066.69,0.44,1
49663,5019,1000.00,9000.00,10000.00,1810.61,7189.39,0.39,1
49664,5019,1000.00,10000.00,11000.00,0.00,4209.81,0.27,1
49665,5019,1000.00,11000.00,12000.00,0.00,3793.64,0.16,1
49666,5019,1000.00,12000.00,13000.00,0.00,4767.15,0.36,1
49667,5019,1000.00,13000.00,14000.00,5039.37,5098.42,0.22,1
49668,5019,0.00,13000.00,14000.00,0.00,0.00,0.00,0
49669,5019,1000.00,14000.00,15000.00,0.00,8385.92,0.32,1
49670,5019,1000.00,15000.00,16000.00,0.00,3394.41,0.19,1
49671,5019,1000.00,16000.00,17000.00,0.00,16000.00,0.15,1
49672,5019,1000.00,17000.00,18000.00,0.00,10398.05,0.29,1
49673,5019,-1000.00,16000.00,17000.00,11435.62,0.00,0.03,0
49674,5019,1000.00,17000.00,18000.00,0.00,17000.00,0.09,1
49675,5019,1000.00,18000.00,19000.00,0.00,5109.37,0.11,1
49676,5019,-1000.00,17000.00,18000.00,8337.83,6605.20,0.19,0
49677,5019,1000.00,18000.00,19000.00,0.00,4079.14,0.02,1
49678,5019,1000.00,19000.00,20000.00,6563.16,12436.84,0.23,1
49679,5019,1000.00,20000.00,21000.00,6489.99,13510.01,0.30,1
49680,5019,1000.00,21000.00,22000.00,0.00,21000.00,0.34,1
49681,5019,1000.00,22000.00,23000.00,9619.60,12380.40,0.26,1
49682,5019,0.00,22000.00,23000.00,0.00,0.00,0.02,0
49683,5019,1000.00,23000.00,24000.00,0.00,23000.00,0.19,1
49684,5019,0.00,23000.00,24000.00,0.00,0.00,0.09,0
49685,5019,1000.00,24000.00,25000.00,2852.59,15694.59,0.37,1
49686,5019,1000.00,25000.00,26000.00,0.00,10366.52,0.26,1
49687,5019,1000.00,26000.00,27000.00,9357.23,16642.77,0.15,1
49688,5019,1000.00,27000.00,28000.00,10673.24,16326.76,0.27,1
49689,5019,-1000.00,26000.00,27000.00,14627.77,13372.23,0.17,0
49690,5019,1000.00,27000.00,28000.00,2500.32,24499.68,0.39,1
49691,5019,1000.00,28000.00,29000.00,13563.43,14436.57,0.11,1
49692,5019,1000.00,29000.00,30000.00,0.00,25543.38,0.41,1
49693,5019,1000.00,30000.00,31000.00,0.00,7050.46,0.17,1
49694,5019,1000.00,31000.00,32000.00,0.00,24170.93,0.41,1
49695,5019,1000.00,32000.00,33000.00,0.00,8347.22,0.08,1
49696,5019,1000.00,33000.00,34000.00,0.00,33000.00,0.29,1
49697,5019,1000.00,34000.00,35000.00,6448.59,27551.41,0.17,1
49698,5019,1000.00,35000.00,36000.00,1585.10,33414.90,0.37,1
49699,5019,1000.00,36000.00,37000.00,0.00,36000.00,0.11,1
49700,5019,-1000.00,35000.00,36000.00,18500.00,18500.00,0.01,0
49701,5019,-1000.00,34000.00,35000.00,0.00,36000.00,0.43,0
49702,5019,-1000.00,33000.00,34000.00,0.00,35000.00,0.18,0
49703,5019,-1000.00,32000.00,33000.00,1854.39,17247.80,0.31,0
49704,5019,-1000.00,31000.00,32000.00,4499.70,28500.30,0.42,0
49705,5019,-1000.00,30000.00,31000.00,13005.57,18994.43,0.17,0
49706,5019,-1000.00,29000.00,30000.00,0.00,31000.00,0.15,0
49707,5019,-1000.00,28000.00,29000.00,6618.62,23381.38,0.31,0
49708,5019,-1000.00,27000.00,28000.00,9802.93,9447.92,0.20,0
49709,5019,-1000.00,26000.00,27000.00,0.00,13110.33,0.26,0
49710,5019,-1000.00,25000.00,26000.00,0.00,8369.12,0.22,0
49711,5019,-1000.00,24000.00,25000.00,0.00,26000.00,0.26,0
49712,5019,-1000.00,23000.00,24000.00,0.00,25000.00,0.15,0
49713,5019,-1000.00,22000.00,23000.00,0.00,23420.65,0.40,0
49714,5019,-1000.00,21000.00,22000.00,0.00,23000.00,0.28,0
49715,5019,0.00,21000.00,22000.00,0.00,0.00,0.09,0
49716,5019,-1000.00,20000.00,21000.00,0.00,22000.00,0.18,0
49717,5019,-1000.00,19000.00,20000.00,2309.01,18690.99,0.17,0
49718,5019,-1000.00,18000.00,19000.00,0.00,20000.00,0.25,0
49719,5019,-1000.00,17000.00,18000.00,0.00,19000.00,0.19,0
49720,5019,-1000.00,16000.00,17000.00,0.00,18000.00,0.15,0
49721,5019,-1000.00,15000.00,16000.00,4690.30,12309.70,0.29,0
49722,5019,-1000.00,14000.00,15000.00,0.00,9647.03,0.21,0
49723,5019,-1000.00,13000.00,14000.00,0.00,15000.00,0.12,0
49724,5019,-1000.00,12000.00,13000.00,0.00,14000.00,0.26,0
49725,5019,-1000.00,11000.00,12000.00,0.00,9825.89,0.19,0
49726,5019,-1000.00,10000.00,11000.00,9470.23,2529.77,0.05,0
49727,5019,-1000.00,9000.00,10000.00,0.00,10560.63,0.26,0
49728,5019,-1000.00,8000.00,9000.00,1200.48,8799.52,0.43,0
49729,5019,0.00,8000.00,9000.00,0.00,0.00,0.10,0
49730,5019,-1000.00,7000.00,8000.00,0.00,9000.00,0.13,0
49731,5019,-1000.00,6000.00,7000.00,4373.20,3626.80,0.00,0
49732,5019,-1000.00,5000.00,6000.00,0.00,7000.00,0.26,0
49733,5019,-1000.00,4000.00,5000.00,2419.78,3580.22,0.27,0
49734,5019,-1000.00,3000.00,4000.00,364.63,4635.37,0.41,0
49735,5019,-1000.00,2000.00,3000.00,0.00,4000.00,0.09,0
49736,5019,-1000.00,1000.00,2000.00,0.00,3000.00,0.11,0
49737,5019,-1000.00,0.00,1000.00,0.00,2000.00,0.21,0
49738,5019,-1000.00,-1000.00,0.00,117.39,882.61,0.26,0
49739,5020,1000.00,1000.00,2000.00,248.59,601.16,0.25,1
49740,5020,1000.00,2000.00,3000.00,0.00,1331.53,0.22,1
49741,5020,1000.00,3000.00,4000.00,961.88,2038.12,0.28,1
49742,5020,-1000.00,2000.00,3000.00,2088.60,1911.40,0.15,0
49743,5020,-604.62,1395.38,2395.38,496.61,108.02,0.12,0
49744,5020,1000.00,2395.38,3395.38,684.37,1711.00,0.36,1
49745,5020,1000.00,3395.38,4395.38,560.57,2056.04,0.34,1
49746,5020,1000.00,4395.38,5395.38,0.00,4395.38,0.07,1
49747,5020,1000.00,5395.38,6395.38,0.00,4185.27,0.06,1
49748,5020,1000.00,6395.38,7395.38,0.00,1921.81,0.19,1
49749,5020,1000.00,7395.38,8395.38,1277.29,6118.08,0.01,1
49750,5020,1000.00,8395.38,9395.38,1220.44,5848.61,0.31,1
49751,5020,0.00,8395.38,9395.38,0.00,0.00,0.01,0
49752,5020,1000.00,9395.38,10395.38,0.00,1692.67,0.18,1
49753,5020,1000.00,10395.38,11395.38,4069.90,4628.98,0.27,1
49754,5020,-1000.00,9395.38,10395.38,1863.56,0.00,0.40,0
49755,5020,1000.00,10395.38,11395.38,3555.62,5606.56,0.28,1
49756,5020,-1000.00,9395.38,10395.38,5879.08,5516.30,0.43,0
49757,5020,1000.00,10395.38,11395.38,4721.44,5673.94,0.16,1
49758,5020,1000.00,11395.38,12395.38,0.00,11395.38,0.22,1
49759,5020,-1000.00,10395.38,11395.38,2236.33,0.00,0.01,0
49760,5020,1000.00,11395.38,12395.38,0.00,11395.38,0.15,1
49761,5020,0.00,11395.38,12395.38,0.00,0.00,0.00,0
49762,5020,1000.00,12395.38,13395.38,0.00,1550.50,0.06,1
49763,5020,1000.00,13395.38,14395.38,2276.44,11118.94,0.11,1
49764,5020,1000.00,14395.38,15395.38,5692.60,8702.77,0.26,1
49765,5020,1000.00,15395.38,16395.38,0.00,15395.38,0.07,1
49766,5020,1000.00,16395.38,17395.38,0.00,4576.20,0.05,1
49767,5020,1000.00,17395.38,18395.38,0.00,5304.06,0.17,1
49768,5020,1000.00,18395.38,19395.38,4620.73,13774.65,0.21,1
49769,5020,1000.00,19395.38,20395.38,0.00,19395.38,0.08,1
49770,5020,1000.00,20395.38,21395.38,0.00,20395.38,0.34,1
49771,5020,-1000.00,19395.38,20395.38,19053.09,2342.29,0.15,0
49772,5020,1000.00,20395.38,21395.38,4692.35,15703.02,0.30,1
49773,5020,-1000.00,19395.38,20395.38,2211.00,0.00,0.06,0
49774,5020,-1000.00,18395.38,19395.38,10561.76,9833.62,0.11,0
49775,5020,1000.00,19395.38,20395.38,0.00,19395.38,0.22,1
49776,5020,1000.00,20395.38,21395.38,3775.86,16619.52,0.33,1
49777,5020,1000.00,21395.38,22395.38,4871.50,16523.88,0.03,1
49778,5020,1000.00,22395.38,23395.38,0.00,22395.38,0.12,1
49779,5020,1000.00,23395.38,24395.38,5724.93,17670.44,0.39,1
49780,5020,1000.00,24395.38,25395.38,1354.24,23041.14,0.43,1
49781,5020,1000.00,25395.38,26395.38,12378.47,13016.90,0.22,1
49782,5021,1000.00,1000.00,2000.00,706.34,293.66,0.12,1
49783,5021,0.00,1000.00,2000.00,0.00,0.00,0.37,0
49784,5021,-373.00,627.00,1627.00,84.41,288.59,0.43,0
49785,5021,-49.08,577.92,1577.92,0.00,49.08,0.26,0
49786,5021,1000.00,1577.92,2577.92,1577.92,0.00,0.04,1
49787,5021,1000.00,2577.92,3577.92,739.99,0.00,0.36,1
49788,5021,0.00,2577.92,3577.92,0.00,0.00,0.25,0
49789,5021,1000.00,3577.92,4577.92,2862.45,715.46,0.07,1
49790,5021,1000.00,4577.92,5577.92,2440.33,2137.58,0.21,1
49791,5021,0.00,4577.92,5577.92,0.00,0.00,0.09,0
49792,5021,-1000.00,3577.92,4577.92,0.00,5577.92,0.38,0
49793,5021,1000.00,4577.92,5577.92,36.92,0.00,0.38,1
49794,5021,-234.48,4343.44,5343.44,0.00,234.48,0.44,0
49795,5021,1000.00,5343.44,6343.44,976.97,0.00,0.21,1
49796,5021,-1000.00,4343.44,5343.44,223.99,6119.45,0.44,0
49797,5021,-1000.00,3343.44,4343.44,0.00,5343.44,0.36,0
49798,5021,-1000.00,2343.44,3343.44,0.00,4343.44,0.09,0
49799,5021,0.00,2343.44,3343.44,0.00,0.00,0.12,0
49800,5021,0.00,2343.44,3343.44,0.00,0.00,0.27,0
49801,5021,-1000.00,1343.44,2343.44,635.22,1887.44,0.31,0
49802,5021,1000.00,2343.44,3343.44,1934.87,408.56,0.14,1
49803,5021,1000.00,3343.44,4343.44,2165.34,1110.36,0.22,1
49804,5021,-1000.00,2343.44,3343.44,2171.72,2171.72,0.01,0
49805,5021,-1000.00,1343.44,2343.44,0.00,3343.44,0.04,0
49806,5021,0.00,1343.44,2343.44,0.00,0.00,0.37,0
49807,5021,-1000.00,343.44,1343.44,1010.92,1332.52,0.04,0
49808,5021,-131.84,211.60,1211.60,0.00,131.84,0.41,0
49809,5021,0.00,211.60,1211.60,0.00,0.00,0.44,0
49810,5021,-1000.00,-788.40,211.60,430.05,781.55,0.29,0
49811,5021,1000.00,211.60,1211.60,120.12,91.47,0.26,1
49812,5021,1000.00,1211.60,2211.60,510.74,442.35,0.29,1
49813,5021,0.00,1211.60,2211.60,0.00,0.00,0.25,0
49814,5021,1000.00,2211.60,3211.60,999.56,202.95,0.33,1
49815,5021,-1000.00,1211.60,2211.60,0.00,3211.60,0.06,0
49816,5021,-1000.00,211.60,1211.60,1074.80,1136.79,0.13,0
49817,5021,-1000.00,-788.40,211.60,0.00,1211.60,0.30,0
49818,5021,-177.63,-966.04,33.96,0.00,177.63,0.06,0
49819,5021,-33.96,-1000.00,0.00,12.80,21.17,0.30,0
49820,5022,1000.00,1000.00,2000.00,0.00,696.01,0.36,1
49821,5022,-699.72,300.28,1300.28,470.15,229.57,0.14,0
49822,5022,1000.00,1300.28,2300.28,0.00,742.15,0.34,1
49823,5022,1000.00,2300.28,3300.28,0.00,1616.01,0.15,1
49824,5022,1000.00,3300.28,4300.28,0.00,3300.28,0.06,1
49825,5022,-1000.00,2300.28,3300.28,2168.21,0.00,0.03,0
49826,5022,1000.00,3300.28,4300.28,707.86,2592.42,0.42,1
49827,5022,-192.13,3108.15,4108.15,192.13,0.00,0.10,0
49828,5022,1000.00,4108.15,5108.15,1425.51,2682.64,0.29,1
49829,5022,1000.00,5108.15,6108.15,0.00,2815.25,0.32,1
49830,5022,-1000.00,4108.15,5108.15,3122.19,2985.96,0.14,0
49831,5022,1000.00,5108.15,6108.15,1534.66,3573.49,0.34,1
49832,5022,1000.00,6108.15,7108.15,0.00,6108.15,0.13,1
49833,5022,1000.00,7108.15,8108.15,0.00,7065.41,0.35,1
49834,5022,1000.00,8108.15,9108.15,0.00,8108.15,0.22,1
49835,5022,1000.00,9108.15,10108.15,4000.95,5107.21,0.26,1
49836,5022,1000.00,10108.15,11108.15,0.00,10108.15,0.30,1
49837,5022,1000.00,11108.15,12108.15,4570.56,6537.59,0.02,1
49838,5022,1000.00,12108.15,13108.15,1507.67,10600.48,0.43,1
49839,5022,1000.00,13108.15,14108.15,6142.38,6965.77,0.14,1
49840,5022,1000.00,14108.15,15108.15,5108.52,8999.63,0.19,1
49841,5022,1000.00,15108.15,16108.15,7554.08,7554.08,0.29,1
49842,5022,1000.00,16108.15,17108.15,1012.53,15095.63,0.40,1
49843,5022,-1000.00,15108.15,16108.15,8554.08,8554.08,0.37,0
49844,5022,-1000.00,14108.15,15108.15,0.00,15681.27,0.43,0
49845,5022,-1000.00,13108.15,14108.15,1918.86,13189.30,0.29,0
49846,5022,-1000.00,12108.15,13108.15,6202.18,7905.97,0.26,0
49847,5022,-1000.00,11108.15,12108.15,0.00,5904.28,0.25,0
49848,5022,-1000.00,10108.15,11108.15,4218.02,7890.14,0.29,0
49849,5022,-1000.00,9108.15,10108.15,4597.29,6510.87,0.08,0
49850,5022,-1000.00,8108.15,9108.15,1823.58,8284.57,0.39,0
49851,5022,-1000.00,7108.15,8108.15,4360.36,4747.80,0.06,0
49852,5022,-1000.00,6108.15,7108.15,2952.78,5155.37,0.29,0
49853,5022,-1000.00,5108.15,6108.15,3415.93,3692.23,0.17,0
49854,5022,-1000.00,4108.15,5108.15,0.00,6108.15,0.36,0
49855,5022,-1000.00,3108.15,4108.15,2808.42,2299.74,0.19,0
49856,5022,0.00,3108.15,4108.15,0.00,0.00,0.05,0
49857,5022,-1000.00,2108.15,3108.15,0.00,2514.77,0.36,0
49858,5022,-1000.00,1108.15,2108.15,388.18,1571.46,0.31,0
49859,5022,-984.27,123.89,1123.89,307.90,676.37,0.23,0
49860,5022,-1000.00,-876.11,123.89,0.00,1123.89,0.21,0
49861,5022,-123.89,-1000.00,0.00,26.94,96.95,0.35,0
49862,5023,-578.80,-578.80,421.20,0.00,578.80,0.37,0
49863,5023,-1000.00,-1578.80,-578.80,218.43,202.77,0.22,0
49864,5024,1000.00,1000.00,2000.00,0.00,1000.00,0.37,1
49865,5024,-1000.00,0.00,1000.00,1380.41,619.59,0.07,0
49866,5024,1000.00,1000.00,2000.00,0.00,236.73,0.17,1
49867,5024,1000.00,2000.00,3000.00,0.00,1988.59,0.31,1
49868,5024,1000.00,3000.00,4000.00,0.00,3000.00,0.35,1
49869,5024,1000.00,4000.00,5000.00,0.00,4000.00,0.23,1
49870,5024,1000.00,5000.00,6000.00,0.00,4282.24,0.41,1
49871,5024,1000.00,6000.00,7000.00,0.00,5129.67,0.23,1
49872,5024,1000.00,7000.00,8000.00,0.00,5366.57,0.01,1
49873,5024,1000.00,8000.00,9000.00,3400.13,4599.87,0.25,1
49874,5024,1000.00,9000.00,10000.00,775.89,8224.11,0.43,1
49875,5024,-1000.00,8000.00,9000.00,5047.40,2297.04,0.14,0
49876,5024,1000.00,9000.00,10000.00,0.00,7601.86,0.10,1
49877,5024,1000.00,10000.00,11000.00,1905.80,8094.20,0.04,1
49878,5024,0.00,10000.00,11000.00,0.00,0.00,0.05,0
49879,5024,1000.00,11000.00,12000.00,0.00,8029.91,0.21,1
49880,5024,1000.00,12000.00,13000.00,0.00,12000.00,0.26,1
49881,5024,1000.00,13000.00,14000.00,2605.77,10394.23,0.13,1
49882,5024,1000.00,14000.00,15000.00,3605.27,10394.73,0.37,1
49883,5024,-1000.00,13000.00,14000.00,1875.20,0.00,0.09,0
49884,5024,1000.00,14000.00,15000.00,0.00,14000.00,0.01,1
49885,5024,1000.00,15000.00,16000.00,7500.00,7500.00,0.05,1
49886,5024,1000.00,16000.00,17000.00,1369.47,2763.95,0.17,1
49887,5024,1000.00,17000.00,18000.00,1171.87,15828.13,0.10,1
49888,5024,0.00,17000.00,18000.00,0.00,0.00,0.01,0
49889,5024,-1000.00,16000.00,17000.00,10549.66,5722.45,0.14,0
49890,5024,1000.00,17000.00,18000.00,0.00,17000.00,0.09,1
49891,5024,-1000.00,16000.00,17000.00,9173.87,0.00,0.03,0
49892,5024,1000.00,17000.00,18000.00,7582.65,9417.35,0.16,1
49893,5024,1000.00,18000.00,19000.00,7754.34,10245.66,0.11,1
49894,5024,1000.00,19000.00,20000.00,2499.46,16500.54,0.31,1
49895,5024,1000.00,20000.00,21000.00,0.00,12351.59,0.35,1
49896,5024,1000.00,21000.00,22000.00,4399.33,16600.67,0.08,1
49897,5024,1000.00,22000.00,23000.00,0.00,22000.00,0.09,1
49898,5024,1000.00,23000.00,24000.00,4908.10,18091.90,0.24,1
49899,5024,1000.00,24000.00,25000.00,0.00,23488.66,0.39,1
49900,5024,1000.00,25000.00,26000.00,7781.80,17218.20,0.02,1
49901,5024,1000.00,26000.00,27000.00,6567.18,19432.82,0.32,1
49902,5024,1000.00,27000.00,28000.00,11346.77,15653.23,0.17,1
49903,5024,1000.00,28000.00,29000.00,2654.44,25345.56,0.11,1
49904,5024,1000.00,29000.00,30000.00,0.00,29000.00,0.41,1
49905,5024,-1000.00,28000.00,29000.00,16008.28,13991.72,0.03,0
49906,5024,1000.00,29000.00,30000.00,0.00,26081.87,0.32,1
49907,5024,-1000.00,28000.00,29000.00,15638.94,14361.06,0.06,0
49908,5024,1000.00,29000.00,30000.00,0.00,20218.07,0.35,1
49909,5024,1000.00,30000.00,31000.00,7750.93,22249.07,0.28,1
49910,5024,1000.00,31000.00,32000.00,0.00,10164.43,0.14,1
49911,5024,-1000.00,30000.00,31000.00,4508.65,27491.35,0.33,0
49912,5024,-1000.00,29000.00,30000.00,4963.54,17440.02,0.33,0
49913,5024,-1000.00,28000.00,29000.00,0.00,30000.00,0.02,0
49914,5024,-1000.00,27000.00,28000.00,14500.00,14500.00,0.10,0
49915,5024,-1000.00,26000.00,27000.00,3729.95,10300.07,0.25,0
49916,5024,-1000.00,25000.00,26000.00,0.00,26652.70,0.23,0
49917,5024,-1000.00,24000.00,25000.00,494.20,21870.36,0.43,0
49918,5024,-1000.00,23000.00,24000.00,8784.34,9974.45,0.23,0
49919,5024,-1000.00,22000.00,23000.00,0.00,24000.00,0.38,0
49920,5024,-1000.00,21000.00,22000.00,0.00,23000.00,0.21,0
49921,5024,-1000.00,20000.00,21000.00,0.00,22000.00,0.21,0
49922,5024,-1000.00,19000.00,20000.00,8613.41,12386.59,0.22,0
49923,5024,-1000.00,18000.00,19000.00,2494.56,17505.44,0.37,0
49924,5024,-1000.00,17000.00,18000.00,0.00,19000.00,0.11,0
49925,5024,-1000.00,16000.00,17000.00,0.00,18000.00,0.05,0
49926,5024,-1000.00,15000.00,16000.00,0.00,6793.65,0.09,0
49927,5024,-1000.00,14000.00,15000.00,0.00,15065.41,0.44,0
49928,5024,-1000.00,13000.00,14000.00,0.00,4906.77,0.22,0
49929,5024,-1000.00,12000.00,13000.00,4072.97,9927.03,0.36,0
49930,5024,-1000.00,11000.00,12000.00,0.00,2873.17,0.02,0
49931,5025,-1000.00,-1000.00,0.00,449.84,550.16,0.11,0
49932,5026,1000.00,1000.00,2000.00,0.00,45.13,0.04,1
49933,5026,1000.00,2000.00,3000.00,855.18,1144.82,0.17,1
49934,5026,1000.00,3000.00,4000.00,0.00,3000.00,0.19,1
49935,5026,1000.00,4000.00,5000.00,1425.91,2574.09,0.27,1
49936,5026,1000.00,5000.00,6000.00,0.00,3181.21,0.18,1
49937,5026,1000.00,6000.00,7000.00,0.00,2873.51,0.09,1
49938,5026,1000.00,7000.00,8000.00,0.00,1151.99,0.12,1
49939,5026,1000.00,8000.00,9000.00,1014.41,6985.59,0.43,1
49940,5026,1000.00,9000.00,10000.00,2954.43,6045.57,0.08,1
49941,5026,1000.00,10000.00,11000.00,0.00,10000.00,0.05,1
49942,5026,0.00,10000.00,11000.00,0.00,0.00,0.00,0
49943,5026,1000.00,11000.00,12000.00,0.00,2409.17,0.16,1
49944,5026,1000.00,12000.00,13000.00,0.00,11835.41,0.24,1
49945,5026,0.00,12000.00,13000.00,0.00,0.00,0.04,0
49946,5026,-1000.00,11000.00,12000.00,7550.85,5449.15,0.21,0
49947,5026,1000.00,12000.00,13000.00,0.00,8266.68,0.21,1
49948,5026,1000.00,13000.00,14000.00,5879.72,7120.28,0.19,1
49949,5026,-1000.00,12000.00,13000.00,629.21,13370.79,0.13,0
49950,5026,-1000.00,11000.00,12000.00,4654.04,8345.96,0.31,0
49951,5026,-1000.00,10000.00,11000.00,0.00,12000.00,0.29,0
49952,5026,-1000.00,9000.00,10000.00,282.91,10717.09,0.35,0
49953,5026,-1000.00,8000.00,9000.00,0.00,7567.01,0.09,0
49954,5026,-1000.00,7000.00,8000.00,5539.57,3460.43,0.11,0
49955,5026,-1000.00,6000.00,7000.00,0.00,8000.00,0.34,0
49956,5026,-1000.00,5000.00,6000.00,276.04,1339.87,0.18,0
49957,5026,-1000.00,4000.00,5000.00,0.00,5473.28,0.35,0
49958,5026,-1000.00,3000.00,4000.00,442.93,4557.07,0.24,0
49959,5026,-1000.00,2000.00,3000.00,0.00,2544.13,0.32,0
49960,5026,-1000.00,1000.00,2000.00,0.00,2696.17,0.13,0
49961,5026,-1000.00,0.00,1000.00,0.00,1441.89,0.39,0
49962,5026,-1000.00,-1000.00,0.00,0.00,1000.00,0.26,0
49963,5027,0.00,0.00,1000.00,0.00,0.00,0.37,0
49964,5027,-1000.00,-1000.00,0.00,51.49,948.51,0.01,0
49965,5028,-1000.00,-1000.00,0.00,0.00,215.00,0.21,0
49966,5029,-528.87,-528.87,471.13,0.00,528.87,0.20,0
49967,5029,-0.67,-529.54,470.46,0.00,0.67,0.39,0
49968,5029,-468.56,-998.10,1.90,0.00,468.56,0.44,0
49969,5029,-1.90,-1000.00,0.00,0.00,1.90,0.24,0
49970,5030,-800.80,-800.80,199.20,0.00,800.80,0.18,0
49971,5030,-199.20,-1000.00,0.00,0.00,199.20,0.28,0
49972,5031,1000.00,1000.00,2000.00,200.50,799.50,0.41,1
49973,5031,1000.00,2000.00,3000.00,0.00,2000.00,0.01,1
49974,5031,1000.00,3000.00,4000.00,0.00,1319.96,0.14,1
49975,5031,1000.00,4000.00,5000.00,0.00,4000.00,0.27,1
49976,5031,1000.00,5000.00,6000.00,0.00,2240.56,0.20,1
49977,5031,1000.00,6000.00,7000.00,0.00,2444.52,0.27,1
49978,5031,1000.00,7000.00,8000.00,0.00,885.72,0.06,1
49979,5031,1000.00,8000.00,9000.00,0.00,8000.00,0.05,1
49980,5031,1000.00,9000.00,10000.00,0.00,5256.44,0.22,1
49981,5031,-1000.00,8000.00,9000.00,2267.31,0.00,0.03,0
49982,5031,1000.00,9000.00,10000.00,814.23,1419.05,0.16,1
49983,5031,1000.00,10000.00,11000.00,1026.62,8973.38,0.42,1
49984,5031,-1000.00,9000.00,10000.00,2054.86,0.00,0.04,0
49985,5031,1000.00,10000.00,11000.00,0.00,4407.84,0.13,1
49986,5031,1000.00,11000.00,12000.00,0.00,11000.00,0.36,1
49987,5031,1000.00,12000.00,13000.00,0.00,12000.00,0.07,1
49988,5031,1000.00,13000.00,14000.00,0.00,13000.00,0.23,1
49989,5031,1000.00,14000.00,15000.00,0.00,12138.28,0.41,1
49990,5031,1000.00,15000.00,16000.00,5512.40,9487.60,0.28,1
49991,5031,-1000.00,14000.00,15000.00,9085.97,6914.03,0.12,0
49992,5031,1000.00,15000.00,16000.00,2440.74,12559.26,0.42,1
49993,5031,1000.00,16000.00,17000.00,226.31,14519.32,0.44,1
49994,5031,1000.00,17000.00,18000.00,0.00,13526.37,0.15,1
49995,5031,1000.00,18000.00,19000.00,8680.43,9319.57,0.44,1
49996,5031,1000.00,19000.00,20000.00,9500.00,9500.00,0.00,1
49997,5031,1000.00,20000.00,21000.00,8138.70,11861.30,0.23,1
49998,5031,1000.00,21000.00,22000.00,1420.26,7648.53,0.25,1
49999,5031,1000.00,22000.00,23000.00,925.27,21074.73,0.41,1
50000,5031,1000.00,23000.00,24000.00,0.00,23000.00,0.04,1
50001,5031,-1000.00,22000.00,23000.00,16988.64,7011.36,0.06,0
50002,5031,1000.00,23000.00,24000.00,8365.94,14634.06,0.28,1
50003,5031,-1000.00,22000.00,23000.00,7726.21,2127.54,0.12,0
50004,5031,1000.00,23000.00,24000.00,0.00,16570.79,0.38,1
50005,5031,-1000.00,22000.00,23000.00,9661.77,0.00,0.05,0
50006,5031,1000.00,23000.00,24000.00,4553.66,18446.34,0.05,1
50007,5031,1000.00,24000.00,25000.00,616.01,23383.99,0.43,1
50008,5031,1000.00,25000.00,26000.00,0.00,25000.00,0.17,1
50009,5031,1000.00,26000.00,27000.00,0.00,26000.00,0.00,1
50010,5031,1000.00,27000.00,28000.00,4157.91,11290.26,0.27,1
50011,5031,1000.00,28000.00,29000.00,491.76,26772.08,0.44,1
50012,5031,1000.00,29000.00,30000.00,0.00,29000.00,0.08,1
50013,5031,0.00,29000.00,30000.00,0.00,0.00,0.02,0
50014,5031,-1000.00,28000.00,29000.00,21434.50,0.00,0.02,0
50015,5031,1000.00,29000.00,30000.00,0.00,29000.00,0.39,1
50016,5031,1000.00,30000.00,31000.00,0.00,23680.38,0.26,1
50017,5031,1000.00,31000.00,32000.00,0.00,13346.90,0.18,1
50018,5031,1000.00,32000.00,33000.00,15828.71,16171.29,0.04,1
50019,5032,1000.00,1000.00,2000.00,148.97,851.03,0.11,1
50020,5032,1000.00,2000.00,3000.00,0.00,2000.00,0.33,1
50021,5032,1000.00,3000.00,4000.00,891.66,2108.34,0.36,1
50022,5032,1000.00,4000.00,5000.00,124.56,3875.44,0.44,1
50023,5032,-1000.00,3000.00,4000.00,4241.29,758.71,0.06,0
50024,5032,1000.00,4000.00,5000.00,1887.42,2112.58,0.24,1
50025,5032,1000.00,5000.00,6000.00,0.00,716.20,0.10,1
50026,5032,-1000.00,4000.00,5000.00,3509.98,2490.02,0.10,0
50027,5032,1000.00,5000.00,6000.00,0.00,5000.00,0.22,1
50028,5032,1000.00,6000.00,7000.00,0.00,6000.00,0.44,1
50029,5032,1000.00,7000.00,8000.00,1848.64,5151.36,0.35,1
50030,5032,1000.00,8000.00,9000.00,1679.02,6320.98,0.11,1
50031,5032,-1000.00,7000.00,8000.00,0.00,9000.00,0.29,0
50032,5032,-1000.00,6000.00,7000.00,0.00,7800.59,0.03,0
50033,5032,-1000.00,5000.00,6000.00,2166.16,4833.84,0.32,0
50034,5032,-1000.00,4000.00,5000.00,993.18,5006.82,0.32,0
50035,5032,-1000.00,3000.00,4000.00,0.00,5000.00,0.12,0
50036,5032,-1000.00,2000.00,3000.00,2000.00,2000.00,0.16,0
50037,5032,-1000.00,1000.00,2000.00,1502.30,1497.70,0.08,0
50038,5032,0.00,1000.00,2000.00,0.00,0.00,0.01,0
50039,5032,-1000.00,0.00,1000.00,628.45,1371.55,0.42,0
50040,5032,-1000.00,-1000.00,0.00,470.24,529.76,0.21,0
50041,5033,1000.00,1000.00,2000.00,22.61,0.00,0.17,1
50042,5033,-1000.00,0.00,1000.00,0.00,1217.63,0.40,0
50043,5033,-1000.00,-1000.00,0.00,0.00,1000.00,0.10,0
50044,5034,0.00,0.00,1000.00,0.00,0.00,0.18,0
50045,5034,1000.00,1000.00,2000.00,507.69,492.31,0.17,1
50046,5034,0.00,1000.00,2000.00,0.00,0.00,0.05,0
50047,5034,-980.76,19.24,1019.24,0.00,980.76,0.32,0
50048,5034,-1000.00,-980.76,19.24,493.39,525.85,0.22,0
50049,5034,1000.00,19.24,1019.24,15.86,3.37,0.09,1
50050,5034,-764.55,-745.31,254.69,163.03,601.53,0.34,0
50051,5034,-254.69,-1000.00,0.00,70.36,184.33,0.29,0
50052,5035,-1000.00,-1000.00,0.00,645.87,354.13,0.09,0
50053,5036,1000.00,1000.00,2000.00,440.91,559.09,0.18,1
50054,5036,1000.00,2000.00,3000.00,0.00,2000.00,0.09,1
50055,5036,1000.00,3000.00,4000.00,1355.77,1644.23,0.22,1
50056,5036,1000.00,4000.00,5000.00,0.00,4000.00,0.30,1
50057,5036,1000.00,5000.00,6000.00,2500.00,2500.00,0.09,1
50058,5036,1000.00,6000.00,7000.00,231.84,4191.59,0.39,1
50059,5036,1000.00,7000.00,8000.00,0.00,5307.71,0.32,1
50060,5036,1000.00,8000.00,9000.00,129.11,7870.89,0.04,1
50061,5036,1000.00,9000.00,10000.00,0.00,2724.48,0.22,1
50062,5036,1000.00,10000.00,11000.00,2680.03,7319.97,0.37,1
50063,5036,1000.00,11000.00,12000.00,0.00,6894.96,0.36,1
50064,5036,1000.00,12000.00,13000.00,3339.75,5026.68,0.25,1
50065,5036,1000.00,13000.00,14000.00,2175.21,10824.79,0.20,1
50066,5036,1000.00,14000.00,15000.00,0.00,14000.00,0.28,1
50067,5036,1000.00,15000.00,16000.00,6327.52,8672.48,0.21,1
50068,5036,1000.00,16000.00,17000.00,0.00,16000.00,0.33,1
50069,5036,-1000.00,15000.00,16000.00,4348.94,0.00,0.09,0
50070,5036,1000.00,16000.00,17000.00,0.00,16000.00,0.38,1
50071,5036,-1000.00,15000.00,16000.00,3110.24,0.00,0.07,0
50072,5036,1000.00,16000.00,17000.00,0.00,16000.00,0.23,1
50073,5036,1000.00,17000.00,18000.00,1464.48,15535.52,0.43,1
50074,5036,1000.00,18000.00,19000.00,0.00,8456.00,0.27,1
50075,5036,-1000.00,17000.00,18000.00,9656.25,9343.75,0.12,0
50076,5036,1000.00,18000.00,19000.00,6335.28,11664.72,0.15,1
50077,5036,1000.00,19000.00,20000.00,0.00,16529.06,0.19,1
50078,5036,1000.00,20000.00,21000.00,0.00,20000.00,0.09,1
50079,5036,1000.00,21000.00,22000.00,0.00,20813.24,0.44,1
50080,5036,1000.00,22000.00,23000.00,5557.11,16442.89,0.38,1
50081,5036,1000.00,23000.00,24000.00,2381.06,20618.94,0.42,1
50082,5036,1000.00,24000.00,25000.00,0.00,24000.00,0.01,1
50083,5036,1000.00,25000.00,26000.00,8108.56,16891.44,0.24,1
50084,5036,1000.00,26000.00,27000.00,5924.49,8462.30,0.22,1
50085,5036,1000.00,27000.00,28000.00,0.00,27000.00,0.27,1
50086,5036,1000.00,28000.00,29000.00,0.00,28000.00,0.13,1
50087,5036,1000.00,29000.00,30000.00,4299.32,24700.68,0.13,1
50088,5036,1000.00,30000.00,31000.00,0.00,19001.50,0.32,1
50089,5036,1000.00,31000.00,32000.00,10776.49,20223.51,0.31,1
50090,5036,1000.00,32000.00,33000.00,0.00,8509.40,0.04,1
50091,5036,1000.00,33000.00,34000.00,0.00,15263.35,0.29,1
50092,5036,1000.00,34000.00,35000.00,599.42,6849.58,0.18,1
50093,5036,1000.00,35000.00,36000.00,15094.63,19905.37,0.15,1
50094,5036,1000.00,36000.00,37000.00,7672.44,28327.56,0.19,1
50095,5036,-1000.00,35000.00,36000.00,13032.19,12667.06,0.20,0
50096,5036,1000.00,36000.00,37000.00,0.00,36000.00,0.36,1
50097,5036,1000.00,37000.00,38000.00,0.00,33046.19,0.34,1
50098,5037,1000.00,1000.00,2000.00,308.10,691.90,0.29,1
50099,5037,1000.00,2000.00,3000.00,45.43,1954.57,0.39,1
50100,5037,1000.00,3000.00,4000.00,0.00,2164.52,0.39,1
50101,5037,1000.00,4000.00,5000.00,0.00,1483.64,0.19,1
50102,5037,1000.00,5000.00,6000.00,0.00,5000.00,0.01,1
50103,5037,1000.00,6000.00,7000.00,1181.03,1615.30,0.20,1
50104,5037,1000.00,7000.00,8000.00,0.00,4872.19,0.39,1
50105,5037,1000.00,8000.00,9000.00,3231.16,4768.84,0.28,1
50106,5037,1000.00,9000.00,10000.00,0.00,9000.00,0.35,1
50107,5037,1000.00,10000.00,11000.00,4746.08,5253.92,0.24,1
50108,5037,1000.00,11000.00,12000.00,0.00,3868.83,0.25,1
50109,5037,1000.00,12000.00,13000.00,4955.27,7044.73,0.18,1
50110,5037,1000.00,13000.00,14000.00,0.00,13000.00,0.15,1
50111,5037,-1000.00,12000.00,13000.00,8067.69,5932.31,0.17,0
50112,5037,1000.00,13000.00,14000.00,4685.14,8314.86,0.23,1
50113,5037,1000.00,14000.00,15000.00,1058.40,7558.34,0.33,1
50114,5037,1000.00,15000.00,16000.00,6817.34,7791.59,0.24,1
50115,5037,1000.00,16000.00,17000.00,0.00,16000.00,0.24,1
50116,5037,1000.00,17000.00,18000.00,0.00,17000.00,0.13,1
50117,5037,-1000.00,16000.00,17000.00,10981.05,7018.95,0.29,0
50118,5037,-1000.00,15000.00,16000.00,8629.43,8370.57,0.13,0
50119,5037,-1000.00,14000.00,15000.00,12497.99,3502.01,0.19,0
50120,5037,1000.00,15000.00,16000.00,0.00,1391.53,0.10,1
50121,5037,1000.00,16000.00,17000.00,5848.38,10151.62,0.31,1
50122,5037,1000.00,17000.00,18000.00,267.20,16732.80,0.34,1
50123,5037,1000.00,18000.00,19000.00,0.00,15930.83,0.41,1
50124,5037,0.00,18000.00,19000.00,0.00,0.00,0.07,0
50125,5037,0.00,18000.00,19000.00,0.00,0.00,0.12,0
50126,5037,-1000.00,17000.00,18000.00,0.00,19000.00,0.35,0
50127,5037,-1000.00,16000.00,17000.00,14013.82,0.00,0.14,0
50128,5037,-1000.00,15000.00,16000.00,13078.10,0.00,0.13,0
50129,5037,-1000.00,14000.00,15000.00,7815.29,0.00,0.23,0
50130,5037,-1000.00,13000.00,14000.00,2229.17,890.58,0.43,0
50131,5037,-1000.00,12000.00,13000.00,736.46,7988.89,0.34,0
50132,5037,-1000.00,11000.00,12000.00,0.00,13000.00,0.20,0
50133,5037,-1000.00,10000.00,11000.00,0.00,12000.00,0.16,0
50134,5037,-1000.00,9000.00,10000.00,0.00,877.95,0.12,0
50135,5037,-1000.00,8000.00,9000.00,3100.70,6899.30,0.35,0
50136,5037,-1000.00,7000.00,8000.00,4876.01,4123.99,0.17,0
50137,5037,-1000.00,6000.00,7000.00,0.00,7097.47,0.43,0
50138,5037,-1000.00,5000.00,6000.00,0.00,7000.00,0.36,0
50139,5037,-1000.00,4000.00,5000.00,0.00,6000.00,0.42,0
50140,5037,-1000.00,3000.00,4000.00,776.02,3256.01,0.37,0
50141,5037,-1000.00,2000.00,3000.00,1453.06,0.00,0.31,0
50142,5037,-1000.00,1000.00,2000.00,730.70,2269.30,0.36,0
50143,5038,-1000.00,-1000.00,0.00,283.04,716.96,0.35,0
50144,5038,-0.00,-1000.00,0.00,0.00,0.00,0.16,0
50145,5039,-484.40,-484.40,515.60,2.73,481.67,0.30,0
50146,5039,-515.60,-1000.00,0.00,157.32,358.28,0.34,0
50147,5040,-741.79,-741.79,258.21,741.79,0.00,0.14,0
50148,5040,1000.00,258.21,1258.21,7.51,147.87,0.30,1
50149,5040,1000.00,1258.21,2258.21,524.53,733.68,0.28,1
50150,5040,1000.00,2258.21,3258.21,0.00,1185.03,0.32,1
50151,5040,-1000.00,1258.21,2258.21,1892.30,1004.25,0.14,0
50152,5040,1000.00,2258.21,3258.21,906.33,1351.88,0.19,1
50153,5040,1000.00,3258.21,4258.21,1111.84,2146.38,0.33,1
50154,5040,1000.00,4258.21,5258.21,1565.18,2693.04,0.11,1
50155,5040,1000.00,5258.21,6258.21,1093.44,4074.02,0.39,1
50156,5040,1000.00,6258.21,7258.21,0.00,6258.21,0.29,1
50157,5040,0.00,6258.21,7258.21,0.00,0.00,0.05,0
50158,5040,-1000.00,5258.21,6258.21,4582.94,1463.58,0.10,0
50159,5040,1000.00,6258.21,7258.21,419.37,5838.84,0.36,1
50160,5040,1000.00,7258.21,8258.21,1259.53,5072.23,0.37,1
50161,5040,-1000.00,6258.21,7258.21,4357.12,3901.09,0.19,0
50162,5040,1000.00,7258.21,8258.21,0.00,7258.21,0.22,1
50163,5040,-1000.00,6258.21,7258.21,4734.59,1215.25,0.10,0
50164,5040,1000.00,7258.21,8258.21,1686.05,5572.16,0.31,1
50165,5040,1000.00,8258.21,9258.21,0.00,4200.55,0.32,1
50166,5040,1000.00,9258.21,10258.21,0.00,9258.21,0.42,1
50167,5040,1000.00,10258.21,11258.21,0.00,3714.06,0.22,1
50168,5040,1000.00,11258.21,12258.21,445.87,10812.34,0.23,1
50169,5040,1000.00,12258.21,13258.21,0.00,4766.00,0.24,1
50170,5040,1000.00,13258.21,14258.21,0.00,5946.60,0.07,1
50171,5040,-1000.00,12258.21,13258.21,12.66,14245.55,0.03,0
50172,5040,-1000.00,11258.21,12258.21,5520.08,7738.14,0.17,0
50173,5040,-1000.00,10258.21,11258.21,0.00,12258.21,0.36,0
50174,5040,-1000.00,9258.21,10258.21,5486.70,5771.51,0.06,0
50175,5040,-1000.00,8258.21,9258.21,3889.94,2678.16,0.17,0
50176,5040,-1000.00,7258.21,8258.21,1825.11,7433.10,0.38,0
50177,5040,-1000.00,6258.21,7258.21,3599.73,4658.48,0.16,0
50178,5040,-1000.00,5258.21,6258.21,3999.64,3258.57,0.15,0
50179,5040,-1000.00,4258.21,5258.21,1579.61,3625.05,0.32,0
50180,5040,-1000.00,3258.21,4258.21,0.00,5258.21,0.31,0
50181,5040,-700.51,2557.70,3557.70,0.00,700.51,0.12,0
50182,5040,-1000.00,1557.70,2557.70,1656.48,1901.22,0.10,0
50183,5040,-1000.00,557.70,1557.70,0.00,1348.07,0.32,0
50184,5040,-725.73,-168.03,831.97,55.69,670.04,0.28,0
50185,5040,-569.70,-737.73,262.27,147.00,422.70,0.30,0
50186,5040,-64.15,-801.88,198.12,7.71,56.44,0.19,0
50187,5040,-198.12,-1000.00,0.00,0.00,198.12,0.04,0
50188,5041,1000.00,1000.00,2000.00,207.42,792.58,0.29,1
50189,5041,1000.00,2000.00,3000.00,0.00,494.23,0.20,1
50190,5041,-1000.00,1000.00,2000.00,3000.00,0.00,0.00,0
50191,5041,1000.00,2000.00,3000.00,278.86,1721.14,0.26,1
50192,5041,1000.00,3000.00,4000.00,585.54,2414.46,0.17,1
50193,5041,1000.00,4000.00,5000.00,0.00,403.09,0.12,1
50194,5041,1000.00,5000.00,6000.00,1319.98,3680.02,0.33,1
50195,5041,1000.00,6000.00,7000.00,86.57,1274.12,0.19,1
50196,5041,1000.00,7000.00,8000.00,0.00,2273.67,0.19,1
50197,5041,1000.00,8000.00,9000.00,0.00,8000.00,0.22,1
50198,5041,1000.00,9000.00,10000.00,1201.64,7798.36,0.26,1
50199,5041,-1000.00,8000.00,9000.00,6249.57,1111.42,0.09,0
50200,5041,1000.00,9000.00,10000.00,0.00,9000.00,0.17,1
50201,5041,1000.00,10000.00,11000.00,0.00,5673.02,0.34,1
50202,5041,1000.00,11000.00,12000.00,0.00,3627.61,0.16,1
50203,5041,-1000.00,10000.00,11000.00,11573.61,0.00,0.02,0
50204,5041,1000.00,11000.00,12000.00,4717.30,6282.70,0.18,1
50205,5041,1000.00,12000.00,13000.00,0.00,12000.00,0.15,1
50206,5041,1000.00,13000.00,14000.00,0.00,13000.00,0.09,1
50207,5041,1000.00,14000.00,15000.00,0.00,14000.00,0.30,1
50208,5041,1000.00,15000.00,16000.00,0.00,15000.00,0.29,1
50209,5041,-1000.00,14000.00,15000.00,11064.46,0.00,0.02,0
50210,5041,1000.00,15000.00,16000.00,0.00,12142.93,0.17,1
50211,5041,1000.00,16000.00,17000.00,1891.84,9513.30,0.35,1
50212,5041,1000.00,17000.00,18000.00,732.50,16267.50,0.02,1
50213,5041,1000.00,18000.00,19000.00,0.00,15589.55,0.27,1
50214,5041,1000.00,19000.00,20000.00,0.00,15213.87,0.13,1
50215,5041,1000.00,20000.00,21000.00,0.00,13116.78,0.21,1
50216,5041,1000.00,21000.00,22000.00,1825.29,19174.71,0.29,1
50217,5041,1000.00,22000.00,23000.00,0.00,22000.00,0.33,1
50218,5041,1000.00,23000.00,24000.00,0.00,13724.60,0.14,1
50219,5041,1000.00,24000.00,25000.00,0.00,14204.34,0.34,1
50220,5041,1000.00,25000.00,26000.00,0.00,25000.00,0.26,1
50221,5041,1000.00,26000.00,27000.00,0.00,26000.00,0.11,1
50222,5041,1000.00,27000.00,28000.00,6959.39,20040.61,0.22,1
50223,5041,1000.00,28000.00,29000.00,0.00,19262.98,0.38,1
50224,5041,1000.00,29000.00,30000.00,0.00,27431.37,0.42,1
50225,5041,1000.00,30000.00,31000.00,0.00,30000.00,0.22,1
50226,5041,1000.00,31000.00,32000.00,0.00,31000.00,0.02,1
50227,5041,1000.00,32000.00,33000.00,89.22,5835.70,0.17,1
50228,5041,1000.00,33000.00,34000.00,11555.74,21444.26,0.29,1
50229,5041,1000.00,34000.00,35000.00,1022.86,32977.14,0.02,1
50230,5041,1000.00,35000.00,36000.00,551.93,25451.77,0.40,1
50231,5042,-1000.00,-1000.00,0.00,283.41,716.59,0.14,0
50232,5043,-1000.00,-1000.00,0.00,708.95,0.00,0.02,0
50233,5044,-1000.00,-1000.00,0.00,0.00,821.04,0.25,0
50234,5045,-536.62,-536.62,463.38,0.00,536.62,0.33,0
50235,5045,-463.38,-1000.00,0.00,223.97,239.41,0.06,0
50236,5046,-621.11,-621.11,378.89,621.11,0.00,0.02,0
50237,5046,0.00,-621.11,378.89,0.00,0.00,0.16,0
50238,5046,-378.89,-1000.00,0.00,195.78,183.11,0.21,0
50239,5047,0.00,0.00,1000.00,0.00,0.00,0.40,0
50240,5047,-1000.00,-1000.00,0.00,489.02,510.98,0.13,0
50241,5048,1000.00,1000.00,2000.00,377.53,622.47,0.30,1
50242,5048,1000.00,2000.00,3000.00,228.05,1771.95,0.42,1
50243,5048,1000.00,3000.00,4000.00,0.00,2178.08,0.16,1
50244,5048,1000.00,4000.00,5000.00,2000.00,2000.00,0.03,1
50245,5048,1000.00,5000.00,6000.00,0.00,5000.00,0.17,1
50246,5048,1000.00,6000.00,7000.00,0.00,5430.94,0.27,1
50247,5048,1000.00,7000.00,8000.00,2836.47,4163.53,0.23,1
50248,5048,-1000.00,6000.00,7000.00,5545.42,2454.58,0.08,0
50249,5048,1000.00,7000.00,8000.00,0.00,7000.00,0.37,1
50250,5048,1000.00,8000.00,9000.00,2363.66,5636.34,0.07,1
50251,5048,1000.00,9000.00,10000.00,0.00,3699.65,0.25,1
50252,5048,1000.00,10000.00,11000.00,0.00,3341.77,0.23,1
50253,5048,1000.00,11000.00,12000.00,3908.92,7091.08,0.11,1
50254,5048,1000.00,12000.00,13000.00,0.00,12000.00,0.28,1
50255,5048,1000.00,13000.00,14000.00,0.00,13000.00,0.24,1
50256,5048,-1000.00,12000.00,13000.00,13389.58,610.42,0.09,0
50257,5048,1000.00,13000.00,14000.00,0.00,13000.00,0.08,1
50258,5048,0.00,13000.00,14000.00,0.00,0.00,0.06,0
50259,5048,1000.00,14000.00,15000.00,0.00,14000.00,0.22,1
50260,5048,1000.00,15000.00,16000.00,0.00,15000.00,0.40,1
50261,5048,1000.00,16000.00,17000.00,0.00,16000.00,0.27,1
50262,5048,1000.00,17000.00,18000.00,8319.64,8680.36,0.12,1
50263,5048,1000.00,18000.00,19000.00,4563.53,13436.47,0.35,1
50264,5048,-1000.00,17000.00,18000.00,15495.96,3504.04,0.05,0
50265,5048,-1000.00,16000.00,17000.00,453.98,10713.79,0.35,0
50266,5048,-1000.00,15000.00,16000.00,6808.20,0.00,0.29,0
50267,5048,-1000.00,14000.00,15000.00,542.80,4519.09,0.40,0
50268,5048,-1000.00,13000.00,14000.00,0.00,2524.70,0.24,0
50269,5048,-1000.00,12000.00,13000.00,0.00,11208.44,0.14,0
50270,5048,-1000.00,11000.00,12000.00,13000.00,0.00,0.06,0
50271,5048,-1000.00,10000.00,11000.00,6914.30,0.00,0.40,0
50272,5048,0.00,10000.00,11000.00,0.00,0.00,0.22,0
50273,5048,-1000.00,9000.00,10000.00,3742.21,7257.79,0.13,0
50274,5048,-1000.00,8000.00,9000.00,3319.58,6680.42,0.32,0
50275,5049,1000.00,1000.00,2000.00,28.35,0.00,0.43,1
50276,5049,1000.00,2000.00,3000.00,995.01,223.44,0.31,1
50277,5049,1000.00,3000.00,4000.00,1346.11,0.00,0.24,1
50278,5049,-1000.00,2000.00,3000.00,0.00,4000.00,0.10,0
50279,5049,1000.00,3000.00,4000.00,2108.94,891.06,0.09,1
50280,5049,1000.00,4000.00,5000.00,2703.24,0.00,0.18,1
50281,5049,-1000.00,3000.00,4000.00,2088.00,2912.00,0.27,0
50282,5049,-1000.00,2000.00,3000.00,0.00,3616.26,0.05,0
50283,5049,-1000.00,1000.00,2000.00,151.97,1828.08,0.36,0
50284,5049,-1000.00,0.00,1000.00,584.07,1415.93,0.01,0
50285,5049,-1000.00,-1000.00,0.00,255.19,744.81,0.32,0
50286,5050,0.00,0.00,1000.00,0.00,0.00,0.02,0
50287,5050,0.00,0.00,1000.00,0.00,0.00,0.06,0
50288,5050,-1000.00,-1000.00,0.00,0.00,1000.00,0.31,0
50289,5051,-601.12,-601.12,398.88,601.12,0.00,0.07,0
50290,5051,-1000.00,-1601.12,-601.12,0.00,132.02,0.34,0
50291,5052,1000.00,1000.00,2000.00,730.79,0.00,0.18,1
50292,5052,1000.00,2000.00,3000.00,1417.44,54.81,0.22,1
50293,5052,-953.61,1046.39,2046.39,107.18,846.43,0.44,0
50294,5052,-1000.00,46.39,1046.39,0.00,1211.71,0.27,0
50295,5052,-538.29,-491.90,508.10,0.00,538.29,0.26,0
50296,5052,0.00,-491.90,508.10,0.00,0.00,0.36,0
50297,5052,0.00,-491.90,508.10,0.00,0.00,0.16,0
50298,5052,0.00,-491.90,508.10,0.00,0.00,0.26,0
50299,5052,1000.00,508.10,1508.10,83.09,0.00,0.34,1
50300,5052,1000.00,1508.10,2508.10,1508.10,0.00,0.00,1
50301,5052,-1000.00,508.10,1508.10,0.00,1254.72,0.22,0
50302,5052,-430.76,77.34,1077.34,0.00,430.76,0.33,0
50303,5052,-578.32,-500.98,499.02,0.00,578.32,0.27,0
50304,5052,-499.02,-1000.00,0.00,0.00,499.02,0.03,0
50305,5053,-1000.00,-1000.00,0.00,0.00,1000.00,0.18,0
50306,5054,-675.62,-675.62,324.38,0.00,675.62,0.37,0
50307,5054,-256.18,-931.80,68.20,0.00,256.18,0.21,0
50308,5054,-68.20,-1000.00,0.00,24.71,43.49,0.31,0
50309,5055,-1000.00,-1000.00,0.00,0.00,127.55,0.27,0
50310,5056,0.00,0.00,1000.00,0.00,0.00,0.31,0
50311,5056,0.00,0.00,1000.00,0.00,0.00,0.40,0
50312,5056,-112.17,-112.17,887.83,0.00,112.17,0.19,0
50313,5056,1000.00,887.83,1887.83,275.61,271.66,0.24,1
50314,5056,-1000.00,-112.17,887.83,662.37,1225.47,0.32,0
50315,5056,-485.52,-597.69,402.31,144.74,340.78,0.25,0
50316,5056,-369.15,-966.84,33.16,0.00,369.15,0.36,0
50317,5056,-33.16,-1000.00,0.00,0.00,33.16,0.07,0
50318,5057,1000.00,1000.00,2000.00,0.00,1000.00,0.01,1
50319,5057,1000.00,2000.00,3000.00,0.00,933.84,0.29,1
50320,5057,1000.00,3000.00,4000.00,0.00,2882.86,0.44,1
50321,5057,1000.00,4000.00,5000.00,0.00,4000.00,0.26,1
50322,5057,-1000.00,3000.00,4000.00,1919.99,1054.11,0.15,0
50323,5057,1000.00,4000.00,5000.00,0.00,4000.00,0.07,1
50324,5057,1000.00,5000.00,6000.00,0.00,1990.63,0.10,1
50325,5057,1000.00,6000.00,7000.00,2405.71,3594.29,0.25,1
50326,5057,0.00,6000.00,7000.00,0.00,0.00,0.07,0
50327,5057,1000.00,7000.00,8000.00,3223.33,3776.67,0.06,1
50328,5057,1000.00,8000.00,9000.00,45.80,7954.20,0.36,1
50329,5057,1000.00,9000.00,10000.00,0.00,9000.00,0.11,1
50330,5057,1000.00,10000.00,11000.00,5000.00,5000.00,0.10,1
50331,5057,-1000.00,9000.00,10000.00,5807.48,4241.06,0.18,0
50332,5057,-1000.00,8000.00,9000.00,7447.83,2552.17,0.08,0
50333,5057,1000.00,9000.00,10000.00,0.00,8515.65,0.42,1
50334,5057,1000.00,10000.00,11000.00,4869.46,5130.54,0.08,1
50335,5057,1000.00,11000.00,12000.00,0.00,11000.00,0.06,1
50336,5057,1000.00,12000.00,13000.00,0.00,12000.00,0.37,1
50337,5057,1000.00,13000.00,14000.00,0.00,7885.66,0.23,1
50338,5057,1000.00,14000.00,15000.00,0.00,14000.00,0.40,1
50339,5057,0.00,14000.00,15000.00,0.00,0.00,0.03,0
50340,5057,1000.00,15000.00,16000.00,0.00,11135.24,0.38,1
50341,5057,1000.00,16000.00,17000.00,0.00,13002.94,0.13,1
50342,5057,-1000.00,15000.00,16000.00,2760.42,0.00,0.08,0
50343,5057,-1000.00,14000.00,15000.00,0.00,16000.00,0.09,0
50344,5057,-322.32,13677.68,14677.68,0.00,322.32,0.09,0
50345,5057,-1000.00,12677.68,13677.68,0.00,14677.68,0.04,0
50346,5057,-1000.00,11677.68,12677.68,3295.46,8912.20,0.34,0
50347,5057,-1000.00,10677.68,11677.68,0.00,8113.95,0.37,0
50348,5057,-1000.00,9677.68,10677.68,5838.84,5838.84,0.01,0
50349,5057,-1000.00,8677.68,9677.68,0.00,4419.98,0.27,0
50350,5057,-1000.00,7677.68,8677.68,1429.53,8248.15,0.32,0
50351,5057,-1000.00,6677.68,7677.68,4338.84,4338.84,0.09,0
50352,5057,-1000.00,5677.68,6677.68,2998.65,4132.77,0.27,0
50353,5057,-1000.00,4677.68,5677.68,2891.40,3786.29,0.19,0
50354,5057,-1000.00,3677.68,4677.68,0.00,3924.21,0.31,0
50355,5057,-1000.00,2677.68,3677.68,0.00,4677.68,0.09,0
50356,5057,-1000.00,1677.68,2677.68,991.57,2686.11,0.30,0
50357,5057,-1000.00,677.68,1677.68,935.78,1741.90,0.32,0
50358,5057,-447.84,229.84,1229.84,0.00,447.84,0.18,0
50359,5058,0.00,0.00,1000.00,0.00,0.00,0.26,0
50360,5058,0.00,0.00,1000.00,0.00,0.00,0.09,0
50361,5058,-1000.00,-1000.00,0.00,0.00,1000.00,0.28,0
50362,5059,-1000.00,-1000.00,0.00,0.00,1000.00,0.10,0
50363,5060,-1000.00,-1000.00,0.00,0.00,1000.00,0.23,0
50364,5061,-1000.00,-1000.00,0.00,0.00,1000.00,0.22,0
50365,5062,-1000.00,-1000.00,0.00,111.94,888.06,0.43,0
50366,5063,-261.25,-261.25,738.75,261.25,0.00,0.03,0
50367,5063,1000.00,738.75,1738.75,0.00,92.97,0.13,1
50368,5063,1000.00,1738.75,2738.75,0.00,1738.75,0.27,1
50369,5063,1000.00,2738.75,3738.75,0.00,1755.19,0.25,1
50370,5063,-1000.00,1738.75,2738.75,2663.05,1075.70,0.05,0
50371,5063,1000.00,2738.75,3738.75,639.86,2098.89,0.39,1
50372,5063,1000.00,3738.75,4738.75,0.00,3738.75,0.18,1
50373,5063,1000.00,4738.75,5738.75,0.00,4738.75,0.30,1
50374,5063,1000.00,5738.75,6738.75,0.00,2688.86,0.28,1
50375,5063,-1000.00,4738.75,5738.75,6738.75,0.00,0.01,0
50376,5063,1000.00,5738.75,6738.75,979.18,4759.57,0.32,1
50377,5063,-1000.00,4738.75,5738.75,3196.38,0.00,0.05,0
50378,5063,-1000.00,3738.75,4738.75,4586.34,1152.41,0.07,0
50379,5063,-1000.00,2738.75,3738.75,3748.52,990.23,0.05,0
50380,5063,1000.00,3738.75,4738.75,0.00,487.58,0.15,1
50381,5063,1000.00,4738.75,5738.75,0.00,3264.96,0.29,1
50382,5063,1000.00,5738.75,6738.75,0.00,5738.75,0.37,1
50383,5063,1000.00,6738.75,7738.75,1003.39,4153.26,0.35,1
50384,5063,1000.00,7738.75,8738.75,1337.27,6401.48,0.30,1
50385,5063,1000.00,8738.75,9738.75,0.00,5289.07,0.35,1
50386,5063,1000.00,9738.75,10738.75,0.00,4884.62,0.22,1
50387,5063,1000.00,10738.75,11738.75,4110.19,6628.56,0.21,1
50388,5063,-1000.00,9738.75,10738.75,7769.28,3969.47,0.01,0
50389,5063,1000.00,10738.75,11738.75,3125.16,7613.59,0.04,1
50390,5063,-1000.00,9738.75,10738.75,4675.64,7063.11,0.21,0
50391,5063,-1000.00,8738.75,9738.75,2792.32,7946.42,0.38,0
50392,5063,-1000.00,7738.75,8738.75,448.25,0.00,0.10,0
50393,5063,-1000.00,6738.75,7738.75,0.00,8738.75,0.00,0
50394,5063,-1000.00,5738.75,6738.75,0.00,7738.75,0.42,0
50395,5063,-1000.00,4738.75,5738.75,2764.82,3973.93,0.21,0
50396,5063,-1000.00,3738.75,4738.75,0.00,4206.62,0.40,0
50397,5063,-1000.00,2738.75,3738.75,0.00,2968.05,0.24,0
50398,5063,-1000.00,1738.75,2738.75,0.00,2354.59,0.03,0
50399,5063,-1000.00,738.75,1738.75,2270.18,0.00,0.02,0
50400,5063,-1000.00,-261.25,738.75,371.08,1195.29,0.36,0
50401,5063,-738.75,-1000.00,0.00,366.46,372.29,0.19,0
50402,5064,-1000.00,-1000.00,0.00,149.99,676.13,0.37,0
50403,5065,-1000.00,-1000.00,0.00,0.00,566.11,0.42,0
50404,5066,0.00,0.00,1000.00,0.00,0.00,0.22,0
50405,5066,-1000.00,-1000.00,0.00,521.08,478.92,0.22,0
50406,5067,-1000.00,-1000.00,0.00,232.12,767.88,0.39,0
50407,5068,-1000.00,-1000.00,0.00,0.00,1000.00,0.32,0
50408,5069,-697.82,-697.82,302.18,0.00,697.82,0.37,0
50409,5069,-302.18,-1000.00,0.00,70.78,231.40,0.39,0
50410,5070,-1000.00,-1000.00,0.00,0.00,485.84,0.06,0
50411,5071,-522.24,-522.24,477.76,522.24,0.00,0.13,0
50412,5071,-1000.00,-1522.24,-522.24,0.00,380.03,0.15,0
50413,5072,-1000.00,-1000.00,0.00,0.00,15.61,0.20,0
50414,5073,-175.27,-175.27,824.73,0.00,175.27,0.30,0
50415,5073,0.00,-175.27,824.73,0.00,0.00,0.19,0
50416,5073,-824.73,-1000.00,0.00,339.05,485.67,0.21,0
50417,5074,1000.00,1000.00,2000.00,0.00,1000.00,0.35,1
50418,5074,1000.00,2000.00,3000.00,279.37,1720.63,0.35,1
50419,5074,1000.00,3000.00,4000.00,1481.89,1518.11,0.10,1
50420,5074,1000.00,4000.00,5000.00,1490.65,2509.35,0.16,1
50421,5074,1000.00,5000.00,6000.00,0.00,4135.37,0.16,1
50422,5074,-1000.00,4000.00,5000.00,3805.92,2194.08,0.14,0
50423,5074,1000.00,5000.00,6000.00,0.00,5000.00,0.37,1
50424,5074,0.00,5000.00,6000.00,0.00,0.00,0.02,0
50425,5074,-1000.00,4000.00,5000.00,3081.47,2918.53,0.16,0
50426,5074,1000.00,5000.00,6000.00,821.44,4178.56,0.40,1
50427,5074,1000.00,6000.00,7000.00,1669.19,4330.81,0.35,1
50428,5074,-1000.00,5000.00,6000.00,6021.60,978.40,0.05,0
50429,5074,-1000.00,4000.00,5000.00,2226.21,0.00,0.07,0
50430,5074,1000.00,5000.00,6000.00,2056.27,2943.73,0.04,1
50431,5074,1000.00,6000.00,7000.00,0.00,3734.07,0.16,1
50432,5074,1000.00,7000.00,8000.00,674.80,6325.20,0.14,1
50433,5074,-1000.00,6000.00,7000.00,5271.79,2728.21,0.09,0
50434,5074,-1000.00,5000.00,6000.00,4144.17,2855.83,0.37,0
50435,5074,1000.00,6000.00,7000.00,455.29,1436.21,0.20,1
50436,5074,1000.00,7000.00,8000.00,3500.00,3500.00,0.07,1
50437,5074,1000.00,8000.00,9000.00,0.00,8000.00,0.27,1
50438,5074,1000.00,9000.00,10000.00,1401.63,6388.12,0.38,1
50439,5074,1000.00,10000.00,11000.00,0.00,10000.00,0.33,1
50440,5074,1000.00,11000.00,12000.00,0.00,11000.00,0.25,1
50441,5074,1000.00,12000.00,13000.00,4456.83,7543.17,0.28,1
50442,5074,1000.00,13000.00,14000.00,0.00,13000.00,0.21,1
50443,5074,1000.00,14000.00,15000.00,0.00,14000.00,0.02,1
50444,5074,0.00,14000.00,15000.00,0.00,0.00,0.04,0
50445,5074,-1000.00,13000.00,14000.00,9219.00,5781.00,0.05,0
50446,5074,1000.00,14000.00,15000.00,4233.19,9766.81,0.13,1
50447,5074,1000.00,15000.00,16000.00,1724.87,13275.13,0.20,1
50448,5074,1000.00,16000.00,17000.00,0.00,16000.00,0.12,1
50449,5074,1000.00,17000.00,18000.00,0.00,4126.55,0.42,1
50450,5074,1000.00,18000.00,19000.00,0.00,18000.00,0.10,1
50451,5074,1000.00,19000.00,20000.00,2597.84,9123.75,0.30,1
50452,5074,-1000.00,18000.00,19000.00,7688.41,233.38,0.09,0
50453,5074,1000.00,19000.00,20000.00,6211.78,11492.92,0.31,1
50454,5074,1000.00,20000.00,21000.00,5315.36,14684.64,0.22,1
50455,5074,1000.00,21000.00,22000.00,0.00,21000.00,0.23,1
50456,5075,-616.00,-616.00,384.00,319.47,296.53,0.19,0
50457,5075,1000.00,384.00,1384.00,147.36,236.64,0.29,1
50458,5075,1000.00,1384.00,2384.00,0.00,916.44,0.27,1
50459,5075,1000.00,2384.00,3384.00,1062.54,1321.46,0.20,1
50460,5075,1000.00,3384.00,4384.00,222.11,3161.88,0.39,1
50461,5075,1000.00,4384.00,5384.00,131.72,1682.42,0.26,1
50462,5075,0.00,4384.00,5384.00,0.00,0.00,0.04,0
50463,5075,1000.00,5384.00,6384.00,0.00,5384.00,0.30,1
50464,5075,1000.00,6384.00,7384.00,0.00,6384.00,0.42,1
50465,5075,1000.00,7384.00,8384.00,0.00,7384.00,0.18,1
50466,5075,1000.00,8384.00,9384.00,0.00,8384.00,0.43,1
50467,5075,1000.00,9384.00,10384.00,0.00,9384.00,0.37,1
50468,5075,1000.00,10384.00,11384.00,0.00,10384.00,0.25,1
50469,5075,1000.00,11384.00,12384.00,0.00,3532.89,0.04,1
50470,5075,-1000.00,10384.00,11384.00,3790.32,2840.35,0.17,0
50471,5075,1000.00,11384.00,12384.00,783.82,10262.59,0.43,1
50472,5075,1000.00,12384.00,13384.00,1188.70,11195.30,0.38,1
50473,5075,1000.00,13384.00,14384.00,6692.00,6692.00,0.05,1
50474,5075,1000.00,14384.00,15384.00,0.00,12690.87,0.40,1
50475,5075,1000.00,15384.00,16384.00,0.00,4403.07,0.22,1
50476,5075,1000.00,16384.00,17384.00,1442.56,14941.44,0.39,1
50477,5075,1000.00,17384.00,18384.00,0.00,10149.01,0.07,1
50478,5075,-1000.00,16384.00,17384.00,8229.98,10154.02,0.29,0
50479,5075,-1000.00,15384.00,16384.00,5789.78,11594.22,0.33,0
50480,5075,-1000.00,14384.00,15384.00,14925.42,1458.58,0.02,0
50481,5075,-1000.00,13384.00,14384.00,0.00,12611.23,0.27,0
50482,5075,-1000.00,12384.00,13384.00,0.00,14384.00,0.43,0
50483,5075,-1000.00,11384.00,12384.00,581.16,12802.84,0.27,0
50484,5075,-1000.00,10384.00,11384.00,3640.52,8743.47,0.34,0
50485,5075,-1000.00,9384.00,10384.00,5201.44,6182.56,0.12,0
50486,5075,-1000.00,8384.00,9384.00,7035.88,3348.12,0.12,0
50487,5075,-1000.00,7384.00,8384.00,1526.88,7857.11,0.39,0
50488,5075,-1000.00,6384.00,7384.00,0.00,8108.51,0.34,0
50489,5075,-1000.00,5384.00,6384.00,0.00,4754.82,0.31,0
50490,5075,-1000.00,4384.00,5384.00,2762.19,0.00,0.03,0
50491,5075,-1000.00,3384.00,4384.00,0.00,4196.80,0.37,0
50492,5075,-1000.00,2384.00,3384.00,0.00,3872.63,0.39,0
50493,5075,-1000.00,1384.00,2384.00,0.00,3384.00,0.30,0
50494,5075,-1000.00,384.00,1384.00,0.00,1816.46,0.23,0
50495,5075,-1000.00,-616.00,384.00,0.00,1384.00,0.36,0
50496,5075,-1000.00,-1616.00,-616.00,204.57,179.43,0.12,0
50497,5076,-1000.00,-1000.00,0.00,0.00,1000.00,0.18,0
50498,5077,-862.81,-862.81,137.19,862.81,0.00,0.09,0
50499,5077,0.00,-862.81,137.19,0.00,0.00,0.42,0
50500,5077,-1000.00,-1862.81,-862.81,34.24,102.95,0.20,0
50501,5078,-497.58,-497.58,502.42,313.52,184.06,0.37,0
50502,5078,-487.06,-984.64,15.36,487.06,0.00,0.08,0
50503,5078,-9.76,-994.40,5.60,4.88,4.87,0.36,0
50504,5078,-784.34,-1778.74,-778.74,0.00,5.60,0.27,0
50505,5079,-1000.00,-1000.00,0.00,560.79,439.21,0.09,0
50506,5080,1000.00,1000.00,2000.00,193.84,0.00,0.35,1
50507,5080,1000.00,2000.00,3000.00,1856.50,143.50,0.12,1
50508,5080,-1000.00,1000.00,2000.00,1246.33,1753.67,0.18,0
50509,5080,1000.00,2000.00,3000.00,1798.18,0.00,0.07,1
50510,5080,0.00,2000.00,3000.00,0.00,0.00,0.24,0
50511,5080,-149.08,1850.92,2850.92,0.00,149.08,0.13,0
50512,5080,1000.00,2850.92,3850.92,557.40,0.00,0.41,1
50513,5080,0.00,2850.92,3850.92,0.00,0.00,0.05,0
50514,5080,-1000.00,1850.92,2850.92,1457.74,2393.18,0.29,0
50515,5080,-1000.00,850.92,1850.92,834.30,2016.62,0.37,0
50516,5080,-1000.00,-149.08,850.92,0.00,1533.65,0.33,0
50517,5080,-756.97,-906.05,93.95,70.80,686.16,0.42,0
50518,5080,-68.53,-974.58,25.42,0.00,68.53,0.38,0
50519,5080,429.20,-545.39,454.61,2.92,2.70,0.43,1
50520,5080,-454.61,-1000.00,0.00,82.80,371.82,0.33,0
50521,5081,-1000.00,-1000.00,0.00,339.03,660.97,0.21,0
50522,5082,0.00,0.00,1000.00,0.00,0.00,0.43,0
50523,5082,-927.69,-927.69,72.31,0.00,927.69,0.14,0
50524,5082,-72.31,-1000.00,0.00,31.69,40.62,0.26,0
50525,5083,0.00,0.00,1000.00,0.00,0.00,0.44,0
50526,5083,-1000.00,-1000.00,0.00,521.57,478.43,0.17,0
50527,5084,1000.00,1000.00,2000.00,0.00,66.62,0.29,1
50528,5084,-720.29,279.71,1279.71,720.29,0.00,0.25,0
50529,5084,1000.00,1279.71,2279.71,0.00,1015.08,0.38,1
50530,5084,1000.00,2279.71,3279.71,0.00,2279.71,0.17,1
50531,5084,1000.00,3279.71,4279.71,0.00,3279.71,0.38,1
50532,5084,1000.00,4279.71,5279.71,1322.39,1858.57,0.25,1
50533,5084,1000.00,5279.71,6279.71,1592.45,3687.26,0.14,1
50534,5084,1000.00,6279.71,7279.71,1891.29,4388.42,0.07,1
50535,5084,1000.00,7279.71,8279.71,2050.17,5229.54,0.19,1
50536,5084,-1000.00,6279.71,7279.71,4667.43,3612.28,0.16,0
50537,5084,-1000.00,5279.71,6279.71,4179.68,3100.03,0.10,0
50538,5084,1000.00,6279.71,7279.71,1966.62,4313.09,0.17,1
50539,5084,1000.00,7279.71,8279.71,0.00,7279.71,0.16,1
50540,5084,-1000.00,6279.71,7279.71,2172.43,1819.49,0.17,0
50541,5084,1000.00,7279.71,8279.71,602.55,6677.17,0.29,1
50542,5084,1000.00,8279.71,9279.71,3645.76,4633.96,0.41,1
50543,5084,1000.00,9279.71,10279.71,3192.88,6086.84,0.24,1
50544,5084,1000.00,10279.71,11279.71,1807.31,8472.40,0.27,1
50545,5084,1000.00,11279.71,12279.71,0.00,11279.71,0.01,1
50546,5084,1000.00,12279.71,13279.71,0.00,8699.21,0.20,1
50547,5084,1000.00,13279.71,14279.71,0.00,13279.71,0.03,1
50548,5084,1000.00,14279.71,15279.71,0.00,12974.13,0.44,1
50549,5084,1000.00,15279.71,16279.71,0.00,15279.71,0.32,1
50550,5084,1000.00,16279.71,17279.71,4889.29,11390.43,0.34,1
50551,5084,1000.00,17279.71,18279.71,0.00,10104.52,0.23,1
50552,5084,1000.00,18279.71,19279.71,5280.42,10107.35,0.30,1
50553,5084,1000.00,19279.71,20279.71,9639.86,9639.86,0.04,1
50554,5084,1000.00,20279.71,21279.71,0.00,20279.71,0.27,1
50555,5084,1000.00,21279.71,22279.71,0.00,21279.71,0.13,1
50556,5084,1000.00,22279.71,23279.71,0.00,22279.71,0.26,1
50557,5084,1000.00,23279.71,24279.71,0.00,23279.71,0.28,1
50558,5084,1000.00,24279.71,25279.71,4640.46,8943.74,0.24,1
50559,5084,1000.00,25279.71,26279.71,8902.45,16377.26,0.28,1
50560,5084,-1000.00,24279.71,25279.71,5190.87,2939.08,0.14,0
50561,5084,1000.00,25279.71,26279.71,0.00,25279.71,0.40,1
50562,5084,1000.00,26279.71,27279.71,5834.30,20445.41,0.40,1
50563,5084,1000.00,27279.71,28279.71,3028.00,24251.71,0.43,1
50564,5084,1000.00,28279.71,29279.71,0.00,28279.71,0.24,1
50565,5084,-1000.00,27279.71,28279.71,21788.01,7491.71,0.07,0
50566,5084,1000.00,28279.71,29279.71,13998.14,14281.58,0.11,1
50567,5084,1000.00,29279.71,30279.71,9212.09,20067.63,0.32,1
50568,5084,1000.00,30279.71,31279.71,0.00,20448.17,0.38,1
50569,5084,1000.00,31279.71,32279.71,0.00,13481.73,0.24,1
50570,5084,1000.00,32279.71,33279.71,9818.53,22461.19,0.44,1
50571,5085,-761.06,-761.06,238.94,761.06,0.00,0.18,0
50572,5085,-56.83,-817.89,182.11,56.83,0.00,0.28,0
50573,5085,-182.11,-1000.00,0.00,110.21,71.90,0.05,0
50574,5086,-778.95,-778.95,221.05,0.00,778.95,0.38,0
50575,5086,-1000.00,-1778.95,-778.95,17.67,0.00,0.04,0
50576,5087,1000.00,1000.00,2000.00,0.00,244.52,0.20,1
50577,5087,1000.00,2000.00,3000.00,0.00,940.56,0.31,1
50578,5087,1000.00,3000.00,4000.00,333.85,2666.15,0.43,1
50579,5087,1000.00,4000.00,5000.00,0.00,3342.09,0.10,1
50580,5087,1000.00,5000.00,6000.00,2500.00,2500.00,0.00,1
50581,5087,1000.00,6000.00,7000.00,0.00,6000.00,0.15,1
50582,5087,1000.00,7000.00,8000.00,0.00,6296.80,0.39,1
50583,5087,1000.00,8000.00,9000.00,0.00,6753.94,0.25,1
50584,5087,1000.00,9000.00,10000.00,0.00,9000.00,0.14,1
50585,5087,1000.00,10000.00,11000.00,4393.73,5606.27,0.25,1
50586,5087,1000.00,11000.00,12000.00,0.00,11000.00,0.02,1
50587,5087,1000.00,12000.00,13000.00,0.00,7741.41,0.28,1
50588,5087,1000.00,13000.00,14000.00,0.00,10084.32,0.37,1
50589,5087,-1000.00,12000.00,13000.00,1778.76,0.00,0.10,0
50590,5087,1000.00,13000.00,14000.00,0.00,13000.00,0.30,1
50591,5087,1000.00,14000.00,15000.00,0.00,14000.00,0.31,1
50592,5087,1000.00,15000.00,16000.00,4435.50,10564.50,0.35,1
50593,5087,1000.00,16000.00,17000.00,0.00,16000.00,0.02,1
50594,5087,1000.00,17000.00,18000.00,4033.39,12966.61,0.19,1
50595,5087,1000.00,18000.00,19000.00,147.43,17852.57,0.44,1
50596,5087,1000.00,19000.00,20000.00,5844.36,13155.64,0.10,1
50597,5087,1000.00,20000.00,21000.00,0.00,9607.08,0.23,1
50598,5087,1000.00,21000.00,22000.00,0.00,21000.00,0.07,1
50599,5087,1000.00,22000.00,23000.00,0.00,17347.34,0.41,1
50600,5087,-1000.00,21000.00,22000.00,9903.86,13096.14,0.37,0
50601,5087,-1000.00,20000.00,21000.00,7044.82,14496.17,0.38,0
50602,5087,-1000.00,19000.00,20000.00,0.00,21000.00,0.43,0
50603,5087,-1000.00,18000.00,19000.00,3742.88,16257.12,0.41,0
50604,5087,-1000.00,17000.00,18000.00,4323.47,14676.53,0.34,0
50605,5087,-1000.00,16000.00,17000.00,5117.92,12882.08,0.30,0
50606,5087,-1000.00,15000.00,16000.00,0.00,17000.00,0.26,0
50607,5087,-201.13,14798.87,15798.87,0.00,201.13,0.07,0
50608,5087,-1000.00,13798.87,14798.87,0.00,15798.87,0.04,0
50609,5087,-1000.00,12798.87,13798.87,0.00,10169.08,0.38,0
50610,5087,-1000.00,11798.87,12798.87,6899.43,6899.43,0.02,0
50611,5087,-1000.00,10798.87,11798.87,4254.80,8544.07,0.34,0
50612,5087,-1000.00,9798.87,10798.87,0.00,11798.87,0.44,0
50613,5087,-1000.00,8798.87,9798.87,1514.07,9284.80,0.39,0
50614,5087,-1000.00,7798.87,8798.87,0.00,6145.84,0.33,0
50615,5087,-1000.00,6798.87,7798.87,4375.09,4423.78,0.20,0
50616,5087,-1000.00,5798.87,6798.87,1899.91,5898.96,0.37,0
50617,5087,-1000.00,4798.87,5798.87,2408.87,4390.00,0.32,0
50618,5087,-1000.00,3798.87,4798.87,0.00,5798.87,0.10,0
50619,5087,-1000.00,2798.87,3798.87,0.00,4205.72,0.33,0
50620,5087,-1000.00,1798.87,2798.87,0.00,3798.87,0.10,0
50621,5087,-1000.00,798.87,1798.87,849.75,1949.11,0.35,0
50622,5087,-1000.00,-201.13,798.87,338.86,1460.01,0.36,0
50623,5087,-483.02,-684.15,315.85,0.00,483.02,0.26,0
50624,5087,-300.13,-984.29,15.71,94.76,205.37,0.33,0
50625,5087,-15.71,-1000.00,-0.00,0.81,14.90,0.43,0
50626,5088,-1000.00,-1000.00,0.00,0.00,68.84,0.26,0
50627,5089,0.00,0.00,1000.00,0.00,0.00,0.21,0
50628,5089,-383.67,-383.67,616.33,383.67,0.00,0.35,0
50629,5089,-1000.00,-1383.67,-383.67,0.00,573.07,0.23,0
50630,5090,-1000.00,-1000.00,0.00,356.69,643.31,0.29,0
50631,5091,-994.28,-994.28,5.72,994.28,0.00,0.11,0
50632,5091,-288.81,-1283.10,-283.10,0.00,1.81,0.37,0
50633,5092,-387.14,-387.14,612.86,0.00,387.14,0.26,0
50634,5092,-1000.00,-1387.14,-387.14,204.40,164.72,0.20,0
50635,5093,-850.49,-850.49,149.51,89.07,761.42,0.40,0
50636,5093,-58.66,-909.15,90.85,0.00,58.66,0.16,0
50637,5093,-90.85,-1000.00,0.00,8.69,82.17,0.42,0
50638,5094,1000.00,1000.00,2000.00,189.74,255.34,0.19,1
50639,5094,1000.00,2000.00,3000.00,814.74,1185.26,0.15,1
50640,5094,1000.00,3000.00,4000.00,0.00,2340.43,0.39,1
50641,5094,1000.00,4000.00,5000.00,773.16,2917.14,0.38,1
50642,5094,-1000.00,3000.00,4000.00,2454.25,654.20,0.11,0
50643,5094,1000.00,4000.00,5000.00,0.00,1597.93,0.25,1
50644,5094,1000.00,5000.00,6000.00,0.00,4348.38,0.16,1
50645,5094,1000.00,6000.00,7000.00,0.00,4941.03,0.32,1
50646,5094,1000.00,7000.00,8000.00,0.00,5805.79,0.22,1
50647,5094,1000.00,8000.00,9000.00,0.00,7765.71,0.44,1
50648,5094,1000.00,9000.00,10000.00,1782.60,7217.40,0.41,1
50649,5094,1000.00,10000.00,11000.00,0.00,10000.00,0.21,1
50650,5094,1000.00,11000.00,12000.00,3126.54,7873.46,0.24,1
50651,5094,1000.00,12000.00,13000.00,714.12,11285.88,0.41,1
50652,5094,1000.00,13000.00,14000.00,0.00,13000.00,0.10,1
50653,5094,1000.00,14000.00,15000.00,0.00,4197.14,0.20,1
50654,5094,1000.00,15000.00,16000.00,2328.33,12671.67,0.42,1
50655,5094,-1000.00,14000.00,15000.00,8493.73,7506.27,0.20,0
50656,5094,1000.00,15000.00,16000.00,0.00,15000.00,0.19,1
50657,5094,1000.00,16000.00,17000.00,6729.89,9270.11,0.20,1
50658,5094,1000.00,17000.00,18000.00,1387.16,15612.84,0.30,1
50659,5094,-1000.00,16000.00,17000.00,5767.23,2245.18,0.13,0
50660,5094,1000.00,17000.00,18000.00,8500.00,8500.00,0.31,1
50661,5094,-1000.00,16000.00,17000.00,8994.98,6375.09,0.18,0
50662,5094,1000.00,17000.00,18000.00,5081.18,11918.82,0.36,1
50663,5094,1000.00,18000.00,19000.00,5509.13,11665.20,0.33,1
50664,5094,1000.00,19000.00,20000.00,7420.12,11579.88,0.28,1
50665,5094,1000.00,20000.00,21000.00,0.00,20000.00,0.01,1
50666,5094,-1000.00,19000.00,20000.00,15170.04,5829.96,0.09,0
50667,5094,1000.00,20000.00,21000.00,0.00,8409.71,0.23,1
50668,5094,1000.00,21000.00,22000.00,2005.78,18994.22,0.43,1
50669,5094,-1000.00,20000.00,21000.00,21110.58,889.42,0.08,0
50670,5094,-1000.00,19000.00,20000.00,12979.44,7439.60,0.15,0
50671,5094,-1000.00,18000.00,19000.00,11701.14,8298.86,0.06,0
50672,5094,1000.00,19000.00,20000.00,0.00,14779.95,0.23,1
50673,5094,1000.00,20000.00,21000.00,0.00,20000.00,0.28,1
50674,5094,-1000.00,19000.00,20000.00,13077.62,7922.38,0.01,0
50675,5094,1000.00,20000.00,21000.00,9273.18,10726.82,0.21,1
50676,5094,1000.00,21000.00,22000.00,2505.09,18494.91,0.33,1
50677,5094,1000.00,22000.00,23000.00,0.00,22000.00,0.00,1
50678,5094,1000.00,23000.00,24000.00,0.00,23000.00,0.41,1
50679,5094,1000.00,24000.00,25000.00,3963.77,20036.23,0.17,1
50680,5094,0.00,24000.00,25000.00,0.00,0.00,0.04,0
50681,5094,1000.00,25000.00,26000.00,2641.86,22358.14,0.38,1
50682,5094,1000.00,26000.00,27000.00,0.00,26000.00,0.20,1
50683,5094,1000.00,27000.00,28000.00,0.00,27000.00,0.18,1
50684,5095,0.00,0.00,1000.00,0.00,0.00,0.08,0
50685,5095,1000.00,1000.00,2000.00,0.00,314.30,0.41,1
50686,5095,-755.90,244.10,1244.10,744.36,11.54,0.09,0
50687,5095,1000.00,1244.10,2244.10,568.74,675.37,0.21,1
50688,5095,-1000.00,244.10,1244.10,0.00,2244.10,0.44,0
50689,5095,-1000.00,-755.90,244.10,0.00,1244.10,0.38,0
50690,5095,-244.10,-1000.00,0.00,140.28,103.82,0.06,0
50691,5096,-1000.00,-1000.00,0.00,383.89,616.11,0.24,0
50692,5097,-557.73,-557.73,442.27,201.11,356.62,0.33,0
50693,5097,-442.27,-1000.00,0.00,0.00,442.27,0.04,0
50694,5098,-1000.00,-1000.00,0.00,498.77,501.23,0.03,0
50695,5099,1000.00,1000.00,2000.00,0.00,720.15,0.35,1
50696,5099,1000.00,2000.00,3000.00,0.00,1766.40,0.42,1
50697,5099,1000.00,3000.00,4000.00,1255.65,1744.35,0.27,1
50698,5099,1000.00,4000.00,5000.00,1096.95,2903.05,0.19,1
50699,5099,1000.00,5000.00,6000.00,2500.00,2500.00,0.04,1
50700,5099,1000.00,6000.00,7000.00,0.00,6000.00,0.22,1
50701,5099,1000.00,7000.00,8000.00,0.00,7000.00,0.34,1
50702,5099,-1000.00,6000.00,7000.00,0.00,7332.51,0.06,0
50703,5099,-1000.00,5000.00,6000.00,3605.38,0.00,0.18,0
50704,5099,-1000.00,4000.00,5000.00,0.00,1018.71,0.14,0
50705,5099,-1000.00,3000.00,4000.00,0.00,1675.11,0.35,0
50706,5099,-1000.00,2000.00,3000.00,1244.21,0.00,0.38,0
50707,5099,-1000.00,1000.00,2000.00,0.00,79.15,0.37,0
50708,5099,-1000.00,0.00,1000.00,218.47,850.57,0.34,0
50709,5099,-34.33,-34.33,965.67,34.33,0.00,0.11,0
50710,5099,0.00,-34.33,965.67,0.00,0.00,0.30,0
50711,5099,-285.03,-319.36,680.64,179.59,105.44,0.41,0
50712,5099,0.00,-319.36,680.64,0.00,0.00,0.18,0
50713,5099,-436.89,-756.25,243.75,436.89,0.00,0.04,0
50714,5099,-1000.00,-1756.25,-756.25,27.56,185.49,0.19,0
50715,5100,1000.00,1000.00,2000.00,61.54,0.00,0.07,1
50716,5100,-1000.00,0.00,1000.00,509.67,903.48,0.30,0
50717,5100,-181.10,-181.10,818.90,0.00,181.10,0.07,0
50718,5100,-568.06,-749.16,250.84,0.00,568.06,0.44,0
50719,5100,1000.00,250.84,1250.84,177.24,73.60,0.18,1
50720,5100,-929.64,-678.80,321.20,0.00,929.64,0.26,0
50721,5100,-321.20,-1000.00,0.00,0.00,321.20,0.31,0
50722,5101,1000.00,1000.00,2000.00,0.00,1000.00,0.20,1
50723,5101,1000.00,2000.00,3000.00,0.00,2000.00,0.20,1
50724,5101,1000.00,3000.00,4000.00,324.70,2675.30,0.24,1
50725,5101,1000.00,4000.00,5000.00,1356.06,2643.94,0.24,1
50726,5101,1000.00,5000.00,6000.00,0.00,1467.55,0.11,1
50727,5101,1000.00,6000.00,7000.00,0.00,6000.00,0.10,1
50728,5101,1000.00,7000.00,8000.00,0.00,7000.00,0.10,1
50729,5101,1000.00,8000.00,9000.00,0.00,1396.83,0.14,1
50730,5101,1000.00,9000.00,10000.00,2289.64,6710.36,0.38,1
50731,5101,1000.00,10000.00,11000.00,2968.48,7031.52,0.07,1
50732,5101,1000.00,11000.00,12000.00,3514.17,7485.83,0.29,1
50733,5101,1000.00,12000.00,13000.00,0.00,8175.70,0.28,1
50734,5101,1000.00,13000.00,14000.00,0.00,13000.00,0.27,1
50735,5101,1000.00,14000.00,15000.00,0.00,14000.00,0.28,1
50736,5101,1000.00,15000.00,16000.00,0.00,15000.00,0.25,1
50737,5101,1000.00,16000.00,17000.00,7316.69,8683.31,0.24,1
50738,5101,1000.00,17000.00,18000.00,0.00,15949.68,0.14,1
50739,5101,1000.00,18000.00,19000.00,0.00,18000.00,0.41,1
50740,5101,1000.00,19000.00,20000.00,1057.30,17942.70,0.39,1
50741,5101,1000.00,20000.00,21000.00,0.00,20000.00,0.17,1
50742,5101,1000.00,21000.00,22000.00,3071.96,15272.46,0.39,1
50743,5101,1000.00,22000.00,23000.00,0.00,22000.00,0.20,1
50744,5101,1000.00,23000.00,24000.00,0.00,23000.00,0.30,1
50745,5101,1000.00,24000.00,25000.00,0.00,19022.03,0.31,1
50746,5101,-1000.00,23000.00,24000.00,13509.99,11490.01,0.28,0
50747,5101,-1000.00,22000.00,23000.00,16194.13,6651.42,0.11,0
50748,5101,1000.00,23000.00,24000.00,7560.42,15439.58,0.22,1
50749,5101,1000.00,24000.00,25000.00,5919.02,18080.98,0.38,1
50750,5101,1000.00,25000.00,26000.00,6321.34,18678.66,0.33,1
50751,5101,1000.00,26000.00,27000.00,0.00,26000.00,0.40,1
50752,5101,1000.00,27000.00,28000.00,0.00,27000.00,0.07,1
50753,5101,1000.00,28000.00,29000.00,0.00,28000.00,0.07,1
50754,5101,1000.00,29000.00,30000.00,1166.44,27833.56,0.44,1
50755,5101,1000.00,30000.00,31000.00,5764.12,24235.88,0.30,1
50756,5101,1000.00,31000.00,32000.00,15423.50,15576.50,0.10,1
50757,5101,1000.00,32000.00,33000.00,0.00,26383.84,0.20,1
50758,5101,1000.00,33000.00,34000.00,0.00,20574.45,0.33,1
50759,5101,1000.00,34000.00,35000.00,0.00,34000.00,0.15,1
50760,5101,1000.00,35000.00,36000.00,13253.08,21746.92,0.28,1
50761,5101,1000.00,36000.00,37000.00,0.00,36000.00,0.39,1
50762,5101,-1000.00,35000.00,36000.00,13572.11,12278.53,0.20,0
50763,5102,1000.00,1000.00,2000.00,53.44,679.37,0.39,1
50764,5102,1000.00,2000.00,3000.00,0.00,2000.00,0.08,1
50765,5102,1000.00,3000.00,4000.00,0.00,3000.00,0.18,1
50766,5102,1000.00,4000.00,5000.00,1100.91,2899.09,0.10,1
50767,5102,1000.00,5000.00,6000.00,1457.74,1892.08,0.23,1
50768,5102,-1000.00,4000.00,5000.00,6000.00,0.00,0.01,0
50769,5102,1000.00,5000.00,6000.00,1073.63,2709.24,0.31,1
50770,5102,1000.00,6000.00,7000.00,0.00,6000.00,0.37,1
50771,5102,-1000.00,5000.00,6000.00,4233.48,2766.52,0.13,0
50772,5102,1000.00,6000.00,7000.00,0.00,6000.00,0.36,1
50773,5102,1000.00,7000.00,8000.00,1831.22,5168.78,0.37,1
50774,5102,1000.00,8000.00,9000.00,4000.00,4000.00,0.21,1
50775,5102,1000.00,9000.00,10000.00,0.00,9000.00,0.44,1
50776,5102,1000.00,10000.00,11000.00,2435.23,7564.77,0.20,1
50777,5102,1000.00,11000.00,12000.00,0.00,5349.78,0.03,1
50778,5102,1000.00,12000.00,13000.00,4736.73,7263.27,0.04,1
50779,5102,1000.00,13000.00,14000.00,4954.17,8045.83,0.05,1
50780,5102,-1000.00,12000.00,13000.00,8287.38,0.00,0.06,0
50781,5102,1000.00,13000.00,14000.00,0.00,13000.00,0.03,1
50782,5102,1000.00,14000.00,15000.00,5961.03,8038.97,0.06,1
50783,5102,-1000.00,13000.00,14000.00,10473.50,941.08,0.22,0
50784,5102,1000.00,14000.00,15000.00,5480.33,8519.67,0.28,1
50785,5102,1000.00,15000.00,16000.00,0.00,15000.00,0.26,1
50786,5102,1000.00,16000.00,17000.00,0.00,16000.00,0.40,1
50787,5102,1000.00,17000.00,18000.00,7419.56,9580.44,0.10,1
50788,5102,1000.00,18000.00,19000.00,4927.81,13072.19,0.25,1
50789,5102,1000.00,19000.00,20000.00,0.00,19000.00,0.43,1
50790,5102,1000.00,20000.00,21000.00,0.00,20000.00,0.05,1
50791,5102,1000.00,21000.00,22000.00,0.00,21000.00,0.40,1
50792,5102,1000.00,22000.00,23000.00,11000.00,11000.00,0.04,1
50793,5102,1000.00,23000.00,24000.00,0.00,23000.00,0.29,1
50794,5102,-1000.00,22000.00,23000.00,13573.88,10426.12,0.38,0
50795,5102,1000.00,23000.00,24000.00,8069.74,12694.37,0.28,1
50796,5102,-1000.00,22000.00,23000.00,3739.04,2232.13,0.14,0
50797,5102,1000.00,23000.00,24000.00,0.00,19535.06,0.42,1
50798,5102,1000.00,24000.00,25000.00,5205.58,8488.78,0.23,1
50799,5102,0.00,24000.00,25000.00,0.00,0.00,0.06,0
50800,5102,1000.00,25000.00,26000.00,8294.19,16705.81,0.31,1
50801,5103,-603.27,-603.27,396.73,0.00,603.27,0.34,0
50802,5103,-396.73,-1000.00,0.00,198.37,198.37,0.05,0
50803,5104,-1000.00,-1000.00,0.00,385.46,614.54,0.13,0
50804,5105,0.00,0.00,1000.00,0.00,0.00,0.39,0
50805,5105,-1000.00,-1000.00,0.00,560.98,439.02,0.18,0
50806,5106,-1000.00,-1000.00,0.00,415.50,584.50,0.02,0
50807,5107,-1000.00,-1000.00,0.00,698.63,301.37,0.10,0
50808,5108,1000.00,1000.00,2000.00,184.46,433.36,0.27,1
50809,5108,1000.00,2000.00,3000.00,803.45,1196.55,0.22,1
50810,5108,1000.00,3000.00,4000.00,0.00,2033.85,0.38,1
50811,5108,1000.00,4000.00,5000.00,0.00,3300.31,0.37,1
50812,5108,1000.00,5000.00,6000.00,0.00,5000.00,0.39,1
50813,5108,1000.00,6000.00,7000.00,0.00,1289.39,0.19,1
50814,5108,1000.00,7000.00,8000.00,743.81,6256.19,0.43,1
50815,5108,1000.00,8000.00,9000.00,0.00,3425.71,0.08,1
50816,5108,1000.00,9000.00,10000.00,3043.49,5956.51,0.29,1
50817,5108,1000.00,10000.00,11000.00,0.00,10000.00,0.43,1
50818,5108,1000.00,11000.00,12000.00,3597.27,7402.73,0.34,1
50819,5108,1000.00,12000.00,13000.00,0.00,12000.00,0.23,1
50820,5108,1000.00,13000.00,14000.00,2030.83,10969.17,0.11,1
50821,5108,1000.00,14000.00,15000.00,0.00,5510.04,0.04,1
50822,5108,1000.00,15000.00,16000.00,0.00,15000.00,0.20,1
50823,5108,1000.00,16000.00,17000.00,4572.38,11427.62,0.11,1
50824,5108,1000.00,17000.00,18000.00,6467.19,10532.81,0.08,1
50825,5108,1000.00,18000.00,19000.00,0.00,3990.78,0.18,1
50826,5108,1000.00,19000.00,20000.00,2775.34,16224.66,0.27,1
50827,5108,1000.00,20000.00,21000.00,4842.28,15157.72,0.18,1
50828,5108,1000.00,21000.00,22000.00,3878.20,17121.80,0.02,1
50829,5108,1000.00,22000.00,23000.00,0.00,22000.00,0.14,1
50830,5108,-1000.00,21000.00,22000.00,12164.77,10835.23,0.12,0
50831,5108,1000.00,22000.00,23000.00,0.00,22000.00,0.42,1
50832,5108,1000.00,23000.00,24000.00,5690.65,17309.35,0.17,1
50833,5108,1000.00,24000.00,25000.00,3110.81,20889.19,0.43,1
50834,5108,1000.00,25000.00,26000.00,0.00,25000.00,0.25,1
50835,5108,1000.00,26000.00,27000.00,0.00,23177.47,0.14,1
50836,5108,1000.00,27000.00,28000.00,0.00,24506.02,0.38,1
50837,5108,1000.00,28000.00,29000.00,13350.66,14649.34,0.24,1
50838,5108,1000.00,29000.00,30000.00,0.00,29000.00,0.24,1
50839,5108,1000.00,30000.00,31000.00,0.00,29779.67,0.22,1
50840,5108,1000.00,31000.00,32000.00,0.00,31000.00,0.21,1
50841,5108,1000.00,32000.00,33000.00,0.00,29919.06,0.41,1
50842,5108,1000.00,33000.00,34000.00,0.00,33000.00,0.30,1
50843,5108,1000.00,34000.00,35000.00,315.49,33684.51,0.42,1
50844,5108,-1000.00,33000.00,34000.00,30853.02,4146.98,0.01,0
50845,5108,1000.00,34000.00,35000.00,16483.80,17516.20,0.11,1
50846,5108,-1000.00,33000.00,34000.00,10173.95,1756.25,0.11,0
50847,5108,1000.00,34000.00,35000.00,0.00,21581.13,0.27,1
50848,5108,1000.00,35000.00,36000.00,10111.04,21889.83,0.32,1
50849,5108,1000.00,36000.00,37000.00,14191.38,21808.62,0.19,1
50850,5108,1000.00,37000.00,38000.00,0.00,5720.24,0.04,1
50851,5108,1000.00,38000.00,39000.00,0.00,1642.95,0.10,1
50852,5108,1000.00,39000.00,40000.00,0.00,17206.88,0.26,1
50853,5108,1000.00,40000.00,41000.00,0.00,32761.42,0.15,1
50854,5108,1000.00,41000.00,42000.00,16117.96,24882.04,0.21,1
50855,5108,-1000.00,40000.00,41000.00,17294.89,24705.11,0.37,0
50856,5108,-1000.00,39000.00,40000.00,0.00,41000.00,0.08,0
50857,5108,-1000.00,38000.00,39000.00,5143.11,34856.89,0.43,0
50858,5108,-1000.00,37000.00,38000.00,22187.18,16812.82,0.08,0
50859,5108,-1000.00,36000.00,37000.00,0.00,27136.81,0.36,0
50860,5108,-1000.00,35000.00,36000.00,9125.39,8243.71,0.18,0
50861,5108,-1000.00,34000.00,35000.00,0.00,36000.00,0.01,0
50862,5108,-1000.00,33000.00,34000.00,0.00,30235.02,0.43,0
50863,5108,-1000.00,32000.00,33000.00,5898.20,28101.80,0.19,0
50864,5108,-1000.00,31000.00,32000.00,0.00,33000.00,0.31,0
50865,5108,-1000.00,30000.00,31000.00,14591.23,17408.77,0.18,0
50866,5108,-1000.00,29000.00,30000.00,0.00,31000.00,0.16,0
50867,5108,-1000.00,28000.00,29000.00,0.00,30000.00,0.31,0
50868,5108,-1000.00,27000.00,28000.00,10553.57,18446.43,0.18,0
50869,5108,-1000.00,26000.00,27000.00,13053.65,14946.35,0.11,0
50870,5108,-1000.00,25000.00,26000.00,17006.88,9993.12,0.04,0
50871,5108,-1000.00,24000.00,25000.00,0.00,24674.84,0.00,0
50872,5108,-1000.00,23000.00,24000.00,14724.31,10275.69,0.15,0
50873,5108,-1000.00,22000.00,23000.00,0.00,6741.80,0.21,0
50874,5108,-1000.00,21000.00,22000.00,7879.83,3897.52,0.14,0
50875,5108,-1000.00,20000.00,21000.00,1416.84,20583.16,0.19,0
50876,5109,-1000.00,-1000.00,0.00,529.45,470.55,0.13,0
50877,5110,0.00,0.00,1000.00,0.00,0.00,0.43,0
50878,5110,0.00,0.00,1000.00,0.00,0.00,0.31,0
50879,5110,-251.57,-251.57,748.43,0.00,251.57,0.22,0
50880,5110,1000.00,748.43,1748.43,545.88,0.00,0.14,1
50881,5110,-778.97,-30.53,969.47,0.00,778.97,0.20,0
50882,5110,-969.47,-1000.00,0.00,404.58,564.89,0.23,0
50883,5110,0.00,-1000.00,0.00,0.00,0.00,0.06,1
50884,5110,-0.00,-1000.00,0.00,0.00,0.00,0.34,0
50885,5110,-0.00,-1000.00,0.00,0.00,0.00,0.13,0
50886,5111,0.00,0.00,1000.00,0.00,0.00,0.02,0
50887,5111,-1000.00,-1000.00,0.00,326.29,673.71,0.08,0
50888,5112,-1000.00,-1000.00,0.00,0.00,1000.00,0.24,0
50889,5113,0.00,0.00,1000.00,0.00,0.00,0.30,0
50890,5113,1000.00,1000.00,2000.00,1000.00,0.00,0.08,1
50891,5113,-1000.00,0.00,1000.00,299.89,949.28,0.31,0
50892,5113,-852.50,-852.50,147.50,75.13,777.37,0.19,0
50893,5113,1000.00,147.50,1147.50,97.47,50.02,0.07,1
50894,5113,-1000.00,-852.50,147.50,479.63,667.87,0.13,0
50895,5113,1000.00,147.50,1147.50,25.31,0.00,0.24,1
50896,5113,1000.00,1147.50,2147.50,1147.50,0.00,0.15,1
50897,5113,0.00,1147.50,2147.50,0.00,0.00,0.10,0
50898,5113,0.00,1147.50,2147.50,0.00,0.00,0.18,0
50899,5113,1000.00,2147.50,3147.50,1547.03,600.46,0.06,1
50900,5113,1000.00,3147.50,4147.50,622.38,0.00,0.42,1
50901,5113,-1000.00,2147.50,3147.50,0.00,1913.01,0.08,0
50902,5113,1000.00,3147.50,4147.50,387.87,169.97,0.43,1
50903,5113,-1000.00,2147.50,3147.50,0.00,1982.77,0.30,0
50904,5113,1000.00,3147.50,4147.50,385.99,0.00,0.42,1
50905,5113,-1000.00,2147.50,3147.50,0.00,2221.85,0.04,0
50906,5113,1000.00,3147.50,4147.50,2712.43,435.06,0.11,1
50907,5113,-1000.00,2147.50,3147.50,40.22,4107.28,0.10,0
50908,5113,0.00,2147.50,3147.50,0.00,0.00,0.15,0
50909,5113,1000.00,3147.50,4147.50,1744.42,1403.07,0.09,1
50910,5113,0.00,3147.50,4147.50,0.00,0.00,0.18,0
50911,5113,-464.45,2683.05,3683.05,128.20,336.25,0.44,0
50912,5113,-1000.00,1683.05,2683.05,0.00,2839.63,0.14,0
50913,5113,-128.58,1554.46,2554.46,128.58,0.00,0.39,0
50914,5113,-731.67,822.79,1822.79,731.67,0.00,0.28,0
50915,5113,-1000.00,-177.21,822.79,0.00,801.08,0.34,0
50916,5113,0.00,-177.21,822.79,0.00,0.00,0.25,0
50917,5113,-29.13,-206.34,793.66,29.13,0.00,0.41,0
50918,5113,-1000.00,-1206.34,-206.34,0.00,793.66,0.01,0
50919,5114,-1000.00,-1000.00,0.00,0.00,1000.00,0.40,0
50920,5115,-1000.00,-1000.00,0.00,0.00,1000.00,0.23,0
50921,5116,-1000.00,-1000.00,0.00,0.00,236.64,0.37,0
50922,5117,0.00,0.00,1000.00,0.00,0.00,0.11,0
50923,5117,-1000.00,-1000.00,0.00,139.92,860.08,0.19,0
50924,5118,-1000.00,-1000.00,0.00,0.00,1000.00,0.39,0
50925,5119,-547.86,-547.86,452.14,0.00,547.86,0.31,0
50926,5119,-1000.00,-1547.86,-547.86,328.69,123.45,0.09,0
50927,5120,-749.44,-749.44,250.56,749.44,0.00,0.19,0
50928,5120,0.00,-749.44,250.56,0.00,0.00,0.26,0
50929,5120,-1000.00,-1749.44,-749.44,46.43,204.13,0.40,0
50930,5121,-336.05,-336.05,663.95,0.00,336.05,0.23,0
50931,5121,-663.95,-1000.00,0.00,226.40,437.55,0.17,0
50932,5122,1000.00,1000.00,2000.00,0.00,388.20,0.23,1
50933,5122,-670.84,329.16,1329.16,670.84,0.00,0.37,0
50934,5122,1000.00,1329.16,2329.16,0.00,364.65,0.16,1
50935,5122,1000.00,2329.16,3329.16,0.00,2329.16,0.13,1
50936,5122,1000.00,3329.16,4329.16,0.00,2862.44,0.34,1
50937,5122,1000.00,4329.16,5329.16,0.00,75.99,0.08,1
50938,5122,1000.00,5329.16,6329.16,0.00,1056.88,0.04,1
50939,5122,1000.00,6329.16,7329.16,0.00,6329.16,0.02,1
50940,5122,1000.00,7329.16,8329.16,798.25,6530.91,0.26,1
50941,5122,1000.00,8329.16,9329.16,1349.12,2601.40,0.22,1
50942,5122,-1000.00,7329.16,8329.16,5593.45,1452.15,0.16,0
50943,5122,1000.00,8329.16,9329.16,1085.56,7243.60,0.39,1
50944,5122,1000.00,9329.16,10329.16,4664.58,4664.58,0.16,1
50945,5122,1000.00,10329.16,11329.16,583.91,8522.86,0.42,1
50946,5122,1000.00,11329.16,12329.16,0.00,7631.04,0.38,1
50947,5122,1000.00,12329.16,13329.16,0.00,8730.04,0.20,1
50948,5122,1000.00,13329.16,14329.16,4061.90,9267.25,0.33,1
50949,5122,1000.00,14329.16,15329.16,0.00,4340.24,0.21,1
50950,5122,-1000.00,13329.16,14329.16,7664.58,7664.58,0.35,0
50951,5122,-1000.00,12329.16,13329.16,0.00,14329.16,0.38,0
50952,5122,-1000.00,11329.16,12329.16,494.54,12834.62,0.44,0
50953,5122,-1000.00,10329.16,11329.16,0.00,12329.16,0.37,0
50954,5122,-1000.00,9329.16,10329.16,6261.49,5067.67,0.16,0
50955,5122,-1000.00,8329.16,9329.16,0.00,9860.14,0.35,0
50956,5122,-1000.00,7329.16,8329.16,6314.58,3014.58,0.11,0
50957,5122,-1000.00,6329.16,7329.16,3469.48,4859.68,0.27,0
50958,5122,-1000.00,5329.16,6329.16,3073.14,4256.02,0.24,0
50959,5122,-1000.00,4329.16,5329.16,0.00,6329.16,0.39,0
50960,5122,-1000.00,3329.16,4329.16,0.00,5329.16,0.26,0
50961,5122,-1000.00,2329.16,3329.16,2164.58,2164.58,0.08,0
50962,5122,-1000.00,1329.16,2329.16,0.00,3329.16,0.06,0
50963,5122,-981.62,347.54,1347.54,0.00,981.62,0.28,0
50964,5122,-1000.00,-652.46,347.54,341.00,1006.54,0.38,0
50965,5122,-86.28,-738.74,261.26,0.00,86.28,0.20,0
50966,5122,-261.26,-1000.00,0.00,87.07,174.19,0.32,0
50967,5123,-534.73,-534.73,465.27,156.87,377.86,0.38,0
50968,5123,0.00,-534.73,465.27,0.00,0.00,0.41,0
50969,5123,-465.27,-1000.00,0.00,0.00,465.27,0.11,0
50970,5124,0.00,0.00,1000.00,0.00,0.00,0.25,0
50971,5124,1000.00,1000.00,2000.00,816.36,0.00,0.07,1
50972,5124,1000.00,2000.00,3000.00,1063.43,936.57,0.15,1
50973,5124,-1000.00,1000.00,2000.00,180.52,1374.61,0.33,0
50974,5124,1000.00,2000.00,3000.00,1057.30,307.84,0.29,1
50975,5124,-1000.00,1000.00,2000.00,0.00,3000.00,0.29,0
50976,5124,-149.90,850.10,1850.10,0.00,149.90,0.30,0
50977,5124,1000.00,1850.10,2850.10,959.53,890.57,0.19,1
50978,5124,0.00,1850.10,2850.10,0.00,0.00,0.07,0
50979,5124,1000.00,2850.10,3850.10,1693.38,453.45,0.10,1
50980,5124,0.00,2850.10,3850.10,0.00,0.00,0.03,0
50981,5124,-1000.00,1850.10,2850.10,370.22,3479.88,0.44,0
50982,5124,-1000.00,850.10,1850.10,1103.48,1746.63,0.19,0
50983,5124,1000.00,1850.10,2850.10,224.03,0.00,0.43,1
50984,5124,0.00,1850.10,2850.10,0.00,0.00,0.03,0
50985,5124,0.00,1850.10,2850.10,0.00,0.00,0.05,0
50986,5124,1000.00,2850.10,3850.10,1656.66,1193.45,0.28,1
50987,5124,-1000.00,1850.10,2850.10,0.00,3850.10,0.32,0
50988,5124,1000.00,2850.10,3850.10,694.07,477.02,0.16,1
50989,5124,-1000.00,1850.10,2850.10,1097.64,2752.46,0.36,0
50990,5124,-1000.00,850.10,1850.10,1425.05,1425.05,0.07,0
50991,5124,-1000.00,-149.90,850.10,0.00,1806.44,0.14,0
50992,5124,-1000.00,-1149.90,-149.90,149.35,700.76,0.42,0
50993,5125,-1000.00,-1000.00,0.00,0.00,1000.00,0.26,0
50994,5126,1000.00,1000.00,2000.00,0.00,1000.00,0.22,1
50995,5126,1000.00,2000.00,3000.00,372.47,1627.53,0.41,1
50996,5126,1000.00,3000.00,4000.00,0.00,410.01,0.12,1
50997,5126,1000.00,4000.00,5000.00,1999.80,2000.20,0.43,1
50998,5126,1000.00,5000.00,6000.00,913.62,4086.38,0.26,1
50999,5126,1000.00,6000.00,7000.00,0.00,6000.00,0.27,1
51000,5126,1000.00,7000.00,8000.00,0.00,7000.00,0.34,1
51001,5126,1000.00,8000.00,9000.00,838.50,7161.50,0.15,1
51002,5126,1000.00,9000.00,10000.00,0.00,9000.00,0.36,1
51003,5126,-172.65,8827.35,9827.35,172.65,0.00,0.01,0
51004,5126,1000.00,9827.35,10827.35,3208.74,6618.61,0.18,1
51005,5126,1000.00,10827.35,11827.35,0.00,10827.35,0.04,1
51006,5126,1000.00,11827.35,12827.35,0.00,11827.35,0.10,1
51007,5126,1000.00,12827.35,13827.35,0.00,9179.23,0.17,1
51008,5126,1000.00,13827.35,14827.35,0.00,12907.07,0.23,1
51009,5126,1000.00,14827.35,15827.35,2671.77,12155.58,0.41,1
51010,5126,0.00,14827.35,15827.35,0.00,0.00,0.00,0
51011,5126,1000.00,15827.35,16827.35,0.00,13664.10,0.26,1
51012,5126,1000.00,16827.35,17827.35,0.00,4491.61,0.20,1
51013,5126,1000.00,17827.35,18827.35,0.00,8906.58,0.30,1
51014,5126,1000.00,18827.35,19827.35,6245.22,12582.13,0.33,1
51015,5126,1000.00,19827.35,20827.35,2918.55,11713.08,0.34,1
51016,5126,1000.00,20827.35,21827.35,0.00,15386.74,0.40,1
51017,5126,-1000.00,19827.35,20827.35,10043.86,3840.08,0.13,0
51018,5126,1000.00,20827.35,21827.35,0.00,10916.99,0.27,1
51019,5126,-1000.00,19827.35,20827.35,3076.56,0.00,0.30,0
51020,5126,1000.00,20827.35,21827.35,6008.64,14818.71,0.17,1
51021,5126,1000.00,21827.35,22827.35,3305.07,18522.27,0.41,1
51022,5126,1000.00,22827.35,23827.35,0.00,16885.04,0.25,1
51023,5126,1000.00,23827.35,24827.35,1110.63,22716.72,0.27,1
51024,5126,1000.00,24827.35,25827.35,0.00,24827.35,0.39,1
51025,5126,1000.00,25827.35,26827.35,0.00,14197.85,0.27,1
51026,5126,1000.00,26827.35,27827.35,0.00,26827.35,0.43,1
51027,5126,1000.00,27827.35,28827.35,11689.50,16137.85,0.27,1
51028,5126,1000.00,28827.35,29827.35,6941.97,21481.62,0.37,1
51029,5126,1000.00,29827.35,30827.35,0.00,29827.35,0.31,1
51030,5126,1000.00,30827.35,31827.35,13452.85,17374.50,0.15,1
51031,5126,1000.00,31827.35,32827.35,0.00,31827.35,0.27,1
51032,5126,-1000.00,30827.35,31827.35,19748.43,13078.92,0.11,0
51033,5126,1000.00,31827.35,32827.35,8448.81,23378.54,0.20,1
51034,5126,1000.00,32827.35,33827.35,0.00,31542.94,0.34,1
51035,5126,1000.00,33827.35,34827.35,0.00,32118.93,0.41,1
51036,5126,1000.00,34827.35,35827.35,0.00,29871.98,0.43,1
51037,5126,1000.00,35827.35,36827.35,4846.62,23050.43,0.36,1
51038,5126,1000.00,36827.35,37827.35,6.14,36821.21,0.44,1
51039,5126,1000.00,37827.35,38827.35,0.00,37827.35,0.30,1
51040,5126,1000.00,38827.35,39827.35,15437.90,23389.45,0.28,1
51041,5126,1000.00,39827.35,40827.35,0.00,5831.87,0.08,1
51042,5127,-690.27,-690.27,309.73,0.00,690.27,0.33,0
51043,5127,-1000.00,-1690.27,-690.27,227.88,81.85,0.05,0
51044,5128,1000.00,1000.00,2000.00,240.49,759.51,0.39,1
51045,5128,-199.82,800.18,1800.18,199.82,0.00,0.07,0
51046,5128,1000.00,1800.18,2800.18,0.00,785.30,0.21,1
51047,5128,1000.00,2800.18,3800.18,0.00,2669.83,0.30,1
51048,5128,1000.00,3800.18,4800.18,843.26,2956.93,0.40,1
51049,5128,1000.00,4800.18,5800.18,2400.09,2400.09,0.29,1
51050,5128,1000.00,5800.18,6800.18,0.00,5800.18,0.33,1
51051,5128,1000.00,6800.18,7800.18,1921.85,4878.33,0.37,1
51052,5128,-1000.00,5800.18,6800.18,3916.91,3883.27,0.14,0
51053,5128,1000.00,6800.18,7800.18,0.00,3608.14,0.09,1
51054,5128,1000.00,7800.18,8800.18,0.00,7529.97,0.43,1
51055,5128,1000.00,8800.18,9800.18,609.80,8190.38,0.34,1
51056,5128,-1000.00,7800.18,8800.18,8096.67,1703.51,0.00,0
51057,5128,1000.00,8800.18,9800.18,1499.12,7301.06,0.30,1
51058,5128,1000.00,9800.18,10800.18,441.80,9358.38,0.25,1
51059,5128,1000.00,10800.18,11800.18,1503.18,9297.00,0.42,1
51060,5128,1000.00,11800.18,12800.18,0.00,8527.13,0.40,1
51061,5128,1000.00,12800.18,13800.18,0.00,3257.76,0.20,1
51062,5128,-1000.00,11800.18,12800.18,8932.95,4867.23,0.11,0
51063,5128,1000.00,12800.18,13800.18,4122.12,8678.06,0.25,1
51064,5128,1000.00,13800.18,14800.18,0.00,13800.18,0.14,1
51065,5128,1000.00,14800.18,15800.18,5898.77,8901.42,0.20,1
51066,5128,1000.00,15800.18,16800.18,0.00,15800.18,0.09,1
51067,5128,-1000.00,14800.18,15800.18,9972.62,0.00,0.04,0
51068,5128,-1000.00,13800.18,14800.18,10100.95,5699.23,0.05,0
51069,5128,-1000.00,12800.18,13800.18,0.00,14800.18,0.07,0
51070,5128,-1000.00,11800.18,12800.18,0.00,13800.18,0.36,0
51071,5128,-1000.00,10800.18,11800.18,0.00,11680.96,0.19,0
51072,5128,-1000.00,9800.18,10800.18,5900.09,5900.09,0.01,0
51073,5128,-1000.00,8800.18,9800.18,2499.11,8301.07,0.11,0
51074,5128,-1000.00,7800.18,8800.18,765.06,2327.86,0.20,0
51075,5128,-1000.00,6800.18,7800.18,815.17,7553.13,0.42,0
51076,5128,-1000.00,5800.18,6800.18,3464.01,2649.06,0.18,0
51077,5128,-1000.00,4800.18,5800.18,946.82,5853.36,0.33,0
51078,5128,-1000.00,3800.18,4800.18,2570.57,3229.62,0.14,0
51079,5128,-1000.00,2800.18,3800.18,153.80,4646.38,0.16,0
51080,5128,-1000.00,1800.18,2800.18,0.00,3800.18,0.21,0
51081,5128,-1000.00,800.18,1800.18,0.00,2800.18,0.02,0
51082,5128,-1000.00,-199.82,800.18,0.00,1800.18,0.33,0
51083,5128,-533.35,-733.16,266.84,100.55,432.80,0.32,0
51084,5128,-266.84,-1000.00,0.00,0.00,266.84,0.13,0
51085,5129,-1000.00,-1000.00,0.00,473.29,0.00,0.29,0
51086,5130,-1000.00,-1000.00,0.00,279.83,720.17,0.30,0
51087,5131,1000.00,1000.00,2000.00,0.00,1000.00,0.23,1
51088,5131,-1000.00,0.00,1000.00,1019.25,105.58,0.09,0
51089,5131,1000.00,1000.00,2000.00,0.00,396.30,0.21,1
51090,5131,1000.00,2000.00,3000.00,527.68,1472.32,0.27,1
51091,5131,1000.00,3000.00,4000.00,0.00,3000.00,0.19,1
51092,5131,1000.00,4000.00,5000.00,1520.51,2479.49,0.30,1
51093,5131,1000.00,5000.00,6000.00,1510.30,3489.70,0.21,1
51094,5131,1000.00,6000.00,7000.00,2045.44,3954.56,0.27,1
51095,5131,1000.00,7000.00,8000.00,2343.72,4656.28,0.26,1
51096,5131,1000.00,8000.00,9000.00,2702.27,5297.73,0.20,1
51097,5131,-1000.00,7000.00,8000.00,4848.63,4151.37,0.42,0
51098,5131,1000.00,8000.00,9000.00,2737.64,5262.36,0.32,1
51099,5131,1000.00,9000.00,10000.00,851.10,7319.53,0.42,1
51100,5131,1000.00,10000.00,11000.00,0.00,6769.17,0.12,1
51101,5131,1000.00,11000.00,12000.00,0.00,11000.00,0.39,1
51102,5131,1000.00,12000.00,13000.00,0.00,8455.74,0.18,1
51103,5131,1000.00,13000.00,14000.00,6500.00,6500.00,0.18,1
51104,5131,1000.00,14000.00,15000.00,0.00,14000.00,0.22,1
51105,5131,-1000.00,13000.00,14000.00,6334.99,8665.01,0.43,0
51106,5131,0.00,13000.00,14000.00,0.00,0.00,0.04,0
51107,5131,-1000.00,12000.00,13000.00,4897.93,9102.07,0.29,0
51108,5131,-1000.00,11000.00,12000.00,3022.41,9977.59,0.37,0
51109,5131,-1000.00,10000.00,11000.00,3441.11,8558.89,0.35,0
51110,5131,-1000.00,9000.00,10000.00,3543.14,7456.86,0.31,0
51111,5131,-1000.00,8000.00,9000.00,6635.28,3364.72,0.04,0
51112,5131,-1000.00,7000.00,8000.00,7334.37,1665.63,0.05,0
51113,5131,-1000.00,6000.00,7000.00,3313.17,4686.83,0.25,0
51114,5131,-1000.00,5000.00,6000.00,0.00,7000.00,0.39,0
51115,5131,-1000.00,4000.00,5000.00,0.00,1536.97,0.20,0
51116,5131,-1000.00,3000.00,4000.00,0.00,3874.41,0.26,0
51117,5131,-1000.00,2000.00,3000.00,0.00,1438.73,0.17,0
51118,5131,-1000.00,1000.00,2000.00,0.00,3000.00,0.25,0
51119,5131,-904.07,95.93,1095.93,0.00,904.07,0.29,0
51120,5131,-1000.00,-904.07,95.93,553.36,542.57,0.06,0
51121,5131,-56.12,-960.18,39.82,0.00,56.12,0.33,0
51122,5131,-17.38,-977.57,22.43,0.00,17.38,0.27,0
51123,5131,0.00,-977.57,22.43,0.00,0.00,0.03,0
51124,5131,-1000.00,-1977.57,-977.57,12.40,10.03,0.15,0
51125,5132,0.00,0.00,1000.00,0.00,0.00,0.06,0
51126,5132,0.00,0.00,1000.00,0.00,0.00,0.36,0
51127,5132,1000.00,1000.00,2000.00,349.23,650.77,0.29,1
51128,5132,1000.00,2000.00,3000.00,0.00,1586.34,0.13,1
51129,5132,1000.00,3000.00,4000.00,0.00,3000.00,0.23,1
51130,5132,1000.00,4000.00,5000.00,0.00,4000.00,0.16,1
51131,5132,1000.00,5000.00,6000.00,0.00,4033.33,0.12,1
51132,5132,1000.00,6000.00,7000.00,0.00,6000.00,0.07,1
51133,5132,1000.00,7000.00,8000.00,3340.97,3659.03,0.36,1
51134,5132,1000.00,8000.00,9000.00,2587.81,5412.19,0.11,1
51135,5132,1000.00,9000.00,10000.00,2696.58,6303.42,0.34,1
51136,5132,1000.00,10000.00,11000.00,2345.40,7654.60,0.30,1
51137,5132,1000.00,11000.00,12000.00,5500.00,5500.00,0.29,1
51138,5132,1000.00,12000.00,13000.00,0.00,6696.68,0.24,1
51139,5132,1000.00,13000.00,14000.00,0.00,13000.00,0.41,1
51140,5132,1000.00,14000.00,15000.00,6988.79,7011.21,0.15,1
51141,5132,1000.00,15000.00,16000.00,0.00,11321.32,0.24,1
51142,5132,1000.00,16000.00,17000.00,4261.81,11738.19,0.35,1
51143,5132,-1000.00,15000.00,16000.00,17000.00,0.00,0.02,0
51144,5132,-1000.00,14000.00,15000.00,9208.64,6791.36,0.03,0
51145,5132,1000.00,15000.00,16000.00,0.00,2150.83,0.10,1
51146,5132,1000.00,16000.00,17000.00,1457.44,14542.56,0.40,1
51147,5132,1000.00,17000.00,18000.00,5219.12,11780.88,0.37,1
51148,5132,1000.00,18000.00,19000.00,2462.58,15537.42,0.40,1
51149,5132,1000.00,19000.00,20000.00,2526.90,16473.10,0.40,1
51150,5132,1000.00,20000.00,21000.00,0.00,16037.90,0.30,1
51151,5132,1000.00,21000.00,22000.00,9875.96,11124.04,0.20,1
51152,5132,1000.00,22000.00,23000.00,2037.86,5662.74,0.20,1
51153,5132,1000.00,23000.00,24000.00,10067.21,12932.79,0.00,1
51154,5132,1000.00,24000.00,25000.00,0.00,24000.00,0.13,1
51155,5132,-1000.00,23000.00,24000.00,12589.30,12410.70,0.44,0
51156,5132,1000.00,24000.00,25000.00,0.00,24000.00,0.06,1
51157,5133,-1000.00,-1000.00,0.00,0.00,1000.00,0.36,0
51158,5134,-1000.00,-1000.00,0.00,50.76,538.48,0.33,0
51159,5135,1000.00,1000.00,2000.00,500.00,500.00,0.06,1
51160,5135,1000.00,2000.00,3000.00,1000.00,1000.00,0.03,1
51161,5135,1000.00,3000.00,4000.00,91.83,2244.97,0.40,1
51162,5135,1000.00,4000.00,5000.00,1843.78,2156.22,0.34,1
51163,5135,1000.00,5000.00,6000.00,0.00,4957.35,0.43,1
51164,5135,1000.00,6000.00,7000.00,2671.88,3328.12,0.17,1
51165,5135,1000.00,7000.00,8000.00,1837.97,5162.03,0.31,1
51166,5135,1000.00,8000.00,9000.00,2942.45,5057.55,0.10,1
51167,5135,1000.00,9000.00,10000.00,3209.42,5790.58,0.15,1
51168,5135,1000.00,10000.00,11000.00,0.00,7489.58,0.40,1
51169,5135,1000.00,11000.00,12000.00,4898.94,6101.06,0.18,1
51170,5135,-1000.00,10000.00,11000.00,6609.37,5390.63,0.40,0
51171,5135,1000.00,11000.00,12000.00,0.00,2696.98,0.17,1
51172,5135,1000.00,12000.00,13000.00,0.00,12000.00,0.04,1
51173,5135,1000.00,13000.00,14000.00,0.00,6998.14,0.02,1
51174,5135,-1000.00,12000.00,13000.00,7137.69,6862.31,0.38,0
51175,5135,-1000.00,11000.00,12000.00,0.00,2477.67,0.18,0
51176,5135,-1000.00,10000.00,11000.00,159.05,5580.76,0.30,0
51177,5135,-1000.00,9000.00,10000.00,0.00,11000.00,0.26,0
51178,5135,-1000.00,8000.00,9000.00,5000.00,5000.00,0.07,0
51179,5135,-1000.00,7000.00,8000.00,3522.88,5477.12,0.26,0
51180,5135,0.00,7000.00,8000.00,0.00,0.00,0.04,0
51181,5135,-1000.00,6000.00,7000.00,0.00,8000.00,0.27,0
51182,5135,-1000.00,5000.00,6000.00,1111.97,5888.03,0.36,0
51183,5135,-1000.00,4000.00,5000.00,0.00,6000.00,0.36,0
51184,5135,-1000.00,3000.00,4000.00,0.00,5000.00,0.12,0
51185,5135,-1000.00,2000.00,3000.00,0.00,4000.00,0.30,0
51186,5135,-1000.00,1000.00,2000.00,1216.77,1783.23,0.08,0
51187,5135,-1000.00,0.00,1000.00,1647.26,352.74,0.09,0
51188,5135,-533.31,-533.31,466.69,0.00,533.31,0.29,0
51189,5135,-466.69,-1000.00,0.00,25.45,441.24,0.44,0
51190,5136,-853.80,-853.80,146.20,0.00,853.80,0.37,0
51191,5136,-146.20,-1000.00,0.00,0.00,146.20,0.28,0
51192,5137,-1000.00,-1000.00,0.00,194.78,805.22,0.33,0
51193,5138,-1000.00,-1000.00,0.00,574.38,425.62,0.11,0
51194,5139,-1000.00,-1000.00,0.00,263.05,736.95,0.26,0
51195,5140,-1000.00,-1000.00,0.00,251.62,748.38,0.25,0
51196,5141,-633.15,-633.15,366.85,522.65,110.50,0.30,0
51197,5141,0.00,-633.15,366.85,0.00,0.00,0.23,0
51198,5141,-1000.00,-1633.15,-633.15,0.00,227.99,0.30,0
51199,5142,1000.00,1000.00,2000.00,0.00,416.77,0.23,1
51200,5142,1000.00,2000.00,3000.00,0.00,1946.14,0.13,1
51201,5142,1000.00,3000.00,4000.00,127.74,2872.26,0.18,1
51202,5142,1000.00,4000.00,5000.00,0.00,2319.06,0.34,1
51203,5142,1000.00,5000.00,6000.00,0.00,5000.00,0.10,1
51204,5142,1000.00,6000.00,7000.00,0.00,6000.00,0.17,1
51205,5142,1000.00,7000.00,8000.00,779.73,6220.27,0.42,1
51206,5142,1000.00,8000.00,9000.00,0.00,8000.00,0.34,1
51207,5142,1000.00,9000.00,10000.00,0.00,9000.00,0.21,1
51208,5142,1000.00,10000.00,11000.00,0.00,10000.00,0.34,1
51209,5142,1000.00,11000.00,12000.00,0.00,10863.37,0.44,1
51210,5142,1000.00,12000.00,13000.00,3328.01,8671.99,0.02,1
51211,5142,1000.00,13000.00,14000.00,2755.17,8579.01,0.35,1
51212,5142,1000.00,14000.00,15000.00,0.00,14000.00,0.11,1
51213,5142,1000.00,15000.00,16000.00,0.00,15000.00,0.01,1
51214,5142,1000.00,16000.00,17000.00,5471.58,10528.42,0.06,1
51215,5142,1000.00,17000.00,18000.00,8500.00,8500.00,0.03,1
51216,5142,1000.00,18000.00,19000.00,3282.34,14717.66,0.37,1
51217,5142,1000.00,19000.00,20000.00,0.00,7788.11,0.27,1
51218,5142,1000.00,20000.00,21000.00,1704.22,18295.78,0.42,1
51219,5142,1000.00,21000.00,22000.00,0.00,21000.00,0.32,1
51220,5142,1000.00,22000.00,23000.00,0.00,22000.00,0.35,1
51221,5142,1000.00,23000.00,24000.00,0.00,19766.16,0.41,1
51222,5142,1000.00,24000.00,25000.00,12000.00,12000.00,0.23,1
51223,5142,1000.00,25000.00,26000.00,10676.95,14323.05,0.14,1
51224,5142,1000.00,26000.00,27000.00,0.00,26000.00,0.19,1
51225,5142,1000.00,27000.00,28000.00,3912.83,23087.17,0.34,1
51226,5142,1000.00,28000.00,29000.00,0.00,20660.65,0.34,1
51227,5142,1000.00,29000.00,30000.00,0.00,12097.91,0.13,1
51228,5142,1000.00,30000.00,31000.00,0.00,30000.00,0.38,1
51229,5142,1000.00,31000.00,32000.00,0.00,31000.00,0.20,1
51230,5142,1000.00,32000.00,33000.00,0.00,32000.00,0.25,1
51231,5142,1000.00,33000.00,34000.00,8219.69,24780.31,0.38,1
51232,5142,1000.00,34000.00,35000.00,0.00,9142.33,0.11,1
51233,5142,1000.00,35000.00,36000.00,625.20,34374.80,0.12,1
51234,5142,1000.00,36000.00,37000.00,0.00,36000.00,0.10,1
51235,5142,1000.00,37000.00,38000.00,0.00,37000.00,0.12,1
51236,5142,1000.00,38000.00,39000.00,13830.19,24169.81,0.35,1
51237,5142,1000.00,39000.00,40000.00,0.00,34307.61,0.17,1
51238,5142,1000.00,40000.00,41000.00,0.00,40000.00,0.00,1
51239,5143,-1000.00,-1000.00,0.00,24.55,975.45,0.44,0
51240,5144,-922.57,-922.57,77.43,0.00,922.57,0.40,0
51241,5144,-77.43,-1000.00,0.00,15.13,62.31,0.39,0
51242,5145,1000.00,1000.00,2000.00,300.80,699.20,0.06,1
51243,5145,1000.00,2000.00,3000.00,839.15,1160.85,0.21,1
51244,5145,1000.00,3000.00,4000.00,0.00,1338.36,0.10,1
51245,5145,1000.00,4000.00,5000.00,82.59,3917.41,0.02,1
51246,5145,1000.00,5000.00,6000.00,607.16,1658.55,0.23,1
51247,5145,1000.00,6000.00,7000.00,0.00,5240.88,0.22,1
51248,5145,1000.00,7000.00,8000.00,0.00,7000.00,0.04,1
51249,5145,-1000.00,6000.00,7000.00,4189.85,3810.15,0.17,0
51250,5145,1000.00,7000.00,8000.00,2997.75,4002.25,0.20,1
51251,5145,1000.00,8000.00,9000.00,810.03,7189.97,0.43,1
51252,5145,1000.00,9000.00,10000.00,2667.22,6332.78,0.25,1
51253,5145,1000.00,10000.00,11000.00,409.97,6391.22,0.37,1
51254,5145,1000.00,11000.00,12000.00,3044.66,7955.34,0.37,1
51255,5145,1000.00,12000.00,13000.00,0.00,12000.00,0.42,1
51256,5145,1000.00,13000.00,14000.00,0.00,13000.00,0.36,1
51257,5145,1000.00,14000.00,15000.00,0.00,12569.85,0.26,1
51258,5145,1000.00,15000.00,16000.00,0.00,4403.11,0.21,1
51259,5145,1000.00,16000.00,17000.00,0.00,10851.40,0.12,1
51260,5145,1000.00,17000.00,18000.00,0.00,17000.00,0.26,1
51261,5145,1000.00,18000.00,19000.00,0.00,18000.00,0.32,1
51262,5145,1000.00,19000.00,20000.00,0.00,10737.30,0.32,1
51263,5145,-1000.00,18000.00,19000.00,13551.09,6448.91,0.06,0
51264,5145,-1000.00,17000.00,18000.00,14878.38,4121.62,0.16,0
51265,5145,-1000.00,16000.00,17000.00,8021.86,9978.14,0.18,0
51266,5145,-1000.00,15000.00,16000.00,0.00,17000.00,0.15,0
51267,5145,-1000.00,14000.00,15000.00,5461.99,5153.71,0.20,0
51268,5145,-1000.00,13000.00,14000.00,0.00,15000.00,0.19,0
51269,5145,-1000.00,12000.00,13000.00,0.00,12655.47,0.27,0
51270,5145,-1000.00,11000.00,12000.00,0.00,13000.00,0.25,0
51271,5145,-1000.00,10000.00,11000.00,0.00,12000.00,0.11,0
51272,5145,-1000.00,9000.00,10000.00,0.00,6024.60,0.10,0
51273,5145,-1000.00,8000.00,9000.00,1532.84,1074.10,0.14,0
51274,5145,-1000.00,7000.00,8000.00,0.00,9000.00,0.33,0
51275,5145,-1000.00,6000.00,7000.00,1095.81,6904.19,0.43,0
51276,5145,-1000.00,5000.00,6000.00,2699.83,4300.17,0.26,0
51277,5145,-1000.00,4000.00,5000.00,0.00,2800.68,0.19,0
51278,5145,-1000.00,3000.00,4000.00,0.00,2598.20,0.31,0
51279,5145,-1000.00,2000.00,3000.00,399.74,2938.80,0.40,0
51280,5145,-1000.00,1000.00,2000.00,0.00,3000.00,0.10,0
51281,5145,-1000.00,0.00,1000.00,1627.37,41.60,0.05,0
51282,5145,-1000.00,-1000.00,0.00,277.77,722.23,0.35,0
51283,5146,-1000.00,-1000.00,0.00,660.30,339.70,0.15,0
51284,5147,-1000.00,-1000.00,0.00,47.69,952.31,0.01,0
51285,5148,-1000.00,-1000.00,0.00,114.48,885.52,0.28,0
51286,5148,-0.00,-1000.00,0.00,0.00,0.00,0.18,0
51287,5149,0.00,0.00,1000.00,0.00,0.00,0.07,0
51288,5149,-365.59,-365.59,634.41,0.00,365.59,0.19,0
51289,5149,-634.41,-1000.00,0.00,162.43,471.98,0.02,0
51290,5150,-1000.00,-1000.00,0.00,0.00,1000.00,0.43,0
51291,5151,-1000.00,-1000.00,0.00,47.87,952.13,0.39,0
51292,5152,-1000.00,-1000.00,0.00,420.16,0.00,0.04,0
51293,5153,-411.03,-411.03,588.97,411.03,0.00,0.30,0
51294,5153,-1000.00,-1411.03,-411.03,87.19,264.05,0.34,0
51295,5154,-1000.00,-1000.00,0.00,303.94,696.06,0.15,0
51296,5155,-1000.00,-1000.00,0.00,0.00,1000.00,0.27,0
51297,5156,-1000.00,-1000.00,0.00,0.00,1000.00,0.41,0
51298,5157,-1000.00,-1000.00,0.00,346.99,463.38,0.28,0
51299,5158,-215.81,-215.81,784.19,0.00,215.81,0.24,0
51300,5158,-784.19,-1000.00,0.00,256.59,527.59,0.31,0
51301,5159,1000.00,1000.00,2000.00,129.14,870.86,0.17,1
51302,5159,1000.00,2000.00,3000.00,664.41,1335.59,0.31,1
51303,5159,1000.00,3000.00,4000.00,0.00,3000.00,0.06,1
51304,5159,1000.00,4000.00,5000.00,0.00,4000.00,0.26,1
51305,5159,1000.00,5000.00,6000.00,0.00,5000.00,0.25,1
51306,5159,1000.00,6000.00,7000.00,0.00,6000.00,0.27,1
51307,5159,1000.00,7000.00,8000.00,147.01,6852.99,0.43,1
51308,5159,1000.00,8000.00,9000.00,0.00,4735.02,0.04,1
51309,5159,1000.00,9000.00,10000.00,1572.89,7427.11,0.41,1
51310,5159,1000.00,10000.00,11000.00,495.70,9504.30,0.13,1
51311,5159,1000.00,11000.00,12000.00,0.00,6812.16,0.15,1
51312,5159,-1000.00,10000.00,11000.00,8559.73,3440.27,0.03,0
51313,5159,-1000.00,9000.00,10000.00,5753.20,0.00,0.02,0
51314,5159,1000.00,10000.00,11000.00,5000.00,5000.00,0.05,1
51315,5159,1000.00,11000.00,12000.00,5028.29,5971.71,0.13,1
51316,5159,1000.00,12000.00,13000.00,0.00,12000.00,0.20,1
51317,5159,1000.00,13000.00,14000.00,0.00,12680.42,0.42,1
51318,5159,1000.00,14000.00,15000.00,0.00,14000.00,0.35,1
51319,5159,1000.00,15000.00,16000.00,2876.85,12123.15,0.41,1
51320,5159,1000.00,16000.00,17000.00,0.00,16000.00,0.35,1
51321,5159,1000.00,17000.00,18000.00,2458.85,10853.24,0.36,1
51322,5159,1000.00,18000.00,19000.00,9000.00,9000.00,0.08,1
51323,5159,1000.00,19000.00,20000.00,0.00,19000.00,0.34,1
51324,5159,1000.00,20000.00,21000.00,0.00,13850.35,0.38,1
51325,5159,1000.00,21000.00,22000.00,2010.43,18989.57,0.26,1
51326,5159,1000.00,22000.00,23000.00,0.00,20363.84,0.42,1
51327,5159,1000.00,23000.00,24000.00,10020.84,12979.16,0.14,1
51328,5159,1000.00,24000.00,25000.00,3903.84,20096.16,0.41,1
51329,5159,1000.00,25000.00,26000.00,2905.86,22094.14,0.07,1
51330,5159,1000.00,26000.00,27000.00,0.00,26000.00,0.41,1
51331,5159,-1000.00,25000.00,26000.00,27000.00,0.00,0.00,0
51332,5159,-1000.00,24000.00,25000.00,15366.67,7714.27,0.14,0
51333,5159,1000.00,25000.00,26000.00,0.00,25000.00,0.29,1
51334,5159,1000.00,26000.00,27000.00,0.00,20191.54,0.06,1
51335,5159,1000.00,27000.00,28000.00,0.00,8260.12,0.11,1
51336,5159,1000.00,28000.00,29000.00,13825.08,14174.92,0.21,1
51337,5159,1000.00,29000.00,30000.00,0.00,7576.11,0.01,1
51338,5159,1000.00,30000.00,31000.00,9665.91,20334.09,0.29,1
51339,5159,1000.00,31000.00,32000.00,15500.00,15500.00,0.01,1
51340,5159,-1000.00,30000.00,31000.00,25899.85,0.00,0.00,0
51341,5159,1000.00,31000.00,32000.00,0.00,31000.00,0.25,1
51342,5159,1000.00,32000.00,33000.00,7519.45,23962.17,0.38,1
51343,5159,-1000.00,31000.00,32000.00,19668.02,13331.98,0.12,0
51344,5159,1000.00,32000.00,33000.00,5659.86,26340.14,0.41,1
51345,5159,1000.00,33000.00,34000.00,0.00,25788.51,0.41,1
51346,5159,-1000.00,32000.00,33000.00,13339.21,20660.79,0.13,0
51347,5159,-1000.00,31000.00,32000.00,19860.18,13139.82,0.11,0
51348,5159,-1000.00,30000.00,31000.00,0.00,32000.00,0.28,0
51349,5159,-1000.00,29000.00,30000.00,9474.07,21525.93,0.35,0
51350,5159,-1000.00,28000.00,29000.00,0.00,21242.03,0.38,0
51351,5159,-1000.00,27000.00,28000.00,13857.52,15142.48,0.14,0
51352,5159,-1000.00,26000.00,27000.00,0.00,26157.43,0.16,0
51353,5159,-1000.00,25000.00,26000.00,14100.11,12899.89,0.15,0
51354,5159,-1000.00,24000.00,25000.00,109.26,25890.74,0.29,0
51355,5159,-1000.00,23000.00,24000.00,0.00,12700.70,0.32,0
51356,5159,-1000.00,22000.00,23000.00,6777.75,17222.25,0.34,0
51357,5159,-1000.00,21000.00,22000.00,8851.75,14148.25,0.33,0
51358,5159,-1000.00,20000.00,21000.00,0.00,22000.00,0.12,0
51359,5159,-1000.00,19000.00,20000.00,5165.47,15113.31,0.37,0
51360,5159,-1000.00,18000.00,19000.00,0.00,20000.00,0.15,0
51361,5159,-1000.00,17000.00,18000.00,10545.68,8454.32,0.17,0
51362,5159,-1000.00,16000.00,17000.00,0.00,11519.46,0.29,0
51363,5159,-1000.00,15000.00,16000.00,0.00,14024.71,0.36,0
51364,5159,-1000.00,14000.00,15000.00,0.00,16000.00,0.36,0
51365,5160,-245.99,-245.99,754.01,0.00,245.99,0.14,0
51366,5160,1000.00,754.01,1754.01,443.41,310.60,0.09,1
51367,5160,-1000.00,-245.99,754.01,0.00,1545.00,0.13,0
51368,5160,1000.00,754.01,1754.01,437.01,317.00,0.23,1
51369,5160,-1000.00,-245.99,754.01,551.55,1046.65,0.31,0
51370,5160,0.00,-245.99,754.01,0.00,0.00,0.11,0
51371,5160,-754.01,-1000.00,0.00,0.00,754.01,0.16,0
51372,5161,-973.34,-973.34,26.66,0.00,973.34,0.41,0
51373,5161,-26.66,-1000.00,0.00,12.77,13.89,0.18,0
51374,5162,-1000.00,-1000.00,0.00,0.00,1000.00,0.36,0
51375,5163,1000.00,1000.00,2000.00,49.50,874.11,0.43,1
51376,5163,1000.00,2000.00,3000.00,561.37,1438.63,0.08,1
51377,5163,1000.00,3000.00,4000.00,0.00,1640.51,0.33,1
51378,5163,1000.00,4000.00,5000.00,0.00,8.46,0.10,1
51379,5163,-1000.00,3000.00,4000.00,2025.19,584.80,0.12,0
51380,5163,1000.00,4000.00,5000.00,0.00,645.52,0.04,1
51381,5163,1000.00,5000.00,6000.00,1263.45,3736.55,0.38,1
51382,5163,1000.00,6000.00,7000.00,0.00,5325.69,0.43,1
51383,5163,1000.00,7000.00,8000.00,0.00,7000.00,0.41,1
51384,5163,1000.00,8000.00,9000.00,0.00,6964.69,0.40,1
51385,5163,1000.00,9000.00,10000.00,0.00,9000.00,0.18,1
51386,5163,-1000.00,8000.00,9000.00,5864.26,2439.09,0.12,0
51387,5163,-1000.00,7000.00,8000.00,6340.83,81.79,0.06,0
51388,5163,-1000.00,6000.00,7000.00,1978.57,1683.22,0.17,0
51389,5163,1000.00,7000.00,8000.00,2799.76,4200.24,0.23,1
51390,5163,1000.00,8000.00,9000.00,0.00,5735.45,0.37,1
51391,5163,1000.00,9000.00,10000.00,0.00,9000.00,0.04,1
51392,5163,1000.00,10000.00,11000.00,0.00,1083.42,0.08,1
51393,5163,-1000.00,9000.00,10000.00,8170.13,2829.87,0.03,0
51394,5163,1000.00,10000.00,11000.00,0.00,5829.54,0.35,1
51395,5163,1000.00,11000.00,12000.00,2539.24,8460.76,0.38,1
51396,5163,1000.00,12000.00,13000.00,0.00,9182.82,0.30,1
51397,5163,1000.00,13000.00,14000.00,0.00,9989.99,0.31,1
51398,5163,1000.00,14000.00,15000.00,0.00,3479.88,0.10,1
51399,5163,-1000.00,13000.00,14000.00,0.00,8925.40,0.17,0
51400,5163,-1000.00,12000.00,13000.00,0.00,14000.00,0.34,0
51401,5163,-1000.00,11000.00,12000.00,0.00,1417.89,0.15,0
51402,5163,-1000.00,10000.00,11000.00,3851.60,8148.40,0.30,0
51403,5163,-1000.00,9000.00,10000.00,4784.43,6215.57,0.09,0
51404,5163,-1000.00,8000.00,9000.00,0.00,6514.81,0.31,0
51405,5163,-1000.00,7000.00,8000.00,0.00,7851.49,0.33,0
51406,5163,-1000.00,6000.00,7000.00,3716.14,202.75,0.09,0
51407,5163,-1000.00,5000.00,6000.00,645.23,6354.77,0.36,0
51408,5163,-1000.00,4000.00,5000.00,563.49,5436.51,0.24,0
51409,5163,-1000.00,3000.00,4000.00,3931.01,1068.99,0.02,0
51410,5163,-1000.00,2000.00,3000.00,1016.10,2983.90,0.37,0
51411,5163,-1000.00,1000.00,2000.00,1400.30,1599.70,0.06,0
51412,5163,-1000.00,0.00,1000.00,2000.00,0.00,0.01,0
51413,5163,-1000.00,-1000.00,0.00,153.81,0.00,0.11,0
51414,5164,0.00,0.00,1000.00,0.00,0.00,0.44,0
51415,5164,0.00,0.00,1000.00,0.00,0.00,0.35,0
51416,5164,-1000.00,-1000.00,0.00,0.00,1000.00,0.03,0
51417,5165,-1000.00,-1000.00,0.00,272.34,727.66,0.35,0
51418,5166,-755.91,-755.91,244.09,0.00,755.91,0.39,0
51419,5166,-244.09,-1000.00,0.00,69.67,174.42,0.04,0
51420,5167,1000.00,1000.00,2000.00,122.23,0.00,0.35,1
51421,5167,1000.00,2000.00,3000.00,314.09,0.00,0.28,1
51422,5167,1000.00,3000.00,4000.00,2162.26,837.74,0.03,1
51423,5167,-1000.00,2000.00,3000.00,1075.43,2924.57,0.37,0
51424,5167,-1000.00,1000.00,2000.00,1500.00,1500.00,0.02,0
51425,5167,-1000.00,0.00,1000.00,331.75,1668.25,0.42,0
51426,5167,-832.60,-832.60,167.40,146.02,686.58,0.39,0
51427,5167,-167.40,-1000.00,0.00,41.53,125.88,0.39,0
51428,5168,1000.00,1000.00,2000.00,106.35,499.74,0.31,1
51429,5168,1000.00,2000.00,3000.00,0.00,2000.00,0.42,1
51430,5168,1000.00,3000.00,4000.00,0.00,2232.07,0.39,1
51431,5168,1000.00,4000.00,5000.00,0.00,2786.15,0.25,1
51432,5168,1000.00,5000.00,6000.00,564.24,923.76,0.17,1
51433,5168,1000.00,6000.00,7000.00,2172.36,3827.64,0.11,1
51434,5168,1000.00,7000.00,8000.00,0.00,7000.00,0.12,1
51435,5168,1000.00,8000.00,9000.00,342.50,5385.77,0.38,1
51436,5168,1000.00,9000.00,10000.00,0.00,9000.00,0.24,1
51437,5168,1000.00,10000.00,11000.00,2488.57,5489.71,0.31,1
51438,5168,1000.00,11000.00,12000.00,0.00,8657.12,0.42,1
51439,5168,1000.00,12000.00,13000.00,0.00,9333.52,0.39,1
51440,5168,1000.00,13000.00,14000.00,0.00,13000.00,0.27,1
51441,5168,1000.00,14000.00,15000.00,5941.71,8058.29,0.11,1
51442,5168,1000.00,15000.00,16000.00,0.00,7793.15,0.27,1
51443,5168,1000.00,16000.00,17000.00,0.00,2112.18,0.06,1
51444,5168,1000.00,17000.00,18000.00,0.00,17000.00,0.10,1
51445,5168,1000.00,18000.00,19000.00,0.00,9799.92,0.30,1
51446,5168,1000.00,19000.00,20000.00,0.00,19000.00,0.32,1
51447,5168,-1000.00,18000.00,19000.00,5362.88,0.00,0.09,0
51448,5168,1000.00,19000.00,20000.00,0.00,19000.00,0.30,1
51449,5168,0.00,19000.00,20000.00,0.00,0.00,0.10,0
51450,5168,-1000.00,18000.00,19000.00,10000.00,10000.00,0.16,0
51451,5168,-1000.00,17000.00,18000.00,0.00,19000.00,0.03,0
51452,5168,-1000.00,16000.00,17000.00,0.00,12585.23,0.30,0
51453,5168,-1000.00,15000.00,16000.00,9248.42,3978.61,0.13,0
51454,5168,-1000.00,14000.00,15000.00,0.00,3986.06,0.04,0
51455,5168,0.00,14000.00,15000.00,0.00,0.00,0.08,0
51456,5168,-1000.00,13000.00,14000.00,7500.00,7500.00,0.03,0
51457,5168,0.00,13000.00,14000.00,0.00,0.00,0.01,0
51458,5168,-1000.00,12000.00,13000.00,5347.18,3276.38,0.16,0
51459,5168,0.00,12000.00,13000.00,0.00,0.00,0.04,0
51460,5168,-1000.00,11000.00,12000.00,3045.21,9954.79,0.21,0
51461,5168,-1000.00,10000.00,11000.00,6409.63,5590.37,0.03,0
51462,5168,-1000.00,9000.00,10000.00,6839.65,4160.35,0.07,0
51463,5168,-1000.00,8000.00,9000.00,580.27,8688.80,0.43,0
51464,5168,-1000.00,7000.00,8000.00,4686.32,1116.68,0.10,0
51465,5168,-1000.00,6000.00,7000.00,0.00,8000.00,0.19,0
51466,5168,-1000.00,5000.00,6000.00,0.00,7000.00,0.17,0
51467,5168,-1000.00,4000.00,5000.00,1665.18,4334.82,0.36,0
51468,5168,-1000.00,3000.00,4000.00,4369.53,30.33,0.04,0
51469,5168,-1000.00,2000.00,3000.00,1545.27,2454.73,0.26,0
51470,5168,-447.13,1552.87,2552.87,0.00,447.13,0.11,0
51471,5168,-1000.00,552.87,1552.87,0.00,2552.87,0.19,0
51472,5168,-1000.00,-447.13,552.87,0.00,1552.87,0.25,0
51473,5168,-552.87,-1000.00,0.00,0.00,552.87,0.35,0
51474,5169,1000.00,1000.00,2000.00,0.00,518.32,0.05,1
51475,5169,1000.00,2000.00,3000.00,0.00,1775.40,0.02,1
51476,5169,1000.00,3000.00,4000.00,0.00,2526.40,0.42,1
51477,5169,-1000.00,2000.00,3000.00,2876.06,0.00,0.04,0
51478,5169,1000.00,3000.00,4000.00,0.00,332.00,0.12,1
51479,5169,1000.00,4000.00,5000.00,880.51,3119.49,0.21,1
51480,5169,1000.00,5000.00,6000.00,0.00,4991.75,0.43,1
51481,5169,1000.00,6000.00,7000.00,0.00,6000.00,0.37,1
51482,5169,1000.00,7000.00,8000.00,0.00,7000.00,0.07,1
51483,5169,1000.00,8000.00,9000.00,3480.68,4097.14,0.24,1
51484,5169,-1000.00,7000.00,8000.00,5272.46,3727.54,0.04,0
51485,5169,1000.00,8000.00,9000.00,0.00,8000.00,0.23,1
51486,5169,1000.00,9000.00,10000.00,0.00,9000.00,0.42,1
51487,5169,1000.00,10000.00,11000.00,0.00,3658.05,0.19,1
51488,5169,1000.00,11000.00,12000.00,0.00,11000.00,0.15,1
51489,5169,1000.00,12000.00,13000.00,0.00,7491.28,0.24,1
51490,5169,1000.00,13000.00,14000.00,35.91,10657.01,0.42,1
51491,5169,1000.00,14000.00,15000.00,0.00,14000.00,0.29,1
51492,5169,-1000.00,13000.00,14000.00,5282.19,0.00,0.01,0
51493,5169,1000.00,14000.00,15000.00,6264.65,7735.35,0.13,1
51494,5169,1000.00,15000.00,16000.00,3466.57,11533.43,0.37,1
51495,5169,1000.00,16000.00,17000.00,1635.32,12944.35,0.41,1
51496,5169,-1000.00,15000.00,16000.00,14106.15,2893.85,0.16,0
51497,5169,-1000.00,14000.00,15000.00,1374.30,14625.70,0.42,0
51498,5169,-1000.00,13000.00,14000.00,0.00,15000.00,0.15,0
51499,5169,-1000.00,12000.00,13000.00,0.00,10305.50,0.07,0
51500,5169,-1000.00,11000.00,12000.00,3028.81,9971.19,0.39,0
51501,5169,-1000.00,10000.00,11000.00,0.00,12000.00,0.01,0
51502,5169,-1000.00,9000.00,10000.00,0.00,9060.48,0.41,0
51503,5169,-1000.00,8000.00,9000.00,5000.00,5000.00,0.04,0
51504,5169,-1000.00,7000.00,8000.00,0.00,5923.98,0.11,0
51505,5169,-1000.00,6000.00,7000.00,1617.44,3157.21,0.25,0
51506,5169,-1000.00,5000.00,6000.00,2377.69,4622.31,0.17,0
51507,5169,-1000.00,4000.00,5000.00,4903.44,0.00,0.02,0
51508,5169,-1000.00,3000.00,4000.00,0.00,4289.16,0.20,0
51509,5169,-1000.00,2000.00,3000.00,0.00,4000.00,0.04,0
51510,5169,-1000.00,1000.00,2000.00,3000.00,0.00,0.01,0
51511,5169,-1000.00,0.00,1000.00,0.00,1564.22,0.30,0
51512,5169,-683.42,-683.42,316.58,0.00,683.42,0.28,0
51513,5169,-1000.00,-1683.42,-683.42,213.88,102.70,0.12,0
51514,5170,1000.00,1000.00,2000.00,281.74,718.26,0.04,1
51515,5170,-1000.00,0.00,1000.00,1146.40,853.60,0.05,0
51516,5170,1000.00,1000.00,2000.00,119.85,573.24,0.34,1
51517,5170,1000.00,2000.00,3000.00,216.28,1783.72,0.31,1
51518,5170,1000.00,3000.00,4000.00,0.00,2378.74,0.13,1
51519,5170,-1000.00,2000.00,3000.00,4000.00,0.00,0.02,0
51520,5170,1000.00,3000.00,4000.00,1480.47,1519.53,0.22,1
51521,5170,1000.00,4000.00,5000.00,0.00,4000.00,0.27,1
51522,5170,1000.00,5000.00,6000.00,0.00,2697.48,0.33,1
51523,5170,1000.00,6000.00,7000.00,2656.37,3343.63,0.06,1
51524,5170,1000.00,7000.00,8000.00,3500.00,3500.00,0.09,1
51525,5170,1000.00,8000.00,9000.00,3349.51,4650.49,0.21,1
51526,5170,1000.00,9000.00,10000.00,0.00,9000.00,0.34,1
51527,5170,-1000.00,8000.00,9000.00,5287.20,4712.80,0.13,0
51528,5170,1000.00,9000.00,10000.00,0.00,7985.58,0.42,1
51529,5170,1000.00,10000.00,11000.00,0.00,767.29,0.13,1
51530,5170,1000.00,11000.00,12000.00,2271.82,8728.18,0.11,1
51531,5170,1000.00,12000.00,13000.00,63.49,11936.51,0.09,1
51532,5170,1000.00,13000.00,14000.00,0.00,13000.00,0.09,1
51533,5170,1000.00,14000.00,15000.00,0.00,3525.98,0.05,1
51534,5170,-1000.00,13000.00,14000.00,8884.88,0.00,0.00,0
51535,5170,1000.00,14000.00,15000.00,0.00,9883.40,0.09,1
51536,5170,-1000.00,13000.00,14000.00,7835.75,7164.25,0.01,0
51537,5170,1000.00,14000.00,15000.00,5682.31,8317.69,0.23,1
51538,5170,0.00,14000.00,15000.00,0.00,0.00,0.05,0
51539,5170,1000.00,15000.00,16000.00,0.00,15000.00,0.24,1
51540,5170,1000.00,16000.00,17000.00,7046.76,8953.24,0.19,1
51541,5170,-1000.00,15000.00,16000.00,5707.17,4282.44,0.17,0
51542,5170,-1000.00,14000.00,15000.00,8749.31,7250.69,0.15,0
51543,5170,1000.00,15000.00,16000.00,5737.74,9262.26,0.22,1
51544,5170,1000.00,16000.00,17000.00,0.00,16000.00,0.14,1
51545,5170,1000.00,17000.00,18000.00,8500.00,8500.00,0.14,1
51546,5170,-1000.00,16000.00,17000.00,10180.14,7819.86,0.02,0
51547,5170,1000.00,17000.00,18000.00,0.00,117.46,0.07,1
51548,5170,1000.00,18000.00,19000.00,0.00,18000.00,0.21,1
51549,5170,1000.00,19000.00,20000.00,0.00,10766.06,0.07,1
51550,5170,1000.00,20000.00,21000.00,4804.92,15195.08,0.39,1
51551,5170,1000.00,21000.00,22000.00,938.93,17918.77,0.43,1
51552,5170,1000.00,22000.00,23000.00,6182.34,15817.66,0.37,1
51553,5170,1000.00,23000.00,24000.00,0.00,19554.34,0.30,1
51554,5170,1000.00,24000.00,25000.00,0.00,24000.00,0.15,1
51555,5171,-559.10,-559.10,440.90,290.95,268.15,0.36,0
51556,5171,-1000.00,-1559.10,-559.10,208.39,219.98,0.23,0
51557,5172,-1000.00,-1000.00,0.00,117.20,882.80,0.42,0
51558,5173,-473.02,-473.02,526.98,0.00,473.02,0.35,0
51559,5173,-526.98,-1000.00,0.00,71.01,455.97,0.11,0
51560,5174,-1000.00,-1000.00,0.00,276.28,723.72,0.28,0
51561,5175,0.00,0.00,1000.00,0.00,0.00,0.28,0
51562,5175,-1000.00,-1000.00,0.00,0.00,1000.00,0.08,0
51563,5176,-1000.00,-1000.00,0.00,0.00,163.75,0.08,0
51564,5177,1000.00,1000.00,2000.00,456.42,543.58,0.05,1
51565,5177,1000.00,2000.00,3000.00,393.86,1606.14,0.23,1
51566,5177,1000.00,3000.00,4000.00,0.00,1499.17,0.19,1
51567,5177,1000.00,4000.00,5000.00,0.00,4000.00,0.14,1
51568,5177,1000.00,5000.00,6000.00,0.00,5000.00,0.11,1
51569,5177,1000.00,6000.00,7000.00,1578.71,4421.29,0.26,1
51570,5177,1000.00,7000.00,8000.00,1258.31,5741.69,0.37,1
51571,5177,1000.00,8000.00,9000.00,0.00,8000.00,0.15,1
51572,5177,1000.00,9000.00,10000.00,3027.06,5972.94,0.19,1
51573,5177,1000.00,10000.00,11000.00,0.00,9908.60,0.24,1
51574,5177,1000.00,11000.00,12000.00,0.00,11000.00,0.17,1
51575,5177,1000.00,12000.00,13000.00,0.00,12000.00,0.22,1
51576,5177,1000.00,13000.00,14000.00,0.00,8915.04,0.34,1
51577,5177,1000.00,14000.00,15000.00,3355.80,10644.20,0.38,1
51578,5177,1000.00,15000.00,16000.00,2841.90,12158.10,0.39,1
51579,5177,1000.00,16000.00,17000.00,0.00,16000.00,0.31,1
51580,5177,1000.00,17000.00,18000.00,0.00,13154.96,0.11,1
51581,5177,1000.00,18000.00,19000.00,5904.31,12095.69,0.31,1
51582,5177,-1000.00,17000.00,18000.00,0.00,19000.00,0.36,0
51583,5177,-1000.00,16000.00,17000.00,4187.64,13812.36,0.22,0
51584,5177,-1000.00,15000.00,16000.00,0.00,11711.49,0.38,0
51585,5177,-1000.00,14000.00,15000.00,8000.00,8000.00,0.09,0
51586,5177,-1000.00,13000.00,14000.00,0.00,15000.00,0.04,0
51587,5177,1000.00,14000.00,15000.00,0.00,14000.00,0.41,1
51588,5177,1000.00,15000.00,16000.00,0.00,9625.94,0.08,1
51589,5177,1000.00,16000.00,17000.00,0.00,16000.00,0.17,1
51590,5177,1000.00,17000.00,18000.00,894.98,14614.63,0.43,1
51591,5177,1000.00,18000.00,19000.00,3257.10,3415.83,0.17,1
51592,5177,1000.00,19000.00,20000.00,0.00,9708.57,0.07,1
51593,5177,1000.00,20000.00,21000.00,6090.68,13909.32,0.18,1
51594,5177,1000.00,21000.00,22000.00,0.00,21000.00,0.04,1
51595,5177,1000.00,22000.00,23000.00,2516.86,19483.14,0.39,1
51596,5177,1000.00,23000.00,24000.00,5578.12,17421.88,0.36,1
51597,5177,1000.00,24000.00,25000.00,0.00,18358.37,0.39,1
51598,5177,-1000.00,23000.00,24000.00,11247.04,10822.50,0.21,0
51599,5177,1000.00,24000.00,25000.00,0.00,24000.00,0.16,1
51600,5177,1000.00,25000.00,26000.00,0.00,11650.04,0.13,1
51601,5177,1000.00,26000.00,27000.00,0.00,26000.00,0.37,1
51602,5177,0.00,26000.00,27000.00,0.00,0.00,0.06,0
51603,5177,1000.00,27000.00,28000.00,1634.00,25366.00,0.33,1
51604,5177,1000.00,28000.00,29000.00,0.00,138.93,0.11,1
51605,5177,1000.00,29000.00,30000.00,14500.00,14500.00,0.04,1
51606,5177,-1000.00,28000.00,29000.00,15396.74,14603.26,0.11,0
51607,5177,1000.00,29000.00,30000.00,340.13,28659.87,0.32,1
51608,5177,1000.00,30000.00,31000.00,7819.11,22180.89,0.37,1
51609,5177,-1000.00,29000.00,30000.00,16469.29,14530.71,0.19,0
51610,5177,1000.00,30000.00,31000.00,0.00,30000.00,0.39,1
51611,5178,0.00,0.00,1000.00,0.00,0.00,0.16,0
51612,5178,1000.00,1000.00,2000.00,0.00,1000.00,0.08,1
51613,5178,1000.00,2000.00,3000.00,0.00,2000.00,0.02,1
51614,5178,0.00,2000.00,3000.00,0.00,0.00,0.05,0
51615,5178,1000.00,3000.00,4000.00,1001.87,1998.13,0.30,1
51616,5178,1000.00,4000.00,5000.00,0.00,2363.38,0.06,1
51617,5178,1000.00,5000.00,6000.00,0.00,5000.00,0.14,1
51618,5178,1000.00,6000.00,7000.00,0.00,2758.88,0.29,1
51619,5178,1000.00,7000.00,8000.00,1232.16,5767.84,0.24,1
51620,5178,1000.00,8000.00,9000.00,1621.79,6378.21,0.31,1
51621,5178,-1000.00,7000.00,8000.00,6105.68,2894.32,0.11,0
51622,5178,1000.00,8000.00,9000.00,0.00,8000.00,0.23,1
51623,5178,-1000.00,7000.00,8000.00,6007.44,2992.56,0.08,0
51624,5178,1000.00,8000.00,9000.00,0.00,8000.00,0.42,1
51625,5178,1000.00,9000.00,10000.00,870.38,8129.62,0.08,1
51626,5178,1000.00,10000.00,11000.00,4248.47,5751.53,0.21,1
51627,5178,1000.00,11000.00,12000.00,0.00,5520.31,0.27,1
51628,5178,1000.00,12000.00,13000.00,0.00,12000.00,0.12,1
51629,5178,1000.00,13000.00,14000.00,0.00,13000.00,0.05,1
51630,5178,1000.00,14000.00,15000.00,0.00,9775.58,0.17,1
51631,5178,1000.00,15000.00,16000.00,0.00,3709.11,0.01,1
51632,5178,1000.00,16000.00,17000.00,0.00,13906.50,0.41,1
51633,5178,1000.00,17000.00,18000.00,6707.47,10292.53,0.22,1
51634,5178,1000.00,18000.00,19000.00,0.00,219.84,0.09,1
51635,5178,-1000.00,17000.00,18000.00,13777.58,5222.42,0.09,0
51636,5178,0.00,17000.00,18000.00,0.00,0.00,0.08,0
51637,5178,-1000.00,16000.00,17000.00,5902.73,8949.31,0.27,0
51638,5178,-1000.00,15000.00,16000.00,9056.36,7645.40,0.20,0
51639,5178,-1000.00,14000.00,15000.00,0.00,5300.23,0.20,0
51640,5178,-1000.00,13000.00,14000.00,0.00,15000.00,0.20,0
51641,5178,-1000.00,12000.00,13000.00,0.00,9160.28,0.26,0
51642,5178,-1000.00,11000.00,12000.00,6421.31,6578.69,0.11,0
51643,5178,-1000.00,10000.00,11000.00,3374.15,3555.92,0.20,0
51644,5178,-1000.00,9000.00,10000.00,44.34,3853.44,0.25,0
51645,5178,-1000.00,8000.00,9000.00,0.00,10000.00,0.05,0
51646,5178,-1000.00,7000.00,8000.00,0.00,9000.00,0.26,0
51647,5178,-1000.00,6000.00,7000.00,3037.47,4962.53,0.10,0
51648,5178,-1000.00,5000.00,6000.00,0.00,5518.46,0.09,0
51649,5178,-442.28,4557.72,5557.72,0.00,442.28,0.43,0
51650,5178,-1000.00,3557.72,4557.72,0.00,3094.85,0.17,0
51651,5178,-1000.00,2557.72,3557.72,0.00,2731.37,0.21,0
51652,5178,1000.00,3557.72,4557.72,23.47,0.00,0.35,1
51653,5178,0.00,3557.72,4557.72,0.00,0.00,0.26,0
51654,5179,-1000.00,-1000.00,0.00,344.91,655.09,0.33,0
51655,5180,-1000.00,-1000.00,0.00,0.00,1000.00,0.40,0
51656,5181,0.00,0.00,1000.00,0.00,0.00,0.24,0
51657,5181,1000.00,1000.00,2000.00,363.02,0.00,0.18,1
51658,5181,-1000.00,0.00,1000.00,651.82,933.63,0.28,0
51659,5181,0.00,0.00,1000.00,0.00,0.00,0.07,0
51660,5181,-1000.00,-1000.00,0.00,50.83,949.17,0.19,0
51661,5182,1000.00,1000.00,2000.00,299.92,700.08,0.33,1
51662,5182,1000.00,2000.00,3000.00,911.84,1088.16,0.23,1
51663,5182,1000.00,3000.00,4000.00,1468.71,1531.29,0.08,1
51664,5182,1000.00,4000.00,5000.00,0.00,4000.00,0.08,1
51665,5182,1000.00,5000.00,6000.00,0.00,5000.00,0.23,1
51666,5182,1000.00,6000.00,7000.00,389.36,5238.49,0.43,1
51667,5182,1000.00,7000.00,8000.00,64.94,5997.08,0.43,1
51668,5182,-1000.00,6000.00,7000.00,2219.60,0.00,0.03,0
51669,5182,1000.00,7000.00,8000.00,0.00,5973.64,0.29,1
51670,5182,1000.00,8000.00,9000.00,2699.89,5300.11,0.02,1
51671,5182,1000.00,9000.00,10000.00,3814.71,5185.29,0.27,1
51672,5182,0.00,9000.00,10000.00,0.00,0.00,0.04,0
51673,5182,1000.00,10000.00,11000.00,0.00,10000.00,0.08,1
51674,5182,-1000.00,9000.00,10000.00,7212.88,3669.88,0.13,0
51675,5182,1000.00,10000.00,11000.00,0.00,10000.00,0.43,1
51676,5182,1000.00,11000.00,12000.00,0.00,11000.00,0.14,1
51677,5182,1000.00,12000.00,13000.00,0.00,4367.41,0.22,1
51678,5182,1000.00,13000.00,14000.00,0.00,6628.12,0.26,1
51679,5182,1000.00,14000.00,15000.00,0.00,14000.00,0.15,1
51680,5182,1000.00,15000.00,16000.00,0.00,15000.00,0.30,1
51681,5182,1000.00,16000.00,17000.00,0.00,16000.00,0.12,1
51682,5182,1000.00,17000.00,18000.00,7793.46,9206.54,0.19,1
51683,5182,1000.00,18000.00,19000.00,0.00,8358.87,0.21,1
51684,5182,-1000.00,17000.00,18000.00,3658.04,0.00,0.06,0
51685,5182,1000.00,18000.00,19000.00,0.00,18000.00,0.24,1
51686,5182,1000.00,19000.00,20000.00,4289.16,14710.84,0.40,1
51687,5182,1000.00,20000.00,21000.00,0.00,8958.38,0.17,1
51688,5182,1000.00,21000.00,22000.00,0.00,15393.57,0.39,1
51689,5182,1000.00,22000.00,23000.00,0.00,16790.76,0.26,1
51690,5182,1000.00,23000.00,24000.00,6400.45,16599.55,0.05,1
51691,5182,1000.00,24000.00,25000.00,0.00,24000.00,0.27,1
51692,5182,1000.00,25000.00,26000.00,5111.93,19888.07,0.29,1
51693,5182,1000.00,26000.00,27000.00,0.00,26000.00,0.05,1
51694,5182,1000.00,27000.00,28000.00,0.00,27000.00,0.32,1
51695,5182,1000.00,28000.00,29000.00,6085.05,16795.62,0.33,1
51696,5182,-1000.00,27000.00,28000.00,15810.90,11189.07,0.17,0
51697,5182,1000.00,28000.00,29000.00,776.49,9923.52,0.25,1
51698,5182,1000.00,29000.00,30000.00,13402.76,15597.24,0.41,1
51699,5182,1000.00,30000.00,31000.00,14128.75,15871.25,0.05,1
51700,5182,1000.00,31000.00,32000.00,11095.02,19904.98,0.29,1
51701,5182,1000.00,32000.00,33000.00,13682.85,18317.15,0.26,1
51702,5183,-1000.00,-1000.00,0.00,261.29,738.71,0.28,0
51703,5184,-1000.00,-1000.00,0.00,556.44,443.56,0.10,0
51704,5185,-197.79,-197.79,802.21,197.79,0.00,0.06,0
51705,5185,-1000.00,-1197.79,-197.79,381.76,420.45,0.16,0
51706,5186,-874.34,-874.34,125.66,0.00,874.34,0.21,0
51707,5186,-125.66,-1000.00,0.00,11.90,113.76,0.18,0
51708,5187,-1000.00,-1000.00,0.00,352.36,647.64,0.21,0
51709,5188,-1000.00,-1000.00,0.00,6.58,663.70,0.38,0
51710,5189,-176.95,-176.95,823.05,176.95,0.00,0.22,0
51711,5189,0.00,-176.95,823.05,0.00,0.00,0.18,0
51712,5189,-823.05,-1000.00,0.00,723.69,99.36,0.07,0
51713,5190,-262.69,-262.69,737.31,0.00,262.69,0.21,0
51714,5190,-372.16,-634.84,365.16,0.00,372.16,0.22,0
51715,5190,-251.22,-886.07,113.93,0.00,251.22,0.28,0
51716,5190,-97.04,-983.11,16.89,43.75,53.29,0.24,0
51717,5190,-6.16,-989.27,10.73,0.00,6.16,0.23,0
51718,5190,-10.73,-1000.00,-0.00,2.32,8.41,0.39,0
51719,5191,1000.00,1000.00,2000.00,192.09,791.28,0.40,1
51720,5191,-1000.00,0.00,1000.00,577.35,1422.65,0.35,0
51721,5191,-1000.00,-1000.00,0.00,0.00,1000.00,0.03,0
51722,5192,-1000.00,-1000.00,0.00,430.41,569.59,0.22,0
51723,5193,-1000.00,-1000.00,0.00,170.55,829.45,0.09,0
51724,5194,0.00,0.00,1000.00,0.00,0.00,0.07,0
51725,5194,-1000.00,-1000.00,0.00,0.00,1000.00,0.32,0
51726,5195,-1000.00,-1000.00,0.00,175.17,824.83,0.10,0
51727,5196,1000.00,1000.00,2000.00,403.09,596.91,0.27,1
51728,5196,1000.00,2000.00,3000.00,977.15,1022.85,0.11,1
51729,5196,1000.00,3000.00,4000.00,641.08,2358.92,0.40,1
51730,5196,1000.00,4000.00,5000.00,1501.23,2498.77,0.25,1
51731,5196,1000.00,5000.00,6000.00,0.00,5000.00,0.07,1
51732,5196,0.00,5000.00,6000.00,0.00,0.00,0.01,0
51733,5196,1000.00,6000.00,7000.00,2971.30,3028.70,0.12,1
51734,5196,1000.00,7000.00,8000.00,589.90,6410.10,0.44,1
51735,5196,1000.00,8000.00,9000.00,2575.14,5424.86,0.02,1
51736,5196,-1000.00,7000.00,8000.00,6811.98,2188.02,0.06,0
51737,5196,1000.00,8000.00,9000.00,2248.94,5751.06,0.29,1
51738,5196,1000.00,9000.00,10000.00,0.00,5472.90,0.29,1
51739,5196,0.00,9000.00,10000.00,0.00,0.00,0.07,0
51740,5196,1000.00,10000.00,11000.00,0.00,9364.15,0.43,1
51741,5196,1000.00,11000.00,12000.00,0.00,5265.83,0.30,1
51742,5196,-1000.00,10000.00,11000.00,2794.62,4972.99,0.12,0
51743,5196,-1000.00,9000.00,10000.00,0.00,6945.44,0.35,0
51744,5196,-1000.00,8000.00,9000.00,3333.05,6666.95,0.27,0
51745,5196,-1000.00,7000.00,8000.00,3624.42,5375.58,0.23,0
51746,5196,-1000.00,6000.00,7000.00,3609.12,4390.88,0.14,0
51747,5196,-1000.00,5000.00,6000.00,1809.09,5190.91,0.29,0
51748,5196,-1000.00,4000.00,5000.00,2174.10,3825.90,0.31,0
51749,5196,-1000.00,3000.00,4000.00,0.00,5000.00,0.29,0
51750,5196,-1000.00,2000.00,3000.00,711.61,2362.57,0.34,0
51751,5196,-1000.00,1000.00,2000.00,0.00,3000.00,0.16,0
51752,5196,-1000.00,0.00,1000.00,0.00,1358.63,0.38,0
51753,5196,1000.00,1000.00,2000.00,252.20,150.21,0.15,1
51754,5196,-1000.00,0.00,1000.00,0.00,2000.00,0.20,0
51755,5196,-1000.00,-1000.00,0.00,0.00,1000.00,0.32,0
51756,5197,-1000.00,-1000.00,0.00,0.00,956.89,0.40,0
51757,5198,-1000.00,-1000.00,0.00,1000.00,0.00,0.01,0
51758,5199,-690.62,-690.62,309.38,690.62,0.00,0.19,0
51759,5199,-1000.00,-1690.62,-690.62,0.00,94.58,0.08,0
51760,5200,-787.55,-787.55,212.45,787.55,0.00,0.14,0
51761,5200,-193.00,-980.55,19.45,123.37,69.62,0.24,0
51762,5200,-1000.00,-1980.55,-980.55,0.00,7.99,0.38,0
51763,5201,1000.00,1000.00,2000.00,0.00,519.33,0.32,1
51764,5201,-1000.00,0.00,1000.00,1410.84,0.00,0.04,0
51765,5201,1000.00,1000.00,2000.00,0.00,618.42,0.36,1
51766,5201,1000.00,2000.00,3000.00,0.00,1033.68,0.30,1
51767,5201,1000.00,3000.00,4000.00,405.97,2594.03,0.24,1
51768,5201,0.00,3000.00,4000.00,0.00,0.00,0.02,0
51769,5201,1000.00,4000.00,5000.00,70.57,3929.43,0.38,1
51770,5201,1000.00,5000.00,6000.00,0.00,2767.64,0.16,1
51771,5201,1000.00,6000.00,7000.00,261.48,5738.52,0.28,1
51772,5201,1000.00,7000.00,8000.00,2045.57,4954.43,0.11,1
51773,5201,1000.00,8000.00,9000.00,966.71,7033.29,0.28,1
51774,5201,1000.00,9000.00,10000.00,0.00,9000.00,0.35,1
51775,5201,1000.00,10000.00,11000.00,4990.07,5009.93,0.44,1
51776,5201,1000.00,11000.00,12000.00,0.00,11000.00,0.21,1
51777,5201,1000.00,12000.00,13000.00,2146.59,9853.41,0.32,1
51778,5201,1000.00,13000.00,14000.00,2234.67,10765.33,0.41,1
51779,5201,1000.00,14000.00,15000.00,6918.63,7081.37,0.18,1
51780,5201,1000.00,15000.00,16000.00,0.00,15000.00,0.36,1
51781,5201,1000.00,16000.00,17000.00,0.00,15905.41,0.19,1
51782,5201,1000.00,17000.00,18000.00,0.00,17000.00,0.03,1
51783,5201,-1000.00,16000.00,17000.00,892.41,17107.59,0.24,0
51784,5201,-1000.00,15000.00,16000.00,0.00,9449.55,0.33,0
51785,5201,-1000.00,14000.00,15000.00,8265.78,7734.22,0.21,0
51786,5201,-1000.00,13000.00,14000.00,0.00,11279.80,0.03,0
51787,5201,-1000.00,12000.00,13000.00,7102.16,6897.84,0.13,0
51788,5201,-1000.00,11000.00,12000.00,4903.15,8096.85,0.29,0
51789,5201,-1000.00,10000.00,11000.00,5320.30,4801.48,0.20,0
51790,5201,-1000.00,9000.00,10000.00,5786.97,5213.03,0.19,0
51791,5201,-1000.00,8000.00,9000.00,2790.28,2631.09,0.19,0
51792,5201,-1000.00,7000.00,8000.00,2943.63,1092.95,0.13,0
51793,5201,-1000.00,6000.00,7000.00,0.00,8000.00,0.06,0
51794,5201,-1000.00,5000.00,6000.00,0.00,2912.65,0.22,0
51795,5201,-1000.00,4000.00,5000.00,0.00,6000.00,0.31,0
51796,5201,-1000.00,3000.00,4000.00,0.00,4087.60,0.42,0
51797,5201,-1000.00,2000.00,3000.00,1506.95,2493.05,0.13,0
51798,5201,-1000.00,1000.00,2000.00,111.56,2229.48,0.40,0
51799,5201,-1000.00,0.00,1000.00,0.00,1054.80,0.08,0
51800,5201,-1000.00,-1000.00,0.00,337.33,662.67,0.00,0
51801,5202,-949.27,-949.27,50.73,0.00,949.27,0.44,0
51802,5202,-31.97,-981.23,18.77,0.00,31.97,0.36,0
51803,5202,-18.77,-1000.00,0.00,3.13,15.63,0.07,0
51804,5203,1000.00,1000.00,2000.00,98.09,901.91,0.04,1
51805,5203,1000.00,2000.00,3000.00,0.00,2000.00,0.27,1
51806,5203,1000.00,3000.00,4000.00,994.60,2005.40,0.03,1
51807,5203,1000.00,4000.00,5000.00,0.00,2832.06,0.24,1
51808,5203,-1000.00,3000.00,4000.00,4583.16,416.84,0.03,0
51809,5203,1000.00,4000.00,5000.00,0.00,4000.00,0.24,1
51810,5203,0.00,4000.00,5000.00,0.00,0.00,0.11,0
51811,5203,1000.00,5000.00,6000.00,0.00,1245.20,0.08,1
51812,5203,-1000.00,4000.00,5000.00,2867.82,1923.79,0.17,0
51813,5203,1000.00,5000.00,6000.00,0.00,2628.58,0.25,1
51814,5203,1000.00,6000.00,7000.00,0.00,1445.19,0.18,1
51815,5203,1000.00,7000.00,8000.00,2986.27,4013.73,0.26,1
51816,5203,0.00,7000.00,8000.00,0.00,0.00,0.06,0
51817,5203,1000.00,8000.00,9000.00,0.00,8000.00,0.43,1
51818,5203,1000.00,9000.00,10000.00,0.00,9000.00,0.06,1
51819,5203,1000.00,10000.00,11000.00,0.00,10000.00,0.31,1
51820,5203,1000.00,11000.00,12000.00,4952.50,6047.50,0.17,1
51821,5203,1000.00,12000.00,13000.00,2356.55,9643.45,0.41,1
51822,5203,1000.00,13000.00,14000.00,5065.58,7934.42,0.22,1
51823,5203,-1000.00,12000.00,13000.00,13315.46,684.54,0.13,0
51824,5203,1000.00,13000.00,14000.00,0.00,7975.44,0.27,1
51825,5203,-1000.00,12000.00,13000.00,11569.04,0.00,0.03,0
51826,5203,1000.00,13000.00,14000.00,0.00,10049.06,0.35,1
51827,5203,0.00,13000.00,14000.00,0.00,0.00,0.05,0
51828,5203,1000.00,14000.00,15000.00,0.00,14000.00,0.32,1
51829,5203,1000.00,15000.00,16000.00,0.00,15000.00,0.38,1
51830,5203,1000.00,16000.00,17000.00,7969.76,8030.24,0.03,1
51831,5203,1000.00,17000.00,18000.00,0.00,16473.91,0.36,1
51832,5203,1000.00,18000.00,19000.00,0.00,8497.74,0.13,1
51833,5203,1000.00,19000.00,20000.00,9500.00,9500.00,0.06,1
51834,5203,1000.00,20000.00,21000.00,3316.82,10328.87,0.31,1
51835,5203,-1000.00,19000.00,20000.00,12164.44,8835.56,0.10,0
51836,5203,1000.00,20000.00,21000.00,0.00,20000.00,0.39,1
51837,5203,1000.00,21000.00,22000.00,0.00,21000.00,0.05,1
51838,5203,1000.00,22000.00,23000.00,0.00,22000.00,0.24,1
51839,5203,1000.00,23000.00,24000.00,0.00,23000.00,0.25,1
51840,5203,1000.00,24000.00,25000.00,507.58,8778.90,0.25,1
51841,5203,1000.00,25000.00,26000.00,10744.27,14255.73,0.21,1
51842,5204,1000.00,1000.00,2000.00,872.40,127.60,0.05,1
51843,5204,-41.41,958.59,1958.59,0.00,41.41,0.42,0
51844,5204,-935.32,23.27,1023.27,0.00,935.32,0.17,0
51845,5204,-1000.00,-976.73,23.27,416.91,606.36,0.12,0
51846,5204,-23.27,-1000.00,0.00,1.82,21.45,0.41,0
51847,5205,1000.00,1000.00,2000.00,0.00,716.13,0.32,1
51848,5205,1000.00,2000.00,3000.00,0.00,2000.00,0.29,1
51849,5205,1000.00,3000.00,4000.00,0.00,1054.19,0.25,1
51850,5205,1000.00,4000.00,5000.00,1383.59,2616.41,0.32,1
51851,5205,1000.00,5000.00,6000.00,0.00,4594.39,0.13,1
51852,5205,1000.00,6000.00,7000.00,1099.57,4900.43,0.08,1
51853,5205,1000.00,7000.00,8000.00,0.00,7000.00,0.08,1
51854,5205,1000.00,8000.00,9000.00,0.00,7822.90,0.40,1
51855,5205,1000.00,9000.00,10000.00,2562.08,6437.92,0.35,1
51856,5205,1000.00,10000.00,11000.00,0.00,10000.00,0.41,1
51857,5205,1000.00,11000.00,12000.00,0.00,10529.02,0.24,1
51858,5205,1000.00,12000.00,13000.00,2968.06,9031.94,0.09,1
51859,5205,0.00,12000.00,13000.00,0.00,0.00,0.06,0
51860,5205,1000.00,13000.00,14000.00,0.00,13000.00,0.29,1
51861,5205,1000.00,14000.00,15000.00,0.00,11960.19,0.30,1
51862,5205,1000.00,15000.00,16000.00,4255.98,10744.02,0.36,1
51863,5205,1000.00,16000.00,17000.00,0.00,16000.00,0.05,1
51864,5205,1000.00,17000.00,18000.00,0.00,17000.00,0.31,1
51865,5205,1000.00,18000.00,19000.00,0.00,18000.00,0.43,1
51866,5205,1000.00,19000.00,20000.00,0.00,19000.00,0.11,1
51867,5205,1000.00,20000.00,21000.00,0.00,20000.00,0.43,1
51868,5205,-1000.00,19000.00,20000.00,4238.48,0.00,0.02,0
51869,5205,-1000.00,18000.00,19000.00,9748.58,2979.28,0.12,0
51870,5205,-1000.00,17000.00,18000.00,1142.16,17857.84,0.40,0
51871,5205,-1000.00,16000.00,17000.00,0.00,16442.20,0.39,0
51872,5205,-1000.00,15000.00,16000.00,4915.34,8439.00,0.28,0
51873,5205,-1000.00,14000.00,15000.00,3190.07,12809.93,0.35,0
51874,5205,-1000.00,13000.00,14000.00,3850.96,11149.04,0.34,0
51875,5205,-1000.00,12000.00,13000.00,0.00,14000.00,0.25,0
51876,5205,-1000.00,11000.00,12000.00,1767.89,11232.11,0.12,0
51877,5205,-1000.00,10000.00,11000.00,6018.69,5981.31,0.16,0
51878,5205,-1000.00,9000.00,10000.00,27.73,0.00,0.06,0
51879,5205,-1000.00,8000.00,9000.00,0.00,9179.12,0.09,0
51880,5205,-1000.00,7000.00,8000.00,0.00,6633.90,0.40,0
51881,5205,-1000.00,6000.00,7000.00,0.00,8000.00,0.02,0
51882,5205,-1000.00,5000.00,6000.00,2845.70,4154.30,0.23,0
51883,5205,-1000.00,4000.00,5000.00,0.00,6000.00,0.14,0
51884,5205,1000.00,5000.00,6000.00,0.00,5000.00,0.09,1
51885,5205,1000.00,6000.00,7000.00,0.00,1831.64,0.23,1
51886,5205,1000.00,7000.00,8000.00,0.00,7000.00,0.33,1
51887,5205,-1000.00,6000.00,7000.00,1526.11,1359.68,0.16,0
51888,5205,1000.00,7000.00,8000.00,0.00,762.78,0.12,1
51889,5205,1000.00,8000.00,9000.00,0.00,2912.72,0.19,1
51890,5205,1000.00,9000.00,10000.00,394.23,8605.77,0.12,1
51891,5205,1000.00,10000.00,11000.00,5000.00,5000.00,0.04,1
51892,5205,1000.00,11000.00,12000.00,0.00,11000.00,0.14,1
51893,5205,1000.00,12000.00,13000.00,3755.93,8244.07,0.28,1
51894,5205,1000.00,13000.00,14000.00,0.00,13000.00,0.05,1
51895,5205,1000.00,14000.00,15000.00,4809.77,9190.23,0.32,1
51896,5205,1000.00,15000.00,16000.00,0.00,11079.55,0.04,1
51897,5205,1000.00,16000.00,17000.00,0.00,15150.57,0.04,1
51898,5205,1000.00,17000.00,18000.00,5385.79,10677.28,0.32,1
51899,5205,1000.00,18000.00,19000.00,2305.59,15694.41,0.32,1
51900,5206,-994.72,-994.72,5.28,0.00,994.72,0.40,0
51901,5206,-1.39,-996.12,3.88,0.00,1.39,0.20,0
51902,5206,-3.09,-999.20,0.80,0.00,3.09,0.33,0
51903,5206,-0.32,-999.52,0.48,0.09,0.23,0.21,0
51904,5206,-10.72,-1010.24,-10.24,0.06,0.06,0.15,0
51905,5207,0.00,0.00,1000.00,0.00,0.00,0.16,0
51906,5207,0.00,0.00,1000.00,0.00,0.00,0.00,0
51907,5207,1000.00,1000.00,2000.00,388.75,0.00,0.30,1
51908,5207,0.00,1000.00,2000.00,0.00,0.00,0.07,0
51909,5207,-1000.00,0.00,1000.00,0.00,2000.00,0.07,0
51910,5207,-1000.00,-1000.00,0.00,403.06,596.94,0.29,0
51911,5208,1000.00,1000.00,2000.00,0.00,1000.00,0.19,1
51912,5208,1000.00,2000.00,3000.00,0.00,2000.00,0.35,1
51913,5208,1000.00,3000.00,4000.00,0.00,2560.51,0.18,1
51914,5208,1000.00,4000.00,5000.00,0.00,4000.00,0.11,1
51915,5208,1000.00,5000.00,6000.00,1131.13,3868.87,0.39,1
51916,5208,1000.00,6000.00,7000.00,286.16,5335.05,0.43,1
51917,5208,1000.00,7000.00,8000.00,0.00,6945.32,0.40,1
51918,5208,1000.00,8000.00,9000.00,0.00,7734.98,0.24,1
51919,5208,1000.00,9000.00,10000.00,179.18,8820.82,0.30,1
51920,5208,1000.00,10000.00,11000.00,0.00,10000.00,0.41,1
51921,5208,1000.00,11000.00,12000.00,5150.75,5849.25,0.13,1
51922,5208,1000.00,12000.00,13000.00,3774.26,8225.74,0.31,1
51923,5208,-1000.00,11000.00,12000.00,6921.89,6078.11,0.16,0
51924,5208,-1000.00,10000.00,11000.00,3535.06,2607.09,0.17,0
51925,5208,1000.00,11000.00,12000.00,0.00,10326.69,0.38,1
51926,5208,1000.00,12000.00,13000.00,1974.57,4409.41,0.10,1
51927,5208,1000.00,13000.00,14000.00,4922.18,8077.82,0.18,1
51928,5208,1000.00,14000.00,15000.00,0.00,3306.25,0.18,1
51929,5208,1000.00,15000.00,16000.00,0.00,15000.00,0.42,1
51930,5208,1000.00,16000.00,17000.00,0.00,16000.00,0.30,1
51931,5208,1000.00,17000.00,18000.00,0.00,10330.02,0.33,1
51932,5208,-1000.00,16000.00,17000.00,11962.44,6037.56,0.24,0
51933,5208,0.00,16000.00,17000.00,0.00,0.00,0.04,0
51934,5208,1000.00,17000.00,18000.00,1167.60,3421.32,0.18,1
51935,5208,1000.00,18000.00,19000.00,0.00,18000.00,0.34,1
51936,5208,1000.00,19000.00,20000.00,228.89,4847.88,0.20,1
51937,5208,1000.00,20000.00,21000.00,0.00,9740.21,0.16,1
51938,5208,-1000.00,19000.00,20000.00,8407.17,0.00,0.06,0
51939,5208,1000.00,20000.00,21000.00,9760.23,10239.77,0.14,1
51940,5208,1000.00,21000.00,22000.00,0.00,20648.54,0.28,1
51941,5208,1000.00,22000.00,23000.00,0.00,22000.00,0.08,1
51942,5208,-1000.00,21000.00,22000.00,5569.62,5037.23,0.17,0
51943,5208,1000.00,22000.00,23000.00,0.00,11023.67,0.26,1
51944,5208,1000.00,23000.00,24000.00,0.00,15789.93,0.33,1
51945,5208,1000.00,24000.00,25000.00,2695.91,21304.09,0.08,1
51946,5208,1000.00,25000.00,26000.00,10321.16,14678.84,0.08,1
51947,5208,1000.00,26000.00,27000.00,0.00,26000.00,0.40,1
51948,5208,1000.00,27000.00,28000.00,3533.44,12230.78,0.28,1
51949,5208,-1000.00,26000.00,27000.00,7017.80,6062.02,0.17,0
51950,5209,-1000.00,-1000.00,0.00,360.16,639.84,0.30,0
51951,5210,-1000.00,-1000.00,0.00,8.07,991.93,0.42,0
51952,5211,1000.00,1000.00,2000.00,134.29,865.71,0.34,1
51953,5211,-1000.00,0.00,1000.00,2000.00,0.00,0.01,0
51954,5211,1000.00,1000.00,2000.00,0.00,1000.00,0.08,1
51955,5211,1000.00,2000.00,3000.00,648.86,1351.14,0.30,1
51956,5211,1000.00,3000.00,4000.00,1138.41,1861.59,0.30,1
51957,5211,-1000.00,2000.00,3000.00,2333.89,1666.11,0.09,0
51958,5211,1000.00,3000.00,4000.00,58.25,2130.17,0.39,1
51959,5211,1000.00,4000.00,5000.00,0.00,3850.23,0.32,1
51960,5211,1000.00,5000.00,6000.00,0.00,4473.04,0.29,1
51961,5211,1000.00,6000.00,7000.00,174.88,5825.12,0.07,1
51962,5211,-1000.00,5000.00,6000.00,2507.81,0.00,0.04,0
51963,5211,1000.00,6000.00,7000.00,1490.43,4509.57,0.24,1
51964,5211,-1000.00,5000.00,6000.00,0.00,1983.49,0.22,0
51965,5211,-1000.00,4000.00,5000.00,0.00,1194.00,0.26,0
51966,5211,-1000.00,3000.00,4000.00,0.00,5000.00,0.23,0
51967,5211,-1000.00,2000.00,3000.00,0.00,3913.66,0.31,0
51968,5211,-1000.00,1000.00,2000.00,2117.13,695.34,0.11,0
51969,5211,-1000.00,0.00,1000.00,758.73,1241.27,0.09,0
51970,5211,-836.20,-836.20,163.80,650.60,185.60,0.10,0
51971,5211,-163.80,-1000.00,0.00,114.98,48.83,0.10,0
51972,5212,0.00,0.00,1000.00,0.00,0.00,0.02,0
51973,5212,-1000.00,-1000.00,0.00,0.00,843.11,0.16,0
51974,5213,0.00,0.00,1000.00,0.00,0.00,0.10,0
51975,5213,-420.56,-420.56,579.44,0.00,420.56,0.34,0
51976,5213,-579.44,-1000.00,0.00,213.46,365.98,0.33,0
51977,5214,0.00,0.00,1000.00,0.00,0.00,0.15,0
51978,5214,-1000.00,-1000.00,0.00,0.00,1000.00,0.02,0
51979,5215,-1000.00,-1000.00,0.00,263.33,736.67,0.37,0
51980,5216,1000.00,1000.00,2000.00,660.44,292.46,0.21,1
51981,5216,0.00,1000.00,2000.00,0.00,0.00,0.39,0
51982,5216,-1000.00,0.00,1000.00,798.52,1201.48,0.28,0
51983,5216,-1000.00,-1000.00,0.00,0.00,1000.00,0.08,0
51984,5217,1000.00,1000.00,2000.00,0.00,1000.00,0.28,1
51985,5217,0.00,1000.00,2000.00,0.00,0.00,0.09,0
51986,5217,1000.00,2000.00,3000.00,0.00,1687.28,0.10,1
51987,5217,1000.00,3000.00,4000.00,0.00,3000.00,0.25,1
51988,5217,-1000.00,2000.00,3000.00,3430.11,222.69,0.05,0
51989,5217,1000.00,3000.00,4000.00,0.00,1271.68,0.07,1
51990,5217,-1000.00,2000.00,3000.00,1602.44,2397.56,0.29,0
51991,5217,-1000.00,1000.00,2000.00,0.00,863.09,0.22,0
51992,5217,-1000.00,0.00,1000.00,0.00,298.00,0.08,0
51993,5217,-1000.00,-1000.00,0.00,0.00,1000.00,0.40,0
51994,5218,-1000.00,-1000.00,0.00,449.29,550.71,0.16,0
51995,5219,-1000.00,-1000.00,0.00,0.00,1000.00,0.25,0
51996,5220,-1000.00,-1000.00,0.00,0.00,162.46,0.29,0
51997,5221,-1000.00,-1000.00,0.00,789.44,210.56,0.03,0
51998,5222,-531.72,-531.72,468.28,0.00,531.72,0.31,0
51999,5222,-468.28,-1000.00,0.00,13.47,454.80,0.20,0
52000,5223,1000.00,1000.00,2000.00,0.00,1000.00,0.01,1
52001,5223,1000.00,2000.00,3000.00,0.00,834.99,0.25,1
52002,5223,-1000.00,1000.00,2000.00,1519.95,1480.05,0.03,0
52003,5223,1000.00,2000.00,3000.00,0.00,1408.05,0.39,1
52004,5223,1000.00,3000.00,4000.00,1120.84,1879.16,0.15,1
52005,5223,1000.00,4000.00,5000.00,1740.26,2259.74,0.08,1
52006,5223,1000.00,5000.00,6000.00,0.00,5000.00,0.28,1
52007,5223,1000.00,6000.00,7000.00,948.39,5051.61,0.07,1
52008,5223,1000.00,7000.00,8000.00,2439.63,4560.37,0.20,1
52009,5223,1000.00,8000.00,9000.00,362.63,7637.37,0.10,1
52010,5223,1000.00,9000.00,10000.00,0.00,9000.00,0.21,1
52011,5223,1000.00,10000.00,11000.00,0.00,10000.00,0.21,1
52012,5223,1000.00,11000.00,12000.00,4129.15,6870.85,0.16,1
52013,5223,1000.00,12000.00,13000.00,1403.01,10353.85,0.42,1
52014,5223,1000.00,13000.00,14000.00,6488.69,6511.31,0.11,1
52015,5223,1000.00,14000.00,15000.00,5974.33,8025.67,0.19,1
52016,5223,1000.00,15000.00,16000.00,2410.24,5010.55,0.23,1
52017,5223,1000.00,16000.00,17000.00,4885.68,11114.32,0.29,1
52018,5223,1000.00,17000.00,18000.00,0.00,17000.00,0.16,1
52019,5223,0.00,17000.00,18000.00,0.00,0.00,0.07,0
52020,5223,1000.00,18000.00,19000.00,8627.11,9372.89,0.13,1
52021,5223,1000.00,19000.00,20000.00,6201.87,12798.13,0.32,1
52022,5223,1000.00,20000.00,21000.00,0.00,9206.77,0.28,1
52023,5223,1000.00,21000.00,22000.00,8281.92,12718.08,0.38,1
52024,5223,-1000.00,20000.00,21000.00,3359.08,18640.92,0.42,0
52025,5223,-1000.00,19000.00,20000.00,0.00,21000.00,0.23,0
52026,5223,-1000.00,18000.00,19000.00,5584.11,14415.89,0.36,0
52027,5223,-1000.00,17000.00,18000.00,0.00,12344.29,0.36,0
52028,5223,-1000.00,16000.00,17000.00,0.00,16785.94,0.43,0
52029,5223,-1000.00,15000.00,16000.00,0.00,17000.00,0.21,0
52030,5223,-1000.00,14000.00,15000.00,0.00,16000.00,0.41,0
52031,5223,-1000.00,13000.00,14000.00,0.00,15000.00,0.16,0
52032,5223,-1000.00,12000.00,13000.00,0.00,14000.00,0.31,0
52033,5223,-1000.00,11000.00,12000.00,0.00,13000.00,0.29,0
52034,5223,-1000.00,10000.00,11000.00,0.00,12000.00,0.02,0
52035,5223,-1000.00,9000.00,10000.00,0.00,11000.00,0.05,0
52036,5223,-1000.00,8000.00,9000.00,4554.36,5445.64,0.17,0
52037,5223,-1000.00,7000.00,8000.00,4500.00,4500.00,0.09,0
52038,5223,-1000.00,6000.00,7000.00,190.59,7809.41,0.20,0
52039,5223,-1000.00,5000.00,6000.00,636.16,6363.84,0.42,0
52040,5223,-1000.00,4000.00,5000.00,3193.01,2806.99,0.16,0
52041,5223,-1000.00,3000.00,4000.00,252.32,3492.77,0.39,0
52042,5223,-1000.00,2000.00,3000.00,0.00,3704.73,0.44,0
52043,5223,-1000.00,1000.00,2000.00,1359.90,1640.10,0.16,0
52044,5223,-1000.00,0.00,1000.00,0.00,1691.96,0.41,0
52045,5223,-555.06,-555.06,444.94,0.00,555.06,0.30,0
52046,5223,-444.94,-1000.00,0.00,0.00,444.94,0.03,0
52047,5224,-1000.00,-1000.00,0.00,0.00,473.01,0.29,0
52048,5225,-1000.00,-1000.00,0.00,25.57,974.43,0.18,0
52049,5226,-338.62,-338.62,661.38,0.00,338.62,0.36,0
52050,5226,-434.71,-773.33,226.67,0.00,434.71,0.23,0
52051,5226,1000.00,226.67,1226.67,129.89,0.00,0.19,1
52052,5226,0.00,226.67,1226.67,0.00,0.00,0.24,0
52053,5226,-1000.00,-773.33,226.67,0.00,1226.67,0.06,0
52054,5226,1000.00,226.67,1226.67,17.18,0.00,0.17,1
52055,5226,-119.39,107.28,1107.28,0.00,119.39,0.19,0
52056,5226,1000.00,1107.28,2107.28,830.70,0.00,0.22,1
52057,5226,-956.60,150.68,1150.68,16.84,939.75,0.34,0
52058,5226,-489.64,-338.96,661.04,0.00,489.64,0.00,0
52059,5226,1000.00,661.04,1661.04,661.04,0.00,0.03,1
52060,5226,1000.00,1661.04,2661.04,1331.99,272.52,0.36,1
52061,5226,1000.00,2661.04,3661.04,1390.08,0.00,0.08,1
52062,5226,-28.27,2632.77,3632.77,0.00,28.27,0.13,0
52063,5226,-1000.00,1632.77,2632.77,1036.70,2596.08,0.14,0
52064,5226,1000.00,2632.77,3632.77,1839.31,611.60,0.21,1
52065,5226,-1000.00,1632.77,2632.77,472.42,1713.08,0.14,0
52066,5226,0.00,1632.77,2632.77,0.00,0.00,0.21,0
52067,5226,1000.00,2632.77,3632.77,526.55,0.00,0.16,1
52068,5226,-1000.00,1632.77,2632.77,0.00,3632.77,0.07,0
52069,5226,1000.00,2632.77,3632.77,1384.66,0.00,0.19,1
52070,5226,1000.00,3632.77,4632.77,937.28,78.01,0.40,1
52071,5226,1000.00,4632.77,5632.77,3373.43,0.00,0.10,1
52072,5226,-1000.00,3632.77,4632.77,0.00,1672.73,0.33,0
52073,5226,0.00,3632.77,4632.77,0.00,0.00,0.11,0
52074,5226,-1000.00,2632.77,3632.77,0.00,1228.87,0.40,0
52075,5226,-1000.00,1632.77,2632.77,1816.39,1816.39,0.00,0
52076,5226,-1000.00,632.77,1632.77,0.00,2632.77,0.10,0
52077,5226,-566.23,66.54,1066.54,566.23,0.00,0.17,0
52078,5226,-1000.00,-933.46,66.54,829.33,237.21,0.39,0
52079,5226,-7.41,-940.87,59.13,7.41,0.00,0.38,0
52080,5226,-1000.00,-1940.87,-940.87,4.65,29.04,0.18,0
52081,5227,-1000.00,-1000.00,0.00,381.30,191.81,0.15,0
52082,5228,0.00,0.00,1000.00,0.00,0.00,0.11,0
52083,5228,1000.00,1000.00,2000.00,506.87,493.13,0.09,1
52084,5228,0.00,1000.00,2000.00,0.00,0.00,0.38,0
52085,5228,-1000.00,0.00,1000.00,703.12,1296.88,0.15,0
52086,5228,-1000.00,-1000.00,0.00,0.00,1000.00,0.40,0
52087,5229,-529.25,-529.25,470.75,0.00,529.25,0.10,0
52088,5229,-470.75,-1000.00,0.00,0.00,470.75,0.34,0
52089,5230,-1000.00,-1000.00,0.00,0.00,1000.00,0.04,0
52090,5231,-705.68,-705.68,294.32,337.22,368.46,0.37,0
52091,5231,0.00,-705.68,294.32,0.00,0.00,0.11,0
52092,5231,-294.32,-1000.00,0.00,83.26,211.06,0.36,0
52093,5232,0.00,0.00,1000.00,0.00,0.00,0.01,0
52094,5232,-507.25,-507.25,492.75,169.49,337.76,0.41,0
52095,5232,-492.75,-1000.00,0.00,167.37,325.38,0.33,0
52096,5232,-0.00,-1000.00,0.00,0.00,0.00,0.28,0
52097,5233,-1000.00,-1000.00,0.00,297.55,702.45,0.04,0
52098,5234,-1000.00,-1000.00,0.00,0.00,1000.00,0.02,0
52099,5235,-409.12,-409.12,590.88,316.49,92.63,0.38,0
52100,5235,0.00,-409.12,590.88,0.00,0.00,0.31,0
52101,5235,-1000.00,-1409.12,-409.12,295.44,295.44,0.01,0
52102,5236,-1000.00,-1000.00,0.00,410.85,589.15,0.12,0
52103,5237,-1000.00,-1000.00,0.00,0.00,1000.00,0.05,0
52104,5238,-1000.00,-1000.00,0.00,456.03,543.97,0.23,0
52105,5239,1000.00,1000.00,2000.00,236.67,763.33,0.19,1
52106,5239,1000.00,2000.00,3000.00,0.00,2000.00,0.18,1
52107,5239,1000.00,3000.00,4000.00,0.00,2788.48,0.29,1
52108,5239,1000.00,4000.00,5000.00,0.00,2338.28,0.35,1
52109,5239,1000.00,5000.00,6000.00,0.00,5000.00,0.11,1
52110,5239,1000.00,6000.00,7000.00,170.53,5829.47,0.39,1
52111,5239,1000.00,7000.00,8000.00,0.00,7000.00,0.29,1
52112,5239,1000.00,8000.00,9000.00,1471.91,6528.09,0.41,1
52113,5239,1000.00,9000.00,10000.00,4500.00,4500.00,0.08,1
52114,5239,1000.00,10000.00,11000.00,0.00,10000.00,0.02,1
52115,5239,1000.00,11000.00,12000.00,4330.49,6669.51,0.20,1
52116,5239,1000.00,12000.00,13000.00,0.00,10020.16,0.37,1
52117,5239,1000.00,13000.00,14000.00,2671.27,10328.73,0.29,1
52118,5239,1000.00,14000.00,15000.00,1817.55,12182.45,0.39,1
52119,5239,1000.00,15000.00,16000.00,0.00,15000.00,0.13,1
52120,5239,0.00,15000.00,16000.00,0.00,0.00,0.01,0
52121,5239,1000.00,16000.00,17000.00,0.00,15296.08,0.18,1
52122,5239,1000.00,17000.00,18000.00,6524.71,10475.29,0.39,1
52123,5239,1000.00,18000.00,19000.00,0.00,18000.00,0.25,1
52124,5239,1000.00,19000.00,20000.00,5078.73,13921.27,0.32,1
52125,5239,1000.00,20000.00,21000.00,6496.31,13503.69,0.04,1
52126,5239,0.00,20000.00,21000.00,0.00,0.00,0.06,0
52127,5239,-1000.00,19000.00,20000.00,17525.54,3474.46,0.18,0
52128,5239,1000.00,20000.00,21000.00,0.00,20000.00,0.03,1
52129,5239,1000.00,21000.00,22000.00,0.00,21000.00,0.29,1
52130,5239,1000.00,22000.00,23000.00,0.00,22000.00,0.19,1
52131,5239,-1000.00,21000.00,22000.00,6874.48,0.00,0.01,0
52132,5239,1000.00,22000.00,23000.00,10976.62,11023.38,0.09,1
52133,5239,1000.00,23000.00,24000.00,9107.27,13892.73,0.10,1
52134,5239,1000.00,24000.00,25000.00,0.00,24000.00,0.22,1
52135,5239,1000.00,25000.00,26000.00,68.18,15404.12,0.36,1
52136,5239,-1000.00,24000.00,25000.00,16303.86,9696.14,0.08,0
52137,5239,-1000.00,23000.00,24000.00,9085.17,2521.11,0.12,0
52138,5239,1000.00,24000.00,25000.00,0.00,5255.60,0.19,1
52139,5239,1000.00,25000.00,26000.00,7408.35,17591.65,0.35,1
52140,5239,-1000.00,24000.00,25000.00,15975.54,10024.46,0.13,0
52141,5239,1000.00,25000.00,26000.00,10258.79,14741.21,0.05,1
52142,5239,1000.00,26000.00,27000.00,0.00,17318.51,0.24,1
52143,5240,-1000.00,-1000.00,0.00,500.00,500.00,0.03,0
52144,5241,-188.37,-188.37,811.63,188.37,0.00,0.04,0
52145,5241,-811.63,-1000.00,0.00,811.63,0.00,0.03,0
52146,5242,-1000.00,-1000.00,0.00,500.00,500.00,0.06,0
52147,5243,-472.17,-472.17,527.83,6.55,465.62,0.33,0
52148,5243,0.00,-472.17,527.83,0.00,0.00,0.41,0
52149,5243,-527.83,-1000.00,0.00,252.01,275.82,0.19,0
52150,5244,-1000.00,-1000.00,0.00,0.00,1000.00,0.18,0
52151,5245,-1000.00,-1000.00,0.00,95.42,904.58,0.35,0
52152,5246,1000.00,1000.00,2000.00,305.28,694.72,0.35,1
52153,5246,1000.00,2000.00,3000.00,751.69,1248.31,0.25,1
52154,5246,1000.00,3000.00,4000.00,5.99,553.13,0.18,1
52155,5246,0.00,3000.00,4000.00,0.00,0.00,0.04,0
52156,5246,1000.00,4000.00,5000.00,0.00,3526.52,0.43,1
52157,5246,1000.00,5000.00,6000.00,0.00,4698.67,0.02,1
52158,5246,1000.00,6000.00,7000.00,0.00,6000.00,0.03,1
52159,5246,1000.00,7000.00,8000.00,1614.62,5385.38,0.34,1
52160,5246,-1000.00,6000.00,7000.00,1807.43,493.76,0.12,0
52161,5246,1000.00,7000.00,8000.00,2010.62,4989.38,0.15,1
52162,5246,1000.00,8000.00,9000.00,1583.21,3927.12,0.29,1
52163,5246,1000.00,9000.00,10000.00,1589.08,7410.92,0.41,1
52164,5246,1000.00,10000.00,11000.00,0.00,10000.00,0.22,1
52165,5246,1000.00,11000.00,12000.00,0.00,11000.00,0.06,1
52166,5246,1000.00,12000.00,13000.00,4135.17,5131.77,0.24,1
52167,5246,1000.00,13000.00,14000.00,4754.90,8245.10,0.03,1
52168,5246,-1000.00,12000.00,13000.00,7790.26,6209.74,0.18,0
52169,5246,1000.00,13000.00,14000.00,0.00,12193.81,0.42,1
52170,5246,1000.00,14000.00,15000.00,1271.80,12728.20,0.34,1
52171,5246,1000.00,15000.00,16000.00,0.00,15000.00,0.32,1
52172,5246,1000.00,16000.00,17000.00,989.10,11959.98,0.40,1
52173,5246,1000.00,17000.00,18000.00,4606.82,12393.18,0.33,1
52174,5246,1000.00,18000.00,19000.00,0.00,18000.00,0.14,1
52175,5246,1000.00,19000.00,20000.00,0.00,5254.62,0.14,1
52176,5246,-1000.00,18000.00,19000.00,10293.14,9706.86,0.15,0
52177,5246,-1000.00,17000.00,18000.00,9500.00,9500.00,0.02,0
52178,5246,-1000.00,16000.00,17000.00,0.00,14955.70,0.22,0
52179,5246,-1000.00,15000.00,16000.00,9078.88,6423.44,0.18,0
52180,5246,-1000.00,14000.00,15000.00,3999.59,12000.41,0.34,0
52181,5246,-1000.00,13000.00,14000.00,0.00,15000.00,0.14,0
52182,5246,-1000.00,12000.00,13000.00,3225.50,10774.50,0.36,0
52183,5246,-1000.00,11000.00,12000.00,2572.78,10427.22,0.30,0
52184,5246,-1000.00,10000.00,11000.00,5099.57,6900.43,0.27,0
52185,5246,-1000.00,9000.00,10000.00,0.00,11000.00,0.30,0
52186,5246,-1000.00,8000.00,9000.00,3794.76,6205.24,0.14,0
52187,5246,-1000.00,7000.00,8000.00,3069.30,5930.70,0.32,0
52188,5246,-1000.00,6000.00,7000.00,0.00,8000.00,0.23,0
52189,5246,-1000.00,5000.00,6000.00,1266.69,5733.31,0.07,0
52190,5246,-1000.00,4000.00,5000.00,0.00,6000.00,0.15,0
52191,5246,-1000.00,3000.00,4000.00,2959.55,2040.45,0.11,0
52192,5246,-1000.00,2000.00,3000.00,0.00,4000.00,0.23,0
52193,5246,-1000.00,1000.00,2000.00,1120.38,1879.62,0.00,0
52194,5246,0.00,1000.00,2000.00,0.00,0.00,0.04,0
52195,5246,-1000.00,0.00,1000.00,1188.65,811.35,0.13,0
52196,5246,-1000.00,-1000.00,0.00,419.65,0.00,0.01,0
52197,5247,-1000.00,-1000.00,0.00,545.18,454.82,0.17,0
52198,5248,1000.00,1000.00,2000.00,395.54,604.46,0.26,1
52199,5248,1000.00,2000.00,3000.00,0.00,2000.00,0.04,1
52200,5248,1000.00,3000.00,4000.00,359.16,659.99,0.19,1
52201,5248,1000.00,4000.00,5000.00,0.00,1736.39,0.16,1
52202,5248,-1000.00,3000.00,4000.00,3063.73,1936.27,0.34,0
52203,5248,1000.00,4000.00,5000.00,492.39,3507.61,0.34,1
52204,5248,1000.00,5000.00,6000.00,0.00,5000.00,0.41,1
52205,5248,-1000.00,4000.00,5000.00,4784.96,0.00,0.03,0
52206,5248,-786.96,3213.04,4213.04,786.96,0.00,0.41,0
52207,5248,-1000.00,2213.04,3213.04,0.00,2197.95,0.23,0
52208,5248,-1000.00,1213.04,2213.04,0.00,1317.78,0.35,0
52209,5248,-482.65,730.39,1730.39,482.65,0.00,0.17,0
52210,5248,-1000.00,-269.61,730.39,714.69,1015.69,0.22,0
52211,5248,-272.65,-542.26,457.74,272.65,0.00,0.27,0
52212,5248,-1000.00,-1542.26,-542.26,0.00,132.23,0.10,0
52213,5249,-703.39,-703.39,296.61,326.88,376.51,0.22,0
52214,5249,-296.61,-1000.00,0.00,0.00,296.61,0.17,0
52215,5250,-606.66,-606.66,393.34,0.00,606.66,0.07,0
52216,5250,-393.34,-1000.00,0.00,98.42,294.92,0.16,0
52217,5251,-1000.00,-1000.00,0.00,360.69,639.31,0.19,0
52218,5252,-1000.00,-1000.00,0.00,0.00,1000.00,0.37,0
52219,5253,1000.00,1000.00,2000.00,0.00,1000.00,0.26,1
52220,5253,1000.00,2000.00,3000.00,781.27,1218.73,0.25,1
52221,5253,1000.00,3000.00,4000.00,454.03,2545.97,0.42,1
52222,5253,-368.31,2631.69,3631.69,368.31,0.00,0.00,0
52223,5253,1000.00,3631.69,4631.69,1478.60,2153.09,0.10,1
52224,5253,-1000.00,2631.69,3631.69,2510.96,2120.72,0.06,0
52225,5253,1000.00,3631.69,4631.69,205.68,2021.61,0.33,1
52226,5253,1000.00,4631.69,5631.69,0.00,4631.69,0.02,1
52227,5253,1000.00,5631.69,6631.69,0.00,5631.69,0.02,1
52228,5253,0.00,5631.69,6631.69,0.00,0.00,0.03,0
52229,5253,1000.00,6631.69,7631.69,0.00,6281.85,0.13,1
52230,5253,1000.00,7631.69,8631.69,0.00,7631.69,0.04,1
52231,5253,1000.00,8631.69,9631.69,0.00,8631.69,0.10,1
52232,5253,1000.00,9631.69,10631.69,2450.87,7180.82,0.38,1
52233,5253,1000.00,10631.69,11631.69,0.00,10631.69,0.05,1
52234,5253,1000.00,11631.69,12631.69,0.00,11631.69,0.39,1
52235,5253,1000.00,12631.69,13631.69,0.00,12631.69,0.42,1
52236,5253,1000.00,13631.69,14631.69,0.00,13631.69,0.05,1
52237,5253,1000.00,14631.69,15631.69,0.00,14631.69,0.39,1
52238,5253,-1000.00,13631.69,14631.69,5916.77,2505.46,0.10,0
52239,5253,1000.00,14631.69,15631.69,6942.84,7688.84,0.12,1
52240,5253,0.00,14631.69,15631.69,0.00,0.00,0.07,0
52241,5253,1000.00,15631.69,16631.69,7036.35,8595.34,0.10,1
52242,5253,1000.00,16631.69,17631.69,6853.09,8303.54,0.25,1
52243,5253,-1000.00,15631.69,16631.69,16152.37,0.00,0.01,0
52244,5253,0.00,15631.69,16631.69,0.00,0.00,0.03,0
52245,5253,1000.00,16631.69,17631.69,0.00,15682.41,0.44,1
52246,5253,1000.00,17631.69,18631.69,0.00,17631.69,0.17,1
52247,5253,-1000.00,16631.69,17631.69,6850.35,3745.94,0.15,0
52248,5253,-1000.00,15631.69,16631.69,9922.35,6511.71,0.16,0
52249,5253,1000.00,16631.69,17631.69,1614.70,15016.99,0.43,1
52250,5253,1000.00,17631.69,18631.69,0.00,2298.33,0.14,1
52251,5253,1000.00,18631.69,19631.69,788.34,6627.10,0.25,1
52252,5253,1000.00,19631.69,20631.69,4632.33,14999.36,0.20,1
52253,5253,-1000.00,18631.69,19631.69,9154.80,4032.99,0.14,0
52254,5253,1000.00,19631.69,20631.69,0.00,19631.69,0.09,1
52255,5253,-1000.00,18631.69,19631.69,17840.60,2791.09,0.11,0
52256,5254,-1000.00,-1000.00,0.00,0.00,1000.00,0.09,0
52257,5255,0.00,0.00,1000.00,0.00,0.00,0.38,0
52258,5255,-1000.00,-1000.00,0.00,0.00,886.09,0.15,0
52259,5256,1000.00,1000.00,2000.00,655.21,344.79,0.15,1
52260,5256,-638.78,361.22,1361.22,232.98,405.80,0.41,0
52261,5256,1000.00,1361.22,2361.22,1127.15,234.08,0.05,1
52262,5256,-1000.00,361.22,1361.22,793.61,1567.61,0.20,0
52263,5256,-1000.00,-638.78,361.22,0.00,1361.22,0.31,0
52264,5256,-361.22,-1000.00,0.00,137.89,223.33,0.23,0
52265,5257,-1000.00,-1000.00,0.00,0.00,485.34,0.08,0
52266,5258,-1000.00,-1000.00,0.00,0.00,1000.00,0.21,0
52267,5259,-889.04,-889.04,110.96,0.00,889.04,0.42,0
52268,5259,-110.96,-1000.00,0.00,0.00,110.96,0.29,0
52269,5260,-1000.00,-1000.00,0.00,275.90,724.10,0.37,0
52270,5261,-1000.00,-1000.00,0.00,623.65,376.35,0.05,0
52271,5262,-196.05,-196.05,803.95,103.42,92.63,0.43,0
52272,5262,0.00,-196.05,803.95,0.00,0.00,0.06,0
52273,5262,-1000.00,-1196.05,-196.05,349.01,454.94,0.39,0
52274,5263,-344.88,-344.88,655.12,295.51,49.36,0.39,0
52275,5263,1000.00,655.12,1655.12,4.80,262.15,0.36,1
52276,5263,-1000.00,-344.88,655.12,864.91,790.21,0.29,0
52277,5263,1000.00,655.12,1655.12,0.00,655.12,0.29,1
52278,5263,1000.00,1655.12,2655.12,249.22,555.79,0.23,1
52279,5263,1000.00,2655.12,3655.12,0.00,2591.29,0.41,1
52280,5263,1000.00,3655.12,4655.12,0.00,1989.30,0.13,1
52281,5263,1000.00,4655.12,5655.12,0.00,4456.49,0.03,1
52282,5263,1000.00,5655.12,6655.12,0.00,5655.12,0.08,1
52283,5263,1000.00,6655.12,7655.12,2548.79,4106.33,0.11,1
52284,5263,0.00,6655.12,7655.12,0.00,0.00,0.03,0
52285,5263,1000.00,7655.12,8655.12,0.00,7655.12,0.25,1
52286,5263,1000.00,8655.12,9655.12,3701.73,4953.39,0.29,1
52287,5263,1000.00,9655.12,10655.12,2131.10,7524.02,0.27,1
52288,5263,1000.00,10655.12,11655.12,0.00,7259.89,0.18,1
52289,5263,-1000.00,9655.12,10655.12,9785.59,1546.19,0.06,0
52290,5263,1000.00,10655.12,11655.12,2169.57,8485.56,0.40,1
52291,5263,1000.00,11655.12,12655.12,0.00,9277.10,0.40,1
52292,5263,1000.00,12655.12,13655.12,0.00,12655.12,0.11,1
52293,5263,-1000.00,11655.12,12655.12,7082.38,2568.14,0.12,0
52294,5263,1000.00,12655.12,13655.12,6323.72,6331.41,0.10,1
52295,5263,-1000.00,11655.12,12655.12,5637.44,8017.68,0.15,0
52296,5263,-1000.00,10655.12,11655.12,453.96,9021.63,0.39,0
52297,5263,-1000.00,9655.12,10655.12,1191.51,6484.98,0.33,0
52298,5263,-1000.00,8655.12,9655.12,903.73,7562.74,0.39,0
52299,5263,-1000.00,7655.12,8655.12,626.46,9028.67,0.43,0
52300,5263,-1000.00,6655.12,7655.12,0.00,8655.12,0.10,0
52301,5263,-1000.00,5655.12,6655.12,4525.29,3129.83,0.10,0
52302,5263,-1000.00,4655.12,5655.12,2265.80,4389.32,0.26,0
52303,5263,-1000.00,3655.12,4655.12,4198.45,1456.67,0.08,0
52304,5263,-1000.00,2655.12,3655.12,0.00,4655.12,0.07,0
52305,5263,-1000.00,1655.12,2655.12,0.00,3655.12,0.37,0
52306,5263,-910.61,744.51,1744.51,78.92,831.69,0.23,0
52307,5263,-1000.00,-255.49,744.51,735.77,1008.74,0.27,0
52308,5263,-744.51,-1000.00,0.00,0.00,744.51,0.15,0
52309,5264,1000.00,1000.00,2000.00,284.06,0.00,0.38,1
52310,5264,0.00,1000.00,2000.00,0.00,0.00,0.41,0
52311,5264,-1000.00,0.00,1000.00,0.00,1239.07,0.36,0
52312,5264,0.00,0.00,1000.00,0.00,0.00,0.40,0
52313,5264,-138.84,-138.84,861.16,0.00,138.84,0.33,0
52314,5264,-861.16,-1000.00,0.00,337.12,524.04,0.27,0
52315,5265,1000.00,1000.00,2000.00,543.94,456.06,0.19,1
52316,5265,0.00,1000.00,2000.00,0.00,0.00,0.13,0
52317,5265,1000.00,2000.00,3000.00,433.89,0.00,0.00,1
52318,5265,0.00,2000.00,3000.00,0.00,0.00,0.08,0
52319,5265,1000.00,3000.00,4000.00,1164.87,0.00,0.17,1
52320,5265,1000.00,4000.00,5000.00,1614.97,0.00,0.01,1
52321,5265,1000.00,5000.00,6000.00,2048.40,857.24,0.34,1
52322,5265,-1000.00,4000.00,5000.00,0.00,6000.00,0.00,0
52323,5265,-1000.00,3000.00,4000.00,899.83,4100.17,0.06,0
52324,5265,0.00,3000.00,4000.00,0.00,0.00,0.09,0
52325,5265,-1000.00,2000.00,3000.00,0.00,3345.54,0.21,0
52326,5265,1000.00,3000.00,4000.00,2125.40,133.52,0.22,1
52327,5265,1000.00,4000.00,5000.00,2139.28,1860.72,0.01,1
52328,5265,1000.00,5000.00,6000.00,3701.25,1162.98,0.17,1
52329,5265,1000.00,6000.00,7000.00,4286.13,0.00,0.22,1
52330,5265,-1000.00,5000.00,6000.00,0.00,5356.78,0.14,0
52331,5265,-1000.00,4000.00,5000.00,2677.07,3322.93,0.27,0
52332,5265,0.00,4000.00,5000.00,0.00,0.00,0.23,0
52333,5265,0.00,4000.00,5000.00,0.00,0.00,0.16,0
52334,5265,-1000.00,3000.00,4000.00,0.00,5000.00,0.03,0
52335,5265,-1000.00,2000.00,3000.00,2000.00,2000.00,0.06,0
52336,5265,-1000.00,1000.00,2000.00,0.00,2403.81,0.23,0
52337,5265,-1000.00,0.00,1000.00,432.46,1567.54,0.14,0
52338,5265,-1000.00,-1000.00,0.00,228.98,771.02,0.39,0
52339,5266,1000.00,1000.00,2000.00,0.00,1000.00,0.05,1
52340,5266,1000.00,2000.00,3000.00,806.67,828.46,0.22,1
52341,5266,1000.00,3000.00,4000.00,0.00,1945.88,0.35,1
52342,5266,1000.00,4000.00,5000.00,0.00,1859.52,0.21,1
52343,5266,1000.00,5000.00,6000.00,0.00,5000.00,0.22,1
52344,5266,-1000.00,4000.00,5000.00,3369.85,2630.15,0.18,0
52345,5266,1000.00,5000.00,6000.00,2027.38,2972.62,0.28,1
52346,5266,1000.00,6000.00,7000.00,0.00,6000.00,0.20,1
52347,5266,-1000.00,5000.00,6000.00,6072.77,0.00,0.02,0
52348,5266,-1000.00,4000.00,5000.00,3156.54,1647.58,0.14,0
52349,5266,1000.00,5000.00,6000.00,599.57,4400.43,0.26,1
52350,5266,1000.00,6000.00,7000.00,2429.88,3570.12,0.20,1
52351,5266,-1000.00,5000.00,6000.00,4470.31,2529.69,0.13,0
52352,5266,1000.00,6000.00,7000.00,799.90,5200.10,0.43,1
52353,5266,1000.00,7000.00,8000.00,3484.19,3515.81,0.03,1
52354,5266,1000.00,8000.00,9000.00,0.00,7726.28,0.23,1
52355,5266,1000.00,9000.00,10000.00,1972.17,3802.33,0.26,1
52356,5266,1000.00,10000.00,11000.00,2855.65,7144.35,0.22,1
52357,5266,1000.00,11000.00,12000.00,0.00,5463.22,0.19,1
52358,5266,1000.00,12000.00,13000.00,0.00,12000.00,0.14,1
52359,5266,-1000.00,11000.00,12000.00,7742.73,5257.27,0.02,0
52360,5266,1000.00,12000.00,13000.00,0.00,9649.05,0.35,1
52361,5266,1000.00,13000.00,14000.00,0.00,1865.09,0.15,1
52362,5266,1000.00,14000.00,15000.00,7000.00,7000.00,0.01,1
52363,5266,-1000.00,13000.00,14000.00,11176.62,3823.38,0.10,0
52364,5266,-1000.00,12000.00,13000.00,3713.37,10286.63,0.35,0
52365,5266,-1000.00,11000.00,12000.00,5850.09,7149.91,0.22,0
52366,5266,-1000.00,10000.00,11000.00,0.00,12000.00,0.20,0
52367,5266,-1000.00,9000.00,10000.00,0.00,11000.00,0.26,0
52368,5266,-1000.00,8000.00,9000.00,0.00,6205.71,0.33,0
52369,5266,-1000.00,7000.00,8000.00,0.00,4028.59,0.14,0
52370,5266,-1000.00,6000.00,7000.00,1634.73,6365.27,0.39,0
52371,5266,-1000.00,5000.00,6000.00,4760.71,2239.29,0.06,0
52372,5266,-1000.00,4000.00,5000.00,299.41,5693.70,0.44,0
52373,5266,-1000.00,3000.00,4000.00,1973.11,0.00,0.02,0
52374,5266,-1000.00,2000.00,3000.00,318.43,1800.46,0.29,0
52375,5266,0.00,2000.00,3000.00,0.00,0.00,0.02,0
52376,5266,-1000.00,1000.00,2000.00,0.00,2561.80,0.38,0
52377,5266,-1000.00,0.00,1000.00,292.20,1707.80,0.38,0
52378,5266,-1000.00,-1000.00,0.00,271.26,728.74,0.33,0
52379,5267,-136.29,-136.29,863.71,0.00,136.29,0.16,0
52380,5267,-271.11,-407.41,592.59,0.00,271.11,0.16,0
52381,5267,-574.71,-982.12,17.88,41.84,532.88,0.43,0
52382,5267,-16.76,-998.88,1.12,0.00,16.76,0.34,0
52383,5267,-0.45,-999.33,0.67,0.00,0.45,0.21,0
52384,5267,-0.67,-1000.00,0.00,0.30,0.36,0.17,0
52385,5268,-61.46,-61.46,938.54,0.00,61.46,0.44,0
52386,5268,-938.54,-1000.00,0.00,0.00,938.54,0.14,0
52387,5269,-523.63,-523.63,476.37,373.14,150.49,0.35,0
52388,5269,-1000.00,-1523.63,-523.63,0.00,227.97,0.16,0
52389,5270,-948.80,-948.80,51.20,0.00,948.80,0.29,0
52390,5270,-51.20,-1000.00,0.00,0.00,51.20,0.29,0
52391,5271,-851.76,-851.76,148.24,0.00,851.76,0.38,0
52392,5271,-148.24,-1000.00,0.00,39.39,108.85,0.35,0
52393,5272,-1000.00,-1000.00,0.00,494.53,505.47,0.02,0
52394,5273,0.00,0.00,1000.00,0.00,0.00,0.01,0
52395,5273,-518.66,-518.66,481.34,0.00,518.66,0.27,0
52396,5273,-450.14,-968.80,31.20,147.79,302.35,0.32,0
52397,5273,-31.20,-1000.00,0.00,7.67,23.53,0.18,0
52398,5274,-635.62,-635.62,364.38,635.62,0.00,0.11,0
52399,5274,-1000.00,-1635.62,-635.62,0.00,65.73,0.20,0
52400,5275,-1000.00,-1000.00,0.00,0.00,62.77,0.37,0
52401,5276,-1000.00,-1000.00,0.00,0.00,1000.00,0.21,0
52402,5277,1000.00,1000.00,2000.00,1000.00,0.00,0.03,1
52403,5277,1000.00,2000.00,3000.00,1337.72,0.00,0.18,1
52404,5277,-1000.00,1000.00,2000.00,192.52,2807.48,0.03,0
52405,5277,-772.09,227.91,1227.91,0.00,772.09,0.24,0
52406,5277,-1000.00,-772.09,227.91,0.00,1227.91,0.33,0
52407,5277,-175.79,-947.88,52.12,0.00,175.79,0.30,0
52408,5277,-42.14,-990.02,9.98,13.13,29.01,0.32,0
52409,5277,1000.00,9.98,1009.98,9.24,0.75,0.01,1
52410,5277,1000.00,1009.98,2009.98,82.75,0.00,0.12,1
52411,5277,-1000.00,9.98,1009.98,304.58,1118.75,0.33,0
52412,5277,1000.00,1009.98,2009.98,517.64,449.28,0.20,1
52413,5277,-1000.00,9.98,1009.98,0.00,2009.98,0.25,0
52414,5277,-1000.00,-990.02,9.98,504.99,504.99,0.15,0
52415,5277,-9.98,-1000.00,0.00,0.00,9.98,0.02,0
52416,5278,1000.00,1000.00,2000.00,0.00,1000.00,0.33,1
52417,5278,1000.00,2000.00,3000.00,676.82,1323.18,0.30,1
52418,5278,1000.00,3000.00,4000.00,0.00,1218.13,0.21,1
52419,5278,1000.00,4000.00,5000.00,0.00,3525.37,0.38,1
52420,5278,-1000.00,3000.00,4000.00,2320.14,1477.56,0.16,0
52421,5278,1000.00,4000.00,5000.00,0.00,3486.97,0.32,1
52422,5278,1000.00,5000.00,6000.00,1334.95,3665.05,0.38,1
52423,5278,1000.00,6000.00,7000.00,617.24,5382.76,0.42,1
52424,5278,1000.00,7000.00,8000.00,2264.28,4735.72,0.32,1
52425,5278,1000.00,8000.00,9000.00,0.00,8000.00,0.14,1
52426,5278,1000.00,9000.00,10000.00,3862.48,5137.52,0.15,1
52427,5278,1000.00,10000.00,11000.00,0.00,3220.44,0.17,1
52428,5278,1000.00,11000.00,12000.00,0.00,11000.00,0.32,1
52429,5278,1000.00,12000.00,13000.00,0.00,12000.00,0.32,1
52430,5278,1000.00,13000.00,14000.00,2477.67,10522.33,0.08,1
52431,5278,1000.00,14000.00,15000.00,7000.00,7000.00,0.05,1
52432,5278,1000.00,15000.00,16000.00,0.00,6388.21,0.13,1
52433,5278,1000.00,16000.00,17000.00,1075.23,14924.77,0.40,1
52434,5278,1000.00,17000.00,18000.00,0.00,5672.79,0.22,1
52435,5278,-1000.00,16000.00,17000.00,0.00,18000.00,0.03,0
52436,5278,-1000.00,15000.00,16000.00,2147.56,14852.44,0.42,0
52437,5278,-1000.00,14000.00,15000.00,0.00,16000.00,0.44,0
52438,5278,-1000.00,13000.00,14000.00,2285.57,12170.63,0.42,0
52439,5278,-1000.00,12000.00,13000.00,2372.62,11627.38,0.42,0
52440,5278,-1000.00,11000.00,12000.00,4360.85,8639.15,0.30,0
52441,5278,-1000.00,10000.00,11000.00,4787.52,7212.48,0.23,0
52442,5278,-1000.00,9000.00,10000.00,5424.93,5575.07,0.22,0
52443,5278,-1000.00,8000.00,9000.00,1471.46,8528.54,0.42,0
52444,5278,-1000.00,7000.00,8000.00,775.40,8224.60,0.27,0
52445,5278,-1000.00,6000.00,7000.00,2660.60,5339.40,0.28,0
52446,5278,-1000.00,5000.00,6000.00,3938.71,3061.29,0.16,0
52447,5278,-1000.00,4000.00,5000.00,0.00,3222.25,0.20,0
52448,5278,-1000.00,3000.00,4000.00,1424.15,3575.85,0.37,0
52449,5278,-1000.00,2000.00,3000.00,0.00,3210.09,0.08,0
52450,5278,-1000.00,1000.00,2000.00,0.00,3000.00,0.37,0
52451,5278,-1000.00,0.00,1000.00,963.12,266.82,0.11,0
52452,5278,-833.25,-833.25,166.75,280.72,552.53,0.30,0
52453,5278,-58.89,-892.15,107.85,0.00,58.89,0.25,0
52454,5278,-107.85,-1000.00,0.00,44.23,63.62,0.23,0
52455,5279,-1000.00,-1000.00,0.00,661.83,338.17,0.11,0
52456,5280,0.00,0.00,1000.00,0.00,0.00,0.19,0
52457,5280,0.00,0.00,1000.00,0.00,0.00,0.28,0
52458,5280,-1000.00,-1000.00,0.00,0.00,1000.00,0.27,0
52459,5281,1000.00,1000.00,2000.00,0.00,804.95,0.42,1
52460,5281,1000.00,2000.00,3000.00,207.26,1792.74,0.08,1
52461,5281,1000.00,3000.00,4000.00,0.00,3000.00,0.35,1
52462,5281,0.00,3000.00,4000.00,0.00,0.00,0.10,0
52463,5281,1000.00,4000.00,5000.00,334.90,2461.09,0.36,1
52464,5281,1000.00,5000.00,6000.00,0.00,5000.00,0.21,1
52465,5281,1000.00,6000.00,7000.00,2361.98,3638.02,0.08,1
52466,5281,1000.00,7000.00,8000.00,0.00,1423.44,0.02,1
52467,5281,1000.00,8000.00,9000.00,0.00,8000.00,0.41,1
52468,5281,1000.00,9000.00,10000.00,0.00,9000.00,0.26,1
52469,5281,1000.00,10000.00,11000.00,0.00,484.18,0.10,1
52470,5281,1000.00,11000.00,12000.00,909.33,10090.67,0.20,1
52471,5281,1000.00,12000.00,13000.00,0.00,12000.00,0.33,1
52472,5281,1000.00,13000.00,14000.00,0.00,13000.00,0.41,1
52473,5281,1000.00,14000.00,15000.00,0.00,7034.95,0.27,1
52474,5281,1000.00,15000.00,16000.00,0.00,6734.83,0.16,1
52475,5281,1000.00,16000.00,17000.00,0.00,10484.65,0.34,1
52476,5281,1000.00,17000.00,18000.00,3724.65,11637.79,0.37,1
52477,5281,1000.00,18000.00,19000.00,1338.95,16661.05,0.39,1
52478,5281,-1000.00,17000.00,18000.00,14528.87,4471.13,0.18,0
52479,5281,1000.00,18000.00,19000.00,4676.66,13323.34,0.36,1
52480,5281,-1000.00,17000.00,18000.00,9500.00,9500.00,0.01,0
52481,5281,-1000.00,16000.00,17000.00,0.00,13729.54,0.40,0
52482,5281,-1000.00,15000.00,16000.00,1397.22,15602.78,0.19,0
52483,5281,-1000.00,14000.00,15000.00,1747.71,14252.29,0.42,0
52484,5281,-1000.00,13000.00,14000.00,7500.00,7500.00,0.19,0
52485,5281,-1000.00,12000.00,13000.00,0.00,14000.00,0.33,0
52486,5281,-1000.00,11000.00,12000.00,0.00,13000.00,0.38,0
52487,5281,-1000.00,10000.00,11000.00,6173.13,5826.87,0.03,0
52488,5281,-1000.00,9000.00,10000.00,3443.89,7556.11,0.34,0
52489,5281,-1000.00,8000.00,9000.00,0.00,5682.32,0.03,0
52490,5281,-1000.00,7000.00,8000.00,4500.00,4500.00,0.04,0
52491,5281,-1000.00,6000.00,7000.00,1508.84,6491.16,0.40,0
52492,5281,-1000.00,5000.00,6000.00,42.40,6957.60,0.35,0
52493,5281,-1000.00,4000.00,5000.00,2305.84,2330.02,0.21,0
52494,5281,-1000.00,3000.00,4000.00,0.00,5000.00,0.16,0
52495,5281,-1000.00,2000.00,3000.00,2172.32,1827.68,0.36,0
52496,5281,-1000.00,1000.00,2000.00,869.76,2130.24,0.32,0
52497,5281,-1000.00,0.00,1000.00,619.81,1380.19,0.31,0
52498,5281,-1000.00,-1000.00,0.00,487.96,512.04,0.14,0
52499,5282,-1000.00,-1000.00,0.00,0.00,1000.00,0.21,0
52500,5283,-1000.00,-1000.00,0.00,0.00,1000.00,0.20,0
52501,5284,-1000.00,-1000.00,0.00,0.00,1000.00,0.36,0
52502,5285,1000.00,1000.00,2000.00,145.25,854.75,0.08,1
52503,5285,1000.00,2000.00,3000.00,261.96,911.81,0.29,1
52504,5285,1000.00,3000.00,4000.00,0.00,3000.00,0.36,1
52505,5285,1000.00,4000.00,5000.00,2000.00,2000.00,0.21,1
52506,5285,1000.00,5000.00,6000.00,0.00,3210.00,0.19,1
52507,5285,1000.00,6000.00,7000.00,2603.82,3396.18,0.09,1
52508,5285,1000.00,7000.00,8000.00,0.00,5684.81,0.10,1
52509,5285,1000.00,8000.00,9000.00,3126.90,4873.10,0.03,1
52510,5285,1000.00,9000.00,10000.00,0.00,5255.52,0.34,1
52511,5285,1000.00,10000.00,11000.00,0.00,8631.48,0.43,1
52512,5285,1000.00,11000.00,12000.00,3933.34,7066.66,0.11,1
52513,5285,1000.00,12000.00,13000.00,0.00,10232.68,0.41,1
52514,5285,1000.00,13000.00,14000.00,0.00,13000.00,0.10,1
52515,5285,1000.00,14000.00,15000.00,0.00,9575.15,0.22,1
52516,5285,1000.00,15000.00,16000.00,0.00,15000.00,0.12,1
52517,5285,1000.00,16000.00,17000.00,0.00,9125.95,0.21,1
52518,5285,1000.00,17000.00,18000.00,4259.89,12740.11,0.32,1
52519,5285,1000.00,18000.00,19000.00,3583.41,14416.59,0.21,1
52520,5285,1000.00,19000.00,20000.00,0.00,873.01,0.12,1
52521,5285,1000.00,20000.00,21000.00,10000.00,10000.00,0.24,1
52522,5285,-1000.00,19000.00,20000.00,16754.93,4245.07,0.11,0
52523,5285,-1000.00,18000.00,19000.00,0.00,20000.00,0.36,0
52524,5285,-1000.00,17000.00,18000.00,9219.59,9780.41,0.13,0
52525,5285,-1000.00,16000.00,17000.00,0.00,17219.76,0.38,0
52526,5285,-1000.00,15000.00,16000.00,6134.38,10865.62,0.07,0
52527,5285,-1000.00,14000.00,15000.00,0.00,16000.00,0.39,0
52528,5285,-1000.00,13000.00,14000.00,0.00,3868.25,0.20,0
52529,5285,-1000.00,12000.00,13000.00,3553.81,7965.97,0.31,0
52530,5285,-1000.00,11000.00,12000.00,0.00,9327.39,0.39,0
52531,5285,-1000.00,10000.00,11000.00,6365.36,5634.64,0.19,0
52532,5285,-1000.00,9000.00,10000.00,0.00,11000.00,0.08,0
52533,5285,-1000.00,8000.00,9000.00,4383.75,5616.25,0.24,0
52534,5285,-1000.00,7000.00,8000.00,0.00,2632.54,0.21,0
52535,5285,-1000.00,6000.00,7000.00,0.00,2616.55,0.11,0
52536,5285,-1000.00,5000.00,6000.00,1507.70,3536.14,0.30,0
52537,5285,-1000.00,4000.00,5000.00,0.00,6000.00,0.13,0
52538,5285,-1000.00,3000.00,4000.00,1604.59,3395.41,0.11,0
52539,5285,-1000.00,2000.00,3000.00,1276.85,2723.15,0.14,0
52540,5285,1000.00,3000.00,4000.00,293.74,2317.28,0.41,1
52541,5285,1000.00,4000.00,5000.00,0.00,1815.15,0.23,1
52542,5285,1000.00,5000.00,6000.00,359.89,4640.11,0.36,1
52543,5285,1000.00,6000.00,7000.00,2303.09,3696.91,0.30,1
52544,5285,1000.00,7000.00,8000.00,3422.79,3577.21,0.21,1
52545,5285,1000.00,8000.00,9000.00,0.00,8000.00,0.32,1
52546,5285,1000.00,9000.00,10000.00,0.00,9000.00,0.15,1
52547,5285,-1000.00,8000.00,9000.00,0.00,4244.68,0.03,0
52548,5285,-1000.00,7000.00,8000.00,2644.18,6355.82,0.25,0
52549,5285,-1000.00,6000.00,7000.00,4291.22,3708.78,0.16,0
52550,5285,-1000.00,5000.00,6000.00,0.00,3732.39,0.15,0
52551,5285,-1000.00,4000.00,5000.00,1532.97,4467.03,0.22,0
52552,5285,-1000.00,3000.00,4000.00,0.00,2861.77,0.34,0
52553,5285,-1000.00,2000.00,3000.00,1846.08,2153.92,0.16,0
52554,5285,-1000.00,1000.00,2000.00,0.00,3000.00,0.39,0
52555,5285,-1000.00,0.00,1000.00,720.57,1279.43,0.28,0
52556,5285,-1000.00,-1000.00,0.00,107.93,556.94,0.33,0
52557,5286,-1000.00,-1000.00,0.00,0.00,1000.00,0.42,0
52558,5287,0.00,0.00,1000.00,0.00,0.00,0.01,0
52559,5287,-1000.00,-1000.00,0.00,0.00,1000.00,0.09,0
52560,5288,-1000.00,-1000.00,0.00,510.78,489.22,0.21,0
52561,5289,0.00,0.00,1000.00,0.00,0.00,0.09,0
52562,5289,0.00,0.00,1000.00,0.00,0.00,0.43,0
52563,5289,-559.99,-559.99,440.01,559.99,0.00,0.12,0
52564,5289,-193.20,-753.19,246.81,193.20,0.00,0.34,0
52565,5289,-246.81,-1000.00,0.00,143.55,103.26,0.01,0
52566,5290,-1000.00,-1000.00,0.00,508.83,491.17,0.12,0
52567,5291,-1000.00,-1000.00,0.00,278.02,721.98,0.37,0
52568,5292,1000.00,1000.00,2000.00,304.23,695.77,0.05,1
52569,5292,1000.00,2000.00,3000.00,0.00,2000.00,0.22,1
52570,5292,1000.00,3000.00,4000.00,0.00,2900.14,0.34,1
52571,5292,1000.00,4000.00,5000.00,535.01,3464.99,0.03,1
52572,5292,1000.00,5000.00,6000.00,0.00,963.99,0.06,1
52573,5292,1000.00,6000.00,7000.00,1596.78,4403.22,0.37,1
52574,5292,1000.00,7000.00,8000.00,0.00,4846.04,0.39,1
52575,5292,1000.00,8000.00,9000.00,0.00,7462.82,0.43,1
52576,5292,1000.00,9000.00,10000.00,0.00,9000.00,0.34,1
52577,5292,1000.00,10000.00,11000.00,0.00,10000.00,0.27,1
52578,5292,1000.00,11000.00,12000.00,0.00,1020.24,0.01,1
52579,5292,1000.00,12000.00,13000.00,0.00,4533.67,0.26,1
52580,5292,1000.00,13000.00,14000.00,3545.47,9454.53,0.30,1
52581,5292,-1000.00,12000.00,13000.00,7225.14,6774.86,0.18,0
52582,5292,1000.00,13000.00,14000.00,0.00,8724.60,0.38,1
52583,5292,1000.00,14000.00,15000.00,3509.04,9555.44,0.35,1
52584,5292,1000.00,15000.00,16000.00,0.00,5451.03,0.22,1
52585,5292,1000.00,16000.00,17000.00,0.00,8771.56,0.06,1
52586,5292,0.00,16000.00,17000.00,0.00,0.00,0.01,0
52587,5292,-1000.00,15000.00,16000.00,7087.06,4004.18,0.15,0
52588,5292,1000.00,16000.00,17000.00,7368.88,8631.12,0.34,1
52589,5292,0.00,16000.00,17000.00,0.00,0.00,0.06,0
52590,5292,1000.00,17000.00,18000.00,4717.27,12282.73,0.37,1
52591,5292,-1000.00,16000.00,17000.00,0.00,14251.15,0.29,0
52592,5292,-1000.00,15000.00,16000.00,2330.14,14669.86,0.38,0
52593,5292,-1000.00,14000.00,15000.00,0.00,6913.20,0.28,0
52594,5292,-1000.00,13000.00,14000.00,255.56,13789.23,0.44,0
52595,5292,-1000.00,12000.00,13000.00,0.00,3545.88,0.03,0
52596,5292,-1000.00,11000.00,12000.00,0.00,9541.34,0.40,0
52597,5292,-1000.00,10000.00,11000.00,2741.05,9258.95,0.37,0
52598,5292,-1000.00,9000.00,10000.00,4365.10,6634.90,0.07,0
52599,5292,-1000.00,8000.00,9000.00,3130.22,6869.78,0.03,0
52600,5292,-1000.00,7000.00,8000.00,3257.00,5743.00,0.25,0
52601,5292,-1000.00,6000.00,7000.00,0.00,8000.00,0.14,0
52602,5292,-1000.00,5000.00,6000.00,0.00,4201.39,0.21,0
52603,5292,-1000.00,4000.00,5000.00,0.00,4087.68,0.36,0
52604,5292,-1000.00,3000.00,4000.00,0.00,3728.33,0.41,0
52605,5292,-1000.00,2000.00,3000.00,0.00,4000.00,0.36,0
52606,5292,-1000.00,1000.00,2000.00,0.00,2860.88,0.30,0
52607,5292,-1000.00,0.00,1000.00,229.98,1770.02,0.37,0
52608,5292,-1000.00,-1000.00,0.00,0.00,1000.00,0.39,0
52609,5293,-1000.00,-1000.00,0.00,185.86,814.14,0.37,0
52610,5294,-243.02,-243.02,756.98,41.47,201.55,0.44,0
52611,5294,-411.60,-654.61,345.39,0.00,411.60,0.18,0
52612,5294,-224.28,-878.90,121.10,0.00,224.28,0.34,0
52613,5294,-78.85,-957.75,42.25,0.00,78.85,0.32,0
52614,5294,-42.25,-1000.00,0.00,0.00,42.25,0.42,0
52615,5295,1000.00,1000.00,2000.00,0.00,1000.00,0.36,1
52616,5295,0.00,1000.00,2000.00,0.00,0.00,0.05,0
52617,5295,1000.00,2000.00,3000.00,930.43,1069.57,0.15,1
52618,5295,1000.00,3000.00,4000.00,374.36,2625.64,0.30,1
52619,5295,1000.00,4000.00,5000.00,0.00,4000.00,0.33,1
52620,5295,1000.00,5000.00,6000.00,0.00,5000.00,0.04,1
52621,5295,0.00,5000.00,6000.00,0.00,0.00,0.10,0
52622,5295,1000.00,6000.00,7000.00,1935.43,4064.57,0.33,1
52623,5295,1000.00,7000.00,8000.00,0.00,7000.00,0.20,1
52624,5295,-1000.00,6000.00,7000.00,4131.06,3868.94,0.06,0
52625,5295,1000.00,7000.00,8000.00,1031.96,5968.04,0.07,1
52626,5295,1000.00,8000.00,9000.00,0.00,8000.00,0.42,1
52627,5295,1000.00,9000.00,10000.00,0.00,4781.10,0.17,1
52628,5295,1000.00,10000.00,11000.00,3405.73,6594.27,0.33,1
52629,5295,-1000.00,9000.00,10000.00,8609.15,589.38,0.05,0
52630,5295,1000.00,10000.00,11000.00,0.00,8714.28,0.18,1
52631,5295,1000.00,11000.00,12000.00,0.00,5442.08,0.31,1
52632,5295,1000.00,12000.00,13000.00,0.00,12000.00,0.30,1
52633,5295,1000.00,13000.00,14000.00,0.00,11724.81,0.05,1
52634,5295,1000.00,14000.00,15000.00,0.00,6271.72,0.05,1
52635,5295,1000.00,15000.00,16000.00,0.00,10853.15,0.38,1
52636,5295,1000.00,16000.00,17000.00,0.00,16000.00,0.43,1
52637,5295,-1000.00,15000.00,16000.00,9806.53,7193.47,0.15,0
52638,5295,1000.00,16000.00,17000.00,7847.20,8152.80,0.05,1
52639,5295,-1000.00,15000.00,16000.00,1099.75,10170.95,0.35,0
52640,5295,-1000.00,14000.00,15000.00,2394.25,13605.75,0.42,0
52641,5295,-1000.00,13000.00,14000.00,5168.45,9831.55,0.29,0
52642,5295,-1000.00,12000.00,13000.00,3331.12,10668.88,0.25,0
52643,5295,-1000.00,11000.00,12000.00,989.61,12010.39,0.43,0
52644,5295,-1000.00,10000.00,11000.00,0.00,12000.00,0.18,0
52645,5295,-1000.00,9000.00,10000.00,0.00,11000.00,0.33,0
52646,5295,-1000.00,8000.00,9000.00,468.65,9531.35,0.39,0
52647,5295,-1000.00,7000.00,8000.00,2846.62,6153.38,0.33,0
52648,5295,-1000.00,6000.00,7000.00,0.00,8000.00,0.19,0
52649,5295,-1000.00,5000.00,6000.00,0.00,2444.94,0.06,0
52650,5295,-1000.00,4000.00,5000.00,0.00,6000.00,0.34,0
52651,5295,-1000.00,3000.00,4000.00,0.00,5000.00,0.42,0
52652,5295,-1000.00,2000.00,3000.00,0.00,4000.00,0.06,0
52653,5295,-1000.00,1000.00,2000.00,1070.62,653.15,0.16,0
52654,5295,-1000.00,0.00,1000.00,568.28,1431.72,0.36,0
52655,5295,-341.67,-341.67,658.33,0.00,341.67,0.20,0
52656,5295,-237.44,-579.10,420.90,0.00,237.44,0.23,0
52657,5295,-420.90,-1000.00,0.00,9.82,411.07,0.44,0
52658,5296,1000.00,1000.00,2000.00,509.58,490.42,0.19,1
52659,5296,-1000.00,0.00,1000.00,0.00,1618.13,0.36,0
52660,5296,-106.50,-106.50,893.50,0.00,106.50,0.24,0
52661,5296,-812.34,-918.84,81.16,0.00,812.34,0.43,0
52662,5296,-81.16,-1000.00,0.00,19.94,61.22,0.38,0
52663,5297,1000.00,1000.00,2000.00,0.00,958.85,0.42,1
52664,5297,1000.00,2000.00,3000.00,0.00,1612.43,0.41,1
52665,5297,1000.00,3000.00,4000.00,266.43,2733.57,0.14,1
52666,5297,1000.00,4000.00,5000.00,0.00,2501.69,0.26,1
52667,5297,1000.00,5000.00,6000.00,318.80,2245.89,0.29,1
52668,5297,1000.00,6000.00,7000.00,0.00,2502.15,0.24,1
52669,5297,1000.00,7000.00,8000.00,0.00,7000.00,0.01,1
52670,5297,1000.00,8000.00,9000.00,3056.17,4943.83,0.22,1
52671,5297,1000.00,9000.00,10000.00,1967.18,7032.82,0.21,1
52672,5297,1000.00,10000.00,11000.00,0.00,7023.00,0.35,1
52673,5297,1000.00,11000.00,12000.00,5376.39,5623.61,0.10,1
52674,5297,1000.00,12000.00,13000.00,0.00,9901.62,0.19,1
52675,5297,1000.00,13000.00,14000.00,2422.94,10577.06,0.21,1
52676,5297,1000.00,14000.00,15000.00,0.00,14000.00,0.38,1
52677,5297,1000.00,15000.00,16000.00,898.56,14101.44,0.43,1
52678,5297,1000.00,16000.00,17000.00,6984.89,9015.11,0.05,1
52679,5297,1000.00,17000.00,18000.00,5591.13,11408.87,0.29,1
52680,5297,1000.00,18000.00,19000.00,3511.01,6211.65,0.23,1
52681,5297,1000.00,19000.00,20000.00,5365.43,9192.70,0.27,1
52682,5297,1000.00,20000.00,21000.00,0.00,17954.48,0.08,1
52683,5297,1000.00,21000.00,22000.00,4516.49,16483.51,0.38,1
52684,5297,1000.00,22000.00,23000.00,0.00,22000.00,0.35,1
52685,5297,1000.00,23000.00,24000.00,10247.13,12752.87,0.06,1
52686,5297,1000.00,24000.00,25000.00,5555.47,18444.53,0.29,1
52687,5297,1000.00,25000.00,26000.00,0.00,25000.00,0.19,1
52688,5297,1000.00,26000.00,27000.00,10704.75,15295.25,0.28,1
52689,5297,1000.00,27000.00,28000.00,0.00,3224.11,0.10,1
52690,5297,1000.00,28000.00,29000.00,14000.00,14000.00,0.02,1
52691,5297,1000.00,29000.00,30000.00,1316.49,22201.49,0.41,1
52692,5297,1000.00,30000.00,31000.00,0.00,30000.00,0.27,1
52693,5297,1000.00,31000.00,32000.00,0.00,31000.00,0.03,1
52694,5297,1000.00,32000.00,33000.00,15935.14,16064.86,0.02,1
52695,5297,1000.00,33000.00,34000.00,2734.90,30265.10,0.29,1
52696,5297,1000.00,34000.00,35000.00,17000.00,17000.00,0.10,1
52697,5297,1000.00,35000.00,36000.00,0.00,22691.37,0.37,1
52698,5297,1000.00,36000.00,37000.00,8647.52,27352.48,0.35,1
52699,5297,1000.00,37000.00,38000.00,0.00,37000.00,0.01,1
52700,5297,1000.00,38000.00,39000.00,11714.41,13279.17,0.22,1
52701,5297,1000.00,39000.00,40000.00,0.00,18609.98,0.27,1
52702,5297,1000.00,40000.00,41000.00,10587.73,29412.27,0.38,1
52703,5297,1000.00,41000.00,42000.00,20500.00,20500.00,0.02,1
52704,5297,1000.00,42000.00,43000.00,4369.62,37630.38,0.24,1
52705,5297,1000.00,43000.00,44000.00,0.00,35186.83,0.42,1
52706,5297,1000.00,44000.00,45000.00,22000.00,22000.00,0.10,1
52707,5297,-1000.00,43000.00,44000.00,29248.66,15588.75,0.14,0
52708,5297,1000.00,44000.00,45000.00,0.00,44000.00,0.07,1
52709,5298,-1000.00,-1000.00,0.00,0.00,1000.00,0.03,0
52710,5299,-1000.00,-1000.00,0.00,500.00,500.00,0.01,0
52711,5300,-99.21,-99.21,900.79,0.00,99.21,0.11,0
52712,5300,-900.79,-1000.00,0.00,0.00,900.79,0.32,0
52713,5301,-727.26,-727.26,272.74,321.38,405.87,0.25,0
52714,5301,-272.74,-1000.00,0.00,0.00,272.74,0.08,0
52715,5302,-1000.00,-1000.00,0.00,375.65,588.93,0.23,0
52716,5303,1000.00,1000.00,2000.00,320.19,0.00,0.04,1
52717,5303,-132.67,867.33,1867.33,0.00,132.67,0.33,0
52718,5303,-1000.00,-132.67,867.33,456.30,1411.02,0.09,0
52719,5303,1000.00,867.33,1867.33,256.11,0.00,0.09,1
52720,5303,-1000.00,-132.67,867.33,0.00,1867.33,0.14,0
52721,5303,-867.33,-1000.00,0.00,0.00,867.33,0.03,0
52722,5304,1000.00,1000.00,2000.00,0.00,1000.00,0.18,1
52723,5304,1000.00,2000.00,3000.00,0.00,1811.34,0.34,1
52724,5304,1000.00,3000.00,4000.00,0.00,3000.00,0.10,1
52725,5304,1000.00,4000.00,5000.00,0.00,4000.00,0.11,1
52726,5304,1000.00,5000.00,6000.00,1880.64,3119.36,0.29,1
52727,5304,1000.00,6000.00,7000.00,2067.42,3932.58,0.27,1
52728,5304,1000.00,7000.00,8000.00,175.07,6100.57,0.43,1
52729,5304,1000.00,8000.00,9000.00,0.00,8000.00,0.40,1
52730,5304,1000.00,9000.00,10000.00,0.00,7544.73,0.43,1
52731,5304,1000.00,10000.00,11000.00,0.00,10000.00,0.14,1
52732,5304,1000.00,11000.00,12000.00,0.00,9573.04,0.42,1
52733,5304,1000.00,12000.00,13000.00,1115.73,3497.56,0.22,1
52734,5304,1000.00,13000.00,14000.00,5714.42,7285.58,0.20,1
52735,5304,1000.00,14000.00,15000.00,0.00,9653.90,0.10,1
52736,5304,1000.00,15000.00,16000.00,6357.61,8642.39,0.25,1
52737,5304,1000.00,16000.00,17000.00,0.00,14070.58,0.09,1
52738,5304,1000.00,17000.00,18000.00,0.00,9762.47,0.28,1
52739,5304,1000.00,18000.00,19000.00,0.00,15516.71,0.41,1
52740,5304,1000.00,19000.00,20000.00,5623.81,13376.19,0.35,1
52741,5304,-1000.00,18000.00,19000.00,3598.50,1837.52,0.14,0
52742,5304,1000.00,19000.00,20000.00,2873.43,16126.57,0.42,1
52743,5304,1000.00,20000.00,21000.00,0.00,7180.92,0.20,1
52744,5304,1000.00,21000.00,22000.00,2385.19,18587.23,0.43,1
52745,5304,1000.00,22000.00,23000.00,0.00,14159.58,0.27,1
52746,5304,-1000.00,21000.00,22000.00,3173.99,19826.01,0.42,0
52747,5304,-1000.00,20000.00,21000.00,0.00,22000.00,0.30,0
52748,5304,-1000.00,19000.00,20000.00,0.00,2047.97,0.12,0
52749,5304,-1000.00,18000.00,19000.00,0.00,20000.00,0.17,0
52750,5304,-1000.00,17000.00,18000.00,0.00,19000.00,0.40,0
52751,5304,-1000.00,16000.00,17000.00,15771.29,2228.71,0.05,0
52752,5304,-1000.00,15000.00,16000.00,0.00,10089.44,0.34,0
52753,5304,-1000.00,14000.00,15000.00,6344.13,9655.87,0.28,0
52754,5304,-1000.00,13000.00,14000.00,5040.59,9100.37,0.30,0
52755,5304,-1000.00,12000.00,13000.00,0.00,14000.00,0.17,0
52756,5304,-1000.00,11000.00,12000.00,0.00,13000.00,0.04,0
52757,5304,-1000.00,10000.00,11000.00,0.00,8455.91,0.17,0
52758,5304,-1000.00,9000.00,10000.00,0.00,11000.00,0.06,0
52759,5304,-1000.00,8000.00,9000.00,2949.61,7050.39,0.23,0
52760,5304,-1000.00,7000.00,8000.00,0.00,7004.85,0.33,0
52761,5304,-1000.00,6000.00,7000.00,1215.53,4907.81,0.35,0
52762,5304,-1000.00,5000.00,6000.00,1778.56,1849.09,0.19,0
52763,5305,-769.38,-769.38,230.62,0.00,769.38,0.27,0
52764,5305,1000.00,230.62,1230.62,31.38,0.00,0.21,1
52765,5305,-1000.00,-769.38,230.62,0.00,1230.62,0.25,0
52766,5305,-230.62,-1000.00,0.00,48.43,182.18,0.38,0
52767,5306,-105.36,-105.36,894.64,0.00,105.36,0.24,0
52768,5306,-562.85,-668.21,331.79,0.00,562.85,0.22,0
52769,5306,1000.00,331.79,1331.79,69.82,0.00,0.27,1
52770,5306,-1000.00,-668.21,331.79,0.00,1331.79,0.33,0
52771,5306,-331.79,-1000.00,0.00,0.00,331.79,0.06,0
52772,5307,-1000.00,-1000.00,0.00,290.45,302.00,0.23,0
52773,5308,-410.70,-410.70,589.30,18.72,391.98,0.27,0
52774,5308,-545.59,-956.29,43.71,68.37,477.22,0.41,0
52775,5308,-39.18,-995.47,4.53,17.27,21.91,0.25,0
52776,5308,-4.53,-1000.00,0.00,0.56,3.98,0.42,0
52777,5309,-790.51,-790.51,209.49,0.00,790.51,0.39,0
52778,5309,0.00,-790.51,209.49,0.00,0.00,0.00,0
52779,5309,-209.49,-1000.00,0.00,0.00,209.49,0.30,0
52780,5310,-1000.00,-1000.00,0.00,0.00,1000.00,0.04,0
52781,5311,-1000.00,-1000.00,0.00,114.71,885.29,0.42,0
52782,5312,-88.65,-88.65,911.35,88.65,0.00,0.04,0
52783,5312,0.00,-88.65,911.35,0.00,0.00,0.31,0
52784,5312,-911.35,-1000.00,0.00,596.79,314.56,0.17,0
52785,5313,-1000.00,-1000.00,0.00,520.20,479.80,0.15,0
52786,5314,-399.53,-399.53,600.47,0.00,399.53,0.20,0
52787,5314,-256.33,-655.86,344.14,0.00,256.33,0.27,0
52788,5314,-344.14,-1000.00,0.00,46.22,297.93,0.41,0
52789,5315,1000.00,1000.00,2000.00,0.00,243.04,0.19,1
52790,5315,1000.00,2000.00,3000.00,1000.00,1000.00,0.05,1
52791,5315,1000.00,3000.00,4000.00,134.04,2865.96,0.44,1
52792,5315,-1000.00,2000.00,3000.00,2085.87,1914.13,0.11,0
52793,5315,1000.00,3000.00,4000.00,0.00,2721.82,0.34,1
52794,5315,1000.00,4000.00,5000.00,2000.00,2000.00,0.06,1
52795,5315,1000.00,5000.00,6000.00,0.00,4554.85,0.40,1
52796,5315,1000.00,6000.00,7000.00,0.00,6000.00,0.22,1
52797,5315,1000.00,7000.00,8000.00,1963.37,5036.63,0.37,1
52798,5315,1000.00,8000.00,9000.00,0.00,3634.21,0.29,1
52799,5315,0.00,8000.00,9000.00,0.00,0.00,0.09,0
52800,5315,1000.00,9000.00,10000.00,4500.00,4500.00,0.00,1
52801,5315,1000.00,10000.00,11000.00,2995.16,3931.66,0.23,1
52802,5315,1000.00,11000.00,12000.00,2842.63,8157.37,0.23,1
52803,5315,1000.00,12000.00,13000.00,0.00,634.77,0.13,1
52804,5315,1000.00,13000.00,14000.00,3829.20,9170.80,0.35,1
52805,5315,1000.00,14000.00,15000.00,0.00,14000.00,0.06,1
52806,5315,-1000.00,13000.00,14000.00,8695.20,6304.80,0.13,0
52807,5315,-1000.00,12000.00,13000.00,9595.77,0.00,0.03,0
52808,5315,-1000.00,11000.00,12000.00,6754.25,6245.75,0.01,0
52809,5315,1000.00,12000.00,13000.00,2991.29,3432.07,0.20,1
52810,5315,-1000.00,11000.00,12000.00,0.00,9834.98,0.29,0
52811,5315,-1000.00,10000.00,11000.00,2815.11,9184.89,0.39,0
52812,5315,-1000.00,9000.00,10000.00,6357.75,4642.25,0.12,0
52813,5315,-1000.00,8000.00,9000.00,4161.87,5838.13,0.14,0
52814,5315,-1000.00,7000.00,8000.00,0.00,9000.00,0.09,0
52815,5315,-1000.00,6000.00,7000.00,1732.09,6267.91,0.39,0
52816,5315,-1000.00,5000.00,6000.00,2795.91,4204.09,0.23,0
52817,5315,-1000.00,4000.00,5000.00,0.00,3148.85,0.03,0
52818,5315,-1000.00,3000.00,4000.00,0.00,3640.54,0.03,0
52819,5315,-1000.00,2000.00,3000.00,0.00,4000.00,0.20,0
52820,5315,-668.00,1332.00,2332.00,0.00,668.00,0.11,0
52821,5315,-279.21,1052.79,2052.79,0.00,279.21,0.15,0
52822,5315,-1000.00,52.79,1052.79,0.00,2052.79,0.15,0
52823,5315,-1000.00,-947.21,52.79,222.33,830.46,0.33,0
52824,5315,-1000.00,-1947.21,-947.21,32.06,20.74,0.09,0
52825,5316,-1000.00,-1000.00,0.00,212.93,787.07,0.22,0
52826,5317,0.00,0.00,1000.00,0.00,0.00,0.40,0
52827,5317,-1000.00,-1000.00,0.00,0.00,214.25,0.26,0
52828,5318,1000.00,1000.00,2000.00,0.00,1000.00,0.12,1
52829,5318,1000.00,2000.00,3000.00,0.00,2000.00,0.30,1
52830,5318,1000.00,3000.00,4000.00,0.00,1828.53,0.10,1
52831,5318,1000.00,4000.00,5000.00,2000.00,2000.00,0.09,1
52832,5318,1000.00,5000.00,6000.00,0.00,5000.00,0.39,1
52833,5318,1000.00,6000.00,7000.00,0.00,6000.00,0.04,1
52834,5318,1000.00,7000.00,8000.00,0.00,5562.92,0.31,1
52835,5318,1000.00,8000.00,9000.00,0.00,8000.00,0.21,1
52836,5318,1000.00,9000.00,10000.00,0.00,9000.00,0.17,1
52837,5318,1000.00,10000.00,11000.00,0.00,10000.00,0.16,1
52838,5318,-1000.00,9000.00,10000.00,4478.84,2587.90,0.16,0
52839,5318,1000.00,10000.00,11000.00,0.00,10000.00,0.32,1
52840,5318,1000.00,11000.00,12000.00,1265.37,9734.63,0.35,1
52841,5318,-1000.00,10000.00,11000.00,6127.48,5872.52,0.03,0
52842,5318,-1000.00,9000.00,10000.00,1864.73,1356.41,0.15,0
52843,5318,1000.00,10000.00,11000.00,0.00,10000.00,0.01,1
52844,5318,1000.00,11000.00,12000.00,4615.06,6384.94,0.19,1
52845,5318,1000.00,12000.00,13000.00,0.00,12000.00,0.25,1
52846,5318,1000.00,13000.00,14000.00,3014.05,9985.95,0.13,1
52847,5318,-1000.00,12000.00,13000.00,5276.44,8723.56,0.35,0
52848,5318,-1000.00,11000.00,12000.00,0.00,2628.07,0.18,0
52849,5318,-1000.00,10000.00,11000.00,6000.00,6000.00,0.04,0
52850,5318,-1000.00,9000.00,10000.00,0.00,11000.00,0.34,0
52851,5318,-1000.00,8000.00,9000.00,0.00,1580.41,0.12,0
52852,5318,-1000.00,7000.00,8000.00,0.00,8723.99,0.37,0
52853,5318,-1000.00,6000.00,7000.00,0.00,5778.49,0.00,0
52854,5318,-1000.00,5000.00,6000.00,0.00,7000.00,0.30,0
52855,5318,-1000.00,4000.00,5000.00,0.00,5240.51,0.15,0
52856,5318,-1000.00,3000.00,4000.00,1277.21,3722.79,0.38,0
52857,5318,-1000.00,2000.00,3000.00,413.59,3586.41,0.35,0
52858,5318,-1000.00,1000.00,2000.00,2312.52,687.48,0.06,0
52859,5318,-1000.00,0.00,1000.00,862.14,1137.86,0.26,0
52860,5318,-1000.00,-1000.00,0.00,404.51,595.49,0.23,0
52861,5319,-1000.00,-1000.00,0.00,0.00,1000.00,0.28,0
52862,5320,-1000.00,-1000.00,0.00,717.75,282.25,0.19,0
52863,5321,-1000.00,-1000.00,0.00,0.00,1000.00,0.20,0
52864,5322,-1000.00,-1000.00,0.00,486.03,513.97,0.15,0
52865,5323,1000.00,1000.00,2000.00,0.00,1000.00,0.21,1
52866,5323,1000.00,2000.00,3000.00,0.00,1354.58,0.30,1
52867,5323,1000.00,3000.00,4000.00,0.00,3000.00,0.43,1
52868,5323,1000.00,4000.00,5000.00,1851.26,2148.74,0.23,1
52869,5323,1000.00,5000.00,6000.00,0.00,5000.00,0.40,1
52870,5323,1000.00,6000.00,7000.00,779.41,5220.59,0.41,1
52871,5323,1000.00,7000.00,8000.00,3077.41,3922.59,0.18,1
52872,5323,1000.00,8000.00,9000.00,0.00,5796.18,0.39,1
52873,5323,0.00,8000.00,9000.00,0.00,0.00,0.03,0
52874,5323,1000.00,9000.00,10000.00,3071.95,5928.05,0.05,1
52875,5323,1000.00,10000.00,11000.00,359.98,9640.02,0.28,1
52876,5323,1000.00,11000.00,12000.00,0.00,11000.00,0.33,1
52877,5323,1000.00,12000.00,13000.00,0.00,6197.38,0.28,1
52878,5323,1000.00,13000.00,14000.00,0.00,13000.00,0.29,1
52879,5323,1000.00,14000.00,15000.00,3377.22,10622.78,0.19,1
52880,5323,0.00,14000.00,15000.00,0.00,0.00,0.00,0
52881,5323,1000.00,15000.00,16000.00,0.00,15000.00,0.33,1
52882,5323,1000.00,16000.00,17000.00,0.00,16000.00,0.23,1
52883,5323,1000.00,17000.00,18000.00,0.00,8844.87,0.27,1
52884,5323,1000.00,18000.00,19000.00,596.95,3589.68,0.18,1
52885,5323,1000.00,19000.00,20000.00,8233.72,10766.28,0.38,1
52886,5323,1000.00,20000.00,21000.00,0.00,5843.06,0.22,1
52887,5323,1000.00,21000.00,22000.00,0.00,21000.00,0.43,1
52888,5323,1000.00,22000.00,23000.00,5574.86,16425.14,0.16,1
52889,5323,1000.00,23000.00,24000.00,0.00,13738.33,0.23,1
52890,5323,1000.00,24000.00,25000.00,0.00,22440.31,0.42,1
52891,5323,1000.00,25000.00,26000.00,0.00,25000.00,0.26,1
52892,5323,1000.00,26000.00,27000.00,0.00,26000.00,0.40,1
52893,5323,1000.00,27000.00,28000.00,0.00,27000.00,0.04,1
52894,5323,1000.00,28000.00,29000.00,0.00,28000.00,0.25,1
52895,5323,-1000.00,27000.00,28000.00,15117.48,13882.52,0.11,0
52896,5323,1000.00,28000.00,29000.00,10783.67,17216.33,0.30,1
52897,5323,1000.00,29000.00,30000.00,9785.10,19214.90,0.30,1
52898,5323,1000.00,30000.00,31000.00,0.00,30000.00,0.37,1
52899,5323,1000.00,31000.00,32000.00,0.00,31000.00,0.17,1
52900,5323,1000.00,32000.00,33000.00,0.00,32000.00,0.36,1
52901,5323,1000.00,33000.00,34000.00,0.00,33000.00,0.23,1
52902,5323,1000.00,34000.00,35000.00,937.23,31970.66,0.44,1
52903,5323,1000.00,35000.00,36000.00,0.00,35000.00,0.37,1
52904,5323,-1000.00,34000.00,35000.00,18003.90,17996.10,0.18,0
52905,5323,1000.00,35000.00,36000.00,0.00,35000.00,0.03,1
52906,5323,1000.00,36000.00,37000.00,17232.85,18767.15,0.20,1
52907,5323,1000.00,37000.00,38000.00,493.03,18217.96,0.31,1
52908,5323,1000.00,38000.00,39000.00,17947.77,20052.23,0.04,1
52909,5323,-1000.00,37000.00,38000.00,19500.00,19500.00,0.23,0
52910,5323,-1000.00,36000.00,37000.00,21811.46,16188.54,0.15,0
52911,5323,-1000.00,35000.00,36000.00,0.00,29302.50,0.34,0
52912,5323,-1000.00,34000.00,35000.00,18000.00,18000.00,0.41,0
52913,5323,-1000.00,33000.00,34000.00,10588.70,24411.30,0.35,0
52914,5323,-1000.00,32000.00,33000.00,11498.71,22501.29,0.11,0
52915,5323,-1000.00,31000.00,32000.00,3910.41,29089.59,0.31,0
52916,5323,-1000.00,30000.00,31000.00,0.00,32000.00,0.31,0
52917,5323,-1000.00,29000.00,30000.00,9408.85,21591.15,0.18,0
52918,5323,-1000.00,28000.00,29000.00,0.00,30000.00,0.00,0
52919,5323,-1000.00,27000.00,28000.00,0.00,11079.06,0.13,0
52920,5323,-1000.00,26000.00,27000.00,7056.37,20943.63,0.24,0
52921,5323,-1000.00,25000.00,26000.00,3741.83,23258.17,0.22,0
52922,5323,0.00,25000.00,26000.00,0.00,0.00,0.01,0
52923,5323,-1000.00,24000.00,25000.00,7906.33,18093.67,0.29,0
52924,5323,-1000.00,23000.00,24000.00,9173.84,15826.16,0.40,0
52925,5323,-1000.00,22000.00,23000.00,11852.72,12147.28,0.11,0
52926,5323,-1000.00,21000.00,22000.00,0.00,23000.00,0.07,0
52927,5323,-1000.00,20000.00,21000.00,2367.42,19632.58,0.30,0
52928,5323,-1000.00,19000.00,20000.00,4409.28,16590.72,0.19,0
52929,5323,-1000.00,18000.00,19000.00,0.00,19232.01,0.23,0
52930,5323,-1000.00,17000.00,18000.00,9336.30,0.00,0.04,0
52931,5323,-1000.00,16000.00,17000.00,0.00,17986.49,0.40,0
52932,5323,-1000.00,15000.00,16000.00,2962.49,14037.51,0.33,0
52933,5324,1000.00,1000.00,2000.00,0.00,1000.00,0.26,1
52934,5324,1000.00,2000.00,3000.00,868.84,1131.16,0.06,1
52935,5324,1000.00,3000.00,4000.00,25.58,2974.42,0.19,1
52936,5324,1000.00,4000.00,5000.00,669.92,944.03,0.11,1
52937,5324,1000.00,5000.00,6000.00,0.00,5000.00,0.35,1
52938,5324,1000.00,6000.00,7000.00,2118.27,3881.73,0.06,1
52939,5324,1000.00,7000.00,8000.00,0.00,4883.30,0.11,1
52940,5324,1000.00,8000.00,9000.00,535.88,5235.09,0.37,1
52941,5324,1000.00,9000.00,10000.00,0.00,9000.00,0.07,1
52942,5324,-1000.00,8000.00,9000.00,5578.25,4421.75,0.14,0
52943,5324,1000.00,9000.00,10000.00,3888.65,5111.35,0.24,1
52944,5324,1000.00,10000.00,11000.00,5000.00,5000.00,0.43,1
52945,5324,1000.00,11000.00,12000.00,1731.49,9268.51,0.37,1
52946,5324,1000.00,12000.00,13000.00,163.06,6134.17,0.32,1
52947,5324,1000.00,13000.00,14000.00,0.00,2132.99,0.03,1
52948,5324,-1000.00,12000.00,13000.00,3909.33,10090.67,0.02,0
52949,5324,-1000.00,11000.00,12000.00,0.00,13000.00,0.35,0
52950,5324,-1000.00,10000.00,11000.00,2388.12,9611.88,0.40,0
52951,5324,-1000.00,9000.00,10000.00,0.00,11000.00,0.38,0
52952,5324,-1000.00,8000.00,9000.00,0.00,10000.00,0.39,0
52953,5324,-1000.00,7000.00,8000.00,0.00,6818.98,0.41,0
52954,5324,-1000.00,6000.00,7000.00,5761.41,2238.59,0.07,0
52955,5324,-1000.00,5000.00,6000.00,2429.98,4570.02,0.33,0
52956,5324,-1000.00,4000.00,5000.00,2884.80,3115.20,0.18,0
52957,5324,-1000.00,3000.00,4000.00,0.00,3856.34,0.41,0
52958,5324,-1000.00,2000.00,3000.00,0.00,4000.00,0.04,0
52959,5324,-1000.00,1000.00,2000.00,769.54,2230.46,0.30,0
52960,5324,-1000.00,0.00,1000.00,0.00,2000.00,0.02,0
52961,5324,-1000.00,-1000.00,0.00,0.00,1000.00,0.05,0
52962,5325,-1000.00,-1000.00,0.00,128.00,872.00,0.15,0
52963,5325,-0.00,-1000.00,-0.00,0.00,0.00,0.13,0
52964,5326,-597.74,-597.74,402.26,0.00,597.74,0.00,0
52965,5326,-402.26,-1000.00,0.00,187.17,215.08,0.02,0
52966,5327,1000.00,1000.00,2000.00,528.33,0.00,0.30,1
52967,5327,0.00,1000.00,2000.00,0.00,0.00,0.22,0
52968,5327,-1000.00,0.00,1000.00,0.00,1291.88,0.37,0
52969,5327,0.00,0.00,1000.00,0.00,0.00,0.35,0
52970,5327,-1000.00,-1000.00,0.00,0.00,1000.00,0.08,0
52971,5328,0.00,0.00,1000.00,0.00,1000.00,0.29,0
52972,5328,0.00,0.00,1000.00,0.00,1000.00,0.12,0
52973,5328,0.00,0.00,1000.00,330.18,669.82,0.34,0
52974,5328,-1000.00,-1000.00,0.00,535.22,464.78,0.07,0
52975,5329,-1000.00,-1000.00,0.00,163.01,836.99,0.11,0
52976,5330,-1000.00,-1000.00,0.00,328.49,671.51,0.32,0
52977,5331,-906.60,-906.60,93.40,9.94,896.66,0.44,0
52978,5331,-93.40,-1000.00,0.00,1.98,91.42,0.26,0
52979,5332,-845.60,-845.60,154.40,0.00,845.60,0.35,0
52980,5332,-154.40,-1000.00,0.00,0.00,154.40,0.18,0
52981,5333,-1000.00,-1000.00,0.00,0.00,732.04,0.22,0
52982,5334,1000.00,1000.00,2000.00,500.00,500.00,0.07,1
52983,5334,1000.00,2000.00,3000.00,460.23,1539.77,0.33,1
52984,5334,1000.00,3000.00,4000.00,1500.00,1500.00,0.02,1
52985,5334,1000.00,4000.00,5000.00,0.00,4000.00,0.32,1
52986,5334,1000.00,5000.00,6000.00,530.00,4470.00,0.34,1
52987,5334,1000.00,6000.00,7000.00,3000.00,3000.00,0.04,1
52988,5334,1000.00,7000.00,8000.00,1821.17,5178.83,0.27,1
52989,5334,1000.00,8000.00,9000.00,0.00,6321.48,0.38,1
52990,5334,1000.00,9000.00,10000.00,0.00,9000.00,0.38,1
52991,5334,1000.00,10000.00,11000.00,0.00,10000.00,0.17,1
52992,5334,-1000.00,9000.00,10000.00,9684.06,1315.94,0.02,0
52993,5334,1000.00,10000.00,11000.00,0.00,6334.04,0.14,1
52994,5334,1000.00,11000.00,12000.00,0.00,6123.22,0.32,1
52995,5334,1000.00,12000.00,13000.00,32.26,11967.74,0.24,1
52996,5334,1000.00,13000.00,14000.00,0.00,13000.00,0.42,1
52997,5334,1000.00,14000.00,15000.00,1915.38,3878.66,0.21,1
52998,5334,1000.00,15000.00,16000.00,6316.33,8683.67,0.27,1
52999,5334,1000.00,16000.00,17000.00,6496.18,9503.82,0.27,1
53000,5334,1000.00,17000.00,18000.00,0.00,8910.07,0.28,1
53001,5334,1000.00,18000.00,19000.00,6089.64,11910.36,0.33,1
53002,5334,-1000.00,17000.00,18000.00,7844.74,0.00,0.06,0
53003,5334,1000.00,18000.00,19000.00,4914.36,10930.21,0.32,1
53004,5334,1000.00,19000.00,20000.00,0.00,15824.87,0.42,1
53005,5334,-1000.00,18000.00,19000.00,15271.54,4728.46,0.23,0
53006,5334,-1000.00,17000.00,18000.00,6792.35,12207.65,0.31,0
53007,5334,-1000.00,16000.00,17000.00,8138.42,9861.58,0.15,0
53008,5334,-1000.00,15000.00,16000.00,0.00,13560.33,0.40,0
53009,5334,-1000.00,14000.00,15000.00,7516.95,8483.05,0.15,0
53010,5334,-1000.00,13000.00,14000.00,4837.12,10162.88,0.29,0
53011,5334,-1000.00,12000.00,13000.00,0.00,8368.18,0.22,0
53012,5334,-1000.00,11000.00,12000.00,0.00,13000.00,0.37,0
53013,5334,-1000.00,10000.00,11000.00,0.00,7779.25,0.35,0
53014,5334,-1000.00,9000.00,10000.00,0.00,11000.00,0.40,0
53015,5334,-1000.00,8000.00,9000.00,0.00,10000.00,0.43,0
53016,5334,-1000.00,7000.00,8000.00,8350.36,0.00,0.02,0
53017,5334,-1000.00,6000.00,7000.00,0.00,3215.52,0.16,0
53018,5334,-1000.00,5000.00,6000.00,81.02,4863.88,0.39,0
53019,5334,-1000.00,4000.00,5000.00,610.33,3603.69,0.35,0
53020,5334,-1000.00,3000.00,4000.00,2324.37,1327.35,0.15,0
53021,5334,-1000.00,2000.00,3000.00,0.00,4000.00,0.17,0
53022,5334,-1000.00,1000.00,2000.00,558.09,0.00,0.09,0
53023,5334,-1000.00,0.00,1000.00,885.14,1114.86,0.27,0
53024,5334,-1000.00,-1000.00,0.00,0.00,1000.00,0.03,0
53025,5335,-1000.00,-1000.00,0.00,0.00,1000.00,0.06,0
53026,5336,1000.00,1000.00,2000.00,0.00,1000.00,0.38,1
53027,5336,1000.00,2000.00,3000.00,180.21,445.74,0.19,1
53028,5336,1000.00,3000.00,4000.00,0.00,1739.89,0.29,1
53029,5336,1000.00,4000.00,5000.00,1021.58,2978.42,0.34,1
53030,5336,1000.00,5000.00,6000.00,0.00,5000.00,0.35,1
53031,5336,1000.00,6000.00,7000.00,0.00,6000.00,0.03,1
53032,5336,1000.00,7000.00,8000.00,1439.79,4174.43,0.33,1
53033,5336,1000.00,8000.00,9000.00,0.00,2323.34,0.16,1
53034,5336,1000.00,9000.00,10000.00,33.95,2819.41,0.23,1
53035,5336,1000.00,10000.00,11000.00,0.00,10000.00,0.13,1
53036,5336,1000.00,11000.00,12000.00,0.00,10295.91,0.25,1
53037,5336,1000.00,12000.00,13000.00,0.00,9732.51,0.31,1
53038,5336,1000.00,13000.00,14000.00,2008.81,10991.19,0.21,1
53039,5336,-603.20,12396.80,13396.80,603.20,0.00,0.02,0
53040,5336,1000.00,13396.80,14396.80,3047.67,10349.13,0.00,1
53041,5336,1000.00,14396.80,15396.80,6722.59,7674.21,0.22,1
53042,5336,1000.00,15396.80,16396.80,0.00,9222.28,0.34,1
53043,5336,1000.00,16396.80,17396.80,0.00,3733.41,0.19,1
53044,5336,1000.00,17396.80,18396.80,0.00,11723.17,0.38,1
53045,5336,-1000.00,16396.80,17396.80,9455.57,8941.23,0.14,0
53046,5336,1000.00,17396.80,18396.80,0.00,10241.17,0.34,1
53047,5336,1000.00,18396.80,19396.80,4874.48,13522.32,0.14,1
53048,5336,1000.00,19396.80,20396.80,0.00,9835.04,0.13,1
53049,5336,-1000.00,18396.80,19396.80,10198.40,10198.40,0.40,0
53050,5336,-1000.00,17396.80,18396.80,4664.56,14732.24,0.09,0
53051,5336,-1000.00,16396.80,17396.80,9975.09,8421.71,0.11,0
53052,5336,-1000.00,15396.80,16396.80,5539.43,11857.37,0.34,0
53053,5336,-1000.00,14396.80,15396.80,0.00,7500.30,0.23,0
53054,5336,-1000.00,13396.80,14396.80,0.00,10027.47,0.37,0
53055,5336,-1000.00,12396.80,13396.80,1659.68,7368.38,0.31,0
53056,5336,-1000.00,11396.80,12396.80,1148.47,12248.33,0.34,0
53057,5336,-1000.00,10396.80,11396.80,0.00,9483.81,0.29,0
53058,5336,-1000.00,9396.80,10396.80,7274.02,4122.78,0.11,0
53059,5336,-1000.00,8396.80,9396.80,899.97,932.51,0.14,0
53060,5336,-1000.00,7396.80,8396.80,3990.15,5406.65,0.21,0
53061,5336,-1000.00,6396.80,7396.80,3931.83,4464.97,0.15,0
53062,5336,-1000.00,5396.80,6396.80,0.00,3900.71,0.23,0
53063,5336,-1000.00,4396.80,5396.80,608.03,5788.77,0.42,0
53064,5336,-1000.00,3396.80,4396.80,0.00,2604.42,0.10,0
53065,5336,-1000.00,2396.80,3396.80,736.16,3660.64,0.42,0
53066,5336,-1000.00,1396.80,2396.80,0.00,1970.09,0.09,0
53067,5336,-1000.00,396.80,1396.80,0.00,2396.80,0.08,0
53068,5336,-1000.00,-603.20,396.80,0.00,1396.80,0.29,0
53069,5336,-396.80,-1000.00,0.00,125.44,271.36,0.21,0
53070,5337,-775.29,-775.29,224.71,95.80,679.49,0.38,0
53071,5337,-224.71,-1000.00,0.00,0.00,224.71,0.22,0
53072,5338,-1000.00,-1000.00,0.00,0.00,1000.00,0.22,0
53073,5339,-1000.00,-1000.00,0.00,0.00,886.48,0.40,0
53074,5340,-1000.00,-1000.00,0.00,0.00,916.37,0.29,0
53075,5341,-826.28,-826.28,173.72,0.00,826.28,0.42,0
53076,5341,-131.91,-958.19,41.81,0.00,131.91,0.24,0
53077,5341,-41.68,-999.87,0.13,1.83,39.84,0.44,0
53078,5341,-0.13,-1000.00,0.00,0.03,0.10,0.14,0
53079,5342,-1000.00,-1000.00,0.00,50.39,22.69,0.12,0
53080,5343,-1000.00,-1000.00,0.00,530.32,469.68,0.06,0
53081,5344,-1000.00,-1000.00,0.00,0.00,1000.00,0.01,0
53082,5345,-1000.00,-1000.00,0.00,369.64,630.36,0.12,0
53083,5346,0.00,0.00,1000.00,0.00,0.00,0.01,0
53084,5346,-1000.00,-1000.00,0.00,0.00,1000.00,0.09,0
53085,5347,-640.15,-640.15,359.85,640.15,0.00,0.08,0
53086,5347,-244.39,-884.54,115.46,169.06,75.33,0.31,0
53087,5347,1000.00,115.46,1115.46,0.00,75.47,0.31,1
53088,5347,1000.00,1115.46,2115.46,557.73,557.73,0.03,1
53089,5347,1000.00,2115.46,3115.46,0.00,2115.46,0.25,1
53090,5347,1000.00,3115.46,4115.46,9.77,3105.69,0.42,1
53091,5347,1000.00,4115.46,5115.46,0.00,4115.46,0.21,1
53092,5347,-1000.00,3115.46,4115.46,4350.24,765.23,0.05,0
53093,5347,1000.00,4115.46,5115.46,0.00,4115.46,0.07,1
53094,5347,1000.00,5115.46,6115.46,0.00,5115.46,0.21,1
53095,5347,1000.00,6115.46,7115.46,2330.91,3784.55,0.29,1
53096,5347,1000.00,7115.46,8115.46,0.00,1826.34,0.20,1
53097,5347,1000.00,8115.46,9115.46,0.00,8115.46,0.03,1
53098,5347,1000.00,9115.46,10115.46,0.00,9115.46,0.18,1
53099,5347,1000.00,10115.46,11115.46,1366.71,6119.53,0.35,1
53100,5347,1000.00,11115.46,12115.46,4268.78,6846.68,0.25,1
53101,5347,1000.00,12115.46,13115.46,4113.88,7137.95,0.30,1
53102,5347,1000.00,13115.46,14115.46,1015.89,12099.57,0.41,1
53103,5347,-1000.00,12115.46,13115.46,7057.73,7057.73,0.09,0
53104,5347,-1000.00,11115.46,12115.46,6557.73,6557.73,0.02,0
53105,5347,-1000.00,10115.46,11115.46,6057.73,6057.73,0.06,0
53106,5347,-1000.00,9115.46,10115.46,0.00,11115.46,0.32,0
53107,5347,-1000.00,8115.46,9115.46,2728.26,7387.21,0.01,0
53108,5347,-1000.00,7115.46,8115.46,0.00,9115.46,0.29,0
53109,5347,-1000.00,6115.46,7115.46,4057.73,4057.73,0.07,0
53110,5347,-1000.00,5115.46,6115.46,1756.79,5358.67,0.37,0
53111,5347,-1000.00,4115.46,5115.46,0.00,6115.46,0.09,0
53112,5347,-1000.00,3115.46,4115.46,216.10,0.00,0.09,0
53113,5347,-366.87,2748.59,3748.59,0.00,366.87,0.13,0
53114,5347,-1000.00,1748.59,2748.59,0.00,3748.59,0.37,0
53115,5347,-1000.00,748.59,1748.59,0.00,2748.59,0.22,0
53116,5347,-1000.00,-251.41,748.59,777.35,971.25,0.03,0
53117,5347,-494.83,-746.23,253.77,198.57,296.26,0.24,0
53118,5347,-238.10,-984.33,15.67,0.00,238.10,0.12,0
53119,5347,-1000.00,-1984.33,-984.33,8.53,7.14,0.07,0
53120,5348,-1000.00,-1000.00,0.00,32.57,967.43,0.23,0
53121,5349,-1000.00,-1000.00,0.00,689.35,310.65,0.10,0
53122,5350,-1000.00,-1000.00,0.00,0.00,1000.00,0.22,0
53123,5351,-1000.00,-1000.00,0.00,214.48,785.52,0.22,0
53124,5352,-751.75,-751.75,248.25,331.59,420.16,0.25,0
53125,5352,-1000.00,-1751.75,-751.75,114.38,103.41,0.22,0
53126,5353,-179.94,-179.94,820.06,84.98,94.96,0.43,0
53127,5353,1000.00,820.06,1820.06,387.76,10.44,0.32,1
53128,5353,1000.00,1820.06,2820.06,1539.66,0.00,0.12,1
53129,5353,-1000.00,820.06,1820.06,1410.03,1410.03,0.04,0
53130,5353,-1000.00,-179.94,820.06,851.49,968.57,0.14,0
53131,5353,1000.00,820.06,1820.06,820.06,0.00,0.01,1
53132,5353,-1000.00,-179.94,820.06,0.00,1606.93,0.41,0
53133,5353,-820.06,-1000.00,0.00,88.57,731.49,0.39,0
53134,5354,1000.00,1000.00,2000.00,248.76,751.24,0.38,1
53135,5354,1000.00,2000.00,3000.00,439.95,1560.05,0.31,1
53136,5354,1000.00,3000.00,4000.00,51.53,379.28,0.15,1
53137,5354,1000.00,4000.00,5000.00,1509.09,2490.91,0.26,1
53138,5354,1000.00,5000.00,6000.00,761.53,4238.47,0.42,1
53139,5354,1000.00,6000.00,7000.00,0.00,4425.31,0.31,1
53140,5354,1000.00,7000.00,8000.00,45.37,1971.16,0.22,1
53141,5354,-1000.00,6000.00,7000.00,5097.50,2902.50,0.12,0
53142,5354,1000.00,7000.00,8000.00,1796.70,2821.82,0.25,1
53143,5354,-1000.00,6000.00,7000.00,5743.51,2256.49,0.09,0
53144,5354,1000.00,7000.00,8000.00,0.00,7000.00,0.17,1
53145,5354,1000.00,8000.00,9000.00,1590.54,6409.46,0.37,1
53146,5354,1000.00,9000.00,10000.00,0.00,9000.00,0.12,1
53147,5354,1000.00,10000.00,11000.00,4191.86,5808.14,0.26,1
53148,5354,1000.00,11000.00,12000.00,0.00,11000.00,0.13,1
53149,5354,1000.00,12000.00,13000.00,0.00,12000.00,0.38,1
53150,5354,1000.00,13000.00,14000.00,0.00,9966.36,0.40,1
53151,5354,1000.00,14000.00,15000.00,0.00,2721.39,0.02,1
53152,5354,-1000.00,13000.00,14000.00,6386.40,3652.74,0.16,0
53153,5354,1000.00,14000.00,15000.00,0.00,14000.00,0.30,1
53154,5354,1000.00,15000.00,16000.00,0.00,15000.00,0.24,1
53155,5354,1000.00,16000.00,17000.00,0.00,12921.82,0.41,1
53156,5354,1000.00,17000.00,18000.00,0.00,1448.44,0.13,1
53157,5354,0.00,17000.00,18000.00,0.00,0.00,0.03,0
53158,5354,1000.00,18000.00,19000.00,7824.63,10175.37,0.19,1
53159,5354,-1000.00,17000.00,18000.00,14074.47,4925.53,0.07,0
53160,5354,1000.00,18000.00,19000.00,0.00,11754.04,0.36,1
53161,5354,1000.00,19000.00,20000.00,7798.60,11201.40,0.01,1
53162,5354,1000.00,20000.00,21000.00,461.79,514.13,0.12,1
53163,5354,1000.00,21000.00,22000.00,0.00,17737.38,0.15,1
53164,5354,1000.00,22000.00,23000.00,0.00,16906.68,0.37,1
53165,5354,1000.00,23000.00,24000.00,0.00,15003.92,0.16,1
53166,5354,1000.00,24000.00,25000.00,8170.74,15829.26,0.13,1
53167,5354,1000.00,25000.00,26000.00,0.00,16893.77,0.21,1
53168,5354,1000.00,26000.00,27000.00,11283.40,14716.60,0.10,1
53169,5354,1000.00,27000.00,28000.00,0.00,27000.00,0.05,1
53170,5354,1000.00,28000.00,29000.00,1876.67,26123.33,0.06,1
53171,5354,-1000.00,27000.00,28000.00,19529.21,9470.79,0.01,0
53172,5354,1000.00,28000.00,29000.00,0.00,6695.80,0.15,1
53173,5354,1000.00,29000.00,30000.00,9657.42,10399.86,0.21,1
53174,5354,1000.00,30000.00,31000.00,10099.98,19900.02,0.30,1
53175,5354,1000.00,31000.00,32000.00,0.00,14218.77,0.24,1
53176,5354,1000.00,32000.00,33000.00,10059.57,21940.43,0.32,1
53177,5354,-1000.00,31000.00,32000.00,15259.91,10487.22,0.17,0
53178,5354,1000.00,32000.00,33000.00,1329.46,30670.54,0.44,1
53179,5354,1000.00,33000.00,34000.00,0.00,14225.47,0.28,1
53180,5354,1000.00,34000.00,35000.00,6678.79,27321.21,0.13,1
53181,5354,1000.00,35000.00,36000.00,13691.42,21308.58,0.24,1
53182,5355,1000.00,1000.00,2000.00,0.00,372.54,0.25,1
53183,5355,1000.00,2000.00,3000.00,0.00,409.21,0.18,1
53184,5355,1000.00,3000.00,4000.00,0.00,2613.61,0.32,1
53185,5355,1000.00,4000.00,5000.00,489.89,3510.11,0.29,1
53186,5355,1000.00,5000.00,6000.00,2426.92,2573.08,0.13,1
53187,5355,1000.00,6000.00,7000.00,1845.31,4154.69,0.05,1
53188,5355,1000.00,7000.00,8000.00,0.00,7000.00,0.30,1
53189,5355,1000.00,8000.00,9000.00,986.20,5318.52,0.37,1
53190,5355,-1000.00,7000.00,8000.00,4872.73,4127.27,0.06,0
53191,5355,1000.00,8000.00,9000.00,0.00,8000.00,0.15,1
53192,5355,-1000.00,7000.00,8000.00,5044.91,0.00,0.03,0
53193,5355,1000.00,8000.00,9000.00,0.00,8000.00,0.34,1
53194,5355,1000.00,9000.00,10000.00,0.00,9000.00,0.21,1
53195,5355,1000.00,10000.00,11000.00,2007.44,7992.56,0.37,1
53196,5355,-1000.00,9000.00,10000.00,10265.28,734.72,0.02,0
53197,5355,1000.00,10000.00,11000.00,0.00,7387.32,0.21,1
53198,5355,1000.00,11000.00,12000.00,4503.27,6496.73,0.26,1
53199,5355,0.00,11000.00,12000.00,0.00,0.00,0.05,0
53200,5355,1000.00,12000.00,13000.00,0.00,9298.54,0.16,1
53201,5355,1000.00,13000.00,14000.00,0.00,2947.55,0.09,1
53202,5355,1000.00,14000.00,15000.00,3195.63,10804.37,0.18,1
53203,5355,1000.00,15000.00,16000.00,0.00,15000.00,0.02,1
53204,5355,-1000.00,14000.00,15000.00,6914.45,9085.55,0.43,0
53205,5355,-1000.00,13000.00,14000.00,7500.00,7500.00,0.03,0
53206,5355,-1000.00,12000.00,13000.00,4616.49,0.00,0.03,0
53207,5355,-1000.00,11000.00,12000.00,6836.89,6163.11,0.06,0
53208,5355,-1000.00,10000.00,11000.00,0.00,6609.10,0.32,0
53209,5355,-1000.00,9000.00,10000.00,0.00,2315.98,0.06,0
53210,5355,-1000.00,8000.00,9000.00,1601.61,8398.39,0.38,0
53211,5355,-1000.00,7000.00,8000.00,0.00,6121.75,0.32,0
53212,5355,-1000.00,6000.00,7000.00,2736.22,5263.78,0.31,0
53213,5355,-1000.00,5000.00,6000.00,0.00,7000.00,0.08,0
53214,5355,-1000.00,4000.00,5000.00,0.00,3572.51,0.18,0
53215,5355,-1000.00,3000.00,4000.00,651.76,4348.24,0.43,0
53216,5355,-1000.00,2000.00,3000.00,0.00,4000.00,0.14,0
53217,5355,-1000.00,1000.00,2000.00,0.00,2010.42,0.33,0
53218,5355,-1000.00,0.00,1000.00,483.51,1516.49,0.31,0
53219,5355,-1000.00,-1000.00,0.00,0.00,1000.00,0.41,0
53220,5356,-1000.00,-1000.00,0.00,500.00,500.00,0.07,0
53221,5357,-1000.00,-1000.00,0.00,285.44,714.56,0.36,0
53222,5358,-1000.00,-1000.00,0.00,897.53,0.00,0.02,0
53223,5359,1000.00,1000.00,2000.00,0.00,1000.00,0.11,1
53224,5359,1000.00,2000.00,3000.00,783.82,1216.18,0.29,1
53225,5359,1000.00,3000.00,4000.00,0.00,3000.00,0.20,1
53226,5359,-1000.00,2000.00,3000.00,1562.53,1324.38,0.19,0
53227,5359,1000.00,3000.00,4000.00,0.00,2508.58,0.39,1
53228,5359,1000.00,4000.00,5000.00,131.52,3868.48,0.43,1
53229,5359,-1000.00,3000.00,4000.00,1359.10,0.00,0.04,0
53230,5359,-1000.00,2000.00,3000.00,2176.82,1823.18,0.11,0
53231,5359,1000.00,3000.00,4000.00,816.63,2183.37,0.17,1
53232,5359,1000.00,4000.00,5000.00,0.00,1375.58,0.23,1
53233,5359,1000.00,5000.00,6000.00,0.00,5000.00,0.10,1
53234,5359,1000.00,6000.00,7000.00,0.00,6000.00,0.41,1
53235,5359,1000.00,7000.00,8000.00,3463.89,3536.11,0.17,1
53236,5359,-1000.00,6000.00,7000.00,4101.65,3898.35,0.18,0
53237,5359,1000.00,7000.00,8000.00,0.00,990.61,0.11,1
53238,5359,1000.00,8000.00,9000.00,0.00,3032.30,0.26,1
53239,5359,1000.00,9000.00,10000.00,0.00,8948.99,0.42,1
53240,5359,1000.00,10000.00,11000.00,0.00,8999.47,0.27,1
53241,5359,1000.00,11000.00,12000.00,0.00,11000.00,0.29,1
53242,5359,1000.00,12000.00,13000.00,0.00,4001.78,0.23,1
53243,5359,1000.00,13000.00,14000.00,0.00,9803.98,0.33,1
53244,5359,1000.00,14000.00,15000.00,0.00,14000.00,0.00,1
53245,5359,1000.00,15000.00,16000.00,2105.90,12086.72,0.41,1
53246,5359,1000.00,16000.00,17000.00,2688.36,13311.64,0.42,1
53247,5359,1000.00,17000.00,18000.00,0.00,17000.00,0.35,1
53248,5359,1000.00,18000.00,19000.00,0.00,18000.00,0.10,1
53249,5359,-1000.00,17000.00,18000.00,10162.61,8837.39,0.09,0
53250,5359,1000.00,18000.00,19000.00,3716.22,14283.78,0.34,1
53251,5359,1000.00,19000.00,20000.00,0.00,18711.84,0.01,1
53252,5359,1000.00,20000.00,21000.00,0.00,20000.00,0.11,1
53253,5359,1000.00,21000.00,22000.00,0.00,21000.00,0.24,1
53254,5359,1000.00,22000.00,23000.00,0.00,22000.00,0.37,1
53255,5359,1000.00,23000.00,24000.00,1542.27,21457.73,0.41,1
53256,5359,1000.00,24000.00,25000.00,4642.20,19357.80,0.41,1
53257,5359,1000.00,25000.00,26000.00,0.00,9247.98,0.24,1
53258,5359,1000.00,26000.00,27000.00,4601.14,21398.86,0.23,1
53259,5359,1000.00,27000.00,28000.00,1807.60,17454.07,0.37,1
53260,5359,-1000.00,26000.00,27000.00,22304.27,0.00,0.04,0
53261,5359,1000.00,27000.00,28000.00,8692.25,18307.75,0.32,1
53262,5359,1000.00,28000.00,29000.00,9769.18,18230.82,0.32,1
53263,5359,1000.00,29000.00,30000.00,3053.20,22091.34,0.40,1
53264,5359,0.00,29000.00,30000.00,0.00,0.00,0.07,0
53265,5359,1000.00,30000.00,31000.00,0.00,30000.00,0.24,1
53266,5359,1000.00,31000.00,32000.00,0.00,31000.00,0.23,1
53267,5359,1000.00,32000.00,33000.00,6012.06,25987.94,0.41,1
53268,5359,1000.00,33000.00,34000.00,9671.67,23328.33,0.04,1
53269,5359,1000.00,34000.00,35000.00,0.00,34000.00,0.27,1
53270,5360,-1000.00,-1000.00,0.00,214.15,785.85,0.36,0
53271,5361,-1000.00,-1000.00,0.00,506.39,493.61,0.14,0
53272,5362,-175.40,-175.40,824.60,0.00,175.40,0.17,0
53273,5362,-824.60,-1000.00,0.00,114.29,710.32,0.20,0
53274,5363,-654.35,-654.35,345.65,0.00,654.35,0.37,0
53275,5363,-345.65,-1000.00,0.00,32.53,313.12,0.43,0
53276,5364,-1000.00,-1000.00,0.00,0.00,1000.00,0.01,0
53277,5365,0.00,0.00,1000.00,0.00,0.00,0.20,0
53278,5365,-508.21,-508.21,491.79,119.94,388.27,0.36,0
53279,5365,-465.17,-973.38,26.62,5.44,459.74,0.44,0
53280,5365,-26.62,-1000.00,0.00,0.00,26.62,0.01,0
53281,5366,1000.00,1000.00,2000.00,168.61,831.39,0.39,1
53282,5366,1000.00,2000.00,3000.00,116.37,1257.61,0.36,1
53283,5366,1000.00,3000.00,4000.00,1218.88,1726.30,0.27,1
53284,5366,1000.00,4000.00,5000.00,0.00,4000.00,0.23,1
53285,5366,1000.00,5000.00,6000.00,0.00,5000.00,0.25,1
53286,5366,1000.00,6000.00,7000.00,0.00,6000.00,0.25,1
53287,5366,1000.00,7000.00,8000.00,3500.00,3500.00,0.03,1
53288,5366,1000.00,8000.00,9000.00,1834.59,6165.41,0.38,1
53289,5366,1000.00,9000.00,10000.00,0.00,9000.00,0.18,1
53290,5366,1000.00,10000.00,11000.00,0.00,8808.13,0.43,1
53291,5366,1000.00,11000.00,12000.00,1542.92,9457.08,0.41,1
53292,5366,1000.00,12000.00,13000.00,353.71,11646.29,0.43,1
53293,5366,1000.00,13000.00,14000.00,0.00,3630.89,0.10,1
53294,5366,1000.00,14000.00,15000.00,0.00,12576.83,0.38,1
53295,5366,-1000.00,13000.00,14000.00,7982.10,5542.14,0.17,0
53296,5366,1000.00,14000.00,15000.00,7000.00,7000.00,0.03,1
53297,5366,1000.00,15000.00,16000.00,0.00,15000.00,0.16,1
53298,5366,1000.00,16000.00,17000.00,5009.29,10990.71,0.22,1
53299,5366,1000.00,17000.00,18000.00,2969.19,14030.81,0.28,1
53300,5366,1000.00,18000.00,19000.00,122.67,3528.98,0.18,1
53301,5366,1000.00,19000.00,20000.00,0.00,17777.64,0.42,1
53302,5366,1000.00,20000.00,21000.00,8284.29,11715.71,0.16,1
53303,5366,1000.00,21000.00,22000.00,5862.68,8806.65,0.25,1
53304,5366,1000.00,22000.00,23000.00,0.00,22000.00,0.00,1
53305,5366,1000.00,23000.00,24000.00,0.00,23000.00,0.14,1
53306,5366,1000.00,24000.00,25000.00,0.00,9865.91,0.14,1
53307,5366,1000.00,25000.00,26000.00,7640.14,17359.86,0.33,1
53308,5366,1000.00,26000.00,27000.00,8552.97,17447.03,0.29,1
53309,5366,1000.00,27000.00,28000.00,0.00,9066.29,0.23,1
53310,5366,1000.00,28000.00,29000.00,4580.91,23419.09,0.35,1
53311,5366,1000.00,29000.00,30000.00,14500.00,14500.00,0.07,1
53312,5366,1000.00,30000.00,31000.00,0.00,26878.87,0.32,1
53313,5366,-1000.00,29000.00,30000.00,19597.46,11402.54,0.09,0
53314,5366,1000.00,30000.00,31000.00,0.00,30000.00,0.03,1
53315,5366,1000.00,31000.00,32000.00,0.00,31000.00,0.27,1
53316,5366,1000.00,32000.00,33000.00,0.00,30705.66,0.36,1
53317,5366,1000.00,33000.00,34000.00,0.00,33000.00,0.36,1
53318,5366,1000.00,34000.00,35000.00,0.00,17123.58,0.31,1
53319,5366,-1000.00,33000.00,34000.00,17562.83,17437.17,0.07,0
53320,5366,1000.00,34000.00,35000.00,0.00,34000.00,0.40,1
53321,5366,1000.00,35000.00,36000.00,16337.41,18662.59,0.24,1
53322,5366,1000.00,36000.00,37000.00,0.00,36000.00,0.41,1
53323,5366,1000.00,37000.00,38000.00,0.00,37000.00,0.35,1
53324,5367,-1000.00,-1000.00,0.00,0.00,1000.00,0.37,0
53325,5368,-218.88,-218.88,781.12,0.00,218.88,0.19,0
53326,5368,-781.12,-1000.00,0.00,99.48,681.64,0.29,0
53327,5369,-1000.00,-1000.00,0.00,0.00,172.67,0.42,0
53328,5370,-1000.00,-1000.00,0.00,0.00,246.60,0.28,0
53329,5371,-1000.00,-1000.00,0.00,456.42,543.58,0.23,0
53330,5372,1000.00,1000.00,2000.00,0.00,720.31,0.29,1
53331,5372,-1000.00,0.00,1000.00,1310.86,689.14,0.06,0
53332,5372,1000.00,1000.00,2000.00,0.00,867.33,0.42,1
53333,5372,1000.00,2000.00,3000.00,0.00,2000.00,0.03,1
53334,5372,1000.00,3000.00,4000.00,0.00,3000.00,0.05,1
53335,5372,1000.00,4000.00,5000.00,395.97,2314.15,0.34,1
53336,5372,1000.00,5000.00,6000.00,1193.36,3806.64,0.32,1
53337,5372,1000.00,6000.00,7000.00,978.11,5021.89,0.39,1
53338,5372,1000.00,7000.00,8000.00,2500.61,4499.39,0.23,1
53339,5372,1000.00,8000.00,9000.00,0.00,6330.89,0.42,1
53340,5372,1000.00,9000.00,10000.00,3221.00,5155.11,0.29,1
53341,5372,1000.00,10000.00,11000.00,2284.34,6281.28,0.34,1
53342,5372,1000.00,11000.00,12000.00,1599.93,9400.07,0.41,1
53343,5372,1000.00,12000.00,13000.00,5968.91,6031.09,0.18,1
53344,5372,-1000.00,11000.00,12000.00,9001.79,3998.21,0.03,0
53345,5372,1000.00,12000.00,13000.00,277.50,11722.50,0.43,1
53346,5372,1000.00,13000.00,14000.00,3484.80,9515.20,0.11,1
53347,5372,-1000.00,12000.00,13000.00,4185.42,0.00,0.01,0
53348,5372,1000.00,13000.00,14000.00,0.00,13000.00,0.01,1
53349,5372,1000.00,14000.00,15000.00,1383.55,10624.33,0.40,1
53350,5372,1000.00,15000.00,16000.00,3246.15,11753.85,0.40,1
53351,5372,-1000.00,14000.00,15000.00,9478.73,6521.27,0.12,0
53352,5372,1000.00,15000.00,16000.00,0.00,15000.00,0.13,1
53353,5372,-1000.00,14000.00,15000.00,9354.27,6645.73,0.17,0
53354,5372,-1000.00,13000.00,14000.00,0.00,9140.56,0.28,0
53355,5372,-1000.00,12000.00,13000.00,2937.64,11062.36,0.22,0
53356,5372,-1000.00,11000.00,12000.00,0.00,13000.00,0.01,0
53357,5372,-1000.00,10000.00,11000.00,4201.01,7798.99,0.04,0
53358,5372,-1000.00,9000.00,10000.00,0.00,10127.55,0.27,0
53359,5372,-1000.00,8000.00,9000.00,0.00,10000.00,0.14,0
53360,5372,-1000.00,7000.00,8000.00,3274.62,5725.38,0.27,0
53361,5372,-1000.00,6000.00,7000.00,0.00,4244.99,0.22,0
53362,5372,-1000.00,5000.00,6000.00,3855.60,1577.90,0.13,0
53363,5372,-1000.00,4000.00,5000.00,0.00,3024.29,0.29,0
53364,5372,-1000.00,3000.00,4000.00,1577.69,3422.31,0.18,0
53365,5372,-1000.00,2000.00,3000.00,2000.00,2000.00,0.05,0
53366,5372,-1000.00,1000.00,2000.00,0.00,3000.00,0.29,0
53367,5372,-1000.00,0.00,1000.00,0.00,1366.65,0.34,0
53368,5372,-1000.00,-1000.00,0.00,345.81,654.19,0.11,0
53369,5373,0.00,0.00,1000.00,0.00,0.00,0.05,0
53370,5373,-1000.00,-1000.00,0.00,0.00,1000.00,0.24,0
53371,5374,-252.17,-252.17,747.83,0.00,252.17,0.26,0
53372,5374,-1000.00,-1252.17,-252.17,582.75,165.08,0.03,0
53373,5375,-847.26,-847.26,152.74,0.00,847.26,0.29,0
53374,5375,-152.74,-1000.00,0.00,72.82,79.92,0.10,0
53375,5376,-1000.00,-1000.00,0.00,0.00,1000.00,0.03,0
53376,5377,-656.57,-656.57,343.43,0.00,656.57,0.32,0
53377,5377,-343.43,-1000.00,0.00,0.00,343.43,0.31,0
53378,5378,-1000.00,-1000.00,0.00,0.00,1000.00,0.25,0
53379,5379,0.00,0.00,1000.00,0.00,0.00,0.44,0
53380,5379,0.00,0.00,1000.00,0.00,0.00,0.21,0
53381,5379,-899.99,-899.99,100.01,440.73,459.26,0.34,0
53382,5379,-100.01,-1000.00,0.00,0.00,100.01,0.14,0
53383,5380,1000.00,1000.00,2000.00,0.00,1000.00,0.19,1
53384,5380,1000.00,2000.00,3000.00,16.20,1793.68,0.44,1
53385,5380,0.00,2000.00,3000.00,0.00,0.00,0.11,0
53386,5380,1000.00,3000.00,4000.00,0.00,3000.00,0.09,1
53387,5380,1000.00,4000.00,5000.00,0.00,2465.30,0.18,1
53388,5380,1000.00,5000.00,6000.00,0.00,5000.00,0.22,1
53389,5380,1000.00,6000.00,7000.00,1784.63,4215.37,0.15,1
53390,5380,1000.00,7000.00,8000.00,2821.82,4178.18,0.23,1
53391,5380,1000.00,8000.00,9000.00,2195.80,5804.20,0.34,1
53392,5380,1000.00,9000.00,10000.00,0.00,5690.47,0.28,1
53393,5380,1000.00,10000.00,11000.00,0.00,5509.42,0.02,1
53394,5380,1000.00,11000.00,12000.00,0.00,6427.42,0.13,1
53395,5380,-1000.00,10000.00,11000.00,6413.47,5586.53,0.17,0
53396,5380,1000.00,11000.00,12000.00,1933.47,9066.53,0.42,1
53397,5380,1000.00,12000.00,13000.00,0.00,7836.87,0.33,1
53398,5380,-1000.00,11000.00,12000.00,6743.16,6256.84,0.39,0
53399,5380,-1000.00,10000.00,11000.00,7341.94,4658.06,0.35,0
53400,5380,-1000.00,9000.00,10000.00,1062.81,767.02,0.43,0
53401,5380,-1000.00,8000.00,9000.00,0.00,326.28,0.23,0
53402,5380,-1000.00,7000.00,8000.00,0.00,6145.24,0.38,0
53403,5380,-1000.00,6000.00,7000.00,0.00,8000.00,0.17,0
53404,5380,-1000.00,5000.00,6000.00,0.00,7000.00,0.38,0
53405,5380,-1000.00,4000.00,5000.00,0.00,6000.00,0.12,0
53406,5380,-1000.00,3000.00,4000.00,0.00,672.24,0.13,0
53407,5380,0.00,3000.00,4000.00,0.00,0.00,0.05,0
53408,5380,-1000.00,2000.00,3000.00,507.84,3492.16,0.12,0
53409,5380,-1000.00,1000.00,2000.00,0.00,3000.00,0.04,0
53410,5380,-1000.00,0.00,1000.00,301.82,1698.18,0.17,0
53411,5380,-1000.00,-1000.00,0.00,0.00,441.66,0.29,0
53412,5381,0.00,0.00,1000.00,0.00,0.00,0.14,0
53413,5381,-1000.00,-1000.00,0.00,370.54,429.04,0.28,0
53414,5382,-1000.00,-1000.00,0.00,170.25,829.75,0.40,0
53415,5383,-1000.00,-1000.00,0.00,167.76,832.24,0.31,0
53416,5384,-1000.00,-1000.00,0.00,374.26,625.74,0.04,0
53417,5385,-237.53,-237.53,762.47,237.53,0.00,0.30,0
53418,5385,0.00,-237.53,762.47,0.00,0.00,0.32,0
53419,5385,-1000.00,-1237.53,-237.53,0.00,762.47,0.28,0
53420,5386,0.00,0.00,1000.00,0.00,0.00,0.04,0
53421,5386,1000.00,1000.00,2000.00,259.46,0.00,0.28,1
53422,5386,-1000.00,0.00,1000.00,0.00,1937.69,0.44,0
53423,5386,-1000.00,-1000.00,0.00,258.79,741.21,0.20,0
53424,5387,1000.00,1000.00,2000.00,0.00,1000.00,0.25,1
53425,5387,1000.00,2000.00,3000.00,0.00,2000.00,0.32,1
53426,5387,1000.00,3000.00,4000.00,1500.00,1500.00,0.05,1
53427,5387,1000.00,4000.00,5000.00,0.00,4000.00,0.43,1
53428,5387,1000.00,5000.00,6000.00,195.78,3287.80,0.37,1
53429,5387,1000.00,6000.00,7000.00,0.00,6000.00,0.29,1
53430,5387,1000.00,7000.00,8000.00,0.00,7000.00,0.15,1
53431,5387,1000.00,8000.00,9000.00,4000.00,4000.00,0.03,1
53432,5387,-1000.00,7000.00,8000.00,5432.20,3567.80,0.10,0
53433,5387,1000.00,8000.00,9000.00,0.00,1218.46,0.14,1
53434,5387,1000.00,9000.00,10000.00,0.00,5067.61,0.34,1
53435,5387,1000.00,10000.00,11000.00,1350.76,7030.33,0.38,1
53436,5387,0.00,10000.00,11000.00,0.00,0.00,0.04,0
53437,5387,-1000.00,9000.00,10000.00,5263.29,0.00,0.04,0
53438,5387,1000.00,10000.00,11000.00,3969.48,6030.52,0.27,1
53439,5387,1000.00,11000.00,12000.00,1292.71,9707.29,0.11,1
53440,5387,1000.00,12000.00,13000.00,0.00,10243.94,0.29,1
53441,5387,1000.00,13000.00,14000.00,0.00,13000.00,0.42,1
53442,5387,1000.00,14000.00,15000.00,0.00,8168.75,0.19,1
53443,5387,1000.00,15000.00,16000.00,5540.44,9459.56,0.12,1
53444,5387,1000.00,16000.00,17000.00,0.00,16000.00,0.18,1
53445,5387,1000.00,17000.00,18000.00,0.00,17000.00,0.35,1
53446,5387,1000.00,18000.00,19000.00,0.00,6620.06,0.24,1
53447,5387,1000.00,19000.00,20000.00,0.00,4109.84,0.19,1
53448,5387,1000.00,20000.00,21000.00,0.00,20000.00,0.22,1
53449,5387,1000.00,21000.00,22000.00,1618.12,19381.88,0.41,1
53450,5387,1000.00,22000.00,23000.00,7357.64,14642.36,0.31,1
53451,5387,1000.00,23000.00,24000.00,11500.00,11500.00,0.01,1
53452,5387,1000.00,24000.00,25000.00,0.00,24000.00,0.29,1
53453,5387,1000.00,25000.00,26000.00,0.00,25000.00,0.01,1
53454,5387,1000.00,26000.00,27000.00,0.00,26000.00,0.42,1
53455,5387,1000.00,27000.00,28000.00,218.10,26781.90,0.37,1
53456,5387,1000.00,28000.00,29000.00,0.00,28000.00,0.40,1
53457,5387,1000.00,29000.00,30000.00,0.00,29000.00,0.40,1
53458,5387,1000.00,30000.00,31000.00,0.00,1743.21,0.12,1
53459,5387,1000.00,31000.00,32000.00,0.00,31000.00,0.13,1
53460,5387,1000.00,32000.00,33000.00,0.00,13628.03,0.23,1
53461,5387,-1000.00,31000.00,32000.00,17351.80,15648.20,0.20,0
53462,5387,1000.00,32000.00,33000.00,0.00,32000.00,0.06,1
53463,5387,1000.00,33000.00,34000.00,0.00,33000.00,0.38,1
53464,5387,1000.00,34000.00,35000.00,0.00,33316.25,0.44,1
53465,5387,-1000.00,33000.00,34000.00,18749.37,16250.63,0.15,0
53466,5387,-1000.00,32000.00,33000.00,18668.48,15331.52,0.06,0
53467,5387,1000.00,33000.00,34000.00,0.00,33000.00,0.35,1
53468,5387,1000.00,34000.00,35000.00,0.00,34000.00,0.18,1
53469,5387,1000.00,35000.00,36000.00,0.00,35000.00,0.05,1
53470,5388,1000.00,1000.00,2000.00,735.05,0.00,0.02,1
53471,5388,-351.27,648.73,1648.73,149.69,201.57,0.15,0
53472,5388,-1000.00,-351.27,648.73,0.00,1648.73,0.43,0
53473,5388,1000.00,648.73,1648.73,389.80,258.94,0.15,1
53474,5388,-1000.00,-351.27,648.73,253.71,1395.03,0.42,0
53475,5388,-618.42,-969.69,30.31,0.00,618.42,0.03,0
53476,5388,-30.31,-1000.00,0.00,0.00,30.31,0.41,0
53477,5389,1000.00,1000.00,2000.00,0.00,474.54,0.09,1
53478,5389,1000.00,2000.00,3000.00,0.00,1809.01,0.22,1
53479,5389,-1000.00,1000.00,2000.00,1530.48,1324.10,0.20,0
53480,5389,1000.00,2000.00,3000.00,0.00,1264.63,0.34,1
53481,5389,1000.00,3000.00,4000.00,0.00,2191.19,0.39,1
53482,5389,1000.00,4000.00,5000.00,1123.48,2876.52,0.37,1
53483,5389,1000.00,5000.00,6000.00,2500.00,2500.00,0.34,1
53484,5389,1000.00,6000.00,7000.00,0.00,6000.00,0.37,1
53485,5389,1000.00,7000.00,8000.00,463.75,6536.25,0.05,1
53486,5389,1000.00,8000.00,9000.00,0.00,8000.00,0.18,1
53487,5389,1000.00,9000.00,10000.00,0.00,9000.00,0.09,1
53488,5389,1000.00,10000.00,11000.00,0.00,10000.00,0.39,1
53489,5389,1000.00,11000.00,12000.00,0.00,1405.04,0.15,1
53490,5389,1000.00,12000.00,13000.00,3650.02,8349.98,0.35,1
53491,5389,1000.00,13000.00,14000.00,6113.56,6886.44,0.14,1
53492,5389,1000.00,14000.00,15000.00,0.00,10896.49,0.39,1
53493,5389,1000.00,15000.00,16000.00,0.00,15000.00,0.11,1
53494,5389,1000.00,16000.00,17000.00,5168.70,10831.30,0.36,1
53495,5389,1000.00,17000.00,18000.00,0.00,17000.00,0.34,1
53496,5389,1000.00,18000.00,19000.00,7024.91,10975.09,0.25,1
53497,5389,1000.00,19000.00,20000.00,0.00,14739.10,0.32,1
53498,5389,-1000.00,18000.00,19000.00,10377.02,9622.98,0.04,0
53499,5389,-1000.00,17000.00,18000.00,17557.06,1442.94,0.01,0
53500,5389,-1000.00,16000.00,17000.00,8269.07,0.00,0.07,0
53501,5389,1000.00,17000.00,18000.00,0.00,8506.65,0.14,1
53502,5389,-1000.00,16000.00,17000.00,15014.16,2985.84,0.04,0
53503,5389,1000.00,17000.00,18000.00,7997.09,9002.91,0.01,1
53504,5389,1000.00,18000.00,19000.00,8591.74,9408.26,0.23,1
53505,5389,1000.00,19000.00,20000.00,0.00,19000.00,0.22,1
53506,5389,1000.00,20000.00,21000.00,10000.00,10000.00,0.10,1
53507,5389,1000.00,21000.00,22000.00,0.00,19335.52,0.44,1
53508,5389,1000.00,22000.00,23000.00,0.00,22000.00,0.01,1
53509,5389,1000.00,23000.00,24000.00,0.00,23000.00,0.17,1
53510,5389,1000.00,24000.00,25000.00,4284.74,14103.94,0.33,1
53511,5389,1000.00,25000.00,26000.00,0.00,25000.00,0.05,1
53512,5389,1000.00,26000.00,27000.00,6977.04,19022.96,0.21,1
53513,5390,-1000.00,-1000.00,0.00,388.94,611.06,0.29,0
53514,5391,-1000.00,-1000.00,0.00,622.34,329.05,0.14,0
53515,5392,-1000.00,-1000.00,0.00,649.39,350.61,0.13,0
53516,5393,1000.00,1000.00,2000.00,0.00,347.32,0.09,1
53517,5393,1000.00,2000.00,3000.00,0.00,2000.00,0.22,1
53518,5393,1000.00,3000.00,4000.00,0.00,3000.00,0.35,1
53519,5393,1000.00,4000.00,5000.00,0.00,4000.00,0.22,1
53520,5393,1000.00,5000.00,6000.00,2299.77,2700.23,0.10,1
53521,5393,-1000.00,4000.00,5000.00,4485.55,1514.45,0.03,0
53522,5393,1000.00,5000.00,6000.00,0.00,3427.14,0.13,1
53523,5393,1000.00,6000.00,7000.00,0.00,6000.00,0.42,1
53524,5393,1000.00,7000.00,8000.00,234.44,6765.56,0.42,1
53525,5393,1000.00,8000.00,9000.00,1280.42,6719.58,0.35,1
53526,5393,1000.00,9000.00,10000.00,0.00,8259.08,0.44,1
53527,5393,1000.00,10000.00,11000.00,0.00,8809.25,0.43,1
53528,5393,1000.00,11000.00,12000.00,0.00,5821.60,0.31,1
53529,5393,1000.00,12000.00,13000.00,0.00,12000.00,0.07,1
53530,5393,0.00,12000.00,13000.00,0.00,0.00,0.09,0
53531,5393,-1000.00,11000.00,12000.00,6190.88,4498.86,0.18,0
53532,5393,1000.00,12000.00,13000.00,6000.00,6000.00,0.05,1
53533,5393,0.00,12000.00,13000.00,0.00,0.00,0.06,0
53534,5393,1000.00,13000.00,14000.00,0.00,13000.00,0.04,1
53535,5393,1000.00,14000.00,15000.00,5561.05,8438.95,0.29,1
53536,5393,1000.00,15000.00,16000.00,0.00,15000.00,0.15,1
53537,5393,1000.00,16000.00,17000.00,0.00,15980.76,0.43,1
53538,5393,1000.00,17000.00,18000.00,2087.30,14912.70,0.43,1
53539,5393,1000.00,18000.00,19000.00,5175.59,12824.41,0.26,1
53540,5393,1000.00,19000.00,20000.00,6092.33,12907.67,0.25,1
53541,5393,1000.00,20000.00,21000.00,0.00,20000.00,0.18,1
53542,5393,1000.00,21000.00,22000.00,0.00,242.69,0.07,1
53543,5393,1000.00,22000.00,23000.00,8649.20,13350.80,0.27,1
53544,5393,1000.00,23000.00,24000.00,0.00,23000.00,0.36,1
53545,5393,1000.00,24000.00,25000.00,4498.15,17474.92,0.38,1
53546,5393,1000.00,25000.00,26000.00,0.00,25000.00,0.40,1
53547,5393,1000.00,26000.00,27000.00,3324.69,22675.31,0.42,1
53548,5393,-1000.00,25000.00,26000.00,26997.30,0.00,0.02,0
53549,5393,1000.00,26000.00,27000.00,0.00,26000.00,0.27,1
53550,5393,1000.00,27000.00,28000.00,0.00,27000.00,0.02,1
53551,5393,1000.00,28000.00,29000.00,0.00,28000.00,0.33,1
53552,5393,1000.00,29000.00,30000.00,0.00,25684.98,0.40,1
53553,5393,1000.00,30000.00,31000.00,0.00,19699.86,0.24,1
53554,5393,1000.00,31000.00,32000.00,0.00,31000.00,0.26,1
53555,5393,1000.00,32000.00,33000.00,9847.49,22152.51,0.34,1
53556,5393,1000.00,33000.00,34000.00,6562.97,26437.03,0.35,1
53557,5393,1000.00,34000.00,35000.00,1767.18,32232.82,0.01,1
53558,5393,1000.00,35000.00,36000.00,17071.20,17928.80,0.10,1
53559,5393,1000.00,36000.00,37000.00,0.00,36000.00,0.39,1
53560,5393,1000.00,37000.00,38000.00,11125.56,25874.44,0.33,1
53561,5393,1000.00,38000.00,39000.00,13696.48,24303.52,0.23,1
53562,5393,1000.00,39000.00,40000.00,1678.32,37321.68,0.40,1
53563,5393,-1000.00,38000.00,39000.00,13235.13,0.00,0.09,0
53564,5393,-1000.00,37000.00,38000.00,15022.36,23977.64,0.23,0
53565,5393,-1000.00,36000.00,37000.00,0.00,38000.00,0.31,0
53566,5393,-1000.00,35000.00,36000.00,11978.96,25021.04,0.34,0
53567,5393,-1000.00,34000.00,35000.00,16917.96,19082.04,0.22,0
53568,5393,-1000.00,33000.00,34000.00,6338.55,28661.45,0.41,0
53569,5393,-1000.00,32000.00,33000.00,2963.89,31036.11,0.44,0
53570,5393,-1000.00,31000.00,32000.00,0.00,8468.31,0.06,0
53571,5393,-1000.00,30000.00,31000.00,10602.21,21397.79,0.07,0
53572,5393,-1000.00,29000.00,30000.00,0.00,31000.00,0.25,0
53573,5393,-1000.00,28000.00,29000.00,10082.62,19917.38,0.20,0
53574,5393,-1000.00,27000.00,28000.00,0.00,29000.00,0.16,0
53575,5393,-1000.00,26000.00,27000.00,0.00,7126.18,0.15,0
53576,5393,-1000.00,25000.00,26000.00,11718.59,14363.21,0.25,0
53577,5393,-1000.00,24000.00,25000.00,2805.32,20599.50,0.41,0
53578,5393,-1000.00,23000.00,24000.00,0.00,7371.92,0.12,0
53579,5393,-1000.00,22000.00,23000.00,2151.93,6788.63,0.21,0
53580,5393,-1000.00,21000.00,22000.00,3004.31,19995.69,0.42,0
53581,5393,-1000.00,20000.00,21000.00,0.00,22000.00,0.42,0
53582,5393,-1000.00,19000.00,20000.00,7422.49,13577.51,0.32,0
53583,5393,-1000.00,18000.00,19000.00,0.00,20000.00,0.09,0
53584,5393,-1000.00,17000.00,18000.00,11508.02,2549.13,0.09,0
53585,5393,-1000.00,16000.00,17000.00,11054.62,6945.38,0.15,0
53586,5393,-1000.00,15000.00,16000.00,0.00,10388.46,0.35,0
53587,5394,-946.80,-946.80,53.20,0.00,946.80,0.43,0
53588,5394,-53.20,-1000.00,0.00,0.00,53.20,0.23,0
53589,5395,1000.00,1000.00,2000.00,0.00,693.76,0.31,1
53590,5395,-1000.00,0.00,1000.00,1070.15,929.85,0.01,0
53591,5395,1000.00,1000.00,2000.00,0.00,1000.00,0.01,1
53592,5395,1000.00,2000.00,3000.00,657.73,1342.27,0.33,1
53593,5395,1000.00,3000.00,4000.00,0.00,2139.18,0.26,1
53594,5395,1000.00,4000.00,5000.00,0.00,4000.00,0.12,1
53595,5395,-355.01,3644.99,4644.99,355.01,0.00,0.02,0
53596,5395,1000.00,4644.99,5644.99,0.00,4644.99,0.26,1
53597,5395,1000.00,5644.99,6644.99,0.00,5644.99,0.24,1
53598,5395,1000.00,6644.99,7644.99,2675.28,3969.72,0.22,1
53599,5395,1000.00,7644.99,8644.99,0.00,6487.54,0.00,1
53600,5395,1000.00,8644.99,9644.99,0.00,8644.99,0.15,1
53601,5395,1000.00,9644.99,10644.99,4822.50,4822.50,0.01,1
53602,5395,1000.00,10644.99,11644.99,0.00,10644.99,0.28,1
53603,5395,1000.00,11644.99,12644.99,46.96,2699.65,0.19,1
53604,5395,1000.00,12644.99,13644.99,0.00,12644.99,0.31,1
53605,5395,1000.00,13644.99,14644.99,0.00,10197.96,0.23,1
53606,5395,-1000.00,12644.99,13644.99,14644.99,0.00,0.01,0
53607,5395,-1000.00,11644.99,12644.99,4904.69,8740.30,0.19,0
53608,5395,-1000.00,10644.99,11644.99,0.00,12644.99,0.44,0
53609,5395,-1000.00,9644.99,10644.99,0.00,9030.86,0.40,0
53610,5395,-1000.00,8644.99,9644.99,0.00,7907.00,0.32,0
53611,5395,-1000.00,7644.99,8644.99,0.00,7474.85,0.02,0
53612,5395,-1000.00,6644.99,7644.99,760.46,0.00,0.07,0
53613,5395,-1000.00,5644.99,6644.99,5863.34,1781.66,0.05,0
53614,5395,-1000.00,4644.99,5644.99,2515.07,4129.93,0.28,0
53615,5395,-1000.00,3644.99,4644.99,0.00,3143.60,0.33,0
53616,5395,-1000.00,2644.99,3644.99,1826.76,2818.24,0.23,0
53617,5395,-1000.00,1644.99,2644.99,0.00,2036.61,0.29,0
53618,5395,-1000.00,644.99,1644.99,0.00,2644.99,0.33,0
53619,5395,-1000.00,-355.01,644.99,660.93,984.06,0.25,0
53620,5395,-644.99,-1000.00,0.00,313.90,331.10,0.06,0
53621,5396,-1000.00,-1000.00,0.00,415.35,584.65,0.05,0
53622,5397,-1000.00,-1000.00,0.00,74.31,385.15,0.36,0
53623,5398,-1000.00,-1000.00,0.00,435.78,564.22,0.13,0
53624,5399,1000.00,1000.00,2000.00,0.00,1000.00,0.39,1
53625,5399,1000.00,2000.00,3000.00,409.27,1590.73,0.35,1
53626,5399,1000.00,3000.00,4000.00,0.00,2514.70,0.25,1
53627,5399,1000.00,4000.00,5000.00,591.05,1939.20,0.30,1
53628,5399,-1000.00,3000.00,4000.00,1752.39,923.58,0.15,0
53629,5399,1000.00,4000.00,5000.00,888.93,2766.34,0.36,1
53630,5399,1000.00,5000.00,6000.00,30.16,4466.68,0.44,1
53631,5399,1000.00,6000.00,7000.00,2153.76,3846.24,0.19,1
53632,5399,1000.00,7000.00,8000.00,2844.31,4155.69,0.11,1
53633,5399,1000.00,8000.00,9000.00,1528.76,6471.24,0.38,1
53634,5399,-1000.00,7000.00,8000.00,2463.25,0.00,0.06,0
53635,5399,-1000.00,6000.00,7000.00,4526.91,884.05,0.09,0
53636,5399,-1000.00,5000.00,6000.00,4133.34,2104.31,0.14,0
53637,5399,1000.00,6000.00,7000.00,217.46,5070.43,0.43,1
53638,5399,1000.00,7000.00,8000.00,0.00,7000.00,0.36,1
53639,5399,1000.00,8000.00,9000.00,2429.53,5291.32,0.33,1
53640,5399,1000.00,9000.00,10000.00,1898.16,7101.84,0.19,1
53641,5399,1000.00,10000.00,11000.00,0.00,6744.02,0.24,1
53642,5399,1000.00,11000.00,12000.00,0.00,11000.00,0.38,1
53643,5399,1000.00,12000.00,13000.00,0.00,7269.32,0.20,1
53644,5399,1000.00,13000.00,14000.00,3135.61,9864.39,0.23,1
53645,5399,1000.00,14000.00,15000.00,0.00,979.94,0.09,1
53646,5399,1000.00,15000.00,16000.00,0.00,14424.12,0.17,1
53647,5399,1000.00,16000.00,17000.00,0.00,9664.64,0.29,1
53648,5399,-1000.00,15000.00,16000.00,1344.41,15655.59,0.44,0
53649,5399,-1000.00,14000.00,15000.00,6241.91,9758.09,0.24,0
53650,5399,-1000.00,13000.00,14000.00,0.00,14744.80,0.41,0
53651,5399,-1000.00,12000.00,13000.00,0.00,14000.00,0.29,0
53652,5399,-1000.00,11000.00,12000.00,0.00,13000.00,0.20,0
53653,5399,-1000.00,10000.00,11000.00,0.00,3426.73,0.13,0
53654,5399,-1000.00,9000.00,10000.00,5500.00,5500.00,0.04,0
53655,5399,-1000.00,8000.00,9000.00,5987.75,4012.25,0.15,0
53656,5399,-1000.00,7000.00,8000.00,1494.89,3395.19,0.25,0
53657,5399,-1000.00,6000.00,7000.00,0.00,8000.00,0.12,0
53658,5399,-1000.00,5000.00,6000.00,0.00,5155.57,0.39,0
53659,5399,-1000.00,4000.00,5000.00,2758.37,3241.63,0.10,0
53660,5399,-1000.00,3000.00,4000.00,1463.67,3536.33,0.33,0
53661,5399,-1000.00,2000.00,3000.00,0.00,3685.70,0.25,0
53662,5399,-1000.00,1000.00,2000.00,0.00,3000.00,0.11,0
53663,5399,-1000.00,0.00,1000.00,370.89,1629.11,0.41,0
53664,5399,-1000.00,-1000.00,0.00,405.74,0.00,0.06,0
53665,5400,-1000.00,-1000.00,0.00,320.75,679.25,0.33,0
53666,5401,-605.30,-605.30,394.70,64.95,540.35,0.29,0
53667,5401,0.00,-605.30,394.70,0.00,0.00,0.44,0
53668,5401,1000.00,394.70,1394.70,219.09,0.00,0.03,1
53669,5401,-1000.00,-605.30,394.70,667.00,727.70,0.31,0
53670,5401,0.00,-605.30,394.70,0.00,0.00,0.42,0
53671,5401,1000.00,394.70,1394.70,239.83,149.85,0.16,1
53672,5401,-1000.00,-605.30,394.70,386.16,1008.54,0.34,0
53673,5401,-394.70,-1000.00,0.00,130.08,264.62,0.32,0
53674,5402,-1000.00,-1000.00,0.00,0.00,1000.00,0.35,0
53675,5403,-901.91,-901.91,98.09,109.92,791.99,0.41,0
53676,5403,-98.09,-1000.00,0.00,40.47,57.62,0.24,0
53677,5404,-1000.00,-1000.00,0.00,45.66,954.34,0.34,0
53678,5405,0.00,0.00,1000.00,0.00,0.00,0.34,0
53679,5405,0.00,0.00,1000.00,0.00,0.00,0.26,0
53680,5405,-1000.00,-1000.00,0.00,0.00,187.13,0.39,0
53681,5406,-1000.00,-1000.00,0.00,252.66,747.34,0.31,0
53682,5407,-1000.00,-1000.00,0.00,190.50,809.50,0.08,0
53683,5407,-0.00,-1000.00,0.00,0.00,0.00,0.33,0
53684,5407,-0.00,-1000.00,0.00,0.00,0.00,0.11,0
53685,5407,-0.00,-1000.00,0.00,0.00,0.00,0.38,0
53686,5407,-0.00,-1000.00,0.00,0.00,0.00,0.44,0
53687,5408,-897.61,-897.61,102.39,241.19,656.43,0.35,0
53688,5408,-70.21,-967.82,32.18,0.00,70.21,0.06,0
53689,5408,-32.18,-1000.00,0.00,5.89,26.29,0.22,0
53690,5409,-873.40,-873.40,126.60,400.89,472.51,0.26,0
53691,5409,-22.87,-896.27,103.73,9.28,13.60,0.43,0
53692,5409,-84.26,-980.54,19.46,0.00,84.26,0.41,0
53693,5409,-19.46,-1000.00,0.00,1.69,17.78,0.40,0
53694,5410,-1000.00,-1000.00,0.00,229.86,223.04,0.38,0
53695,5411,1000.00,1000.00,2000.00,446.91,553.09,0.20,1
53696,5411,1000.00,2000.00,3000.00,0.00,2000.00,0.01,1
53697,5411,1000.00,3000.00,4000.00,0.00,1723.43,0.30,1
53698,5411,1000.00,4000.00,5000.00,0.00,4000.00,0.22,1
53699,5411,1000.00,5000.00,6000.00,0.00,5000.00,0.16,1
53700,5411,1000.00,6000.00,7000.00,0.00,2578.11,0.25,1
53701,5411,1000.00,7000.00,8000.00,0.00,7000.00,0.28,1
53702,5411,0.00,7000.00,8000.00,0.00,0.00,0.00,0
53703,5411,1000.00,8000.00,9000.00,759.05,5815.99,0.39,1
53704,5411,1000.00,9000.00,10000.00,2882.42,6117.58,0.32,1
53705,5411,1000.00,10000.00,11000.00,1292.76,8707.24,0.37,1
53706,5411,1000.00,11000.00,12000.00,1268.73,8380.44,0.40,1
53707,5411,1000.00,12000.00,13000.00,0.00,7098.15,0.35,1
53708,5411,1000.00,13000.00,14000.00,6500.00,6500.00,0.00,1
53709,5411,-1000.00,12000.00,13000.00,7584.61,1565.48,0.10,0
53710,5411,1000.00,13000.00,14000.00,0.00,13000.00,0.29,1
53711,5411,1000.00,14000.00,15000.00,0.00,14000.00,0.27,1
53712,5411,-1000.00,13000.00,14000.00,9181.58,2993.99,0.11,0
53713,5411,1000.00,14000.00,15000.00,6501.40,7498.60,0.17,1
53714,5411,1000.00,15000.00,16000.00,0.00,15000.00,0.11,1
53715,5411,1000.00,16000.00,17000.00,2647.82,13352.18,0.08,1
53716,5411,1000.00,17000.00,18000.00,0.00,17000.00,0.23,1
53717,5411,-1000.00,16000.00,17000.00,6781.20,11218.80,0.11,0
53718,5411,-1000.00,15000.00,16000.00,4759.87,12240.13,0.36,0
53719,5411,0.00,15000.00,16000.00,0.00,0.00,0.06,0
53720,5411,-1000.00,14000.00,15000.00,0.00,11574.31,0.32,0
53721,5411,-1000.00,13000.00,14000.00,6839.88,0.00,0.06,0
53722,5411,-1000.00,12000.00,13000.00,3077.98,10922.02,0.35,0
53723,5411,-1000.00,11000.00,12000.00,0.00,4020.91,0.10,0
53724,5411,-1000.00,10000.00,11000.00,6000.00,6000.00,0.05,0
53725,5411,-1000.00,9000.00,10000.00,0.00,9582.39,0.43,0
53726,5411,-1000.00,8000.00,9000.00,0.00,10000.00,0.04,0
53727,5411,-1000.00,7000.00,8000.00,4500.00,4500.00,0.00,0
53728,5411,-1000.00,6000.00,7000.00,0.00,6973.44,0.39,0
53729,5411,-1000.00,5000.00,6000.00,2066.04,2207.52,0.20,0
53730,5411,-1000.00,4000.00,5000.00,0.00,4717.05,0.35,0
53731,5411,-1000.00,3000.00,4000.00,2500.00,2500.00,0.03,0
53732,5411,-1000.00,2000.00,3000.00,0.00,1215.31,0.19,0
53733,5411,-1000.00,1000.00,2000.00,0.00,1244.43,0.11,0
53734,5411,-1000.00,0.00,1000.00,894.94,511.52,0.16,0
53735,5411,-1000.00,-1000.00,0.00,203.90,796.10,0.31,0
53736,5412,1000.00,1000.00,2000.00,0.00,199.01,0.20,1
53737,5412,-1000.00,0.00,1000.00,1604.39,329.86,0.18,0
53738,5412,1000.00,1000.00,2000.00,400.29,599.71,0.14,1
53739,5412,1000.00,2000.00,3000.00,0.00,2000.00,0.37,1
53740,5412,1000.00,3000.00,4000.00,0.00,3000.00,0.06,1
53741,5412,1000.00,4000.00,5000.00,0.00,1129.77,0.10,1
53742,5412,1000.00,5000.00,6000.00,0.00,2553.25,0.14,1
53743,5412,-1000.00,4000.00,5000.00,1663.96,1268.11,0.17,0
53744,5412,1000.00,5000.00,6000.00,0.00,5000.00,0.13,1
53745,5412,1000.00,6000.00,7000.00,0.00,1383.49,0.15,1
53746,5412,1000.00,7000.00,8000.00,0.00,6326.82,0.25,1
53747,5412,1000.00,8000.00,9000.00,0.00,8000.00,0.28,1
53748,5412,1000.00,9000.00,10000.00,0.00,9000.00,0.25,1
53749,5412,1000.00,10000.00,11000.00,0.00,10000.00,0.14,1
53750,5412,1000.00,11000.00,12000.00,3392.13,7607.87,0.35,1
53751,5412,1000.00,12000.00,13000.00,5780.12,6219.88,0.13,1
53752,5412,-1000.00,11000.00,12000.00,10660.84,0.00,0.02,0
53753,5412,1000.00,12000.00,13000.00,0.00,4176.39,0.05,1
53754,5412,1000.00,13000.00,14000.00,0.00,11591.75,0.43,1
53755,5412,-1000.00,12000.00,13000.00,8119.85,5880.15,0.17,0
53756,5412,1000.00,13000.00,14000.00,0.00,13000.00,0.33,1
53757,5412,1000.00,14000.00,15000.00,0.00,12257.89,0.41,1
53758,5412,1000.00,15000.00,16000.00,94.40,10344.14,0.39,1
53759,5412,1000.00,16000.00,17000.00,5555.90,10444.10,0.14,1
53760,5412,-1000.00,15000.00,16000.00,0.00,9456.86,0.23,0
53761,5412,-1000.00,14000.00,15000.00,0.00,14097.89,0.26,0
53762,5412,-1000.00,13000.00,14000.00,0.00,12409.61,0.42,0
53763,5412,-1000.00,12000.00,13000.00,3892.78,2039.30,0.14,0
53764,5412,-1000.00,11000.00,12000.00,3449.66,9550.34,0.18,0
53765,5412,-1000.00,10000.00,11000.00,6474.19,5525.81,0.12,0
53766,5412,-1000.00,9000.00,10000.00,0.00,11000.00,0.29,0
53767,5412,-1000.00,8000.00,9000.00,2118.80,4118.49,0.26,0
53768,5412,-1000.00,7000.00,8000.00,1711.52,7288.48,0.40,0
53769,5412,-1000.00,6000.00,7000.00,3161.84,4838.16,0.18,0
53770,5412,-827.55,5172.45,6172.45,0.00,827.55,0.11,0
53771,5412,-1000.00,4172.45,5172.45,0.00,6172.45,0.03,0
53772,5412,-1000.00,3172.45,4172.45,616.10,4556.35,0.43,0
53773,5412,-1000.00,2172.45,3172.45,1183.20,2989.25,0.32,0
53774,5412,-1000.00,1172.45,2172.45,6.40,3166.04,0.31,0
53775,5412,-1000.00,172.45,1172.45,1086.22,1086.22,0.01,0
53776,5412,-1000.00,-827.55,172.45,562.04,0.00,0.06,0
53777,5412,-57.11,-884.67,115.33,0.00,57.11,0.23,0
53778,5412,-115.33,-1000.00,-0.00,29.76,85.57,0.13,0
53779,5413,-1000.00,-1000.00,0.00,387.24,612.76,0.30,0
53780,5414,-1000.00,-1000.00,0.00,0.00,1000.00,0.19,0
53781,5415,1000.00,1000.00,2000.00,0.00,690.73,0.36,1
53782,5415,1000.00,2000.00,3000.00,1000.00,1000.00,0.09,1
53783,5415,1000.00,3000.00,4000.00,0.00,398.34,0.14,1
53784,5415,1000.00,4000.00,5000.00,0.00,755.53,0.17,1
53785,5415,1000.00,5000.00,6000.00,0.00,2380.66,0.26,1
53786,5415,1000.00,6000.00,7000.00,0.00,6000.00,0.02,1
53787,5415,1000.00,7000.00,8000.00,2042.79,4957.21,0.30,1
53788,5415,1000.00,8000.00,9000.00,0.00,1108.51,0.13,1
53789,5415,1000.00,9000.00,10000.00,1233.08,7766.92,0.43,1
53790,5415,1000.00,10000.00,11000.00,0.00,4516.49,0.29,1
53791,5415,1000.00,11000.00,12000.00,2653.62,8346.38,0.01,1
53792,5415,-1000.00,10000.00,11000.00,7466.43,4533.57,0.00,0
53793,5415,1000.00,11000.00,12000.00,0.00,8021.87,0.30,1
53794,5415,-1000.00,10000.00,11000.00,8833.66,3166.34,0.03,0
53795,5415,1000.00,11000.00,12000.00,0.00,11000.00,0.10,1
53796,5415,1000.00,12000.00,13000.00,1238.73,5794.75,0.30,1
53797,5415,1000.00,13000.00,14000.00,0.00,13000.00,0.25,1
53798,5415,1000.00,14000.00,15000.00,0.00,3373.76,0.15,1
53799,5415,1000.00,15000.00,16000.00,0.00,15000.00,0.41,1
53800,5415,1000.00,16000.00,17000.00,5827.64,10172.36,0.25,1
53801,5415,1000.00,17000.00,18000.00,5545.31,11454.69,0.32,1
53802,5416,-1000.00,-1000.00,0.00,0.00,1000.00,0.17,0
53803,5417,-1000.00,-1000.00,0.00,403.37,596.63,0.20,0
53804,5418,1000.00,1000.00,2000.00,0.00,1000.00,0.22,1
53805,5418,0.00,1000.00,2000.00,0.00,0.00,0.02,0
53806,5418,1000.00,2000.00,3000.00,0.00,38.87,0.08,1
53807,5418,1000.00,3000.00,4000.00,0.00,3000.00,0.43,1
53808,5418,1000.00,4000.00,5000.00,0.00,3260.03,0.01,1
53809,5418,1000.00,5000.00,6000.00,0.00,5000.00,0.16,1
53810,5418,1000.00,6000.00,7000.00,0.00,6000.00,0.16,1
53811,5418,-1000.00,5000.00,6000.00,1904.35,810.66,0.13,0
53812,5418,1000.00,6000.00,7000.00,2271.05,3728.95,0.24,1
53813,5418,1000.00,7000.00,8000.00,893.48,6106.52,0.41,1
53814,5418,-1000.00,6000.00,7000.00,4284.94,3715.06,0.16,0
53815,5418,-1000.00,5000.00,6000.00,3783.57,3216.43,0.05,0
53816,5418,0.00,5000.00,6000.00,0.00,0.00,0.05,0
53817,5418,1000.00,6000.00,7000.00,0.00,6000.00,0.01,1
53818,5418,1000.00,7000.00,8000.00,0.00,7000.00,0.37,1
53819,5418,1000.00,8000.00,9000.00,1585.78,6414.22,0.27,1
53820,5418,1000.00,9000.00,10000.00,3810.49,5189.51,0.12,1
53821,5418,1000.00,10000.00,11000.00,2685.92,7314.08,0.37,1
53822,5418,1000.00,11000.00,12000.00,1763.89,3474.81,0.22,1
53823,5418,1000.00,12000.00,13000.00,0.00,1456.60,0.15,1
53824,5418,1000.00,13000.00,14000.00,4370.95,8629.05,0.32,1
53825,5418,1000.00,14000.00,15000.00,993.10,13006.90,0.27,1
53826,5418,1000.00,15000.00,16000.00,6029.14,8970.86,0.27,1
53827,5418,1000.00,16000.00,17000.00,0.00,8514.70,0.28,1
53828,5418,-1000.00,15000.00,16000.00,7849.99,4894.77,0.16,0
53829,5418,-1000.00,14000.00,15000.00,4223.67,0.00,0.40,0
53830,5418,-1000.00,13000.00,14000.00,15000.00,0.00,0.01,0
53831,5418,-1000.00,12000.00,13000.00,6451.74,0.00,0.19,0
53832,5418,-1000.00,11000.00,12000.00,0.00,3720.41,0.22,0
53833,5418,-1000.00,10000.00,11000.00,0.00,4254.91,0.36,0
53834,5418,-1000.00,9000.00,10000.00,2626.52,7516.41,0.39,0
53835,5418,-1000.00,8000.00,9000.00,0.00,5358.71,0.03,0
53836,5418,-1000.00,7000.00,8000.00,1314.81,7685.19,0.35,0
53837,5418,-1000.00,6000.00,7000.00,3002.76,4997.24,0.18,0
53838,5419,-1000.00,-1000.00,0.00,0.00,1000.00,0.04,0
53839,5420,-1000.00,-1000.00,0.00,359.73,640.27,0.30,0
53840,5421,-893.59,-893.59,106.41,0.00,893.59,0.43,0
53841,5421,-1000.00,-1893.59,-893.59,54.61,51.80,0.13,0
53842,5422,-628.06,-628.06,371.94,0.00,628.06,0.36,0
53843,5422,-1000.00,-1628.06,-628.06,220.78,151.15,0.15,0
53844,5423,0.00,0.00,1000.00,0.00,0.00,0.01,0
53845,5423,-103.20,-103.20,896.80,103.20,0.00,0.07,0
53846,5423,1000.00,896.80,1896.80,0.00,771.89,0.43,1
53847,5423,1000.00,1896.80,2896.80,0.00,1896.80,0.26,1
53848,5423,1000.00,2896.80,3896.80,0.00,2835.60,0.33,1
53849,5423,1000.00,3896.80,4896.80,315.44,3112.49,0.41,1
53850,5423,1000.00,4896.80,5896.80,2398.26,2498.54,0.11,1
53851,5423,1000.00,5896.80,6896.80,0.00,4009.71,0.16,1
53852,5423,1000.00,6896.80,7896.80,0.00,5188.14,0.36,1
53853,5423,1000.00,7896.80,8896.80,0.00,6622.55,0.09,1
53854,5423,1000.00,8896.80,9896.80,1474.78,3397.31,0.25,1
53855,5423,-1000.00,7896.80,8896.80,5591.58,4305.22,0.18,0
53856,5423,1000.00,8896.80,9896.80,3952.76,4944.04,0.26,1
53857,5423,1000.00,9896.80,10896.80,0.00,9896.80,0.02,1
53858,5423,1000.00,10896.80,11896.80,0.00,8594.70,0.36,1
53859,5423,1000.00,11896.80,12896.80,0.00,10992.09,0.05,1
53860,5423,1000.00,12896.80,13896.80,4571.28,8325.52,0.29,1
53861,5423,1000.00,13896.80,14896.80,0.00,13896.80,0.20,1
53862,5423,1000.00,14896.80,15896.80,0.00,11245.96,0.20,1
53863,5423,1000.00,15896.80,16896.80,2005.04,11659.21,0.39,1
53864,5423,1000.00,16896.80,17896.80,8117.93,8778.87,0.13,1
53865,5423,1000.00,17896.80,18896.80,2687.00,15209.80,0.36,1
53866,5423,1000.00,18896.80,19896.80,1467.19,17429.61,0.36,1
53867,5423,1000.00,19896.80,20896.80,0.00,19896.80,0.28,1
53868,5423,1000.00,20896.80,21896.80,6052.62,14844.18,0.34,1
53869,5423,1000.00,21896.80,22896.80,6412.73,15484.07,0.24,1
53870,5423,1000.00,22896.80,23896.80,0.00,22896.80,0.26,1
53871,5423,1000.00,23896.80,24896.80,0.00,2748.11,0.14,1
53872,5423,1000.00,24896.80,25896.80,0.00,6732.64,0.11,1
53873,5423,1000.00,25896.80,26896.80,0.00,25896.80,0.44,1
53874,5423,0.00,25896.80,26896.80,0.00,0.00,0.03,0
53875,5423,1000.00,26896.80,27896.80,13448.40,13448.40,0.04,1
53876,5423,1000.00,27896.80,28896.80,0.00,27896.80,0.28,1
53877,5423,1000.00,28896.80,29896.80,0.00,28896.80,0.38,1
53878,5423,1000.00,29896.80,30896.80,0.00,29896.80,0.20,1
53879,5423,1000.00,30896.80,31896.80,0.00,30896.80,0.34,1
53880,5423,1000.00,31896.80,32896.80,0.00,31896.80,0.42,1
53881,5423,1000.00,32896.80,33896.80,11746.63,21150.17,0.29,1
53882,5423,1000.00,33896.80,34896.80,16788.98,17107.82,0.11,1
53883,5423,1000.00,34896.80,35896.80,0.00,34896.80,0.37,1
53884,5423,1000.00,35896.80,36896.80,0.00,35896.80,0.09,1
53885,5423,1000.00,36896.80,37896.80,0.00,30433.11,0.11,1
53886,5423,1000.00,37896.80,38896.80,0.00,32858.29,0.36,1
53887,5423,1000.00,38896.80,39896.80,0.00,38896.80,0.34,1
53888,5423,1000.00,39896.80,40896.80,9280.19,25069.39,0.34,1
53889,5423,-843.49,39053.31,40053.31,843.49,0.00,0.04,0
53890,5423,1000.00,40053.31,41053.31,17571.95,22481.36,0.13,1
53891,5423,-1000.00,39053.31,40053.31,10438.86,30614.45,0.19,0
53892,5423,-1000.00,38053.31,39053.31,0.00,29812.11,0.35,0
53893,5423,-1000.00,37053.31,38053.31,6145.80,15257.93,0.26,0
53894,5423,-1000.00,36053.31,37053.31,18489.37,19563.94,0.06,0
53895,5423,-1000.00,35053.31,36053.31,0.00,27790.98,0.39,0
53896,5423,-1000.00,34053.31,35053.31,0.00,26202.90,0.40,0
53897,5423,-1000.00,33053.31,34053.31,0.00,19694.88,0.17,0
53898,5423,-1000.00,32053.31,33053.31,0.00,26314.66,0.41,0
53899,5423,-1000.00,31053.31,32053.31,12276.33,20776.98,0.03,0
53900,5423,-1000.00,30053.31,31053.31,0.00,32053.31,0.40,0
53901,5423,-1000.00,29053.31,30053.31,0.00,31053.31,0.35,0
53902,5423,-1000.00,28053.31,29053.31,0.00,30053.31,0.27,0
53903,5423,-1000.00,27053.31,28053.31,0.00,29053.31,0.16,0
53904,5423,-1000.00,26053.31,27053.31,735.02,27318.29,0.34,0
53905,5423,-1000.00,25053.31,26053.31,13526.65,13526.65,0.04,0
53906,5423,-1000.00,24053.31,25053.31,11124.76,14928.55,0.18,0
53907,5423,-1000.00,23053.31,24053.31,0.00,9835.52,0.09,0
53908,5423,-1000.00,22053.31,23053.31,0.00,12954.96,0.31,0
53909,5423,-1000.00,21053.31,22053.31,3246.63,19806.68,0.17,0
53910,5423,-1000.00,20053.31,21053.31,7730.34,0.00,0.02,0
53911,5423,-1000.00,19053.31,20053.31,2336.73,18716.58,0.14,0
53912,5423,-1000.00,18053.31,19053.31,6955.23,13098.08,0.29,0
53913,5423,-1000.00,17053.31,18053.31,8425.74,10627.57,0.20,0
53914,5424,1000.00,1000.00,2000.00,271.58,0.00,0.03,1
53915,5424,-1000.00,0.00,1000.00,341.12,1658.88,0.32,0
53916,5424,1000.00,1000.00,2000.00,485.85,428.19,0.20,1
53917,5424,-1000.00,0.00,1000.00,0.00,2000.00,0.37,0
53918,5424,-1000.00,-1000.00,0.00,0.00,1000.00,0.36,0
53919,5425,-1000.00,-1000.00,0.00,0.00,1000.00,0.13,0
53920,5426,-1000.00,-1000.00,0.00,426.66,573.34,0.24,0
53921,5427,-1000.00,-1000.00,0.00,0.00,1000.00,0.37,0
53922,5428,1000.00,1000.00,2000.00,0.00,1000.00,0.21,1
53923,5428,1000.00,2000.00,3000.00,207.63,1792.37,0.39,1
53924,5428,1000.00,3000.00,4000.00,0.00,3000.00,0.03,1
53925,5428,1000.00,4000.00,5000.00,1456.14,2543.86,0.31,1
53926,5428,1000.00,5000.00,6000.00,0.00,3451.56,0.34,1
53927,5428,-1000.00,4000.00,5000.00,2408.78,0.00,0.08,0
53928,5428,1000.00,5000.00,6000.00,1202.11,3797.89,0.39,1
53929,5428,1000.00,6000.00,7000.00,1739.27,3923.79,0.33,1
53930,5428,-1000.00,5000.00,6000.00,2829.25,216.51,0.10,0
53931,5428,1000.00,6000.00,7000.00,0.00,100.19,0.03,1
53932,5428,0.00,6000.00,7000.00,0.00,0.00,0.07,0
53933,5428,1000.00,7000.00,8000.00,0.00,1715.85,0.19,1
53934,5428,1000.00,8000.00,9000.00,0.00,2889.01,0.15,1
53935,5428,1000.00,9000.00,10000.00,0.00,9000.00,0.06,1
53936,5428,1000.00,10000.00,11000.00,0.00,10000.00,0.35,1
53937,5428,1000.00,11000.00,12000.00,2976.48,8023.52,0.37,1
53938,5428,1000.00,12000.00,13000.00,1675.22,10324.78,0.42,1
53939,5428,1000.00,13000.00,14000.00,0.00,8877.00,0.37,1
53940,5428,1000.00,14000.00,15000.00,0.00,13070.69,0.43,1
53941,5428,1000.00,15000.00,16000.00,5323.20,9676.80,0.14,1
53942,5428,1000.00,16000.00,17000.00,0.00,13927.94,0.33,1
53943,5428,-1000.00,15000.00,16000.00,9806.64,7193.36,0.17,0
53944,5428,1000.00,16000.00,17000.00,787.30,15212.70,0.29,1
53945,5428,-1000.00,15000.00,16000.00,11489.99,5510.01,0.04,0
53946,5428,-1000.00,14000.00,15000.00,0.00,10650.68,0.27,0
53947,5428,-1000.00,13000.00,14000.00,0.00,6172.74,0.20,0
53948,5428,-1000.00,12000.00,13000.00,1991.66,12008.34,0.41,0
53949,5428,-1000.00,11000.00,12000.00,0.00,13000.00,0.04,0
53950,5428,-1000.00,10000.00,11000.00,0.00,7116.61,0.22,0
53951,5428,-1000.00,9000.00,10000.00,3026.12,7973.88,0.32,0
53952,5428,-1000.00,8000.00,9000.00,3198.67,6801.33,0.17,0
53953,5428,-1000.00,7000.00,8000.00,0.00,9000.00,0.13,0
53954,5428,-1000.00,6000.00,7000.00,0.00,6255.20,0.32,0
53955,5428,-1000.00,5000.00,6000.00,0.00,7000.00,0.02,0
53956,5428,-1000.00,4000.00,5000.00,773.70,430.09,0.13,0
53957,5428,-1000.00,3000.00,4000.00,908.33,1218.76,0.24,0
53958,5428,-1000.00,2000.00,3000.00,0.00,4000.00,0.08,0
53959,5428,-1000.00,1000.00,2000.00,1302.22,1697.78,0.01,0
53960,5428,-1000.00,0.00,1000.00,1110.88,889.12,0.13,0
53961,5428,-1000.00,-1000.00,0.00,0.00,1000.00,0.13,0
53962,5429,-661.68,-661.68,338.32,0.00,661.68,0.38,0
53963,5429,-338.32,-1000.00,0.00,0.00,338.32,0.33,0
53964,5430,-1000.00,-1000.00,0.00,0.00,1000.00,0.05,0
53965,5431,-1000.00,-1000.00,0.00,190.47,809.53,0.26,0
53966,5432,1000.00,1000.00,2000.00,0.00,1000.00,0.35,1
53967,5432,1000.00,2000.00,3000.00,29.70,1970.30,0.31,1
53968,5432,1000.00,3000.00,4000.00,0.00,3000.00,0.07,1
53969,5432,-1000.00,2000.00,3000.00,2989.65,731.61,0.08,0
53970,5432,-1000.00,1000.00,2000.00,2155.23,844.77,0.09,0
53971,5432,1000.00,2000.00,3000.00,605.63,1394.37,0.33,1
53972,5432,1000.00,3000.00,4000.00,0.00,3000.00,0.16,1
53973,5432,-562.92,2437.08,3437.08,562.92,0.00,0.03,0
53974,5432,1000.00,3437.08,4437.08,0.00,2075.48,0.32,1
53975,5432,1000.00,4437.08,5437.08,1907.05,2530.03,0.20,1
53976,5432,1000.00,5437.08,6437.08,1595.94,3841.14,0.36,1
53977,5432,1000.00,6437.08,7437.08,0.00,2556.90,0.26,1
53978,5432,1000.00,7437.08,8437.08,0.00,3298.79,0.02,1
53979,5432,1000.00,8437.08,9437.08,0.00,4146.47,0.21,1
53980,5432,0.00,8437.08,9437.08,0.00,0.00,0.08,0
53981,5432,1000.00,9437.08,10437.08,1992.05,7445.03,0.40,1
53982,5432,1000.00,10437.08,11437.08,3691.73,6745.35,0.29,1
53983,5432,-1000.00,9437.08,10437.08,6213.13,5223.95,0.13,0
53984,5432,1000.00,10437.08,11437.08,815.44,9621.64,0.44,1
53985,5432,1000.00,11437.08,12437.08,0.00,11437.08,0.30,1
53986,5432,1000.00,12437.08,13437.08,228.30,4079.67,0.24,1
53987,5432,1000.00,13437.08,14437.08,2219.97,11217.11,0.20,1
53988,5432,-1000.00,12437.08,13437.08,7631.77,6805.31,0.19,0
53989,5432,1000.00,13437.08,14437.08,4626.64,8810.44,0.11,1
53990,5432,0.00,13437.08,14437.08,0.00,0.00,0.02,0
53991,5432,1000.00,14437.08,15437.08,0.00,14251.51,0.44,1
53992,5432,1000.00,15437.08,16437.08,4405.07,11032.01,0.30,1
53993,5432,1000.00,16437.08,17437.08,8218.54,8218.54,0.08,1
53994,5432,1000.00,17437.08,18437.08,5346.22,12090.86,0.34,1
53995,5432,1000.00,18437.08,19437.08,3140.22,13897.96,0.39,1
53996,5432,1000.00,19437.08,20437.08,0.00,19437.08,0.38,1
53997,5432,1000.00,20437.08,21437.08,0.00,20437.08,0.23,1
53998,5432,-1000.00,19437.08,20437.08,11352.21,10084.87,0.00,0
53999,5432,1000.00,20437.08,21437.08,0.00,19548.20,0.14,1
54000,5432,1000.00,21437.08,22437.08,4748.70,16688.38,0.22,1
54001,5432,1000.00,22437.08,23437.08,0.00,11801.50,0.12,1
54002,5432,1000.00,23437.08,24437.08,0.00,23437.08,0.33,1
54003,5432,1000.00,24437.08,25437.08,0.00,24437.08,0.14,1
54004,5432,1000.00,25437.08,26437.08,9189.23,16247.85,0.31,1
54005,5432,-754.85,24682.24,25682.24,754.85,0.00,0.04,0
54006,5432,1000.00,25682.24,26682.24,11402.86,14279.38,0.23,1
54007,5432,-1000.00,24682.24,25682.24,17778.80,8903.43,0.04,0
54008,5432,1000.00,25682.24,26682.24,0.00,25682.24,0.24,1
54009,5432,-1000.00,24682.24,25682.24,19850.28,6831.96,0.01,0
54010,5432,1000.00,25682.24,26682.24,8978.73,16703.51,0.20,1
54011,5433,-269.20,-269.20,730.80,269.20,0.00,0.09,0
54012,5433,-1000.00,-1269.20,-269.20,131.69,162.17,0.39,0
54013,5434,1000.00,1000.00,2000.00,414.82,275.96,0.25,1
54014,5434,-1000.00,0.00,1000.00,0.00,1543.49,0.44,0
54015,5434,-1000.00,-1000.00,0.00,0.00,1000.00,0.13,0
54016,5435,-1000.00,-1000.00,0.00,0.00,1000.00,0.04,0
54017,5436,-151.81,-151.81,848.19,0.00,151.81,0.15,0
54018,5436,-604.44,-756.25,243.75,0.00,604.44,0.05,0
54019,5436,-34.30,-790.55,209.45,0.00,34.30,0.14,0
54020,5436,-209.45,-1000.00,0.00,0.00,209.45,0.20,0
54021,5437,-1000.00,-1000.00,0.00,0.00,263.91,0.24,0
54022,5438,0.00,0.00,1000.00,0.00,0.00,0.13,0
54023,5438,-1000.00,-1000.00,0.00,0.00,383.87,0.21,0
54024,5439,-545.18,-545.18,454.82,0.00,545.18,0.21,0
54025,5439,-454.82,-1000.00,0.00,96.72,358.10,0.14,0
54026,5440,-507.38,-507.38,492.62,0.00,507.38,0.37,0
54027,5440,-492.62,-1000.00,0.00,104.78,387.84,0.35,0
54028,5441,0.00,0.00,1000.00,0.00,0.00,0.05,0
54029,5441,0.00,0.00,1000.00,0.00,0.00,0.13,0
54030,5441,0.00,0.00,1000.00,0.00,0.00,0.37,0
54031,5441,-1000.00,-1000.00,0.00,0.00,892.75,0.20,0
54032,5442,0.00,0.00,1000.00,0.00,0.00,0.35,0
54033,5442,0.00,0.00,1000.00,0.00,0.00,0.32,0
54034,5442,0.00,0.00,1000.00,0.00,0.00,0.38,0
54035,5442,-670.34,-670.34,329.66,0.00,670.34,0.44,0
54036,5442,-329.66,-1000.00,-0.00,57.02,272.64,0.28,0
54037,5443,-1000.00,-1000.00,0.00,795.22,204.78,0.04,0
54038,5444,1000.00,1000.00,2000.00,0.00,942.77,0.44,1
54039,5444,1000.00,2000.00,3000.00,668.79,1331.21,0.14,1
54040,5444,1000.00,3000.00,4000.00,660.28,2339.72,0.40,1
54041,5444,1000.00,4000.00,5000.00,874.99,3125.01,0.40,1
54042,5444,1000.00,5000.00,6000.00,911.65,4088.35,0.16,1
54043,5444,1000.00,6000.00,7000.00,0.00,6000.00,0.16,1
54044,5444,1000.00,7000.00,8000.00,0.00,5362.51,0.39,1
54045,5444,1000.00,8000.00,9000.00,0.00,8000.00,0.24,1
54046,5444,1000.00,9000.00,10000.00,3778.93,5221.07,0.21,1
54047,5444,1000.00,10000.00,11000.00,0.00,2953.93,0.21,1
54048,5444,1000.00,11000.00,12000.00,2376.47,8623.53,0.40,1
54049,5444,1000.00,12000.00,13000.00,0.00,12000.00,0.42,1
54050,5444,1000.00,13000.00,14000.00,0.00,13000.00,0.28,1
54051,5444,1000.00,14000.00,15000.00,5311.62,8688.38,0.24,1
54052,5444,1000.00,15000.00,16000.00,0.00,9376.11,0.13,1
54053,5444,1000.00,16000.00,17000.00,0.00,4116.92,0.21,1
54054,5444,1000.00,17000.00,18000.00,5074.50,11925.50,0.09,1
54055,5444,1000.00,18000.00,19000.00,3222.33,14777.67,0.41,1
54056,5444,0.00,18000.00,19000.00,0.00,0.00,0.01,0
54057,5444,1000.00,19000.00,20000.00,0.00,19000.00,0.38,1
54058,5444,1000.00,20000.00,21000.00,0.00,9760.17,0.10,1
54059,5444,-1000.00,19000.00,20000.00,20407.79,592.21,0.01,0
54060,5444,1000.00,20000.00,21000.00,0.00,20000.00,0.02,1
54061,5444,-1000.00,19000.00,20000.00,9888.58,11111.42,0.06,0
54062,5444,-1000.00,18000.00,19000.00,1314.79,18685.21,0.22,0
54063,5444,-1000.00,17000.00,18000.00,0.00,11233.38,0.34,0
54064,5444,-1000.00,16000.00,17000.00,0.00,8581.07,0.24,0
54065,5444,-1000.00,15000.00,16000.00,0.00,14374.87,0.27,0
54066,5444,-1000.00,14000.00,15000.00,0.00,16000.00,0.04,0
54067,5444,-1000.00,13000.00,14000.00,1031.32,13968.68,0.44,0
54068,5444,-1000.00,12000.00,13000.00,0.00,14000.00,0.20,0
54069,5444,-1000.00,11000.00,12000.00,0.00,9407.62,0.39,0
54070,5444,-1000.00,10000.00,11000.00,1337.98,8186.26,0.38,0
54071,5444,-1000.00,9000.00,10000.00,5324.30,5675.70,0.05,0
54072,5444,-1000.00,8000.00,9000.00,0.00,7793.79,0.33,0
54073,5444,-1000.00,7000.00,8000.00,3623.11,5376.89,0.21,0
54074,5444,-1000.00,6000.00,7000.00,1754.67,6245.33,0.40,0
54075,5444,-1000.00,5000.00,6000.00,0.00,7000.00,0.05,0
54076,5444,-1000.00,4000.00,5000.00,176.29,4202.81,0.39,0
54077,5444,-1000.00,3000.00,4000.00,1615.24,3384.76,0.26,0
54078,5444,-1000.00,2000.00,3000.00,169.15,3830.85,0.44,0
54079,5444,-1000.00,1000.00,2000.00,1500.00,1500.00,0.02,0
54080,5444,-1000.00,0.00,1000.00,952.46,146.72,0.10,0
54081,5444,-1000.00,-1000.00,0.00,223.36,776.64,0.22,0
54082,5445,-992.37,-992.37,7.63,313.07,679.30,0.33,0
54083,5445,-7.63,-1000.00,0.00,1.91,5.72,0.32,0
54084,5446,-1000.00,-1000.00,0.00,236.95,763.05,0.37,0
54085,5447,-1000.00,-1000.00,0.00,0.00,699.79,0.09,0
54086,5448,1000.00,1000.00,2000.00,247.98,752.02,0.38,1
54087,5448,1000.00,2000.00,3000.00,406.65,1593.35,0.40,1
54088,5448,1000.00,3000.00,4000.00,0.00,3000.00,0.11,1
54089,5448,1000.00,4000.00,5000.00,1758.76,2241.24,0.21,1
54090,5448,1000.00,5000.00,6000.00,0.00,4348.84,0.26,1
54091,5448,-1000.00,4000.00,5000.00,4154.89,1845.11,0.06,0
54092,5448,1000.00,5000.00,6000.00,0.00,5000.00,0.14,1
54093,5448,1000.00,6000.00,7000.00,0.00,5791.55,0.39,1
54094,5448,1000.00,7000.00,8000.00,0.00,7000.00,0.02,1
54095,5448,-1000.00,6000.00,7000.00,1855.59,391.37,0.12,0
54096,5448,1000.00,7000.00,8000.00,0.00,7000.00,0.37,1
54097,5448,-1000.00,6000.00,7000.00,5231.13,2768.87,0.00,0
54098,5448,1000.00,7000.00,8000.00,0.00,2609.70,0.10,1
54099,5448,1000.00,8000.00,9000.00,0.00,6824.65,0.33,1
54100,5448,1000.00,9000.00,10000.00,0.00,1565.10,0.07,1
54101,5448,1000.00,10000.00,11000.00,0.00,10000.00,0.20,1
54102,5448,1000.00,11000.00,12000.00,0.00,11000.00,0.00,1
54103,5448,1000.00,12000.00,13000.00,5444.22,5802.11,0.23,1
54104,5448,-1000.00,11000.00,12000.00,9400.61,0.00,0.09,0
54105,5448,-1000.00,10000.00,11000.00,0.00,12000.00,0.02,0
54106,5448,-1000.00,9000.00,10000.00,731.89,10268.11,0.44,0
54107,5448,-1000.00,8000.00,9000.00,0.00,10000.00,0.40,0
54108,5448,-1000.00,7000.00,8000.00,3829.19,5170.81,0.27,0
54109,5448,-1000.00,6000.00,7000.00,0.00,8000.00,0.15,0
54110,5448,-1000.00,5000.00,6000.00,0.00,3773.79,0.24,0
54111,5448,0.00,5000.00,6000.00,0.00,0.00,0.10,0
54112,5448,-1000.00,4000.00,5000.00,0.00,6000.00,0.39,0
54113,5448,-1000.00,3000.00,4000.00,2282.39,2717.61,0.22,0
54114,5448,-1000.00,2000.00,3000.00,495.60,0.00,0.09,0
54115,5448,-1000.00,1000.00,2000.00,0.00,3000.00,0.33,0
54116,5448,-1000.00,0.00,1000.00,0.00,2000.00,0.34,0
54117,5448,-478.41,-478.41,521.59,0.00,478.41,0.27,0
54118,5448,-125.01,-603.42,396.58,0.00,125.01,0.20,0
54119,5448,-396.58,-1000.00,0.00,116.64,279.94,0.13,0
54120,5449,1000.00,1000.00,2000.00,208.69,791.31,0.40,1
54121,5449,1000.00,2000.00,3000.00,0.00,1576.99,0.19,1
54122,5449,1000.00,3000.00,4000.00,627.56,1667.94,0.32,1
54123,5449,1000.00,4000.00,5000.00,434.92,3565.08,0.42,1
54124,5449,1000.00,5000.00,6000.00,0.00,5000.00,0.23,1
54125,5449,1000.00,6000.00,7000.00,0.00,6000.00,0.21,1
54126,5449,1000.00,7000.00,8000.00,0.00,862.85,0.10,1
54127,5449,1000.00,8000.00,9000.00,472.99,7527.01,0.36,1
54128,5449,1000.00,9000.00,10000.00,0.00,9000.00,0.13,1
54129,5449,1000.00,10000.00,11000.00,3878.30,6121.70,0.19,1
54130,5449,-1000.00,9000.00,10000.00,5235.82,0.00,0.07,0
54131,5449,-1000.00,8000.00,9000.00,5264.79,1832.18,0.12,0
54132,5449,1000.00,9000.00,10000.00,0.00,8557.61,0.00,1
54133,5449,1000.00,10000.00,11000.00,451.88,9548.12,0.37,1
54134,5449,1000.00,11000.00,12000.00,2926.27,8073.73,0.37,1
54135,5449,1000.00,12000.00,13000.00,301.81,11698.19,0.36,1
54136,5449,1000.00,13000.00,14000.00,0.00,2160.60,0.06,1
54137,5449,1000.00,14000.00,15000.00,0.00,14000.00,0.07,1
54138,5449,-1000.00,13000.00,14000.00,2886.20,0.00,0.06,0
54139,5449,0.00,13000.00,14000.00,0.00,0.00,0.04,0
54140,5449,-1000.00,12000.00,13000.00,0.00,9805.33,0.15,0
54141,5449,-1000.00,11000.00,12000.00,0.00,13000.00,0.28,0
54142,5449,-1000.00,10000.00,11000.00,4475.11,0.00,0.08,0
54143,5449,-1000.00,9000.00,10000.00,385.13,10614.87,0.40,0
54144,5449,-1000.00,8000.00,9000.00,408.43,6913.64,0.39,0
54145,5449,-1000.00,7000.00,8000.00,0.00,9000.00,0.05,0
54146,5449,-1000.00,6000.00,7000.00,1433.13,6566.87,0.40,0
54147,5449,-1000.00,5000.00,6000.00,0.00,5360.47,0.11,0
54148,5449,-1000.00,4000.00,5000.00,0.00,6000.00,0.10,0
54149,5449,-1000.00,3000.00,4000.00,2500.00,2500.00,0.05,0
54150,5449,-1000.00,2000.00,3000.00,1151.77,2848.23,0.18,0
54151,5449,-1000.00,1000.00,2000.00,0.00,2238.81,0.28,0
54152,5449,-655.70,344.30,1344.30,0.00,655.70,0.23,0
54153,5449,-1000.00,-655.70,344.30,0.00,1344.30,0.25,0
54154,5449,-344.30,-1000.00,0.00,118.06,226.24,0.30,0
54155,5450,-461.62,-461.62,538.38,461.62,0.00,0.27,0
54156,5450,-1000.00,-1461.62,-461.62,0.00,538.38,0.10,0
54157,5451,-1000.00,-1000.00,0.00,0.00,1000.00,0.11,0
54158,5452,0.00,0.00,1000.00,0.00,0.00,0.26,0
54159,5452,0.00,0.00,1000.00,0.00,0.00,0.34,0
54160,5452,-1000.00,-1000.00,0.00,138.02,861.98,0.31,0
54161,5453,-1000.00,-1000.00,0.00,479.98,520.02,0.19,0
54162,5454,0.00,0.00,1000.00,0.00,0.00,0.06,0
54163,5454,1000.00,1000.00,2000.00,287.75,712.25,0.36,1
54164,5454,1000.00,2000.00,3000.00,908.89,1091.11,0.15,1
54165,5454,1000.00,3000.00,4000.00,0.00,3000.00,0.08,1
54166,5454,1000.00,4000.00,5000.00,0.00,2070.16,0.08,1
54167,5454,-1000.00,3000.00,4000.00,914.61,635.31,0.15,0
54168,5454,1000.00,4000.00,5000.00,0.00,4000.00,0.23,1
54169,5454,1000.00,5000.00,6000.00,0.00,5000.00,0.26,1
54170,5454,-1000.00,4000.00,5000.00,3144.60,2855.40,0.18,0
54171,5454,1000.00,5000.00,6000.00,676.40,4323.60,0.37,1
54172,5454,1000.00,6000.00,7000.00,97.33,5902.67,0.36,1
54173,5454,1000.00,7000.00,8000.00,0.00,4873.09,0.11,1
54174,5454,1000.00,8000.00,9000.00,0.00,8000.00,0.18,1
54175,5454,1000.00,9000.00,10000.00,0.00,9000.00,0.03,1
54176,5454,1000.00,10000.00,11000.00,2285.88,7714.12,0.39,1
54177,5454,1000.00,11000.00,12000.00,0.00,7373.96,0.13,1
54178,5454,1000.00,12000.00,13000.00,0.00,4786.22,0.26,1
54179,5454,1000.00,13000.00,14000.00,0.00,13000.00,0.10,1
54180,5454,1000.00,14000.00,15000.00,1427.86,12572.14,0.18,1
54181,5454,1000.00,15000.00,16000.00,4387.06,10612.94,0.36,1
54182,5454,1000.00,16000.00,17000.00,1265.02,9414.98,0.35,1
54183,5454,1000.00,17000.00,18000.00,4455.40,12544.60,0.35,1
54184,5454,-1000.00,16000.00,17000.00,0.00,18000.00,0.28,0
54185,5454,-1000.00,15000.00,16000.00,0.00,17000.00,0.44,0
54186,5454,-1000.00,14000.00,15000.00,3014.71,12985.29,0.05,0
54187,5454,-1000.00,13000.00,14000.00,7468.86,7531.14,0.11,0
54188,5454,-1000.00,12000.00,13000.00,0.00,8647.05,0.35,0
54189,5454,-1000.00,11000.00,12000.00,0.00,13000.00,0.12,0
54190,5454,-1000.00,10000.00,11000.00,755.36,11244.64,0.31,0
54191,5454,-1000.00,9000.00,10000.00,0.00,11000.00,0.19,0
54192,5454,-1000.00,8000.00,9000.00,5844.08,4155.92,0.12,0
54193,5454,-1000.00,7000.00,8000.00,0.00,5151.75,0.34,0
54194,5454,-1000.00,6000.00,7000.00,4000.00,4000.00,0.02,0
54195,5454,-1000.00,5000.00,6000.00,0.00,7000.00,0.22,0
54196,5454,-1000.00,4000.00,5000.00,246.39,5753.61,0.29,0
54197,5454,-1000.00,3000.00,4000.00,1573.79,3426.21,0.34,0
54198,5454,-1000.00,2000.00,3000.00,1017.49,2982.51,0.31,0
54199,5454,-1000.00,1000.00,2000.00,390.51,2609.49,0.43,0
54200,5454,-1000.00,0.00,1000.00,367.36,1632.64,0.41,0
54201,5454,-1000.00,-1000.00,0.00,490.92,509.08,0.06,0
54202,5455,-1000.00,-1000.00,0.00,995.69,0.00,0.02,0
54203,5456,-896.81,-896.81,103.19,569.67,327.14,0.15,0
54204,5456,1000.00,103.19,1103.19,0.00,91.22,0.20,1
54205,5456,1000.00,1103.19,2103.19,0.00,1103.19,0.35,1
54206,5456,1000.00,2103.19,3103.19,869.99,1233.20,0.16,1
54207,5456,1000.00,3103.19,4103.19,1109.90,1993.29,0.31,1
54208,5456,1000.00,4103.19,5103.19,11.69,3342.59,0.42,1
54209,5456,1000.00,5103.19,6103.19,1559.64,3543.55,0.32,1
54210,5456,1000.00,6103.19,7103.19,0.00,6103.19,0.16,1
54211,5456,1000.00,7103.19,8103.19,1170.37,5667.86,0.40,1
54212,5456,-1000.00,6103.19,7103.19,4738.03,3365.16,0.17,0
54213,5456,1000.00,7103.19,8103.19,0.00,3076.44,0.18,1
54214,5456,1000.00,8103.19,9103.19,447.80,7431.70,0.44,1
54215,5456,1000.00,9103.19,10103.19,2245.42,6857.77,0.32,1
54216,5456,1000.00,10103.19,11103.19,1608.10,2597.26,0.20,1
54217,5456,-1000.00,9103.19,10103.19,7146.42,2988.21,0.12,0
54218,5456,1000.00,10103.19,11103.19,1617.21,8485.98,0.41,1
54219,5456,0.00,10103.19,11103.19,0.00,0.00,0.09,0
54220,5456,1000.00,11103.19,12103.19,4491.65,6611.53,0.24,1
54221,5456,0.00,11103.19,12103.19,0.00,0.00,0.01,0
54222,5456,-1000.00,10103.19,11103.19,7147.95,3850.62,0.14,0
54223,5456,-1000.00,9103.19,10103.19,553.59,10549.60,0.30,0
54224,5456,-1000.00,8103.19,9103.19,1403.11,8700.08,0.43,0
54225,5456,-1000.00,7103.19,8103.19,1990.78,2887.94,0.22,0
54226,5456,-1000.00,6103.19,7103.19,4051.59,4051.59,0.07,0
54227,5456,-1000.00,5103.19,6103.19,6101.25,0.00,0.15,0
54228,5456,-1000.00,4103.19,5103.19,3101.56,3001.63,0.05,0
54229,5456,-1000.00,3103.19,4103.19,0.00,4985.94,0.42,0
54230,5456,-1000.00,2103.19,3103.19,2051.59,2051.59,0.07,0
54231,5456,-1000.00,1103.19,2103.19,0.00,3103.19,0.08,0
54232,5456,-1000.00,103.19,1103.19,667.66,1435.53,0.20,0
54233,5456,-1000.00,-896.81,103.19,0.00,385.97,0.03,0
54234,5456,-1000.00,-1896.81,-896.81,0.00,19.70,0.18,0
54235,5457,-1000.00,-1000.00,0.00,0.00,1000.00,0.00,0
54236,5458,-1000.00,-1000.00,0.00,460.25,539.75,0.15,0
54237,5459,-1000.00,-1000.00,0.00,237.95,750.63,0.37,0
54238,5460,-1000.00,-1000.00,0.00,680.16,20.56,0.06,0
54239,5461,-1000.00,-1000.00,0.00,0.00,60.04,0.31,0
54240,5462,1000.00,1000.00,2000.00,148.53,851.47,0.42,1
54241,5462,1000.00,2000.00,3000.00,619.94,1380.06,0.27,1
54242,5462,1000.00,3000.00,4000.00,0.00,3000.00,0.23,1
54243,5462,-1000.00,2000.00,3000.00,2012.48,1987.52,0.22,0
54244,5462,-1000.00,1000.00,2000.00,1716.12,1283.88,0.09,0
54245,5462,1000.00,2000.00,3000.00,0.00,1452.72,0.32,1
54246,5462,1000.00,3000.00,4000.00,857.18,2142.82,0.14,1
54247,5462,1000.00,4000.00,5000.00,0.00,4000.00,0.23,1
54248,5462,1000.00,5000.00,6000.00,1888.96,3111.04,0.28,1
54249,5462,1000.00,6000.00,7000.00,0.00,6000.00,0.26,1
54250,5462,1000.00,7000.00,8000.00,517.42,3005.78,0.28,1
54251,5462,1000.00,8000.00,9000.00,1322.45,6677.55,0.42,1
54252,5462,-1000.00,7000.00,8000.00,3108.29,0.00,0.09,0
54253,5462,1000.00,8000.00,9000.00,0.00,2329.50,0.20,1
54254,5462,1000.00,9000.00,10000.00,3460.99,5539.01,0.27,1
54255,5462,1000.00,10000.00,11000.00,4451.52,5548.48,0.25,1
54256,5462,1000.00,11000.00,12000.00,3557.53,7442.47,0.30,1
54257,5462,1000.00,12000.00,13000.00,2885.31,9114.69,0.38,1
54258,5462,1000.00,13000.00,14000.00,5893.03,7106.97,0.24,1
54259,5462,1000.00,14000.00,15000.00,1171.93,12828.07,0.43,1
54260,5462,1000.00,15000.00,16000.00,0.00,27.45,0.07,1
54261,5462,1000.00,16000.00,17000.00,6042.25,9957.75,0.12,1
54262,5462,-1000.00,15000.00,16000.00,9010.33,0.00,0.04,0
54263,5462,1000.00,16000.00,17000.00,0.00,16000.00,0.11,1
54264,5462,-1000.00,15000.00,16000.00,13038.25,3961.75,0.03,0
54265,5462,1000.00,16000.00,17000.00,2296.96,13703.04,0.31,1
54266,5462,1000.00,17000.00,18000.00,0.00,15006.73,0.10,1
54267,5462,1000.00,18000.00,19000.00,0.00,14309.31,0.01,1
54268,5462,1000.00,19000.00,20000.00,4685.66,14314.34,0.38,1
54269,5462,1000.00,20000.00,21000.00,0.00,20000.00,0.35,1
54270,5462,1000.00,21000.00,22000.00,0.00,21000.00,0.08,1
54271,5462,-1000.00,20000.00,21000.00,12061.36,9938.64,0.16,0
54272,5462,1000.00,21000.00,22000.00,0.00,17969.88,0.36,1
54273,5462,1000.00,22000.00,23000.00,7448.30,14551.70,0.18,1
54274,5462,1000.00,23000.00,24000.00,8802.63,14197.37,0.14,1
54275,5462,1000.00,24000.00,25000.00,0.00,4769.03,0.17,1
54276,5462,1000.00,25000.00,26000.00,0.00,25000.00,0.21,1
54277,5462,1000.00,26000.00,27000.00,0.00,23480.43,0.35,1
54278,5462,1000.00,27000.00,28000.00,0.00,15121.41,0.34,1
54279,5462,1000.00,28000.00,29000.00,0.00,28000.00,0.25,1
54280,5462,0.00,28000.00,29000.00,0.00,0.00,0.03,0
54281,5463,-506.72,-506.72,493.28,0.00,506.72,0.31,0
54282,5463,-171.34,-678.05,321.95,56.13,115.20,0.19,0
54283,5463,-321.95,-1000.00,0.00,76.94,245.01,0.39,0
54284,5464,-1000.00,-1000.00,0.00,0.00,912.47,0.07,0
54285,5465,-1000.00,-1000.00,0.00,452.15,547.85,0.20,0
54286,5466,-1000.00,-1000.00,0.00,0.00,1000.00,0.32,0
54287,5467,-1000.00,-1000.00,0.00,0.00,1000.00,0.21,0
54288,5468,-1000.00,-1000.00,0.00,0.00,135.32,0.43,0
54289,5469,-1000.00,-1000.00,0.00,0.00,1000.00,0.21,0
54290,5470,-842.07,-842.07,157.93,0.00,842.07,0.15,0
54291,5470,-81.23,-923.30,76.70,25.53,55.70,0.36,0
54292,5470,1000.00,76.70,1076.70,49.19,0.00,0.21,1
54293,5470,-572.10,-495.39,504.61,0.00,572.10,0.24,0
54294,5470,-385.41,-880.80,119.20,110.70,274.71,0.27,0
54295,5470,0.00,-880.80,119.20,0.00,0.00,0.16,0
54296,5470,-38.86,-919.66,80.34,0.00,38.86,0.38,0
54297,5470,0.00,-919.66,80.34,0.00,0.00,0.31,0
54298,5470,1000.00,80.34,1080.34,42.91,0.00,0.22,1
54299,5470,-653.67,-573.33,426.67,0.00,653.67,0.24,0
54300,5470,0.00,-573.33,426.67,0.00,0.00,0.13,0
54301,5470,1000.00,426.67,1426.67,269.78,94.55,0.24,1
54302,5470,1000.00,1426.67,2426.67,859.05,567.62,0.11,1
54303,5470,-1000.00,426.67,1426.67,0.00,1236.43,0.29,0
54304,5470,1000.00,1426.67,2426.67,448.28,0.00,0.38,1
54305,5470,1000.00,2426.67,3426.67,1407.58,0.00,0.26,1
54306,5470,1000.00,3426.67,4426.67,2199.68,1226.99,0.12,1
54307,5470,0.00,3426.67,4426.67,0.00,0.00,0.29,0
54308,5470,-1000.00,2426.67,3426.67,0.00,4426.67,0.04,0
54309,5470,-1000.00,1426.67,2426.67,900.10,976.64,0.40,0
54310,5470,-1000.00,426.67,1426.67,0.00,2247.56,0.24,0
54311,5470,-1000.00,-573.33,426.67,1352.78,0.00,0.08,0
54312,5470,-138.73,-712.07,287.93,138.73,0.00,0.38,0
54313,5470,-191.32,-903.39,96.61,191.32,0.00,0.13,0
54314,5470,-55.49,-958.88,41.12,55.49,0.00,0.15,0
54315,5470,-14.45,-973.33,26.67,14.45,0.00,0.27,0
54316,5470,0.00,-973.33,26.67,0.00,0.00,0.34,0
54317,5470,-15.47,-988.79,11.21,9.33,6.14,0.35,0
54318,5470,-1000.00,-1988.79,-988.79,4.90,6.31,0.26,0
54319,5471,-1000.00,-1000.00,0.00,0.00,1000.00,0.01,0
54320,5472,-907.15,-907.15,92.85,907.15,0.00,0.13,0
54321,5472,-1000.00,-1907.15,-907.15,0.00,46.97,0.20,0
54322,5473,0.00,0.00,1000.00,0.00,0.00,0.12,0
54323,5473,-1000.00,-1000.00,0.00,0.00,129.42,0.26,0
54324,5474,1000.00,1000.00,2000.00,317.72,682.28,0.17,1
54325,5474,1000.00,2000.00,3000.00,144.75,1256.37,0.36,1
54326,5474,-1000.00,1000.00,2000.00,1973.22,0.00,0.01,0
54327,5474,1000.00,2000.00,3000.00,0.00,2000.00,0.15,1
54328,5474,1000.00,3000.00,4000.00,736.20,2263.80,0.08,1
54329,5474,-1000.00,2000.00,3000.00,2127.18,1872.82,0.06,0
54330,5474,1000.00,3000.00,4000.00,156.67,2843.33,0.37,1
54331,5474,1000.00,4000.00,5000.00,1382.81,2617.19,0.33,1
54332,5474,1000.00,5000.00,6000.00,0.00,4651.10,0.27,1
54333,5474,1000.00,6000.00,7000.00,702.14,5297.86,0.43,1
54334,5474,1000.00,7000.00,8000.00,1058.08,4645.66,0.37,1
54335,5474,1000.00,8000.00,9000.00,429.50,7570.50,0.27,1
54336,5474,-1000.00,7000.00,8000.00,5035.84,3964.16,0.15,0
54337,5474,0.00,7000.00,8000.00,0.00,0.00,0.02,0
54338,5474,-1000.00,6000.00,7000.00,4014.60,3985.40,0.19,0
54339,5474,1000.00,7000.00,8000.00,0.00,927.06,0.16,1
54340,5474,1000.00,8000.00,9000.00,0.00,4892.68,0.18,1
54341,5474,0.00,8000.00,9000.00,0.00,0.00,0.05,0
54342,5474,1000.00,9000.00,10000.00,2697.15,6302.85,0.28,1
54343,5474,1000.00,10000.00,11000.00,0.00,10000.00,0.21,1
54344,5474,1000.00,11000.00,12000.00,1056.53,9943.47,0.40,1
54345,5474,1000.00,12000.00,13000.00,945.36,7864.36,0.37,1
54346,5474,-1000.00,11000.00,12000.00,8268.39,4731.61,0.09,0
54347,5474,1000.00,12000.00,13000.00,0.00,12000.00,0.03,1
54348,5474,1000.00,13000.00,14000.00,0.00,13000.00,0.29,1
54349,5474,1000.00,14000.00,15000.00,203.44,13796.56,0.18,1
54350,5474,-1000.00,13000.00,14000.00,10908.01,4091.99,0.00,0
54351,5474,1000.00,14000.00,15000.00,0.00,9399.38,0.20,1
54352,5474,1000.00,15000.00,16000.00,0.00,15000.00,0.31,1
54353,5474,1000.00,16000.00,17000.00,7849.62,8150.38,0.12,1
54354,5474,0.00,16000.00,17000.00,0.00,0.00,0.01,0
54355,5474,-1000.00,15000.00,16000.00,0.00,7251.78,0.14,0
54356,5474,-1000.00,14000.00,15000.00,0.00,782.14,0.09,0
54357,5474,-1000.00,13000.00,14000.00,2111.42,12888.58,0.38,0
54358,5474,-1000.00,12000.00,13000.00,217.21,10054.86,0.38,0
54359,5474,-1000.00,11000.00,12000.00,5046.15,7953.85,0.15,0
54360,5474,-1000.00,10000.00,11000.00,0.00,10420.18,0.39,0
54361,5474,-1000.00,9000.00,10000.00,0.00,8767.09,0.35,0
54362,5474,-1000.00,8000.00,9000.00,1497.98,0.00,0.18,0
54363,5474,-1000.00,7000.00,8000.00,2082.47,6917.53,0.16,0
54364,5474,-1000.00,6000.00,7000.00,1554.01,6445.99,0.41,0
54365,5475,1000.00,1000.00,2000.00,0.00,350.44,0.27,1
54366,5475,1000.00,2000.00,3000.00,1000.00,1000.00,0.01,1
54367,5475,1000.00,3000.00,4000.00,818.91,2181.09,0.36,1
54368,5475,1000.00,4000.00,5000.00,0.00,4000.00,0.14,1
54369,5475,-1000.00,3000.00,4000.00,0.00,5000.00,0.27,0
54370,5475,-1000.00,2000.00,3000.00,1185.73,2814.27,0.12,0
54371,5475,-1000.00,1000.00,2000.00,146.00,2854.00,0.43,0
54372,5475,-1000.00,0.00,1000.00,0.00,2000.00,0.29,0
54373,5475,-1000.00,-1000.00,0.00,0.00,668.27,0.38,0
54374,5476,0.00,0.00,1000.00,0.00,0.00,0.04,0
54375,5476,-1000.00,-1000.00,0.00,0.00,147.07,0.32,0
54376,5477,-537.51,-537.51,462.49,537.51,0.00,0.06,0
54377,5477,0.00,-537.51,462.49,0.00,0.00,0.09,0
54378,5477,-234.85,-772.36,227.64,150.07,84.78,0.22,0
54379,5477,-227.64,-1000.00,0.00,227.64,0.00,0.00,0
54380,5478,1000.00,1000.00,2000.00,198.65,801.35,0.38,1
54381,5478,1000.00,2000.00,3000.00,0.00,713.13,0.22,1
54382,5478,1000.00,3000.00,4000.00,0.00,3000.00,0.43,1
54383,5478,1000.00,4000.00,5000.00,1497.91,2502.09,0.17,1
54384,5478,1000.00,5000.00,6000.00,0.00,1580.74,0.08,1
54385,5478,1000.00,6000.00,7000.00,1741.76,4258.24,0.07,1
54386,5478,-730.37,5269.63,6269.63,730.37,0.00,0.08,0
54387,5478,1000.00,6269.63,7269.63,0.00,6269.63,0.13,1
54388,5478,1000.00,7269.63,8269.63,591.59,6678.04,0.20,1
54389,5478,1000.00,8269.63,9269.63,3141.36,5128.27,0.26,1
54390,5478,1000.00,9269.63,10269.63,554.92,7048.45,0.41,1
54391,5478,1000.00,10269.63,11269.63,0.00,10269.63,0.01,1
54392,5478,1000.00,11269.63,12269.63,0.00,1819.53,0.17,1
54393,5478,1000.00,12269.63,13269.63,861.14,11408.49,0.36,1
54394,5478,1000.00,13269.63,14269.63,363.55,12906.08,0.44,1
54395,5478,1000.00,14269.63,15269.63,0.00,14269.63,0.01,1
54396,5478,1000.00,15269.63,16269.63,0.00,15269.63,0.38,1
54397,5478,1000.00,16269.63,17269.63,4757.17,11512.46,0.05,1
54398,5478,0.00,16269.63,17269.63,0.00,0.00,0.11,0
54399,5478,1000.00,17269.63,18269.63,6166.51,11103.12,0.10,1
54400,5478,1000.00,18269.63,19269.63,0.00,18269.63,0.22,1
54401,5478,0.00,18269.63,19269.63,0.00,0.00,0.04,0
54402,5478,-1000.00,17269.63,18269.63,6156.56,3947.86,0.16,0
54403,5478,1000.00,18269.63,19269.63,6542.28,11727.35,0.29,1
54404,5478,1000.00,19269.63,20269.63,5725.08,13544.55,0.08,1
54405,5478,1000.00,20269.63,21269.63,0.00,20269.63,0.05,1
54406,5478,1000.00,21269.63,22269.63,0.00,21269.63,0.38,1
54407,5478,0.00,21269.63,22269.63,0.00,0.00,0.05,0
54408,5478,1000.00,22269.63,23269.63,0.00,22269.63,0.06,1
54409,5478,1000.00,23269.63,24269.63,11634.82,11634.82,0.08,1
54410,5478,1000.00,24269.63,25269.63,0.00,14582.62,0.32,1
54411,5478,1000.00,25269.63,26269.63,12488.92,12780.71,0.16,1
54412,5478,1000.00,26269.63,27269.63,0.00,26269.63,0.05,1
54413,5478,1000.00,27269.63,28269.63,0.00,27269.63,0.15,1
54414,5478,1000.00,28269.63,29269.63,9808.49,18461.14,0.28,1
54415,5478,-1000.00,27269.63,28269.63,16296.60,11141.67,0.17,0
54416,5478,1000.00,28269.63,29269.63,0.00,24185.33,0.42,1
54417,5478,1000.00,29269.63,30269.63,0.00,29269.63,0.16,1
54418,5478,1000.00,30269.63,31269.63,7180.02,14158.19,0.28,1
54419,5478,1000.00,31269.63,32269.63,0.00,31269.63,0.03,1
54420,5478,1000.00,32269.63,33269.63,0.00,7335.11,0.15,1
54421,5478,1000.00,33269.63,34269.63,0.00,33269.63,0.32,1
54422,5478,1000.00,34269.63,35269.63,4851.84,29417.79,0.43,1
54423,5478,1000.00,35269.63,36269.63,9065.41,26204.22,0.37,1
54424,5478,1000.00,36269.63,37269.63,7041.82,29227.81,0.41,1
54425,5478,1000.00,37269.63,38269.63,0.00,37269.63,0.03,1
54426,5478,1000.00,38269.63,39269.63,13927.92,24341.71,0.21,1
54427,5478,-1000.00,37269.63,38269.63,199.29,0.00,0.03,0
54428,5478,-1000.00,36269.63,37269.63,0.00,38269.63,0.05,0
54429,5478,-1000.00,35269.63,36269.63,8410.43,28859.20,0.38,0
54430,5478,-1000.00,34269.63,35269.63,0.00,36269.63,0.09,0
54431,5478,-1000.00,33269.63,34269.63,0.00,11192.61,0.17,0
54432,5478,-1000.00,32269.63,33269.63,0.00,34269.63,0.09,0
54433,5478,-1000.00,31269.63,32269.63,0.00,33269.63,0.03,0
54434,5478,-1000.00,30269.63,31269.63,8499.24,22729.41,0.36,0
54435,5478,-1000.00,29269.63,30269.63,0.00,16318.09,0.28,0
54436,5478,-1000.00,28269.63,29269.63,11283.65,18985.98,0.30,0
54437,5478,-1000.00,27269.63,28269.63,0.00,29269.63,0.31,0
54438,5478,0.00,27269.63,28269.63,0.00,0.00,0.01,0
54439,5478,-1000.00,26269.63,27269.63,7999.00,20270.63,0.33,0
54440,5478,-1000.00,25269.63,26269.63,0.00,27269.63,0.03,0
54441,5478,-1000.00,24269.63,25269.63,5707.64,20561.99,0.25,0
54442,5478,-1000.00,23269.63,24269.63,11442.53,13827.10,0.07,0
54443,5478,-1000.00,22269.63,23269.63,10355.28,13914.35,0.20,0
54444,5478,-1000.00,21269.63,22269.63,0.00,23269.63,0.15,0
54445,5478,-1000.00,20269.63,21269.63,7604.92,14664.71,0.29,0
54446,5478,-1000.00,19269.63,20269.63,0.00,3639.62,0.17,0
54447,5478,-1000.00,18269.63,19269.63,3857.53,0.00,0.02,0
54448,5479,-1000.00,-1000.00,0.00,64.63,935.37,0.44,0
54449,5480,-1000.00,-1000.00,0.00,393.02,606.98,0.18,0
54450,5481,1000.00,1000.00,2000.00,0.00,490.42,0.24,1
54451,5481,1000.00,2000.00,3000.00,257.55,1742.45,0.37,1
54452,5481,1000.00,3000.00,4000.00,1493.67,1506.33,0.07,1
54453,5481,1000.00,4000.00,5000.00,0.00,4000.00,0.06,1
54454,5481,1000.00,5000.00,6000.00,1721.73,3278.27,0.11,1
54455,5481,1000.00,6000.00,7000.00,0.00,6000.00,0.01,1
54456,5481,1000.00,7000.00,8000.00,2295.47,4704.53,0.18,1
54457,5481,1000.00,8000.00,9000.00,0.00,8000.00,0.04,1
54458,5481,-1000.00,7000.00,8000.00,5018.73,3981.27,0.17,0
54459,5481,1000.00,8000.00,9000.00,0.00,5984.83,0.40,1
54460,5481,1000.00,9000.00,10000.00,981.03,8018.97,0.33,1
54461,5481,1000.00,10000.00,11000.00,3707.91,6292.09,0.02,1
54462,5481,1000.00,11000.00,12000.00,0.00,11000.00,0.37,1
54463,5481,1000.00,12000.00,13000.00,1880.85,10119.15,0.08,1
54464,5481,1000.00,13000.00,14000.00,0.00,7669.57,0.35,1
54465,5481,1000.00,14000.00,15000.00,0.00,8434.85,0.17,1
54466,5481,-1000.00,13000.00,14000.00,8500.22,4438.54,0.14,0
54467,5481,1000.00,14000.00,15000.00,284.66,13715.34,0.44,1
54468,5481,1000.00,15000.00,16000.00,0.00,10384.66,0.39,1
54469,5481,-1000.00,14000.00,15000.00,9471.51,1578.40,0.09,0
54470,5481,1000.00,15000.00,16000.00,0.00,3900.93,0.10,1
54471,5481,1000.00,16000.00,17000.00,4204.29,11795.71,0.35,1
54472,5481,1000.00,17000.00,18000.00,0.00,13197.26,0.39,1
54473,5481,1000.00,18000.00,19000.00,2350.26,15649.74,0.41,1
54474,5481,1000.00,19000.00,20000.00,9242.38,9757.62,0.14,1
54475,5481,1000.00,20000.00,21000.00,0.00,20000.00,0.09,1
54476,5481,1000.00,21000.00,22000.00,0.00,21000.00,0.25,1
54477,5481,1000.00,22000.00,23000.00,8700.97,13299.03,0.18,1
54478,5481,0.00,22000.00,23000.00,0.00,0.00,0.02,0
54479,5481,1000.00,23000.00,24000.00,0.00,23000.00,0.22,1
54480,5481,1000.00,24000.00,25000.00,11237.21,12762.79,0.02,1
54481,5481,1000.00,25000.00,26000.00,2167.62,22832.38,0.43,1
54482,5481,1000.00,26000.00,27000.00,0.00,12346.25,0.16,1
54483,5481,1000.00,27000.00,28000.00,0.00,26901.01,0.09,1
54484,5481,1000.00,28000.00,29000.00,7937.23,20062.77,0.34,1
54485,5481,1000.00,29000.00,30000.00,0.00,29000.00,0.06,1
54486,5481,1000.00,30000.00,31000.00,0.00,9069.34,0.02,1
54487,5481,1000.00,31000.00,32000.00,3163.52,27836.48,0.43,1
54488,5481,1000.00,32000.00,33000.00,0.00,32000.00,0.27,1
54489,5481,1000.00,33000.00,34000.00,0.00,33000.00,0.16,1
54490,5481,1000.00,34000.00,35000.00,0.00,34000.00,0.10,1
54491,5481,1000.00,35000.00,36000.00,0.00,21367.90,0.28,1
54492,5481,1000.00,36000.00,37000.00,8505.78,27494.22,0.13,1
54493,5481,-1000.00,35000.00,36000.00,13275.49,6763.87,0.15,0
54494,5481,0.00,35000.00,36000.00,0.00,0.00,0.01,0
54495,5481,-1000.00,34000.00,35000.00,0.00,22893.98,0.33,0
54496,5481,-1000.00,33000.00,34000.00,6040.36,28959.64,0.28,0
54497,5481,-1000.00,32000.00,33000.00,0.00,34000.00,0.18,0
54498,5481,-1000.00,31000.00,32000.00,0.00,22570.95,0.30,0
54499,5481,0.00,31000.00,32000.00,0.00,0.00,0.01,0
54500,5481,-1000.00,30000.00,31000.00,4647.47,27352.53,0.28,0
54501,5481,-1000.00,29000.00,30000.00,0.00,5460.10,0.09,0
54502,5481,-1000.00,28000.00,29000.00,0.00,30000.00,0.13,0
54503,5481,-1000.00,27000.00,28000.00,0.00,29000.00,0.15,0
54504,5481,-1000.00,26000.00,27000.00,3752.88,24247.12,0.32,0
54505,5481,-1000.00,25000.00,26000.00,13500.00,13500.00,0.06,0
54506,5481,-1000.00,24000.00,25000.00,8005.13,17994.87,0.19,0
54507,5481,-1000.00,23000.00,24000.00,9365.84,15634.16,0.25,0
54508,5481,-1000.00,22000.00,23000.00,6413.68,17586.32,0.37,0
54509,5481,-1000.00,21000.00,22000.00,12963.20,10036.80,0.18,0
54510,5481,-1000.00,20000.00,21000.00,5376.27,10717.23,0.28,0
54511,5481,-1000.00,19000.00,20000.00,3081.23,12176.42,0.34,0
54512,5481,-1000.00,18000.00,19000.00,5842.72,14157.28,0.36,0
54513,5481,-1000.00,17000.00,18000.00,696.84,0.00,0.07,0
54514,5482,-246.64,-246.64,753.36,246.64,0.00,0.10,0
54515,5482,0.00,-246.64,753.36,0.00,0.00,0.20,0
54516,5482,-1000.00,-1246.64,-246.64,46.36,302.35,0.27,0
54517,5483,-1000.00,-1000.00,0.00,336.01,663.99,0.30,0
54518,5484,-1000.00,-1000.00,0.00,0.00,28.76,0.35,0
54519,5485,1000.00,1000.00,2000.00,605.63,394.37,0.06,1
54520,5485,-324.92,675.08,1675.08,0.00,324.92,0.29,0
54521,5485,1000.00,1675.08,2675.08,976.80,0.00,0.18,1
54522,5485,-1000.00,675.08,1675.08,0.00,1395.69,0.12,0
54523,5485,-1000.00,-324.92,675.08,0.00,1237.73,0.32,0
54524,5485,-675.08,-1000.00,0.00,176.60,498.48,0.07,0
54525,5486,-1000.00,-1000.00,0.00,466.43,533.57,0.03,0
54526,5487,-1000.00,-1000.00,0.00,0.00,399.27,0.18,0
54527,5488,-302.19,-302.19,697.81,0.00,302.19,0.06,0
54528,5488,-697.81,-1000.00,0.00,0.00,697.81,0.04,0
54529,5489,-1000.00,-1000.00,0.00,0.00,1000.00,0.09,0
54530,5490,-611.33,-611.33,388.67,0.00,611.33,0.32,0
54531,5490,-20.08,-631.42,368.58,0.00,20.08,0.03,0
54532,5490,-198.01,-829.42,170.58,22.28,175.73,0.30,0
54533,5490,-94.15,-923.57,76.43,0.00,94.15,0.03,0
54534,5490,-76.43,-1000.00,0.00,0.00,76.43,0.22,0
54535,5491,-1000.00,-1000.00,0.00,0.00,888.97,0.16,0
54536,5492,-1000.00,-1000.00,0.00,0.00,1000.00,0.15,0
54537,5493,-1000.00,-1000.00,0.00,90.76,909.24,0.26,0
54538,5494,1000.00,1000.00,2000.00,218.87,617.55,0.34,1
54539,5494,1000.00,2000.00,3000.00,0.00,1753.32,0.37,1
54540,5494,1000.00,3000.00,4000.00,0.00,1903.02,0.14,1
54541,5494,1000.00,4000.00,5000.00,922.01,3077.99,0.39,1
54542,5494,1000.00,5000.00,6000.00,0.00,1487.41,0.22,1
54543,5494,1000.00,6000.00,7000.00,0.00,3533.73,0.33,1
54544,5494,1000.00,7000.00,8000.00,725.73,1244.96,0.17,1
54545,5494,1000.00,8000.00,9000.00,1362.06,6637.94,0.18,1
54546,5494,1000.00,9000.00,10000.00,3985.15,5014.85,0.16,1
54547,5494,1000.00,10000.00,11000.00,0.00,10000.00,0.08,1
54548,5494,1000.00,11000.00,12000.00,0.00,1058.31,0.07,1
54549,5494,-1000.00,10000.00,11000.00,4495.35,0.00,0.01,0
54550,5494,1000.00,11000.00,12000.00,0.00,905.43,0.08,1
54551,5494,1000.00,12000.00,13000.00,127.66,11872.34,0.06,1
54552,5494,1000.00,13000.00,14000.00,410.47,12589.53,0.26,1
54553,5494,1000.00,14000.00,15000.00,1293.92,10637.54,0.40,1
54554,5494,1000.00,15000.00,16000.00,0.00,15000.00,0.25,1
54555,5494,1000.00,16000.00,17000.00,0.00,11001.31,0.06,1
54556,5494,1000.00,17000.00,18000.00,0.00,13997.58,0.42,1
54557,5494,1000.00,18000.00,19000.00,8900.13,9099.87,0.17,1
54558,5494,1000.00,19000.00,20000.00,8829.35,10170.65,0.02,1
54559,5494,1000.00,20000.00,21000.00,0.00,20000.00,0.33,1
54560,5494,1000.00,21000.00,22000.00,6425.85,14574.15,0.06,1
54561,5494,-1000.00,20000.00,21000.00,13142.61,8857.39,0.10,0
54562,5494,-1000.00,19000.00,20000.00,11028.38,9971.62,0.12,0
54563,5494,1000.00,20000.00,21000.00,0.00,20000.00,0.42,1
54564,5494,-1000.00,19000.00,20000.00,15935.88,5064.12,0.08,0
54565,5494,1000.00,20000.00,21000.00,0.00,15908.90,0.33,1
54566,5494,1000.00,21000.00,22000.00,3890.29,8753.18,0.26,1
54567,5494,1000.00,22000.00,23000.00,0.00,11114.29,0.31,1
54568,5494,1000.00,23000.00,24000.00,0.00,23000.00,0.04,1
54569,5494,1000.00,24000.00,25000.00,0.00,24000.00,0.11,1
54570,5494,1000.00,25000.00,26000.00,0.00,17315.90,0.08,1
54571,5494,1000.00,26000.00,27000.00,0.00,22272.94,0.43,1
54572,5494,1000.00,27000.00,28000.00,0.00,27000.00,0.22,1
54573,5494,1000.00,28000.00,29000.00,6835.55,21164.45,0.12,1
54574,5494,1000.00,29000.00,30000.00,0.00,29000.00,0.29,1
54575,5494,1000.00,30000.00,31000.00,0.00,30000.00,0.31,1
54576,5494,1000.00,31000.00,32000.00,0.00,31000.00,0.01,1
54577,5494,1000.00,32000.00,33000.00,9950.87,22049.13,0.29,1
54578,5494,1000.00,33000.00,34000.00,4014.94,28985.06,0.43,1
54579,5494,1000.00,34000.00,35000.00,17000.00,17000.00,0.07,1
54580,5494,-1000.00,33000.00,34000.00,11727.49,287.67,0.10,0
54581,5495,-1000.00,-1000.00,0.00,0.00,161.83,0.38,0
54582,5496,1000.00,1000.00,2000.00,395.59,604.41,0.27,1
54583,5496,1000.00,2000.00,3000.00,342.37,1657.63,0.31,1
54584,5496,1000.00,3000.00,4000.00,1500.00,1500.00,0.01,1
54585,5496,1000.00,4000.00,5000.00,1453.62,2159.19,0.27,1
54586,5496,1000.00,5000.00,6000.00,575.03,3376.52,0.37,1
54587,5496,1000.00,6000.00,7000.00,527.46,5472.54,0.26,1
54588,5496,1000.00,7000.00,8000.00,0.00,4657.39,0.21,1
54589,5496,1000.00,8000.00,9000.00,4000.00,4000.00,0.05,1
54590,5496,1000.00,9000.00,10000.00,3261.98,5738.02,0.25,1
54591,5496,1000.00,10000.00,11000.00,0.00,4917.59,0.06,1
54592,5496,1000.00,11000.00,12000.00,0.00,11000.00,0.32,1
54593,5496,1000.00,12000.00,13000.00,3732.27,8267.73,0.31,1
54594,5496,1000.00,13000.00,14000.00,5172.25,7827.75,0.09,1
54595,5496,1000.00,14000.00,15000.00,0.00,14000.00,0.18,1
54596,5496,1000.00,15000.00,16000.00,5803.53,9196.47,0.08,1
54597,5496,-1000.00,14000.00,15000.00,8135.81,7864.19,0.20,0
54598,5496,1000.00,15000.00,16000.00,503.35,13243.45,0.43,1
54599,5496,-1000.00,14000.00,15000.00,10021.85,5978.15,0.06,0
54600,5496,1000.00,15000.00,16000.00,4793.85,10206.15,0.28,1
54601,5496,-1000.00,14000.00,15000.00,9030.53,5136.70,0.15,0
54602,5496,-1000.00,13000.00,14000.00,9663.58,151.34,0.06,0
54603,5496,1000.00,14000.00,15000.00,0.00,4130.84,0.20,1
54604,5496,1000.00,15000.00,16000.00,7500.00,7500.00,0.05,1
54605,5496,-1000.00,14000.00,15000.00,4029.05,3469.04,0.17,0
54606,5496,1000.00,15000.00,16000.00,0.00,15000.00,0.37,1
54607,5496,1000.00,16000.00,17000.00,3232.82,12767.18,0.30,1
54608,5496,1000.00,17000.00,18000.00,0.00,14299.57,0.20,1
54609,5496,1000.00,18000.00,19000.00,0.00,6274.70,0.16,1
54610,5496,1000.00,19000.00,20000.00,0.00,19000.00,0.44,1
54611,5496,1000.00,20000.00,21000.00,0.00,20000.00,0.18,1
54612,5496,1000.00,21000.00,22000.00,0.00,21000.00,0.30,1
54613,5496,1000.00,22000.00,23000.00,9737.93,12262.07,0.25,1
54614,5496,1000.00,23000.00,24000.00,0.00,23000.00,0.28,1
54615,5496,1000.00,24000.00,25000.00,0.00,24000.00,0.05,1
54616,5496,1000.00,25000.00,26000.00,0.00,13703.45,0.10,1
54617,5496,1000.00,26000.00,27000.00,0.00,26000.00,0.32,1
54618,5496,1000.00,27000.00,28000.00,0.00,25528.38,0.37,1
54619,5496,1000.00,28000.00,29000.00,3324.25,7785.86,0.21,1
54620,5496,1000.00,29000.00,30000.00,12562.25,16437.75,0.23,1
54621,5496,1000.00,30000.00,31000.00,0.00,30000.00,0.15,1
54622,5496,1000.00,31000.00,32000.00,0.00,31000.00,0.16,1
54623,5497,-1000.00,-1000.00,0.00,0.00,1000.00,0.28,0
54624,5498,-606.00,-606.00,394.00,262.58,343.41,0.22,0
54625,5498,-394.00,-1000.00,0.00,172.57,221.43,0.26,0
54626,5499,-789.49,-789.49,210.51,0.00,789.49,0.42,0
54627,5499,-96.72,-886.21,113.79,0.00,96.72,0.07,0
54628,5499,-70.05,-956.26,43.74,0.00,70.05,0.29,0
54629,5499,-43.74,-1000.00,0.00,0.00,43.74,0.00,0
54630,5500,-1000.00,-1000.00,0.00,378.42,621.58,0.24,0
54631,5501,-1000.00,-1000.00,0.00,0.00,1000.00,0.26,0
54632,5502,1000.00,1000.00,2000.00,0.00,652.85,0.35,1
54633,5502,1000.00,2000.00,3000.00,0.00,1710.46,0.43,1
54634,5502,1000.00,3000.00,4000.00,0.00,3000.00,0.41,1
54635,5502,1000.00,4000.00,5000.00,91.74,3908.26,0.44,1
54636,5502,1000.00,5000.00,6000.00,824.67,3078.51,0.35,1
54637,5502,1000.00,6000.00,7000.00,896.44,5103.56,0.37,1
54638,5502,1000.00,7000.00,8000.00,0.00,7000.00,0.20,1
54639,5502,1000.00,8000.00,9000.00,1435.09,6564.91,0.41,1
54640,5502,1000.00,9000.00,10000.00,4431.82,4568.18,0.12,1
54641,5502,1000.00,10000.00,11000.00,0.00,7276.10,0.40,1
54642,5502,1000.00,11000.00,12000.00,360.14,10639.86,0.33,1
54643,5502,1000.00,12000.00,13000.00,2602.53,9397.47,0.20,1
54644,5502,0.00,12000.00,13000.00,0.00,0.00,0.06,0
54645,5502,1000.00,13000.00,14000.00,0.00,1973.44,0.14,1
54646,5502,1000.00,14000.00,15000.00,0.00,14000.00,0.04,1
54647,5502,1000.00,15000.00,16000.00,0.00,12143.09,0.16,1
54648,5502,1000.00,16000.00,17000.00,0.00,11657.15,0.38,1
54649,5502,1000.00,17000.00,18000.00,0.00,13377.07,0.00,1
54650,5502,1000.00,18000.00,19000.00,0.00,18000.00,0.07,1
54651,5502,1000.00,19000.00,20000.00,3261.50,15738.50,0.17,1
54652,5502,1000.00,20000.00,21000.00,0.00,8866.78,0.19,1
54653,5502,1000.00,21000.00,22000.00,0.00,19709.33,0.42,1
54654,5502,-1000.00,20000.00,21000.00,5245.23,16754.77,0.39,0
54655,5502,-1000.00,19000.00,20000.00,0.00,21000.00,0.01,0
54656,5502,-1000.00,18000.00,19000.00,0.00,15806.01,0.18,0
54657,5502,-1000.00,17000.00,18000.00,0.00,18155.47,0.44,0
54658,5502,-1000.00,16000.00,17000.00,0.00,16993.47,0.18,0
54659,5502,-1000.00,15000.00,16000.00,0.00,17000.00,0.15,0
54660,5502,-1000.00,14000.00,15000.00,0.00,8117.63,0.30,0
54661,5502,0.00,14000.00,15000.00,0.00,0.00,0.07,0
54662,5502,0.00,14000.00,15000.00,0.00,0.00,0.03,0
54663,5502,-1000.00,13000.00,14000.00,11031.57,26.77,0.05,0
54664,5502,-1000.00,12000.00,13000.00,5813.88,8186.12,0.28,0
54665,5502,-1000.00,11000.00,12000.00,4024.43,8975.57,0.33,0
54666,5502,-99.68,10900.32,11900.32,0.00,99.68,0.04,0
54667,5502,-1000.00,9900.32,10900.32,0.00,11900.32,0.40,0
54668,5502,-1000.00,8900.32,9900.32,0.00,10900.32,0.03,0
54669,5502,-1000.00,7900.32,8900.32,2168.97,7265.84,0.37,0
54670,5502,-1000.00,6900.32,7900.32,0.00,8900.32,0.01,0
54671,5502,-1000.00,5900.32,6900.32,0.00,7900.32,0.19,0
54672,5502,-1000.00,4900.32,5900.32,0.00,6900.32,0.14,0
54673,5502,-1000.00,3900.32,4900.32,2485.54,3414.77,0.26,0
54674,5502,1000.00,4900.32,5900.32,2450.16,2450.16,0.07,1
54675,5502,1000.00,5900.32,6900.32,1298.97,4502.54,0.38,1
54676,5502,1000.00,6900.32,7900.32,507.45,6392.86,0.29,1
54677,5502,-1000.00,5900.32,6900.32,3950.16,3950.16,0.10,0
54678,5502,-1000.00,4900.32,5900.32,3148.82,3751.50,0.16,0
54679,5502,-1000.00,3900.32,4900.32,5782.98,0.00,0.07,0
54680,5502,-1000.00,2900.32,3900.32,1873.66,1056.54,0.34,0
54681,5502,-341.01,2559.31,3559.31,238.71,102.30,0.44,0
54682,5502,-1000.00,1559.31,2559.31,2991.28,0.00,0.03,0
54683,5502,1000.00,2559.31,3559.31,0.00,2559.31,0.41,1
54684,5502,1000.00,3559.31,4559.31,0.00,2768.31,0.41,1
54685,5502,1000.00,4559.31,5559.31,2279.65,2279.65,0.04,1
54686,5502,1000.00,5559.31,6559.31,2682.82,2876.48,0.18,1
54687,5502,1000.00,6559.31,7559.31,729.47,5829.84,0.31,1
54688,5502,1000.00,7559.31,8559.31,3093.81,4465.50,0.24,1
54689,5502,-1000.00,6559.31,7559.31,3013.02,2500.89,0.19,0
54690,5502,1000.00,7559.31,8559.31,1818.40,5740.90,0.12,1
54691,5502,1000.00,8559.31,9559.31,1699.85,5550.78,0.35,1
54692,5502,1000.00,9559.31,10559.31,3116.71,6442.60,0.08,1
54693,5502,1000.00,10559.31,11559.31,4972.59,5586.72,0.15,1
54694,5502,1000.00,11559.31,12559.31,2138.21,9421.10,0.41,1
54695,5502,1000.00,12559.31,13559.31,0.00,12559.31,0.12,1
54696,5503,-1000.00,-1000.00,0.00,446.06,13.26,0.09,0
54697,5504,1000.00,1000.00,2000.00,352.74,647.26,0.27,1
54698,5504,1000.00,2000.00,3000.00,0.00,1269.05,0.38,1
54699,5504,1000.00,3000.00,4000.00,448.52,2551.48,0.21,1
54700,5504,1000.00,4000.00,5000.00,0.00,1490.91,0.25,1
54701,5504,1000.00,5000.00,6000.00,304.54,2413.31,0.30,1
54702,5504,1000.00,6000.00,7000.00,0.00,2912.07,0.30,1
54703,5504,1000.00,7000.00,8000.00,1109.90,5890.10,0.27,1
54704,5504,1000.00,8000.00,9000.00,0.00,8000.00,0.06,1
54705,5504,1000.00,9000.00,10000.00,705.04,8294.96,0.33,1
54706,5504,1000.00,10000.00,11000.00,0.00,10000.00,0.14,1
54707,5504,1000.00,11000.00,12000.00,4987.62,6012.38,0.15,1
54708,5504,1000.00,12000.00,13000.00,3307.46,7895.13,0.34,1
54709,5504,1000.00,13000.00,14000.00,920.19,12079.81,0.42,1
54710,5504,1000.00,14000.00,15000.00,0.00,14000.00,0.07,1
54711,5504,1000.00,15000.00,16000.00,998.13,4333.30,0.22,1
54712,5504,1000.00,16000.00,17000.00,0.00,16000.00,0.26,1
54713,5504,1000.00,17000.00,18000.00,8500.00,8500.00,0.03,1
54714,5504,1000.00,18000.00,19000.00,0.00,9946.29,0.16,1
54715,5504,1000.00,19000.00,20000.00,2154.06,16845.94,0.20,1
54716,5504,1000.00,20000.00,21000.00,0.00,5663.87,0.01,1
54717,5504,-1000.00,19000.00,20000.00,8021.70,7969.31,0.21,0
54718,5504,1000.00,20000.00,21000.00,0.00,12346.02,0.33,1
54719,5504,1000.00,21000.00,22000.00,0.00,21000.00,0.26,1
54720,5504,1000.00,22000.00,23000.00,3662.70,18337.30,0.42,1
54721,5504,1000.00,23000.00,24000.00,0.00,23000.00,0.31,1
54722,5504,-1000.00,22000.00,23000.00,15962.28,8037.72,0.10,0
54723,5504,1000.00,23000.00,24000.00,0.00,23000.00,0.04,1
54724,5504,0.00,23000.00,24000.00,0.00,0.00,0.04,0
54725,5504,1000.00,24000.00,25000.00,0.00,12564.13,0.29,1
54726,5504,1000.00,25000.00,26000.00,8624.75,16375.25,0.27,1
54727,5504,1000.00,26000.00,27000.00,0.00,26000.00,0.41,1
54728,5504,1000.00,27000.00,28000.00,0.00,7534.62,0.14,1
54729,5504,1000.00,28000.00,29000.00,7009.43,20990.57,0.37,1
54730,5504,1000.00,29000.00,30000.00,0.00,29000.00,0.43,1
54731,5504,1000.00,30000.00,31000.00,0.00,30000.00,0.07,1
54732,5504,1000.00,31000.00,32000.00,1602.03,29397.97,0.35,1
54733,5504,1000.00,32000.00,33000.00,0.00,32000.00,0.22,1
54734,5504,1000.00,33000.00,34000.00,0.00,33000.00,0.39,1
54735,5504,1000.00,34000.00,35000.00,14600.19,16506.02,0.24,1
54736,5504,-1000.00,33000.00,34000.00,18662.66,16337.34,0.18,0
54737,5504,1000.00,34000.00,35000.00,0.00,19699.70,0.33,1
54738,5504,1000.00,35000.00,36000.00,0.00,17820.61,0.17,1
54739,5504,-1000.00,34000.00,35000.00,19666.53,16333.47,0.14,0
54740,5504,1000.00,35000.00,36000.00,10233.71,24766.29,0.34,1
54741,5504,1000.00,36000.00,37000.00,0.00,32016.54,0.15,1
54742,5504,1000.00,37000.00,38000.00,0.00,37000.00,0.41,1
54743,5504,1000.00,38000.00,39000.00,1639.97,36360.03,0.23,1
54744,5504,-1000.00,37000.00,38000.00,17235.11,21764.89,0.04,0
54745,5504,-1000.00,36000.00,37000.00,0.00,35277.98,0.32,0
54746,5504,-1000.00,35000.00,36000.00,0.00,37000.00,0.15,0
54747,5504,-1000.00,34000.00,35000.00,12198.71,23801.29,0.07,0
54748,5504,-1000.00,33000.00,34000.00,0.00,35000.00,0.26,0
54749,5504,-1000.00,32000.00,33000.00,2135.56,31864.44,0.42,0
54750,5504,0.00,32000.00,33000.00,0.00,0.00,0.09,0
54751,5504,-1000.00,31000.00,32000.00,0.00,33000.00,0.18,0
54752,5504,-1000.00,30000.00,31000.00,8166.02,23833.98,0.37,0
54753,5504,-1000.00,29000.00,30000.00,0.00,25761.14,0.14,0
54754,5504,-1000.00,28000.00,29000.00,5350.08,24649.92,0.13,0
54755,5504,-1000.00,27000.00,28000.00,0.00,29000.00,0.04,0
54756,5504,-1000.00,26000.00,27000.00,0.00,28000.00,0.02,0
54757,5504,-1000.00,25000.00,26000.00,0.00,16325.79,0.35,0
54758,5504,-1000.00,24000.00,25000.00,9058.13,16941.87,0.21,0
54759,5504,-1000.00,23000.00,24000.00,12750.16,12249.84,0.03,0
54760,5504,-1000.00,22000.00,23000.00,0.00,10989.34,0.09,0
54761,5504,-1000.00,21000.00,22000.00,0.00,23000.00,0.04,0
54762,5504,-1000.00,20000.00,21000.00,0.00,22000.00,0.30,0
54763,5504,-1000.00,19000.00,20000.00,0.00,21000.00,0.10,0
54764,5504,-1000.00,18000.00,19000.00,2785.12,17214.88,0.43,0
54765,5504,-1000.00,17000.00,18000.00,0.00,19000.00,0.38,0
54766,5504,-1000.00,16000.00,17000.00,11946.25,6053.75,0.05,0
54767,5504,-1000.00,15000.00,16000.00,0.00,15974.01,0.27,0
54768,5504,-1000.00,14000.00,15000.00,8000.00,8000.00,0.09,0
54769,5504,-1000.00,13000.00,14000.00,0.00,9966.93,0.37,0
54770,5504,-1000.00,12000.00,13000.00,7000.00,7000.00,0.07,0
54771,5504,-1000.00,11000.00,12000.00,0.00,13000.00,0.04,0
54772,5504,-1000.00,10000.00,11000.00,0.00,12000.00,0.40,0
54773,5504,-1000.00,9000.00,10000.00,3810.19,7189.81,0.17,0
54774,5504,-1000.00,8000.00,9000.00,0.00,10000.00,0.32,0
54775,5504,-1000.00,7000.00,8000.00,0.00,5571.42,0.31,0
54776,5504,-1000.00,6000.00,7000.00,0.00,8000.00,0.40,0
54777,5504,-1000.00,5000.00,6000.00,676.47,4640.92,0.37,0
54778,5504,-1000.00,4000.00,5000.00,1801.71,4198.29,0.28,0
54779,5504,-1000.00,3000.00,4000.00,0.00,5000.00,0.01,0
54780,5504,-1000.00,2000.00,3000.00,0.00,4000.00,0.32,0
54781,5504,-1000.00,1000.00,2000.00,0.00,3000.00,0.09,0
54782,5504,-1000.00,0.00,1000.00,565.47,1434.53,0.17,0
54783,5504,-1000.00,-1000.00,0.00,0.00,1000.00,0.12,0
54784,5505,-1000.00,-1000.00,0.00,364.63,635.37,0.12,0
54785,5506,-1000.00,-1000.00,0.00,108.88,891.12,0.39,0
54786,5507,1000.00,1000.00,2000.00,0.00,347.14,0.23,1
54787,5507,0.00,1000.00,2000.00,0.00,0.00,0.10,0
54788,5507,1000.00,2000.00,3000.00,606.03,629.69,0.20,1
54789,5507,1000.00,3000.00,4000.00,0.00,3000.00,0.00,1
54790,5507,1000.00,4000.00,5000.00,0.00,4000.00,0.22,1
54791,5507,1000.00,5000.00,6000.00,1384.70,3615.30,0.36,1
54792,5507,1000.00,6000.00,7000.00,1156.42,3738.86,0.34,1
54793,5507,1000.00,7000.00,8000.00,0.00,4473.39,0.27,1
54794,5507,1000.00,8000.00,9000.00,0.00,381.29,0.12,1
54795,5507,1000.00,9000.00,10000.00,0.00,9000.00,0.38,1
54796,5507,1000.00,10000.00,11000.00,0.00,10000.00,0.37,1
54797,5507,1000.00,11000.00,12000.00,2379.19,8620.81,0.40,1
54798,5507,1000.00,12000.00,13000.00,0.00,10054.70,0.40,1
54799,5507,1000.00,13000.00,14000.00,4004.54,8995.46,0.05,1
54800,5507,1000.00,14000.00,15000.00,0.00,10724.87,0.18,1
54801,5507,1000.00,15000.00,16000.00,0.00,4644.20,0.17,1
54802,5507,1000.00,16000.00,17000.00,6922.33,9077.67,0.18,1
54803,5507,1000.00,17000.00,18000.00,0.00,17000.00,0.03,1
54804,5507,1000.00,18000.00,19000.00,0.00,18000.00,0.28,1
54805,5507,1000.00,19000.00,20000.00,3622.27,15377.73,0.42,1
54806,5507,1000.00,20000.00,21000.00,0.00,4025.17,0.06,1
54807,5507,-1000.00,19000.00,20000.00,5955.52,3839.10,0.16,0
54808,5507,1000.00,20000.00,21000.00,0.00,20000.00,0.41,1
54809,5507,1000.00,21000.00,22000.00,10203.64,10796.36,0.12,1
54810,5507,1000.00,22000.00,23000.00,2172.89,19827.11,0.30,1
54811,5507,1000.00,23000.00,24000.00,0.00,5496.94,0.08,1
54812,5507,1000.00,24000.00,25000.00,0.00,23812.39,0.18,1
54813,5507,1000.00,25000.00,26000.00,0.00,14359.54,0.30,1
54814,5507,0.00,25000.00,26000.00,0.00,0.00,0.03,0
54815,5507,1000.00,26000.00,27000.00,0.00,11854.11,0.18,1
54816,5507,1000.00,27000.00,28000.00,9784.89,17215.11,0.27,1
54817,5507,1000.00,28000.00,29000.00,701.63,12940.70,0.30,1
54818,5507,1000.00,29000.00,30000.00,0.00,19448.44,0.08,1
54819,5507,1000.00,30000.00,31000.00,13431.35,16568.65,0.26,1
54820,5507,0.00,30000.00,31000.00,0.00,0.00,0.01,0
54821,5507,1000.00,31000.00,32000.00,0.00,31000.00,0.32,1
54822,5507,-1000.00,30000.00,31000.00,22565.21,0.00,0.05,0
54823,5507,1000.00,31000.00,32000.00,0.00,31000.00,0.01,1
54824,5507,1000.00,32000.00,33000.00,0.00,8298.16,0.21,1
54825,5508,1000.00,1000.00,2000.00,11.94,793.29,0.42,1
54826,5508,-1000.00,0.00,1000.00,1394.17,90.68,0.06,0
54827,5508,-646.45,-646.45,353.55,646.45,0.00,0.05,0
54828,5508,1000.00,353.55,1353.55,147.97,205.58,0.23,1
54829,5508,1000.00,1353.55,2353.55,676.01,677.54,0.11,1
54830,5508,1000.00,2353.55,3353.55,0.00,2353.55,0.26,1
54831,5508,1000.00,3353.55,4353.55,529.49,2824.06,0.42,1
54832,5508,1000.00,4353.55,5353.55,0.00,4353.55,0.18,1
54833,5508,1000.00,5353.55,6353.55,0.00,5353.55,0.36,1
54834,5508,1000.00,6353.55,7353.55,666.65,5686.90,0.37,1
54835,5508,1000.00,7353.55,8353.55,0.00,5227.23,0.34,1
54836,5508,1000.00,8353.55,9353.55,0.00,3501.16,0.28,1
54837,5508,-1000.00,7353.55,8353.55,0.00,9353.55,0.19,0
54838,5508,-1000.00,6353.55,7353.55,2732.57,5620.99,0.33,0
54839,5508,-1000.00,5353.55,6353.55,2114.07,0.00,0.09,0
54840,5508,-1000.00,4353.55,5353.55,1107.88,4305.71,0.37,0
54841,5508,-1000.00,3353.55,4353.55,1735.01,3618.55,0.16,0
54842,5508,-1000.00,2353.55,3353.55,0.00,4353.55,0.44,0
54843,5508,-1000.00,1353.55,2353.55,0.00,3353.55,0.10,0
54844,5508,-1000.00,353.55,1353.55,0.00,2353.55,0.14,0
54845,5508,-1000.00,-646.45,353.55,0.00,1353.55,0.01,0
54846,5508,-1000.00,-1646.45,-646.45,3.10,323.71,0.44,0
54847,5509,1000.00,1000.00,2000.00,346.32,0.00,0.26,1
54848,5509,1000.00,2000.00,3000.00,258.93,0.00,0.34,1
54849,5509,-1000.00,1000.00,2000.00,0.00,3000.00,0.25,0
54850,5509,-1000.00,0.00,1000.00,0.00,2000.00,0.07,0
54851,5509,-771.08,-771.08,228.92,366.82,404.27,0.23,0
54852,5509,-228.92,-1000.00,0.00,110.24,118.68,0.06,0
54853,5510,1000.00,1000.00,2000.00,274.44,725.56,0.27,1
54854,5510,-426.38,573.62,1573.62,300.31,126.07,0.13,0
54855,5510,1000.00,1573.62,2573.62,0.00,1573.62,0.04,1
54856,5510,-1000.00,573.62,1573.62,1577.12,104.63,0.07,0
54857,5510,-583.71,-10.09,989.91,294.53,289.18,0.17,0
54858,5510,1000.00,989.91,1989.91,0.00,989.91,0.29,1
54859,5510,1000.00,1989.91,2989.91,116.28,1873.64,0.36,1
54860,5510,1000.00,2989.91,3989.91,0.00,1937.95,0.26,1
54861,5510,-1000.00,1989.91,2989.91,2087.45,1902.46,0.03,0
54862,5510,1000.00,2989.91,3989.91,120.02,2869.89,0.34,1
54863,5510,1000.00,3989.91,4989.91,274.65,3715.27,0.44,1
54864,5510,1000.00,4989.91,5989.91,0.00,4296.17,0.42,1
54865,5510,1000.00,5989.91,6989.91,0.00,5989.91,0.25,1
54866,5510,1000.00,6989.91,7989.91,0.00,6976.36,0.39,1
54867,5510,-1000.00,5989.91,6989.91,2419.86,0.00,0.05,0
54868,5510,0.00,5989.91,6989.91,0.00,0.00,0.07,0
54869,5510,1000.00,6989.91,7989.91,1378.96,5610.95,0.17,1
54870,5510,1000.00,7989.91,8989.91,0.00,1613.94,0.13,1
54871,5510,-1000.00,6989.91,7989.91,5669.71,0.00,0.06,0
54872,5510,1000.00,7989.91,8989.91,0.00,7989.91,0.34,1
54873,5510,1000.00,8989.91,9989.91,0.00,8989.91,0.37,1
54874,5510,1000.00,9989.91,10989.91,0.00,9989.91,0.02,1
54875,5510,-1000.00,8989.91,9989.91,1120.11,9869.80,0.43,0
54876,5510,-1000.00,7989.91,8989.91,1040.60,8949.31,0.43,0
54877,5510,-1000.00,6989.91,7989.91,2443.46,1560.27,0.15,0
54878,5510,-1000.00,5989.91,6989.91,1496.12,6493.79,0.40,0
54879,5510,-1000.00,4989.91,5989.91,0.00,6989.91,0.24,0
54880,5510,-1000.00,3989.91,4989.91,0.00,2984.91,0.31,0
54881,5510,-1000.00,2989.91,3989.91,886.93,4102.98,0.06,0
54882,5510,-1000.00,1989.91,2989.91,0.00,2786.06,0.32,0
54883,5510,-974.60,1015.32,2015.32,0.00,974.60,0.10,0
54884,5510,0.00,1015.32,2015.32,0.00,0.00,0.03,0
54885,5510,-1000.00,15.32,1015.32,179.90,147.04,0.13,0
54886,5510,-365.15,-349.83,650.17,0.00,365.15,0.25,0
54887,5510,-623.95,-973.78,26.22,0.00,623.95,0.03,0
54888,5510,-23.72,-997.50,2.50,5.27,18.45,0.37,0
54889,5510,-2.50,-1000.00,0.00,1.11,1.39,0.18,0
54890,5511,-417.83,-417.83,582.17,227.17,190.66,0.39,0
54891,5511,-207.49,-625.32,374.68,207.49,0.00,0.37,0
54892,5511,-290.39,-915.71,84.29,216.25,74.14,0.26,0
54893,5511,-1000.00,-1915.71,-915.71,0.00,33.46,0.14,0
54894,5512,-56.95,-56.95,943.05,56.95,0.00,0.27,0
54895,5512,-308.16,-365.11,634.89,167.90,140.26,0.42,0
54896,5512,1000.00,634.89,1634.89,186.54,448.34,0.21,1
54897,5512,1000.00,1634.89,2634.89,0.00,1634.89,0.32,1
54898,5512,1000.00,2634.89,3634.89,0.00,362.13,0.15,1
54899,5512,1000.00,3634.89,4634.89,0.00,3634.89,0.17,1
54900,5512,1000.00,4634.89,5634.89,2317.44,2317.44,0.08,1
54901,5512,1000.00,5634.89,6634.89,0.00,5634.89,0.37,1
54902,5512,1000.00,6634.89,7634.89,593.68,2962.36,0.29,1
54903,5512,1000.00,7634.89,8634.89,0.00,3735.25,0.28,1
54904,5512,1000.00,8634.89,9634.89,0.00,7407.76,0.40,1
54905,5512,-1000.00,7634.89,8634.89,8636.84,998.04,0.05,0
54906,5512,1000.00,8634.89,9634.89,0.00,8634.89,0.10,1
54907,5512,1000.00,9634.89,10634.89,2696.95,6937.94,0.21,1
54908,5512,1000.00,10634.89,11634.89,0.00,1073.89,0.40,1
54909,5512,-1000.00,9634.89,10634.89,6287.85,5347.04,0.04,0
54910,5512,-1000.00,8634.89,9634.89,5213.34,4981.70,0.21,0
54911,5512,1000.00,9634.89,10634.89,849.32,7318.27,0.39,1
54912,5512,0.00,9634.89,10634.89,0.00,0.00,0.04,0
54913,5512,1000.00,10634.89,11634.89,0.00,10634.89,0.10,1
54914,5512,1000.00,11634.89,12634.89,0.00,4953.87,0.24,1
54915,5512,1000.00,12634.89,13634.89,1047.25,6156.56,0.30,1
54916,5512,1000.00,13634.89,14634.89,6181.15,7453.74,0.11,1
54917,5512,1000.00,14634.89,15634.89,1085.18,13266.27,0.43,1
54918,5512,1000.00,15634.89,16634.89,7022.07,8612.81,0.29,1
54919,5512,1000.00,16634.89,17634.89,4788.53,11846.36,0.36,1
54920,5512,1000.00,17634.89,18634.89,8817.44,8817.44,0.06,1
54921,5512,1000.00,18634.89,19634.89,4753.76,13881.13,0.37,1
54922,5512,1000.00,19634.89,20634.89,0.00,6888.79,0.21,1
54923,5512,1000.00,20634.89,21634.89,0.00,20634.89,0.30,1
54924,5512,0.00,20634.89,21634.89,0.00,0.00,0.11,0
54925,5512,1000.00,21634.89,22634.89,0.00,10356.56,0.27,1
54926,5512,1000.00,22634.89,23634.89,3814.45,4797.83,0.18,1
54927,5512,1000.00,23634.89,24634.89,0.00,23634.89,0.04,1
54928,5512,1000.00,24634.89,25634.89,0.00,24634.89,0.09,1
54929,5512,1000.00,25634.89,26634.89,0.00,25634.89,0.12,1
54930,5512,1000.00,26634.89,27634.89,0.00,15798.54,0.33,1
54931,5512,1000.00,27634.89,28634.89,6939.56,20695.33,0.38,1
54932,5512,-1000.00,26634.89,27634.89,22172.11,6462.78,0.06,0
54933,5512,1000.00,27634.89,28634.89,0.00,18760.54,0.04,1
54934,5512,1000.00,28634.89,29634.89,4922.47,23712.41,0.34,1
54935,5512,1000.00,29634.89,30634.89,8630.72,21004.17,0.34,1
54936,5512,1000.00,30634.89,31634.89,8509.00,18491.99,0.32,1
54937,5513,-1000.00,-1000.00,0.00,594.65,405.35,0.17,0
54938,5514,1000.00,1000.00,2000.00,327.34,672.66,0.31,1
54939,5514,0.00,1000.00,2000.00,0.00,0.00,0.28,0
54940,5514,1000.00,2000.00,3000.00,0.00,1287.94,0.20,1
54941,5514,1000.00,3000.00,4000.00,0.00,521.67,0.14,1
54942,5514,1000.00,4000.00,5000.00,1162.35,2837.65,0.35,1
54943,5514,1000.00,5000.00,6000.00,0.00,5000.00,0.26,1
54944,5514,1000.00,6000.00,7000.00,2392.91,3607.09,0.19,1
54945,5514,1000.00,7000.00,8000.00,0.00,1847.26,0.21,1
54946,5514,1000.00,8000.00,9000.00,0.00,7895.19,0.38,1
54947,5514,1000.00,9000.00,10000.00,734.50,7331.76,0.42,1
54948,5514,-1000.00,8000.00,9000.00,3166.06,2615.81,0.18,0
54949,5514,1000.00,9000.00,10000.00,0.00,198.76,0.02,1
54950,5514,1000.00,10000.00,11000.00,0.00,2481.16,0.20,1
54951,5514,1000.00,11000.00,12000.00,0.00,11000.00,0.20,1
54952,5514,1000.00,12000.00,13000.00,0.00,11927.75,0.38,1
54953,5514,1000.00,13000.00,14000.00,0.00,13000.00,0.41,1
54954,5514,1000.00,14000.00,15000.00,3701.63,10298.37,0.31,1
54955,5514,-1000.00,13000.00,14000.00,12386.43,0.00,0.02,0
54956,5514,1000.00,14000.00,15000.00,5064.54,8935.46,0.31,1
54957,5514,1000.00,15000.00,16000.00,0.00,15000.00,0.03,1
54958,5514,1000.00,16000.00,17000.00,0.00,16000.00,0.15,1
54959,5514,1000.00,17000.00,18000.00,0.00,12667.53,0.29,1
54960,5514,1000.00,18000.00,19000.00,0.00,16635.16,0.25,1
54961,5514,-1000.00,17000.00,18000.00,11830.74,7169.26,0.13,0
54962,5514,1000.00,18000.00,19000.00,0.00,10668.26,0.31,1
54963,5514,1000.00,19000.00,20000.00,385.71,18614.29,0.27,1
54964,5514,1000.00,20000.00,21000.00,2271.70,17728.30,0.36,1
54965,5514,1000.00,21000.00,22000.00,0.00,13017.90,0.36,1
54966,5514,1000.00,22000.00,23000.00,6081.38,12307.87,0.30,1
54967,5514,-1000.00,21000.00,22000.00,14197.37,8802.63,0.14,0
54968,5514,1000.00,22000.00,23000.00,4798.18,17201.82,0.37,1
54969,5514,1000.00,23000.00,24000.00,0.00,23000.00,0.21,1
54970,5514,-1000.00,22000.00,23000.00,18650.51,5349.49,0.07,0
54971,5514,1000.00,23000.00,24000.00,6082.16,16917.84,0.07,1
54972,5514,1000.00,24000.00,25000.00,3428.59,20571.41,0.31,1
54973,5514,1000.00,25000.00,26000.00,12447.46,12552.54,0.11,1
54974,5514,1000.00,26000.00,27000.00,13000.00,13000.00,0.06,1
54975,5514,1000.00,27000.00,28000.00,0.00,22901.00,0.41,1
54976,5514,1000.00,28000.00,29000.00,11206.70,15191.50,0.26,1
54977,5514,1000.00,29000.00,30000.00,0.00,29000.00,0.35,1
54978,5514,1000.00,30000.00,31000.00,10679.54,19320.46,0.31,1
54979,5514,1000.00,31000.00,32000.00,0.00,31000.00,0.11,1
54980,5514,-1000.00,30000.00,31000.00,16602.68,15397.32,0.12,0
54981,5514,1000.00,31000.00,32000.00,0.00,31000.00,0.14,1
54982,5515,-1000.00,-1000.00,0.00,0.00,1000.00,0.17,0
54983,5516,-1000.00,-1000.00,0.00,0.00,1000.00,0.40,0
54984,5517,-1000.00,-1000.00,0.00,485.38,514.62,0.21,0
54985,5518,-1000.00,-1000.00,0.00,666.90,333.10,0.09,0
54986,5519,-796.98,-796.98,203.02,0.00,796.98,0.05,0
54987,5519,-203.02,-1000.00,0.00,63.97,139.04,0.10,0
54988,5520,-754.02,-754.02,245.98,0.00,754.02,0.18,0
54989,5520,-245.98,-1000.00,0.00,0.00,245.98,0.43,0
54990,5521,1000.00,1000.00,2000.00,320.32,679.68,0.34,1
54991,5521,-1000.00,0.00,1000.00,1295.31,704.69,0.13,0
54992,5521,1000.00,1000.00,2000.00,0.00,1000.00,0.19,1
54993,5521,1000.00,2000.00,3000.00,0.00,2000.00,0.30,1
54994,5521,1000.00,3000.00,4000.00,662.81,2337.19,0.28,1
54995,5521,1000.00,4000.00,5000.00,0.00,3990.37,0.44,1
54996,5521,-473.39,3526.61,4526.61,473.39,0.00,0.08,0
54997,5521,1000.00,4526.61,5526.61,0.00,1380.52,0.09,1
54998,5521,1000.00,5526.61,6526.61,962.57,4564.04,0.21,1
54999,5521,1000.00,6526.61,7526.61,0.00,3077.12,0.29,1
55000,5521,1000.00,7526.61,8526.61,0.00,504.09,0.02,1
55001,5521,-1000.00,6526.61,7526.61,2691.54,176.33,0.10,0
55002,5521,-1000.00,5526.61,6526.61,3753.25,3393.14,0.21,0
55003,5521,1000.00,6526.61,7526.61,0.00,6526.61,0.32,1
55004,5521,1000.00,7526.61,8526.61,0.00,2954.70,0.26,1
55005,5521,1000.00,8526.61,9526.61,0.00,8209.00,0.32,1
55006,5521,1000.00,9526.61,10526.61,837.61,8689.00,0.44,1
55007,5521,1000.00,10526.61,11526.61,3336.14,7190.47,0.34,1
55008,5521,1000.00,11526.61,12526.61,3721.84,7804.77,0.33,1
55009,5521,-1000.00,10526.61,11526.61,7943.98,0.00,0.02,0
55010,5521,-1000.00,9526.61,10526.61,2741.57,1632.58,0.15,0
55011,5521,1000.00,10526.61,11526.61,1035.31,9491.30,0.44,1
55012,5521,1000.00,11526.61,12526.61,1407.75,10118.86,0.43,1
55013,5521,1000.00,12526.61,13526.61,3255.92,9270.69,0.37,1
55014,5521,1000.00,13526.61,14526.61,0.00,3025.66,0.12,1
55015,5521,1000.00,14526.61,15526.61,0.00,11460.29,0.10,1
55016,5521,1000.00,15526.61,16526.61,0.00,9518.54,0.20,1
55017,5521,1000.00,16526.61,17526.61,0.00,11641.43,0.35,1
55018,5521,-865.50,15661.10,16661.10,865.50,0.00,0.10,0
55019,5521,1000.00,16661.10,17661.10,1022.47,15638.64,0.03,1
55020,5521,-1000.00,15661.10,16661.10,12386.46,5016.27,0.11,0
55021,5521,1000.00,16661.10,17661.10,0.00,16661.10,0.30,1
55022,5521,-1000.00,15661.10,16661.10,12083.61,5577.50,0.04,0
55023,5521,1000.00,16661.10,17661.10,6494.13,10166.97,0.29,1
55024,5521,1000.00,17661.10,18661.10,5932.47,11728.64,0.33,1
55025,5521,1000.00,18661.10,19661.10,9330.55,9330.55,0.01,1
55026,5521,1000.00,19661.10,20661.10,3451.87,16209.23,0.16,1
55027,5521,1000.00,20661.10,21661.10,7341.50,13319.60,0.22,1
55028,5521,-1000.00,19661.10,20661.10,6572.53,3854.90,0.15,0
55029,5521,1000.00,20661.10,21661.10,5325.31,7048.48,0.22,1
55030,5521,1000.00,21661.10,22661.10,0.00,21661.10,0.17,1
55031,5521,1000.00,22661.10,23661.10,731.63,18501.47,0.42,1
55032,5521,1000.00,23661.10,24661.10,2501.63,21159.48,0.43,1
55033,5521,1000.00,24661.10,25661.10,0.00,18133.88,0.36,1
55034,5521,1000.00,25661.10,26661.10,11667.51,13993.60,0.23,1
55035,5521,1000.00,26661.10,27661.10,0.00,26661.10,0.25,1
55036,5521,1000.00,27661.10,28661.10,7084.25,20576.86,0.36,1
55037,5521,1000.00,28661.10,29661.10,0.00,28661.10,0.40,1
55038,5521,-1000.00,27661.10,28661.10,3619.96,0.00,0.03,0
55039,5521,1000.00,28661.10,29661.10,0.00,12736.74,0.28,1
55040,5521,-1000.00,27661.10,28661.10,10467.31,4759.63,0.14,0
55041,5521,1000.00,28661.10,29661.10,0.00,28661.10,0.08,1
55042,5521,1000.00,29661.10,30661.10,0.00,29661.10,0.40,1
55043,5521,1000.00,30661.10,31661.10,14639.78,16021.33,0.06,1
55044,5521,1000.00,31661.10,32661.10,5344.30,26316.81,0.32,1
55045,5521,1000.00,32661.10,33661.10,12865.00,19796.11,0.29,1
55046,5521,1000.00,33661.10,34661.10,0.00,33661.10,0.40,1
55047,5521,1000.00,34661.10,35661.10,12012.17,22648.93,0.31,1
55048,5521,1000.00,35661.10,36661.10,12517.91,23143.19,0.04,1
55049,5521,1000.00,36661.10,37661.10,0.00,26444.12,0.28,1
55050,5521,1000.00,37661.10,38661.10,0.00,5424.65,0.15,1
55051,5521,1000.00,38661.10,39661.10,0.00,38661.10,0.02,1
55052,5521,0.00,38661.10,39661.10,0.00,0.00,0.00,0
55053,5521,1000.00,39661.10,40661.10,19219.50,20441.60,0.07,1
55054,5521,1000.00,40661.10,41661.10,10539.62,30121.49,0.38,1
55055,5521,-1000.00,39661.10,40661.10,9843.65,3382.66,0.13,0
55056,5521,1000.00,40661.10,41661.10,334.10,26536.99,0.37,1
55057,5521,1000.00,41661.10,42661.10,0.00,15128.07,0.21,1
55058,5521,1000.00,42661.10,43661.10,0.00,33392.32,0.37,1
55059,5522,-1000.00,-1000.00,0.00,0.00,1000.00,0.05,0
55060,5523,-674.71,-674.71,325.29,0.00,674.71,0.35,0
55061,5523,-325.29,-1000.00,0.00,75.59,249.69,0.15,0
55062,5524,1000.00,1000.00,2000.00,0.00,896.55,0.41,1
55063,5524,1000.00,2000.00,3000.00,0.00,1569.22,0.15,1
55064,5524,1000.00,3000.00,4000.00,0.00,2478.28,0.42,1
55065,5524,1000.00,4000.00,5000.00,1724.65,2275.35,0.24,1
55066,5524,1000.00,5000.00,6000.00,0.00,5000.00,0.25,1
55067,5524,1000.00,6000.00,7000.00,0.00,1354.89,0.17,1
55068,5524,1000.00,7000.00,8000.00,2241.23,4758.77,0.30,1
55069,5524,1000.00,8000.00,9000.00,2526.93,5473.07,0.25,1
55070,5524,1000.00,9000.00,10000.00,0.00,9000.00,0.40,1
55071,5524,1000.00,10000.00,11000.00,0.00,1583.17,0.07,1
55072,5524,1000.00,11000.00,12000.00,1716.92,4566.34,0.27,1
55073,5524,1000.00,12000.00,13000.00,0.00,8233.20,0.12,1
55074,5524,1000.00,13000.00,14000.00,0.00,13000.00,0.09,1
55075,5524,1000.00,14000.00,15000.00,6786.24,7213.76,0.08,1
55076,5524,-1000.00,13000.00,14000.00,7743.05,7256.95,0.19,0
55077,5524,1000.00,14000.00,15000.00,0.00,14000.00,0.30,1
55078,5524,1000.00,15000.00,16000.00,0.00,15000.00,0.23,1
55079,5524,1000.00,16000.00,17000.00,4682.82,11317.18,0.36,1
55080,5524,1000.00,17000.00,18000.00,0.00,17000.00,0.17,1
55081,5524,-1000.00,16000.00,17000.00,6300.92,11699.08,0.27,0
55082,5524,-1000.00,15000.00,16000.00,0.00,15501.62,0.15,0
55083,5524,-1000.00,14000.00,15000.00,8000.00,8000.00,0.01,0
55084,5524,-1000.00,13000.00,14000.00,5016.49,9983.51,0.20,0
55085,5524,-1000.00,12000.00,13000.00,3381.39,8315.80,0.32,0
55086,5524,-1000.00,11000.00,12000.00,1265.12,11734.88,0.42,0
55087,5524,-1000.00,10000.00,11000.00,0.00,12000.00,0.17,0
55088,5524,-1000.00,9000.00,10000.00,0.00,11000.00,0.02,0
55089,5524,-1000.00,8000.00,9000.00,3396.45,6603.55,0.31,0
55090,5524,-1000.00,7000.00,8000.00,0.00,9000.00,0.09,0
55091,5524,-1000.00,6000.00,7000.00,4571.83,501.57,0.08,0
55092,5524,-1000.00,5000.00,6000.00,2667.46,2403.20,0.20,0
55093,5524,-1000.00,4000.00,5000.00,3015.28,2984.72,0.21,0
55094,5524,-1000.00,3000.00,4000.00,1933.58,2438.56,0.25,0
55095,5524,-1000.00,2000.00,3000.00,1574.87,2425.13,0.24,0
55096,5524,-1000.00,1000.00,2000.00,1886.10,1113.90,0.11,0
55097,5524,-517.60,482.40,1482.40,0.00,517.60,0.09,0
55098,5524,0.00,482.40,1482.40,0.00,0.00,0.09,0
55099,5524,-1000.00,-517.60,482.40,1335.39,147.01,0.04,0
55100,5524,-482.40,-1000.00,0.00,0.00,482.40,0.29,0
55101,5525,1000.00,1000.00,2000.00,188.52,0.00,0.36,1
55102,5525,-201.39,798.61,1798.61,0.00,201.39,0.38,0
55103,5525,1000.00,1798.61,2798.61,886.49,0.00,0.03,1
55104,5525,1000.00,2798.61,3798.61,2290.25,0.00,0.07,1
55105,5525,-1000.00,1798.61,2798.61,104.66,1198.31,0.23,0
55106,5525,-1000.00,798.61,1798.61,105.35,2693.26,0.38,0
55107,5525,1000.00,1798.61,2798.61,919.12,879.49,0.08,1
55108,5525,1000.00,2798.61,3798.61,308.74,0.00,0.04,1
55109,5525,1000.00,3798.61,4798.61,2406.91,1391.69,0.17,1
55110,5525,-1000.00,2798.61,3798.61,1207.37,3591.23,0.37,0
55111,5525,-1000.00,1798.61,2798.61,0.00,1552.67,0.26,0
55112,5525,1000.00,2798.61,3798.61,1990.68,807.93,0.08,1
55113,5525,0.00,2798.61,3798.61,0.00,0.00,0.01,0
55114,5525,0.00,2798.61,3798.61,0.00,0.00,0.39,0
55115,5525,-1000.00,1798.61,2798.61,0.00,2213.41,0.25,0
55116,5525,-1000.00,798.61,1798.61,744.44,1768.06,0.33,0
55117,5525,-1000.00,-201.39,798.61,0.00,1798.61,0.11,0
55118,5525,-798.61,-1000.00,0.00,361.89,436.71,0.16,0
55119,5526,-869.07,-869.07,130.93,0.00,869.07,0.09,0
55120,5526,1000.00,130.93,1130.93,130.93,0.00,0.03,1
55121,5526,1000.00,1130.93,2130.93,930.19,200.74,0.03,1
55122,5526,-1000.00,130.93,1130.93,482.99,1408.99,0.35,0
55123,5526,-924.57,-793.64,206.36,247.71,676.86,0.35,0
55124,5526,-206.36,-1000.00,0.00,99.91,106.45,0.11,0
55125,5527,-1000.00,-1000.00,0.00,0.00,1000.00,0.05,0
55126,5528,-1000.00,-1000.00,0.00,547.94,452.06,0.18,0
55127,5528,0.00,-1000.00,0.00,0.00,0.00,0.39,1
55128,5528,0.00,-1000.00,0.00,0.00,0.00,0.33,1
55129,5528,0.00,-1000.00,0.00,0.00,0.00,0.36,1
55130,5528,0.00,-1000.00,0.00,0.00,0.00,0.16,1
55131,5528,0.00,-1000.00,0.00,0.00,0.00,0.35,1
55132,5528,0.03,-999.97,0.03,0.00,0.00,0.20,1
55133,5528,3.98,-995.99,4.01,0.00,0.03,0.18,1
55134,5528,415.45,-580.54,419.46,0.00,3.30,0.04,1
55135,5528,1000.00,419.46,1419.46,0.00,252.51,0.35,1
55136,5528,1000.00,1419.46,2419.46,0.00,445.56,0.08,1
55137,5528,1000.00,2419.46,3419.46,0.00,1709.84,0.09,1
55138,5528,1000.00,3419.46,4419.46,1296.25,2123.21,0.30,1
55139,5528,1000.00,4419.46,5419.46,0.00,4419.46,0.06,1
55140,5528,1000.00,5419.46,6419.46,0.00,5419.46,0.27,1
55141,5528,1000.00,6419.46,7419.46,78.08,6341.38,0.08,1
55142,5528,1000.00,7419.46,8419.46,0.00,4657.32,0.17,1
55143,5528,1000.00,8419.46,9419.46,1781.18,6638.27,0.40,1
55144,5528,1000.00,9419.46,10419.46,3626.89,5792.57,0.15,1
55145,5528,1000.00,10419.46,11419.46,0.00,10419.46,0.39,1
55146,5528,1000.00,11419.46,12419.46,0.00,406.03,0.10,1
55147,5528,1000.00,12419.46,13419.46,0.00,12419.46,0.05,1
55148,5528,1000.00,13419.46,14419.46,5075.99,8343.47,0.19,1
55149,5528,-1000.00,12419.46,13419.46,9191.40,5228.06,0.13,0
55150,5528,-1000.00,11419.46,12419.46,0.00,4737.56,0.25,0
55151,5528,-1000.00,10419.46,11419.46,0.00,12419.46,0.03,0
55152,5528,-1000.00,9419.46,10419.46,5709.73,5709.73,0.00,0
55153,5528,-1000.00,8419.46,9419.46,0.00,10419.46,0.09,0
55154,5528,-1000.00,7419.46,8419.46,6823.73,2164.85,0.09,0
55155,5528,-1000.00,6419.46,7419.46,4544.79,3627.30,0.19,0
55156,5528,-1000.00,5419.46,6419.46,3768.45,3651.00,0.16,0
55157,5528,-1000.00,4419.46,5419.46,2265.88,0.00,0.09,0
55158,5528,-1000.00,3419.46,4419.46,0.00,3641.55,0.19,0
55159,5528,-1000.00,2419.46,3419.46,0.00,4419.46,0.40,0
55160,5528,-1000.00,1419.46,2419.46,305.37,3114.08,0.08,0
55161,5528,-1000.00,419.46,1419.46,0.00,1546.61,0.36,0
55162,5528,-295.22,124.24,1124.24,8.74,286.47,0.18,0
55163,5528,-857.99,-733.75,266.25,0.00,857.99,0.39,0
55164,5528,-15.57,-749.32,250.68,0.00,15.57,0.12,0
55165,5528,-250.68,-1000.00,0.00,106.73,143.95,0.23,0
55166,5529,0.00,0.00,1000.00,0.00,0.00,0.03,0
55167,5529,1000.00,1000.00,2000.00,70.27,0.00,0.37,1
55168,5529,-1000.00,0.00,1000.00,0.00,2000.00,0.04,0
55169,5529,1000.00,1000.00,2000.00,375.50,0.00,0.03,1
55170,5529,-1000.00,0.00,1000.00,0.00,1793.80,0.26,0
55171,5529,-577.57,-577.57,422.43,0.00,577.57,0.21,0
55172,5529,-273.24,-850.81,149.19,0.00,273.24,0.37,0
55173,5529,-149.19,-1000.00,0.00,50.61,98.58,0.19,0
55174,5530,-1000.00,-1000.00,0.00,546.81,453.19,0.04,0
55175,5531,-1000.00,-1000.00,0.00,0.00,879.68,0.42,0
55176,5532,0.00,0.00,1000.00,0.00,0.00,0.39,0
55177,5532,-187.39,-187.39,812.61,0.00,187.39,0.12,0
55178,5532,1000.00,812.61,1812.61,336.30,0.00,0.04,1
55179,5532,-434.73,377.87,1377.87,0.00,434.73,0.20,0
55180,5532,-501.07,-123.19,876.81,209.74,291.32,0.18,0
55181,5532,1000.00,876.81,1876.81,281.00,152.48,0.37,1
55182,5532,1000.00,1876.81,2876.81,846.39,0.00,0.13,1
55183,5532,-1000.00,876.81,1876.81,1438.40,1438.40,0.03,0
55184,5532,-1000.00,-123.19,876.81,0.00,1876.81,0.06,0
55185,5532,-401.97,-525.16,474.84,0.00,401.97,0.11,0
55186,5532,0.00,-525.16,474.84,0.00,0.00,0.18,0
55187,5532,-474.84,-1000.00,0.00,142.79,332.05,0.25,0
55188,5533,-6.96,-6.96,993.04,0.00,6.96,0.11,0
55189,5533,-544.02,-550.98,449.02,0.00,544.02,0.29,0
55190,5533,-449.02,-1000.00,0.00,0.00,449.02,0.18,0
55191,5534,-1000.00,-1000.00,0.00,626.42,373.58,0.13,0
55192,5535,1000.00,1000.00,2000.00,603.43,396.57,0.11,1
55193,5535,1000.00,2000.00,3000.00,1543.69,0.00,0.15,1
55194,5535,0.00,2000.00,3000.00,0.00,0.00,0.19,0
55195,5535,1000.00,3000.00,4000.00,1360.05,0.00,0.33,1
55196,5535,-1000.00,2000.00,3000.00,936.89,3063.11,0.31,0
55197,5535,-1000.00,1000.00,2000.00,0.00,2356.48,0.42,0
55198,5535,-1000.00,0.00,1000.00,0.00,2000.00,0.01,0
55199,5535,1000.00,1000.00,2000.00,175.48,0.00,0.03,1
55200,5535,-1000.00,0.00,1000.00,807.54,1192.46,0.26,0
55201,5535,-1000.00,-1000.00,0.00,0.00,1000.00,0.17,0
55202,5536,1000.00,1000.00,2000.00,1000.00,0.00,0.03,1
55203,5536,1000.00,2000.00,3000.00,1083.72,916.28,0.12,1
55204,5536,-1000.00,1000.00,2000.00,0.00,1753.59,0.26,0
55205,5536,-119.17,880.83,1880.83,0.00,119.17,0.11,0
55206,5536,-1000.00,-119.17,880.83,709.79,1171.04,0.25,0
55207,5536,0.00,-119.17,880.83,0.00,0.00,0.33,0
55208,5536,-180.97,-300.14,699.86,0.00,180.97,0.35,0
55209,5536,-336.64,-636.78,363.22,0.00,336.64,0.32,0
55210,5536,-76.96,-713.73,286.27,0.00,76.96,0.42,0
55211,5536,-286.27,-1000.00,0.00,0.00,286.27,0.40,0
55212,5537,-1000.00,-1000.00,0.00,260.24,739.76,0.32,0
55213,5538,-1000.00,-1000.00,0.00,0.00,894.82,0.41,0
55214,5539,-1000.00,-1000.00,0.00,347.48,652.52,0.27,0
55215,5540,1000.00,1000.00,2000.00,0.00,837.55,0.31,1
55216,5540,1000.00,2000.00,3000.00,1000.00,1000.00,0.03,1
55217,5540,1000.00,3000.00,4000.00,501.24,2498.76,0.13,1
55218,5540,1000.00,4000.00,5000.00,0.00,4000.00,0.35,1
55219,5540,-1000.00,3000.00,4000.00,3461.52,0.00,0.01,0
55220,5540,1000.00,4000.00,5000.00,349.10,3053.73,0.40,1
55221,5540,1000.00,5000.00,6000.00,0.00,2627.59,0.05,1
55222,5540,1000.00,6000.00,7000.00,942.50,4941.01,0.41,1
55223,5540,-1000.00,5000.00,6000.00,7000.00,0.00,0.02,0
55224,5540,-1000.00,4000.00,5000.00,1618.27,1440.16,0.18,0
55225,5540,1000.00,5000.00,6000.00,0.00,948.74,0.11,1
55226,5540,1000.00,6000.00,7000.00,2436.25,2596.28,0.22,1
55227,5540,1000.00,7000.00,8000.00,0.00,7000.00,0.13,1
55228,5540,1000.00,8000.00,9000.00,0.00,8000.00,0.41,1
55229,5540,1000.00,9000.00,10000.00,4279.58,4720.42,0.24,1
55230,5540,1000.00,10000.00,11000.00,0.00,9037.06,0.36,1
55231,5540,-1000.00,9000.00,10000.00,6647.23,4352.77,0.06,0
55232,5540,-1000.00,8000.00,9000.00,6512.82,3487.18,0.09,0
55233,5540,1000.00,9000.00,10000.00,0.00,7555.28,0.41,1
55234,5540,1000.00,10000.00,11000.00,117.02,4099.27,0.27,1
55235,5540,1000.00,11000.00,12000.00,3508.38,7491.62,0.26,1
55236,5540,1000.00,12000.00,13000.00,0.00,9449.07,0.23,1
55237,5540,1000.00,13000.00,14000.00,5071.04,7928.96,0.23,1
55238,5540,1000.00,14000.00,15000.00,0.00,9029.42,0.35,1
55239,5540,-1000.00,13000.00,14000.00,0.00,15000.00,0.22,0
55240,5540,-1000.00,12000.00,13000.00,7893.96,5827.32,0.18,0
55241,5540,-1000.00,11000.00,12000.00,5173.74,7826.26,0.27,0
55242,5540,-1000.00,10000.00,11000.00,3846.69,8153.31,0.28,0
55243,5540,-1000.00,9000.00,10000.00,4009.22,4534.35,0.23,0
55244,5540,-1000.00,8000.00,9000.00,0.00,10000.00,0.36,0
55245,5540,0.00,8000.00,9000.00,0.00,0.00,0.07,0
55246,5540,-1000.00,7000.00,8000.00,0.00,9000.00,0.09,0
55247,5540,-1000.00,6000.00,7000.00,1944.89,6055.11,0.39,0
55248,5540,-1000.00,5000.00,6000.00,0.00,7000.00,0.05,0
55249,5540,-1000.00,4000.00,5000.00,0.00,6000.00,0.05,0
55250,5540,-1000.00,3000.00,4000.00,182.41,4817.59,0.37,0
55251,5540,-1000.00,2000.00,3000.00,0.00,3716.19,0.44,0
55252,5540,-1000.00,1000.00,2000.00,0.00,3000.00,0.33,0
55253,5540,-1000.00,0.00,1000.00,0.00,2000.00,0.25,0
55254,5540,-888.12,-888.12,111.88,0.00,888.12,0.42,0
55255,5540,-111.88,-1000.00,0.00,0.00,111.88,0.11,0
55256,5541,-645.86,-645.86,354.14,0.00,645.86,0.37,0
55257,5541,-295.05,-940.91,59.09,54.99,240.06,0.37,0
55258,5541,-59.09,-1000.00,0.00,25.73,33.36,0.07,0
55259,5542,-1000.00,-1000.00,0.00,872.66,127.34,0.03,0
55260,5543,1000.00,1000.00,2000.00,0.00,1000.00,0.41,1
55261,5543,1000.00,2000.00,3000.00,819.40,1180.60,0.24,1
55262,5543,1000.00,3000.00,4000.00,0.00,3000.00,0.12,1
55263,5543,1000.00,4000.00,5000.00,0.00,4000.00,0.42,1
55264,5543,1000.00,5000.00,6000.00,0.00,5000.00,0.44,1
55265,5543,1000.00,6000.00,7000.00,0.00,3323.55,0.09,1
55266,5543,-1000.00,5000.00,6000.00,0.00,1498.76,0.14,0
55267,5543,-1000.00,4000.00,5000.00,2690.55,3309.45,0.01,0
55268,5543,-1000.00,3000.00,4000.00,0.00,3798.77,0.18,0
55269,5543,-1000.00,2000.00,3000.00,0.00,3797.73,0.44,0
55270,5543,-1000.00,1000.00,2000.00,0.00,3000.00,0.23,0
55271,5543,-1000.00,0.00,1000.00,858.35,1141.65,0.26,0
55272,5543,-1000.00,-1000.00,0.00,50.19,63.97,0.13,0
55273,5544,-1000.00,-1000.00,0.00,495.77,504.23,0.21,0
55274,5545,-1000.00,-1000.00,0.00,459.69,540.31,0.14,0
55275,5546,-1000.00,-1000.00,0.00,0.00,1000.00,0.09,0
55276,5547,1000.00,1000.00,2000.00,0.00,1000.00,0.38,1
55277,5547,1000.00,2000.00,3000.00,0.00,1464.98,0.34,1
55278,5547,1000.00,3000.00,4000.00,299.31,2700.69,0.36,1
55279,5547,1000.00,4000.00,5000.00,0.00,3851.67,0.44,1
55280,5547,1000.00,5000.00,6000.00,0.00,3818.75,0.38,1
55281,5547,1000.00,6000.00,7000.00,1698.06,4301.94,0.34,1
55282,5547,1000.00,7000.00,8000.00,0.00,7000.00,0.06,1
55283,5547,1000.00,8000.00,9000.00,0.00,8000.00,0.10,1
55284,5547,1000.00,9000.00,10000.00,3032.48,5967.52,0.31,1
55285,5547,1000.00,10000.00,11000.00,0.00,2935.00,0.12,1
55286,5547,1000.00,11000.00,12000.00,0.00,11000.00,0.07,1
55287,5547,1000.00,12000.00,13000.00,3672.97,8327.03,0.31,1
55288,5547,1000.00,13000.00,14000.00,0.00,10189.25,0.07,1
55289,5547,1000.00,14000.00,15000.00,0.00,11242.37,0.35,1
55290,5547,1000.00,15000.00,16000.00,0.00,15000.00,0.05,1
55291,5547,1000.00,16000.00,17000.00,0.00,16000.00,0.04,1
55292,5547,1000.00,17000.00,18000.00,4642.08,12357.92,0.17,1
55293,5547,1000.00,18000.00,19000.00,0.00,2183.70,0.15,1
55294,5547,1000.00,19000.00,20000.00,0.00,9696.87,0.10,1
55295,5547,1000.00,20000.00,21000.00,5930.04,14069.96,0.33,1
55296,5547,1000.00,21000.00,22000.00,0.00,18880.99,0.21,1
55297,5547,1000.00,22000.00,23000.00,0.00,6714.47,0.08,1
55298,5547,-1000.00,21000.00,22000.00,0.00,23000.00,0.33,0
55299,5547,-1000.00,20000.00,21000.00,0.00,22000.00,0.22,0
55300,5547,-1000.00,19000.00,20000.00,0.00,20429.97,0.33,0
55301,5547,-1000.00,18000.00,19000.00,6163.61,13836.39,0.35,0
55302,5547,-1000.00,17000.00,18000.00,0.00,19000.00,0.24,0
55303,5547,-1000.00,16000.00,17000.00,0.00,3254.47,0.13,0
55304,5547,-1000.00,15000.00,16000.00,8191.81,7555.74,0.21,0
55305,5547,-1000.00,14000.00,15000.00,5942.80,10057.20,0.25,0
55306,5547,-1000.00,13000.00,14000.00,0.00,15000.00,0.19,0
55307,5547,-1000.00,12000.00,13000.00,5056.11,8562.28,0.30,0
55308,5547,-1000.00,11000.00,12000.00,0.00,13000.00,0.14,0
55309,5547,-1000.00,10000.00,11000.00,6530.63,5469.37,0.12,0
55310,5547,-1000.00,9000.00,10000.00,0.00,1823.64,0.16,0
55311,5547,-1000.00,8000.00,9000.00,923.79,6737.20,0.38,0
55312,5547,-1000.00,7000.00,8000.00,4237.40,4762.60,0.24,0
55313,5547,-1000.00,6000.00,7000.00,86.67,1253.61,0.16,0
55314,5547,-1000.00,5000.00,6000.00,0.00,7000.00,0.23,0
55315,5547,-1000.00,4000.00,5000.00,421.57,5578.43,0.40,0
55316,5547,-1000.00,3000.00,4000.00,0.00,5000.00,0.10,0
55317,5547,-1000.00,2000.00,3000.00,4000.00,0.00,0.01,0
55318,5547,-1000.00,1000.00,2000.00,703.77,2296.23,0.18,0
55319,5547,-1000.00,0.00,1000.00,476.15,1523.85,0.38,0
55320,5547,-1000.00,-1000.00,0.00,207.43,792.57,0.37,0
55321,5548,1000.00,1000.00,2000.00,117.13,882.87,0.43,1
55322,5548,-1000.00,0.00,1000.00,1017.09,982.91,0.15,0
55323,5548,-1000.00,-1000.00,0.00,174.89,514.15,0.31,0
55324,5549,-1000.00,-1000.00,0.00,0.00,1000.00,0.40,0
55325,5550,0.00,0.00,1000.00,0.00,0.00,0.08,0
55326,5550,-277.52,-277.52,722.48,0.00,277.52,0.06,0
55327,5550,-722.48,-1000.00,0.00,247.56,474.92,0.33,0
55328,5551,-1000.00,-1000.00,0.00,47.04,303.75,0.39,0
55329,5552,1000.00,1000.00,2000.00,0.00,193.62,0.18,1
55330,5552,1000.00,2000.00,3000.00,0.00,2000.00,0.31,1
55331,5552,1000.00,3000.00,4000.00,1240.76,1759.24,0.16,1
55332,5552,1000.00,4000.00,5000.00,0.00,3907.09,0.15,1
55333,5552,1000.00,5000.00,6000.00,1039.45,3960.55,0.35,1
55334,5552,1000.00,6000.00,7000.00,2895.62,3104.38,0.18,1
55335,5552,1000.00,7000.00,8000.00,0.00,3596.43,0.30,1
55336,5552,1000.00,8000.00,9000.00,1922.59,3252.33,0.25,1
55337,5552,-1000.00,7000.00,8000.00,5190.67,3809.33,0.11,0
55338,5552,1000.00,8000.00,9000.00,2868.58,5131.42,0.06,1
55339,5552,1000.00,9000.00,10000.00,0.00,7275.02,0.42,1
55340,5552,1000.00,10000.00,11000.00,4327.20,5672.80,0.26,1
55341,5552,1000.00,11000.00,12000.00,3673.51,7326.49,0.33,1
55342,5552,-1000.00,10000.00,11000.00,8333.73,0.00,0.04,0
55343,5552,-1000.00,9000.00,10000.00,5596.52,5403.48,0.19,0
55344,5552,1000.00,10000.00,11000.00,1490.53,8509.47,0.09,1
55345,5552,1000.00,11000.00,12000.00,0.00,8049.59,0.23,1
55346,5552,1000.00,12000.00,13000.00,0.00,5653.95,0.30,1
55347,5552,1000.00,13000.00,14000.00,0.00,13000.00,0.21,1
55348,5552,1000.00,14000.00,15000.00,4782.82,9217.18,0.32,1
55349,5552,1000.00,15000.00,16000.00,5358.03,9641.97,0.29,1
55350,5552,1000.00,16000.00,17000.00,4034.52,6420.45,0.25,1
55351,5552,-1000.00,15000.00,16000.00,6638.42,10361.58,0.29,0
55352,5552,-1000.00,14000.00,15000.00,0.00,2732.18,0.10,0
55353,5552,-1000.00,13000.00,14000.00,0.00,12285.00,0.39,0
55354,5552,-1000.00,12000.00,13000.00,0.00,14000.00,0.03,0
55355,5552,-1000.00,11000.00,12000.00,0.00,13000.00,0.36,0
55356,5552,-1000.00,10000.00,11000.00,0.00,12000.00,0.42,0
55357,5552,-1000.00,9000.00,10000.00,0.00,11000.00,0.11,0
55358,5552,-1000.00,8000.00,9000.00,1101.58,8898.42,0.26,0
55359,5552,-1000.00,7000.00,8000.00,0.00,5684.46,0.36,0
55360,5552,-1000.00,6000.00,7000.00,4554.91,3445.09,0.07,0
55361,5552,-1000.00,5000.00,6000.00,0.00,7000.00,0.40,0
55362,5552,-1000.00,4000.00,5000.00,2298.68,3701.32,0.30,0
55363,5552,-1000.00,3000.00,4000.00,0.00,4111.74,0.32,0
55364,5552,-1000.00,2000.00,3000.00,0.00,4000.00,0.04,0
55365,5552,-1000.00,1000.00,2000.00,897.53,2102.47,0.34,0
55366,5552,1000.00,2000.00,3000.00,0.00,2000.00,0.21,1
55367,5552,1000.00,3000.00,4000.00,1118.38,1881.62,0.06,1
55368,5552,1000.00,4000.00,5000.00,0.00,4000.00,0.32,1
55369,5552,1000.00,5000.00,6000.00,1214.86,3785.14,0.37,1
55370,5552,-1000.00,4000.00,5000.00,4734.35,1265.65,0.05,0
55371,5552,1000.00,5000.00,6000.00,0.00,5000.00,0.07,1
55372,5552,1000.00,6000.00,7000.00,2751.87,3248.13,0.17,1
55373,5552,1000.00,7000.00,8000.00,175.78,6824.22,0.16,1
55374,5552,1000.00,8000.00,9000.00,0.00,8000.00,0.35,1
55375,5552,1000.00,9000.00,10000.00,0.00,1949.10,0.19,1
55376,5552,1000.00,10000.00,11000.00,0.00,10000.00,0.14,1
55377,5552,1000.00,11000.00,12000.00,0.00,11000.00,0.09,1
55378,5552,1000.00,12000.00,13000.00,0.00,12000.00,0.40,1
55379,5552,1000.00,13000.00,14000.00,0.00,7553.79,0.27,1
55380,5552,1000.00,14000.00,15000.00,0.00,14000.00,0.38,1
55381,5552,1000.00,15000.00,16000.00,3771.99,11228.01,0.26,1
55382,5553,0.00,0.00,1000.00,0.00,0.00,0.25,0
55383,5553,-823.78,-823.78,176.22,823.78,0.00,0.07,0
55384,5553,1000.00,176.22,1176.22,0.00,154.53,0.02,1
55385,5553,1000.00,1176.22,2176.22,257.85,258.82,0.18,1
55386,5553,1000.00,2176.22,3176.22,369.46,657.74,0.22,1
55387,5553,1000.00,3176.22,4176.22,110.80,842.55,0.21,1
55388,5553,1000.00,4176.22,5176.22,0.00,4176.22,0.04,1
55389,5553,1000.00,5176.22,6176.22,0.00,2938.02,0.13,1
55390,5553,1000.00,6176.22,7176.22,0.00,4828.12,0.10,1
55391,5553,1000.00,7176.22,8176.22,0.00,5018.54,0.14,1
55392,5553,1000.00,8176.22,9176.22,0.00,2986.15,0.21,1
55393,5553,1000.00,9176.22,10176.22,4234.04,4942.18,0.15,1
55394,5553,1000.00,10176.22,11176.22,0.00,9273.39,0.09,1
55395,5553,1000.00,11176.22,12176.22,2327.45,3833.76,0.23,1
55396,5553,1000.00,12176.22,13176.22,0.00,12176.22,0.13,1
55397,5553,1000.00,13176.22,14176.22,0.00,13176.22,0.32,1
55398,5553,1000.00,14176.22,15176.22,4839.80,9336.41,0.30,1
55399,5553,1000.00,15176.22,16176.22,4764.48,10411.74,0.32,1
55400,5553,1000.00,16176.22,17176.22,0.00,16176.22,0.10,1
55401,5553,1000.00,17176.22,18176.22,0.00,5373.66,0.05,1
55402,5553,1000.00,18176.22,19176.22,3858.86,14317.36,0.30,1
55403,5553,1000.00,19176.22,20176.22,0.00,15814.38,0.40,1
55404,5553,1000.00,20176.22,21176.22,0.00,20176.22,0.08,1
55405,5553,1000.00,21176.22,22176.22,0.00,21176.22,0.25,1
55406,5553,1000.00,22176.22,23176.22,9281.72,12894.50,0.13,1
55407,5553,1000.00,23176.22,24176.22,11588.11,11588.11,0.08,1
55408,5553,1000.00,24176.22,25176.22,10416.52,13759.70,0.04,1
55409,5553,1000.00,25176.22,26176.22,0.00,11002.58,0.01,1
55410,5553,-1000.00,24176.22,25176.22,14236.33,11939.89,0.11,0
55411,5553,1000.00,25176.22,26176.22,0.00,25176.22,0.22,1
55412,5553,-1000.00,24176.22,25176.22,2532.11,0.00,0.05,0
55413,5553,1000.00,25176.22,26176.22,497.43,24678.79,0.29,1
55414,5553,1000.00,26176.22,27176.22,0.00,22942.07,0.37,1
55415,5553,1000.00,27176.22,28176.22,11387.02,15789.20,0.17,1
55416,5553,0.00,27176.22,28176.22,0.00,0.00,0.03,0
55417,5553,1000.00,28176.22,29176.22,2491.30,25684.92,0.36,1
55418,5553,1000.00,29176.22,30176.22,9753.67,19422.55,0.33,1
55419,5553,1000.00,30176.22,31176.22,8760.78,21415.44,0.34,1
55420,5553,1000.00,31176.22,32176.22,0.00,31176.22,0.37,1
55421,5553,1000.00,32176.22,33176.22,7028.45,25147.77,0.39,1
55422,5553,1000.00,33176.22,34176.22,0.00,33176.22,0.41,1
55423,5553,1000.00,34176.22,35176.22,0.00,23797.93,0.27,1
55424,5553,1000.00,35176.22,36176.22,13335.33,21840.89,0.27,1
55425,5553,1000.00,36176.22,37176.22,0.00,36176.22,0.01,1
55426,5554,-264.02,-264.02,735.98,0.00,264.02,0.15,0
55427,5554,-1000.00,-1264.02,-264.02,417.75,318.22,0.09,0
55428,5555,-1000.00,-1000.00,0.00,436.27,563.73,0.26,0
55429,5556,-953.91,-953.91,46.09,0.00,953.91,0.27,0
55430,5556,-46.09,-1000.00,0.00,21.48,24.61,0.14,0
55431,5557,-1000.00,-1000.00,0.00,109.96,890.04,0.43,0
55432,5558,0.00,0.00,1000.00,0.00,0.00,0.38,0
55433,5558,-1000.00,-1000.00,0.00,1000.00,0.00,0.10,0
55434,5559,-1000.00,-1000.00,0.00,0.00,1000.00,0.34,0
55435,5560,-1000.00,-1000.00,0.00,0.00,1000.00,0.04,0
55436,5561,1000.00,1000.00,2000.00,436.20,563.80,0.22,1
55437,5561,1000.00,2000.00,3000.00,429.24,1570.76,0.40,1
55438,5561,1000.00,3000.00,4000.00,0.00,3000.00,0.09,1
55439,5561,1000.00,4000.00,5000.00,0.00,3633.15,0.37,1
55440,5561,1000.00,5000.00,6000.00,0.00,1209.36,0.20,1
55441,5561,1000.00,6000.00,7000.00,0.00,3730.05,0.30,1
55442,5561,1000.00,7000.00,8000.00,0.00,7000.00,0.14,1
55443,5561,1000.00,8000.00,9000.00,938.00,7062.00,0.11,1
55444,5561,1000.00,9000.00,10000.00,2365.01,6634.99,0.27,1
55445,5561,1000.00,10000.00,11000.00,0.00,1309.23,0.14,1
55446,5561,1000.00,11000.00,12000.00,1194.64,9805.36,0.16,1
55447,5561,1000.00,12000.00,13000.00,0.00,7182.34,0.31,1
55448,5561,1000.00,13000.00,14000.00,3567.15,9432.85,0.32,1
55449,5561,-1000.00,12000.00,13000.00,7399.02,6600.98,0.09,0
55450,5561,1000.00,13000.00,14000.00,952.32,12047.68,0.28,1
55451,5561,1000.00,14000.00,15000.00,3346.57,10653.43,0.25,1
55452,5561,1000.00,15000.00,16000.00,7358.95,7641.05,0.11,1
55453,5561,-658.65,14341.35,15341.35,658.65,0.00,0.01,0
55454,5561,-1000.00,13341.35,14341.35,4313.83,865.22,0.12,0
55455,5561,1000.00,14341.35,15341.35,0.00,9948.08,0.31,1
55456,5561,1000.00,15341.35,16341.35,3243.16,12098.19,0.15,1
55457,5561,1000.00,16341.35,17341.35,0.00,16341.35,0.09,1
55458,5561,1000.00,17341.35,18341.35,0.00,16899.21,0.44,1
55459,5561,0.00,17341.35,18341.35,0.00,0.00,0.07,0
55460,5561,1000.00,18341.35,19341.35,0.00,14030.66,0.39,1
55461,5561,1000.00,19341.35,20341.35,5462.87,13878.48,0.29,1
55462,5561,1000.00,20341.35,21341.35,0.00,20341.35,0.28,1
55463,5561,1000.00,21341.35,22341.35,0.00,21341.35,0.16,1
55464,5561,1000.00,22341.35,23341.35,11025.48,11315.87,0.20,1
55465,5561,1000.00,23341.35,24341.35,0.00,23341.35,0.18,1
55466,5561,1000.00,24341.35,25341.35,0.00,7315.01,0.17,1
55467,5561,1000.00,25341.35,26341.35,0.00,25341.35,0.10,1
55468,5561,1000.00,26341.35,27341.35,0.00,26341.35,0.38,1
55469,5561,1000.00,27341.35,28341.35,7016.84,20324.51,0.36,1
55470,5561,1000.00,28341.35,29341.35,10407.15,17934.20,0.06,1
55471,5561,-1000.00,27341.35,28341.35,15102.22,14239.13,0.01,0
55472,5561,1000.00,28341.35,29341.35,13139.67,15201.68,0.19,1
55473,5561,1000.00,29341.35,30341.35,7775.49,21565.86,0.36,1
55474,5561,1000.00,30341.35,31341.35,0.00,23759.49,0.34,1
55475,5561,1000.00,31341.35,32341.35,11083.49,20257.86,0.32,1
55476,5561,1000.00,32341.35,33341.35,0.00,24098.09,0.07,1
55477,5561,1000.00,33341.35,34341.35,0.00,33341.35,0.25,1
55478,5561,1000.00,34341.35,35341.35,349.03,33992.32,0.43,1
55479,5561,1000.00,35341.35,36341.35,6023.75,29317.60,0.17,1
55480,5561,0.00,35341.35,36341.35,0.00,0.00,0.06,0
55481,5562,-1000.00,-1000.00,0.00,0.00,1000.00,0.21,0
55482,5563,-1000.00,-1000.00,0.00,0.00,1000.00,0.03,0
55483,5564,-884.98,-884.98,115.02,0.00,884.98,0.39,0
55484,5564,-115.02,-1000.00,0.00,0.00,115.02,0.16,0
55485,5565,-897.51,-897.51,102.49,897.51,0.00,0.14,0
55486,5565,-1000.00,-1897.51,-897.51,30.24,60.56,0.26,0
55487,5566,-967.08,-967.08,32.92,0.00,967.08,0.43,0
55488,5566,-32.92,-1000.00,0.00,0.00,32.92,0.11,0
55489,5567,-527.39,-527.39,472.61,0.00,527.39,0.31,0
55490,5567,-472.61,-1000.00,0.00,0.00,472.61,0.36,0
55491,5568,-1000.00,-1000.00,0.00,0.00,1000.00,0.10,0
55492,5569,0.00,0.00,1000.00,0.00,0.00,0.03,0
55493,5569,0.00,0.00,1000.00,0.00,0.00,0.08,0
55494,5569,-1000.00,-1000.00,0.00,119.76,880.24,0.16,0
55495,5570,-451.22,-451.22,548.78,61.79,389.43,0.26,0
55496,5570,-548.78,-1000.00,0.00,125.27,423.51,0.40,0
55497,5571,1000.00,1000.00,2000.00,0.00,43.47,0.08,1
55498,5571,1000.00,2000.00,3000.00,0.00,2000.00,0.27,1
55499,5571,1000.00,3000.00,4000.00,0.00,2233.06,0.39,1
55500,5571,1000.00,4000.00,5000.00,1373.97,2626.03,0.08,1
55501,5571,1000.00,5000.00,6000.00,0.00,5000.00,0.31,1
55502,5571,1000.00,6000.00,7000.00,1501.56,4498.44,0.29,1
55503,5571,1000.00,7000.00,8000.00,0.00,7000.00,0.20,1
55504,5571,1000.00,8000.00,9000.00,1170.07,6829.93,0.02,1
55505,5571,1000.00,9000.00,10000.00,3735.11,5264.89,0.23,1
55506,5571,1000.00,10000.00,11000.00,0.00,10000.00,0.36,1
55507,5571,1000.00,11000.00,12000.00,0.00,11000.00,0.33,1
55508,5571,0.00,11000.00,12000.00,0.00,0.00,0.01,0
55509,5571,-1000.00,10000.00,11000.00,8930.02,3069.98,0.08,0
55510,5571,1000.00,11000.00,12000.00,851.66,10148.34,0.44,1
55511,5571,1000.00,12000.00,13000.00,2329.36,9670.64,0.27,1
55512,5571,1000.00,13000.00,14000.00,2861.79,8867.98,0.36,1
55513,5571,1000.00,14000.00,15000.00,0.00,6702.46,0.16,1
55514,5571,1000.00,15000.00,16000.00,0.00,15000.00,0.03,1
55515,5571,1000.00,16000.00,17000.00,0.00,16000.00,0.30,1
55516,5571,1000.00,17000.00,18000.00,0.00,17000.00,0.20,1
55517,5571,1000.00,18000.00,19000.00,0.00,18000.00,0.36,1
55518,5571,-1000.00,17000.00,18000.00,7096.36,4716.69,0.17,0
55519,5571,0.00,17000.00,18000.00,0.00,0.00,0.02,0
55520,5571,-1000.00,16000.00,17000.00,5389.89,3325.76,0.16,0
55521,5571,-1000.00,15000.00,16000.00,6036.54,10963.46,0.34,0
55522,5571,-1000.00,14000.00,15000.00,0.00,5690.60,0.26,0
55523,5571,-1000.00,13000.00,14000.00,0.00,15000.00,0.14,0
55524,5571,-1000.00,12000.00,13000.00,1313.03,9598.92,0.38,0
55525,5571,-1000.00,11000.00,12000.00,0.00,13000.00,0.20,0
55526,5571,-1000.00,10000.00,11000.00,0.00,12000.00,0.04,0
55527,5571,-1000.00,9000.00,10000.00,0.00,11000.00,0.12,0
55528,5571,-1000.00,8000.00,9000.00,0.00,8392.47,0.42,0
55529,5571,-1000.00,7000.00,8000.00,0.00,7699.79,0.24,0
55530,5571,-1000.00,6000.00,7000.00,4050.28,3949.72,0.20,0
55531,5571,-1000.00,5000.00,6000.00,3500.00,3500.00,0.07,0
55532,5571,-1000.00,4000.00,5000.00,29.84,3395.68,0.34,0
55533,5571,-1000.00,3000.00,4000.00,840.88,2933.54,0.34,0
55534,5571,-1000.00,2000.00,3000.00,0.00,4000.00,0.18,0
55535,5571,-1000.00,1000.00,2000.00,0.00,1004.82,0.14,0
55536,5571,-1000.00,0.00,1000.00,608.02,1391.98,0.04,0
55537,5571,-1000.00,-1000.00,0.00,0.00,1000.00,0.39,0
55538,5572,-1000.00,-1000.00,0.00,0.00,1000.00,0.20,0
55539,5573,-1000.00,-1000.00,0.00,392.30,607.70,0.29,0
55540,5574,0.00,0.00,1000.00,0.00,0.00,0.08,0
55541,5574,-1000.00,-1000.00,0.00,392.29,560.62,0.35,0
55542,5575,-1000.00,-1000.00,0.00,308.16,691.84,0.23,0
55543,5576,0.00,0.00,1000.00,0.00,0.00,0.02,0
55544,5576,-1000.00,-1000.00,0.00,0.00,74.11,0.08,0
55545,5577,-380.76,-380.76,619.24,380.76,0.00,0.33,0
55546,5577,-282.68,-663.44,336.56,282.68,0.00,0.05,0
55547,5577,-1000.00,-1663.44,-663.44,40.41,296.15,0.43,0
55548,5578,-1000.00,-1000.00,0.00,622.04,377.96,0.09,0
55549,5579,-1000.00,-1000.00,0.00,296.72,703.28,0.34,0
55550,5580,-1000.00,-1000.00,0.00,28.62,971.38,0.20,0
55551,5581,-1000.00,-1000.00,0.00,0.00,497.45,0.31,0
55552,5582,-1000.00,-1000.00,0.00,292.60,707.40,0.35,0
55553,5583,1000.00,1000.00,2000.00,0.00,1000.00,0.35,1
55554,5583,-1000.00,0.00,1000.00,1187.86,812.14,0.17,0
55555,5583,1000.00,1000.00,2000.00,445.56,554.44,0.18,1
55556,5583,1000.00,2000.00,3000.00,0.00,2000.00,0.11,1
55557,5583,1000.00,3000.00,4000.00,0.00,3000.00,0.33,1
55558,5583,1000.00,4000.00,5000.00,0.00,4000.00,0.06,1
55559,5583,1000.00,5000.00,6000.00,0.00,5000.00,0.06,1
55560,5583,1000.00,6000.00,7000.00,0.00,1048.42,0.17,1
55561,5583,1000.00,7000.00,8000.00,0.00,7000.00,0.25,1
55562,5583,1000.00,8000.00,9000.00,0.00,8000.00,0.17,1
55563,5583,-1000.00,7000.00,8000.00,4815.56,4184.44,0.05,0
55564,5583,1000.00,8000.00,9000.00,0.00,8000.00,0.00,1
55565,5583,1000.00,9000.00,10000.00,0.00,9000.00,0.03,1
55566,5583,0.00,9000.00,10000.00,0.00,0.00,0.08,0
55567,5583,-1000.00,8000.00,9000.00,5682.28,1523.21,0.10,0
55568,5583,1000.00,9000.00,10000.00,0.00,9000.00,0.22,1
55569,5583,1000.00,10000.00,11000.00,0.00,3229.08,0.21,1
55570,5583,1000.00,11000.00,12000.00,5500.00,5500.00,0.10,1
55571,5583,1000.00,12000.00,13000.00,1357.55,10642.45,0.15,1
55572,5583,-1000.00,11000.00,12000.00,9143.11,3856.89,0.07,0
55573,5583,1000.00,12000.00,13000.00,0.00,12000.00,0.04,1
55574,5583,1000.00,13000.00,14000.00,2749.48,10250.52,0.40,1
55575,5583,1000.00,14000.00,15000.00,7000.00,7000.00,0.04,1
55576,5583,1000.00,15000.00,16000.00,3935.61,11064.39,0.34,1
55577,5583,-1000.00,14000.00,15000.00,10414.88,5585.12,0.03,0
55578,5583,-1000.00,13000.00,14000.00,8261.66,4643.64,0.15,0
55579,5583,1000.00,14000.00,15000.00,4386.85,9613.15,0.33,1
55580,5583,1000.00,15000.00,16000.00,0.00,12077.35,0.42,1
55581,5583,1000.00,16000.00,17000.00,0.00,16000.00,0.26,1
55582,5583,1000.00,17000.00,18000.00,0.00,2239.08,0.03,1
55583,5583,1000.00,18000.00,19000.00,5677.86,12322.14,0.20,1
55584,5583,1000.00,19000.00,20000.00,0.00,15271.61,0.13,1
55585,5583,1000.00,20000.00,21000.00,0.00,20000.00,0.39,1
55586,5583,1000.00,21000.00,22000.00,1716.59,19114.89,0.43,1
55587,5583,1000.00,22000.00,23000.00,9730.12,12269.88,0.23,1
55588,5583,1000.00,23000.00,24000.00,5453.30,17546.70,0.35,1
55589,5583,1000.00,24000.00,25000.00,7794.30,16205.70,0.32,1
55590,5583,1000.00,25000.00,26000.00,8029.26,16970.74,0.34,1
55591,5583,-1000.00,24000.00,25000.00,6751.23,0.00,0.05,0
55592,5583,1000.00,25000.00,26000.00,5749.66,19250.34,0.31,1
55593,5583,1000.00,26000.00,27000.00,11164.39,14835.61,0.12,1
55594,5583,1000.00,27000.00,28000.00,0.00,27000.00,0.07,1
55595,5583,1000.00,28000.00,29000.00,0.00,17781.71,0.17,1
55596,5583,1000.00,29000.00,30000.00,8913.57,14525.98,0.27,1
55597,5583,1000.00,30000.00,31000.00,8881.25,21118.75,0.30,1
55598,5583,-1000.00,29000.00,30000.00,18883.24,12116.76,0.13,0
55599,5583,1000.00,30000.00,31000.00,9176.77,20823.23,0.25,1
55600,5584,-1000.00,-1000.00,0.00,450.83,128.31,0.12,0
55601,5585,1000.00,1000.00,2000.00,0.00,1000.00,0.40,1
55602,5585,1000.00,2000.00,3000.00,0.00,1654.21,0.40,1
55603,5585,1000.00,3000.00,4000.00,407.28,2592.72,0.43,1
55604,5585,1000.00,4000.00,5000.00,0.00,742.23,0.17,1
55605,5585,1000.00,5000.00,6000.00,0.00,4891.75,0.25,1
55606,5585,1000.00,6000.00,7000.00,2129.63,3870.37,0.31,1
55607,5585,1000.00,7000.00,8000.00,2083.68,4916.32,0.08,1
55608,5585,1000.00,8000.00,9000.00,2053.51,5946.49,0.38,1
55609,5585,1000.00,9000.00,10000.00,2727.89,5862.53,0.33,1
55610,5585,1000.00,10000.00,11000.00,0.00,42.45,0.10,1
55611,5585,1000.00,11000.00,12000.00,0.00,11000.00,0.27,1
55612,5585,1000.00,12000.00,13000.00,0.00,12000.00,0.42,1
55613,5585,1000.00,13000.00,14000.00,0.00,13000.00,0.25,1
55614,5585,1000.00,14000.00,15000.00,0.00,4860.27,0.18,1
55615,5585,1000.00,15000.00,16000.00,6478.97,8521.03,0.14,1
55616,5585,1000.00,16000.00,17000.00,0.00,1055.43,0.13,1
55617,5585,1000.00,17000.00,18000.00,0.00,17000.00,0.34,1
55618,5585,-1000.00,16000.00,17000.00,7191.67,6343.87,0.20,0
55619,5585,1000.00,17000.00,18000.00,1430.67,15569.33,0.21,1
55620,5585,1000.00,18000.00,19000.00,0.00,18000.00,0.24,1
55621,5585,1000.00,19000.00,20000.00,0.00,19000.00,0.43,1
55622,5585,-1000.00,18000.00,19000.00,12833.71,7166.29,0.06,0
55623,5585,-1000.00,17000.00,18000.00,0.00,16468.28,0.38,0
55624,5585,-1000.00,16000.00,17000.00,0.00,10302.26,0.34,0
55625,5585,-1000.00,15000.00,16000.00,0.00,17000.00,0.38,0
55626,5585,-1000.00,14000.00,15000.00,3245.14,12754.86,0.39,0
55627,5585,-1000.00,13000.00,14000.00,2794.04,12205.96,0.38,0
55628,5585,-1000.00,12000.00,13000.00,0.00,3393.77,0.10,0
55629,5585,-1000.00,11000.00,12000.00,7557.69,5442.31,0.16,0
55630,5585,-1000.00,10000.00,11000.00,4057.66,7942.34,0.11,0
55631,5585,-1000.00,9000.00,10000.00,299.95,8884.19,0.42,0
55632,5585,-1000.00,8000.00,9000.00,0.00,7645.91,0.18,0
55633,5585,-1000.00,7000.00,8000.00,0.00,9000.00,0.13,0
55634,5585,-1000.00,6000.00,7000.00,2322.84,5677.16,0.14,0
55635,5585,0.00,6000.00,7000.00,0.00,0.00,0.05,0
55636,5585,-1000.00,5000.00,6000.00,0.00,7000.00,0.00,0
55637,5585,-1000.00,4000.00,5000.00,0.00,6000.00,0.13,0
55638,5585,-1000.00,3000.00,4000.00,0.00,3427.90,0.38,0
55639,5585,-1000.00,2000.00,3000.00,0.00,3566.17,0.37,0
55640,5585,-1000.00,1000.00,2000.00,1426.41,1573.59,0.15,0
55641,5585,-1000.00,0.00,1000.00,125.34,1874.66,0.23,0
55642,5585,-1000.00,-1000.00,0.00,114.44,885.56,0.05,0
55643,5586,1000.00,1000.00,2000.00,358.12,641.88,0.17,1
55644,5586,1000.00,2000.00,3000.00,0.00,2000.00,0.23,1
55645,5586,1000.00,3000.00,4000.00,0.00,1780.73,0.33,1
55646,5586,1000.00,4000.00,5000.00,910.20,3089.80,0.39,1
55647,5586,1000.00,5000.00,6000.00,1769.49,3230.51,0.09,1
55648,5586,1000.00,6000.00,7000.00,0.00,2347.75,0.26,1
55649,5586,1000.00,7000.00,8000.00,0.00,2220.60,0.20,1
55650,5586,1000.00,8000.00,9000.00,0.00,8000.00,0.25,1
55651,5586,1000.00,9000.00,10000.00,1829.19,7170.81,0.02,1
55652,5586,-1000.00,8000.00,9000.00,3355.54,737.90,0.11,0
55653,5586,1000.00,9000.00,10000.00,0.00,8577.22,0.44,1
55654,5586,-1000.00,8000.00,9000.00,8469.27,0.00,0.02,0
55655,5586,1000.00,9000.00,10000.00,0.00,297.45,0.04,1
55656,5586,-1000.00,8000.00,9000.00,7992.14,2007.86,0.05,0
55657,5586,1000.00,9000.00,10000.00,2295.32,6704.68,0.37,1
55658,5586,-1000.00,8000.00,9000.00,4430.86,1124.06,0.11,0
55659,5586,-1000.00,7000.00,8000.00,9000.00,0.00,0.03,0
55660,5586,-1000.00,6000.00,7000.00,0.00,5379.72,0.17,0
55661,5586,-1000.00,5000.00,6000.00,2430.86,4569.14,0.34,0
55662,5586,-1000.00,4000.00,5000.00,0.00,2445.68,0.26,0
55663,5586,-1000.00,3000.00,4000.00,0.00,5000.00,0.27,0
55664,5586,-1000.00,2000.00,3000.00,265.87,3734.13,0.18,0
55665,5586,-1000.00,1000.00,2000.00,692.12,2307.88,0.39,0
55666,5586,-1000.00,0.00,1000.00,0.00,2000.00,0.27,0
55667,5586,-1000.00,-1000.00,0.00,199.10,343.33,0.23,0
55668,5587,-900.14,-900.14,99.86,369.65,530.48,0.27,0
55669,5587,-99.86,-1000.00,0.00,0.00,99.86,0.41,0
55670,5588,1000.00,1000.00,2000.00,216.07,783.93,0.39,1
55671,5588,1000.00,2000.00,3000.00,0.00,2000.00,0.30,1
55672,5588,1000.00,3000.00,4000.00,955.13,2044.87,0.33,1
55673,5588,1000.00,4000.00,5000.00,1718.08,2281.92,0.20,1
55674,5588,1000.00,5000.00,6000.00,0.00,5000.00,0.27,1
55675,5588,1000.00,6000.00,7000.00,1616.48,4383.52,0.20,1
55676,5588,1000.00,7000.00,8000.00,0.00,7000.00,0.18,1
55677,5588,1000.00,8000.00,9000.00,0.00,5120.10,0.36,1
55678,5588,1000.00,9000.00,10000.00,0.00,6322.94,0.17,1
55679,5588,1000.00,10000.00,11000.00,0.00,5870.34,0.32,1
55680,5588,-1000.00,9000.00,10000.00,2690.71,323.75,0.11,0
55681,5588,-1000.00,8000.00,9000.00,6323.66,3676.34,0.14,0
55682,5588,1000.00,9000.00,10000.00,0.00,9000.00,0.08,1
55683,5588,1000.00,10000.00,11000.00,2844.34,7155.66,0.28,1
55684,5588,1000.00,11000.00,12000.00,0.00,10848.72,0.25,1
55685,5588,1000.00,12000.00,13000.00,1294.29,10705.71,0.43,1
55686,5588,1000.00,13000.00,14000.00,3216.84,9783.16,0.38,1
55687,5588,1000.00,14000.00,15000.00,0.00,10613.71,0.39,1
55688,5588,1000.00,15000.00,16000.00,0.00,15000.00,0.01,1
55689,5588,1000.00,16000.00,17000.00,0.00,16000.00,0.30,1
55690,5588,1000.00,17000.00,18000.00,0.00,17000.00,0.13,1
55691,5588,1000.00,18000.00,19000.00,483.32,7883.23,0.28,1
55692,5588,1000.00,19000.00,20000.00,0.00,1493.70,0.14,1
55693,5588,1000.00,20000.00,21000.00,0.00,20000.00,0.31,1
55694,5588,1000.00,21000.00,22000.00,7308.13,13691.87,0.23,1
55695,5588,1000.00,22000.00,23000.00,1989.60,3900.45,0.17,1
55696,5588,1000.00,23000.00,24000.00,0.00,23000.00,0.19,1
55697,5588,-1000.00,22000.00,23000.00,24000.00,0.00,0.00,0
55698,5588,1000.00,23000.00,24000.00,0.00,23000.00,0.01,1
55699,5588,1000.00,24000.00,25000.00,3352.39,20647.61,0.25,1
55700,5588,1000.00,25000.00,26000.00,0.00,4382.60,0.16,1
55701,5588,1000.00,26000.00,27000.00,5092.48,20907.52,0.16,1
55702,5588,-1000.00,25000.00,26000.00,18177.04,8822.96,0.09,0
55703,5588,1000.00,26000.00,27000.00,0.00,26000.00,0.23,1
55704,5588,1000.00,27000.00,28000.00,0.00,13631.43,0.24,1
55705,5588,1000.00,28000.00,29000.00,2882.56,25117.44,0.27,1
55706,5588,0.00,28000.00,29000.00,0.00,0.00,0.06,0
55707,5588,1000.00,29000.00,30000.00,0.00,29000.00,0.13,1
55708,5588,1000.00,30000.00,31000.00,0.00,30000.00,0.36,1
55709,5588,1000.00,31000.00,32000.00,0.00,26234.60,0.16,1
55710,5588,1000.00,32000.00,33000.00,9131.30,22868.70,0.32,1
55711,5589,1000.00,1000.00,2000.00,0.00,1000.00,0.41,1
55712,5589,1000.00,2000.00,3000.00,361.87,1638.13,0.02,1
55713,5589,1000.00,3000.00,4000.00,0.00,3000.00,0.20,1
55714,5589,1000.00,4000.00,5000.00,0.00,4000.00,0.42,1
55715,5589,1000.00,5000.00,6000.00,644.76,4355.24,0.39,1
55716,5589,1000.00,6000.00,7000.00,937.82,5062.18,0.41,1
55717,5589,1000.00,7000.00,8000.00,0.00,5375.08,0.39,1
55718,5589,1000.00,8000.00,9000.00,0.00,5862.44,0.09,1
55719,5589,1000.00,9000.00,10000.00,2305.99,6694.01,0.23,1
55720,5589,1000.00,10000.00,11000.00,0.00,4107.57,0.22,1
55721,5589,1000.00,11000.00,12000.00,0.00,7343.66,0.28,1
55722,5589,1000.00,12000.00,13000.00,3286.02,8713.98,0.22,1
55723,5589,1000.00,13000.00,14000.00,0.00,4568.51,0.25,1
55724,5589,1000.00,14000.00,15000.00,0.00,2398.52,0.13,1
55725,5589,1000.00,15000.00,16000.00,0.00,15000.00,0.39,1
55726,5589,1000.00,16000.00,17000.00,8000.00,8000.00,0.00,1
55727,5589,1000.00,17000.00,18000.00,0.00,3951.09,0.19,1
55728,5589,1000.00,18000.00,19000.00,0.00,16709.10,0.07,1
55729,5589,1000.00,19000.00,20000.00,0.00,17571.54,0.29,1
55730,5589,1000.00,20000.00,21000.00,5082.88,14917.12,0.23,1
55731,5589,1000.00,21000.00,22000.00,0.00,21000.00,0.17,1
55732,5589,1000.00,22000.00,23000.00,0.00,22000.00,0.04,1
55733,5589,-1000.00,21000.00,22000.00,0.00,14147.74,0.35,0
55734,5589,-1000.00,20000.00,21000.00,11208.51,10129.11,0.22,0
55735,5589,-1000.00,19000.00,20000.00,0.00,4958.15,0.20,0
55736,5589,-1000.00,18000.00,19000.00,0.00,20000.00,0.39,0
55737,5589,-1000.00,17000.00,18000.00,0.00,6306.94,0.21,0
55738,5589,-1000.00,16000.00,17000.00,0.00,4916.78,0.21,0
55739,5589,-1000.00,15000.00,16000.00,0.00,12225.78,0.29,0
55740,5589,-1000.00,14000.00,15000.00,4203.98,9456.75,0.32,0
55741,5589,-1000.00,13000.00,14000.00,0.00,13294.07,0.31,0
55742,5589,-1000.00,12000.00,13000.00,0.00,14000.00,0.31,0
55743,5589,-1000.00,11000.00,12000.00,0.00,13000.00,0.05,0
55744,5589,-1000.00,10000.00,11000.00,2093.33,5347.33,0.28,0
55745,5589,-1000.00,9000.00,10000.00,3386.71,7613.29,0.08,0
55746,5589,-1000.00,8000.00,9000.00,0.00,10000.00,0.36,0
55747,5589,-1000.00,7000.00,8000.00,0.00,6049.82,0.34,0
55748,5589,-1000.00,6000.00,7000.00,0.00,8000.00,0.22,0
55749,5589,-1000.00,5000.00,6000.00,928.60,6071.40,0.42,0
55750,5589,-1000.00,4000.00,5000.00,1369.53,3087.25,0.30,0
55751,5589,-1000.00,3000.00,4000.00,1803.90,3196.10,0.23,0
55752,5589,-1000.00,2000.00,3000.00,401.70,3598.30,0.38,0
55753,5589,-1000.00,1000.00,2000.00,710.10,79.74,0.11,0
55754,5589,-1000.00,0.00,1000.00,0.00,2000.00,0.39,0
55755,5589,0.00,0.00,1000.00,0.00,0.00,0.00,0
55756,5589,1000.00,1000.00,2000.00,336.87,663.13,0.30,1
55757,5589,-1000.00,0.00,1000.00,1004.09,995.91,0.14,0
55758,5589,-554.65,-554.65,445.35,395.33,159.32,0.13,0
55759,5589,1000.00,445.35,1445.35,0.00,445.35,0.31,1
55760,5589,1000.00,1445.35,2445.35,82.66,1362.69,0.42,1
55761,5589,1000.00,2445.35,3445.35,0.00,2445.35,0.08,1
55762,5589,-1000.00,1445.35,2445.35,1198.80,0.00,0.04,0
55763,5589,1000.00,2445.35,3445.35,0.00,2445.35,0.19,1
55764,5589,1000.00,3445.35,4445.35,0.00,2266.97,0.30,1
55765,5589,1000.00,4445.35,5445.35,0.00,2523.37,0.10,1
55766,5589,1000.00,5445.35,6445.35,0.00,5445.35,0.27,1
55767,5589,1000.00,6445.35,7445.35,2499.54,3945.81,0.27,1
55768,5589,1000.00,7445.35,8445.35,0.00,7035.56,0.43,1
55769,5589,1000.00,8445.35,9445.35,2945.89,5499.46,0.04,1
55770,5589,1000.00,9445.35,10445.35,579.01,803.88,0.14,1
55771,5589,1000.00,10445.35,11445.35,0.00,1858.62,0.06,1
55772,5589,1000.00,11445.35,12445.35,0.00,11445.35,0.31,1
55773,5589,1000.00,12445.35,13445.35,4933.86,7511.49,0.29,1
55774,5589,-1000.00,11445.35,12445.35,9179.38,4265.97,0.09,0
55775,5589,1000.00,12445.35,13445.35,0.00,12445.35,0.25,1
55776,5589,1000.00,13445.35,14445.35,3720.58,9724.77,0.36,1
55777,5589,-1000.00,12445.35,13445.35,8980.74,5464.61,0.06,0
55778,5589,1000.00,13445.35,14445.35,0.00,13445.35,0.04,1
55779,5589,1000.00,14445.35,15445.35,3693.78,10751.57,0.14,1
55780,5590,-1000.00,-1000.00,0.00,455.09,544.91,0.16,0
55781,5591,1000.00,1000.00,2000.00,49.38,950.62,0.42,1
55782,5591,1000.00,2000.00,3000.00,481.97,1518.03,0.39,1
55783,5591,1000.00,3000.00,4000.00,1222.22,1777.78,0.27,1
55784,5591,1000.00,4000.00,5000.00,1800.11,2199.89,0.25,1
55785,5591,1000.00,5000.00,6000.00,685.97,4314.03,0.23,1
55786,5591,1000.00,6000.00,7000.00,0.00,3109.51,0.16,1
55787,5591,1000.00,7000.00,8000.00,669.10,6330.90,0.18,1
55788,5591,1000.00,8000.00,9000.00,2313.60,5686.40,0.35,1
55789,5591,1000.00,9000.00,10000.00,1014.39,7985.61,0.25,1
55790,5591,1000.00,10000.00,11000.00,0.00,10000.00,0.15,1
55791,5591,1000.00,11000.00,12000.00,429.26,10570.74,0.25,1
55792,5591,1000.00,12000.00,13000.00,0.00,9588.56,0.40,1
55793,5591,1000.00,13000.00,14000.00,5803.00,7197.00,0.22,1
55794,5591,1000.00,14000.00,15000.00,95.51,13904.49,0.41,1
55795,5591,1000.00,15000.00,16000.00,0.00,6588.99,0.28,1
55796,5591,1000.00,16000.00,17000.00,0.00,12402.73,0.15,1
55797,5591,1000.00,17000.00,18000.00,0.00,17000.00,0.38,1
55798,5591,-1000.00,16000.00,17000.00,0.00,18000.00,0.39,0
55799,5591,-1000.00,15000.00,16000.00,8136.94,0.00,0.06,0
55800,5591,-1000.00,14000.00,15000.00,6020.45,39.21,0.09,0
55801,5591,-1000.00,13000.00,14000.00,11163.52,3836.48,0.07,0
55802,5591,-1000.00,12000.00,13000.00,0.00,14000.00,0.09,0
55803,5591,-1000.00,11000.00,12000.00,2398.25,10601.75,0.16,0
55804,5591,-1000.00,10000.00,11000.00,592.27,7972.53,0.38,0
55805,5591,-1000.00,9000.00,10000.00,780.59,10219.41,0.21,0
55806,5591,-1000.00,8000.00,9000.00,0.00,10000.00,0.25,0
55807,5591,-1000.00,7000.00,8000.00,0.00,3258.50,0.22,0
55808,5591,-1000.00,6000.00,7000.00,6558.12,1441.88,0.04,0
55809,5591,-1000.00,5000.00,6000.00,0.00,5877.99,0.29,0
55810,5591,-1000.00,4000.00,5000.00,2603.10,3396.90,0.20,0
55811,5591,0.00,4000.00,5000.00,0.00,0.00,0.01,0
55812,5591,-1000.00,3000.00,4000.00,0.00,4358.79,0.42,0
55813,5591,0.00,3000.00,4000.00,0.00,0.00,0.06,0
55814,5591,-1000.00,2000.00,3000.00,1491.19,2508.81,0.19,0
55815,5591,-1000.00,1000.00,2000.00,1155.31,785.84,0.17,0
55816,5591,-1000.00,0.00,1000.00,0.00,1338.45,0.29,0
55817,5591,-1000.00,-1000.00,0.00,16.26,983.74,0.02,0
55818,5592,-1000.00,-1000.00,0.00,1000.00,0.00,0.04,0
55819,5593,-1000.00,-1000.00,0.00,0.00,1000.00,0.15,0
55820,5594,1000.00,1000.00,2000.00,0.00,539.07,0.31,1
55821,5594,1000.00,2000.00,3000.00,0.00,202.53,0.15,1
55822,5594,1000.00,3000.00,4000.00,0.00,2403.01,0.39,1
55823,5594,1000.00,4000.00,5000.00,598.53,3401.47,0.40,1
55824,5594,1000.00,5000.00,6000.00,0.00,5000.00,0.23,1
55825,5594,1000.00,6000.00,7000.00,0.00,6000.00,0.07,1
55826,5594,1000.00,7000.00,8000.00,0.00,3134.23,0.17,1
55827,5594,1000.00,8000.00,9000.00,0.00,4567.04,0.29,1
55828,5594,1000.00,9000.00,10000.00,3456.78,5543.22,0.29,1
55829,5594,0.00,9000.00,10000.00,0.00,0.00,0.05,0
55830,5594,1000.00,10000.00,11000.00,0.00,6072.66,0.22,1
55831,5594,1000.00,11000.00,12000.00,3372.87,7627.13,0.34,1
55832,5594,1000.00,12000.00,13000.00,2853.83,9146.17,0.39,1
55833,5594,1000.00,13000.00,14000.00,0.00,8094.99,0.36,1
55834,5594,1000.00,14000.00,15000.00,2600.23,11399.77,0.41,1
55835,5594,-1000.00,13000.00,14000.00,7510.05,7489.95,0.22,0
55836,5594,-1000.00,12000.00,13000.00,7057.61,6942.39,0.13,0
55837,5594,1000.00,13000.00,14000.00,4996.73,7238.21,0.27,1
55838,5594,0.00,13000.00,14000.00,0.00,0.00,0.02,0
55839,5594,1000.00,14000.00,15000.00,759.56,13240.44,0.42,1
55840,5594,1000.00,15000.00,16000.00,0.00,15000.00,0.37,1
55841,5595,0.00,0.00,1000.00,0.00,0.00,0.04,0
55842,5595,1000.00,1000.00,2000.00,0.00,1000.00,0.22,1
55843,5595,1000.00,2000.00,3000.00,810.33,1189.67,0.11,1
55844,5595,1000.00,3000.00,4000.00,0.00,3000.00,0.25,1
55845,5595,1000.00,4000.00,5000.00,0.00,4000.00,0.15,1
55846,5595,1000.00,5000.00,6000.00,1367.12,3632.88,0.36,1
55847,5595,1000.00,6000.00,7000.00,1981.31,4018.69,0.15,1
55848,5595,1000.00,7000.00,8000.00,0.00,6889.53,0.43,1
55849,5595,1000.00,8000.00,9000.00,0.00,8000.00,0.29,1
55850,5595,1000.00,9000.00,10000.00,0.00,4306.70,0.29,1
55851,5595,1000.00,10000.00,11000.00,0.00,6136.60,0.30,1
55852,5595,1000.00,11000.00,12000.00,0.00,11000.00,0.03,1
55853,5595,1000.00,12000.00,13000.00,0.00,11337.89,0.26,1
55854,5595,1000.00,13000.00,14000.00,6500.00,6500.00,0.06,1
55855,5595,1000.00,14000.00,15000.00,3165.39,10834.61,0.40,1
55856,5595,1000.00,15000.00,16000.00,6476.63,8523.37,0.14,1
55857,5595,1000.00,16000.00,17000.00,8000.00,8000.00,0.07,1
55858,5595,1000.00,17000.00,18000.00,5651.26,11348.74,0.33,1
55859,5595,-1000.00,16000.00,17000.00,7964.23,3033.80,0.13,0
55860,5595,1000.00,17000.00,18000.00,0.00,17000.00,0.41,1
55861,5595,-1000.00,16000.00,17000.00,0.00,18000.00,0.30,0
55862,5595,-1000.00,15000.00,16000.00,1403.17,11288.29,0.38,0
55863,5595,-1000.00,14000.00,15000.00,16000.00,0.00,0.00,0
55864,5595,-1000.00,13000.00,14000.00,3738.69,8462.26,0.31,0
55865,5595,-1000.00,12000.00,13000.00,0.00,9420.51,0.13,0
55866,5595,-1000.00,11000.00,12000.00,0.00,7983.51,0.31,0
55867,5595,-1000.00,10000.00,11000.00,3786.62,8213.38,0.03,0
55868,5595,-1000.00,9000.00,10000.00,0.00,11000.00,0.41,0
55869,5595,-1000.00,8000.00,9000.00,5000.00,5000.00,0.01,0
55870,5595,-1000.00,7000.00,8000.00,5547.43,3452.57,0.09,0
55871,5595,-1000.00,6000.00,7000.00,3933.97,4066.03,0.14,0
55872,5595,-1000.00,5000.00,6000.00,0.00,4112.36,0.29,0
55873,5595,-1000.00,4000.00,5000.00,0.00,6000.00,0.21,0
55874,5595,-1000.00,3000.00,4000.00,3478.87,1521.13,0.09,0
55875,5595,-1000.00,2000.00,3000.00,1240.14,2759.86,0.34,0
55876,5595,-1000.00,1000.00,2000.00,491.62,2508.38,0.28,0
55877,5595,-1000.00,0.00,1000.00,0.00,1210.56,0.11,0
55878,5595,-587.10,-587.10,412.90,0.00,587.10,0.12,0
55879,5595,-330.04,-917.14,82.86,0.00,330.04,0.16,0
55880,5595,-82.86,-1000.00,0.00,33.15,49.72,0.28,0
55881,5596,0.00,0.00,1000.00,0.00,0.00,0.31,0
55882,5596,1000.00,1000.00,2000.00,0.00,266.11,0.14,1
55883,5596,1000.00,2000.00,3000.00,0.00,1444.12,0.39,1
55884,5596,-1000.00,1000.00,2000.00,1845.08,0.00,0.06,0
55885,5596,1000.00,2000.00,3000.00,41.13,876.31,0.29,1
55886,5596,-1000.00,1000.00,2000.00,1109.91,0.00,0.09,0
55887,5596,1000.00,2000.00,3000.00,162.84,902.56,0.29,1
55888,5596,1000.00,3000.00,4000.00,0.00,516.63,0.10,1
55889,5596,1000.00,4000.00,5000.00,0.00,4000.00,0.42,1
55890,5596,1000.00,5000.00,6000.00,0.00,5000.00,0.37,1
55891,5596,1000.00,6000.00,7000.00,0.00,6000.00,0.08,1
55892,5596,1000.00,7000.00,8000.00,1091.72,5908.28,0.08,1
55893,5596,1000.00,8000.00,9000.00,224.93,7775.07,0.41,1
55894,5596,1000.00,9000.00,10000.00,2899.00,6101.00,0.32,1
55895,5596,-1000.00,8000.00,9000.00,4028.95,3170.51,0.18,0
55896,5596,-1000.00,7000.00,8000.00,7296.86,695.10,0.05,0
55897,5596,1000.00,8000.00,9000.00,0.00,8000.00,0.44,1
55898,5596,1000.00,9000.00,10000.00,1240.60,7759.40,0.20,1
55899,5596,-1000.00,8000.00,9000.00,10000.00,0.00,0.01,0
55900,5596,1000.00,9000.00,10000.00,4376.19,4623.81,0.20,1
55901,5596,1000.00,10000.00,11000.00,0.00,10000.00,0.03,1
55902,5596,-1000.00,9000.00,10000.00,3217.45,5397.88,0.27,0
55903,5596,-1000.00,8000.00,9000.00,4756.35,5243.65,0.03,0
55904,5596,-1000.00,7000.00,8000.00,0.00,9000.00,0.14,0
55905,5596,-1000.00,6000.00,7000.00,3308.55,1217.99,0.13,0
55906,5596,-1000.00,5000.00,6000.00,3826.26,3173.74,0.03,0
55907,5596,-1000.00,4000.00,5000.00,0.00,4757.35,0.42,0
55908,5596,-1000.00,3000.00,4000.00,0.00,3597.15,0.36,0
55909,5596,-1000.00,2000.00,3000.00,592.52,3407.48,0.39,0
55910,5596,-1000.00,1000.00,2000.00,721.05,2278.95,0.39,0
55911,5596,-1000.00,0.00,1000.00,0.00,1016.44,0.31,0
55912,5596,-951.37,-951.37,48.63,0.00,951.37,0.43,0
55913,5596,-13.14,-964.51,35.49,0.00,13.14,0.21,0
55914,5596,-1000.00,-1964.51,-964.51,6.48,0.00,0.04,0
55915,5597,1000.00,1000.00,2000.00,356.11,643.89,0.35,1
55916,5597,1000.00,2000.00,3000.00,0.00,2000.00,0.21,1
55917,5597,1000.00,3000.00,4000.00,0.00,3000.00,0.24,1
55918,5597,1000.00,4000.00,5000.00,1025.97,2974.03,0.24,1
55919,5597,-1000.00,3000.00,4000.00,1453.19,3546.81,0.33,0
55920,5597,-1000.00,2000.00,3000.00,1259.94,2740.06,0.25,0
55921,5597,-1000.00,1000.00,2000.00,0.00,1996.28,0.31,0
55922,5597,-1000.00,0.00,1000.00,0.00,2000.00,0.40,0
55923,5597,-960.75,-960.75,39.25,665.47,295.29,0.12,0
55924,5597,-1000.00,-1960.75,-960.75,0.00,39.25,0.21,0
55925,5598,-1000.00,-1000.00,0.00,0.00,1000.00,0.18,0
55926,5599,1000.00,1000.00,2000.00,261.96,0.00,0.34,1
55927,5599,0.00,1000.00,2000.00,0.00,0.00,0.13,0
55928,5599,-1000.00,0.00,1000.00,0.00,2000.00,0.32,0
55929,5599,-311.03,-311.03,688.97,0.00,311.03,0.35,0
55930,5599,-688.97,-1000.00,0.00,227.86,461.11,0.28,0
55931,5600,-1000.00,-1000.00,0.00,0.00,1000.00,0.41,0
55932,5601,1000.00,1000.00,2000.00,274.75,725.25,0.30,1
55933,5601,1000.00,2000.00,3000.00,174.89,730.41,0.25,1
55934,5601,1000.00,3000.00,4000.00,110.41,2889.59,0.08,1
55935,5601,1000.00,4000.00,5000.00,0.00,4000.00,0.17,1
55936,5601,1000.00,5000.00,6000.00,0.00,5000.00,0.10,1
55937,5601,1000.00,6000.00,7000.00,1414.60,3145.85,0.30,1
55938,5601,1000.00,7000.00,8000.00,0.00,7000.00,0.15,1
55939,5601,1000.00,8000.00,9000.00,3961.14,4038.86,0.07,1
55940,5601,1000.00,9000.00,10000.00,0.00,7680.80,0.41,1
55941,5601,1000.00,10000.00,11000.00,4783.12,5216.88,0.20,1
55942,5601,-1000.00,9000.00,10000.00,3392.08,594.43,0.11,0
55943,5601,1000.00,10000.00,11000.00,0.00,2476.38,0.10,1
55944,5601,1000.00,11000.00,12000.00,0.00,9434.28,0.20,1
55945,5601,1000.00,12000.00,13000.00,3172.03,8827.97,0.36,1
55946,5601,1000.00,13000.00,14000.00,3214.53,9785.47,0.34,1
55947,5601,1000.00,14000.00,15000.00,0.00,14000.00,0.06,1
55948,5601,1000.00,15000.00,16000.00,0.00,10958.69,0.40,1
55949,5601,-1000.00,14000.00,15000.00,9554.76,6445.24,0.14,0
55950,5601,1000.00,15000.00,16000.00,0.00,15000.00,0.30,1
55951,5601,-1000.00,14000.00,15000.00,8162.93,7837.07,0.12,0
55952,5601,1000.00,15000.00,16000.00,5092.59,9907.41,0.27,1
55953,5601,1000.00,16000.00,17000.00,0.00,7469.31,0.27,1
55954,5601,1000.00,17000.00,18000.00,0.00,14818.98,0.34,1
55955,5601,1000.00,18000.00,19000.00,0.00,18000.00,0.19,1
55956,5601,1000.00,19000.00,20000.00,0.00,19000.00,0.41,1
55957,5601,1000.00,20000.00,21000.00,0.00,20000.00,0.11,1
55958,5601,1000.00,21000.00,22000.00,0.00,21000.00,0.40,1
55959,5601,1000.00,22000.00,23000.00,0.00,2895.05,0.15,1
55960,5601,1000.00,23000.00,24000.00,0.00,23000.00,0.21,1
55961,5601,1000.00,24000.00,25000.00,4590.10,19409.90,0.33,1
55962,5601,1000.00,25000.00,26000.00,6711.47,18288.53,0.00,1
55963,5601,1000.00,26000.00,27000.00,0.00,16366.62,0.17,1
55964,5601,1000.00,27000.00,28000.00,4850.82,22149.18,0.10,1
55965,5601,1000.00,28000.00,29000.00,0.00,28000.00,0.03,1
55966,5601,-1000.00,27000.00,28000.00,20425.62,7951.61,0.11,0
55967,5601,-1000.00,26000.00,27000.00,17302.63,0.00,0.06,0
55968,5601,-1000.00,25000.00,26000.00,20447.88,0.00,0.04,0
55969,5601,1000.00,26000.00,27000.00,5730.59,6776.07,0.19,1
55970,5601,1000.00,27000.00,28000.00,153.15,8944.02,0.24,1
55971,5601,1000.00,28000.00,29000.00,4077.92,23922.08,0.37,1
55972,5601,1000.00,29000.00,30000.00,14500.00,14500.00,0.03,1
55973,5601,1000.00,30000.00,31000.00,5530.48,24469.52,0.37,1
55974,5601,-1000.00,29000.00,30000.00,18505.13,12494.87,0.11,0
55975,5601,1000.00,30000.00,31000.00,12931.81,17068.19,0.26,1
55976,5601,1000.00,31000.00,32000.00,0.00,29392.25,0.28,1
55977,5601,-1000.00,30000.00,31000.00,17637.42,14362.58,0.14,0
55978,5601,0.00,30000.00,31000.00,0.00,0.00,0.03,0
55979,5601,-1000.00,29000.00,30000.00,0.00,26980.90,0.15,0
55980,5601,-1000.00,28000.00,29000.00,0.00,30000.00,0.11,0
55981,5601,-1000.00,27000.00,28000.00,15561.17,13438.83,0.19,0
55982,5601,-1000.00,26000.00,27000.00,7434.59,19604.78,0.35,0
55983,5601,-1000.00,25000.00,26000.00,0.00,9288.71,0.05,0
55984,5601,-1000.00,24000.00,25000.00,0.00,16629.95,0.10,0
55985,5601,-1000.00,23000.00,24000.00,7848.88,17151.12,0.35,0
55986,5601,-1000.00,22000.00,23000.00,0.00,24000.00,0.39,0
55987,5601,-1000.00,21000.00,22000.00,0.00,23000.00,0.17,0
55988,5601,-1000.00,20000.00,21000.00,22000.00,0.00,0.01,0
55989,5601,-1000.00,19000.00,20000.00,3720.32,17279.68,0.41,0
55990,5601,-1000.00,18000.00,19000.00,0.00,20000.00,0.03,0
55991,5601,-1000.00,17000.00,18000.00,0.00,16454.29,0.43,0
55992,5601,-1000.00,16000.00,17000.00,8180.50,0.00,0.05,0
55993,5601,-1000.00,15000.00,16000.00,0.00,11871.58,0.30,0
55994,5601,-1000.00,14000.00,15000.00,9316.65,6683.35,0.17,0
55995,5601,-1000.00,13000.00,14000.00,5573.30,8736.43,0.29,0
55996,5601,-1000.00,12000.00,13000.00,0.00,14000.00,0.30,0
55997,5601,-1000.00,11000.00,12000.00,856.21,12143.79,0.42,0
55998,5601,-1000.00,10000.00,11000.00,2245.47,9754.53,0.40,0
55999,5601,-1000.00,9000.00,10000.00,781.32,9196.74,0.42,0
56000,5601,-1000.00,8000.00,9000.00,2741.77,7258.23,0.24,0
56001,5601,-1000.00,7000.00,8000.00,4479.49,4520.51,0.10,0
56002,5602,-97.27,-97.27,902.73,0.00,97.27,0.19,0
56003,5602,-313.32,-410.59,589.41,0.00,313.32,0.33,0
56004,5602,-589.41,-1000.00,0.00,9.60,579.81,0.44,0
56005,5603,-361.04,-361.04,638.96,0.00,361.04,0.18,0
56006,5603,-638.96,-1000.00,0.00,0.00,638.96,0.28,0
56007,5604,0.00,0.00,1000.00,0.00,0.00,0.29,0
56008,5604,-830.99,-830.99,169.01,830.99,0.00,0.17,0
56009,5604,-1000.00,-1830.99,-830.99,0.00,39.66,0.29,0
56010,5605,-603.66,-603.66,396.34,0.00,603.66,0.32,0
56011,5605,-396.34,-1000.00,0.00,135.75,260.59,0.33,0
56012,5606,-1000.00,-1000.00,0.00,0.00,230.11,0.09,0
56013,5607,-1000.00,-1000.00,0.00,0.00,1000.00,0.24,0
56014,5608,1000.00,1000.00,2000.00,0.00,1000.00,0.39,1
56015,5608,1000.00,2000.00,3000.00,431.15,586.40,0.21,1
56016,5608,1000.00,3000.00,4000.00,0.00,3000.00,0.24,1
56017,5608,1000.00,4000.00,5000.00,0.00,2052.53,0.28,1
56018,5608,1000.00,5000.00,6000.00,0.00,5000.00,0.44,1
56019,5608,-1000.00,4000.00,5000.00,3616.63,0.00,0.02,0
56020,5608,1000.00,5000.00,6000.00,2217.01,2782.99,0.26,1
56021,5608,-1000.00,4000.00,5000.00,2300.81,1934.47,0.19,0
56022,5608,1000.00,5000.00,6000.00,2172.87,2827.13,0.26,1
56023,5608,1000.00,6000.00,7000.00,876.23,5123.77,0.24,1
56024,5608,1000.00,7000.00,8000.00,0.00,7000.00,0.00,1
56025,5608,-146.37,6853.63,7853.63,146.37,0.00,0.02,0
56026,5608,1000.00,7853.63,8853.63,2735.19,5118.45,0.30,1
56027,5608,-1000.00,6853.63,7853.63,7334.98,0.00,0.02,0
56028,5608,1000.00,7853.63,8853.63,0.00,7853.63,0.05,1
56029,5608,1000.00,8853.63,9853.63,0.00,8853.63,0.11,1
56030,5608,1000.00,9853.63,10853.63,0.00,7075.48,0.07,1
56031,5608,1000.00,10853.63,11853.63,2699.06,8154.57,0.38,1
56032,5608,-1000.00,9853.63,10853.63,4345.40,7508.23,0.19,0
56033,5608,-1000.00,8853.63,9853.63,0.00,10853.63,0.07,0
56034,5608,-1000.00,7853.63,8853.63,4926.82,4926.82,0.08,0
56035,5608,-1000.00,6853.63,7853.63,0.00,8853.63,0.41,0
56036,5608,-1000.00,5853.63,6853.63,0.00,3425.13,0.29,0
56037,5608,1000.00,6853.63,7853.63,2462.72,4390.91,0.19,1
56038,5608,1000.00,7853.63,8853.63,0.00,7853.63,0.02,1
56039,5608,1000.00,8853.63,9853.63,745.75,8107.88,0.35,1
56040,5608,1000.00,9853.63,10853.63,0.00,9853.63,0.17,1
56041,5608,1000.00,10853.63,11853.63,0.00,7690.65,0.15,1
56042,5608,1000.00,11853.63,12853.63,0.00,11853.63,0.28,1
56043,5608,1000.00,12853.63,13853.63,1963.44,10890.20,0.20,1
56044,5608,-1000.00,11853.63,12853.63,3273.64,2697.33,0.17,0
56045,5608,1000.00,12853.63,13853.63,0.00,7468.02,0.20,1
56046,5608,1000.00,13853.63,14853.63,0.00,13853.63,0.04,1
56047,5608,1000.00,14853.63,15853.63,5445.61,9408.02,0.30,1
56048,5608,1000.00,15853.63,16853.63,0.00,14783.71,0.04,1
56049,5608,1000.00,16853.63,17853.63,57.46,16796.17,0.31,1
56050,5608,1000.00,17853.63,18853.63,0.00,62.72,0.09,1
56051,5608,1000.00,18853.63,19853.63,0.00,16374.09,0.41,1
56052,5608,1000.00,19853.63,20853.63,751.28,12527.07,0.37,1
56053,5608,1000.00,20853.63,21853.63,0.00,13179.47,0.33,1
56054,5608,1000.00,21853.63,22853.63,1102.93,9899.99,0.29,1
56055,5608,1000.00,22853.63,23853.63,10888.92,11964.71,0.22,1
56056,5608,0.00,22853.63,23853.63,0.00,0.00,0.02,0
56057,5608,1000.00,23853.63,24853.63,0.00,23853.63,0.41,1
56058,5608,-1000.00,22853.63,23853.63,20085.20,4768.43,0.00,0
56059,5608,1000.00,23853.63,24853.63,0.00,22589.70,0.16,1
56060,5608,1000.00,24853.63,25853.63,4545.47,20308.16,0.38,1
56061,5609,-969.21,-969.21,30.79,325.16,644.05,0.38,0
56062,5609,-30.79,-1000.00,0.00,0.00,30.79,0.37,0
56063,5610,0.00,0.00,1000.00,0.00,0.00,0.41,0
56064,5610,-1000.00,-1000.00,0.00,0.00,1000.00,0.08,0
56065,5611,-1000.00,-1000.00,0.00,112.92,887.08,0.14,0
56066,5612,0.00,0.00,1000.00,0.00,0.00,0.38,0
56067,5612,-720.03,-720.03,279.97,720.03,0.00,0.08,0
56068,5612,-279.97,-1000.00,0.00,179.53,100.44,0.04,0
56069,5613,1000.00,1000.00,2000.00,0.00,1000.00,0.16,1
56070,5613,1000.00,2000.00,3000.00,615.11,1384.89,0.30,1
56071,5613,1000.00,3000.00,4000.00,0.00,2409.07,0.13,1
56072,5613,-1000.00,2000.00,3000.00,3470.27,0.00,0.01,0
56073,5613,1000.00,3000.00,4000.00,1340.60,1659.40,0.19,1
56074,5613,1000.00,4000.00,5000.00,0.00,4000.00,0.31,1
56075,5613,1000.00,5000.00,6000.00,800.70,4199.30,0.38,1
56076,5613,1000.00,6000.00,7000.00,1743.59,2762.63,0.26,1
56077,5613,1000.00,7000.00,8000.00,0.00,1774.80,0.19,1
56078,5613,1000.00,8000.00,9000.00,7.12,7992.88,0.33,1
56079,5613,1000.00,9000.00,10000.00,0.00,9000.00,0.07,1
56080,5613,1000.00,10000.00,11000.00,0.00,10000.00,0.37,1
56081,5613,1000.00,11000.00,12000.00,5500.00,5500.00,0.10,1
56082,5613,1000.00,12000.00,13000.00,0.00,9637.26,0.30,1
56083,5613,1000.00,13000.00,14000.00,0.00,13000.00,0.34,1
56084,5613,1000.00,14000.00,15000.00,0.00,14000.00,0.22,1
56085,5613,1000.00,15000.00,16000.00,613.42,10396.90,0.39,1
56086,5613,1000.00,16000.00,17000.00,6402.40,9597.60,0.05,1
56087,5613,1000.00,17000.00,18000.00,284.95,6056.15,0.25,1
56088,5613,1000.00,18000.00,19000.00,0.00,18000.00,0.40,1
56089,5613,1000.00,19000.00,20000.00,6418.16,12581.84,0.20,1
56090,5613,1000.00,20000.00,21000.00,9001.94,10998.06,0.16,1
56091,5613,-1000.00,19000.00,20000.00,10577.72,10422.28,0.08,0
56092,5613,-1000.00,18000.00,19000.00,4471.70,15528.30,0.40,0
56093,5613,-1000.00,17000.00,18000.00,4275.72,0.00,0.02,0
56094,5613,-1000.00,16000.00,17000.00,0.00,7522.11,0.14,0
56095,5613,-1000.00,15000.00,16000.00,4167.06,12832.94,0.32,0
56096,5613,-1000.00,14000.00,15000.00,3409.91,12590.09,0.40,0
56097,5613,-1000.00,13000.00,14000.00,0.00,15000.00,0.44,0
56098,5613,-1000.00,12000.00,13000.00,0.00,12837.10,0.23,0
56099,5613,-1000.00,11000.00,12000.00,5546.57,7453.43,0.17,0
56100,5613,-1000.00,10000.00,11000.00,0.00,12000.00,0.24,0
56101,5613,-1000.00,9000.00,10000.00,1412.21,9587.79,0.43,0
56102,5613,-1000.00,8000.00,9000.00,1379.70,8620.30,0.41,0
56103,5613,-1000.00,7000.00,8000.00,0.00,7690.60,0.10,0
56104,5613,-1000.00,6000.00,7000.00,0.00,8000.00,0.34,0
56105,5613,-1000.00,5000.00,6000.00,0.00,7000.00,0.06,0
56106,5613,-1000.00,4000.00,5000.00,0.00,6000.00,0.09,0
56107,5613,-1000.00,3000.00,4000.00,0.00,5000.00,0.12,0
56108,5613,-1000.00,2000.00,3000.00,3127.61,872.39,0.01,0
56109,5613,-1000.00,1000.00,2000.00,1556.19,1443.81,0.18,0
56110,5613,-1000.00,0.00,1000.00,892.03,1107.97,0.25,0
56111,5613,-983.67,-983.67,16.33,0.00,983.67,0.05,0
56112,5613,-10.70,-994.37,5.63,0.00,10.70,0.37,0
56113,5613,-308.97,-1303.34,-303.34,1.82,0.00,0.07,0
56114,5614,-1000.00,-1000.00,0.00,0.00,991.30,0.15,0
56115,5615,-10.36,-10.36,989.64,0.00,10.36,0.32,0
56116,5615,1000.00,989.64,1989.64,407.69,0.00,0.35,1
56117,5615,1000.00,1989.64,2989.64,50.35,0.00,0.31,1
56118,5615,-1000.00,989.64,1989.64,697.44,1285.63,0.32,0
56119,5615,1000.00,1989.64,2989.64,611.04,311.25,0.38,1
56120,5615,-1000.00,989.64,1989.64,0.00,2989.64,0.08,0
56121,5615,-1000.00,-10.36,989.64,0.00,1929.75,0.40,0
56122,5615,-989.64,-1000.00,0.00,383.13,606.52,0.04,0
56123,5616,-1000.00,-1000.00,0.00,315.78,684.22,0.15,0
56124,5617,1000.00,1000.00,2000.00,151.17,848.83,0.32,1
56125,5617,1000.00,2000.00,3000.00,0.00,2000.00,0.18,1
56126,5617,-1000.00,1000.00,2000.00,1360.68,986.07,0.18,0
56127,5617,1000.00,2000.00,3000.00,0.00,1596.17,0.41,1
56128,5617,1000.00,3000.00,4000.00,0.00,3000.00,0.22,1
56129,5617,1000.00,4000.00,5000.00,1843.13,2156.87,0.15,1
56130,5617,-1000.00,3000.00,4000.00,3374.40,1625.60,0.12,0
56131,5617,1000.00,4000.00,5000.00,956.35,3043.65,0.28,1
56132,5617,1000.00,5000.00,6000.00,1530.66,3469.34,0.35,1
56133,5617,1000.00,6000.00,7000.00,2378.75,3621.25,0.18,1
56134,5617,1000.00,7000.00,8000.00,0.00,7000.00,0.21,1
56135,5617,1000.00,8000.00,9000.00,0.00,6269.01,0.22,1
56136,5617,1000.00,9000.00,10000.00,2778.15,6221.85,0.22,1
56137,5617,-1000.00,8000.00,9000.00,6914.07,1539.38,0.08,0
56138,5617,0.00,8000.00,9000.00,0.00,0.00,0.08,0
56139,5617,1000.00,9000.00,10000.00,0.00,9000.00,0.25,1
56140,5617,1000.00,10000.00,11000.00,0.00,9363.21,0.39,1
56141,5617,1000.00,11000.00,12000.00,2905.08,8094.92,0.35,1
56142,5617,1000.00,12000.00,13000.00,0.00,12000.00,0.15,1
56143,5617,1000.00,13000.00,14000.00,4383.22,8616.78,0.27,1
56144,5617,1000.00,14000.00,15000.00,3621.79,10378.21,0.37,1
56145,5617,1000.00,15000.00,16000.00,0.00,15000.00,0.18,1
56146,5617,1000.00,16000.00,17000.00,0.00,15037.55,0.25,1
56147,5617,-1000.00,15000.00,16000.00,14190.79,1756.32,0.05,0
56148,5617,-1000.00,14000.00,15000.00,10758.51,5241.49,0.09,0
56149,5617,1000.00,15000.00,16000.00,0.00,15000.00,0.05,1
56150,5617,1000.00,16000.00,17000.00,0.00,16000.00,0.39,1
56151,5617,1000.00,17000.00,18000.00,0.00,17000.00,0.02,1
56152,5617,-1000.00,16000.00,17000.00,12844.93,173.73,0.06,0
56153,5617,1000.00,17000.00,18000.00,0.00,17000.00,0.05,1
56154,5617,1000.00,18000.00,19000.00,5709.87,12290.13,0.32,1
56155,5617,1000.00,19000.00,20000.00,2630.17,16369.83,0.35,1
56156,5617,1000.00,20000.00,21000.00,10000.00,10000.00,0.05,1
56157,5617,1000.00,21000.00,22000.00,0.00,14689.31,0.27,1
56158,5617,1000.00,22000.00,23000.00,11000.00,11000.00,0.08,1
56159,5617,1000.00,23000.00,24000.00,0.00,23000.00,0.20,1
56160,5617,1000.00,24000.00,25000.00,9133.71,14866.29,0.12,1
56161,5617,1000.00,25000.00,26000.00,0.00,22284.62,0.42,1
56162,5617,1000.00,26000.00,27000.00,0.00,15983.20,0.32,1
56163,5617,-1000.00,25000.00,26000.00,1930.90,0.00,0.07,0
56164,5617,1000.00,26000.00,27000.00,5580.04,20419.96,0.40,1
56165,5618,-1000.00,-1000.00,0.00,0.00,1000.00,0.26,0
56166,5619,-1000.00,-1000.00,0.00,0.00,1000.00,0.08,0
56167,5620,-1000.00,-1000.00,0.00,460.12,539.88,0.16,0
56168,5620,-0.00,-1000.00,0.00,0.00,0.00,0.25,0
56169,5620,-0.00,-1000.00,-0.00,0.00,0.00,0.07,0
56170,5621,1000.00,1000.00,2000.00,127.81,347.56,0.24,1
56171,5621,1000.00,2000.00,3000.00,0.00,750.29,0.01,1
56172,5621,1000.00,3000.00,4000.00,879.35,2120.65,0.35,1
56173,5621,1000.00,4000.00,5000.00,0.00,3465.30,0.23,1
56174,5621,1000.00,5000.00,6000.00,81.12,716.89,0.16,1
56175,5621,1000.00,6000.00,7000.00,2551.56,3448.44,0.13,1
56176,5621,1000.00,7000.00,8000.00,0.00,7000.00,0.03,1
56177,5621,1000.00,8000.00,9000.00,0.00,8000.00,0.16,1
56178,5621,1000.00,9000.00,10000.00,2557.99,6442.01,0.31,1
56179,5621,1000.00,10000.00,11000.00,0.00,8190.08,0.10,1
56180,5621,1000.00,11000.00,12000.00,0.00,11000.00,0.13,1
56181,5621,1000.00,12000.00,13000.00,0.00,11362.11,0.26,1
56182,5621,1000.00,13000.00,14000.00,0.00,13000.00,0.33,1
56183,5621,1000.00,14000.00,15000.00,0.00,10143.38,0.31,1
56184,5621,1000.00,15000.00,16000.00,4994.15,10005.85,0.23,1
56185,5621,1000.00,16000.00,17000.00,6876.39,9123.61,0.18,1
56186,5621,1000.00,17000.00,18000.00,0.00,7049.86,0.04,1
56187,5621,1000.00,18000.00,19000.00,0.00,18000.00,0.09,1
56188,5621,1000.00,19000.00,20000.00,2709.87,3074.74,0.16,1
56189,5621,1000.00,20000.00,21000.00,0.00,15974.37,0.29,1
56190,5621,1000.00,21000.00,22000.00,1350.73,19649.27,0.44,1
56191,5621,1000.00,22000.00,23000.00,0.00,11757.86,0.01,1
56192,5621,-1000.00,21000.00,22000.00,0.00,23000.00,0.24,0
56193,5621,-1000.00,20000.00,21000.00,0.00,13742.28,0.13,0
56194,5621,-1000.00,19000.00,20000.00,0.00,18929.33,0.44,0
56195,5621,-1000.00,18000.00,19000.00,0.00,19651.81,0.30,0
56196,5621,-1000.00,17000.00,18000.00,1785.75,6829.54,0.25,0
56197,5621,-1000.00,16000.00,17000.00,4906.46,9371.64,0.29,0
56198,5621,-1000.00,15000.00,16000.00,8500.00,8500.00,0.03,0
56199,5621,-1000.00,14000.00,15000.00,0.00,10882.42,0.06,0
56200,5621,-1000.00,13000.00,14000.00,0.00,13186.95,0.29,0
56201,5621,-1000.00,12000.00,13000.00,0.00,7127.40,0.13,0
56202,5621,-1000.00,11000.00,12000.00,12161.56,838.44,0.03,0
56203,5621,-1000.00,10000.00,11000.00,0.00,12000.00,0.43,0
56204,5621,-1000.00,9000.00,10000.00,2428.49,8571.51,0.38,0
56205,5621,0.00,9000.00,10000.00,0.00,0.00,0.06,0
56206,5621,-1000.00,8000.00,9000.00,0.00,10000.00,0.10,0
56207,5621,-1000.00,7000.00,8000.00,0.00,6300.72,0.21,0
56208,5621,-1000.00,6000.00,7000.00,1425.09,6574.91,0.36,0
56209,5621,-1000.00,5000.00,6000.00,0.00,2161.44,0.22,0
56210,5621,-1000.00,4000.00,5000.00,0.00,6000.00,0.30,0
56211,5621,-1000.00,3000.00,4000.00,0.00,5000.00,0.31,0
56212,5621,-1000.00,2000.00,3000.00,0.00,4000.00,0.14,0
56213,5621,-1000.00,1000.00,2000.00,524.04,2475.96,0.40,0
56214,5621,0.00,1000.00,2000.00,0.00,0.00,0.07,0
56215,5621,-1000.00,0.00,1000.00,156.23,1843.77,0.18,0
56216,5622,-1000.00,-1000.00,0.00,162.00,838.00,0.18,0
56217,5623,-1000.00,-1000.00,0.00,414.37,585.63,0.17,0
56218,5624,-1000.00,-1000.00,0.00,500.00,500.00,0.01,0
56219,5625,1000.00,1000.00,2000.00,152.01,847.99,0.42,1
56220,5625,1000.00,2000.00,3000.00,949.53,1050.47,0.14,1
56221,5625,1000.00,3000.00,4000.00,270.21,2016.79,0.38,1
56222,5625,-1000.00,2000.00,3000.00,1571.21,0.00,0.07,0
56223,5625,1000.00,3000.00,4000.00,0.00,3000.00,0.24,1
56224,5625,1000.00,4000.00,5000.00,0.00,4000.00,0.37,1
56225,5625,1000.00,5000.00,6000.00,406.32,4593.68,0.39,1
56226,5625,1000.00,6000.00,7000.00,2787.94,3212.06,0.02,1
56227,5625,-1000.00,5000.00,6000.00,4274.14,2725.86,0.01,0
56228,5625,1000.00,6000.00,7000.00,0.00,5851.93,0.31,1
56229,5625,-1000.00,5000.00,6000.00,3800.14,3199.86,0.19,0
56230,5625,1000.00,6000.00,7000.00,0.00,6000.00,0.26,1
56231,5625,1000.00,7000.00,8000.00,2761.35,3347.54,0.24,1
56232,5625,1000.00,8000.00,9000.00,0.00,268.58,0.07,1
56233,5625,1000.00,9000.00,10000.00,4387.36,4612.64,0.15,1
56234,5625,-1000.00,8000.00,9000.00,538.05,466.79,0.12,0
56235,5625,-1000.00,7000.00,8000.00,5929.53,3070.47,0.09,0
56236,5625,1000.00,8000.00,9000.00,0.00,8000.00,0.30,1
56237,5625,1000.00,9000.00,10000.00,2168.46,6831.54,0.38,1
56238,5625,1000.00,10000.00,11000.00,0.00,10000.00,0.17,1
56239,5625,1000.00,11000.00,12000.00,2823.91,8176.09,0.34,1
56240,5625,1000.00,12000.00,13000.00,0.00,12000.00,0.05,1
56241,5625,1000.00,13000.00,14000.00,0.00,6610.01,0.13,1
56242,5625,1000.00,14000.00,15000.00,0.00,14000.00,0.24,1
56243,5625,1000.00,15000.00,16000.00,0.00,15000.00,0.32,1
56244,5625,1000.00,16000.00,17000.00,0.00,10910.10,0.16,1
56245,5625,1000.00,17000.00,18000.00,0.00,15883.33,0.40,1
56246,5625,1000.00,18000.00,19000.00,0.00,10601.96,0.34,1
56247,5625,1000.00,19000.00,20000.00,4769.55,14230.45,0.27,1
56248,5625,1000.00,20000.00,21000.00,3927.42,16072.58,0.28,1
56249,5625,1000.00,21000.00,22000.00,7381.42,13618.58,0.32,1
56250,5625,1000.00,22000.00,23000.00,0.00,22000.00,0.30,1
56251,5625,1000.00,23000.00,24000.00,9668.83,13331.17,0.17,1
56252,5625,-1000.00,22000.00,23000.00,8805.93,2018.92,0.11,0
56253,5625,1000.00,23000.00,24000.00,4451.33,18548.67,0.40,1
56254,5625,1000.00,24000.00,25000.00,0.00,4913.04,0.13,1
56255,5625,1000.00,25000.00,26000.00,0.00,21968.84,0.43,1
56256,5625,1000.00,26000.00,27000.00,4488.17,21511.83,0.13,1
56257,5625,1000.00,27000.00,28000.00,0.00,27000.00,0.25,1
56258,5625,0.00,27000.00,28000.00,0.00,0.00,0.04,0
56259,5626,1000.00,1000.00,2000.00,0.00,1000.00,0.12,1
56260,5626,1000.00,2000.00,3000.00,0.00,1096.89,0.06,1
56261,5626,1000.00,3000.00,4000.00,0.00,2530.67,0.37,1
56262,5626,1000.00,4000.00,5000.00,1659.60,2340.40,0.26,1
56263,5626,1000.00,5000.00,6000.00,0.00,5000.00,0.24,1
56264,5626,1000.00,6000.00,7000.00,0.00,1879.97,0.22,1
56265,5626,1000.00,7000.00,8000.00,0.00,7000.00,0.11,1
56266,5626,-1000.00,6000.00,7000.00,4765.33,3234.67,0.16,0
56267,5626,1000.00,7000.00,8000.00,3065.91,3934.09,0.11,1
56268,5626,1000.00,8000.00,9000.00,0.00,8000.00,0.26,1
56269,5626,1000.00,9000.00,10000.00,4160.99,4839.01,0.16,1
56270,5626,1000.00,10000.00,11000.00,0.00,10000.00,0.38,1
56271,5626,1000.00,11000.00,12000.00,0.00,11000.00,0.14,1
56272,5626,1000.00,12000.00,13000.00,4563.02,7436.98,0.30,1
56273,5626,1000.00,13000.00,14000.00,0.00,13000.00,0.16,1
56274,5626,-1000.00,12000.00,13000.00,11320.23,1.68,0.04,0
56275,5626,-1000.00,11000.00,12000.00,4667.80,0.00,0.07,0
56276,5626,1000.00,12000.00,13000.00,5209.02,6790.98,0.10,1
56277,5626,-1000.00,11000.00,12000.00,0.00,2088.52,0.08,0
56278,5626,-1000.00,10000.00,11000.00,7457.39,4542.61,0.22,0
56279,5626,-1000.00,9000.00,10000.00,505.31,0.00,0.08,0
56280,5626,-1000.00,8000.00,9000.00,0.00,10000.00,0.27,0
56281,5626,-1000.00,7000.00,8000.00,781.46,0.00,0.08,0
56282,5626,-1000.00,6000.00,7000.00,3755.10,4244.90,0.10,0
56283,5626,-1000.00,5000.00,6000.00,0.00,7000.00,0.32,0
56284,5626,-1000.00,4000.00,5000.00,0.00,2661.20,0.28,0
56285,5626,-1000.00,3000.00,4000.00,0.00,4764.75,0.26,0
56286,5626,-1000.00,2000.00,3000.00,1913.92,2086.08,0.23,0
56287,5626,-1000.00,1000.00,2000.00,660.71,2339.29,0.40,0
56288,5626,0.00,1000.00,2000.00,0.00,0.00,0.00,0
56289,5626,-1000.00,0.00,1000.00,0.00,2000.00,0.14,0
56290,5626,-1000.00,-1000.00,0.00,221.42,778.58,0.20,0
56291,5627,1000.00,1000.00,2000.00,163.52,0.00,0.24,1
56292,5627,1000.00,2000.00,3000.00,405.05,0.00,0.17,1
56293,5627,-1000.00,1000.00,2000.00,0.00,3000.00,0.02,0
56294,5627,-1000.00,0.00,1000.00,0.00,2000.00,0.02,0
56295,5627,0.00,0.00,1000.00,0.00,0.00,0.07,0
56296,5627,-672.29,-672.29,327.71,0.00,672.29,0.10,0
56297,5627,1000.00,327.71,1327.71,287.15,40.56,0.09,1
56298,5627,-1000.00,-672.29,327.71,0.00,1327.71,0.16,0
56299,5627,-301.71,-974.01,25.99,0.00,301.71,0.09,0
56300,5627,-4.88,-978.89,21.11,0.00,4.88,0.32,0
56301,5627,-20.27,-999.16,0.84,0.00,20.27,0.27,0
56302,5627,-0.65,-999.81,0.19,0.00,0.65,0.19,0
56303,5627,-0.19,-1000.00,0.00,0.00,0.19,0.31,0
56304,5628,-166.36,-166.36,833.64,0.00,166.36,0.33,0
56305,5628,1000.00,833.64,1833.64,275.90,0.00,0.38,1
56306,5628,-652.61,181.03,1181.03,0.00,652.61,0.35,0
56307,5628,0.00,181.03,1181.03,0.00,0.00,0.41,0
56308,5628,-1000.00,-818.97,181.03,0.00,1181.03,0.10,0
56309,5628,-181.03,-1000.00,0.00,88.23,92.80,0.07,0
56310,5629,-580.61,-580.61,419.39,462.70,117.91,0.32,0
56311,5629,-310.61,-891.22,108.78,310.61,0.00,0.03,0
56312,5629,-1000.00,-1891.22,-891.22,0.00,108.78,0.30,0
56313,5630,1000.00,1000.00,2000.00,0.00,412.34,0.26,1
56314,5630,1000.00,2000.00,3000.00,822.09,1177.91,0.15,1
56315,5630,1000.00,3000.00,4000.00,905.30,2094.70,0.24,1
56316,5630,-1000.00,2000.00,3000.00,2110.99,1018.51,0.14,0
56317,5630,-1000.00,1000.00,2000.00,1534.79,1465.21,0.05,0
56318,5630,1000.00,2000.00,3000.00,0.00,2000.00,0.34,1
56319,5630,1000.00,3000.00,4000.00,0.00,3000.00,0.25,1
56320,5630,1000.00,4000.00,5000.00,150.60,888.31,0.19,1
56321,5630,-1000.00,3000.00,4000.00,2786.05,2213.95,0.08,0
56322,5630,1000.00,4000.00,5000.00,1919.16,2080.84,0.11,1
56323,5630,1000.00,5000.00,6000.00,1991.03,3008.97,0.29,1
56324,5630,1000.00,6000.00,7000.00,1567.72,4432.28,0.23,1
56325,5630,1000.00,7000.00,8000.00,0.00,7000.00,0.36,1
56326,5630,-1000.00,6000.00,7000.00,8000.00,0.00,0.01,0
56327,5630,1000.00,7000.00,8000.00,0.00,322.30,0.12,1
56328,5630,1000.00,8000.00,9000.00,0.00,8000.00,0.17,1
56329,5630,1000.00,9000.00,10000.00,267.68,8732.32,0.44,1
56330,5630,1000.00,10000.00,11000.00,0.00,9339.05,0.24,1
56331,5630,1000.00,11000.00,12000.00,0.00,10710.27,0.42,1
56332,5630,1000.00,12000.00,13000.00,0.00,595.43,0.07,1
56333,5630,1000.00,13000.00,14000.00,6358.22,6641.78,0.21,1
56334,5630,1000.00,14000.00,15000.00,4991.99,7414.98,0.27,1
56335,5630,-1000.00,13000.00,14000.00,9748.27,5251.73,0.03,0
56336,5630,1000.00,14000.00,15000.00,0.00,14000.00,0.20,1
56337,5630,1000.00,15000.00,16000.00,4523.47,10476.53,0.34,1
56338,5630,1000.00,16000.00,17000.00,7962.08,8037.92,0.01,1
56339,5630,1000.00,17000.00,18000.00,0.00,13630.10,0.39,1
56340,5630,-1000.00,16000.00,17000.00,3238.54,0.00,0.09,0
56341,5630,1000.00,17000.00,18000.00,0.00,6025.18,0.21,1
56342,5630,-1000.00,16000.00,17000.00,13431.33,4568.67,0.07,0
56343,5630,1000.00,17000.00,18000.00,7044.60,9955.40,0.05,1
56344,5630,-1000.00,16000.00,17000.00,4934.47,808.79,0.11,0
56345,5630,1000.00,17000.00,18000.00,3171.92,13828.08,0.33,1
56346,5630,1000.00,18000.00,19000.00,1529.52,12064.81,0.38,1
56347,5630,1000.00,19000.00,20000.00,0.00,9629.50,0.13,1
56348,5630,1000.00,20000.00,21000.00,0.00,12598.40,0.21,1
56349,5630,-1000.00,19000.00,20000.00,12920.48,8079.52,0.01,0
56350,5630,1000.00,20000.00,21000.00,560.95,17248.93,0.43,1
56351,5630,1000.00,21000.00,22000.00,10500.00,10500.00,0.05,1
56352,5630,1000.00,22000.00,23000.00,0.00,20476.35,0.30,1
56353,5630,1000.00,23000.00,24000.00,3491.97,18953.37,0.41,1
56354,5630,1000.00,24000.00,25000.00,0.00,21938.40,0.18,1
56355,5630,1000.00,25000.00,26000.00,0.00,8949.77,0.15,1
56356,5630,1000.00,26000.00,27000.00,2252.46,23747.54,0.31,1
56357,5630,1000.00,27000.00,28000.00,9863.19,17136.81,0.26,1
56358,5630,1000.00,28000.00,29000.00,3425.79,16679.29,0.35,1
56359,5631,1000.00,1000.00,2000.00,745.71,0.00,0.13,1
56360,5631,1000.00,2000.00,3000.00,1996.92,0.00,0.08,1
56361,5631,-1000.00,1000.00,2000.00,1356.51,1643.49,0.17,0
56362,5631,1000.00,2000.00,3000.00,1266.30,733.70,0.04,1
56363,5631,1000.00,3000.00,4000.00,1137.95,0.00,0.27,1
56364,5631,1000.00,4000.00,5000.00,2979.55,768.15,0.08,1
56365,5631,0.00,4000.00,5000.00,0.00,0.00,0.11,0
56366,5631,-1000.00,3000.00,4000.00,2163.68,2711.18,0.25,0
56367,5631,-1000.00,2000.00,3000.00,1241.31,2758.69,0.16,0
56368,5631,-1000.00,1000.00,2000.00,381.20,2618.80,0.32,0
56369,5631,-1000.00,0.00,1000.00,0.00,2000.00,0.18,0
56370,5631,-210.45,-210.45,789.55,0.00,210.45,0.14,0
56371,5631,-638.74,-849.19,150.81,0.00,638.74,0.34,0
56372,5631,-150.81,-1000.00,0.00,0.00,150.81,0.04,0
56373,5632,-1000.00,-1000.00,0.00,302.21,697.79,0.34,0
56374,5633,-421.55,-421.55,578.45,0.00,421.55,0.34,0
56375,5633,-578.45,-1000.00,0.00,287.20,291.24,0.13,0
56376,5634,-719.56,-719.56,280.44,172.59,546.96,0.34,0
56377,5634,0.00,-719.56,280.44,0.00,0.00,0.14,0
56378,5634,-280.44,-1000.00,0.00,0.00,280.44,0.07,0
56379,5635,-804.65,-804.65,195.35,0.00,804.65,0.17,0
56380,5635,-180.04,-984.69,15.31,0.00,180.04,0.44,0
56381,5635,-15.31,-1000.00,0.00,6.04,9.27,0.24,0
56382,5636,1000.00,1000.00,2000.00,14.39,0.00,0.29,1
56383,5636,-1000.00,0.00,1000.00,0.00,1290.64,0.22,0
56384,5636,-1000.00,-1000.00,0.00,0.00,1000.00,0.01,0
56385,5637,-448.93,-448.93,551.07,364.88,84.05,0.36,0
56386,5637,-69.81,-518.74,481.26,38.34,31.47,0.44,0
56387,5637,-1000.00,-1518.74,-518.74,165.29,315.97,0.09,0
56388,5638,-1000.00,-1000.00,0.00,0.00,1000.00,0.19,0
56389,5639,-1000.00,-1000.00,0.00,50.80,949.20,0.44,0
56390,5640,-1000.00,-1000.00,0.00,385.99,614.01,0.26,0
56391,5641,1000.00,1000.00,2000.00,0.00,1000.00,0.14,1
56392,5641,1000.00,2000.00,3000.00,0.00,839.99,0.19,1
56393,5641,1000.00,3000.00,4000.00,600.42,1836.19,0.34,1
56394,5641,1000.00,4000.00,5000.00,526.95,3473.05,0.43,1
56395,5641,1000.00,5000.00,6000.00,761.19,4229.53,0.41,1
56396,5641,-1000.00,4000.00,5000.00,4299.22,1700.78,0.02,0
56397,5641,1000.00,5000.00,6000.00,0.00,2713.39,0.33,1
56398,5641,1000.00,6000.00,7000.00,2468.80,3531.20,0.22,1
56399,5641,1000.00,7000.00,8000.00,3255.53,3744.47,0.05,1
56400,5641,1000.00,8000.00,9000.00,0.00,1469.49,0.17,1
56401,5641,1000.00,9000.00,10000.00,0.00,9000.00,0.29,1
56402,5641,1000.00,10000.00,11000.00,4264.58,5735.42,0.20,1
56403,5641,-1000.00,9000.00,10000.00,5971.88,5028.12,0.13,0
56404,5641,1000.00,10000.00,11000.00,0.00,3505.52,0.23,1
56405,5641,1000.00,11000.00,12000.00,0.00,5398.63,0.26,1
56406,5641,1000.00,12000.00,13000.00,0.00,12000.00,0.19,1
56407,5641,1000.00,13000.00,14000.00,0.00,13000.00,0.35,1
56408,5641,1000.00,14000.00,15000.00,0.00,10972.29,0.41,1
56409,5641,1000.00,15000.00,16000.00,0.00,3308.68,0.18,1
56410,5641,1000.00,16000.00,17000.00,0.00,16000.00,0.02,1
56411,5641,1000.00,17000.00,18000.00,0.00,17000.00,0.33,1
56412,5641,-1000.00,16000.00,17000.00,5071.67,2475.98,0.14,0
56413,5641,1000.00,17000.00,18000.00,0.00,4433.29,0.21,1
56414,5641,1000.00,18000.00,19000.00,0.00,15805.70,0.33,1
56415,5641,-1000.00,17000.00,18000.00,0.00,14284.12,0.37,0
56416,5641,-1000.00,16000.00,17000.00,0.00,18000.00,0.30,0
56417,5641,-1000.00,15000.00,16000.00,200.20,16799.80,0.14,0
56418,5641,-1000.00,14000.00,15000.00,686.46,10611.40,0.38,0
56419,5641,-1000.00,13000.00,14000.00,10315.56,4684.44,0.08,0
56420,5641,-1000.00,12000.00,13000.00,0.00,8259.53,0.18,0
56421,5641,-1000.00,11000.00,12000.00,6500.00,6500.00,0.08,0
56422,5641,-1000.00,10000.00,11000.00,0.00,6448.95,0.27,0
56423,5641,-1000.00,9000.00,10000.00,2531.75,8468.25,0.39,0
56424,5641,-1000.00,8000.00,9000.00,2679.91,5009.81,0.28,0
56425,5641,-1000.00,7000.00,8000.00,1141.73,7858.27,0.12,0
56426,5641,-1000.00,6000.00,7000.00,1995.33,6004.67,0.37,0
56427,5641,-1000.00,5000.00,6000.00,0.00,3141.12,0.28,0
56428,5641,-1000.00,4000.00,5000.00,0.00,3807.55,0.01,0
56429,5641,-1000.00,3000.00,4000.00,1338.66,2372.47,0.27,0
56430,5641,-1000.00,2000.00,3000.00,0.00,4000.00,0.42,0
56431,5641,-1000.00,1000.00,2000.00,0.00,3000.00,0.10,0
56432,5641,0.00,1000.00,2000.00,0.00,0.00,0.02,0
56433,5641,-1000.00,0.00,1000.00,0.00,1748.31,0.43,0
56434,5641,-1000.00,-1000.00,0.00,575.04,229.84,0.12,0
56435,5642,-737.00,-737.00,263.00,0.00,737.00,0.40,0
56436,5642,-263.00,-1000.00,0.00,24.57,238.43,0.21,0
56437,5643,-571.58,-571.58,428.42,108.27,463.31,0.29,0
56438,5643,-378.39,-949.97,50.03,0.00,378.39,0.43,0
56439,5643,-50.03,-1000.00,0.00,25.01,25.01,0.03,0
56440,5644,-1000.00,-1000.00,0.00,1000.00,0.00,0.00,0
56441,5645,-1000.00,-1000.00,0.00,0.00,197.41,0.30,0
56442,5646,-74.21,-74.21,925.79,74.21,0.00,0.34,0
56443,5646,-925.79,-1000.00,0.00,925.79,0.00,0.10,0
56444,5647,1000.00,1000.00,2000.00,0.00,379.40,0.11,1
56445,5647,1000.00,2000.00,3000.00,302.27,1697.73,0.42,1
56446,5647,1000.00,3000.00,4000.00,0.00,2914.58,0.37,1
56447,5647,1000.00,4000.00,5000.00,842.25,1871.06,0.28,1
56448,5647,1000.00,5000.00,6000.00,0.00,5000.00,0.26,1
56449,5647,1000.00,6000.00,7000.00,0.00,6000.00,0.18,1
56450,5647,1000.00,7000.00,8000.00,0.00,6987.99,0.39,1
56451,5647,1000.00,8000.00,9000.00,0.00,6376.28,0.28,1
56452,5647,1000.00,9000.00,10000.00,1580.30,6568.01,0.38,1
56453,5647,1000.00,10000.00,11000.00,3197.90,6802.10,0.34,1
56454,5647,1000.00,11000.00,12000.00,0.00,11000.00,0.41,1
56455,5647,1000.00,12000.00,13000.00,0.00,12000.00,0.05,1
56456,5647,1000.00,13000.00,14000.00,0.00,13000.00,0.18,1
56457,5647,1000.00,14000.00,15000.00,0.00,14000.00,0.05,1
56458,5647,1000.00,15000.00,16000.00,0.00,11255.57,0.18,1
56459,5647,1000.00,16000.00,17000.00,4728.72,11271.28,0.34,1
56460,5647,1000.00,17000.00,18000.00,6564.59,10435.41,0.21,1
56461,5647,1000.00,18000.00,19000.00,1592.31,12674.25,0.39,1
56462,5647,1000.00,19000.00,20000.00,0.00,5202.25,0.20,1
56463,5647,1000.00,20000.00,21000.00,7568.64,12431.36,0.10,1
56464,5647,-1000.00,19000.00,20000.00,10928.66,10071.34,0.12,0
56465,5647,1000.00,20000.00,21000.00,0.00,4353.21,0.19,1
56466,5647,-1000.00,19000.00,20000.00,7758.62,0.00,0.00,0
56467,5647,1000.00,20000.00,21000.00,0.00,12230.02,0.06,1
56468,5647,-1000.00,19000.00,20000.00,0.00,21000.00,0.06,0
56469,5647,-1000.00,18000.00,19000.00,12383.57,7616.43,0.15,0
56470,5647,-1000.00,17000.00,18000.00,0.00,19000.00,0.00,0
56471,5647,-1000.00,16000.00,17000.00,0.00,18000.00,0.34,0
56472,5647,-1000.00,15000.00,16000.00,0.00,17000.00,0.00,0
56473,5647,-1000.00,14000.00,15000.00,4894.58,11105.42,0.35,0
56474,5647,-1000.00,13000.00,14000.00,0.00,7012.30,0.29,0
56475,5647,-1000.00,12000.00,13000.00,803.18,13196.82,0.44,0
56476,5647,-1000.00,11000.00,12000.00,6500.00,6500.00,0.09,0
56477,5647,-1000.00,10000.00,11000.00,2038.34,9961.66,0.11,0
56478,5647,0.00,10000.00,11000.00,0.00,0.00,0.02,0
56479,5647,-1000.00,9000.00,10000.00,338.70,10661.30,0.17,0
56480,5647,-1000.00,8000.00,9000.00,0.00,10000.00,0.28,0
56481,5647,-1000.00,7000.00,8000.00,0.00,9000.00,0.32,0
56482,5647,-1000.00,6000.00,7000.00,245.36,7754.64,0.21,0
56483,5647,-1000.00,5000.00,6000.00,3996.90,3003.10,0.09,0
56484,5647,-1000.00,4000.00,5000.00,1123.78,3353.12,0.32,0
56485,5647,-655.49,3344.51,4344.51,199.39,456.10,0.14,0
56486,5647,-1000.00,2344.51,3344.51,3393.86,950.65,0.05,0
56487,5647,-1000.00,1344.51,2344.51,1318.76,905.16,0.17,0
56488,5647,-1000.00,344.51,1344.51,403.35,1941.16,0.42,0
56489,5647,0.00,344.51,1344.51,0.00,0.00,0.06,0
56490,5647,-1000.00,-655.49,344.51,316.30,1028.21,0.07,0
56491,5647,-344.51,-1000.00,-0.00,88.47,256.04,0.38,0
56492,5648,-1000.00,-1000.00,0.00,0.00,217.55,0.31,0
56493,5649,-1000.00,-1000.00,0.00,0.00,750.36,0.21,0
56494,5650,-155.08,-155.08,844.92,155.08,0.00,0.39,0
56495,5650,-1000.00,-1155.08,-155.08,0.00,191.00,0.40,0
56496,5651,-1000.00,-1000.00,0.00,0.00,1000.00,0.36,0
56497,5652,-1000.00,-1000.00,0.00,144.73,855.27,0.04,0
56498,5653,1000.00,1000.00,2000.00,213.02,309.19,0.21,1
56499,5653,1000.00,2000.00,3000.00,0.00,2000.00,0.43,1
56500,5653,1000.00,3000.00,4000.00,328.21,1313.15,0.28,1
56501,5653,1000.00,4000.00,5000.00,0.00,2637.88,0.37,1
56502,5653,1000.00,5000.00,6000.00,189.89,4810.11,0.42,1
56503,5653,1000.00,6000.00,7000.00,1995.99,4004.01,0.12,1
56504,5653,1000.00,7000.00,8000.00,1359.29,5640.71,0.30,1
56505,5653,1000.00,8000.00,9000.00,0.00,8000.00,0.36,1
56506,5653,1000.00,9000.00,10000.00,1248.41,7751.59,0.43,1
56507,5653,1000.00,10000.00,11000.00,268.80,4479.37,0.29,1
56508,5653,1000.00,11000.00,12000.00,0.00,11000.00,0.15,1
56509,5653,1000.00,12000.00,13000.00,0.00,12000.00,0.19,1
56510,5653,1000.00,13000.00,14000.00,0.00,7401.43,0.10,1
56511,5653,1000.00,14000.00,15000.00,0.00,14000.00,0.39,1
56512,5653,1000.00,15000.00,16000.00,0.00,15000.00,0.08,1
56513,5653,-1000.00,14000.00,15000.00,9019.54,6980.46,0.08,0
56514,5653,1000.00,15000.00,16000.00,0.00,15000.00,0.22,1
56515,5653,1000.00,16000.00,17000.00,0.00,16000.00,0.15,1
56516,5653,1000.00,17000.00,18000.00,4792.81,12101.83,0.35,1
56517,5653,1000.00,18000.00,19000.00,1700.71,16299.29,0.20,1
56518,5653,1000.00,19000.00,20000.00,0.00,14123.44,0.33,1
56519,5653,-1000.00,18000.00,19000.00,0.00,14969.79,0.39,0
56520,5653,-1000.00,17000.00,18000.00,4123.30,14876.70,0.37,0
56521,5653,-1000.00,16000.00,17000.00,8778.15,9221.85,0.07,0
56522,5653,-1000.00,15000.00,16000.00,0.00,17000.00,0.05,0
56523,5653,-1000.00,14000.00,15000.00,0.00,16000.00,0.01,0
56524,5653,-1000.00,13000.00,14000.00,0.00,2601.38,0.05,0
56525,5653,-1000.00,12000.00,13000.00,0.00,9171.75,0.36,0
56526,5653,-1000.00,11000.00,12000.00,374.03,11562.66,0.43,0
56527,5653,-1000.00,10000.00,11000.00,1240.63,10759.37,0.18,0
56528,5653,-1000.00,9000.00,10000.00,0.00,4772.77,0.04,0
56529,5653,-1000.00,8000.00,9000.00,0.00,10000.00,0.38,0
56530,5653,-1000.00,7000.00,8000.00,2018.34,6981.66,0.38,0
56531,5653,-1000.00,6000.00,7000.00,0.00,8000.00,0.11,0
56532,5653,-1000.00,5000.00,6000.00,3925.66,3074.34,0.18,0
56533,5653,-1000.00,4000.00,5000.00,1172.36,1271.71,0.18,0
56534,5653,-1000.00,3000.00,4000.00,3078.57,1921.43,0.08,0
56535,5653,1000.00,4000.00,5000.00,0.00,3153.00,0.30,1
56536,5653,1000.00,5000.00,6000.00,0.00,5000.00,0.20,1
56537,5653,1000.00,6000.00,7000.00,2605.15,3394.85,0.24,1
56538,5653,1000.00,7000.00,8000.00,2079.56,4920.44,0.34,1
56539,5653,1000.00,8000.00,9000.00,0.00,8000.00,0.34,1
56540,5653,1000.00,9000.00,10000.00,0.00,9000.00,0.07,1
56541,5653,0.00,9000.00,10000.00,0.00,0.00,0.01,0
56542,5653,1000.00,10000.00,11000.00,1647.69,8352.31,0.41,1
56543,5653,-90.08,9909.92,10909.92,90.08,0.00,0.05,0
56544,5653,1000.00,10909.92,11909.92,4234.17,6675.75,0.29,1
56545,5653,1000.00,11909.92,12909.92,5834.72,6075.19,0.19,1
56546,5653,1000.00,12909.92,13909.92,625.73,11510.96,0.43,1
56547,5653,1000.00,13909.92,14909.92,0.00,13909.92,0.04,1
56548,5653,-1000.00,12909.92,13909.92,8975.95,5933.96,0.14,0
56549,5653,1000.00,13909.92,14909.92,6420.10,7489.82,0.18,1
56550,5653,1000.00,14909.92,15909.92,0.00,14909.92,0.25,1
56551,5653,1000.00,15909.92,16909.92,5721.70,10188.22,0.27,1
56552,5653,1000.00,16909.92,17909.92,0.00,5816.74,0.09,1
56553,5653,1000.00,17909.92,18909.92,0.00,17909.92,0.40,1
56554,5653,1000.00,18909.92,19909.92,0.00,9490.65,0.27,1
56555,5653,1000.00,19909.92,20909.92,4557.99,15351.93,0.37,1
56556,5653,1000.00,20909.92,21909.92,0.00,20909.92,0.43,1
56557,5654,-1000.00,-1000.00,0.00,221.93,275.35,0.21,0
56558,5655,-30.25,-30.25,969.75,30.25,0.00,0.10,0
56559,5655,0.00,-30.25,969.75,0.00,0.00,0.44,0
56560,5655,-1000.00,-1030.25,-30.25,0.00,378.12,0.22,0
56561,5656,-1000.00,-1000.00,0.00,443.85,556.15,0.14,0
56562,5657,-711.84,-711.84,288.16,0.00,711.84,0.29,0
56563,5657,-288.16,-1000.00,0.00,0.00,288.16,0.39,0
56564,5658,-990.00,-990.00,10.00,0.00,990.00,0.26,0
56565,5658,-2.24,-992.24,7.76,0.77,1.47,0.16,0
56566,5658,-7.76,-1000.00,0.00,0.00,7.76,0.31,0
56567,5659,-1000.00,-1000.00,0.00,0.00,1000.00,0.27,0
56568,5660,-672.07,-672.07,327.93,0.00,672.07,0.11,0
56569,5660,1000.00,327.93,1327.93,74.82,0.00,0.41,1
56570,5660,1000.00,1327.93,2327.93,715.29,612.64,0.19,1
56571,5660,-1000.00,327.93,1327.93,0.00,2327.93,0.00,0
56572,5660,1000.00,1327.93,2327.93,1029.48,0.00,0.05,1
56573,5660,-1000.00,327.93,1327.93,0.00,1614.06,0.34,0
56574,5660,1000.00,1327.93,2327.93,938.82,389.12,0.09,1
56575,5660,-1000.00,327.93,1327.93,0.00,2327.93,0.06,0
56576,5660,-1000.00,-672.07,327.93,0.00,1327.93,0.16,0
56577,5660,-303.22,-975.28,24.72,0.00,303.22,0.43,0
56578,5660,-24.72,-1000.00,0.00,10.88,13.83,0.11,0
56579,5661,-755.59,-755.59,244.41,0.00,755.59,0.34,0
56580,5661,-160.14,-915.73,84.27,0.00,160.14,0.29,0
56581,5661,-84.27,-1000.00,0.00,0.00,84.27,0.07,0
56582,5662,-1000.00,-1000.00,0.00,0.00,788.33,0.21,0
56583,5663,-673.38,-673.38,326.62,0.00,673.38,0.04,0
56584,5663,-326.62,-1000.00,0.00,120.60,206.02,0.30,0
56585,5664,-1000.00,-1000.00,0.00,1000.00,0.00,0.03,0
56586,5665,1000.00,1000.00,2000.00,1000.00,0.00,0.06,1
56587,5665,0.00,1000.00,2000.00,0.00,0.00,0.14,0
56588,5665,-1000.00,0.00,1000.00,0.00,1964.80,0.44,0
56589,5665,1000.00,1000.00,2000.00,111.95,0.00,0.40,1
56590,5665,-1000.00,0.00,1000.00,168.73,1459.64,0.40,0
56591,5665,0.00,0.00,1000.00,0.00,0.00,0.17,0
56592,5665,-420.60,-420.60,579.40,0.00,420.60,0.19,0
56593,5665,1000.00,579.40,1579.40,62.93,0.00,0.26,1
56594,5665,0.00,579.40,1579.40,0.00,0.00,0.28,0
56595,5665,0.00,579.40,1579.40,0.00,0.00,0.17,0
56596,5665,-673.36,-93.96,906.04,0.00,673.36,0.34,0
56597,5665,1000.00,906.04,1906.04,613.45,260.58,0.12,1
56598,5665,-1000.00,-93.96,906.04,143.47,1762.58,0.44,0
56599,5665,-906.04,-1000.00,0.00,84.01,822.03,0.23,0
56600,5666,1000.00,1000.00,2000.00,500.00,500.00,0.01,1
56601,5666,1000.00,2000.00,3000.00,341.10,1658.90,0.41,1
56602,5666,1000.00,3000.00,4000.00,0.00,1813.33,0.21,1
56603,5666,1000.00,4000.00,5000.00,0.00,4000.00,0.27,1
56604,5666,1000.00,5000.00,6000.00,940.18,4059.82,0.26,1
56605,5666,1000.00,6000.00,7000.00,0.00,6000.00,0.42,1
56606,5666,1000.00,7000.00,8000.00,0.00,7000.00,0.17,1
56607,5666,1000.00,8000.00,9000.00,3455.10,4544.90,0.19,1
56608,5666,1000.00,9000.00,10000.00,0.00,9000.00,0.17,1
56609,5666,1000.00,10000.00,11000.00,3848.49,6151.51,0.29,1
56610,5666,1000.00,11000.00,12000.00,1921.85,9078.15,0.40,1
56611,5666,1000.00,12000.00,13000.00,0.00,6359.24,0.25,1
56612,5666,1000.00,13000.00,14000.00,0.00,7259.88,0.34,1
56613,5666,1000.00,14000.00,15000.00,2283.83,11716.17,0.35,1
56614,5666,1000.00,15000.00,16000.00,0.00,15000.00,0.23,1
56615,5666,0.00,15000.00,16000.00,0.00,0.00,0.00,0
56616,5666,1000.00,16000.00,17000.00,0.00,6602.12,0.13,1
56617,5666,1000.00,17000.00,18000.00,0.00,9176.10,0.12,1
56618,5666,1000.00,18000.00,19000.00,5489.02,8952.43,0.27,1
56619,5666,1000.00,19000.00,20000.00,1333.70,14188.56,0.40,1
56620,5666,1000.00,20000.00,21000.00,6831.43,8266.18,0.23,1
56621,5666,1000.00,21000.00,22000.00,8164.19,12835.81,0.25,1
56622,5666,1000.00,22000.00,23000.00,5512.33,16487.67,0.19,1
56623,5666,1000.00,23000.00,24000.00,0.00,21682.59,0.35,1
56624,5666,1000.00,24000.00,25000.00,5177.77,18822.23,0.39,1
56625,5666,1000.00,25000.00,26000.00,6702.38,18297.62,0.31,1
56626,5666,1000.00,26000.00,27000.00,12384.04,13615.96,0.05,1
56627,5666,1000.00,27000.00,28000.00,10258.59,16741.41,0.26,1
56628,5666,1000.00,28000.00,29000.00,6522.78,21477.22,0.39,1
56629,5666,1000.00,29000.00,30000.00,7373.20,21626.80,0.25,1
56630,5666,1000.00,30000.00,31000.00,0.00,30000.00,0.30,1
56631,5666,-1000.00,29000.00,30000.00,1512.48,625.48,0.12,0
56632,5666,1000.00,30000.00,31000.00,12571.86,17428.14,0.27,1
56633,5666,1000.00,31000.00,32000.00,0.00,28410.58,0.43,1
56634,5666,1000.00,32000.00,33000.00,0.00,30042.96,0.31,1
56635,5666,1000.00,33000.00,34000.00,5946.76,23867.59,0.38,1
56636,5666,1000.00,34000.00,35000.00,0.00,34000.00,0.04,1
56637,5666,1000.00,35000.00,36000.00,0.00,24161.03,0.07,1
56638,5666,-1000.00,34000.00,35000.00,19014.95,16985.05,0.10,0
56639,5666,1000.00,35000.00,36000.00,4545.13,30454.87,0.42,1
56640,5666,1000.00,36000.00,37000.00,16030.49,19969.51,0.15,1
56641,5666,1000.00,37000.00,38000.00,5093.53,31906.47,0.27,1
56642,5666,-1000.00,36000.00,37000.00,18206.50,15445.46,0.20,0
56643,5666,1000.00,37000.00,38000.00,14191.37,22808.63,0.26,1
56644,5666,1000.00,38000.00,39000.00,0.00,38000.00,0.32,1
56645,5666,-1000.00,37000.00,38000.00,6349.57,32650.43,0.42,0
56646,5666,-1000.00,36000.00,37000.00,0.00,24554.88,0.23,0
56647,5666,-1000.00,35000.00,36000.00,4049.75,32950.25,0.41,0
56648,5666,-1000.00,34000.00,35000.00,0.00,23693.08,0.26,0
56649,5666,-1000.00,33000.00,34000.00,23611.77,3842.38,0.08,0
56650,5666,-1000.00,32000.00,33000.00,0.00,34000.00,0.05,0
56651,5666,-1000.00,31000.00,32000.00,0.00,30846.19,0.39,0
56652,5666,-1000.00,30000.00,31000.00,0.00,32000.00,0.40,0
56653,5666,-1000.00,29000.00,30000.00,0.00,31000.00,0.07,0
56654,5666,-1000.00,28000.00,29000.00,0.00,30000.00,0.41,0
56655,5666,-1000.00,27000.00,28000.00,19494.91,9505.09,0.06,0
56656,5666,-1000.00,26000.00,27000.00,0.00,28000.00,0.28,0
56657,5666,-1000.00,25000.00,26000.00,490.45,26509.55,0.38,0
56658,5666,-1000.00,24000.00,25000.00,7551.01,0.00,0.16,0
56659,5666,-1000.00,23000.00,24000.00,0.00,25000.00,0.44,0
56660,5666,-1000.00,22000.00,23000.00,0.00,15086.61,0.11,0
56661,5666,-1000.00,21000.00,22000.00,8000.30,14999.70,0.32,0
56662,5666,-1000.00,20000.00,21000.00,0.00,19724.08,0.35,0
56663,5666,-1000.00,19000.00,20000.00,0.00,16214.31,0.23,0
56664,5667,-555.07,-555.07,444.93,0.00,555.07,0.01,0
56665,5667,-1000.00,-1555.07,-555.07,166.99,0.00,0.06,0
56666,5668,-1000.00,-1000.00,0.00,0.00,1000.00,0.19,0
56667,5669,-1000.00,-1000.00,0.00,0.00,1000.00,0.39,0
56668,5670,-1000.00,-1000.00,0.00,453.51,546.49,0.23,0
56669,5671,-1000.00,-1000.00,0.00,0.00,249.15,0.40,0
56670,5672,-1000.00,-1000.00,0.00,500.00,500.00,0.07,0
56671,5673,1000.00,1000.00,2000.00,77.57,922.43,0.41,1
56672,5673,1000.00,2000.00,3000.00,780.30,1219.70,0.25,1
56673,5673,1000.00,3000.00,4000.00,1122.18,1877.82,0.25,1
56674,5673,-1000.00,2000.00,3000.00,1307.53,863.86,0.16,0
56675,5673,1000.00,3000.00,4000.00,0.00,545.82,0.13,1
56676,5673,1000.00,4000.00,5000.00,1158.10,2841.90,0.31,1
56677,5673,1000.00,5000.00,6000.00,1652.31,3347.69,0.33,1
56678,5673,1000.00,6000.00,7000.00,2609.82,3390.18,0.13,1
56679,5673,1000.00,7000.00,8000.00,0.00,7000.00,0.32,1
56680,5673,1000.00,8000.00,9000.00,0.00,8000.00,0.21,1
56681,5673,1000.00,9000.00,10000.00,1295.38,7704.62,0.41,1
56682,5673,1000.00,10000.00,11000.00,0.00,6815.79,0.32,1
56683,5673,1000.00,11000.00,12000.00,0.00,8810.29,0.19,1
56684,5673,1000.00,12000.00,13000.00,2459.13,9540.87,0.40,1
56685,5673,1000.00,13000.00,14000.00,0.00,6085.72,0.10,1
56686,5673,1000.00,14000.00,15000.00,0.00,14000.00,0.41,1
56687,5673,1000.00,15000.00,16000.00,2211.55,12788.45,0.42,1
56688,5673,1000.00,16000.00,17000.00,4890.18,11109.82,0.27,1
56689,5673,1000.00,17000.00,18000.00,5980.90,11019.10,0.21,1
56690,5673,-1000.00,16000.00,17000.00,6319.60,11680.40,0.30,0
56691,5673,-1000.00,15000.00,16000.00,0.00,6181.12,0.15,0
56692,5673,-1000.00,14000.00,15000.00,0.00,16000.00,0.07,0
56693,5673,-1000.00,13000.00,14000.00,0.00,15000.00,0.36,0
56694,5673,-1000.00,12000.00,13000.00,0.00,7423.63,0.22,0
56695,5673,-1000.00,11000.00,12000.00,3574.31,872.03,0.12,0
56696,5673,-1000.00,10000.00,11000.00,0.00,12000.00,0.30,0
56697,5673,-1000.00,9000.00,10000.00,4045.20,6954.80,0.30,0
56698,5673,-1000.00,8000.00,9000.00,0.00,7760.71,0.18,0
56699,5673,-1000.00,7000.00,8000.00,4302.46,4697.54,0.14,0
56700,5673,-1000.00,6000.00,7000.00,298.67,7701.33,0.28,0
56701,5673,-1000.00,5000.00,6000.00,0.00,1732.67,0.18,0
56702,5673,-1000.00,4000.00,5000.00,0.00,6000.00,0.12,0
56703,5673,-1000.00,3000.00,4000.00,2151.60,2848.40,0.19,0
56704,5673,-1000.00,2000.00,3000.00,1612.25,2387.75,0.05,0
56705,5673,-1000.00,1000.00,2000.00,0.00,3000.00,0.27,0
56706,5673,-1000.00,0.00,1000.00,0.00,2000.00,0.33,0
56707,5673,-1000.00,-1000.00,0.00,33.80,966.20,0.38,0
56708,5674,-1000.00,-1000.00,0.00,0.00,1000.00,0.44,0
56709,5675,-202.33,-202.33,797.67,202.33,0.00,0.32,0
56710,5675,-1000.00,-1202.33,-202.33,0.00,338.64,0.32,0
56711,5676,-1000.00,-1000.00,0.00,59.27,371.62,0.25,0
56712,5677,-1000.00,-1000.00,0.00,33.41,85.81,0.44,0
56713,5678,-1000.00,-1000.00,0.00,307.15,692.85,0.30,0
56714,5679,-423.73,-423.73,576.27,280.13,143.60,0.39,0
56715,5679,-1000.00,-1423.73,-423.73,193.73,280.20,0.27,0
56716,5680,0.00,0.00,1000.00,0.00,0.00,0.12,0
56717,5680,0.00,0.00,1000.00,0.00,0.00,0.29,0
56718,5680,-1000.00,-1000.00,0.00,0.00,212.84,0.15,0
56719,5681,-951.46,-951.46,48.54,0.00,951.46,0.12,0
56720,5681,0.00,-951.46,48.54,0.00,0.00,0.30,0
56721,5681,1000.00,48.54,1048.54,27.79,0.37,0.28,1
56722,5681,-325.75,-277.22,722.78,0.00,325.75,0.32,0
56723,5681,1000.00,722.78,1722.78,654.38,0.00,0.10,1
56724,5681,-1000.00,-277.22,722.78,0.00,1306.38,0.14,0
56725,5681,1000.00,722.78,1722.78,154.68,0.00,0.40,1
56726,5681,-1000.00,-277.22,722.78,762.49,960.30,0.12,0
56727,5681,0.00,-277.22,722.78,0.00,0.00,0.40,0
56728,5681,-9.87,-287.09,712.91,0.00,9.87,0.44,0
56729,5681,1000.00,712.91,1712.91,314.85,0.00,0.26,1
56730,5681,1000.00,1712.91,2712.91,1047.15,261.28,0.25,1
56731,5681,1000.00,2712.91,3712.91,1048.59,0.00,0.18,1
56732,5681,1000.00,3712.91,4712.91,2104.25,1608.66,0.21,1
56733,5681,-1000.00,2712.91,3712.91,0.00,4712.91,0.10,0
56734,5681,-1000.00,1712.91,2712.91,0.00,3110.97,0.13,0
56735,5681,1000.00,2712.91,3712.91,776.51,3.64,0.39,1
56736,5681,-1000.00,1712.91,2712.91,82.81,1449.87,0.36,0
56737,5681,-768.79,944.12,1944.12,0.00,768.79,0.37,0
56738,5681,-1000.00,-55.88,944.12,0.00,1150.23,0.35,0
56739,5681,-1000.00,-1055.88,-55.88,136.20,414.87,0.29,0
56740,5682,-1000.00,-1000.00,0.00,468.79,531.21,0.10,0
56741,5683,-1000.00,-1000.00,0.00,443.33,556.67,0.09,0
56742,5684,-1000.00,-1000.00,0.00,0.00,1000.00,0.20,0
56743,5685,-565.67,-565.67,434.33,306.51,259.15,0.39,0
56744,5685,1000.00,434.33,1434.33,147.43,218.59,0.36,1
56745,5685,1000.00,1434.33,2434.33,0.00,1434.33,0.16,1
56746,5685,-1000.00,434.33,1434.33,1279.28,983.33,0.18,0
56747,5685,1000.00,1434.33,2434.33,0.00,1353.70,0.22,1
56748,5685,-1000.00,434.33,1434.33,1567.78,866.55,0.13,0
56749,5685,1000.00,1434.33,2434.33,160.65,1273.68,0.42,1
56750,5685,1000.00,2434.33,3434.33,0.00,2013.81,0.39,1
56751,5685,1000.00,3434.33,4434.33,0.00,3434.33,0.14,1
56752,5685,1000.00,4434.33,5434.33,2217.17,2217.17,0.03,1
56753,5685,1000.00,5434.33,6434.33,0.00,5434.33,0.08,1
56754,5685,1000.00,6434.33,7434.33,1203.52,5230.81,0.35,1
56755,5685,1000.00,7434.33,8434.33,0.00,2522.99,0.11,1
56756,5685,1000.00,8434.33,9434.33,2271.81,6162.52,0.37,1
56757,5685,1000.00,9434.33,10434.33,1382.14,8052.19,0.37,1
56758,5685,1000.00,10434.33,11434.33,0.00,10434.33,0.37,1
56759,5685,1000.00,11434.33,12434.33,4184.80,7249.54,0.27,1
56760,5685,1000.00,12434.33,13434.33,0.00,12434.33,0.40,1
56761,5685,1000.00,13434.33,14434.33,3534.73,9899.61,0.35,1
56762,5685,1000.00,14434.33,15434.33,113.83,323.94,0.12,1
56763,5685,1000.00,15434.33,16434.33,0.00,1966.33,0.14,1
56764,5685,1000.00,16434.33,17434.33,0.00,16434.33,0.22,1
56765,5685,-1000.00,15434.33,16434.33,8994.13,0.00,0.01,0
56766,5685,1000.00,16434.33,17434.33,2045.99,14388.35,0.03,1
56767,5685,1000.00,17434.33,18434.33,0.00,17434.33,0.21,1
56768,5685,1000.00,18434.33,19434.33,0.00,18434.33,0.04,1
56769,5685,1000.00,19434.33,20434.33,0.00,17934.21,0.44,1
56770,5685,0.00,19434.33,20434.33,0.00,0.00,0.07,0
56771,5685,1000.00,20434.33,21434.33,0.00,20434.33,0.12,1
56772,5685,1000.00,21434.33,22434.33,0.00,21434.33,0.22,1
56773,5685,1000.00,22434.33,23434.33,4504.12,17930.22,0.40,1
56774,5685,1000.00,23434.33,24434.33,0.00,2225.43,0.14,1
56775,5685,1000.00,24434.33,25434.33,0.00,24434.33,0.11,1
56776,5685,1000.00,25434.33,26434.33,6371.65,19062.68,0.18,1
56777,5685,1000.00,26434.33,27434.33,0.00,15446.91,0.14,1
56778,5685,0.00,26434.33,27434.33,0.00,0.00,0.06,0
56779,5685,-1000.00,25434.33,26434.33,0.00,27434.33,0.34,0
56780,5685,-1000.00,24434.33,25434.33,0.00,15399.72,0.21,0
56781,5685,-1000.00,23434.33,24434.33,0.00,16954.39,0.34,0
56782,5685,-1000.00,22434.33,23434.33,2907.03,18539.76,0.40,0
56783,5685,-1000.00,21434.33,22434.33,0.00,23434.33,0.38,0
56784,5685,-1000.00,20434.33,21434.33,0.00,14464.83,0.31,0
56785,5685,-1000.00,19434.33,20434.33,0.00,902.76,0.12,0
56786,5685,-1000.00,18434.33,19434.33,0.00,20434.33,0.42,0
56787,5685,-1000.00,17434.33,18434.33,0.00,19434.33,0.28,0
56788,5685,-1000.00,16434.33,17434.33,0.00,11803.56,0.34,0
56789,5685,-1000.00,15434.33,16434.33,1268.19,16166.14,0.18,0
56790,5685,-1000.00,14434.33,15434.33,0.00,3655.98,0.41,0
56791,5685,-1000.00,13434.33,14434.33,0.00,15434.33,0.10,0
56792,5685,-1000.00,12434.33,13434.33,0.00,2394.73,0.17,0
56793,5685,-1000.00,11434.33,12434.33,0.00,11371.41,0.16,0
56794,5685,-1000.00,10434.33,11434.33,250.98,12183.35,0.29,0
56795,5685,-1000.00,9434.33,10434.33,0.00,9201.90,0.24,0
56796,5685,-1000.00,8434.33,9434.33,0.00,4038.41,0.26,0
56797,5685,-1000.00,7434.33,8434.33,38.35,3934.94,0.28,0
56798,5685,-1000.00,6434.33,7434.33,3162.12,5272.22,0.18,0
56799,5685,-1000.00,5434.33,6434.33,0.00,6330.01,0.39,0
56800,5685,-649.47,4784.86,5784.86,0.00,649.47,0.14,0
56801,5685,-1000.00,3784.86,4784.86,3397.79,2387.06,0.09,0
56802,5685,-1000.00,2784.86,3784.86,2004.82,2780.04,0.25,0
56803,5685,-1000.00,1784.86,2784.86,0.00,3784.86,0.07,0
56804,5685,-1000.00,784.86,1784.86,353.55,2431.31,0.43,0
56805,5685,-1000.00,-215.14,784.86,316.38,1468.48,0.41,0
56806,5685,-784.86,-1000.00,0.00,165.64,619.21,0.40,0
56807,5686,-398.86,-398.86,601.14,90.69,308.17,0.38,0
56808,5686,1000.00,601.14,1601.14,18.69,0.00,0.02,1
56809,5686,1000.00,1601.14,2601.14,1384.50,0.00,0.13,1
56810,5686,-1000.00,601.14,1601.14,190.24,2410.90,0.29,0
56811,5686,-1000.00,-398.86,601.14,513.38,1087.76,0.30,0
56812,5686,-601.14,-1000.00,0.00,138.60,462.54,0.34,0
56813,5687,-1000.00,-1000.00,0.00,204.04,795.96,0.41,0
56814,5688,-1000.00,-1000.00,0.00,77.54,922.46,0.13,0
56815,5689,-1000.00,-1000.00,0.00,0.00,491.66,0.29,0
56816,5690,1000.00,1000.00,2000.00,0.00,1000.00,0.29,1
56817,5690,1000.00,2000.00,3000.00,0.00,1864.64,0.43,1
56818,5690,-1000.00,1000.00,2000.00,1649.16,1350.84,0.17,0
56819,5690,1000.00,2000.00,3000.00,0.00,386.58,0.18,1
56820,5690,-1000.00,1000.00,2000.00,1609.21,1382.69,0.20,0
56821,5690,-1000.00,0.00,1000.00,801.84,217.88,0.12,0
56822,5690,1000.00,1000.00,2000.00,0.00,267.07,0.13,1
56823,5690,1000.00,2000.00,3000.00,0.00,2000.00,0.08,1
56824,5690,1000.00,3000.00,4000.00,1250.33,1749.67,0.02,1
56825,5690,1000.00,4000.00,5000.00,159.78,3840.22,0.44,1
56826,5690,1000.00,5000.00,6000.00,0.00,3771.19,0.27,1
56827,5690,-1000.00,4000.00,5000.00,4082.11,1917.89,0.02,0
56828,5690,1000.00,5000.00,6000.00,2101.19,2898.81,0.21,1
56829,5690,-1000.00,4000.00,5000.00,4868.31,269.60,0.05,0
56830,5690,1000.00,5000.00,6000.00,0.00,1748.68,0.13,1
56831,5690,1000.00,6000.00,7000.00,0.00,2680.11,0.11,1
56832,5690,1000.00,7000.00,8000.00,0.00,2637.96,0.24,1
56833,5690,1000.00,8000.00,9000.00,3839.71,4160.29,0.20,1
56834,5690,1000.00,9000.00,10000.00,452.58,8547.42,0.31,1
56835,5690,-1000.00,8000.00,9000.00,2233.78,7766.22,0.19,0
56836,5690,-1000.00,7000.00,8000.00,2504.37,6495.63,0.36,0
56837,5690,-1000.00,6000.00,7000.00,0.00,8000.00,0.09,0
56838,5690,0.00,6000.00,7000.00,0.00,0.00,0.06,0
56839,5690,-1000.00,5000.00,6000.00,0.00,4791.26,0.29,0
56840,5690,-1000.00,4000.00,5000.00,1418.36,4581.64,0.00,0
56841,5690,-1000.00,3000.00,4000.00,1150.32,3664.81,0.37,0
56842,5690,-1000.00,2000.00,3000.00,1144.06,2855.94,0.19,0
56843,5690,-1000.00,1000.00,2000.00,0.00,3000.00,0.03,0
56844,5690,-568.12,431.88,1431.88,0.00,568.12,0.15,0
56845,5690,-1000.00,-568.12,431.88,0.00,1431.88,0.06,0
56846,5690,-431.88,-1000.00,0.00,0.00,431.88,0.04,0
56847,5691,-1000.00,-1000.00,0.00,78.71,921.29,0.28,0
56848,5692,-571.89,-571.89,428.11,0.00,571.89,0.30,0
56849,5692,-428.11,-1000.00,0.00,2.37,425.74,0.35,0
56850,5693,-1000.00,-1000.00,0.00,433.73,566.27,0.24,0
56851,5694,0.00,0.00,1000.00,0.00,0.00,0.15,0
56852,5694,-1000.00,-1000.00,0.00,0.00,1000.00,0.05,0
56853,5695,-1000.00,-1000.00,0.00,500.00,500.00,0.02,0
56854,5696,-941.16,-941.16,58.84,0.00,268.90,0.21,0
56855,5696,-198.79,-1139.95,-139.95,2.04,56.80,0.16,0
56856,5697,1000.00,1000.00,2000.00,0.00,502.36,0.25,1
56857,5697,1000.00,2000.00,3000.00,694.77,1305.23,0.26,1
56858,5697,1000.00,3000.00,4000.00,0.00,2337.43,0.38,1
56859,5697,1000.00,4000.00,5000.00,45.89,3954.11,0.44,1
56860,5697,-1000.00,3000.00,4000.00,2784.67,2215.33,0.12,0
56861,5697,-1000.00,2000.00,3000.00,1486.23,74.12,0.10,0
56862,5697,1000.00,3000.00,4000.00,1479.31,1520.69,0.02,1
56863,5697,1000.00,4000.00,5000.00,0.00,3964.03,0.21,1
56864,5697,1000.00,5000.00,6000.00,847.94,4152.06,0.38,1
56865,5697,1000.00,6000.00,7000.00,0.00,477.75,0.12,1
56866,5697,1000.00,7000.00,8000.00,0.00,4271.96,0.23,1
56867,5697,-1000.00,6000.00,7000.00,3874.78,0.00,0.01,0
56868,5697,1000.00,7000.00,8000.00,0.00,6048.87,0.43,1
56869,5697,1000.00,8000.00,9000.00,0.00,8000.00,0.09,1
56870,5697,1000.00,9000.00,10000.00,0.00,5901.62,0.36,1
56871,5697,1000.00,10000.00,11000.00,0.00,9477.29,0.32,1
56872,5697,1000.00,11000.00,12000.00,0.00,9450.93,0.05,1
56873,5697,1000.00,12000.00,13000.00,0.00,12000.00,0.06,1
56874,5697,1000.00,13000.00,14000.00,0.00,3243.10,0.14,1
56875,5697,-1000.00,12000.00,13000.00,8293.87,5706.13,0.13,0
56876,5697,-1000.00,11000.00,12000.00,5982.18,7017.82,0.14,0
56877,5697,-1000.00,10000.00,11000.00,0.00,12000.00,0.30,0
56878,5697,-1000.00,9000.00,10000.00,3595.72,7404.28,0.23,0
56879,5697,-1000.00,8000.00,9000.00,861.06,9138.94,0.14,0
56880,5697,-1000.00,7000.00,8000.00,2472.30,6527.70,0.34,0
56881,5697,-1000.00,6000.00,7000.00,0.00,1792.76,0.17,0
56882,5697,-1000.00,5000.00,6000.00,0.00,6659.55,0.39,0
56883,5697,-1000.00,4000.00,5000.00,4168.11,1831.89,0.09,0
56884,5697,-1000.00,3000.00,4000.00,2270.71,2729.29,0.18,0
56885,5697,-1000.00,2000.00,3000.00,921.70,3078.30,0.01,0
56886,5697,-1000.00,1000.00,2000.00,317.92,2682.08,0.42,0
56887,5697,-1000.00,0.00,1000.00,866.92,1133.08,0.19,0
56888,5697,-599.25,-599.25,400.75,223.53,375.72,0.24,0
56889,5697,-200.59,-799.84,200.16,0.00,200.59,0.31,0
56890,5697,-179.26,-979.10,20.90,72.38,106.88,0.27,0
56891,5697,-20.90,-1000.00,0.00,5.15,15.75,0.37,0
56892,5698,-1000.00,-1000.00,0.00,0.00,1000.00,0.07,0
56893,5699,-972.05,-972.05,27.95,0.00,972.05,0.40,0
56894,5699,-27.95,-1000.00,0.00,11.76,16.18,0.16,0
56895,5700,1000.00,1000.00,2000.00,318.09,0.00,0.14,1
56896,5700,-681.28,318.72,1318.72,0.00,681.28,0.42,0
56897,5700,1000.00,1318.72,2318.72,507.01,502.21,0.35,1
56898,5700,-1000.00,318.72,1318.72,0.00,2318.72,0.06,0
56899,5700,1000.00,1318.72,2318.72,567.32,290.72,0.15,1
56900,5700,-314.95,1003.77,2003.77,0.00,314.95,0.15,0
56901,5700,-1000.00,3.77,1003.77,0.00,1477.77,0.23,0
56902,5700,-1000.00,-996.23,3.77,261.48,742.29,0.30,0
56903,5700,-2.52,-998.75,1.25,0.00,2.52,0.38,0
56904,5700,-1.25,-1000.00,0.00,0.00,1.25,0.26,0
56905,5701,-513.45,-513.45,486.55,513.45,0.00,0.18,0
56906,5701,1000.00,486.55,1486.55,0.00,9.06,0.02,1
56907,5701,1000.00,1486.55,2486.55,0.00,1486.55,0.24,1
56908,5701,1000.00,2486.55,3486.55,971.43,1515.13,0.24,1
56909,5701,1000.00,3486.55,4486.55,6.63,3479.93,0.44,1
56910,5701,1000.00,4486.55,5486.55,2179.67,2306.88,0.20,1
56911,5701,1000.00,5486.55,6486.55,1697.07,3789.48,0.35,1
56912,5701,1000.00,6486.55,7486.55,0.00,6486.55,0.30,1
56913,5701,1000.00,7486.55,8486.55,0.00,4709.86,0.05,1
56914,5701,1000.00,8486.55,9486.55,0.00,8486.55,0.26,1
56915,5701,-1000.00,7486.55,8486.55,5039.66,4446.90,0.02,0
56916,5701,1000.00,8486.55,9486.55,0.00,4869.47,0.33,1
56917,5701,1000.00,9486.55,10486.55,3943.70,5542.86,0.12,1
56918,5701,1000.00,10486.55,11486.55,0.00,10486.55,0.37,1
56919,5701,1000.00,11486.55,12486.55,0.00,7531.86,0.16,1
56920,5701,1000.00,12486.55,13486.55,0.00,6251.45,0.12,1
56921,5701,1000.00,13486.55,14486.55,3295.29,9093.41,0.35,1
56922,5701,1000.00,14486.55,15486.55,0.00,12657.40,0.22,1
56923,5701,1000.00,15486.55,16486.55,0.00,4477.33,0.02,1
56924,5701,1000.00,16486.55,17486.55,0.00,8010.17,0.25,1
56925,5701,1000.00,17486.55,18486.55,893.94,16592.61,0.43,1
56926,5701,1000.00,18486.55,19486.55,0.00,13339.13,0.39,1
56927,5701,-1000.00,17486.55,18486.55,3783.83,0.00,0.01,0
56928,5701,1000.00,18486.55,19486.55,8077.04,10409.52,0.17,1
56929,5701,-1000.00,17486.55,18486.55,0.00,19486.55,0.25,0
56930,5701,-584.16,16902.39,17902.39,0.00,584.16,0.12,0
56931,5701,-1000.00,15902.39,16902.39,0.00,9855.65,0.13,0
56932,5701,-1000.00,14902.39,15902.39,0.00,16902.39,0.20,0
56933,5701,-1000.00,13902.39,14902.39,2069.56,13832.83,0.25,0
56934,5701,-1000.00,12902.39,13902.39,0.00,14902.39,0.29,0
56935,5701,-1000.00,11902.39,12902.39,0.00,13902.39,0.26,0
56936,5701,-1000.00,10902.39,11902.39,7276.57,5625.82,0.06,0
56937,5701,-1000.00,9902.39,10902.39,2043.15,9859.24,0.19,0
56938,5701,-1000.00,8902.39,9902.39,6929.17,3973.22,0.01,0
56939,5701,-1000.00,7902.39,8902.39,0.00,9902.39,0.39,0
56940,5701,-793.57,7108.82,8108.82,0.00,793.57,0.14,0
56941,5701,-1000.00,6108.82,7108.82,0.00,8108.82,0.40,0
56942,5701,-1000.00,5108.82,6108.82,0.00,7108.82,0.28,0
56943,5701,-1000.00,4108.82,5108.82,0.00,6108.82,0.22,0
56944,5701,-1000.00,3108.82,4108.82,0.00,2018.41,0.26,0
56945,5701,-1000.00,2108.82,3108.82,0.00,4108.82,0.21,0
56946,5701,-1000.00,1108.82,2108.82,0.00,3108.82,0.33,0
56947,5701,-1000.00,108.82,1108.82,0.00,1381.60,0.31,0
56948,5701,-1000.00,-891.18,108.82,804.31,304.51,0.01,0
56949,5701,-108.82,-1000.00,0.00,44.74,64.08,0.12,0
56950,5702,-501.39,-501.39,498.61,501.39,0.00,0.09,0
56951,5702,0.00,-501.39,498.61,0.00,0.00,0.02,0
56952,5702,-280.29,-781.67,218.33,221.00,59.29,0.19,0
56953,5702,-1000.00,-1781.67,-781.67,0.00,218.33,0.36,0
56954,5703,-175.54,-175.54,824.46,175.54,0.00,0.28,0
56955,5703,-487.17,-662.71,337.29,267.62,219.55,0.35,0
56956,5703,-1000.00,-1662.71,-662.71,150.64,186.65,0.25,0
56957,5704,-1000.00,-1000.00,0.00,675.80,324.20,0.08,0
56958,5705,-1000.00,-1000.00,0.00,443.77,556.23,0.16,0
56959,5706,1000.00,1000.00,2000.00,78.47,52.20,0.44,1
56960,5706,1000.00,2000.00,3000.00,178.53,0.00,0.43,1
56961,5706,1000.00,3000.00,4000.00,2284.02,715.98,0.07,1
56962,5706,-1000.00,2000.00,3000.00,0.00,1131.41,0.12,0
56963,5706,1000.00,3000.00,4000.00,2423.75,576.25,0.03,1
56964,5706,0.00,3000.00,4000.00,0.00,0.00,0.14,0
56965,5706,0.00,3000.00,4000.00,0.00,0.00,0.21,0
56966,5706,0.00,3000.00,4000.00,0.00,0.00,0.29,0
56967,5706,-295.60,2704.40,3704.40,0.00,295.60,0.40,0
56968,5706,-1000.00,1704.40,2704.40,0.00,2407.07,0.17,0
56969,5706,-1000.00,704.40,1704.40,0.00,2704.40,0.32,0
56970,5706,1000.00,1704.40,2704.40,134.00,0.00,0.42,1
56971,5706,-170.82,1533.57,2533.57,45.80,125.03,0.44,0
56972,5706,0.00,1533.57,2533.57,0.00,0.00,0.02,0
56973,5706,-1000.00,533.57,1533.57,0.00,2533.57,0.25,0
56974,5706,-1000.00,-466.43,533.57,306.17,748.83,0.30,0
56975,5706,1000.00,533.57,1533.57,2.26,0.00,0.19,1
56976,5706,-1000.00,-466.43,533.57,66.47,1467.11,0.02,0
56977,5706,-396.12,-862.55,137.45,87.65,308.48,0.27,0
56978,5706,-137.45,-1000.00,0.00,47.55,89.90,0.30,0
56979,5707,-1000.00,-1000.00,0.00,0.00,1000.00,0.10,0
56980,5708,-630.69,-630.69,369.31,0.00,1.89,0.10,0
56981,5708,-1000.00,-1630.69,-630.69,0.00,256.05,0.07,0
56982,5709,-1000.00,-1000.00,0.00,537.58,462.42,0.01,0
56983,5710,-1000.00,-1000.00,0.00,0.00,1000.00,0.07,0
56984,5711,-1000.00,-1000.00,0.00,298.39,701.61,0.32,0
56985,5712,-1000.00,-1000.00,0.00,0.00,422.90,0.30,0
56986,5713,1000.00,1000.00,2000.00,761.46,0.00,0.20,1
56987,5713,-613.66,386.34,1386.34,0.00,613.66,0.05,0
56988,5713,-1000.00,-613.66,386.34,693.17,693.17,0.02,0
56989,5713,-160.98,-774.65,225.35,79.20,81.79,0.39,0
56990,5713,-162.69,-937.34,62.66,31.71,130.98,0.30,0
56991,5713,-62.66,-1000.00,0.00,9.24,53.43,0.32,0
56992,5714,-1000.00,-1000.00,0.00,118.35,881.65,0.34,0
56993,5715,1000.00,1000.00,2000.00,0.00,561.49,0.30,1
56994,5715,1000.00,2000.00,3000.00,624.07,1375.93,0.12,1
56995,5715,1000.00,3000.00,4000.00,0.00,1681.82,0.29,1
56996,5715,-1000.00,2000.00,3000.00,2133.04,1866.96,0.04,0
56997,5715,1000.00,3000.00,4000.00,0.00,2698.04,0.44,1
56998,5715,1000.00,4000.00,5000.00,1490.59,2509.41,0.16,1
56999,5715,-1000.00,3000.00,4000.00,3002.94,0.00,0.04,0
57000,5715,1000.00,4000.00,5000.00,482.07,2733.68,0.38,1
57001,5715,1000.00,5000.00,6000.00,1612.07,3387.93,0.08,1
57002,5715,1000.00,6000.00,7000.00,2432.70,3567.30,0.21,1
57003,5715,1000.00,7000.00,8000.00,1533.89,5466.11,0.29,1
57004,5715,1000.00,8000.00,9000.00,0.00,926.54,0.06,1
57005,5715,-1000.00,7000.00,8000.00,4766.88,4233.12,0.15,0
57006,5715,1000.00,8000.00,9000.00,2330.51,5669.49,0.34,1
57007,5715,-1000.00,7000.00,8000.00,5179.22,0.00,0.04,0
57008,5715,1000.00,8000.00,9000.00,0.00,5635.78,0.38,1
57009,5715,1000.00,9000.00,10000.00,0.00,7972.63,0.32,1
57010,5715,1000.00,10000.00,11000.00,1227.70,8772.30,0.27,1
57011,5715,1000.00,11000.00,12000.00,0.00,10819.98,0.29,1
57012,5715,-1000.00,10000.00,11000.00,8330.67,3669.33,0.02,0
57013,5715,1000.00,11000.00,12000.00,0.00,11000.00,0.19,1
57014,5715,-1000.00,10000.00,11000.00,6197.65,5802.35,0.18,0
57015,5715,1000.00,11000.00,12000.00,982.16,10017.84,0.24,1
57016,5715,1000.00,12000.00,13000.00,0.00,12000.00,0.25,1
57017,5715,1000.00,13000.00,14000.00,5325.67,7674.33,0.28,1
57018,5715,1000.00,14000.00,15000.00,0.00,8216.15,0.08,1
57019,5715,1000.00,15000.00,16000.00,5423.05,9576.95,0.25,1
57020,5715,1000.00,16000.00,17000.00,5051.66,10948.34,0.24,1
57021,5715,1000.00,17000.00,18000.00,0.00,13901.95,0.30,1
57022,5715,-1000.00,16000.00,17000.00,4912.23,0.00,0.05,0
57023,5715,1000.00,17000.00,18000.00,0.00,16305.05,0.07,1
57024,5715,1000.00,18000.00,19000.00,0.00,18000.00,0.06,1
57025,5715,1000.00,19000.00,20000.00,9500.00,9500.00,0.10,1
57026,5715,-1000.00,18000.00,19000.00,17673.16,0.00,0.00,0
57027,5715,1000.00,19000.00,20000.00,5272.79,13727.21,0.36,1
57028,5715,1000.00,20000.00,21000.00,0.00,20000.00,0.02,1
57029,5715,1000.00,21000.00,22000.00,4044.84,7381.29,0.23,1
57030,5715,1000.00,22000.00,23000.00,0.00,22000.00,0.44,1
57031,5715,1000.00,23000.00,24000.00,9372.47,13627.53,0.27,1
57032,5715,1000.00,24000.00,25000.00,0.00,24000.00,0.43,1
57033,5715,1000.00,25000.00,26000.00,0.00,25000.00,0.01,1
57034,5715,1000.00,26000.00,27000.00,0.00,22642.27,0.40,1
57035,5715,1000.00,27000.00,28000.00,3343.15,23656.85,0.02,1
57036,5715,1000.00,28000.00,29000.00,0.00,19981.18,0.36,1
57037,5715,1000.00,29000.00,30000.00,9866.70,19133.30,0.30,1
57038,5715,1000.00,30000.00,31000.00,9452.24,20547.76,0.33,1
57039,5715,1000.00,31000.00,32000.00,11347.18,19652.82,0.15,1
57040,5715,-1000.00,30000.00,31000.00,9017.14,22982.86,0.36,0
57041,5715,-1000.00,29000.00,30000.00,9134.01,21865.99,0.34,0
57042,5715,-1000.00,28000.00,29000.00,1778.11,20978.20,0.39,0
57043,5715,-1000.00,27000.00,28000.00,13444.79,15555.21,0.15,0
57044,5715,-1000.00,26000.00,27000.00,672.82,27327.18,0.42,0
57045,5715,-1000.00,25000.00,26000.00,10468.09,16531.91,0.28,0
57046,5715,-1000.00,24000.00,25000.00,0.00,26000.00,0.35,0
57047,5715,-1000.00,23000.00,24000.00,0.00,12029.92,0.30,0
57048,5715,0.00,23000.00,24000.00,0.00,0.00,0.06,0
57049,5715,-1000.00,22000.00,23000.00,0.00,15315.09,0.37,0
57050,5715,-1000.00,21000.00,22000.00,9235.33,5730.94,0.16,0
57051,5715,-1000.00,20000.00,21000.00,10558.76,11441.24,0.20,0
57052,5715,-1000.00,19000.00,20000.00,0.00,8426.83,0.16,0
57053,5715,-1000.00,18000.00,19000.00,0.00,20000.00,0.27,0
57054,5715,-1000.00,17000.00,18000.00,8630.39,10369.61,0.13,0
57055,5715,-1000.00,16000.00,17000.00,0.00,18000.00,0.20,0
57056,5715,-1000.00,15000.00,16000.00,0.00,17000.00,0.15,0
57057,5715,-1000.00,14000.00,15000.00,4669.73,11330.27,0.35,0
57058,5715,-1000.00,13000.00,14000.00,0.00,11621.24,0.15,0
57059,5715,-1000.00,12000.00,13000.00,0.00,5009.74,0.20,0
57060,5716,1000.00,1000.00,2000.00,324.71,453.46,0.25,1
57061,5716,1000.00,2000.00,3000.00,0.00,697.98,0.24,1
57062,5716,1000.00,3000.00,4000.00,0.00,3000.00,0.30,1
57063,5716,1000.00,4000.00,5000.00,1258.07,2741.93,0.32,1
57064,5716,1000.00,5000.00,6000.00,0.00,4256.97,0.29,1
57065,5716,1000.00,6000.00,7000.00,0.00,6000.00,0.41,1
57066,5716,1000.00,7000.00,8000.00,3500.00,3500.00,0.09,1
57067,5716,1000.00,8000.00,9000.00,2208.73,2528.56,0.21,1
57068,5716,1000.00,9000.00,10000.00,0.00,3384.27,0.25,1
57069,5716,1000.00,10000.00,11000.00,0.00,8769.43,0.41,1
57070,5716,1000.00,11000.00,12000.00,2253.23,8746.77,0.16,1
57071,5716,1000.00,12000.00,13000.00,0.00,12000.00,0.44,1
57072,5716,1000.00,13000.00,14000.00,3007.30,9992.70,0.37,1
57073,5716,1000.00,14000.00,15000.00,3635.56,10364.44,0.37,1
57074,5716,1000.00,15000.00,16000.00,0.00,15000.00,0.35,1
57075,5716,1000.00,16000.00,17000.00,0.00,14459.26,0.02,1
57076,5716,1000.00,17000.00,18000.00,5157.57,11842.43,0.24,1
57077,5716,1000.00,18000.00,19000.00,2515.89,15484.11,0.30,1
57078,5716,1000.00,19000.00,20000.00,3956.57,14450.38,0.38,1
57079,5716,1000.00,20000.00,21000.00,0.00,20000.00,0.00,1
57080,5716,1000.00,21000.00,22000.00,0.00,19820.42,0.40,1
57081,5716,1000.00,22000.00,23000.00,6545.85,15454.15,0.29,1
57082,5716,1000.00,23000.00,24000.00,0.00,11343.77,0.31,1
57083,5716,-1000.00,22000.00,23000.00,14921.24,0.00,0.03,0
57084,5716,-1000.00,21000.00,22000.00,11304.50,2363.32,0.10,0
57085,5716,-1000.00,20000.00,21000.00,0.00,22000.00,0.34,0
57086,5716,-1000.00,19000.00,20000.00,6265.64,14734.36,0.33,0
57087,5716,-1000.00,18000.00,19000.00,5967.52,14032.48,0.36,0
57088,5716,-1000.00,17000.00,18000.00,6758.08,12241.92,0.31,0
57089,5716,-1000.00,16000.00,17000.00,0.00,18000.00,0.37,0
57090,5716,-1000.00,15000.00,16000.00,7555.52,9444.48,0.20,0
57091,5716,-1000.00,14000.00,15000.00,41.78,15958.22,0.29,0
57092,5716,-1000.00,13000.00,14000.00,4651.20,0.00,0.06,0
57093,5716,0.00,13000.00,14000.00,0.00,0.00,0.04,0
57094,5716,-1000.00,12000.00,13000.00,1716.94,7201.72,0.31,0
57095,5716,-1000.00,11000.00,12000.00,0.00,13000.00,0.40,0
57096,5716,-1000.00,10000.00,11000.00,0.00,5324.12,0.27,0
57097,5716,-1000.00,9000.00,10000.00,1117.26,4930.60,0.29,0
57098,5716,-523.02,8476.98,9476.98,125.71,397.31,0.12,0
57099,5716,-1000.00,7476.98,8476.98,1510.85,7966.12,0.10,0
57100,5716,-1000.00,6476.98,7476.98,0.00,8476.98,0.43,0
57101,5716,-1000.00,5476.98,6476.98,1479.28,5997.69,0.36,0
57102,5716,-1000.00,4476.98,5476.98,0.00,6476.98,0.06,0
57103,5716,-1000.00,3476.98,4476.98,0.00,5476.98,0.21,0
57104,5716,-1000.00,2476.98,3476.98,0.00,4476.98,0.23,0
57105,5716,-1000.00,1476.98,2476.98,2030.31,0.00,0.04,0
57106,5716,-1000.00,476.98,1476.98,1265.80,1211.17,0.17,0
57107,5716,1000.00,1476.98,2476.98,0.00,1476.98,0.29,1
57108,5716,1000.00,2476.98,3476.98,1044.91,1432.06,0.15,1
57109,5716,-1000.00,1476.98,2476.98,0.00,1976.06,0.30,0
57110,5716,-1000.00,476.98,1476.98,0.00,802.24,0.20,0
57111,5716,-1000.00,-523.02,476.98,0.00,1476.98,0.22,0
57112,5716,-1000.00,-1523.02,-523.02,0.00,476.98,0.12,0
57113,5717,-1000.00,-1000.00,0.00,0.00,618.83,0.13,0
57114,5718,-1000.00,-1000.00,0.00,300.67,699.33,0.20,0
57115,5719,-1000.00,-1000.00,0.00,711.01,288.99,0.10,0
57116,5720,-1000.00,-1000.00,0.00,378.46,621.54,0.10,0
57117,5721,-1000.00,-1000.00,0.00,428.37,571.63,0.25,0
57118,5722,1000.00,1000.00,2000.00,201.28,798.72,0.20,1
57119,5722,1000.00,2000.00,3000.00,878.71,1121.29,0.19,1
57120,5722,1000.00,3000.00,4000.00,7.30,1050.51,0.25,1
57121,5722,1000.00,4000.00,5000.00,0.00,185.67,0.03,1
57122,5722,1000.00,5000.00,6000.00,0.00,5000.00,0.30,1
57123,5722,1000.00,6000.00,7000.00,0.00,6000.00,0.17,1
57124,5722,1000.00,7000.00,8000.00,1380.05,5619.95,0.18,1
57125,5722,1000.00,8000.00,9000.00,3828.41,4171.59,0.10,1
57126,5722,1000.00,9000.00,10000.00,215.08,4923.84,0.33,1
57127,5722,1000.00,10000.00,11000.00,0.00,10000.00,0.34,1
57128,5722,1000.00,11000.00,12000.00,0.00,11000.00,0.24,1
57129,5722,1000.00,12000.00,13000.00,0.00,12000.00,0.29,1
57130,5722,-1000.00,11000.00,12000.00,13000.00,0.00,0.01,0
57131,5722,1000.00,12000.00,13000.00,0.00,12000.00,0.32,1
57132,5722,1000.00,13000.00,14000.00,507.52,12492.48,0.43,1
57133,5722,-1000.00,12000.00,13000.00,7370.31,6629.69,0.15,0
57134,5722,1000.00,13000.00,14000.00,0.00,13000.00,0.02,1
57135,5722,1000.00,14000.00,15000.00,5920.23,8079.77,0.24,1
57136,5722,1000.00,15000.00,16000.00,0.00,12807.72,0.08,1
57137,5722,1000.00,16000.00,17000.00,0.00,16000.00,0.12,1
57138,5722,1000.00,17000.00,18000.00,0.00,14647.51,0.23,1
57139,5722,1000.00,18000.00,19000.00,0.00,11907.32,0.19,1
57140,5722,1000.00,19000.00,20000.00,9500.00,9500.00,0.01,1
57141,5722,-1000.00,18000.00,19000.00,11951.47,8048.53,0.02,0
57142,5722,1000.00,19000.00,20000.00,0.00,16479.29,0.36,1
57143,5722,1000.00,20000.00,21000.00,0.00,11290.43,0.18,1
57144,5722,1000.00,21000.00,22000.00,0.00,21000.00,0.04,1
57145,5722,1000.00,22000.00,23000.00,6925.30,15074.70,0.09,1
57146,5722,1000.00,23000.00,24000.00,0.00,16316.53,0.10,1
57147,5722,0.00,23000.00,24000.00,0.00,0.00,0.09,0
57148,5722,1000.00,24000.00,25000.00,0.00,24000.00,0.07,1
57149,5722,1000.00,25000.00,26000.00,0.00,14702.54,0.35,1
57150,5722,1000.00,26000.00,27000.00,12678.66,13321.34,0.12,1
57151,5722,1000.00,27000.00,28000.00,0.00,27000.00,0.31,1
57152,5722,1000.00,28000.00,29000.00,12690.82,15309.18,0.13,1
57153,5722,1000.00,29000.00,30000.00,0.00,29000.00,0.44,1
57154,5722,1000.00,30000.00,31000.00,14486.73,15513.27,0.14,1
57155,5722,1000.00,31000.00,32000.00,8117.66,22882.34,0.34,1
57156,5722,-1000.00,30000.00,31000.00,18039.74,13960.26,0.15,0
57157,5722,1000.00,31000.00,32000.00,3343.52,27656.48,0.34,1
57158,5722,1000.00,32000.00,33000.00,9230.30,22769.70,0.12,1
57159,5722,1000.00,33000.00,34000.00,0.00,33000.00,0.05,1
57160,5722,1000.00,34000.00,35000.00,615.92,23048.77,0.38,1
57161,5722,1000.00,35000.00,36000.00,0.00,35000.00,0.39,1
57162,5722,-1000.00,34000.00,35000.00,0.00,36000.00,0.24,0
57163,5722,-1000.00,33000.00,34000.00,0.00,2691.57,0.07,0
57164,5722,-1000.00,32000.00,33000.00,15868.70,16362.61,0.22,0
57165,5722,-1000.00,31000.00,32000.00,10287.84,22712.16,0.35,0
57166,5722,-1000.00,30000.00,31000.00,0.00,8740.22,0.21,0
57167,5722,-1000.00,29000.00,30000.00,494.69,30505.31,0.37,0
57168,5722,-1000.00,28000.00,29000.00,8224.04,21775.96,0.34,0
57169,5722,-1000.00,27000.00,28000.00,0.00,26911.56,0.13,0
57170,5722,-1000.00,26000.00,27000.00,0.00,28000.00,0.23,0
57171,5722,-1000.00,25000.00,26000.00,10650.00,12335.75,0.24,0
57172,5722,-1000.00,24000.00,25000.00,4369.62,0.00,0.00,0
57173,5722,-1000.00,23000.00,24000.00,7985.37,17014.63,0.34,0
57174,5722,-1000.00,22000.00,23000.00,9703.39,3628.29,0.13,0
57175,5722,-1000.00,21000.00,22000.00,0.00,18482.47,0.11,0
57176,5722,-1000.00,20000.00,21000.00,5168.04,16831.96,0.39,0
57177,5722,-1000.00,19000.00,20000.00,1899.35,1923.75,0.14,0
57178,5722,-1000.00,18000.00,19000.00,0.00,20000.00,0.16,0
57179,5722,-1000.00,17000.00,18000.00,3908.39,15091.61,0.39,0
57180,5722,-1000.00,16000.00,17000.00,6990.98,11009.02,0.23,0
57181,5722,-1000.00,15000.00,16000.00,0.00,12108.19,0.35,0
57182,5722,-1000.00,14000.00,15000.00,0.00,12262.02,0.37,0
57183,5722,-1000.00,13000.00,14000.00,1342.08,13657.92,0.32,0
57184,5722,-1000.00,12000.00,13000.00,4531.51,9468.49,0.28,0
57185,5722,-1000.00,11000.00,12000.00,0.00,8721.36,0.38,0
57186,5723,-944.85,-944.85,55.15,0.00,944.85,0.39,0
57187,5723,-1000.00,-1944.85,-944.85,29.12,0.00,0.07,0
57188,5724,1000.00,1000.00,2000.00,162.17,837.83,0.41,1
57189,5724,1000.00,2000.00,3000.00,0.00,2000.00,0.03,1
57190,5724,1000.00,3000.00,4000.00,415.19,2584.81,0.15,1
57191,5724,1000.00,4000.00,5000.00,160.10,3839.90,0.42,1
57192,5724,1000.00,5000.00,6000.00,0.00,5000.00,0.10,1
57193,5724,1000.00,6000.00,7000.00,178.59,5821.41,0.03,1
57194,5724,1000.00,7000.00,8000.00,0.00,4472.26,0.09,1
57195,5724,1000.00,8000.00,9000.00,0.00,8000.00,0.05,1
57196,5724,1000.00,9000.00,10000.00,0.00,5842.29,0.18,1
57197,5724,1000.00,10000.00,11000.00,0.00,388.09,0.12,1
57198,5724,-1000.00,9000.00,10000.00,5586.78,5413.22,0.21,0
57199,5724,1000.00,10000.00,11000.00,0.00,10000.00,0.26,1
57200,5724,1000.00,11000.00,12000.00,0.00,6752.90,0.34,1
57201,5724,1000.00,12000.00,13000.00,0.00,1346.43,0.13,1
57202,5724,1000.00,13000.00,14000.00,0.00,13000.00,0.18,1
57203,5724,-1000.00,12000.00,13000.00,4006.15,9993.85,0.20,0
57204,5724,-1000.00,11000.00,12000.00,2591.60,10408.40,0.17,0
57205,5724,-1000.00,10000.00,11000.00,0.00,12000.00,0.32,0
57206,5724,-1000.00,9000.00,10000.00,4310.93,6689.07,0.25,0
57207,5724,-1000.00,8000.00,9000.00,0.00,10000.00,0.17,0
57208,5724,-1000.00,7000.00,8000.00,4327.22,4672.78,0.19,0
57209,5724,-1000.00,6000.00,7000.00,4636.87,3363.13,0.17,0
57210,5724,-1000.00,5000.00,6000.00,3153.88,3846.12,0.18,0
57211,5724,-1000.00,4000.00,5000.00,0.00,6000.00,0.05,0
57212,5724,-1000.00,3000.00,4000.00,0.00,4897.39,0.43,0
57213,5724,-1000.00,2000.00,3000.00,1645.71,2354.29,0.20,0
57214,5724,-1000.00,1000.00,2000.00,0.00,3000.00,0.02,0
57215,5724,-1000.00,0.00,1000.00,0.00,2000.00,0.13,0
57216,5724,-939.02,-939.02,60.98,0.00,939.02,0.11,0
57217,5724,-49.86,-988.88,11.12,0.00,49.86,0.18,0
57218,5724,-8.25,-997.12,2.88,0.00,8.25,0.34,0
57219,5724,-0.17,-997.29,2.71,0.00,0.17,0.13,0
57220,5724,-2.71,-1000.00,-0.00,0.18,2.53,0.36,0
57221,5725,1000.00,1000.00,2000.00,163.26,836.74,0.41,1
57222,5725,1000.00,2000.00,3000.00,0.00,2000.00,0.33,1
57223,5725,1000.00,3000.00,4000.00,0.00,3000.00,0.05,1
57224,5725,1000.00,4000.00,5000.00,778.14,1082.50,0.20,1
57225,5725,1000.00,5000.00,6000.00,0.00,1192.78,0.12,1
57226,5725,1000.00,6000.00,7000.00,0.00,6000.00,0.17,1
57227,5725,1000.00,7000.00,8000.00,0.00,7000.00,0.04,1
57228,5725,1000.00,8000.00,9000.00,927.22,2945.46,0.25,1
57229,5725,1000.00,9000.00,10000.00,4286.30,4713.70,0.13,1
57230,5725,1000.00,10000.00,11000.00,4111.97,5888.03,0.05,1
57231,5725,1000.00,11000.00,12000.00,3836.52,7163.48,0.03,1
57232,5725,1000.00,12000.00,13000.00,5681.54,6318.46,0.15,1
57233,5725,-1000.00,11000.00,12000.00,0.00,13000.00,0.32,0
57234,5725,-1000.00,10000.00,11000.00,0.00,12000.00,0.40,0
57235,5725,-1000.00,9000.00,10000.00,0.00,11000.00,0.32,0
57236,5725,-1000.00,8000.00,9000.00,0.00,1780.01,0.17,0
57237,5725,0.00,8000.00,9000.00,0.00,0.00,0.02,0
57238,5725,-1000.00,7000.00,8000.00,0.00,7665.49,0.41,0
57239,5725,-1000.00,6000.00,7000.00,1879.55,6120.45,0.39,0
57240,5725,-1000.00,5000.00,6000.00,4177.09,2822.91,0.11,0
57241,5725,-1000.00,4000.00,5000.00,0.00,6000.00,0.05,0
57242,5725,-1000.00,3000.00,4000.00,0.00,570.73,0.09,0
57243,5725,0.00,3000.00,4000.00,0.00,0.00,0.01,0
57244,5725,-1000.00,2000.00,3000.00,0.00,4000.00,0.28,0
57245,5725,-1000.00,1000.00,2000.00,442.39,2557.61,0.42,0
57246,5725,-561.52,438.48,1438.48,0.00,561.52,0.38,0
57247,5725,-1000.00,-561.52,438.48,381.18,151.30,0.13,0
57248,5725,-438.48,-1000.00,0.00,142.24,296.25,0.26,0
57249,5726,-79.45,-79.45,920.55,0.00,79.45,0.42,0
57250,5726,0.00,-79.45,920.55,0.00,0.00,0.34,0
57251,5726,1000.00,920.55,1920.55,681.60,0.00,0.08,1
57252,5726,-1000.00,-79.45,920.55,201.42,1719.13,0.07,0
57253,5726,0.00,-79.45,920.55,0.00,0.00,0.02,0
57254,5726,-920.55,-1000.00,0.00,0.00,920.55,0.43,0
57255,5727,1000.00,1000.00,2000.00,145.69,624.24,0.35,1
57256,5727,1000.00,2000.00,3000.00,1000.00,1000.00,0.03,1
57257,5727,0.00,2000.00,3000.00,0.00,0.00,0.09,0
57258,5727,0.00,2000.00,3000.00,0.00,0.00,0.03,0
57259,5727,1000.00,3000.00,4000.00,0.00,2270.80,0.35,1
57260,5727,1000.00,4000.00,5000.00,0.00,4000.00,0.09,1
57261,5727,1000.00,5000.00,6000.00,0.00,2614.98,0.25,1
57262,5727,-1000.00,4000.00,5000.00,1749.74,4250.26,0.19,0
57263,5727,-1000.00,3000.00,4000.00,2038.27,2961.73,0.07,0
57264,5727,-1000.00,2000.00,3000.00,664.93,3252.58,0.17,0
57265,5727,-1000.00,1000.00,2000.00,815.44,699.27,0.37,0
57266,5727,-1000.00,0.00,1000.00,1520.13,476.90,0.16,0
57267,5727,-1000.00,-1000.00,0.00,338.57,661.43,0.28,0
57268,5728,-1000.00,-1000.00,0.00,0.00,1000.00,0.31,0
57269,5729,-1000.00,-1000.00,0.00,697.05,302.95,0.11,0
57270,5730,1000.00,1000.00,2000.00,568.68,224.57,0.28,1
57271,5730,-715.03,284.97,1284.97,0.00,715.03,0.13,0
57272,5730,-1000.00,-715.03,284.97,0.00,1284.97,0.43,0
57273,5730,-284.97,-1000.00,0.00,0.00,284.97,0.10,0
57274,5731,-1000.00,-1000.00,0.00,293.45,706.55,0.36,0
57275,5732,-1000.00,-1000.00,0.00,0.00,1000.00,0.19,0
57276,5733,-1000.00,-1000.00,0.00,125.93,874.07,0.29,0
57277,5734,-966.70,-966.70,33.30,621.33,345.37,0.22,0
57278,5734,0.00,-966.70,33.30,0.00,0.00,0.44,0
57279,5734,-33.30,-1000.00,0.00,27.02,6.28,0.05,0
57280,5735,1000.00,1000.00,2000.00,0.00,874.87,0.34,1
57281,5735,1000.00,2000.00,3000.00,996.73,1003.27,0.06,1
57282,5735,1000.00,3000.00,4000.00,721.40,2278.60,0.23,1
57283,5735,1000.00,4000.00,5000.00,1714.42,2285.58,0.20,1
57284,5735,1000.00,5000.00,6000.00,0.00,5000.00,0.41,1
57285,5735,1000.00,6000.00,7000.00,306.55,5693.45,0.44,1
57286,5735,1000.00,7000.00,8000.00,0.00,4526.05,0.06,1
57287,5735,1000.00,8000.00,9000.00,748.35,7251.65,0.43,1
57288,5735,1000.00,9000.00,10000.00,1866.48,4614.12,0.30,1
57289,5735,1000.00,10000.00,11000.00,0.00,9418.83,0.44,1
57290,5735,1000.00,11000.00,12000.00,0.00,11000.00,0.02,1
57291,5735,1000.00,12000.00,13000.00,0.00,12000.00,0.21,1
57292,5735,1000.00,13000.00,14000.00,0.00,7176.57,0.32,1
57293,5735,1000.00,14000.00,15000.00,0.00,14000.00,0.39,1
57294,5735,1000.00,15000.00,16000.00,0.00,15000.00,0.42,1
57295,5735,1000.00,16000.00,17000.00,4701.03,11298.97,0.15,1
57296,5735,1000.00,17000.00,18000.00,2715.47,12057.67,0.38,1
57297,5735,1000.00,18000.00,19000.00,860.55,17139.45,0.38,1
57298,5735,1000.00,19000.00,20000.00,0.00,19000.00,0.18,1
57299,5735,1000.00,20000.00,21000.00,0.00,20000.00,0.18,1
57300,5735,1000.00,21000.00,22000.00,0.00,21000.00,0.37,1
57301,5735,1000.00,22000.00,23000.00,6553.85,15446.15,0.34,1
57302,5735,-1000.00,21000.00,22000.00,11427.23,9943.52,0.20,0
57303,5735,-1000.00,20000.00,21000.00,17659.62,0.00,0.02,0
57304,5735,-1000.00,19000.00,20000.00,0.00,21000.00,0.11,0
57305,5735,-1000.00,18000.00,19000.00,10000.00,10000.00,0.07,0
57306,5735,-1000.00,17000.00,18000.00,0.00,17943.48,0.22,0
57307,5735,-1000.00,16000.00,17000.00,9000.00,9000.00,0.04,0
57308,5735,-1000.00,15000.00,16000.00,2748.57,11205.03,0.36,0
57309,5735,-1000.00,14000.00,15000.00,0.00,16000.00,0.34,0
57310,5735,-1000.00,13000.00,14000.00,0.00,2888.40,0.18,0
57311,5735,0.00,13000.00,14000.00,0.00,0.00,0.04,0
57312,5735,-1000.00,12000.00,13000.00,3175.15,10824.85,0.39,0
57313,5735,-1000.00,11000.00,12000.00,3460.20,9539.80,0.37,0
57314,5735,-1000.00,10000.00,11000.00,0.00,12000.00,0.01,0
57315,5735,-1000.00,9000.00,10000.00,0.00,11000.00,0.17,0
57316,5735,-1000.00,8000.00,9000.00,856.37,9143.63,0.43,0
57317,5735,-1000.00,7000.00,8000.00,1312.45,7687.55,0.39,0
57318,5735,-1000.00,6000.00,7000.00,0.00,2273.04,0.21,0
57319,5735,-1000.00,5000.00,6000.00,0.00,7000.00,0.23,0
57320,5735,-1000.00,4000.00,5000.00,3000.00,3000.00,0.09,0
57321,5735,-1000.00,3000.00,4000.00,0.00,4558.68,0.31,0
57322,5735,-1000.00,2000.00,3000.00,0.00,2231.00,0.15,0
57323,5735,-1000.00,1000.00,2000.00,0.00,2136.52,0.39,0
57324,5735,-300.51,699.49,1699.49,0.00,300.51,0.16,0
57325,5735,-1000.00,-300.51,699.49,212.88,1486.61,0.38,0
57326,5735,-699.49,-1000.00,0.00,223.03,476.47,0.25,0
57327,5736,-968.97,-968.97,31.03,0.00,968.97,0.18,0
57328,5736,-27.52,-996.49,3.51,0.00,27.52,0.03,0
57329,5736,-3.51,-1000.00,0.00,0.00,3.51,0.04,0
57330,5737,-165.43,-165.43,834.57,0.00,165.43,0.12,0
57331,5737,-232.52,-397.94,602.06,0.00,232.52,0.43,0
57332,5737,-602.06,-1000.00,0.00,0.00,602.06,0.44,0
57333,5738,-1000.00,-1000.00,0.00,0.00,639.43,0.02,0
57334,5739,-733.32,-733.32,266.68,0.00,733.32,0.18,0
57335,5739,-266.68,-1000.00,0.00,0.00,266.68,0.01,0
57336,5740,1000.00,1000.00,2000.00,453.11,546.89,0.17,1
57337,5740,1000.00,2000.00,3000.00,0.00,1747.87,0.38,1
57338,5740,1000.00,3000.00,4000.00,188.39,961.31,0.23,1
57339,5740,1000.00,4000.00,5000.00,0.00,4000.00,0.10,1
57340,5740,1000.00,5000.00,6000.00,0.00,1727.12,0.21,1
57341,5740,1000.00,6000.00,7000.00,0.00,6000.00,0.11,1
57342,5740,1000.00,7000.00,8000.00,0.00,7000.00,0.19,1
57343,5740,1000.00,8000.00,9000.00,0.00,8000.00,0.29,1
57344,5740,1000.00,9000.00,10000.00,0.00,9000.00,0.09,1
57345,5740,1000.00,10000.00,11000.00,3903.45,5536.12,0.27,1
57346,5740,1000.00,11000.00,12000.00,0.00,11000.00,0.16,1
57347,5740,0.00,11000.00,12000.00,0.00,0.00,0.07,0
57348,5740,1000.00,12000.00,13000.00,0.00,12000.00,0.11,1
57349,5740,1000.00,13000.00,14000.00,0.00,6855.23,0.29,1
57350,5740,1000.00,14000.00,15000.00,3528.41,10471.59,0.34,1
57351,5740,1000.00,15000.00,16000.00,0.00,10058.13,0.35,1
57352,5740,1000.00,16000.00,17000.00,2044.02,13955.98,0.34,1
57353,5740,1000.00,17000.00,18000.00,5021.36,11978.64,0.14,1
57354,5740,1000.00,18000.00,19000.00,0.00,18000.00,0.23,1
57355,5740,-1000.00,17000.00,18000.00,13689.68,5310.32,0.09,0
57356,5740,1000.00,18000.00,19000.00,0.00,18000.00,0.25,1
57357,5740,1000.00,19000.00,20000.00,0.00,16490.36,0.06,1
57358,5740,-1000.00,18000.00,19000.00,0.00,20000.00,0.26,0
57359,5740,-1000.00,17000.00,18000.00,0.00,14105.93,0.40,0
57360,5740,-1000.00,16000.00,17000.00,4908.35,13091.65,0.03,0
57361,5740,-1000.00,15000.00,16000.00,0.00,15963.52,0.36,0
57362,5740,-1000.00,14000.00,15000.00,1603.42,14396.58,0.43,0
57363,5740,-1000.00,13000.00,14000.00,8192.57,6807.43,0.19,0
57364,5740,-1000.00,12000.00,13000.00,0.00,14000.00,0.03,0
57365,5740,-1000.00,11000.00,12000.00,0.00,13000.00,0.38,0
57366,5740,-1000.00,10000.00,11000.00,1865.91,10134.09,0.40,0
57367,5740,-1000.00,9000.00,10000.00,518.82,10481.18,0.15,0
57368,5740,-1000.00,8000.00,9000.00,4700.74,5299.26,0.14,0
57369,5740,-1000.00,7000.00,8000.00,16.28,6458.73,0.40,0
57370,5740,0.00,7000.00,8000.00,0.00,0.00,0.03,0
57371,5740,-1000.00,6000.00,7000.00,0.00,8000.00,0.17,0
57372,5740,-1000.00,5000.00,6000.00,1699.88,5300.12,0.30,0
57373,5740,-1000.00,4000.00,5000.00,2139.21,3860.79,0.13,0
57374,5740,-1000.00,3000.00,4000.00,2412.12,2587.88,0.22,0
57375,5740,-1000.00,2000.00,3000.00,0.00,3617.59,0.04,0
57376,5740,-1000.00,1000.00,2000.00,0.00,3000.00,0.37,0
57377,5740,-1000.00,0.00,1000.00,0.00,2000.00,0.31,0
57378,5740,-1000.00,-1000.00,0.00,397.19,0.00,0.03,0
57379,5741,0.00,0.00,1000.00,0.00,0.00,0.06,0
57380,5741,-452.64,-452.64,547.36,452.64,0.00,0.16,0
57381,5741,1000.00,547.36,1547.36,124.34,423.02,0.38,1
57382,5741,1000.00,1547.36,2547.36,0.00,1547.36,0.36,1
57383,5741,1000.00,2547.36,3547.36,0.00,928.06,0.25,1
57384,5741,1000.00,3547.36,4547.36,0.00,3547.36,0.08,1
57385,5741,1000.00,4547.36,5547.36,0.00,3530.30,0.29,1
57386,5741,1000.00,5547.36,6547.36,0.00,5547.36,0.28,1
57387,5741,1000.00,6547.36,7547.36,0.00,6547.36,0.11,1
57388,5741,1000.00,7547.36,8547.36,505.22,7042.14,0.43,1
57389,5741,1000.00,8547.36,9547.36,0.00,8547.36,0.22,1
57390,5741,1000.00,9547.36,10547.36,1338.54,8208.83,0.33,1
57391,5741,1000.00,10547.36,11547.36,5034.84,5512.52,0.13,1
57392,5741,1000.00,11547.36,12547.36,0.00,11547.36,0.01,1
57393,5741,0.00,11547.36,12547.36,0.00,0.00,0.03,0
57394,5741,-1000.00,10547.36,11547.36,8323.13,1960.46,0.22,0
57395,5741,1000.00,11547.36,12547.36,0.00,8422.95,0.26,1
57396,5741,1000.00,12547.36,13547.36,0.00,11129.04,0.36,1
57397,5741,1000.00,13547.36,14547.36,0.00,3560.18,0.11,1
57398,5741,1000.00,14547.36,15547.36,0.00,12163.19,0.42,1
57399,5741,1000.00,15547.36,16547.36,0.00,15547.36,0.16,1
57400,5741,1000.00,16547.36,17547.36,0.00,6261.35,0.03,1
57401,5741,1000.00,17547.36,18547.36,0.00,17547.36,0.09,1
57402,5741,1000.00,18547.36,19547.36,0.00,5112.16,0.10,1
57403,5741,1000.00,19547.36,20547.36,545.50,19001.86,0.30,1
57404,5741,1000.00,20547.36,21547.36,0.00,20547.36,0.26,1
57405,5741,1000.00,21547.36,22547.36,10773.68,10773.68,0.00,1
57406,5741,1000.00,22547.36,23547.36,6983.41,7570.25,0.21,1
57407,5741,1000.00,23547.36,24547.36,1023.61,22523.75,0.30,1
57408,5741,-1000.00,22547.36,23547.36,12682.19,11865.17,0.18,0
57409,5741,-1000.00,21547.36,22547.36,14671.72,8875.64,0.08,0
57410,5741,1000.00,22547.36,23547.36,4050.11,6820.28,0.22,1
57411,5741,1000.00,23547.36,24547.36,0.00,20256.79,0.04,1
57412,5741,1000.00,24547.36,25547.36,0.00,12864.11,0.14,1
57413,5741,1000.00,25547.36,26547.36,0.00,23394.23,0.31,1
57414,5741,-1000.00,24547.36,25547.36,10798.66,0.00,0.07,0
57415,5741,1000.00,25547.36,26547.36,0.00,25547.36,0.02,1
57416,5741,1000.00,26547.36,27547.36,0.00,12274.69,0.05,1
57417,5741,-1000.00,25547.36,26547.36,15385.64,12161.72,0.18,0
57418,5741,1000.00,26547.36,27547.36,0.00,23654.46,0.18,1
57419,5741,1000.00,27547.36,28547.36,0.00,26873.60,0.44,1
57420,5741,0.00,27547.36,28547.36,0.00,0.00,0.02,0
57421,5741,1000.00,28547.36,29547.36,0.00,28547.36,0.42,1
57422,5742,-291.54,-291.54,708.46,291.54,0.00,0.38,0
57423,5742,-1000.00,-1291.54,-291.54,0.00,140.80,0.23,0
57424,5743,0.00,0.00,1000.00,0.00,0.00,0.13,0
57425,5743,-1000.00,-1000.00,0.00,1000.00,0.00,0.03,0
57426,5744,-1000.00,-1000.00,0.00,471.71,528.29,0.10,0
57427,5745,1000.00,1000.00,2000.00,0.00,116.74,0.15,1
57428,5745,1000.00,2000.00,3000.00,0.00,2000.00,0.08,1
57429,5745,1000.00,3000.00,4000.00,930.21,2069.79,0.24,1
57430,5745,1000.00,4000.00,5000.00,612.69,3387.31,0.07,1
57431,5745,1000.00,5000.00,6000.00,2428.38,2571.62,0.13,1
57432,5745,1000.00,6000.00,7000.00,0.00,6000.00,0.20,1
57433,5745,-1000.00,5000.00,6000.00,4404.50,2595.50,0.07,0
57434,5745,1000.00,6000.00,7000.00,0.00,1180.57,0.06,1
57435,5745,-1000.00,5000.00,6000.00,3915.98,3084.02,0.16,0
57436,5745,1000.00,6000.00,7000.00,0.00,6000.00,0.24,1
57437,5745,1000.00,7000.00,8000.00,2184.57,4815.43,0.35,1
57438,5745,1000.00,8000.00,9000.00,3588.24,4371.80,0.25,1
57439,5745,1000.00,9000.00,10000.00,0.00,9000.00,0.05,1
57440,5745,1000.00,10000.00,11000.00,0.00,1627.62,0.12,1
57441,5745,1000.00,11000.00,12000.00,1250.94,9749.06,0.32,1
57442,5745,1000.00,12000.00,13000.00,696.27,405.91,0.12,1
57443,5745,-1000.00,11000.00,12000.00,0.00,13000.00,0.39,0
57444,5745,-1000.00,10000.00,11000.00,0.00,12000.00,0.24,0
57445,5745,-1000.00,9000.00,10000.00,0.00,8720.03,0.39,0
57446,5745,-1000.00,8000.00,9000.00,0.00,10000.00,0.14,0
57447,5745,-1000.00,7000.00,8000.00,0.00,8469.19,0.44,0
57448,5745,-1000.00,6000.00,7000.00,0.00,5521.92,0.35,0
57449,5745,-1000.00,5000.00,6000.00,564.39,6435.61,0.44,0
57450,5745,-1000.00,4000.00,5000.00,0.00,5281.53,0.41,0
57451,5745,-1000.00,3000.00,4000.00,0.00,3539.35,0.37,0
57452,5745,-1000.00,2000.00,3000.00,0.00,3287.55,0.27,0
57453,5745,1000.00,3000.00,4000.00,2414.15,585.85,0.07,1
57454,5745,-1000.00,2000.00,3000.00,319.66,3680.34,0.35,0
57455,5745,-1000.00,1000.00,2000.00,1410.15,1589.85,0.22,0
57456,5745,-1000.00,0.00,1000.00,695.33,1304.67,0.32,0
57457,5745,-1000.00,-1000.00,0.00,500.00,500.00,0.00,0
57458,5746,-1000.00,-1000.00,0.00,910.42,89.58,0.02,0
57459,5746,0.00,-1000.00,0.00,0.00,0.00,0.33,0
57460,5746,0.00,-1000.00,0.00,0.00,0.00,0.11,0
57461,5746,0.00,-1000.00,0.00,0.00,0.00,0.36,0
57462,5746,-0.00,-1000.00,0.00,0.00,0.00,0.20,0
57463,5747,1000.00,1000.00,2000.00,199.23,652.27,0.35,1
57464,5747,1000.00,2000.00,3000.00,0.00,2000.00,0.19,1
57465,5747,1000.00,3000.00,4000.00,0.00,3000.00,0.08,1
57466,5747,1000.00,4000.00,5000.00,0.00,4000.00,0.13,1
57467,5747,-1000.00,3000.00,4000.00,2655.50,2344.50,0.19,0
57468,5747,1000.00,4000.00,5000.00,0.00,1754.55,0.24,1
57469,5747,1000.00,5000.00,6000.00,0.00,5000.00,0.07,1
57470,5747,1000.00,6000.00,7000.00,0.00,2863.18,0.06,1
57471,5747,1000.00,7000.00,8000.00,2735.89,4264.11,0.29,1
57472,5747,1000.00,8000.00,9000.00,3005.91,4994.09,0.13,1
57473,5747,-1000.00,7000.00,8000.00,4978.25,4021.75,0.00,0
57474,5747,1000.00,8000.00,9000.00,761.31,6301.60,0.41,1
57475,5747,-1000.00,7000.00,8000.00,3740.75,383.75,0.10,0
57476,5747,1000.00,8000.00,9000.00,0.00,8000.00,0.26,1
57477,5747,1000.00,9000.00,10000.00,0.00,9000.00,0.01,1
57478,5747,1000.00,10000.00,11000.00,0.00,10000.00,0.17,1
57479,5747,0.00,10000.00,11000.00,0.00,0.00,0.03,0
57480,5747,1000.00,11000.00,12000.00,0.00,9830.07,0.36,1
57481,5747,1000.00,12000.00,13000.00,0.00,12000.00,0.29,1
57482,5747,1000.00,13000.00,14000.00,359.51,10220.21,0.41,1
57483,5747,0.00,13000.00,14000.00,0.00,0.00,0.03,0
57484,5747,1000.00,14000.00,15000.00,4868.23,9131.77,0.19,1
57485,5747,1000.00,15000.00,16000.00,4820.83,10179.17,0.23,1
57486,5747,1000.00,16000.00,17000.00,8000.00,8000.00,0.01,1
57487,5747,1000.00,17000.00,18000.00,0.00,13142.79,0.38,1
57488,5747,1000.00,18000.00,19000.00,0.00,18000.00,0.41,1
57489,5747,1000.00,19000.00,20000.00,7095.28,11904.72,0.20,1
57490,5747,1000.00,20000.00,21000.00,6269.91,13730.09,0.33,1
57491,5747,1000.00,21000.00,22000.00,2794.64,18205.36,0.31,1
57492,5747,1000.00,22000.00,23000.00,9708.70,12291.30,0.06,1
57493,5747,-1000.00,21000.00,22000.00,2262.19,0.00,0.03,0
57494,5747,1000.00,22000.00,23000.00,0.00,11285.49,0.24,1
57495,5747,1000.00,23000.00,24000.00,0.00,6575.58,0.07,1
57496,5747,1000.00,24000.00,25000.00,0.00,24000.00,0.32,1
57497,5747,1000.00,25000.00,26000.00,2607.09,22392.91,0.43,1
57498,5747,1000.00,26000.00,27000.00,0.00,22955.07,0.43,1
57499,5747,1000.00,27000.00,28000.00,0.00,27000.00,0.35,1
57500,5747,1000.00,28000.00,29000.00,0.00,28000.00,0.11,1
57501,5747,1000.00,29000.00,30000.00,14289.71,14710.29,0.11,1
57502,5747,-1000.00,28000.00,29000.00,6293.12,5297.03,0.16,0
57503,5747,1000.00,29000.00,30000.00,0.00,29000.00,0.18,1
57504,5747,1000.00,30000.00,31000.00,0.00,24426.65,0.06,1
57505,5747,-1000.00,29000.00,30000.00,15881.89,15118.11,0.14,0
57506,5748,0.00,0.00,1000.00,0.00,0.00,0.28,0
57507,5748,1000.00,1000.00,2000.00,28.11,0.00,0.38,1
57508,5748,-1000.00,0.00,1000.00,556.54,1443.46,0.31,0
57509,5748,-881.51,-881.51,118.49,0.00,881.51,0.39,0
57510,5748,-118.49,-1000.00,0.00,0.00,118.49,0.03,0
57511,5749,-1000.00,-1000.00,0.00,500.00,500.00,0.07,0
57512,5750,-719.25,-719.25,280.75,415.11,304.14,0.18,0
57513,5750,1000.00,280.75,1280.75,110.05,170.70,0.29,1
57514,5750,1000.00,1280.75,2280.75,331.75,949.01,0.32,1
57515,5750,1000.00,2280.75,3280.75,0.00,2242.56,0.09,1
57516,5750,1000.00,3280.75,4280.75,1245.86,2034.89,0.26,1
57517,5750,-1000.00,2280.75,3280.75,2930.51,1350.24,0.06,0
57518,5750,1000.00,3280.75,4280.75,1350.55,1930.20,0.19,1
57519,5750,1000.00,4280.75,5280.75,0.00,4280.75,0.04,1
57520,5750,1000.00,5280.75,6280.75,0.00,1978.86,0.12,1
57521,5750,1000.00,6280.75,7280.75,0.00,5169.16,0.39,1
57522,5750,1000.00,7280.75,8280.75,0.00,5555.20,0.19,1
57523,5750,1000.00,8280.75,9280.75,1322.17,6958.59,0.42,1
57524,5750,1000.00,9280.75,10280.75,0.00,9280.75,0.40,1
57525,5750,1000.00,10280.75,11280.75,0.00,4096.53,0.06,1
57526,5750,1000.00,11280.75,12280.75,0.00,3957.65,0.03,1
57527,5750,-1000.00,10280.75,11280.75,5711.75,4790.95,0.20,0
57528,5750,1000.00,11280.75,12280.75,1656.55,9624.20,0.42,1
57529,5750,1000.00,12280.75,13280.75,0.00,9319.17,0.22,1
57530,5750,1000.00,13280.75,14280.75,0.00,13280.75,0.28,1
57531,5750,1000.00,14280.75,15280.75,0.00,14280.75,0.14,1
57532,5750,1000.00,15280.75,16280.75,1100.38,14180.38,0.10,1
57533,5750,1000.00,16280.75,17280.75,5336.69,10944.06,0.33,1
57534,5750,1000.00,17280.75,18280.75,4480.80,12799.96,0.35,1
57535,5750,1000.00,18280.75,19280.75,0.00,18280.75,0.33,1
57536,5750,1000.00,19280.75,20280.75,0.00,16492.04,0.35,1
57537,5750,1000.00,20280.75,21280.75,5776.08,9690.25,0.27,1
57538,5750,0.00,20280.75,21280.75,0.00,0.00,0.03,0
57539,5750,-1000.00,19280.75,20280.75,21280.75,0.00,0.01,0
57540,5750,-1000.00,18280.75,19280.75,0.00,14305.76,0.12,0
57541,5750,-1000.00,17280.75,18280.75,7728.43,10055.75,0.24,0
57542,5750,-1000.00,16280.75,17280.75,4057.21,0.00,0.03,0
57543,5750,-1000.00,15280.75,16280.75,4849.45,1512.48,0.29,0
57544,5750,-1000.00,14280.75,15280.75,3478.75,0.00,0.28,0
57545,5750,-1000.00,13280.75,14280.75,3110.27,12170.48,0.40,0
57546,5750,-1000.00,12280.75,13280.75,6925.72,7355.04,0.23,0
57547,5750,-1000.00,11280.75,12280.75,8603.90,0.00,0.01,0
57548,5750,-1000.00,10280.75,11280.75,0.00,7061.84,0.32,0
57549,5750,-1000.00,9280.75,10280.75,0.00,9133.69,0.20,0
57550,5750,-1000.00,8280.75,9280.75,1265.13,9015.63,0.33,0
57551,5750,-1000.00,7280.75,8280.75,3994.99,4331.15,0.23,0
57552,5750,-1000.00,6280.75,7280.75,0.00,7492.67,0.41,0
57553,5750,-1000.00,5280.75,6280.75,1611.07,5669.69,0.24,0
57554,5750,-1000.00,4280.75,5280.75,0.00,6280.75,0.03,0
57555,5750,-1000.00,3280.75,4280.75,0.00,3197.78,0.41,0
57556,5750,-1000.00,2280.75,3280.75,0.00,2504.25,0.09,0
57557,5751,-441.46,-441.46,558.54,0.00,441.46,0.20,0
57558,5751,-558.54,-1000.00,0.00,0.00,558.54,0.26,0
57559,5752,-1000.00,-1000.00,0.00,0.00,724.88,0.39,0
57560,5753,-1000.00,-1000.00,0.00,325.69,674.31,0.04,0
57561,5753,-0.00,-1000.00,0.00,0.00,0.00,0.01,0
57562,5754,-1000.00,-1000.00,0.00,0.00,1000.00,0.25,0
57563,5755,-1000.00,-1000.00,0.00,0.00,82.13,0.40,0
57564,5756,-1000.00,-1000.00,0.00,252.55,747.45,0.36,0
57565,5757,1000.00,1000.00,2000.00,102.28,897.72,0.09,1
57566,5757,1000.00,2000.00,3000.00,0.00,2000.00,0.33,1
57567,5757,1000.00,3000.00,4000.00,469.77,814.10,0.20,1
57568,5757,1000.00,4000.00,5000.00,898.13,3101.87,0.37,1
57569,5757,1000.00,5000.00,6000.00,410.26,4589.74,0.21,1
57570,5757,1000.00,6000.00,7000.00,2423.03,3576.97,0.22,1
57571,5757,1000.00,7000.00,8000.00,3082.57,3917.43,0.18,1
57572,5757,1000.00,8000.00,9000.00,0.00,8000.00,0.22,1
57573,5757,1000.00,9000.00,10000.00,0.00,9000.00,0.19,1
57574,5757,1000.00,10000.00,11000.00,1996.47,8003.53,0.07,1
57575,5757,1000.00,11000.00,12000.00,639.08,7394.97,0.38,1
57576,5757,1000.00,12000.00,13000.00,0.00,4155.03,0.22,1
57577,5757,1000.00,13000.00,14000.00,5455.61,7544.39,0.27,1
57578,5757,1000.00,14000.00,15000.00,6589.07,7410.93,0.01,1
57579,5757,1000.00,15000.00,16000.00,0.00,6775.28,0.24,1
57580,5757,1000.00,16000.00,17000.00,4565.98,11434.02,0.36,1
57581,5757,1000.00,17000.00,18000.00,6132.53,10867.47,0.28,1
57582,5757,1000.00,18000.00,19000.00,7132.93,10867.07,0.15,1
57583,5757,-1000.00,17000.00,18000.00,0.00,4154.69,0.19,0
57584,5757,-1000.00,16000.00,17000.00,0.00,18000.00,0.16,0
57585,5757,-1000.00,15000.00,16000.00,0.00,2655.42,0.09,0
57586,5757,-1000.00,14000.00,15000.00,7691.46,8308.54,0.07,0
57587,5757,-1000.00,13000.00,14000.00,11213.18,3786.82,0.03,0
57588,5757,-1000.00,12000.00,13000.00,0.00,11750.76,0.38,0
57589,5757,-1000.00,11000.00,12000.00,0.00,3118.27,0.18,0
57590,5757,-1000.00,10000.00,11000.00,0.00,12000.00,0.31,0
57591,5757,-950.06,9049.94,10049.94,58.04,892.02,0.14,0
57592,5757,-1000.00,8049.94,9049.94,3665.43,6384.51,0.22,0
57593,5757,-1000.00,7049.94,8049.94,0.00,7848.85,0.36,0
57594,5757,-1000.00,6049.94,7049.94,57.73,4493.02,0.34,0
57595,5757,-1000.00,5049.94,6049.94,2489.47,4560.47,0.27,0
57596,5757,-1000.00,4049.94,5049.94,1124.64,4925.30,0.10,0
57597,5757,-1000.00,3049.94,4049.94,349.81,4700.13,0.35,0
57598,5757,-401.32,2648.62,3648.62,0.00,401.32,0.07,0
57599,5757,-1000.00,1648.62,2648.62,193.40,3455.22,0.43,0
57600,5757,-1000.00,648.62,1648.62,0.00,2648.62,0.42,0
57601,5757,-1000.00,-351.38,648.62,292.50,113.39,0.13,0
57602,5757,1000.00,648.62,1648.62,259.98,388.64,0.22,1
57603,5757,1000.00,1648.62,2648.62,0.00,1648.62,0.43,1
57604,5757,1000.00,2648.62,3648.62,0.00,1299.72,0.27,1
57605,5757,1000.00,3648.62,4648.62,0.00,765.32,0.11,1
57606,5757,-1000.00,2648.62,3648.62,2672.60,1976.02,0.08,0
57607,5757,1000.00,3648.62,4648.62,395.59,1491.35,0.27,1
57608,5757,1000.00,4648.62,5648.62,0.00,4648.62,0.24,1
57609,5757,1000.00,5648.62,6648.62,0.00,5648.62,0.11,1
57610,5757,-1000.00,4648.62,5648.62,4589.28,2059.34,0.08,0
57611,5757,1000.00,5648.62,6648.62,0.00,5648.62,0.04,1
57612,5757,1000.00,6648.62,7648.62,0.00,6648.62,0.12,1
57613,5757,1000.00,7648.62,8648.62,1657.68,5990.94,0.31,1
57614,5757,1000.00,8648.62,9648.62,1267.79,7380.83,0.42,1
57615,5757,1000.00,9648.62,10648.62,3964.09,5330.29,0.26,1
57616,5757,1000.00,10648.62,11648.62,775.51,9873.11,0.39,1
57617,5757,1000.00,11648.62,12648.62,2371.70,9276.92,0.40,1
57618,5757,1000.00,12648.62,13648.62,1982.55,6459.94,0.31,1
57619,5758,-1000.00,-1000.00,0.00,688.85,300.45,0.12,0
57620,5759,1000.00,1000.00,2000.00,273.42,693.80,0.35,1
57621,5759,1000.00,2000.00,3000.00,921.93,1078.07,0.02,1
57622,5759,1000.00,3000.00,4000.00,590.01,2409.99,0.27,1
57623,5759,1000.00,4000.00,5000.00,639.10,3360.90,0.29,1
57624,5759,1000.00,5000.00,6000.00,0.00,5000.00,0.25,1
57625,5759,1000.00,6000.00,7000.00,2269.17,3730.83,0.09,1
57626,5759,1000.00,7000.00,8000.00,1632.15,2221.54,0.21,1
57627,5759,1000.00,8000.00,9000.00,4000.00,4000.00,0.10,1
57628,5759,1000.00,9000.00,10000.00,0.00,9000.00,0.22,1
57629,5759,1000.00,10000.00,11000.00,0.00,10000.00,0.17,1
57630,5759,1000.00,11000.00,12000.00,0.00,11000.00,0.26,1
57631,5759,1000.00,12000.00,13000.00,0.00,12000.00,0.21,1
57632,5759,1000.00,13000.00,14000.00,1984.47,8597.76,0.37,1
57633,5759,-1000.00,12000.00,13000.00,11760.91,1355.78,0.05,0
57634,5759,1000.00,13000.00,14000.00,0.00,13000.00,0.13,1
57635,5759,1000.00,14000.00,15000.00,0.00,14000.00,0.26,1
57636,5759,1000.00,15000.00,16000.00,725.54,14274.46,0.13,1
57637,5759,1000.00,16000.00,17000.00,0.00,16000.00,0.02,1
57638,5759,0.00,16000.00,17000.00,0.00,0.00,0.03,0
57639,5759,1000.00,17000.00,18000.00,0.00,2492.35,0.16,1
57640,5759,1000.00,18000.00,19000.00,4633.39,13366.61,0.35,1
57641,5759,1000.00,19000.00,20000.00,417.74,18582.26,0.24,1
57642,5759,1000.00,20000.00,21000.00,0.00,19169.95,0.44,1
57643,5759,0.00,20000.00,21000.00,0.00,0.00,0.02,0
57644,5759,-1000.00,19000.00,20000.00,0.00,18190.14,0.42,0
57645,5759,-1000.00,18000.00,19000.00,0.00,6454.43,0.04,0
57646,5759,-846.02,17153.98,18153.98,0.00,846.02,0.12,0
57647,5759,-1000.00,16153.98,17153.98,1088.81,14713.34,0.42,0
57648,5759,-1000.00,15153.98,16153.98,0.00,16381.09,0.07,0
57649,5759,-1000.00,14153.98,15153.98,2464.03,13689.95,0.16,0
57650,5759,-857.67,13296.31,14296.31,0.00,857.67,0.08,0
57651,5759,-1000.00,12296.31,13296.31,7689.50,6606.81,0.18,0
57652,5759,-1000.00,11296.31,12296.31,5796.64,7499.67,0.19,0
57653,5759,-1000.00,10296.31,11296.31,855.23,11441.08,0.42,0
57654,5759,-1000.00,9296.31,10296.31,3862.77,7156.65,0.31,0
57655,5759,-370.30,8926.01,9926.01,0.00,370.30,0.10,0
57656,5759,-1000.00,7926.01,8926.01,362.06,9563.95,0.44,0
57657,5759,-1000.00,6926.01,7926.01,0.00,2169.46,0.20,0
57658,5759,-1000.00,5926.01,6926.01,7243.54,0.00,0.01,0
57659,5759,-1000.00,4926.01,5926.01,0.00,6044.28,0.07,0
57660,5759,-1000.00,3926.01,4926.01,2484.16,3441.85,0.09,0
57661,5759,-1000.00,2926.01,3926.01,0.00,2069.83,0.28,0
57662,5759,-1000.00,1926.01,2926.01,0.00,3926.01,0.17,0
57663,5759,-1000.00,926.01,1926.01,147.68,2213.79,0.41,0
57664,5759,-1000.00,-73.99,926.01,308.29,1617.72,0.42,0
57665,5759,-1000.00,-1073.99,-73.99,599.67,326.34,0.00,0
57666,5760,-1000.00,-1000.00,0.00,559.88,440.12,0.17,0
57667,5761,1000.00,1000.00,2000.00,389.77,610.23,0.28,1
57668,5761,1000.00,2000.00,3000.00,0.00,830.75,0.21,1
57669,5761,-1000.00,1000.00,2000.00,1414.37,1094.10,0.19,0
57670,5761,1000.00,2000.00,3000.00,110.83,1889.17,0.31,1
57671,5761,1000.00,3000.00,4000.00,909.23,2090.77,0.19,1
57672,5761,1000.00,4000.00,5000.00,1510.23,2489.77,0.26,1
57673,5761,1000.00,5000.00,6000.00,0.00,5000.00,0.16,1
57674,5761,1000.00,6000.00,7000.00,697.37,936.53,0.16,1
57675,5761,1000.00,7000.00,8000.00,729.32,6270.68,0.32,1
57676,5761,1000.00,8000.00,9000.00,1286.20,6713.80,0.37,1
57677,5761,1000.00,9000.00,10000.00,0.00,4838.58,0.31,1
57678,5761,1000.00,10000.00,11000.00,0.00,7317.82,0.38,1
57679,5761,0.00,10000.00,11000.00,0.00,0.00,0.08,0
57680,5761,-1000.00,9000.00,10000.00,0.00,11000.00,0.44,0
57681,5761,-1000.00,8000.00,9000.00,5000.00,5000.00,0.02,0
57682,5761,-1000.00,7000.00,8000.00,0.00,9000.00,0.35,0
57683,5761,-1000.00,6000.00,7000.00,0.00,8000.00,0.32,0
57684,5761,-1000.00,5000.00,6000.00,0.00,7000.00,0.11,0
57685,5761,-1000.00,4000.00,5000.00,0.00,2274.76,0.01,0
57686,5761,-1000.00,3000.00,4000.00,801.72,4198.28,0.42,0
57687,5761,-1000.00,2000.00,3000.00,0.00,3027.90,0.38,0
57688,5761,-525.47,1474.53,2474.53,0.00,525.47,0.01,0
57689,5761,0.00,1474.53,2474.53,0.00,0.00,0.12,0
57690,5761,0.00,1474.53,2474.53,0.00,0.00,0.13,0
57691,5761,-1000.00,474.53,1474.53,0.00,2474.53,0.24,0
57692,5761,-1000.00,-525.47,474.53,0.00,1474.53,0.38,0
57693,5761,-474.53,-1000.00,0.00,0.00,474.53,0.06,0
57694,5762,-1000.00,-1000.00,0.00,404.86,595.14,0.17,0
57695,5763,0.00,0.00,1000.00,0.00,0.00,0.13,0
57696,5763,0.00,0.00,1000.00,0.00,0.00,0.36,0
57697,5763,-1000.00,-1000.00,0.00,0.00,1000.00,0.09,0
57698,5764,-1000.00,-1000.00,0.00,435.73,564.27,0.04,0
57699,5765,1000.00,1000.00,2000.00,500.00,500.00,0.02,1
57700,5765,1000.00,2000.00,3000.00,0.00,782.43,0.26,1
57701,5765,0.00,2000.00,3000.00,0.00,0.00,0.02,0
57702,5765,1000.00,3000.00,4000.00,327.41,2672.59,0.42,1
57703,5765,1000.00,4000.00,5000.00,0.00,2977.27,0.26,1
57704,5765,1000.00,5000.00,6000.00,0.00,742.84,0.12,1
57705,5765,1000.00,6000.00,7000.00,0.00,6000.00,0.06,1
57706,5765,1000.00,7000.00,8000.00,0.00,1915.42,0.09,1
57707,5765,1000.00,8000.00,9000.00,0.00,8000.00,0.15,1
57708,5765,1000.00,9000.00,10000.00,0.00,4252.22,0.26,1
57709,5765,1000.00,10000.00,11000.00,0.00,10000.00,0.14,1
57710,5765,1000.00,11000.00,12000.00,0.00,11000.00,0.30,1
57711,5765,1000.00,12000.00,13000.00,0.00,11253.03,0.42,1
57712,5765,1000.00,13000.00,14000.00,3772.90,9227.10,0.35,1
57713,5765,1000.00,14000.00,15000.00,0.00,12636.42,0.42,1
57714,5765,1000.00,15000.00,16000.00,0.00,11954.73,0.36,1
57715,5765,-1000.00,14000.00,15000.00,16000.00,0.00,0.01,0
57716,5765,1000.00,15000.00,16000.00,0.00,3936.31,0.15,1
57717,5765,-1000.00,14000.00,15000.00,10574.40,5425.60,0.11,0
57718,5765,1000.00,15000.00,16000.00,6226.69,8773.31,0.06,1
57719,5765,1000.00,16000.00,17000.00,5081.37,10918.63,0.16,1
57720,5765,1000.00,17000.00,18000.00,6119.47,10880.53,0.30,1
57721,5765,1000.00,18000.00,19000.00,2379.80,15620.20,0.20,1
57722,5765,-1000.00,17000.00,18000.00,6403.88,5027.13,0.18,0
57723,5765,1000.00,18000.00,19000.00,0.00,18000.00,0.21,1
57724,5765,1000.00,19000.00,20000.00,0.00,19000.00,0.02,1
57725,5765,1000.00,20000.00,21000.00,0.00,20000.00,0.17,1
57726,5765,1000.00,21000.00,22000.00,4429.23,16570.77,0.40,1
57727,5765,1000.00,22000.00,23000.00,0.00,22000.00,0.27,1
57728,5765,1000.00,23000.00,24000.00,0.00,23000.00,0.21,1
57729,5765,1000.00,24000.00,25000.00,430.50,23569.50,0.15,1
57730,5765,1000.00,25000.00,26000.00,12500.00,12500.00,0.04,1
57731,5765,1000.00,26000.00,27000.00,5298.51,20701.49,0.31,1
57732,5765,1000.00,27000.00,28000.00,11814.39,15185.61,0.05,1
57733,5765,1000.00,28000.00,29000.00,1034.62,3117.93,0.15,1
57734,5765,1000.00,29000.00,30000.00,0.00,26338.99,0.00,1
57735,5765,-1000.00,28000.00,29000.00,3616.23,0.00,0.09,0
57736,5766,-1000.00,-1000.00,0.00,0.00,1000.00,0.29,0
57737,5767,1000.00,1000.00,2000.00,0.00,1000.00,0.24,1
57738,5767,1000.00,2000.00,3000.00,0.00,2000.00,0.02,1
57739,5767,1000.00,3000.00,4000.00,631.36,1109.41,0.24,1
57740,5767,1000.00,4000.00,5000.00,2000.00,2000.00,0.08,1
57741,5767,1000.00,5000.00,6000.00,0.00,5000.00,0.44,1
57742,5767,1000.00,6000.00,7000.00,0.00,6000.00,0.37,1
57743,5767,1000.00,7000.00,8000.00,0.00,3466.45,0.30,1
57744,5767,1000.00,8000.00,9000.00,2648.13,5351.87,0.34,1
57745,5767,1000.00,9000.00,10000.00,0.00,5153.86,0.18,1
57746,5767,1000.00,10000.00,11000.00,1689.30,8310.70,0.38,1
57747,5767,1000.00,11000.00,12000.00,3514.48,7485.52,0.34,1
57748,5767,1000.00,12000.00,13000.00,0.00,12000.00,0.43,1
57749,5767,1000.00,13000.00,14000.00,4954.43,8045.57,0.25,1
57750,5767,1000.00,14000.00,15000.00,1681.35,12318.65,0.43,1
57751,5767,1000.00,15000.00,16000.00,0.00,15000.00,0.23,1
57752,5767,1000.00,16000.00,17000.00,0.00,7518.05,0.30,1
57753,5767,-1000.00,15000.00,16000.00,12311.98,2974.51,0.08,0
57754,5767,1000.00,16000.00,17000.00,5295.51,10704.49,0.21,1
57755,5767,-1000.00,15000.00,16000.00,12146.15,4853.85,0.05,0
57756,5767,1000.00,16000.00,17000.00,0.00,8663.48,0.22,1
57757,5767,1000.00,17000.00,18000.00,0.00,15824.29,0.09,1
57758,5767,1000.00,18000.00,19000.00,0.00,18000.00,0.16,1
57759,5767,1000.00,19000.00,20000.00,5579.10,12995.03,0.34,1
57760,5767,1000.00,20000.00,21000.00,0.00,20000.00,0.16,1
57761,5767,1000.00,21000.00,22000.00,0.00,5055.55,0.15,1
57762,5767,1000.00,22000.00,23000.00,9938.43,12061.57,0.17,1
57763,5767,1000.00,23000.00,24000.00,0.00,23000.00,0.02,1
57764,5767,1000.00,24000.00,25000.00,12000.00,12000.00,0.06,1
57765,5767,1000.00,25000.00,26000.00,5458.27,19541.73,0.28,1
57766,5767,1000.00,26000.00,27000.00,0.00,10160.37,0.25,1
57767,5767,1000.00,27000.00,28000.00,1882.32,25117.68,0.10,1
57768,5767,1000.00,28000.00,29000.00,0.00,28000.00,0.38,1
57769,5767,1000.00,29000.00,30000.00,3897.55,25102.45,0.42,1
57770,5767,1000.00,30000.00,31000.00,0.00,30000.00,0.35,1
57771,5767,1000.00,31000.00,32000.00,13967.12,17032.88,0.12,1
57772,5767,1000.00,32000.00,33000.00,8349.95,23650.05,0.23,1
57773,5767,-1000.00,31000.00,32000.00,19139.81,13860.19,0.09,0
57774,5767,1000.00,32000.00,33000.00,0.00,20350.86,0.23,1
57775,5767,1000.00,33000.00,34000.00,2448.28,30551.72,0.44,1
57776,5767,1000.00,34000.00,35000.00,0.00,10047.24,0.08,1
57777,5767,-1000.00,33000.00,34000.00,20121.51,14878.49,0.11,0
57778,5768,-876.05,-876.05,123.95,31.75,844.30,0.43,0
57779,5768,-123.95,-1000.00,0.00,30.77,93.18,0.21,0
57780,5769,-1000.00,-1000.00,0.00,591.44,408.56,0.13,0
57781,5770,-1000.00,-1000.00,0.00,500.00,500.00,0.01,0
57782,5771,-1000.00,-1000.00,0.00,0.00,1000.00,0.19,0
57783,5772,-1000.00,-1000.00,0.00,281.19,718.81,0.36,0
57784,5773,-774.61,-774.61,225.39,0.00,774.61,0.15,0
57785,5773,-225.39,-1000.00,0.00,51.01,174.38,0.39,0
57786,5774,-633.82,-633.82,366.18,0.00,633.82,0.36,0
57787,5774,-366.18,-1000.00,0.00,0.00,366.18,0.08,0
57788,5775,-325.73,-325.73,674.27,0.00,325.73,0.38,0
57789,5775,-674.27,-1000.00,0.00,220.35,453.91,0.02,0
57790,5776,0.00,0.00,1000.00,0.00,0.00,0.01,0
57791,5776,1000.00,1000.00,2000.00,0.00,1000.00,0.33,1
57792,5776,1000.00,2000.00,3000.00,0.00,545.96,0.11,1
57793,5776,1000.00,3000.00,4000.00,0.00,3000.00,0.43,1
57794,5776,1000.00,4000.00,5000.00,1119.76,2853.89,0.35,1
57795,5776,1000.00,5000.00,6000.00,0.00,5000.00,0.42,1
57796,5776,1000.00,6000.00,7000.00,0.00,1543.36,0.12,1
57797,5776,1000.00,7000.00,8000.00,0.00,7000.00,0.27,1
57798,5776,1000.00,8000.00,9000.00,2492.28,5507.72,0.35,1
57799,5776,1000.00,9000.00,10000.00,0.00,8637.84,0.07,1
57800,5776,1000.00,10000.00,11000.00,2343.09,7656.91,0.38,1
57801,5776,1000.00,11000.00,12000.00,0.00,2194.69,0.17,1
57802,5776,1000.00,12000.00,13000.00,0.00,12000.00,0.20,1
57803,5776,1000.00,13000.00,14000.00,0.00,7273.16,0.27,1
57804,5776,1000.00,14000.00,15000.00,2436.30,11563.70,0.30,1
57805,5776,1000.00,15000.00,16000.00,0.00,11354.04,0.41,1
57806,5776,-1000.00,14000.00,15000.00,9113.13,6886.87,0.06,0
57807,5776,1000.00,15000.00,16000.00,3685.16,11314.84,0.38,1
57808,5776,1000.00,16000.00,17000.00,4275.92,11724.08,0.34,1
57809,5776,1000.00,17000.00,18000.00,0.00,17000.00,0.21,1
57810,5776,1000.00,18000.00,19000.00,0.00,18000.00,0.36,1
57811,5776,-1000.00,17000.00,18000.00,0.00,19000.00,0.07,0
57812,5776,-1000.00,16000.00,17000.00,0.00,11434.79,0.26,0
57813,5776,-1000.00,15000.00,16000.00,9454.15,1220.84,0.09,0
57814,5776,-1000.00,14000.00,15000.00,0.00,16000.00,0.10,0
57815,5776,-1000.00,13000.00,14000.00,6116.48,8883.52,0.22,0
57816,5776,-1000.00,12000.00,13000.00,8781.68,5218.32,0.10,0
57817,5776,-1000.00,11000.00,12000.00,0.00,13000.00,0.27,0
57818,5776,-1000.00,10000.00,11000.00,6017.24,5982.76,0.04,0
57819,5776,-1000.00,9000.00,10000.00,6601.50,4398.50,0.14,0
57820,5776,-1000.00,8000.00,9000.00,0.00,6457.30,0.29,0
57821,5776,-1000.00,7000.00,8000.00,0.00,9000.00,0.25,0
57822,5776,-1000.00,6000.00,7000.00,2129.86,5870.14,0.27,0
57823,5776,-1000.00,5000.00,6000.00,0.00,7000.00,0.05,0
57824,5776,-1000.00,4000.00,5000.00,2184.86,0.00,0.05,0
57825,5776,-1000.00,3000.00,4000.00,0.00,5000.00,0.20,0
57826,5776,-735.82,2264.18,3264.18,0.00,735.82,0.17,0
57827,5776,-1000.00,1264.18,2264.18,3264.18,0.00,0.00,0
57828,5776,-1000.00,264.18,1264.18,465.71,1798.48,0.40,0
57829,5776,-1000.00,-735.82,264.18,313.87,950.31,0.29,0
57830,5776,-264.18,-1000.00,0.00,0.00,264.18,0.16,0
57831,5777,0.00,0.00,1000.00,0.00,0.00,0.20,0
57832,5777,-1000.00,-1000.00,0.00,0.00,292.51,0.14,0
57833,5778,1000.00,1000.00,2000.00,0.00,770.63,0.40,1
57834,5778,1000.00,2000.00,3000.00,0.00,1080.34,0.33,1
57835,5778,1000.00,3000.00,4000.00,1500.00,1500.00,0.07,1
57836,5778,1000.00,4000.00,5000.00,0.00,620.49,0.14,1
57837,5778,1000.00,5000.00,6000.00,0.00,2909.44,0.01,1
57838,5778,0.00,5000.00,6000.00,0.00,0.00,0.02,0
57839,5778,1000.00,6000.00,7000.00,0.00,4772.52,0.34,1
57840,5778,1000.00,7000.00,8000.00,0.00,5558.75,0.30,1
57841,5778,1000.00,8000.00,9000.00,0.00,8000.00,0.17,1
57842,5778,1000.00,9000.00,10000.00,4333.95,4666.05,0.13,1
57843,5778,1000.00,10000.00,11000.00,370.47,9629.53,0.01,1
57844,5778,1000.00,11000.00,12000.00,1666.88,9333.12,0.36,1
57845,5778,-1000.00,10000.00,11000.00,4933.49,4414.86,0.20,0
57846,5778,1000.00,11000.00,12000.00,0.00,11000.00,0.15,1
57847,5778,1000.00,12000.00,13000.00,0.00,12000.00,0.21,1
57848,5778,1000.00,13000.00,14000.00,2214.97,10785.03,0.39,1
57849,5778,-1000.00,12000.00,13000.00,13195.99,0.00,0.01,0
57850,5778,1000.00,13000.00,14000.00,4189.44,8810.56,0.28,1
57851,5778,-1000.00,12000.00,13000.00,1108.68,0.00,0.08,0
57852,5778,1000.00,13000.00,14000.00,2978.18,10021.82,0.10,1
57853,5778,1000.00,14000.00,15000.00,7000.00,7000.00,0.01,1
57854,5778,1000.00,15000.00,16000.00,591.10,14408.90,0.40,1
57855,5778,1000.00,16000.00,17000.00,0.00,16000.00,0.42,1
57856,5778,-1000.00,15000.00,16000.00,5068.21,11931.79,0.31,0
57857,5778,-1000.00,14000.00,15000.00,1434.66,761.93,0.12,0
57858,5778,-1000.00,13000.00,14000.00,8957.63,6042.37,0.16,0
57859,5778,-1000.00,12000.00,13000.00,0.00,14000.00,0.11,0
57860,5778,-1000.00,11000.00,12000.00,4228.57,8771.43,0.30,0
57861,5778,-1000.00,10000.00,11000.00,0.00,11658.94,0.42,0
57862,5778,-1000.00,9000.00,10000.00,0.00,7686.43,0.30,0
57863,5778,-1000.00,8000.00,9000.00,7136.28,2863.72,0.02,0
57864,5778,-1000.00,7000.00,8000.00,618.84,8381.16,0.44,0
57865,5778,-1000.00,6000.00,7000.00,0.00,6495.57,0.35,0
57866,5778,-1000.00,5000.00,6000.00,1596.58,5403.42,0.12,0
57867,5778,-1000.00,4000.00,5000.00,141.64,5152.54,0.43,0
57868,5778,-1000.00,3000.00,4000.00,269.73,1148.95,0.19,0
57869,5778,-1000.00,2000.00,3000.00,1936.73,2063.27,0.07,0
57870,5778,-1000.00,1000.00,2000.00,591.97,474.94,0.16,0
57871,5778,-1000.00,0.00,1000.00,992.70,1007.30,0.16,0
57872,5778,-1000.00,-1000.00,0.00,0.00,1000.00,0.04,0
57873,5779,-1000.00,-1000.00,0.00,0.00,333.83,0.23,0
57874,5780,-1000.00,-1000.00,0.00,640.78,359.22,0.15,0
57875,5781,-1000.00,-1000.00,0.00,0.00,1000.00,0.22,0
57876,5782,1000.00,1000.00,2000.00,278.16,23.19,0.40,1
57877,5782,-1000.00,0.00,1000.00,890.24,1109.76,0.13,0
57878,5782,-494.48,-494.48,505.52,0.00,494.48,0.11,0
57879,5782,-80.08,-574.55,425.45,0.00,80.08,0.04,0
57880,5782,1000.00,425.45,1425.45,49.75,0.00,0.04,1
57881,5782,-1000.00,-574.55,425.45,0.00,1150.91,0.43,0
57882,5782,1000.00,425.45,1425.45,233.27,192.18,0.05,1
57883,5782,-1000.00,-574.55,425.45,420.93,1004.52,0.35,0
57884,5782,1000.00,425.45,1425.45,98.25,0.00,0.01,1
57885,5782,1000.00,1425.45,2425.45,1068.46,356.99,0.02,1
57886,5782,-1000.00,425.45,1425.45,1212.72,1212.72,0.09,0
57887,5782,-1000.00,-574.55,425.45,712.72,712.72,0.05,0
57888,5782,0.00,-574.55,425.45,0.00,0.00,0.05,0
57889,5782,-425.45,-1000.00,0.00,0.00,425.45,0.10,0
57890,5783,-1000.00,-1000.00,0.00,149.32,850.68,0.42,0
57891,5784,-1000.00,-1000.00,0.00,56.28,943.72,0.42,0
57892,5785,1000.00,1000.00,2000.00,715.45,284.55,0.02,1
57893,5785,-1000.00,0.00,1000.00,574.59,1425.41,0.20,0
57894,5785,-807.68,-807.68,192.32,358.36,449.32,0.24,0
57895,5785,-79.47,-887.14,112.86,15.62,63.85,0.24,0
57896,5785,-10.41,-897.56,102.44,0.00,10.41,0.17,0
57897,5785,-65.66,-963.22,36.78,28.60,37.06,0.39,0
57898,5785,-36.78,-1000.00,0.00,0.00,36.78,0.15,0
57899,5786,-1000.00,-1000.00,0.00,653.18,346.82,0.05,0
57900,5787,1000.00,1000.00,2000.00,0.00,1000.00,0.37,1
57901,5787,1000.00,2000.00,3000.00,954.16,1045.84,0.09,1
57902,5787,1000.00,3000.00,4000.00,0.00,2319.58,0.22,1
57903,5787,1000.00,4000.00,5000.00,0.00,2034.77,0.17,1
57904,5787,1000.00,5000.00,6000.00,0.00,4203.50,0.27,1
57905,5787,1000.00,6000.00,7000.00,0.00,6000.00,0.19,1
57906,5787,1000.00,7000.00,8000.00,1157.40,5297.95,0.42,1
57907,5787,-1000.00,6000.00,7000.00,4148.33,3851.67,0.06,0
57908,5787,1000.00,7000.00,8000.00,0.00,4801.37,0.05,1
57909,5787,1000.00,8000.00,9000.00,967.15,7032.85,0.41,1
57910,5787,-1000.00,7000.00,8000.00,4642.30,4357.70,0.20,0
57911,5787,1000.00,8000.00,9000.00,0.00,8000.00,0.20,1
57912,5787,1000.00,9000.00,10000.00,2712.15,6287.85,0.19,1
57913,5787,1000.00,10000.00,11000.00,2035.33,7964.67,0.18,1
57914,5787,1000.00,11000.00,12000.00,0.00,11000.00,0.31,1
57915,5787,1000.00,12000.00,13000.00,4651.58,7348.42,0.12,1
57916,5787,1000.00,13000.00,14000.00,0.00,13000.00,0.44,1
57917,5787,1000.00,14000.00,15000.00,3518.06,10481.94,0.24,1
57918,5787,1000.00,15000.00,16000.00,5515.33,9484.67,0.20,1
57919,5787,-1000.00,14000.00,15000.00,0.00,11423.71,0.20,0
57920,5787,-1000.00,13000.00,14000.00,0.00,15000.00,0.08,0
57921,5787,-1000.00,12000.00,13000.00,5245.31,8016.46,0.28,0
57922,5787,-1000.00,11000.00,12000.00,3369.86,0.00,0.09,0
57923,5787,-1000.00,10000.00,11000.00,0.00,12000.00,0.01,0
57924,5787,-1000.00,9000.00,10000.00,0.00,8130.91,0.19,0
57925,5787,-1000.00,8000.00,9000.00,0.00,10000.00,0.44,0
57926,5787,-1000.00,7000.00,8000.00,2213.02,6786.98,0.38,0
57927,5787,-1000.00,6000.00,7000.00,0.00,6517.53,0.39,0
57928,5787,-1000.00,5000.00,6000.00,0.00,5972.57,0.00,0
57929,5787,-1000.00,4000.00,5000.00,1842.99,4157.01,0.35,0
57930,5787,-1000.00,3000.00,4000.00,634.27,2650.94,0.32,0
57931,5787,-1000.00,2000.00,3000.00,1559.23,2440.77,0.27,0
57932,5787,-1000.00,1000.00,2000.00,1683.37,1316.63,0.05,0
57933,5787,-1000.00,0.00,1000.00,1217.93,782.07,0.12,0
57934,5787,-1000.00,-1000.00,0.00,0.00,1000.00,0.24,0
57935,5788,-1000.00,-1000.00,0.00,258.57,741.43,0.25,0
57936,5789,-1000.00,-1000.00,0.00,0.00,1000.00,0.44,0
57937,5790,-1000.00,-1000.00,0.00,299.07,0.00,0.30,0
57938,5791,-1000.00,-1000.00,0.00,0.00,1000.00,0.19,0
57939,5792,-628.07,-628.07,371.93,417.08,210.99,0.33,0
57940,5792,-1000.00,-1628.07,-628.07,0.00,329.69,0.14,0
57941,5793,-1000.00,-1000.00,0.00,0.00,1000.00,0.22,0
57942,5794,-1000.00,-1000.00,0.00,106.90,547.47,0.33,0
57943,5795,-1000.00,-1000.00,0.00,30.25,969.75,0.43,0
57944,5796,-1000.00,-1000.00,0.00,0.00,829.73,0.22,0
57945,5797,-1000.00,-1000.00,0.00,517.52,482.48,0.19,0
57946,5798,1000.00,1000.00,2000.00,204.68,0.00,0.41,1
57947,5798,1000.00,2000.00,3000.00,222.19,0.00,0.13,1
57948,5798,-1000.00,1000.00,2000.00,703.33,2296.67,0.25,0
57949,5798,-676.54,323.46,1323.46,0.00,676.54,0.31,0
57950,5798,-1000.00,-676.54,323.46,0.00,1112.19,0.40,0
57951,5798,1000.00,323.46,1323.46,323.46,0.00,0.02,1
57952,5798,0.00,323.46,1323.46,0.00,0.00,0.03,0
57953,5798,-1000.00,-676.54,323.46,0.00,1175.11,0.42,0
57954,5798,-323.46,-1000.00,0.00,0.00,323.46,0.12,0
57955,5799,-1000.00,-1000.00,0.00,29.99,970.01,0.43,0
57956,5800,-70.12,-70.12,929.88,70.12,0.00,0.36,0
57957,5800,-1000.00,-1070.12,-70.12,72.20,857.68,0.07,0
57958,5801,-1000.00,-1000.00,0.00,365.73,634.27,0.24,0
57959,5802,1000.00,1000.00,2000.00,0.00,1000.00,0.42,1
57960,5802,1000.00,2000.00,3000.00,0.00,2000.00,0.22,1
57961,5802,1000.00,3000.00,4000.00,646.51,664.35,0.18,1
57962,5802,1000.00,4000.00,5000.00,1125.13,2874.87,0.37,1
57963,5802,1000.00,5000.00,6000.00,0.00,5000.00,0.28,1
57964,5802,1000.00,6000.00,7000.00,0.00,6000.00,0.07,1
57965,5802,1000.00,7000.00,8000.00,0.00,7000.00,0.27,1
57966,5802,1000.00,8000.00,9000.00,3920.00,4080.00,0.02,1
57967,5802,1000.00,9000.00,10000.00,1853.11,7146.89,0.30,1
57968,5802,1000.00,10000.00,11000.00,296.89,2913.45,0.22,1
57969,5802,1000.00,11000.00,12000.00,0.00,11000.00,0.22,1
57970,5802,0.00,11000.00,12000.00,0.00,0.00,0.09,0
57971,5802,1000.00,12000.00,13000.00,0.00,12000.00,0.32,1
57972,5802,1000.00,13000.00,14000.00,5801.44,7198.56,0.17,1
57973,5802,1000.00,14000.00,15000.00,0.00,14000.00,0.22,1
57974,5802,1000.00,15000.00,16000.00,3201.11,11798.89,0.33,1
57975,5802,1000.00,16000.00,17000.00,986.60,11927.33,0.40,1
57976,5802,1000.00,17000.00,18000.00,0.00,17000.00,0.40,1
57977,5802,1000.00,18000.00,19000.00,8984.06,9015.94,0.11,1
57978,5802,1000.00,19000.00,20000.00,0.00,19000.00,0.17,1
57979,5802,1000.00,20000.00,21000.00,9899.82,10100.18,0.09,1
57980,5802,1000.00,21000.00,22000.00,0.00,5697.79,0.21,1
57981,5802,1000.00,22000.00,23000.00,1685.94,20314.06,0.22,1
57982,5802,1000.00,23000.00,24000.00,0.00,6789.84,0.17,1
57983,5802,1000.00,24000.00,25000.00,0.00,15871.92,0.28,1
57984,5802,1000.00,25000.00,26000.00,2864.03,22135.97,0.21,1
57985,5802,1000.00,26000.00,27000.00,0.00,21261.49,0.32,1
57986,5802,1000.00,27000.00,28000.00,5165.74,21834.26,0.41,1
57987,5802,1000.00,28000.00,29000.00,3547.65,24452.35,0.41,1
57988,5802,1000.00,29000.00,30000.00,0.00,789.91,0.08,1
57989,5802,1000.00,30000.00,31000.00,474.11,28780.16,0.44,1
57990,5802,1000.00,31000.00,32000.00,12124.50,18875.50,0.29,1
57991,5802,1000.00,32000.00,33000.00,15758.02,16241.98,0.16,1
57992,5802,-1000.00,31000.00,32000.00,24687.16,0.00,0.02,0
57993,5802,1000.00,32000.00,33000.00,0.00,19980.90,0.23,1
57994,5802,1000.00,33000.00,34000.00,14826.15,18173.85,0.14,1
57995,5802,1000.00,34000.00,35000.00,0.00,2060.71,0.05,1
57996,5802,1000.00,35000.00,36000.00,8127.03,21913.82,0.34,1
57997,5802,1000.00,36000.00,37000.00,0.00,36000.00,0.29,1
57998,5802,1000.00,37000.00,38000.00,0.00,22127.72,0.31,1
57999,5802,1000.00,38000.00,39000.00,75.10,37924.90,0.41,1
58000,5802,1000.00,39000.00,40000.00,0.00,31502.64,0.42,1
58001,5802,1000.00,40000.00,41000.00,9986.32,30013.68,0.37,1
58002,5802,1000.00,41000.00,42000.00,2975.61,11906.32,0.22,1
58003,5802,1000.00,42000.00,43000.00,0.00,22698.92,0.03,1
58004,5802,1000.00,43000.00,44000.00,0.00,15987.09,0.19,1
58005,5803,-1000.00,-1000.00,0.00,529.83,470.17,0.18,0
58006,5804,-1000.00,-1000.00,0.00,463.01,536.99,0.03,0
58007,5805,-1000.00,-1000.00,0.00,731.02,268.98,0.09,0
58008,5806,-1000.00,-1000.00,0.00,605.76,260.60,0.12,0
58009,5807,-1000.00,-1000.00,0.00,125.57,874.43,0.13,0
58010,5808,1000.00,1000.00,2000.00,209.96,0.00,0.37,1
58011,5808,0.00,1000.00,2000.00,0.00,0.00,0.37,0
58012,5808,-1000.00,0.00,1000.00,0.00,1605.36,0.32,0
58013,5808,1000.00,1000.00,2000.00,678.62,321.38,0.10,1
58014,5808,1000.00,2000.00,3000.00,307.57,0.00,0.07,1
58015,5808,1000.00,3000.00,4000.00,537.77,0.00,0.37,1
58016,5808,1000.00,4000.00,5000.00,3402.95,0.00,0.14,1
58017,5808,-1000.00,3000.00,4000.00,0.00,5000.00,0.04,0
58018,5808,1000.00,4000.00,5000.00,1507.41,1433.30,0.21,1
58019,5808,-1000.00,3000.00,4000.00,0.00,3798.52,0.06,0
58020,5808,0.00,3000.00,4000.00,0.00,0.00,0.12,0
58021,5808,1000.00,4000.00,5000.00,237.30,0.00,0.12,1
58022,5808,-1000.00,3000.00,4000.00,1260.61,0.00,0.30,0
58023,5808,-1000.00,2000.00,3000.00,1528.79,1977.01,0.25,0
58024,5808,-1000.00,1000.00,2000.00,488.49,2511.51,0.37,0
58025,5808,-1000.00,0.00,1000.00,0.00,1893.38,0.15,0
58026,5808,-1000.00,-1000.00,0.00,489.66,510.34,0.21,0
58027,5809,-895.72,-895.72,104.28,0.00,895.72,0.15,0
58028,5809,-104.28,-1000.00,-0.00,26.91,77.37,0.03,0
58029,5810,0.00,0.00,1000.00,0.00,0.00,0.42,0
58030,5810,-152.98,-152.98,847.02,0.00,152.98,0.14,0
58031,5810,-765.54,-918.52,81.48,160.36,605.18,0.33,0
58032,5810,-81.48,-1000.00,0.00,0.48,81.00,0.43,0
58033,5811,-1000.00,-1000.00,0.00,133.93,866.07,0.37,0
58034,5812,-694.45,-694.45,305.55,0.00,694.45,0.05,0
58035,5812,-273.01,-967.47,32.53,0.00,273.01,0.36,0
58036,5812,-32.53,-1000.00,0.00,7.38,25.15,0.20,0
58037,5813,-63.03,-63.03,936.97,63.03,0.00,0.44,0
58038,5813,-1000.00,-1063.03,-63.03,185.55,521.56,0.27,0
58039,5814,-1000.00,-1000.00,0.00,0.00,1000.00,0.25,0
58040,5815,-1000.00,-1000.00,0.00,158.61,841.39,0.42,0
58041,5815,-0.00,-1000.00,0.00,0.00,0.00,0.43,0
58042,5816,-838.99,-838.99,161.01,537.03,301.96,0.26,0
58043,5816,-1000.00,-1838.99,-838.99,0.00,58.85,0.04,0
58044,5817,-1000.00,-1000.00,0.00,251.38,748.62,0.38,0
58045,5818,-1000.00,-1000.00,0.00,510.91,489.09,0.21,0
58046,5819,-1000.00,-1000.00,0.00,565.24,434.76,0.04,0
58047,5820,-1000.00,-1000.00,0.00,630.38,181.87,0.24,0
58048,5821,-1000.00,-1000.00,0.00,302.56,697.44,0.34,0
58049,5822,1000.00,1000.00,2000.00,0.00,1000.00,0.18,1
58050,5822,1000.00,2000.00,3000.00,0.00,752.95,0.23,1
58051,5822,1000.00,3000.00,4000.00,0.00,3000.00,0.15,1
58052,5822,1000.00,4000.00,5000.00,0.00,4000.00,0.17,1
58053,5822,1000.00,5000.00,6000.00,1152.20,3847.80,0.39,1
58054,5822,-1000.00,4000.00,5000.00,5858.92,0.00,0.01,0
58055,5822,1000.00,5000.00,6000.00,1427.11,3572.89,0.29,1
58056,5822,1000.00,6000.00,7000.00,556.86,5443.14,0.24,1
58057,5822,1000.00,7000.00,8000.00,398.57,4940.78,0.39,1
58058,5822,1000.00,8000.00,9000.00,2027.58,5972.42,0.38,1
58059,5822,1000.00,9000.00,10000.00,0.00,7800.13,0.41,1
58060,5822,1000.00,10000.00,11000.00,0.00,10000.00,0.29,1
58061,5822,1000.00,11000.00,12000.00,0.00,11000.00,0.24,1
58062,5822,1000.00,12000.00,13000.00,0.00,9279.66,0.40,1
58063,5822,1000.00,13000.00,14000.00,0.00,13000.00,0.11,1
58064,5822,1000.00,14000.00,15000.00,0.00,8531.03,0.30,1
58065,5822,1000.00,15000.00,16000.00,2200.76,12799.24,0.35,1
58066,5822,1000.00,16000.00,17000.00,0.00,16000.00,0.10,1
58067,5822,-1000.00,15000.00,16000.00,7600.33,4952.98,0.17,0
58068,5822,1000.00,16000.00,17000.00,0.00,16000.00,0.37,1
58069,5822,1000.00,17000.00,18000.00,3253.66,13746.34,0.34,1
58070,5822,1000.00,18000.00,19000.00,0.00,18000.00,0.28,1
58071,5822,1000.00,19000.00,20000.00,0.00,19000.00,0.29,1
58072,5822,1000.00,20000.00,21000.00,6922.33,13077.67,0.25,1
58073,5822,1000.00,21000.00,22000.00,0.00,21000.00,0.04,1
58074,5822,1000.00,22000.00,23000.00,0.00,17104.43,0.21,1
58075,5822,1000.00,23000.00,24000.00,2251.04,2511.34,0.14,1
58076,5822,1000.00,24000.00,25000.00,1691.37,22308.63,0.42,1
58077,5822,1000.00,25000.00,26000.00,0.00,25000.00,0.24,1
58078,5822,1000.00,26000.00,27000.00,0.00,7669.73,0.12,1
58079,5822,1000.00,27000.00,28000.00,7412.42,19587.58,0.36,1
58080,5822,0.00,27000.00,28000.00,0.00,0.00,0.01,0
58081,5822,1000.00,28000.00,29000.00,1856.11,26143.89,0.34,1
58082,5822,1000.00,29000.00,30000.00,0.00,6284.94,0.13,1
58083,5822,-1000.00,28000.00,29000.00,13704.95,10175.51,0.18,0
58084,5822,1000.00,29000.00,30000.00,14500.00,14500.00,0.05,1
58085,5822,1000.00,30000.00,31000.00,8316.12,21683.88,0.36,1
58086,5822,1000.00,31000.00,32000.00,13989.00,17011.00,0.19,1
58087,5822,-1000.00,30000.00,31000.00,19134.91,12865.09,0.11,0
58088,5822,1000.00,31000.00,32000.00,0.00,31000.00,0.22,1
58089,5822,1000.00,32000.00,33000.00,2831.56,13249.29,0.27,1
58090,5822,1000.00,33000.00,34000.00,7480.59,25519.41,0.35,1
58091,5822,-1000.00,32000.00,33000.00,23581.66,10418.34,0.07,0
58092,5822,1000.00,33000.00,34000.00,5997.50,26231.74,0.40,1
58093,5822,1000.00,34000.00,35000.00,16165.32,17834.68,0.09,1
58094,5822,1000.00,35000.00,36000.00,7602.34,13248.08,0.24,1
58095,5822,1000.00,36000.00,37000.00,3419.67,32580.33,0.27,1
58096,5822,-1000.00,35000.00,36000.00,12546.80,17098.48,0.25,0
58097,5822,-1000.00,34000.00,35000.00,0.00,36000.00,0.14,0
58098,5822,-1000.00,33000.00,34000.00,12318.22,22681.78,0.10,0
58099,5822,-1000.00,32000.00,33000.00,0.00,22333.22,0.11,0
58100,5822,-1000.00,31000.00,32000.00,12480.75,20519.25,0.22,0
58101,5822,-1000.00,30000.00,31000.00,0.00,32000.00,0.18,0
58102,5822,-1000.00,29000.00,30000.00,0.00,19997.70,0.16,0
58103,5822,-1000.00,28000.00,29000.00,5522.87,24477.13,0.39,0
58104,5822,-1000.00,27000.00,28000.00,0.00,29000.00,0.00,0
58105,5822,-1000.00,26000.00,27000.00,3023.20,6775.54,0.20,0
58106,5822,-1000.00,25000.00,26000.00,0.00,27000.00,0.28,0
58107,5822,-1000.00,24000.00,25000.00,18498.93,7501.07,0.06,0
58108,5822,-1000.00,23000.00,24000.00,9715.98,15284.02,0.23,0
58109,5822,-1000.00,22000.00,23000.00,0.00,24000.00,0.20,0
58110,5822,-1000.00,21000.00,22000.00,1032.91,0.00,0.04,0
58111,5822,-1000.00,20000.00,21000.00,0.00,22000.00,0.19,0
58112,5822,-1000.00,19000.00,20000.00,2737.06,12997.21,0.35,0
58113,5822,-1000.00,18000.00,19000.00,0.00,14277.10,0.34,0
58114,5822,-1000.00,17000.00,18000.00,750.22,18249.78,0.43,0
58115,5822,-1000.00,16000.00,17000.00,5276.68,12723.32,0.35,0
58116,5822,-1000.00,15000.00,16000.00,743.49,3322.39,0.18,0
58117,5822,-1000.00,14000.00,15000.00,0.00,8744.33,0.30,0
58118,5822,-1000.00,13000.00,14000.00,7881.84,7118.16,0.18,0
58119,5822,0.00,13000.00,14000.00,0.00,0.00,0.04,0
58120,5822,-1000.00,12000.00,13000.00,4242.08,9757.92,0.10,0
58121,5822,-1000.00,11000.00,12000.00,6343.14,6656.86,0.12,0
58122,5822,-1000.00,10000.00,11000.00,7907.55,0.00,0.04,0
58123,5822,-1000.00,9000.00,10000.00,0.00,11000.00,0.02,0
58124,5822,-1000.00,8000.00,9000.00,3107.37,6892.63,0.34,0
58125,5822,-275.04,7724.96,8724.96,0.00,275.04,0.12,0
58126,5822,-1000.00,6724.96,7724.96,0.00,8724.96,0.17,0
58127,5822,-1000.00,5724.96,6724.96,4480.37,3244.59,0.09,0
58128,5822,-1000.00,4724.96,5724.96,0.00,6724.96,0.12,0
58129,5822,-1000.00,3724.96,4724.96,1442.87,4282.10,0.37,0
58130,5822,-1000.00,2724.96,3724.96,1358.59,3366.38,0.36,0
58131,5822,-1000.00,1724.96,2724.96,1675.06,1940.04,0.24,0
58132,5822,-1000.00,724.96,1724.96,791.50,1933.47,0.36,0
58133,5822,-1000.00,-275.04,724.96,0.00,1679.07,0.18,0
58134,5822,-1000.00,-1275.04,-275.04,454.82,270.14,0.12,0
58135,5823,-1000.00,-1000.00,0.00,206.35,793.65,0.40,0
58136,5824,-706.96,-706.96,293.04,0.00,706.96,0.17,0
58137,5824,-1000.00,-1706.96,-706.96,98.32,91.14,0.32,0
58138,5825,-1000.00,-1000.00,0.00,333.95,666.05,0.32,0
58139,5826,1000.00,1000.00,2000.00,330.71,669.29,0.16,1
58140,5826,1000.00,2000.00,3000.00,0.00,1153.91,0.31,1
58141,5826,1000.00,3000.00,4000.00,0.00,2288.79,0.38,1
58142,5826,1000.00,4000.00,5000.00,541.16,3458.84,0.24,1
58143,5826,1000.00,5000.00,6000.00,0.00,5000.00,0.14,1
58144,5826,1000.00,6000.00,7000.00,2160.22,3839.78,0.21,1
58145,5826,1000.00,7000.00,8000.00,2614.67,4385.33,0.27,1
58146,5826,1000.00,8000.00,9000.00,1025.72,4583.55,0.34,1
58147,5826,1000.00,9000.00,10000.00,2604.83,6395.17,0.34,1
58148,5826,-1000.00,8000.00,9000.00,5656.52,4343.48,0.04,0
58149,5826,1000.00,9000.00,10000.00,3522.73,5477.27,0.29,1
58150,5826,1000.00,10000.00,11000.00,3287.22,6712.78,0.31,1
58151,5826,1000.00,11000.00,12000.00,0.00,11000.00,0.02,1
58152,5826,-1000.00,10000.00,11000.00,2644.84,1217.57,0.13,0
58153,5826,-1000.00,9000.00,10000.00,7323.84,3676.16,0.13,0
58154,5826,1000.00,10000.00,11000.00,1269.42,8730.58,0.35,1
58155,5826,1000.00,11000.00,12000.00,0.00,9074.76,0.26,1
58156,5826,1000.00,12000.00,13000.00,0.00,12000.00,0.10,1
58157,5826,1000.00,13000.00,14000.00,2735.33,10264.67,0.40,1
58158,5826,1000.00,14000.00,15000.00,0.00,2295.55,0.11,1
58159,5826,1000.00,15000.00,16000.00,6303.56,8696.44,0.10,1
58160,5826,-1000.00,14000.00,15000.00,12689.32,3310.68,0.07,0
58161,5826,1000.00,15000.00,16000.00,0.00,15000.00,0.07,1
58162,5826,-1000.00,14000.00,15000.00,5398.24,2071.39,0.13,0
58163,5826,1000.00,15000.00,16000.00,0.00,15000.00,0.02,1
58164,5826,1000.00,16000.00,17000.00,0.00,16000.00,0.26,1
58165,5826,1000.00,17000.00,18000.00,2245.32,14754.68,0.20,1
58166,5826,1000.00,18000.00,19000.00,0.00,13760.23,0.30,1
58167,5826,1000.00,19000.00,20000.00,0.00,9112.50,0.30,1
58168,5826,1000.00,20000.00,21000.00,0.00,18493.23,0.40,1
58169,5826,1000.00,21000.00,22000.00,0.00,20828.68,0.33,1
58170,5826,0.00,21000.00,22000.00,0.00,0.00,0.06,0
58171,5826,1000.00,22000.00,23000.00,9273.54,12726.46,0.02,1
58172,5826,1000.00,23000.00,24000.00,3422.31,4733.46,0.18,1
58173,5826,1000.00,24000.00,25000.00,0.00,23623.96,0.25,1
58174,5826,1000.00,25000.00,26000.00,0.00,11957.25,0.30,1
58175,5826,1000.00,26000.00,27000.00,0.00,19190.78,0.14,1
58176,5826,0.00,26000.00,27000.00,0.00,0.00,0.02,0
58177,5827,1000.00,1000.00,2000.00,442.33,0.00,0.15,1
58178,5827,0.00,1000.00,2000.00,0.00,0.00,0.30,0
58179,5827,-60.87,939.13,1939.13,0.00,60.87,0.38,0
58180,5827,-931.35,7.78,1007.78,0.00,931.35,0.32,0
58181,5827,-1000.00,-992.22,7.78,388.10,619.68,0.23,0
58182,5827,-7.78,-1000.00,0.00,1.08,6.70,0.42,0
58183,5828,1000.00,1000.00,2000.00,424.56,575.44,0.25,1
58184,5828,1000.00,2000.00,3000.00,0.00,1330.15,0.36,1
58185,5828,-486.95,1513.05,2513.05,486.95,0.00,0.04,0
58186,5828,1000.00,2513.05,3513.05,1256.52,1256.52,0.01,1
58187,5828,1000.00,3513.05,4513.05,0.00,1455.85,0.25,1
58188,5828,1000.00,4513.05,5513.05,2051.41,2461.63,0.25,1
58189,5828,0.00,4513.05,5513.05,0.00,0.00,0.07,0
58190,5828,-1000.00,3513.05,4513.05,2336.11,572.96,0.11,0
58191,5828,1000.00,4513.05,5513.05,0.00,4513.05,0.31,1
58192,5828,1000.00,5513.05,6513.05,0.00,5079.36,0.24,1
58193,5828,1000.00,6513.05,7513.05,185.87,6310.18,0.44,1
58194,5828,1000.00,7513.05,8513.05,0.00,3980.86,0.16,1
58195,5828,1000.00,8513.05,9513.05,0.00,8513.05,0.39,1
58196,5828,1000.00,9513.05,10513.05,0.00,9513.05,0.17,1
58197,5828,1000.00,10513.05,11513.05,0.00,5639.84,0.32,1
58198,5828,1000.00,11513.05,12513.05,5459.51,6053.54,0.22,1
58199,5828,-1000.00,10513.05,11513.05,9093.11,3419.93,0.03,0
58200,5828,1000.00,11513.05,12513.05,1821.61,9691.44,0.42,1
58201,5828,1000.00,12513.05,13513.05,0.00,12513.05,0.27,1
58202,5828,-1000.00,11513.05,12513.05,8288.91,5224.14,0.07,0
58203,5828,1000.00,12513.05,13513.05,766.98,2775.18,0.19,1
58204,5828,1000.00,13513.05,14513.05,3530.29,9982.76,0.38,1
58205,5828,1000.00,14513.05,15513.05,0.00,2089.79,0.05,1
58206,5828,1000.00,15513.05,16513.05,0.00,11265.55,0.24,1
58207,5828,-1000.00,14513.05,15513.05,5843.07,10669.97,0.23,0
58208,5828,-1000.00,13513.05,14513.05,0.00,14217.27,0.33,0
58209,5828,-1000.00,12513.05,13513.05,4806.86,9706.18,0.15,0
58210,5828,-1000.00,11513.05,12513.05,5631.49,7881.56,0.21,0
58211,5828,-1000.00,10513.05,11513.05,34.20,12478.85,0.14,0
58212,5828,-1000.00,9513.05,10513.05,0.00,11513.05,0.37,0
58213,5828,-1000.00,8513.05,9513.05,0.00,2888.23,0.04,0
58214,5828,-1000.00,7513.05,8513.05,0.00,9513.05,0.42,0
58215,5828,-1000.00,6513.05,7513.05,2827.89,5685.16,0.33,0
58216,5828,-1000.00,5513.05,6513.05,567.99,6945.05,0.44,0
58217,5828,-1000.00,4513.05,5513.05,2603.49,3909.56,0.07,0
58218,5828,-1000.00,3513.05,4513.05,0.00,3600.86,0.25,0
58219,5828,-1000.00,2513.05,3513.05,0.00,4196.66,0.33,0
58220,5828,-1000.00,1513.05,2513.05,0.00,3513.05,0.12,0
58221,5828,-1000.00,513.05,1513.05,309.66,2203.39,0.34,0
58222,5828,-1000.00,-486.95,513.05,397.62,1115.43,0.28,0
58223,5828,-101.85,-588.81,411.19,0.00,101.85,0.17,0
58224,5829,-1000.00,-1000.00,0.00,0.00,1000.00,0.05,0
58225,5830,-712.43,-712.43,287.57,712.43,0.00,0.16,0
58226,5830,-1000.00,-1712.43,-712.43,0.00,195.57,0.22,0
58227,5831,-1000.00,-1000.00,0.00,393.52,606.48,0.29,0
58228,5832,-796.30,-796.30,203.70,795.47,0.83,0.05,0
58229,5832,1000.00,203.70,1203.70,59.95,143.74,0.31,1
58230,5832,1000.00,1203.70,2203.70,0.00,1016.93,0.20,1
58231,5832,1000.00,2203.70,3203.70,302.77,1220.39,0.33,1
58232,5832,1000.00,3203.70,4203.70,0.00,1848.93,0.26,1
58233,5832,1000.00,4203.70,5203.70,1394.60,2809.10,0.15,1
58234,5832,-1000.00,3203.70,4203.70,3731.03,1472.67,0.01,0
58235,5832,1000.00,4203.70,5203.70,0.00,4203.70,0.16,1
58236,5832,1000.00,5203.70,6203.70,0.00,432.77,0.12,1
58237,5832,1000.00,6203.70,7203.70,3101.85,3101.85,0.10,1
58238,5832,1000.00,7203.70,8203.70,0.00,725.78,0.13,1
58239,5832,-1000.00,6203.70,7203.70,4958.57,3245.13,0.16,0
58240,5832,1000.00,7203.70,8203.70,2438.67,4765.03,0.31,1
58241,5832,1000.00,8203.70,9203.70,3290.01,4913.69,0.26,1
58242,5832,1000.00,9203.70,10203.70,4601.85,4601.85,0.02,1
58243,5832,0.00,9203.70,10203.70,0.00,0.00,0.05,0
58244,5832,1000.00,10203.70,11203.70,0.00,10203.70,0.11,1
58245,5832,1000.00,11203.70,12203.70,0.00,11203.70,0.37,1
58246,5832,1000.00,12203.70,13203.70,1663.45,10540.25,0.41,1
58247,5832,0.00,12203.70,13203.70,0.00,0.00,0.04,0
58248,5832,1000.00,13203.70,14203.70,3990.42,9213.28,0.12,1
58249,5832,1000.00,14203.70,15203.70,0.00,11098.73,0.22,1
58250,5832,-525.73,13677.97,14677.97,525.73,0.00,0.07,0
58251,5832,1000.00,14677.97,15677.97,0.00,9458.05,0.07,1
58252,5832,1000.00,15677.97,16677.97,0.00,15677.97,0.10,1
58253,5832,1000.00,16677.97,17677.97,3543.76,13134.21,0.32,1
58254,5832,1000.00,17677.97,18677.97,0.00,17677.97,0.28,1
58255,5832,1000.00,18677.97,19677.97,0.00,18677.97,0.02,1
58256,5832,-1000.00,17677.97,18677.97,12004.05,7673.92,0.09,0
58257,5832,1000.00,18677.97,19677.97,0.00,18677.97,0.15,1
58258,5832,1000.00,19677.97,20677.97,0.00,19677.97,0.39,1
58259,5832,1000.00,20677.97,21677.97,5238.54,14760.27,0.36,1
58260,5832,1000.00,21677.97,22677.97,9660.69,12017.28,0.20,1
58261,5832,-1000.00,20677.97,21677.97,14615.60,3709.98,0.09,0
58262,5832,1000.00,21677.97,22677.97,8454.39,13223.58,0.22,1
58263,5832,1000.00,22677.97,23677.97,5010.38,17667.59,0.32,1
58264,5832,1000.00,23677.97,24677.97,5442.42,18235.55,0.39,1
58265,5832,1000.00,24677.97,25677.97,0.00,24677.97,0.22,1
58266,5832,1000.00,25677.97,26677.97,0.00,7624.25,0.15,1
58267,5832,1000.00,26677.97,27677.97,3562.98,23114.98,0.30,1
58268,5832,1000.00,27677.97,28677.97,0.00,27677.97,0.15,1
58269,5832,1000.00,28677.97,29677.97,0.00,17767.88,0.36,1
58270,5832,1000.00,29677.97,30677.97,12732.13,16945.84,0.26,1
58271,5833,-1000.00,-1000.00,0.00,732.46,267.54,0.09,0
58272,5834,1000.00,1000.00,2000.00,0.00,1000.00,0.04,1
58273,5834,-1000.00,0.00,1000.00,1021.60,978.40,0.08,0
58274,5834,1000.00,1000.00,2000.00,223.96,776.04,0.36,1
58275,5834,1000.00,2000.00,3000.00,474.01,1525.99,0.34,1
58276,5834,1000.00,3000.00,4000.00,394.45,2544.00,0.42,1
58277,5834,1000.00,4000.00,5000.00,0.00,2466.29,0.19,1
58278,5834,1000.00,5000.00,6000.00,1035.41,3964.59,0.39,1
58279,5834,1000.00,6000.00,7000.00,3000.00,3000.00,0.09,1
58280,5834,1000.00,7000.00,8000.00,0.00,7000.00,0.26,1
58281,5834,1000.00,8000.00,9000.00,2788.30,5211.70,0.28,1
58282,5834,1000.00,9000.00,10000.00,0.00,9000.00,0.36,1
58283,5834,1000.00,10000.00,11000.00,0.00,10000.00,0.22,1
58284,5834,1000.00,11000.00,12000.00,4942.84,6057.16,0.17,1
58285,5834,1000.00,12000.00,13000.00,5051.07,6948.93,0.26,1
58286,5834,-1000.00,11000.00,12000.00,10242.66,2757.34,0.06,0
58287,5834,1000.00,12000.00,13000.00,4467.85,7532.15,0.29,1
58288,5834,1000.00,13000.00,14000.00,0.00,3316.65,0.20,1
58289,5834,1000.00,14000.00,15000.00,3499.80,10500.20,0.10,1
58290,5834,1000.00,15000.00,16000.00,0.00,15000.00,0.34,1
58291,5834,-1000.00,14000.00,15000.00,6706.61,64.93,0.09,0
58292,5834,1000.00,15000.00,16000.00,7374.74,7625.26,0.15,1
58293,5834,1000.00,16000.00,17000.00,0.00,16000.00,0.35,1
58294,5834,1000.00,17000.00,18000.00,0.00,3482.71,0.15,1
58295,5834,1000.00,18000.00,19000.00,0.00,11511.47,0.18,1
58296,5834,1000.00,19000.00,20000.00,0.00,19000.00,0.08,1
58297,5834,1000.00,20000.00,21000.00,0.00,821.68,0.10,1
58298,5834,1000.00,21000.00,22000.00,0.00,12597.84,0.33,1
58299,5834,0.00,21000.00,22000.00,0.00,0.00,0.08,0
58300,5834,1000.00,22000.00,23000.00,6951.02,15048.98,0.22,1
58301,5834,-1000.00,21000.00,22000.00,11185.82,0.00,0.03,0
58302,5834,1000.00,22000.00,23000.00,0.00,22000.00,0.25,1
58303,5834,1000.00,23000.00,24000.00,0.00,9789.73,0.28,1
58304,5834,1000.00,24000.00,25000.00,1781.19,22218.81,0.43,1
58305,5834,1000.00,25000.00,26000.00,0.00,25000.00,0.31,1
58306,5834,1000.00,26000.00,27000.00,0.00,26000.00,0.14,1
58307,5834,1000.00,27000.00,28000.00,9221.34,17778.66,0.21,1
58308,5834,0.00,27000.00,28000.00,0.00,0.00,0.02,0
58309,5834,-1000.00,26000.00,27000.00,16457.95,11542.05,0.06,0
58310,5834,1000.00,27000.00,28000.00,8875.16,18124.84,0.33,1
58311,5834,1000.00,28000.00,29000.00,0.00,28000.00,0.19,1
58312,5834,1000.00,29000.00,30000.00,11011.42,17988.58,0.20,1
58313,5834,-1000.00,28000.00,29000.00,14791.78,0.00,0.03,0
58314,5834,-1000.00,27000.00,28000.00,17438.83,0.00,0.02,0
58315,5834,1000.00,28000.00,29000.00,0.00,28000.00,0.05,1
58316,5834,-1000.00,27000.00,28000.00,24808.31,4053.79,0.06,0
58317,5834,1000.00,28000.00,29000.00,7355.37,20644.63,0.36,1
58318,5834,1000.00,29000.00,30000.00,290.90,16679.62,0.34,1
58319,5834,1000.00,30000.00,31000.00,0.00,30000.00,0.40,1
58320,5834,-1000.00,29000.00,30000.00,0.00,31000.00,0.11,0
58321,5834,-1000.00,28000.00,29000.00,4504.05,25495.95,0.28,0
58322,5834,-1000.00,27000.00,28000.00,0.00,9377.84,0.11,0
58323,5834,-1000.00,26000.00,27000.00,10697.37,17302.63,0.04,0
58324,5834,-1000.00,25000.00,26000.00,12112.55,14887.45,0.08,0
58325,5834,-1000.00,24000.00,25000.00,13043.91,12956.09,0.00,0
58326,5834,-1000.00,23000.00,24000.00,5809.61,19190.39,0.39,0
58327,5834,-1000.00,22000.00,23000.00,5757.58,18242.42,0.39,0
58328,5834,-1000.00,21000.00,22000.00,0.00,5106.13,0.16,0
58329,5834,-1000.00,20000.00,21000.00,5286.85,16713.15,0.39,0
58330,5834,-1000.00,19000.00,20000.00,10500.00,10500.00,0.07,0
58331,5834,-1000.00,18000.00,19000.00,2265.93,17734.07,0.21,0
58332,5834,-1000.00,17000.00,18000.00,9341.97,9658.03,0.20,0
58333,5834,-1000.00,16000.00,17000.00,0.00,7302.69,0.26,0
58334,5834,-1000.00,15000.00,16000.00,3694.10,13305.90,0.39,0
58335,5834,-1000.00,14000.00,15000.00,7563.25,8436.75,0.09,0
58336,5834,-1000.00,13000.00,14000.00,0.00,13224.33,0.43,0
58337,5834,-1000.00,12000.00,13000.00,0.00,9543.24,0.37,0
58338,5834,-1000.00,11000.00,12000.00,0.00,9358.59,0.20,0
58339,5834,-1000.00,10000.00,11000.00,0.00,11043.29,0.36,0
58340,5834,-1000.00,9000.00,10000.00,0.00,6675.06,0.35,0
58341,5834,-1000.00,8000.00,9000.00,3318.05,6681.95,0.12,0
58342,5834,-1000.00,7000.00,8000.00,3193.12,5806.88,0.29,0
58343,5835,-1000.00,-1000.00,0.00,433.52,566.48,0.19,0
58344,5836,1000.00,1000.00,2000.00,0.00,1000.00,0.26,1
58345,5836,1000.00,2000.00,3000.00,541.09,1458.91,0.14,1
58346,5836,-64.60,1935.40,2935.40,64.60,0.00,0.07,0
58347,5836,1000.00,2935.40,3935.40,336.18,2201.34,0.40,1
58348,5836,-289.61,2645.79,3645.79,217.27,72.34,0.12,0
58349,5836,1000.00,3645.79,4645.79,639.58,1795.87,0.30,1
58350,5836,1000.00,4645.79,5645.79,1985.85,2659.93,0.11,1
58351,5836,1000.00,5645.79,6645.79,0.00,3965.69,0.29,1
58352,5836,0.00,5645.79,6645.79,0.00,0.00,0.06,0
58353,5836,1000.00,6645.79,7645.79,130.78,6515.00,0.44,1
58354,5836,1000.00,7645.79,8645.79,2248.09,5397.69,0.30,1
58355,5836,1000.00,8645.79,9645.79,3973.85,4671.94,0.21,1
58356,5836,1000.00,9645.79,10645.79,0.00,4522.41,0.09,1
58357,5836,-1000.00,8645.79,9645.79,6144.33,4501.45,0.08,0
58358,5836,1000.00,9645.79,10645.79,0.00,6740.76,0.09,1
58359,5836,1000.00,10645.79,11645.79,0.00,10645.79,0.28,1
58360,5836,1000.00,11645.79,12645.79,0.00,11645.79,0.13,1
58361,5836,1000.00,12645.79,13645.79,3567.67,9078.11,0.36,1
58362,5836,1000.00,13645.79,14645.79,1510.26,5375.62,0.26,1
58363,5836,1000.00,14645.79,15645.79,0.00,5449.19,0.03,1
58364,5836,-1000.00,13645.79,14645.79,7822.89,7822.89,0.05,0
58365,5836,-1000.00,12645.79,13645.79,0.00,14645.79,0.25,0
58366,5836,-1000.00,11645.79,12645.79,0.00,6014.42,0.28,0
58367,5836,-1000.00,10645.79,11645.79,4115.27,8530.51,0.32,0
58368,5836,-1000.00,9645.79,10645.79,0.00,11645.79,0.26,0
58369,5836,-1000.00,8645.79,9645.79,3034.45,7611.34,0.34,0
58370,5836,-1000.00,7645.79,8645.79,3368.14,6277.65,0.29,0
58371,5836,-1000.00,6645.79,7645.79,1911.39,6734.40,0.40,0
58372,5836,-1000.00,5645.79,6645.79,3904.13,3741.66,0.18,0
58373,5836,-1000.00,4645.79,5645.79,0.00,2622.87,0.24,0
58374,5836,-1000.00,3645.79,4645.79,724.79,4921.00,0.43,0
58375,5836,-1000.00,2645.79,3645.79,1711.53,2934.25,0.02,0
58376,5836,-1000.00,1645.79,2645.79,587.83,2464.72,0.37,0
58377,5836,-1000.00,645.79,1645.79,524.23,2121.55,0.41,0
58378,5836,-1000.00,-354.21,645.79,0.00,1313.35,0.40,0
58379,5836,-645.79,-1000.00,0.00,125.28,520.51,0.16,0
58380,5837,-928.34,-928.34,71.66,0.00,928.34,0.39,0
58381,5837,-71.66,-1000.00,0.00,0.00,71.66,0.16,0
58382,5838,-1000.00,-1000.00,0.00,572.63,427.37,0.16,0
58383,5839,-1000.00,-1000.00,0.00,124.46,875.54,0.35,0
58384,5840,-994.69,-994.69,5.31,0.00,994.69,0.10,0
58385,5840,-3.85,-998.54,1.46,0.41,3.44,0.37,0
58386,5840,-1.46,-1000.00,0.00,0.00,1.46,0.38,0
58387,5841,1000.00,1000.00,2000.00,316.75,683.25,0.34,1
58388,5841,1000.00,2000.00,3000.00,0.00,1789.88,0.41,1
58389,5841,1000.00,3000.00,4000.00,1328.27,1671.73,0.14,1
58390,5841,1000.00,4000.00,5000.00,1935.99,2064.01,0.22,1
58391,5841,1000.00,5000.00,6000.00,1094.72,3905.28,0.07,1
58392,5841,1000.00,6000.00,7000.00,1456.61,4543.39,0.38,1
58393,5841,1000.00,7000.00,8000.00,2230.97,3588.93,0.28,1
58394,5841,1000.00,8000.00,9000.00,0.00,6255.94,0.28,1
58395,5841,-1000.00,7000.00,8000.00,5237.75,3762.25,0.07,0
58396,5841,1000.00,8000.00,9000.00,0.00,8000.00,0.34,1
58397,5841,1000.00,9000.00,10000.00,0.00,9000.00,0.44,1
58398,5841,1000.00,10000.00,11000.00,0.00,10000.00,0.27,1
58399,5841,1000.00,11000.00,12000.00,0.00,11000.00,0.41,1
58400,5841,1000.00,12000.00,13000.00,0.00,12000.00,0.03,1
58401,5841,1000.00,13000.00,14000.00,1065.21,11934.79,0.44,1
58402,5841,1000.00,14000.00,15000.00,6623.30,7376.70,0.08,1
58403,5841,1000.00,15000.00,16000.00,2522.38,12477.62,0.42,1
58404,5841,1000.00,16000.00,17000.00,8000.00,8000.00,0.03,1
58405,5841,1000.00,17000.00,18000.00,8500.00,8500.00,0.08,1
58406,5841,1000.00,18000.00,19000.00,1280.80,4724.84,0.21,1
58407,5841,1000.00,19000.00,20000.00,0.00,19000.00,0.03,1
58408,5841,1000.00,20000.00,21000.00,1608.08,18391.92,0.07,1
58409,5841,1000.00,21000.00,22000.00,8667.83,12332.17,0.21,1
58410,5841,1000.00,22000.00,23000.00,0.00,22000.00,0.36,1
58411,5841,-1000.00,21000.00,22000.00,9820.44,13179.56,0.26,0
58412,5841,-1000.00,20000.00,21000.00,2864.65,19135.35,0.14,0
58413,5841,-1000.00,19000.00,20000.00,0.00,7459.11,0.21,0
58414,5841,0.00,19000.00,20000.00,0.00,0.00,0.38,0
58415,5841,-1000.00,18000.00,19000.00,0.00,4171.31,0.24,0
58416,5841,-1000.00,17000.00,18000.00,0.00,18238.47,0.27,0
58417,5841,-1000.00,16000.00,17000.00,9000.00,9000.00,0.01,0
58418,5841,-1000.00,15000.00,16000.00,4500.21,5883.63,0.39,0
58419,5841,-1000.00,14000.00,15000.00,0.00,16000.00,0.15,0
58420,5841,-1000.00,13000.00,14000.00,0.00,15000.00,0.41,0
58421,5842,-1000.00,-1000.00,0.00,0.00,599.50,0.07,0
58422,5843,-1000.00,-1000.00,0.00,339.21,660.79,0.06,0
58423,5844,0.00,0.00,1000.00,0.00,0.00,0.02,0
58424,5844,-1000.00,-1000.00,0.00,275.62,724.38,0.22,0
58425,5845,1000.00,1000.00,2000.00,0.00,59.99,0.07,1
58426,5845,1000.00,2000.00,3000.00,207.93,349.46,0.17,1
58427,5845,1000.00,3000.00,4000.00,0.00,675.13,0.17,1
58428,5845,0.00,3000.00,4000.00,0.00,0.00,0.04,0
58429,5845,1000.00,4000.00,5000.00,0.00,4000.00,0.24,1
58430,5845,1000.00,5000.00,6000.00,0.00,5000.00,0.12,1
58431,5845,1000.00,6000.00,7000.00,3000.00,3000.00,0.06,1
58432,5845,1000.00,7000.00,8000.00,2296.50,4703.50,0.14,1
58433,5845,1000.00,8000.00,9000.00,0.00,6147.72,0.41,1
58434,5845,1000.00,9000.00,10000.00,0.00,9000.00,0.10,1
58435,5845,1000.00,10000.00,11000.00,0.00,10000.00,0.09,1
58436,5845,1000.00,11000.00,12000.00,0.00,11000.00,0.20,1
58437,5845,1000.00,12000.00,13000.00,0.00,7981.17,0.36,1
58438,5845,1000.00,13000.00,14000.00,0.00,12057.46,0.35,1
58439,5845,1000.00,14000.00,15000.00,0.00,14000.00,0.21,1
58440,5845,-1000.00,13000.00,14000.00,4819.50,0.00,0.05,0
58441,5845,1000.00,14000.00,15000.00,6015.23,7984.77,0.14,1
58442,5845,1000.00,15000.00,16000.00,0.00,9335.03,0.29,1
58443,5845,1000.00,16000.00,17000.00,0.00,16000.00,0.29,1
58444,5845,1000.00,17000.00,18000.00,3916.68,13083.32,0.39,1
58445,5845,1000.00,18000.00,19000.00,0.00,16949.52,0.38,1
58446,5845,1000.00,19000.00,20000.00,0.00,3243.93,0.10,1
58447,5845,1000.00,20000.00,21000.00,6680.96,13319.04,0.32,1
58448,5845,1000.00,21000.00,22000.00,0.00,16829.33,0.36,1
58449,5845,1000.00,22000.00,23000.00,0.00,22000.00,0.16,1
58450,5845,1000.00,23000.00,24000.00,0.00,11017.58,0.28,1
58451,5845,1000.00,24000.00,25000.00,7417.01,16582.99,0.35,1
58452,5845,1000.00,25000.00,26000.00,4962.95,6971.81,0.20,1
58453,5845,1000.00,26000.00,27000.00,9032.34,16967.66,0.33,1
58454,5845,1000.00,27000.00,28000.00,0.00,8206.57,0.20,1
58455,5845,1000.00,28000.00,29000.00,0.00,13346.49,0.23,1
58456,5845,1000.00,29000.00,30000.00,9405.48,19594.52,0.27,1
58457,5845,0.00,29000.00,30000.00,0.00,0.00,0.13,0
58458,5845,1000.00,30000.00,31000.00,0.00,6323.95,0.17,1
58459,5845,1000.00,31000.00,32000.00,8532.94,22467.06,0.08,1
58460,5845,1000.00,32000.00,33000.00,6371.61,25628.39,0.39,1
58461,5845,1000.00,33000.00,34000.00,6450.71,26549.29,0.26,1
58462,5845,1000.00,34000.00,35000.00,257.08,33742.92,0.18,1
58463,5845,1000.00,35000.00,36000.00,0.00,35000.00,0.41,1
58464,5846,1000.00,1000.00,2000.00,399.03,0.00,0.19,1
58465,5846,0.00,1000.00,2000.00,0.00,0.00,0.30,0
58466,5846,1000.00,2000.00,3000.00,1096.86,903.14,0.15,1
58467,5846,-1000.00,1000.00,2000.00,397.79,2602.21,0.41,0
58468,5846,1000.00,2000.00,3000.00,1071.71,451.44,0.13,1
58469,5846,-1000.00,1000.00,2000.00,0.00,3000.00,0.14,0
58470,5846,1000.00,2000.00,3000.00,1886.32,113.68,0.01,1
58471,5846,-1000.00,1000.00,2000.00,0.00,1294.38,0.12,0
58472,5846,-1000.00,0.00,1000.00,0.00,2000.00,0.07,0
58473,5846,-1000.00,-1000.00,0.00,0.00,1000.00,0.10,0
58474,5847,-1000.00,-1000.00,0.00,0.00,1000.00,0.42,0
58475,5848,1000.00,1000.00,2000.00,1000.00,0.00,0.02,1
58476,5848,0.00,1000.00,2000.00,0.00,0.00,0.10,0
58477,5848,-1000.00,0.00,1000.00,634.54,776.62,0.35,0
58478,5848,-915.63,-915.63,84.37,0.00,915.63,0.37,0
58479,5848,-48.93,-964.56,35.44,0.00,48.93,0.20,0
58480,5848,-10.99,-975.55,24.45,0.00,10.99,0.35,0
58481,5848,-24.45,-1000.00,0.00,0.00,24.45,0.14,0
58482,5849,-1000.00,-1000.00,0.00,951.73,48.27,0.07,0
58483,5850,-1000.00,-1000.00,0.00,0.00,1000.00,0.03,0
58484,5851,-756.67,-756.67,243.33,538.56,218.11,0.28,0
58485,5851,-243.33,-1000.00,0.00,243.33,0.00,0.05,0
58486,5852,-969.39,-969.39,30.61,0.00,969.39,0.32,0
58487,5852,-1000.00,-1969.39,-969.39,21.51,0.00,0.05,0
58488,5853,-1000.00,-1000.00,0.00,695.72,304.28,0.00,0
58489,5854,-1000.00,-1000.00,0.00,0.00,1000.00,0.01,0
58490,5855,-656.04,-656.04,343.96,656.04,0.00,0.19,0
58491,5855,145.79,-510.25,489.75,0.00,1.16,0.39,1
58492,5855,0.00,-510.25,489.75,0.00,0.00,0.01,0
58493,5855,1000.00,489.75,1489.75,225.20,264.56,0.16,1
58494,5855,1000.00,1489.75,2489.75,744.88,744.88,0.10,1
58495,5855,1000.00,2489.75,3489.75,0.00,1016.64,0.17,1
58496,5855,1000.00,3489.75,4489.75,0.00,1545.52,0.24,1
58497,5855,1000.00,4489.75,5489.75,0.00,2238.92,0.30,1
58498,5855,-1000.00,3489.75,4489.75,3028.28,2461.47,0.10,0
58499,5855,1000.00,4489.75,5489.75,330.59,3034.42,0.38,1
58500,5855,1000.00,5489.75,6489.75,590.09,4899.66,0.37,1
58501,5855,-1000.00,4489.75,5489.75,2118.59,1927.06,0.19,0
58502,5855,1000.00,5489.75,6489.75,0.00,3257.46,0.09,1
58503,5855,0.00,5489.75,6489.75,0.00,0.00,0.01,0
58504,5855,0.00,5489.75,6489.75,0.00,0.00,0.05,0
58505,5855,1000.00,6489.75,7489.75,0.00,2203.91,0.07,1
58506,5855,1000.00,7489.75,8489.75,0.00,3009.04,0.25,1
58507,5855,1000.00,8489.75,9489.75,0.00,3906.53,0.10,1
58508,5855,-1000.00,7489.75,8489.75,3585.64,2981.18,0.19,0
58509,5855,-1000.00,6489.75,7489.75,5942.74,2547.01,0.07,0
58510,5855,1000.00,7489.75,8489.75,0.00,7489.75,0.22,1
58511,5855,1000.00,8489.75,9489.75,0.00,8489.75,0.10,1
58512,5855,1000.00,9489.75,10489.75,0.00,9489.75,0.29,1
58513,5855,1000.00,10489.75,11489.75,0.00,10489.75,0.27,1
58514,5855,1000.00,11489.75,12489.75,0.00,9290.68,0.05,1
58515,5855,1000.00,12489.75,13489.75,164.59,12304.57,0.44,1
58516,5855,1000.00,13489.75,14489.75,0.00,13489.75,0.38,1
58517,5855,1000.00,14489.75,15489.75,2646.92,11842.83,0.36,1
58518,5855,1000.00,15489.75,16489.75,3694.37,11795.38,0.30,1
58519,5855,1000.00,16489.75,17489.75,0.00,13884.48,0.11,1
58520,5855,1000.00,17489.75,18489.75,0.00,17489.75,0.18,1
58521,5855,-1000.00,16489.75,17489.75,4897.44,4414.30,0.18,0
58522,5856,-1000.00,-1000.00,0.00,0.00,1000.00,0.11,0
58523,5857,0.00,0.00,1000.00,0.00,0.00,0.22,0
58524,5857,0.00,0.00,1000.00,0.00,0.00,0.42,0
58525,5857,1000.00,1000.00,2000.00,0.00,1000.00,0.42,1
58526,5857,1000.00,2000.00,3000.00,400.16,1599.84,0.24,1
58527,5857,1000.00,3000.00,4000.00,0.00,2948.86,0.41,1
58528,5857,1000.00,4000.00,5000.00,0.00,4000.00,0.15,1
58529,5857,-1000.00,3000.00,4000.00,2638.62,2361.38,0.04,0
58530,5857,1000.00,4000.00,5000.00,903.53,1080.34,0.20,1
58531,5857,1000.00,5000.00,6000.00,0.00,3603.13,0.33,1
58532,5857,1000.00,6000.00,7000.00,0.00,1553.87,0.21,1
58533,5857,1000.00,7000.00,8000.00,0.00,6979.22,0.34,1
58534,5857,1000.00,8000.00,9000.00,3722.20,4277.80,0.23,1
58535,5857,1000.00,9000.00,10000.00,1386.82,7613.18,0.22,1
58536,5857,-1000.00,8000.00,9000.00,5045.56,4954.44,0.16,0
58537,5857,1000.00,9000.00,10000.00,0.00,7503.59,0.31,1
58538,5857,1000.00,10000.00,11000.00,0.00,5797.66,0.05,1
58539,5857,1000.00,11000.00,12000.00,0.00,11000.00,0.09,1
58540,5857,1000.00,12000.00,13000.00,2817.54,9182.46,0.05,1
58541,5857,1000.00,13000.00,14000.00,1996.11,11003.89,0.28,1
58542,5857,1000.00,14000.00,15000.00,0.00,12900.39,0.43,1
58543,5857,1000.00,15000.00,16000.00,2083.10,12916.90,0.37,1
58544,5857,1000.00,16000.00,17000.00,1648.21,10633.51,0.37,1
58545,5857,1000.00,17000.00,18000.00,0.00,17000.00,0.07,1
58546,5857,1000.00,18000.00,19000.00,55.14,6192.79,0.24,1
58547,5857,-1000.00,17000.00,18000.00,0.00,2698.72,0.14,0
58548,5857,-1000.00,16000.00,17000.00,0.00,3230.58,0.30,0
58549,5857,-1000.00,15000.00,16000.00,1339.89,11891.97,0.39,0
58550,5857,-1000.00,14000.00,15000.00,8000.00,8000.00,0.07,0
58551,5857,-1000.00,13000.00,14000.00,5292.85,9707.15,0.32,0
58552,5857,-1000.00,12000.00,13000.00,6328.40,7671.60,0.23,0
58553,5857,-1000.00,11000.00,12000.00,0.00,12786.80,0.01,0
58554,5857,-1000.00,10000.00,11000.00,0.00,6931.22,0.06,0
58555,5857,-1000.00,9000.00,10000.00,4075.75,6924.25,0.30,0
58556,5857,-1000.00,8000.00,9000.00,0.00,8158.48,0.12,0
58557,5857,-1000.00,7000.00,8000.00,3348.20,5651.80,0.15,0
58558,5857,-1000.00,6000.00,7000.00,0.00,8000.00,0.39,0
58559,5857,-1000.00,5000.00,6000.00,2474.59,0.00,0.08,0
58560,5857,-1000.00,4000.00,5000.00,0.00,6000.00,0.07,0
58561,5857,-486.06,3513.94,4513.94,0.00,486.06,0.20,0
58562,5857,-1000.00,2513.94,3513.94,0.00,3438.17,0.37,0
58563,5857,1000.00,3513.94,4513.94,1639.87,0.00,0.06,1
58564,5857,-1000.00,2513.94,3513.94,0.00,1996.44,0.34,0
58565,5857,-568.42,1945.52,2945.52,0.00,568.42,0.02,0
58566,5858,1000.00,1000.00,2000.00,588.21,411.79,0.02,1
58567,5858,-551.32,448.68,1448.68,0.00,551.32,0.31,0
58568,5858,-1000.00,-551.32,448.68,0.00,1219.99,0.19,0
58569,5858,1000.00,448.68,1448.68,189.94,89.47,0.23,1
58570,5858,-1000.00,-551.32,448.68,644.82,803.87,0.18,0
58571,5858,-403.24,-954.56,45.44,174.60,228.65,0.26,0
58572,5858,326.40,-628.16,371.84,2.63,0.00,0.09,1
58573,5858,-371.84,-1000.00,0.00,94.61,277.23,0.07,0
58574,5859,-1000.00,-1000.00,0.00,593.51,18.95,0.07,0
58575,5860,-1000.00,-1000.00,0.00,705.73,205.88,0.09,0
58576,5861,1000.00,1000.00,2000.00,95.99,612.28,0.35,1
58577,5861,1000.00,2000.00,3000.00,41.56,1396.14,0.39,1
58578,5861,1000.00,3000.00,4000.00,952.17,2047.83,0.33,1
58579,5861,-1000.00,2000.00,3000.00,3405.20,0.00,0.02,0
58580,5861,1000.00,3000.00,4000.00,0.00,3000.00,0.41,1
58581,5861,1000.00,4000.00,5000.00,0.00,4000.00,0.27,1
58582,5861,1000.00,5000.00,6000.00,1153.85,3846.15,0.39,1
58583,5861,1000.00,6000.00,7000.00,0.00,1988.17,0.18,1
58584,5861,1000.00,7000.00,8000.00,3316.66,3683.34,0.23,1
58585,5861,1000.00,8000.00,9000.00,0.00,3667.00,0.27,1
58586,5861,1000.00,9000.00,10000.00,0.00,6673.77,0.33,1
58587,5861,1000.00,10000.00,11000.00,0.00,6908.72,0.18,1
58588,5861,1000.00,11000.00,12000.00,2206.68,8793.32,0.13,1
58589,5861,1000.00,12000.00,13000.00,0.00,12000.00,0.07,1
58590,5861,1000.00,13000.00,14000.00,0.00,11060.02,0.40,1
58591,5861,1000.00,14000.00,15000.00,0.00,11144.03,0.10,1
58592,5861,1000.00,15000.00,16000.00,0.00,15000.00,0.10,1
58593,5861,1000.00,16000.00,17000.00,0.00,16000.00,0.44,1
58594,5861,1000.00,17000.00,18000.00,1812.26,5303.01,0.23,1
58595,5861,1000.00,18000.00,19000.00,5461.33,11942.17,0.33,1
58596,5861,1000.00,19000.00,20000.00,9496.27,9503.73,0.22,1
58597,5861,-1000.00,18000.00,19000.00,10406.97,9593.03,0.02,0
58598,5861,-1000.00,17000.00,18000.00,14260.52,4739.48,0.07,0
58599,5861,-1000.00,16000.00,17000.00,8327.01,9672.99,0.21,0
58600,5861,-1000.00,15000.00,16000.00,5162.67,11837.33,0.06,0
58601,5861,-1000.00,14000.00,15000.00,79.68,15920.32,0.41,0
58602,5861,-1000.00,13000.00,14000.00,0.00,15000.00,0.28,0
58603,5861,-1000.00,12000.00,13000.00,2138.64,11861.36,0.33,0
58604,5861,-1000.00,11000.00,12000.00,4119.72,8880.28,0.24,0
58605,5861,-1000.00,10000.00,11000.00,3236.67,8763.33,0.18,0
58606,5861,-1000.00,9000.00,10000.00,1903.33,9096.67,0.00,0
58607,5861,-1000.00,8000.00,9000.00,1692.53,8307.47,0.41,0
58608,5861,-1000.00,7000.00,8000.00,0.00,5231.19,0.12,0
58609,5861,-1000.00,6000.00,7000.00,0.00,3408.96,0.27,0
58610,5861,-1000.00,5000.00,6000.00,3263.64,0.00,0.03,0
58611,5861,-1000.00,4000.00,5000.00,0.00,4792.51,0.38,0
58612,5861,-1000.00,3000.00,4000.00,1342.35,3657.65,0.36,0
58613,5861,-1000.00,2000.00,3000.00,1875.20,918.89,0.14,0
58614,5861,-1000.00,1000.00,2000.00,1887.87,458.30,0.09,0
58615,5861,0.00,1000.00,2000.00,0.00,0.00,0.03,0
58616,5861,-1000.00,0.00,1000.00,0.00,2000.00,0.40,0
58617,5861,-327.38,-327.38,672.62,0.00,327.38,0.06,0
58618,5861,1000.00,672.62,1672.62,243.28,429.33,0.32,1
58619,5861,1000.00,1672.62,2672.62,0.00,1672.62,0.29,1
58620,5861,1000.00,2672.62,3672.62,1336.31,1336.31,0.07,1
58621,5861,-900.89,1771.73,2771.73,900.89,0.00,0.06,0
58622,5861,-1000.00,771.73,1771.73,0.00,237.98,0.44,0
58623,5861,-1000.00,-228.27,771.73,0.00,30.41,0.43,0
58624,5861,0.00,-228.27,771.73,0.00,0.00,0.05,0
58625,5861,-631.40,-859.67,140.33,631.40,0.00,0.14,0
58626,5861,0.00,-859.67,140.33,0.00,0.00,0.35,0
58627,5861,1000.00,140.33,1140.33,0.00,140.33,0.19,1
58628,5861,1000.00,1140.33,2140.33,0.00,1140.33,0.05,1
58629,5861,1000.00,2140.33,3140.33,0.00,1014.01,0.24,1
58630,5861,1000.00,3140.33,4140.33,1330.46,1809.88,0.17,1
58631,5861,1000.00,4140.33,5140.33,1736.26,2404.08,0.06,1
58632,5861,1000.00,5140.33,6140.33,0.00,5140.33,0.31,1
58633,5861,1000.00,6140.33,7140.33,1897.73,4242.61,0.30,1
58634,5861,1000.00,7140.33,8140.33,58.47,7081.87,0.44,1
58635,5861,0.00,7140.33,8140.33,0.00,0.00,0.05,0
58636,5861,1000.00,8140.33,9140.33,0.00,858.11,0.08,1
58637,5861,1000.00,9140.33,10140.33,3997.30,5143.03,0.13,1
58638,5861,1000.00,10140.33,11140.33,0.00,479.66,0.12,1
58639,5861,1000.00,11140.33,12140.33,5570.17,5570.17,0.00,1
58640,5862,-678.35,-678.35,321.65,0.00,678.35,0.31,0
58641,5862,-137.74,-816.09,183.91,0.00,137.74,0.34,0
58642,5862,-183.91,-1000.00,0.00,0.00,183.91,0.04,0
58643,5863,-1000.00,-1000.00,0.00,0.00,1000.00,0.18,0
58644,5864,-981.47,-981.47,18.53,662.09,319.37,0.13,0
58645,5864,1000.00,18.53,1018.53,0.00,18.53,0.24,1
58646,5864,-193.27,-174.73,825.27,193.27,0.00,0.07,0
58647,5864,1000.00,825.27,1825.27,19.51,754.37,0.44,1
58648,5864,-1000.00,-174.73,825.27,1172.79,652.47,0.01,0
58649,5864,1000.00,825.27,1825.27,386.98,438.29,0.23,1
58650,5864,1000.00,1825.27,2825.27,692.25,1133.02,0.24,1
58651,5864,1000.00,2825.27,3825.27,0.00,2825.27,0.36,1
58652,5864,1000.00,3825.27,4825.27,0.00,3071.61,0.41,1
58653,5864,1000.00,4825.27,5825.27,2107.25,2718.02,0.25,1
58654,5864,-1000.00,3825.27,4825.27,4092.77,1732.49,0.02,0
58655,5864,1000.00,4825.27,5825.27,959.25,3866.01,0.37,1
58656,5864,1000.00,5825.27,6825.27,0.00,5825.27,0.41,1
58657,5864,1000.00,6825.27,7825.27,0.00,6825.27,0.39,1
58658,5864,1000.00,7825.27,8825.27,3314.76,4510.51,0.21,1
58659,5864,1000.00,8825.27,9825.27,0.00,8825.27,0.10,1
58660,5864,1000.00,9825.27,10825.27,651.98,9173.28,0.25,1
58661,5864,1000.00,10825.27,11825.27,3607.25,7218.02,0.17,1
58662,5864,1000.00,11825.27,12825.27,0.00,11825.27,0.30,1
58663,5864,1000.00,12825.27,13825.27,4109.29,8715.98,0.33,1
58664,5864,1000.00,13825.27,14825.27,4488.56,9336.71,0.32,1
58665,5864,1000.00,14825.27,15825.27,0.00,12049.69,0.41,1
58666,5864,1000.00,15825.27,16825.27,0.00,12680.89,0.38,1
58667,5864,-1000.00,14825.27,15825.27,2491.28,0.00,0.03,0
58668,5864,-1000.00,13825.27,14825.27,1073.20,14752.06,0.15,0
58669,5864,-1000.00,12825.27,13825.27,7412.63,7412.63,0.01,0
58670,5864,-1000.00,11825.27,12825.27,0.00,13825.27,0.18,0
58671,5864,-1000.00,10825.27,11825.27,0.00,11889.63,0.39,0
58672,5864,-1000.00,9825.27,10825.27,0.00,7632.06,0.28,0
58673,5864,-1000.00,8825.27,9825.27,0.00,10825.27,0.06,0
58674,5864,-1000.00,7825.27,8825.27,0.00,8717.00,0.21,0
58675,5864,-1000.00,6825.27,7825.27,0.00,8825.27,0.34,0
58676,5864,-1000.00,5825.27,6825.27,0.00,7235.07,0.16,0
58677,5864,-1000.00,4825.27,5825.27,0.00,3452.90,0.09,0
58678,5864,-1000.00,3825.27,4825.27,0.00,3597.31,0.36,0
58679,5864,-1000.00,2825.27,3825.27,0.00,1993.78,0.27,0
58680,5864,-1000.00,1825.27,2825.27,0.00,3825.27,0.02,0
58681,5864,-1000.00,825.27,1825.27,1108.57,1716.69,0.26,0
58682,5864,-1000.00,-174.73,825.27,241.76,1010.48,0.33,0
58683,5864,-825.27,-1000.00,0.00,42.01,783.26,0.18,0
58684,5864,-0.00,-1000.00,0.00,0.00,0.00,0.22,0
58685,5864,-0.00,-1000.00,0.00,0.00,0.00,0.23,0
58686,5865,-624.65,-624.65,375.35,0.00,624.65,0.34,0
58687,5865,-44.62,-669.27,330.73,0.00,44.62,0.15,0
58688,5865,-330.73,-1000.00,0.00,0.00,330.73,0.08,0
58689,5866,1000.00,1000.00,2000.00,7.93,724.28,0.40,1
58690,5866,1000.00,2000.00,3000.00,494.82,1505.18,0.14,1
58691,5866,1000.00,3000.00,4000.00,276.80,2445.65,0.42,1
58692,5866,1000.00,4000.00,5000.00,0.00,4000.00,0.23,1
58693,5866,1000.00,5000.00,6000.00,0.00,5000.00,0.23,1
58694,5866,1000.00,6000.00,7000.00,0.00,6000.00,0.02,1
58695,5866,1000.00,7000.00,8000.00,0.00,7000.00,0.19,1
58696,5866,1000.00,8000.00,9000.00,148.07,6922.52,0.43,1
58697,5866,1000.00,9000.00,10000.00,0.00,9000.00,0.14,1
58698,5866,1000.00,10000.00,11000.00,0.00,10000.00,0.29,1
58699,5866,1000.00,11000.00,12000.00,2102.50,8897.50,0.08,1
58700,5866,-1000.00,10000.00,11000.00,6897.62,5102.38,0.05,0
58701,5866,1000.00,11000.00,12000.00,0.00,11000.00,0.04,1
58702,5866,1000.00,12000.00,13000.00,1841.05,4702.60,0.26,1
58703,5866,-1000.00,11000.00,12000.00,2076.81,0.00,0.02,0
58704,5866,1000.00,12000.00,13000.00,0.00,12000.00,0.14,1
58705,5866,1000.00,13000.00,14000.00,0.00,13000.00,0.29,1
58706,5866,1000.00,14000.00,15000.00,0.00,14000.00,0.09,1
58707,5866,1000.00,15000.00,16000.00,0.00,7077.07,0.30,1
58708,5866,1000.00,16000.00,17000.00,0.00,16000.00,0.41,1
58709,5866,0.00,16000.00,17000.00,0.00,0.00,0.03,0
58710,5866,1000.00,17000.00,18000.00,0.00,17000.00,0.12,1
58711,5866,1000.00,18000.00,19000.00,8924.66,9075.34,0.04,1
58712,5866,1000.00,19000.00,20000.00,4514.87,14485.13,0.30,1
58713,5866,1000.00,20000.00,21000.00,0.00,20000.00,0.12,1
58714,5866,1000.00,21000.00,22000.00,802.33,20197.67,0.14,1
58715,5866,1000.00,22000.00,23000.00,0.00,22000.00,0.29,1
58716,5866,1000.00,23000.00,24000.00,0.00,23000.00,0.33,1
58717,5866,1000.00,24000.00,25000.00,5670.78,18329.22,0.38,1
58718,5866,1000.00,25000.00,26000.00,0.00,25000.00,0.42,1
58719,5866,1000.00,26000.00,27000.00,0.00,21566.62,0.42,1
58720,5866,-1000.00,25000.00,26000.00,15009.01,11990.99,0.16,0
58721,5866,0.00,25000.00,26000.00,0.00,0.00,0.07,0
58722,5866,1000.00,26000.00,27000.00,0.00,20082.51,0.24,1
58723,5866,1000.00,27000.00,28000.00,0.00,15022.56,0.33,1
58724,5866,1000.00,28000.00,29000.00,0.00,12711.14,0.24,1
58725,5866,1000.00,29000.00,30000.00,0.00,17578.96,0.16,1
58726,5866,1000.00,30000.00,31000.00,0.00,30000.00,0.13,1
58727,5866,1000.00,31000.00,32000.00,1899.95,11931.02,0.26,1
58728,5867,-1000.00,-1000.00,0.00,446.55,553.45,0.14,0
58729,5868,1000.00,1000.00,2000.00,287.11,712.89,0.19,1
58730,5868,1000.00,2000.00,3000.00,0.00,2000.00,0.37,1
58731,5868,1000.00,3000.00,4000.00,0.00,3000.00,0.02,1
58732,5868,-1000.00,2000.00,3000.00,2234.12,1765.88,0.17,0
58733,5868,-1000.00,1000.00,2000.00,1812.66,1187.34,0.06,0
58734,5868,1000.00,2000.00,3000.00,490.63,1509.37,0.38,1
58735,5868,1000.00,3000.00,4000.00,247.76,2752.24,0.42,1
58736,5868,1000.00,4000.00,5000.00,0.00,4000.00,0.12,1
58737,5868,1000.00,5000.00,6000.00,0.00,1134.14,0.18,1
58738,5868,1000.00,6000.00,7000.00,2702.64,3297.36,0.21,1
58739,5868,1000.00,7000.00,8000.00,985.67,2266.55,0.23,1
58740,5868,1000.00,8000.00,9000.00,0.00,3602.11,0.23,1
58741,5868,1000.00,9000.00,10000.00,0.00,8819.28,0.42,1
58742,5868,1000.00,10000.00,11000.00,0.00,10000.00,0.24,1
58743,5868,1000.00,11000.00,12000.00,0.00,3800.55,0.24,1
58744,5868,1000.00,12000.00,13000.00,0.00,5725.84,0.08,1
58745,5868,-1000.00,11000.00,12000.00,6811.90,6188.10,0.12,0
58746,5868,1000.00,12000.00,13000.00,0.00,12000.00,0.26,1
58747,5868,1000.00,13000.00,14000.00,0.00,11307.21,0.19,1
58748,5868,1000.00,14000.00,15000.00,0.00,14000.00,0.25,1
58749,5868,1000.00,15000.00,16000.00,4419.06,10580.94,0.34,1
58750,5868,1000.00,16000.00,17000.00,1721.23,6809.98,0.28,1
58751,5868,-1000.00,15000.00,16000.00,0.00,17000.00,0.14,0
58752,5868,-1000.00,14000.00,15000.00,0.00,9349.66,0.31,0
58753,5868,-1000.00,13000.00,14000.00,2876.56,12123.44,0.17,0
58754,5868,-1000.00,12000.00,13000.00,2606.26,9310.40,0.36,0
58755,5868,-1000.00,11000.00,12000.00,0.00,12105.22,0.09,0
58756,5868,-1000.00,10000.00,11000.00,7078.90,4921.10,0.00,0
58757,5868,-1000.00,9000.00,10000.00,0.00,5411.45,0.07,0
58758,5868,-1000.00,8000.00,9000.00,828.73,7601.04,0.40,0
58759,5868,-1000.00,7000.00,8000.00,0.00,9000.00,0.17,0
58760,5868,-1000.00,6000.00,7000.00,5362.57,2637.43,0.12,0
58761,5868,-1000.00,5000.00,6000.00,3134.95,3865.05,0.17,0
58762,5868,-1000.00,4000.00,5000.00,3000.00,3000.00,0.09,0
58763,5868,-1000.00,3000.00,4000.00,0.00,3308.18,0.28,0
58764,5868,-1000.00,2000.00,3000.00,0.00,3315.19,0.06,0
58765,5868,-1000.00,1000.00,2000.00,1538.38,1461.62,0.07,0
58766,5868,-1000.00,0.00,1000.00,393.52,1606.48,0.29,0
58767,5868,-1000.00,-1000.00,0.00,369.79,630.21,0.15,0
58768,5869,-985.69,-985.69,14.31,0.00,985.69,0.44,0
58769,5869,-14.31,-1000.00,0.00,1.82,12.49,0.32,0
58770,5870,-1000.00,-1000.00,0.00,672.43,327.57,0.03,0
58771,5871,-885.71,-885.71,114.29,0.00,885.71,0.42,0
58772,5871,-114.29,-1000.00,0.00,44.91,69.38,0.26,0
58773,5872,1000.00,1000.00,2000.00,161.82,838.18,0.39,1
58774,5872,1000.00,2000.00,3000.00,0.00,1238.92,0.18,1
58775,5872,1000.00,3000.00,4000.00,1320.31,1679.69,0.20,1
58776,5872,1000.00,4000.00,5000.00,0.00,4000.00,0.18,1
58777,5872,1000.00,5000.00,6000.00,1818.51,3181.49,0.01,1
58778,5872,1000.00,6000.00,7000.00,589.82,5410.18,0.27,1
58779,5872,1000.00,7000.00,8000.00,3350.20,3649.80,0.13,1
58780,5872,1000.00,8000.00,9000.00,0.00,8000.00,0.20,1
58781,5872,1000.00,9000.00,10000.00,777.58,8222.42,0.42,1
58782,5872,1000.00,10000.00,11000.00,0.00,7531.71,0.24,1
58783,5872,1000.00,11000.00,12000.00,3670.03,7329.97,0.13,1
58784,5872,1000.00,12000.00,13000.00,0.00,12000.00,0.30,1
58785,5872,1000.00,13000.00,14000.00,0.00,13000.00,0.02,1
58786,5872,1000.00,14000.00,15000.00,1455.34,12544.66,0.43,1
58787,5872,1000.00,15000.00,16000.00,0.00,14266.88,0.12,1
58788,5872,1000.00,16000.00,17000.00,2594.89,13405.11,0.42,1
58789,5872,1000.00,17000.00,18000.00,0.00,17000.00,0.39,1
58790,5872,1000.00,18000.00,19000.00,7209.22,10790.78,0.08,1
58791,5872,-1000.00,17000.00,18000.00,3686.06,1802.52,0.13,0
58792,5872,1000.00,18000.00,19000.00,0.00,16203.44,0.34,1
58793,5872,1000.00,19000.00,20000.00,7037.21,11962.79,0.12,1
58794,5872,1000.00,20000.00,21000.00,0.00,19534.63,0.43,1
58795,5872,-1000.00,19000.00,20000.00,13421.59,7578.41,0.11,0
58796,5872,-1000.00,18000.00,19000.00,7965.40,0.00,0.06,0
58797,5872,1000.00,19000.00,20000.00,1744.64,17255.36,0.44,1
58798,5872,1000.00,20000.00,21000.00,3427.84,16572.16,0.10,1
58799,5872,1000.00,21000.00,22000.00,0.00,9105.92,0.27,1
58800,5872,0.00,21000.00,22000.00,0.00,0.00,0.00,0
58801,5872,1000.00,22000.00,23000.00,0.00,22000.00,0.09,1
58802,5872,-1000.00,21000.00,22000.00,14549.45,8450.55,0.01,0
58803,5872,1000.00,22000.00,23000.00,780.42,21219.58,0.44,1
58804,5872,-1000.00,21000.00,22000.00,0.00,23000.00,0.14,0
58805,5872,0.00,21000.00,22000.00,0.00,0.00,0.02,0
58806,5872,-1000.00,20000.00,21000.00,7795.78,10655.70,0.26,0
58807,5872,-1000.00,19000.00,20000.00,0.00,20652.39,0.23,0
58808,5872,-1000.00,18000.00,19000.00,0.00,20000.00,0.03,0
58809,5872,-1000.00,17000.00,18000.00,0.00,19000.00,0.18,0
58810,5872,-1000.00,16000.00,17000.00,928.47,17071.53,0.35,0
58811,5872,-1000.00,15000.00,16000.00,2169.10,14830.90,0.43,0
58812,5872,-1000.00,14000.00,15000.00,7119.59,8880.41,0.14,0
58813,5872,-1000.00,13000.00,14000.00,0.00,1158.60,0.11,0
58814,5873,-440.31,-440.31,559.69,440.31,0.00,0.34,0
58815,5873,-229.49,-669.79,330.21,229.49,0.00,0.03,0
58816,5873,-1000.00,-1669.79,-669.79,30.32,139.10,0.34,0
58817,5874,-1000.00,-1000.00,0.00,326.51,673.49,0.32,0
58818,5875,-1000.00,-1000.00,0.00,475.58,524.42,0.16,0
58819,5876,-1000.00,-1000.00,0.00,0.00,1000.00,0.14,0
58820,5877,1000.00,1000.00,2000.00,0.00,102.22,0.14,1
58821,5877,1000.00,2000.00,3000.00,424.22,1575.78,0.34,1
58822,5877,1000.00,3000.00,4000.00,0.00,3000.00,0.26,1
58823,5877,1000.00,4000.00,5000.00,0.00,3298.73,0.37,1
58824,5877,1000.00,5000.00,6000.00,342.54,4657.46,0.33,1
58825,5877,1000.00,6000.00,7000.00,0.00,4779.38,0.37,1
58826,5877,1000.00,7000.00,8000.00,0.00,7000.00,0.09,1
58827,5877,1000.00,8000.00,9000.00,0.00,8000.00,0.04,1
58828,5877,1000.00,9000.00,10000.00,0.00,9000.00,0.12,1
58829,5877,1000.00,10000.00,11000.00,0.00,8301.21,0.37,1
58830,5877,1000.00,11000.00,12000.00,0.00,11000.00,0.35,1
58831,5877,1000.00,12000.00,13000.00,339.93,4084.17,0.24,1
58832,5877,1000.00,13000.00,14000.00,2730.57,10269.43,0.39,1
58833,5877,1000.00,14000.00,15000.00,4919.16,9080.84,0.06,1
58834,5877,1000.00,15000.00,16000.00,100.30,14899.70,0.44,1
58835,5877,-1000.00,14000.00,15000.00,12738.55,3261.45,0.07,0
58836,5877,1000.00,15000.00,16000.00,6554.31,8445.69,0.18,1
58837,5877,1000.00,16000.00,17000.00,8000.00,8000.00,0.07,1
58838,5877,-1000.00,15000.00,16000.00,10030.04,6969.96,0.11,0
58839,5877,1000.00,16000.00,17000.00,0.00,15517.73,0.14,1
58840,5877,1000.00,17000.00,18000.00,7937.98,9062.02,0.15,1
58841,5877,1000.00,18000.00,19000.00,0.00,17538.78,0.42,1
58842,5877,1000.00,19000.00,20000.00,1325.44,14689.45,0.41,1
58843,5877,1000.00,20000.00,21000.00,0.00,20000.00,0.32,1
58844,5877,-1000.00,19000.00,20000.00,16726.57,4273.43,0.01,0
58845,5877,-1000.00,18000.00,19000.00,9931.24,4726.70,0.29,0
58846,5877,1000.00,19000.00,20000.00,0.00,8254.17,0.10,1
58847,5877,1000.00,20000.00,21000.00,5819.43,8835.31,0.25,1
58848,5877,1000.00,21000.00,22000.00,8676.65,12323.35,0.27,1
58849,5877,-1000.00,20000.00,21000.00,13169.39,7658.82,0.15,0
58850,5877,1000.00,21000.00,22000.00,0.00,11860.74,0.30,1
58851,5877,1000.00,22000.00,23000.00,9896.74,12103.26,0.25,1
58852,5877,-1000.00,21000.00,22000.00,3153.29,0.00,0.10,0
58853,5877,-1000.00,20000.00,21000.00,7332.71,3545.24,0.14,0
58854,5877,1000.00,21000.00,22000.00,8898.37,12101.63,0.16,1
58855,5877,-1000.00,20000.00,21000.00,12856.76,9143.24,0.16,0
58856,5877,1000.00,21000.00,22000.00,0.00,12950.82,0.36,1
58857,5877,1000.00,22000.00,23000.00,10276.60,11723.40,0.23,1
58858,5877,1000.00,23000.00,24000.00,0.00,14082.67,0.00,1
58859,5877,1000.00,24000.00,25000.00,0.00,24000.00,0.24,1
58860,5877,1000.00,25000.00,26000.00,2321.15,11388.73,0.29,1
58861,5877,1000.00,26000.00,27000.00,0.00,26000.00,0.05,1
58862,5877,1000.00,27000.00,28000.00,8067.42,18932.58,0.34,1
58863,5877,1000.00,28000.00,29000.00,0.00,28000.00,0.31,1
58864,5877,1000.00,29000.00,30000.00,10864.89,18135.11,0.22,1
58865,5877,1000.00,30000.00,31000.00,13393.14,16606.86,0.09,1
58866,5877,1000.00,31000.00,32000.00,0.00,31000.00,0.05,1
58867,5877,1000.00,32000.00,33000.00,0.00,32000.00,0.05,1
58868,5878,-1000.00,-1000.00,0.00,0.00,1000.00,0.40,0
58869,5879,1000.00,1000.00,2000.00,0.00,1000.00,0.19,1
58870,5879,1000.00,2000.00,3000.00,551.21,1448.79,0.33,1
58871,5879,1000.00,3000.00,4000.00,1400.88,1599.12,0.24,1
58872,5879,1000.00,4000.00,5000.00,0.00,4000.00,0.02,1
58873,5879,1000.00,5000.00,6000.00,0.00,5000.00,0.00,1
58874,5879,0.00,5000.00,6000.00,0.00,0.00,0.01,0
58875,5879,1000.00,6000.00,7000.00,0.00,6000.00,0.15,1
58876,5879,-1000.00,5000.00,6000.00,3774.03,3225.97,0.18,0
58877,5879,1000.00,6000.00,7000.00,0.00,6000.00,0.21,1
58878,5879,1000.00,7000.00,8000.00,682.41,5480.29,0.41,1
58879,5879,1000.00,8000.00,9000.00,0.00,6606.70,0.24,1
58880,5879,1000.00,9000.00,10000.00,3731.52,5268.48,0.16,1
58881,5879,1000.00,10000.00,11000.00,3282.87,6717.13,0.19,1
58882,5879,-1000.00,9000.00,10000.00,6542.58,4457.42,0.02,0
58883,5879,1000.00,10000.00,11000.00,2410.45,7589.55,0.39,1
58884,5879,1000.00,11000.00,12000.00,5049.17,5950.83,0.24,1
58885,5879,1000.00,12000.00,13000.00,1044.76,8436.92,0.39,1
58886,5879,1000.00,13000.00,14000.00,0.00,13000.00,0.17,1
58887,5879,1000.00,14000.00,15000.00,6027.78,7972.22,0.22,1
58888,5879,1000.00,15000.00,16000.00,2916.76,12083.24,0.03,1
58889,5879,1000.00,16000.00,17000.00,689.62,4348.27,0.21,1
58890,5879,1000.00,17000.00,18000.00,0.00,17000.00,0.09,1
58891,5879,1000.00,18000.00,19000.00,0.00,11199.23,0.24,1
58892,5879,1000.00,19000.00,20000.00,8130.73,10869.27,0.26,1
58893,5879,1000.00,20000.00,21000.00,0.00,18351.52,0.20,1
58894,5879,1000.00,21000.00,22000.00,0.00,20773.54,0.42,1
58895,5879,0.00,21000.00,22000.00,0.00,0.00,0.03,0
58896,5879,1000.00,22000.00,23000.00,2622.78,19377.22,0.43,1
58897,5879,1000.00,23000.00,24000.00,11500.00,11500.00,0.07,1
58898,5879,1000.00,24000.00,25000.00,8011.94,15988.06,0.22,1
58899,5879,1000.00,25000.00,26000.00,0.00,25000.00,0.05,1
58900,5879,1000.00,26000.00,27000.00,8993.08,17006.92,0.17,1
58901,5879,1000.00,27000.00,28000.00,0.00,27000.00,0.10,1
58902,5879,1000.00,28000.00,29000.00,0.00,28000.00,0.02,1
58903,5879,1000.00,29000.00,30000.00,9337.20,19662.80,0.20,1
58904,5879,1000.00,30000.00,31000.00,10991.44,19008.56,0.27,1
58905,5879,1000.00,31000.00,32000.00,12980.58,18019.42,0.02,1
58906,5879,1000.00,32000.00,33000.00,10793.03,21206.97,0.33,1
58907,5879,1000.00,33000.00,34000.00,0.00,26669.51,0.26,1
58908,5879,1000.00,34000.00,35000.00,4193.11,20866.45,0.35,1
58909,5879,1000.00,35000.00,36000.00,10111.47,24888.53,0.15,1
58910,5879,1000.00,36000.00,37000.00,0.00,36000.00,0.19,1
58911,5879,1000.00,37000.00,38000.00,18500.00,18500.00,0.09,1
58912,5879,1000.00,38000.00,39000.00,0.00,7704.84,0.18,1
58913,5879,-1000.00,37000.00,38000.00,22140.73,0.00,0.04,0
58914,5879,1000.00,38000.00,39000.00,1507.04,24759.69,0.37,1
58915,5879,-1000.00,37000.00,38000.00,23328.59,13032.02,0.15,0
58916,5879,-1000.00,36000.00,37000.00,7315.55,30684.45,0.39,0
58917,5879,-1000.00,35000.00,36000.00,4663.15,32336.85,0.18,0
58918,5879,-1000.00,34000.00,35000.00,6120.19,24252.80,0.37,0
58919,5879,-1000.00,33000.00,34000.00,48.00,34952.00,0.44,0
58920,5879,-1000.00,32000.00,33000.00,0.00,34000.00,0.43,0
58921,5879,-1000.00,31000.00,32000.00,12796.41,20203.59,0.18,0
58922,5879,-1000.00,30000.00,31000.00,0.00,32000.00,0.10,0
58923,5879,-1000.00,29000.00,30000.00,5685.67,24199.93,0.39,0
58924,5879,-1000.00,28000.00,29000.00,11216.61,18783.39,0.12,0
58925,5879,-1000.00,27000.00,28000.00,0.00,29000.00,0.37,0
58926,5879,-1000.00,26000.00,27000.00,0.00,28000.00,0.08,0
58927,5879,-1000.00,25000.00,26000.00,9970.12,17029.88,0.28,0
58928,5879,-1000.00,24000.00,25000.00,0.00,24976.13,0.43,0
58929,5879,-1000.00,23000.00,24000.00,0.00,16570.78,0.36,0
58930,5879,-1000.00,22000.00,23000.00,0.00,24000.00,0.11,0
58931,5879,-1000.00,21000.00,22000.00,5313.15,3822.41,0.16,0
58932,5879,-1000.00,20000.00,21000.00,4347.56,17652.44,0.41,0
58933,5879,-1000.00,19000.00,20000.00,11286.38,9713.62,0.18,0
58934,5879,-1000.00,18000.00,19000.00,2137.24,16531.29,0.42,0
58935,5879,-1000.00,17000.00,18000.00,0.00,12390.98,0.35,0
58936,5879,-1000.00,16000.00,17000.00,1437.04,13383.96,0.40,0
58937,5880,-1000.00,-1000.00,0.00,238.44,761.56,0.28,0
58938,5881,-1000.00,-1000.00,0.00,354.30,645.70,0.17,0
58939,5881,-0.00,-1000.00,0.00,0.00,0.00,0.33,0
58940,5882,0.00,0.00,1000.00,0.00,0.00,0.04,0
58941,5882,1000.00,1000.00,2000.00,574.30,0.00,0.27,1
58942,5882,1000.00,2000.00,3000.00,1757.86,0.00,0.14,1
58943,5882,-1000.00,1000.00,2000.00,1294.16,1323.36,0.22,0
58944,5882,-1000.00,0.00,1000.00,0.00,1335.51,0.13,0
58945,5882,-1000.00,-1000.00,0.00,432.16,567.84,0.20,0
58946,5883,0.00,0.00,1000.00,0.00,0.00,0.08,0
58947,5883,1000.00,1000.00,2000.00,1000.00,0.00,0.03,1
58948,5883,-370.45,629.55,1629.55,0.00,370.45,0.19,0
58949,5883,0.00,629.55,1629.55,0.00,0.00,0.19,0
58950,5883,-1000.00,-370.45,629.55,0.00,1419.13,0.10,0
58951,5883,0.00,-370.45,629.55,0.00,0.00,0.23,0
58952,5883,1000.00,629.55,1629.55,343.93,0.00,0.29,1
58953,5883,-1000.00,-370.45,629.55,453.99,1175.55,0.17,0
58954,5883,-302.62,-673.07,326.93,0.00,302.62,0.30,0
58955,5883,1000.00,326.93,1326.93,326.93,0.00,0.04,1
58956,5883,-486.16,-159.23,840.77,0.00,486.16,0.39,0
58957,5883,-191.47,-350.70,649.30,0.00,191.47,0.30,0
58958,5883,1000.00,649.30,1649.30,192.39,0.00,0.09,1
58959,5883,1000.00,1649.30,2649.30,1050.30,599.00,0.02,1
58960,5883,0.00,1649.30,2649.30,0.00,0.00,0.02,0
58961,5883,1000.00,2649.30,3649.30,1168.00,0.00,0.22,1
58962,5883,1000.00,3649.30,4649.30,1260.53,1037.91,0.34,1
58963,5883,1000.00,4649.30,5649.30,3206.64,1442.66,0.12,1
58964,5883,1000.00,5649.30,6649.30,4800.79,0.00,0.08,1
58965,5883,0.00,5649.30,6649.30,0.00,0.00,0.06,0
58966,5883,-1000.00,4649.30,5649.30,2596.55,4052.75,0.08,0
58967,5883,0.00,4649.30,5649.30,0.00,0.00,0.33,0
58968,5883,-1000.00,3649.30,4649.30,2817.93,2831.37,0.12,0
58969,5883,1000.00,4649.30,5649.30,3871.75,0.00,0.14,1
58970,5883,0.00,4649.30,5649.30,0.00,0.00,0.26,0
58971,5883,-1000.00,3649.30,4649.30,647.03,5002.27,0.06,0
58972,5883,-154.22,3495.08,4495.08,154.22,0.00,0.36,0
58973,5883,-1000.00,2495.08,3495.08,0.00,1006.35,0.40,0
58974,5883,-1000.00,1495.08,2495.08,0.00,2362.05,0.23,0
58975,5883,-1000.00,495.08,1495.08,1574.27,0.00,0.06,0
58976,5883,-436.72,58.36,1058.36,275.99,160.73,0.41,0
58977,5883,-1000.00,-941.64,58.36,791.24,267.11,0.14,0
58978,5883,-1000.00,-1941.64,-941.64,0.00,16.26,0.33,0
58979,5884,-1000.00,-1000.00,0.00,235.38,764.62,0.24,0
58980,5885,-782.46,-782.46,217.54,782.46,0.00,0.01,0
58981,5885,-1000.00,-1782.46,-782.46,0.00,119.71,0.34,0
58982,5886,-1000.00,-1000.00,0.00,0.00,813.07,0.05,0
58983,5887,-1000.00,-1000.00,0.00,0.00,1000.00,0.09,0
58984,5888,1000.00,1000.00,2000.00,390.17,609.83,0.18,1
58985,5888,1000.00,2000.00,3000.00,1000.00,1000.00,0.05,1
58986,5888,1000.00,3000.00,4000.00,0.00,1224.44,0.19,1
58987,5888,1000.00,4000.00,5000.00,0.00,4000.00,0.02,1
58988,5888,1000.00,5000.00,6000.00,0.00,2010.46,0.16,1
58989,5888,1000.00,6000.00,7000.00,0.00,6000.00,0.10,1
58990,5888,1000.00,7000.00,8000.00,0.00,7000.00,0.09,1
58991,5888,-1000.00,6000.00,7000.00,5916.04,2083.96,0.07,0
58992,5888,1000.00,7000.00,8000.00,2355.85,4644.15,0.23,1
58993,5888,1000.00,8000.00,9000.00,208.38,5892.50,0.40,1
58994,5888,1000.00,9000.00,10000.00,2417.01,6582.99,0.36,1
58995,5888,0.00,9000.00,10000.00,0.00,0.00,0.04,0
58996,5888,1000.00,10000.00,11000.00,0.00,10000.00,0.27,1
58997,5888,-1000.00,9000.00,10000.00,5808.95,5191.05,0.12,0
58998,5888,1000.00,10000.00,11000.00,4437.69,5562.31,0.10,1
58999,5888,-1000.00,9000.00,10000.00,5551.55,5448.45,0.17,0
59000,5888,1000.00,10000.00,11000.00,0.00,10000.00,0.08,1
59001,5888,1000.00,11000.00,12000.00,0.00,9080.85,0.25,1
59002,5888,1000.00,12000.00,13000.00,0.00,12000.00,0.38,1
59003,5888,1000.00,13000.00,14000.00,0.00,13000.00,0.42,1
59004,5888,1000.00,14000.00,15000.00,3710.60,10289.40,0.29,1
59005,5888,1000.00,15000.00,16000.00,2293.90,12706.10,0.38,1
59006,5888,1000.00,16000.00,17000.00,6764.31,9235.69,0.14,1
59007,5888,1000.00,17000.00,18000.00,0.00,11516.67,0.36,1
59008,5888,1000.00,18000.00,19000.00,0.00,601.99,0.04,1
59009,5888,1000.00,19000.00,20000.00,7108.50,11891.50,0.15,1
59010,5888,1000.00,20000.00,21000.00,10000.00,10000.00,0.09,1
59011,5888,1000.00,21000.00,22000.00,0.00,10394.87,0.22,1
59012,5888,1000.00,22000.00,23000.00,0.00,18355.86,0.37,1
59013,5888,1000.00,23000.00,24000.00,0.00,23000.00,0.10,1
59014,5888,1000.00,24000.00,25000.00,0.00,24000.00,0.02,1
59015,5888,1000.00,25000.00,26000.00,5541.51,19458.49,0.37,1
59016,5888,1000.00,26000.00,27000.00,0.00,25436.59,0.44,1
59017,5888,0.00,26000.00,27000.00,0.00,0.00,0.08,0
59018,5888,1000.00,27000.00,28000.00,9953.18,17046.82,0.26,1
59019,5888,1000.00,28000.00,29000.00,4956.98,23043.02,0.41,1
59020,5888,1000.00,29000.00,30000.00,5024.52,23975.48,0.25,1
59021,5888,-1000.00,28000.00,29000.00,7257.98,7083.05,0.18,0
59022,5888,1000.00,29000.00,30000.00,0.00,29000.00,0.20,1
59023,5888,1000.00,30000.00,31000.00,0.00,22302.62,0.38,1
59024,5888,1000.00,31000.00,32000.00,0.00,6905.61,0.18,1
59025,5888,1000.00,32000.00,33000.00,7506.11,24493.89,0.33,1
59026,5888,1000.00,33000.00,34000.00,0.00,23957.75,0.27,1
59027,5888,1000.00,34000.00,35000.00,0.00,34000.00,0.42,1
59028,5888,0.00,34000.00,35000.00,0.00,0.00,0.02,0
59029,5889,1000.00,1000.00,2000.00,0.00,1000.00,0.31,1
59030,5889,1000.00,2000.00,3000.00,0.00,1608.66,0.34,1
59031,5889,1000.00,3000.00,4000.00,0.00,3000.00,0.01,1
59032,5889,1000.00,4000.00,5000.00,1325.57,2674.43,0.32,1
59033,5889,1000.00,5000.00,6000.00,0.00,3705.64,0.21,1
59034,5889,1000.00,6000.00,7000.00,0.00,6000.00,0.37,1
59035,5889,-1000.00,5000.00,6000.00,4683.16,2316.84,0.09,0
59036,5889,-1000.00,4000.00,5000.00,2060.23,0.00,0.06,0
59037,5889,1000.00,5000.00,6000.00,2428.65,2571.35,0.00,1
59038,5889,1000.00,6000.00,7000.00,3000.00,3000.00,0.04,1
59039,5889,1000.00,7000.00,8000.00,1902.62,5097.38,0.37,1
59040,5889,1000.00,8000.00,9000.00,0.00,1834.97,0.12,1
59041,5889,1000.00,9000.00,10000.00,0.00,4420.55,0.26,1
59042,5889,1000.00,10000.00,11000.00,4353.55,5646.45,0.10,1
59043,5889,1000.00,11000.00,12000.00,3370.87,7629.13,0.34,1
59044,5889,1000.00,12000.00,13000.00,0.00,3273.37,0.11,1
59045,5889,1000.00,13000.00,14000.00,997.90,6147.02,0.30,1
59046,5889,-1000.00,12000.00,13000.00,7269.29,6730.71,0.09,0
59047,5889,1000.00,13000.00,14000.00,0.00,13000.00,0.30,1
59048,5889,1000.00,14000.00,15000.00,0.00,13533.82,0.43,1
59049,5889,1000.00,15000.00,16000.00,4511.10,10488.90,0.16,1
59050,5889,1000.00,16000.00,17000.00,3029.32,12970.68,0.41,1
59051,5889,-1000.00,15000.00,16000.00,17000.00,0.00,0.00,0
59052,5889,1000.00,16000.00,17000.00,427.20,15572.80,0.22,1
59053,5889,1000.00,17000.00,18000.00,0.00,17000.00,0.02,1
59054,5889,1000.00,18000.00,19000.00,0.00,8541.95,0.18,1
59055,5889,1000.00,19000.00,20000.00,129.24,18870.76,0.26,1
59056,5889,1000.00,20000.00,21000.00,4660.43,15339.57,0.10,1
59057,5889,-1000.00,19000.00,20000.00,14247.36,6752.64,0.07,0
59058,5889,1000.00,20000.00,21000.00,0.00,20000.00,0.43,1
59059,5889,1000.00,21000.00,22000.00,0.00,21000.00,0.22,1
59060,5889,1000.00,22000.00,23000.00,0.00,11167.95,0.31,1
59061,5889,1000.00,23000.00,24000.00,10495.60,12504.40,0.13,1
59062,5889,1000.00,24000.00,25000.00,0.00,17492.49,0.39,1
59063,5889,1000.00,25000.00,26000.00,0.00,25000.00,0.39,1
59064,5889,1000.00,26000.00,27000.00,0.00,20080.31,0.41,1
59065,5889,1000.00,27000.00,28000.00,0.00,18277.77,0.02,1
59066,5889,1000.00,28000.00,29000.00,0.00,24044.00,0.23,1
59067,5889,1000.00,29000.00,30000.00,0.00,29000.00,0.34,1
59068,5889,1000.00,30000.00,31000.00,0.00,30000.00,0.30,1
59069,5889,1000.00,31000.00,32000.00,0.00,24123.56,0.41,1
59070,5890,-1000.00,-1000.00,0.00,0.00,135.00,0.42,0
59071,5891,-1000.00,-1000.00,0.00,300.64,699.36,0.34,0
59072,5892,-1000.00,-1000.00,0.00,0.00,1000.00,0.10,0
59073,5893,-700.11,-700.11,299.89,0.00,700.11,0.39,0
59074,5893,-1000.00,-1700.11,-700.11,259.90,0.00,0.04,0
59075,5894,-1000.00,-1000.00,0.00,0.00,1000.00,0.02,0
59076,5895,1000.00,1000.00,2000.00,323.47,676.53,0.25,1
59077,5895,1000.00,2000.00,3000.00,978.97,1021.03,0.14,1
59078,5895,1000.00,3000.00,4000.00,1500.00,1500.00,0.01,1
59079,5895,1000.00,4000.00,5000.00,298.12,3701.88,0.43,1
59080,5895,1000.00,5000.00,6000.00,0.00,2680.62,0.24,1
59081,5895,1000.00,6000.00,7000.00,0.00,6000.00,0.05,1
59082,5895,1000.00,7000.00,8000.00,498.67,3266.52,0.30,1
59083,5895,1000.00,8000.00,9000.00,3925.28,4074.72,0.09,1
59084,5895,1000.00,9000.00,10000.00,0.00,9000.00,0.06,1
59085,5895,1000.00,10000.00,11000.00,0.00,10000.00,0.22,1
59086,5895,1000.00,11000.00,12000.00,0.00,11000.00,0.25,1
59087,5895,1000.00,12000.00,13000.00,1322.64,10677.36,0.42,1
59088,5895,1000.00,13000.00,14000.00,1017.22,11982.78,0.33,1
59089,5895,-1000.00,12000.00,13000.00,8910.11,5089.89,0.13,0
59090,5895,-1000.00,11000.00,12000.00,7847.65,5152.35,0.06,0
59091,5895,1000.00,12000.00,13000.00,4990.27,7009.73,0.10,1
59092,5895,1000.00,13000.00,14000.00,4618.72,8381.28,0.09,1
59093,5895,1000.00,14000.00,15000.00,7000.00,7000.00,0.02,1
59094,5895,1000.00,15000.00,16000.00,0.00,14372.35,0.23,1
59095,5895,1000.00,16000.00,17000.00,8000.00,8000.00,0.03,1
59096,5895,1000.00,17000.00,18000.00,2050.65,7330.67,0.28,1
59097,5895,1000.00,18000.00,19000.00,9000.00,9000.00,0.02,1
59098,5895,1000.00,19000.00,20000.00,6785.44,10393.65,0.28,1
59099,5895,1000.00,20000.00,21000.00,0.00,9839.85,0.31,1
59100,5895,1000.00,21000.00,22000.00,2755.32,18244.68,0.43,1
59101,5895,1000.00,22000.00,23000.00,0.00,18669.89,0.13,1
59102,5895,1000.00,23000.00,24000.00,0.00,19467.31,0.40,1
59103,5895,1000.00,24000.00,25000.00,3244.94,20755.06,0.16,1
59104,5895,-1000.00,23000.00,24000.00,11582.66,2121.75,0.10,0
59105,5895,1000.00,24000.00,25000.00,0.00,6506.33,0.13,1
59106,5895,1000.00,25000.00,26000.00,0.00,7469.36,0.21,1
59107,5895,1000.00,26000.00,27000.00,9921.17,16078.83,0.30,1
59108,5895,1000.00,27000.00,28000.00,0.00,18819.12,0.39,1
59109,5895,1000.00,28000.00,29000.00,13652.76,14347.24,0.15,1
59110,5895,1000.00,29000.00,30000.00,12937.30,16062.70,0.20,1
59111,5895,1000.00,30000.00,31000.00,3852.57,16240.52,0.32,1
59112,5895,1000.00,31000.00,32000.00,679.29,19802.87,0.37,1
59113,5895,-1000.00,30000.00,31000.00,18390.24,13609.76,0.01,0
59114,5895,1000.00,31000.00,32000.00,0.00,30277.63,0.33,1
59115,5895,1000.00,32000.00,33000.00,0.00,32000.00,0.07,1
59116,5895,1000.00,33000.00,34000.00,3669.51,29330.49,0.27,1
59117,5896,-1000.00,-1000.00,0.00,416.66,583.34,0.28,0
59118,5897,-162.64,-162.64,837.36,0.00,162.64,0.19,0
59119,5897,-837.36,-1000.00,0.00,245.16,592.20,0.04,0
59120,5898,-1000.00,-1000.00,0.00,504.70,495.30,0.07,0
59121,5899,-752.61,-752.61,247.39,0.00,752.61,0.26,0
59122,5899,-98.79,-851.40,148.60,36.07,62.72,0.20,0
59123,5899,-1000.00,-1851.40,-851.40,41.97,0.00,0.03,0
59124,5900,-1000.00,-1000.00,0.00,0.00,1000.00,0.41,0
59125,5901,1000.00,1000.00,2000.00,228.94,732.54,0.37,1
59126,5901,1000.00,2000.00,3000.00,0.00,1941.59,0.40,1
59127,5901,1000.00,3000.00,4000.00,1094.85,1905.15,0.18,1
59128,5901,1000.00,4000.00,5000.00,1676.43,1777.56,0.23,1
59129,5901,1000.00,5000.00,6000.00,0.00,5000.00,0.26,1
59130,5901,1000.00,6000.00,7000.00,1197.34,4802.66,0.21,1
59131,5901,-1000.00,5000.00,6000.00,3725.01,3274.99,0.10,0
59132,5901,1000.00,6000.00,7000.00,0.00,3040.43,0.28,1
59133,5901,1000.00,7000.00,8000.00,2316.43,4683.57,0.33,1
59134,5901,1000.00,8000.00,9000.00,3177.91,4822.09,0.23,1
59135,5901,1000.00,9000.00,10000.00,0.00,9000.00,0.05,1
59136,5901,1000.00,10000.00,11000.00,4542.82,5427.15,0.25,1
59137,5901,-1000.00,9000.00,10000.00,5933.41,0.00,0.05,0
59138,5901,1000.00,10000.00,11000.00,5000.00,5000.00,0.04,1
59139,5901,1000.00,11000.00,12000.00,0.00,11000.00,0.01,1
59140,5901,1000.00,12000.00,13000.00,0.00,6147.70,0.11,1
59141,5901,1000.00,13000.00,14000.00,3497.80,7588.17,0.31,1
59142,5901,1000.00,14000.00,15000.00,2533.84,11466.16,0.39,1
59143,5901,1000.00,15000.00,16000.00,0.00,15000.00,0.22,1
59144,5901,1000.00,16000.00,17000.00,0.00,15407.72,0.44,1
59145,5901,1000.00,17000.00,18000.00,0.00,17000.00,0.42,1
59146,5901,1000.00,18000.00,19000.00,0.00,18000.00,0.00,1
59147,5901,1000.00,19000.00,20000.00,0.00,19000.00,0.30,1
59148,5901,1000.00,20000.00,21000.00,0.00,6419.48,0.22,1
59149,5901,-1000.00,19000.00,20000.00,0.00,21000.00,0.44,0
59150,5901,-1000.00,18000.00,19000.00,4199.51,15800.49,0.37,0
59151,5901,-1000.00,17000.00,18000.00,2742.47,16257.53,0.20,0
59152,5901,-1000.00,16000.00,17000.00,7563.59,10436.41,0.21,0
59153,5901,-1000.00,15000.00,16000.00,0.00,17000.00,0.15,0
59154,5901,0.00,15000.00,16000.00,0.00,0.00,0.01,0
59155,5901,-1000.00,14000.00,15000.00,1443.45,14556.55,0.43,0
59156,5901,-1000.00,13000.00,14000.00,0.00,9672.42,0.32,0
59157,5901,-1000.00,12000.00,13000.00,0.00,14000.00,0.23,0
59158,5901,-1000.00,11000.00,12000.00,630.83,12355.12,0.44,0
59159,5901,-1000.00,10000.00,11000.00,2856.85,9143.15,0.37,0
59160,5901,-1000.00,9000.00,10000.00,4493.76,6506.24,0.23,0
59161,5901,0.00,9000.00,10000.00,0.00,0.00,0.04,0
59162,5901,-1000.00,8000.00,9000.00,4646.83,5353.17,0.16,0
59163,5901,-1000.00,7000.00,8000.00,0.00,8023.53,0.27,0
59164,5901,-1000.00,6000.00,7000.00,2416.31,5583.69,0.34,0
59165,5901,-1000.00,5000.00,6000.00,2849.01,4150.99,0.20,0
59166,5901,-1000.00,4000.00,5000.00,1385.45,4614.55,0.16,0
59167,5901,-1000.00,3000.00,4000.00,4114.38,885.62,0.03,0
59168,5901,-1000.00,2000.00,3000.00,1010.30,2989.70,0.12,0
59169,5901,-1000.00,1000.00,2000.00,0.00,2382.28,0.36,0
59170,5901,-1000.00,0.00,1000.00,0.00,2000.00,0.23,0
59171,5901,-1000.00,-1000.00,0.00,387.54,612.46,0.03,0
59172,5902,1000.00,1000.00,2000.00,129.64,870.36,0.43,1
59173,5902,1000.00,2000.00,3000.00,186.99,1813.01,0.40,1
59174,5902,1000.00,3000.00,4000.00,0.00,2405.82,0.23,1
59175,5902,1000.00,4000.00,5000.00,0.00,3863.54,0.40,1
59176,5902,1000.00,5000.00,6000.00,0.00,5000.00,0.23,1
59177,5902,1000.00,6000.00,7000.00,0.00,6000.00,0.26,1
59178,5902,1000.00,7000.00,8000.00,0.00,4459.51,0.31,1
59179,5902,-45.11,6954.89,7954.89,45.11,0.00,0.10,0
59180,5902,1000.00,7954.89,8954.89,3739.80,4215.09,0.12,1
59181,5902,1000.00,8954.89,9954.89,0.00,6295.63,0.28,1
59182,5902,1000.00,9954.89,10954.89,4956.08,4998.82,0.18,1
59183,5902,1000.00,10954.89,11954.89,0.00,9512.11,0.01,1
59184,5902,1000.00,11954.89,12954.89,0.00,11954.89,0.10,1
59185,5902,1000.00,12954.89,13954.89,0.00,772.55,0.07,1
59186,5902,1000.00,13954.89,14954.89,4687.09,9267.80,0.30,1
59187,5902,1000.00,14954.89,15954.89,0.00,14954.89,0.10,1
59188,5902,1000.00,15954.89,16954.89,0.00,15954.89,0.05,1
59189,5902,1000.00,16954.89,17954.89,507.74,16447.15,0.29,1
59190,5902,1000.00,17954.89,18954.89,0.00,9136.16,0.30,1
59191,5902,-1000.00,16954.89,17954.89,9287.41,2270.60,0.11,0
59192,5902,1000.00,17954.89,18954.89,1107.57,16847.32,0.43,1
59193,5902,1000.00,18954.89,19954.89,1250.96,14552.41,0.41,1
59194,5902,1000.00,19954.89,20954.89,0.00,5600.53,0.13,1
59195,5902,1000.00,20954.89,21954.89,0.00,16170.10,0.29,1
59196,5902,1000.00,21954.89,22954.89,2869.71,19085.19,0.31,1
59197,5902,1000.00,22954.89,23954.89,0.00,22954.89,0.26,1
59198,5902,1000.00,23954.89,24954.89,0.00,23954.89,0.33,1
59199,5902,-1000.00,22954.89,23954.89,13899.36,6706.37,0.14,0
59200,5902,1000.00,23954.89,24954.89,0.00,4791.08,0.03,1
59201,5902,1000.00,24954.89,25954.89,0.00,24954.89,0.40,1
59202,5902,1000.00,25954.89,26954.89,0.00,25954.89,0.06,1
59203,5902,1000.00,26954.89,27954.89,8018.19,18936.71,0.36,1
59204,5902,-1000.00,25954.89,26954.89,16081.39,11873.50,0.14,0
59205,5902,1000.00,26954.89,27954.89,5740.39,21214.50,0.19,1
59206,5902,1000.00,27954.89,28954.89,11876.26,16078.63,0.27,1
59207,5902,1000.00,28954.89,29954.89,11384.64,17570.26,0.27,1
59208,5903,-341.67,-341.67,658.33,0.00,341.67,0.41,0
59209,5903,0.00,-341.67,658.33,0.00,0.00,0.21,0
59210,5903,-370.20,-711.87,288.13,0.00,370.20,0.22,0
59211,5903,-288.13,-1000.00,0.00,63.17,224.96,0.25,0
59212,5904,1000.00,1000.00,2000.00,362.51,0.00,0.27,1
59213,5904,1000.00,2000.00,3000.00,163.42,21.94,0.44,1
59214,5904,0.00,2000.00,3000.00,0.00,0.00,0.37,0
59215,5904,1000.00,3000.00,4000.00,3000.00,0.00,0.04,1
59216,5904,-980.79,2019.21,3019.21,0.00,980.79,0.20,0
59217,5904,-918.46,1100.76,2100.76,310.92,607.54,0.41,0
59218,5904,-1000.00,100.76,1100.76,0.00,1839.49,0.03,0
59219,5904,-1000.00,-899.24,100.76,0.00,1100.76,0.17,0
59220,5904,1000.00,100.76,1100.76,55.28,45.48,0.05,1
59221,5904,-1000.00,-899.24,100.76,0.00,1100.76,0.21,0
59222,5904,-83.98,-983.22,16.78,0.00,83.98,0.09,0
59223,5904,-16.78,-1000.00,0.00,0.00,16.78,0.30,0
59224,5905,-1000.00,-1000.00,0.00,365.44,634.56,0.17,0
59225,5906,1000.00,1000.00,2000.00,408.31,310.60,0.18,1
59226,5906,-1000.00,0.00,1000.00,30.42,1969.58,0.40,0
59227,5906,-1000.00,-1000.00,0.00,0.00,1000.00,0.05,0
59228,5907,1000.00,1000.00,2000.00,565.28,434.72,0.16,1
59229,5907,-1000.00,0.00,1000.00,545.50,1454.50,0.34,0
59230,5907,-1000.00,-1000.00,0.00,313.93,686.07,0.30,0
59231,5908,-1000.00,-1000.00,0.00,482.29,517.71,0.06,0
59232,5909,0.00,0.00,1000.00,0.00,0.00,0.30,0
59233,5909,-688.61,-688.61,311.39,557.26,131.34,0.28,0
59234,5909,-1000.00,-1688.61,-688.61,135.05,176.34,0.02,0
59235,5910,1000.00,1000.00,2000.00,139.18,860.82,0.42,1
59236,5910,-1000.00,0.00,1000.00,1757.19,29.61,0.04,0
59237,5910,1000.00,1000.00,2000.00,0.00,867.88,0.12,1
59238,5910,1000.00,2000.00,3000.00,289.15,1710.85,0.35,1
59239,5910,0.00,2000.00,3000.00,0.00,0.00,0.06,0
59240,5910,1000.00,3000.00,4000.00,0.00,1028.72,0.19,1
59241,5910,1000.00,4000.00,5000.00,0.00,1525.36,0.19,1
59242,5910,1000.00,5000.00,6000.00,0.00,5000.00,0.43,1
59243,5910,1000.00,6000.00,7000.00,0.00,6000.00,0.44,1
59244,5910,1000.00,7000.00,8000.00,2193.01,4806.99,0.11,1
59245,5910,1000.00,8000.00,9000.00,0.00,8000.00,0.35,1
59246,5910,1000.00,9000.00,10000.00,0.00,9000.00,0.19,1
59247,5910,1000.00,10000.00,11000.00,3774.10,4765.25,0.25,1
59248,5910,1000.00,11000.00,12000.00,0.00,11000.00,0.17,1
59249,5910,1000.00,12000.00,13000.00,0.00,12000.00,0.37,1
59250,5910,0.00,12000.00,13000.00,0.00,0.00,0.04,0
59251,5910,-1000.00,11000.00,12000.00,8498.16,4501.84,0.09,0
59252,5910,1000.00,12000.00,13000.00,5015.65,6984.35,0.19,1
59253,5910,-1000.00,11000.00,12000.00,7836.95,5163.05,0.11,0
59254,5910,1000.00,12000.00,13000.00,5132.08,6867.92,0.16,1
59255,5910,1000.00,13000.00,14000.00,5647.68,7352.32,0.26,1
59256,5910,-279.09,12720.91,13720.91,0.00,279.09,0.10,0
59257,5910,-1000.00,11720.91,12720.91,1199.84,12177.51,0.43,0
59258,5910,-1000.00,10720.91,11720.91,6750.17,2297.22,0.12,0
59259,5910,-1000.00,9720.91,10720.91,1969.06,9751.85,0.24,0
59260,5910,-1000.00,8720.91,9720.91,0.00,10720.91,0.42,0
59261,5910,-1000.00,7720.91,8720.91,0.00,9720.91,0.16,0
59262,5910,-1000.00,6720.91,7720.91,2452.77,6268.14,0.35,0
59263,5910,-1000.00,5720.91,6720.91,896.38,6824.53,0.43,0
59264,5910,-1000.00,4720.91,5720.91,0.00,6720.91,0.19,0
59265,5910,-1000.00,3720.91,4720.91,0.00,3550.76,0.36,0
59266,5910,-1000.00,2720.91,3720.91,131.48,4589.43,0.33,0
59267,5910,-1000.00,1720.91,2720.91,589.24,2687.59,0.38,0
59268,5910,-1000.00,720.91,1720.91,1249.92,1470.98,0.14,0
59269,5910,-1000.00,-279.09,720.91,588.85,1132.06,0.22,0
59270,5910,-720.91,-1000.00,0.00,211.47,509.44,0.35,0
59271,5911,-1000.00,-1000.00,0.00,0.00,1000.00,0.41,0
59272,5912,-1000.00,-1000.00,0.00,160.40,839.60,0.31,0
59273,5913,-1000.00,-1000.00,0.00,0.00,1000.00,0.29,0
59274,5914,-602.58,-602.58,397.42,0.00,602.58,0.35,0
59275,5914,-219.02,-821.60,178.40,0.00,219.02,0.12,0
59276,5914,-178.40,-1000.00,0.00,0.00,178.40,0.02,0
59277,5915,-1000.00,-1000.00,0.00,0.00,913.25,0.43,0
59278,5916,-1000.00,-1000.00,0.00,417.61,582.39,0.18,0
59279,5917,-1000.00,-1000.00,0.00,165.22,834.78,0.07,0
59280,5918,1000.00,1000.00,2000.00,296.92,703.08,0.12,1
59281,5918,1000.00,2000.00,3000.00,0.00,1278.97,0.29,1
59282,5918,1000.00,3000.00,4000.00,637.49,2362.51,0.40,1
59283,5918,1000.00,4000.00,5000.00,0.00,3387.48,0.43,1
59284,5918,1000.00,5000.00,6000.00,0.00,5000.00,0.29,1
59285,5918,1000.00,6000.00,7000.00,2655.03,3344.97,0.04,1
59286,5918,1000.00,7000.00,8000.00,0.00,6449.80,0.43,1
59287,5918,1000.00,8000.00,9000.00,0.00,8000.00,0.38,1
59288,5918,1000.00,9000.00,10000.00,0.00,9000.00,0.43,1
59289,5918,1000.00,10000.00,11000.00,0.00,6017.43,0.32,1
59290,5918,1000.00,11000.00,12000.00,1206.34,9793.66,0.43,1
59291,5918,1000.00,12000.00,13000.00,1526.50,10473.50,0.40,1
59292,5918,0.00,12000.00,13000.00,0.00,0.00,0.06,0
59293,5918,1000.00,13000.00,14000.00,0.00,13000.00,0.01,1
59294,5918,1000.00,14000.00,15000.00,0.00,2974.09,0.01,1
59295,5918,0.00,14000.00,15000.00,0.00,0.00,0.02,0
59296,5918,1000.00,15000.00,16000.00,6415.69,8584.31,0.17,1
59297,5918,1000.00,16000.00,17000.00,0.00,16000.00,0.23,1
59298,5918,1000.00,17000.00,18000.00,421.55,16578.45,0.27,1
59299,5918,1000.00,18000.00,19000.00,0.00,18000.00,0.34,1
59300,5918,1000.00,19000.00,20000.00,8029.51,10970.49,0.25,1
59301,5918,1000.00,20000.00,21000.00,0.00,4093.22,0.18,1
59302,5918,1000.00,21000.00,22000.00,4034.79,13643.14,0.35,1
59303,5918,1000.00,22000.00,23000.00,0.00,17621.40,0.30,1
59304,5918,-1000.00,21000.00,22000.00,0.00,23000.00,0.25,0
59305,5918,-1000.00,20000.00,21000.00,8811.99,13188.01,0.17,0
59306,5918,-1000.00,19000.00,20000.00,2228.90,18771.10,0.43,0
59307,5918,-1000.00,18000.00,19000.00,0.00,6644.02,0.23,0
59308,5918,-1000.00,17000.00,18000.00,0.00,15767.55,0.41,0
59309,5918,-1000.00,16000.00,17000.00,0.00,18000.00,0.18,0
59310,5918,-1000.00,15000.00,16000.00,7717.07,9282.93,0.00,0
59311,5918,-1000.00,14000.00,15000.00,0.00,16000.00,0.22,0
59312,5918,-1000.00,13000.00,14000.00,0.00,15000.00,0.00,0
59313,5918,-1000.00,12000.00,13000.00,6048.17,7951.83,0.02,0
59314,5918,-1000.00,11000.00,12000.00,0.00,13000.00,0.20,0
59315,5918,-1000.00,10000.00,11000.00,0.00,4334.86,0.21,0
59316,5918,-1000.00,9000.00,10000.00,0.00,11000.00,0.31,0
59317,5918,-1000.00,8000.00,9000.00,3196.11,4693.18,0.26,0
59318,5918,-1000.00,7000.00,8000.00,0.00,7692.62,0.43,0
59319,5918,-1000.00,6000.00,7000.00,0.00,8000.00,0.15,0
59320,5918,-1000.00,5000.00,6000.00,0.00,7000.00,0.04,0
59321,5918,-1000.00,4000.00,5000.00,4328.11,1671.89,0.09,0
59322,5918,-1000.00,3000.00,4000.00,0.00,3665.17,0.40,0
59323,5918,-1000.00,2000.00,3000.00,65.01,3934.99,0.34,0
59324,5918,-771.41,1228.59,2228.59,0.00,771.41,0.05,0
59325,5918,-1000.00,228.59,1228.59,931.37,1297.22,0.27,0
59326,5918,-1000.00,-771.41,228.59,714.47,514.12,0.17,0
59327,5918,-228.59,-1000.00,0.00,70.64,157.95,0.21,0
59328,5919,-1000.00,-1000.00,0.00,433.49,566.51,0.20,0
59329,5920,1000.00,1000.00,2000.00,142.15,799.40,0.41,1
59330,5920,1000.00,2000.00,3000.00,0.00,2000.00,0.25,1
59331,5920,1000.00,3000.00,4000.00,0.00,1633.08,0.21,1
59332,5920,1000.00,4000.00,5000.00,0.00,2956.91,0.04,1
59333,5920,1000.00,5000.00,6000.00,0.00,5000.00,0.29,1
59334,5920,1000.00,6000.00,7000.00,1925.23,4074.77,0.11,1
59335,5920,1000.00,7000.00,8000.00,1391.36,5608.64,0.15,1
59336,5920,1000.00,8000.00,9000.00,0.00,7833.78,0.27,1
59337,5920,1000.00,9000.00,10000.00,2797.07,6202.93,0.27,1
59338,5920,1000.00,10000.00,11000.00,0.00,2476.87,0.13,1
59339,5920,1000.00,11000.00,12000.00,0.00,6328.82,0.31,1
59340,5920,1000.00,12000.00,13000.00,0.00,12000.00,0.00,1
59341,5920,1000.00,13000.00,14000.00,0.00,5193.37,0.23,1
59342,5920,1000.00,14000.00,15000.00,0.00,2912.92,0.09,1
59343,5920,0.00,14000.00,15000.00,0.00,0.00,0.09,0
59344,5920,1000.00,15000.00,16000.00,0.00,15000.00,0.14,1
59345,5920,1000.00,16000.00,17000.00,0.00,16000.00,0.01,1
59346,5920,1000.00,17000.00,18000.00,7982.70,9017.30,0.06,1
59347,5920,-1000.00,16000.00,17000.00,9454.86,8545.14,0.12,0
59348,5920,1000.00,17000.00,18000.00,0.00,15165.18,0.30,1
59349,5920,-249.67,16750.33,17750.33,249.67,0.00,0.00,0
59350,5920,1000.00,17750.33,18750.33,0.00,17750.33,0.27,1
59351,5920,1000.00,18750.33,19750.33,0.00,6672.61,0.18,1
59352,5920,-1000.00,17750.33,18750.33,10009.62,9740.71,0.14,0
59353,5920,1000.00,18750.33,19750.33,0.00,11918.29,0.30,1
59354,5920,1000.00,19750.33,20750.33,0.00,19750.33,0.22,1
59355,5920,1000.00,20750.33,21750.33,6282.80,14467.53,0.30,1
59356,5920,1000.00,21750.33,22750.33,0.00,18250.55,0.42,1
59357,5920,-1000.00,20750.33,21750.33,19902.62,2847.71,0.03,0
59358,5920,1000.00,21750.33,22750.33,0.00,21750.33,0.02,1
59359,5920,1000.00,22750.33,23750.33,0.00,22750.33,0.05,1
59360,5920,1000.00,23750.33,24750.33,0.00,23750.33,0.17,1
59361,5920,1000.00,24750.33,25750.33,4642.23,20108.10,0.41,1
59362,5920,1000.00,25750.33,26750.33,12875.16,12875.16,0.02,1
59363,5920,1000.00,26750.33,27750.33,10840.31,15910.02,0.21,1
59364,5920,1000.00,27750.33,28750.33,922.43,26827.90,0.44,1
59365,5920,1000.00,28750.33,29750.33,6729.26,15688.89,0.31,1
59366,5920,1000.00,29750.33,30750.33,6752.29,22998.04,0.39,1
59367,5920,1000.00,30750.33,31750.33,0.00,27451.30,0.41,1
59368,5920,1000.00,31750.33,32750.33,0.00,31750.33,0.07,1
59369,5920,1000.00,32750.33,33750.33,12150.03,20600.29,0.27,1
59370,5920,1000.00,33750.33,34750.33,0.00,33750.33,0.04,1
59371,5920,-1000.00,32750.33,33750.33,18271.29,16479.04,0.12,0
59372,5920,1000.00,33750.33,34750.33,15582.94,18167.39,0.21,1
59373,5920,1000.00,34750.33,35750.33,0.00,31154.80,0.43,1
59374,5920,1000.00,35750.33,36750.33,11141.73,24608.60,0.32,1
59375,5921,-1000.00,-1000.00,0.00,0.00,1000.00,0.25,0
59376,5922,-1000.00,-1000.00,0.00,388.39,611.61,0.17,0
59377,5923,-90.46,-90.46,909.54,90.46,0.00,0.42,0
59378,5923,-1000.00,-1090.46,-90.46,0.00,86.54,0.37,0
59379,5924,-1000.00,-1000.00,0.00,362.83,637.17,0.15,0
59380,5925,-748.83,-748.83,251.17,146.96,601.86,0.34,0
59381,5925,-1000.00,-1748.83,-748.83,136.93,114.24,0.10,0
59382,5926,-1000.00,-1000.00,0.00,0.00,1000.00,0.11,0
59383,5927,-1000.00,-1000.00,0.00,312.19,586.21,0.24,0
59384,5928,-1000.00,-1000.00,0.00,0.00,1000.00,0.06,0
59385,5929,-1000.00,-1000.00,0.00,6.72,993.28,0.07,0
59386,5930,1000.00,1000.00,2000.00,0.00,419.77,0.17,1
59387,5930,1000.00,2000.00,3000.00,124.74,422.08,0.19,1
59388,5930,1000.00,3000.00,4000.00,1500.00,1500.00,0.09,1
59389,5930,1000.00,4000.00,5000.00,1714.35,2285.65,0.20,1
59390,5930,1000.00,5000.00,6000.00,0.00,5000.00,0.42,1
59391,5930,1000.00,6000.00,7000.00,0.00,6000.00,0.37,1
59392,5930,1000.00,7000.00,8000.00,916.33,5550.54,0.41,1
59393,5930,0.00,7000.00,8000.00,0.00,0.00,0.01,0
59394,5930,1000.00,8000.00,9000.00,3489.47,4510.53,0.19,1
59395,5930,1000.00,9000.00,10000.00,0.00,9000.00,0.03,1
59396,5930,1000.00,10000.00,11000.00,0.00,10000.00,0.33,1
59397,5930,1000.00,11000.00,12000.00,0.00,11000.00,0.33,1
59398,5930,1000.00,12000.00,13000.00,0.00,9576.40,0.30,1
59399,5930,1000.00,13000.00,14000.00,0.00,2492.34,0.04,1
59400,5930,1000.00,14000.00,15000.00,0.00,5488.41,0.21,1
59401,5930,1000.00,15000.00,16000.00,4787.93,10212.07,0.19,1
59402,5930,1000.00,16000.00,17000.00,0.00,15147.25,0.41,1
59403,5930,1000.00,17000.00,18000.00,4662.21,12337.79,0.37,1
59404,5930,1000.00,18000.00,19000.00,0.00,5719.36,0.18,1
59405,5930,-1000.00,17000.00,18000.00,11963.87,2997.33,0.10,0
59406,5930,1000.00,18000.00,19000.00,0.00,17982.32,0.14,1
59407,5930,1000.00,19000.00,20000.00,8615.96,10384.04,0.25,1
59408,5930,1000.00,20000.00,21000.00,0.00,1604.30,0.14,1
59409,5930,-1000.00,19000.00,20000.00,2025.70,18974.30,0.43,0
59410,5930,-1000.00,18000.00,19000.00,0.00,11652.99,0.16,0
59411,5930,-1000.00,17000.00,18000.00,9772.17,9227.83,0.20,0
59412,5930,-1000.00,16000.00,17000.00,2150.17,6618.42,0.25,0
59413,5930,-1000.00,15000.00,16000.00,0.00,17000.00,0.02,0
59414,5930,-1000.00,14000.00,15000.00,5015.80,10984.20,0.34,0
59415,5930,-1000.00,13000.00,14000.00,3350.50,11649.50,0.12,0
59416,5930,-1000.00,12000.00,13000.00,5347.33,8652.67,0.20,0
59417,5930,0.00,12000.00,13000.00,0.00,0.00,0.06,0
59418,5930,-1000.00,11000.00,12000.00,0.00,13000.00,0.29,0
59419,5930,-1000.00,10000.00,11000.00,7968.11,0.00,0.02,0
59420,5930,-1000.00,9000.00,10000.00,1889.21,9110.79,0.42,0
59421,5930,-1000.00,8000.00,9000.00,5000.00,5000.00,0.03,0
59422,5930,-1000.00,7000.00,8000.00,2805.42,6194.58,0.35,0
59423,5930,-1000.00,6000.00,7000.00,0.00,8000.00,0.41,0
59424,5930,-1000.00,5000.00,6000.00,1800.65,5199.35,0.25,0
59425,5930,-1000.00,4000.00,5000.00,0.00,6000.00,0.12,0
59426,5930,-1000.00,3000.00,4000.00,0.00,5000.00,0.12,0
59427,5930,-1000.00,2000.00,3000.00,513.86,0.00,0.01,0
59428,5930,-1000.00,1000.00,2000.00,0.00,2833.16,0.44,0
59429,5930,-1000.00,0.00,1000.00,1186.33,813.67,0.15,0
59430,5930,-598.01,-598.01,401.99,0.00,598.01,0.19,0
59431,5930,-401.99,-1000.00,0.00,0.00,401.99,0.12,0
59432,5931,-1000.00,-1000.00,0.00,622.10,377.90,0.09,0
59433,5932,-499.64,-499.64,500.36,0.00,499.64,0.35,0
59434,5932,-500.36,-1000.00,0.00,0.00,500.36,0.07,0
59435,5933,-1000.00,-1000.00,0.00,682.67,317.33,0.01,0
59436,5934,-1000.00,-1000.00,0.00,421.83,578.17,0.05,0
59437,5935,-1000.00,-1000.00,0.00,372.24,627.76,0.17,0
59438,5936,-1000.00,-1000.00,0.00,203.23,623.74,0.34,0
59439,5937,-1000.00,-1000.00,0.00,394.73,605.27,0.28,0
59440,5938,1000.00,1000.00,2000.00,0.00,1000.00,0.24,1
59441,5938,1000.00,2000.00,3000.00,0.00,2000.00,0.01,1
59442,5938,1000.00,3000.00,4000.00,1218.72,1781.28,0.28,1
59443,5938,1000.00,4000.00,5000.00,0.00,4000.00,0.37,1
59444,5938,-1000.00,3000.00,4000.00,2238.55,517.83,0.11,0
59445,5938,1000.00,4000.00,5000.00,1870.35,2129.65,0.10,1
59446,5938,1000.00,5000.00,6000.00,0.00,5000.00,0.05,1
59447,5938,1000.00,6000.00,7000.00,1297.40,4702.60,0.20,1
59448,5938,1000.00,7000.00,8000.00,589.47,6410.53,0.43,1
59449,5938,1000.00,8000.00,9000.00,2677.93,5322.07,0.07,1
59450,5938,1000.00,9000.00,10000.00,0.00,9000.00,0.29,1
59451,5938,1000.00,10000.00,11000.00,0.00,6781.93,0.38,1
59452,5938,1000.00,11000.00,12000.00,3042.56,7957.44,0.30,1
59453,5938,1000.00,12000.00,13000.00,0.00,12000.00,0.33,1
59454,5938,1000.00,13000.00,14000.00,3381.50,9618.50,0.33,1
59455,5938,1000.00,14000.00,15000.00,1754.53,12245.47,0.43,1
59456,5938,1000.00,15000.00,16000.00,0.00,8164.12,0.33,1
59457,5938,1000.00,16000.00,17000.00,2290.28,13709.72,0.12,1
59458,5938,1000.00,17000.00,18000.00,8300.87,8699.13,0.05,1
59459,5938,-1000.00,16000.00,17000.00,9151.49,8848.51,0.17,0
59460,5938,-1000.00,15000.00,16000.00,0.00,17000.00,0.14,0
59461,5938,-1000.00,14000.00,15000.00,0.00,16000.00,0.09,0
59462,5938,-1000.00,13000.00,14000.00,0.00,12099.58,0.28,0
59463,5938,-1000.00,12000.00,13000.00,0.00,14000.00,0.29,0
59464,5938,-1000.00,11000.00,12000.00,5950.52,1100.89,0.10,0
59465,5938,-1000.00,10000.00,11000.00,4761.77,4811.63,0.22,0
59466,5938,-1000.00,9000.00,10000.00,726.21,10273.79,0.32,0
59467,5938,-1000.00,8000.00,9000.00,3153.42,6846.58,0.35,0
59468,5938,-1000.00,7000.00,8000.00,4594.08,4405.92,0.04,0
59469,5938,-1000.00,6000.00,7000.00,0.00,8000.00,0.12,0
59470,5938,0.00,6000.00,7000.00,0.00,0.00,0.04,0
59471,5938,-1000.00,5000.00,6000.00,3500.00,3500.00,0.09,0
59472,5938,-1000.00,4000.00,5000.00,0.00,1778.39,0.13,0
59473,5938,-1000.00,3000.00,4000.00,0.00,1329.31,0.19,0
59474,5938,-1000.00,2000.00,3000.00,0.00,4000.00,0.29,0
59475,5938,-1000.00,1000.00,2000.00,0.00,2450.55,0.31,0
59476,5938,-1000.00,0.00,1000.00,0.00,2000.00,0.24,0
59477,5938,-1000.00,-1000.00,0.00,500.00,500.00,0.00,0
59478,5939,1000.00,1000.00,2000.00,500.00,500.00,0.09,1
59479,5939,1000.00,2000.00,3000.00,667.53,1332.47,0.24,1
59480,5939,1000.00,3000.00,4000.00,584.97,2415.03,0.22,1
59481,5939,1000.00,4000.00,5000.00,587.35,3412.65,0.20,1
59482,5939,1000.00,5000.00,6000.00,1892.75,3107.25,0.26,1
59483,5939,1000.00,6000.00,7000.00,0.00,6000.00,0.43,1
59484,5939,1000.00,7000.00,8000.00,0.00,6743.56,0.36,1
59485,5939,0.00,7000.00,8000.00,0.00,0.00,0.07,0
59486,5939,1000.00,8000.00,9000.00,0.00,5253.90,0.38,1
59487,5939,1000.00,9000.00,10000.00,1085.26,7914.74,0.37,1
59488,5939,1000.00,10000.00,11000.00,0.00,10000.00,0.19,1
59489,5939,1000.00,11000.00,12000.00,0.00,1938.88,0.17,1
59490,5939,1000.00,12000.00,13000.00,0.00,12000.00,0.39,1
59491,5939,1000.00,13000.00,14000.00,2174.44,10576.27,0.41,1
59492,5939,1000.00,14000.00,15000.00,1877.87,12122.13,0.41,1
59493,5939,1000.00,15000.00,16000.00,0.00,15000.00,0.43,1
59494,5939,1000.00,16000.00,17000.00,0.00,16000.00,0.33,1
59495,5939,1000.00,17000.00,18000.00,0.00,17000.00,0.27,1
59496,5939,-1000.00,16000.00,17000.00,0.00,18000.00,0.23,0
59497,5939,-1000.00,15000.00,16000.00,8493.24,8506.76,0.09,0
59498,5939,-1000.00,14000.00,15000.00,8616.96,7383.04,0.19,0
59499,5939,-1000.00,13000.00,14000.00,0.00,13447.17,0.42,0
59500,5939,-1000.00,12000.00,13000.00,4052.39,9947.61,0.33,0
59501,5939,-1000.00,11000.00,12000.00,0.00,13000.00,0.15,0
59502,5939,-1000.00,10000.00,11000.00,115.14,11884.86,0.41,0
59503,5939,-1000.00,9000.00,10000.00,1389.43,9610.57,0.43,0
59504,5939,-1000.00,8000.00,9000.00,4792.99,5207.01,0.10,0
59505,5939,-1000.00,7000.00,8000.00,0.00,6699.72,0.38,0
59506,5939,-1000.00,6000.00,7000.00,3730.98,1221.04,0.12,0
59507,5939,-1000.00,5000.00,6000.00,5709.41,711.68,0.06,0
59508,5939,-1000.00,4000.00,5000.00,0.00,6000.00,0.24,0
59509,5939,-1000.00,3000.00,4000.00,3445.87,1554.13,0.10,0
59510,5939,-1000.00,2000.00,3000.00,0.00,4000.00,0.14,0
59511,5939,-1000.00,1000.00,2000.00,0.00,2657.48,0.13,0
59512,5939,-1000.00,0.00,1000.00,459.55,1540.45,0.38,0
59513,5939,-1000.00,-1000.00,0.00,430.61,569.39,0.19,0
59514,5940,1000.00,1000.00,2000.00,246.12,0.00,0.40,1
59515,5940,-1000.00,0.00,1000.00,0.00,1125.99,0.23,0
59516,5940,1000.00,1000.00,2000.00,790.57,0.00,0.13,1
59517,5940,1000.00,2000.00,3000.00,940.67,588.40,0.16,1
59518,5940,-1000.00,1000.00,2000.00,0.00,1872.44,0.36,0
59519,5940,-1000.00,0.00,1000.00,0.00,1361.77,0.31,0
59520,5940,-1000.00,-1000.00,0.00,427.46,572.54,0.24,0
59521,5941,1000.00,1000.00,2000.00,152.95,847.05,0.27,1
59522,5941,-1000.00,0.00,1000.00,1067.77,932.23,0.03,0
59523,5941,1000.00,1000.00,2000.00,397.13,602.87,0.14,1
59524,5941,1000.00,2000.00,3000.00,559.82,1440.18,0.37,1
59525,5941,1000.00,3000.00,4000.00,799.72,2200.28,0.28,1
59526,5941,1000.00,4000.00,5000.00,0.00,4000.00,0.30,1
59527,5941,1000.00,5000.00,6000.00,0.00,3384.73,0.37,1
59528,5941,1000.00,6000.00,7000.00,237.55,1472.11,0.20,1
59529,5941,1000.00,7000.00,8000.00,0.00,4147.68,0.29,1
59530,5941,1000.00,8000.00,9000.00,2502.67,5497.33,0.34,1
59531,5941,1000.00,9000.00,10000.00,256.63,8743.37,0.40,1
59532,5941,1000.00,10000.00,11000.00,690.69,4341.17,0.28,1
59533,5941,1000.00,11000.00,12000.00,0.00,11000.00,0.30,1
59534,5941,1000.00,12000.00,13000.00,0.00,9728.44,0.06,1
59535,5941,1000.00,13000.00,14000.00,30.01,12969.99,0.40,1
59536,5941,1000.00,14000.00,15000.00,0.00,9344.03,0.15,1
59537,5941,1000.00,15000.00,16000.00,0.00,15000.00,0.04,1
59538,5941,1000.00,16000.00,17000.00,0.00,8459.59,0.17,1
59539,5941,1000.00,17000.00,18000.00,0.00,17000.00,0.08,1
59540,5941,1000.00,18000.00,19000.00,0.00,18000.00,0.16,1
59541,5941,1000.00,19000.00,20000.00,0.00,15723.69,0.31,1
59542,5941,1000.00,20000.00,21000.00,0.00,5343.80,0.19,1
59543,5941,1000.00,21000.00,22000.00,4708.93,16291.07,0.39,1
59544,5941,-1000.00,20000.00,21000.00,7315.28,14684.72,0.27,0
59545,5941,-1000.00,19000.00,20000.00,0.00,21000.00,0.02,0
59546,5941,-1000.00,18000.00,19000.00,10640.62,9359.38,0.18,0
59547,5941,-1000.00,17000.00,18000.00,1200.43,17799.57,0.44,0
59548,5941,-1000.00,16000.00,17000.00,7674.77,10325.23,0.13,0
59549,5941,-1000.00,15000.00,16000.00,6263.15,10736.85,0.30,0
59550,5941,-1000.00,14000.00,15000.00,0.00,7750.22,0.29,0
59551,5941,-1000.00,13000.00,14000.00,0.00,15000.00,0.42,0
59552,5941,-1000.00,12000.00,13000.00,4485.22,9514.78,0.14,0
59553,5941,-1000.00,11000.00,12000.00,3522.97,0.00,0.08,0
59554,5941,-1000.00,10000.00,11000.00,0.00,12000.00,0.40,0
59555,5941,-1000.00,9000.00,10000.00,0.00,9508.64,0.19,0
59556,5941,-1000.00,8000.00,9000.00,3256.35,6743.65,0.09,0
59557,5941,-1000.00,7000.00,8000.00,0.00,9000.00,0.32,0
59558,5941,-1000.00,6000.00,7000.00,0.00,8000.00,0.14,0
59559,5941,-1000.00,5000.00,6000.00,330.60,6669.40,0.21,0
59560,5941,-1000.00,4000.00,5000.00,13.38,5072.25,0.43,0
59561,5941,-1000.00,3000.00,4000.00,0.00,4490.92,0.38,0
59562,5941,-1000.00,2000.00,3000.00,1885.49,0.00,0.00,0
59563,5941,-1000.00,1000.00,2000.00,0.00,2200.76,0.25,0
59564,5941,-1000.00,0.00,1000.00,0.00,2000.00,0.24,0
59565,5941,-798.87,-798.87,201.13,0.00,798.87,0.05,0
59566,5941,-187.66,-986.53,13.47,5.68,181.98,0.44,0
59567,5941,-11.70,-998.23,1.77,0.00,11.70,0.30,0
59568,5941,186.04,-812.18,187.82,0.00,1.36,0.37,1
59569,5941,1000.00,187.82,1187.82,0.00,86.21,0.24,1
59570,5941,1000.00,1187.82,2187.82,0.00,648.07,0.31,1
59571,5941,-1000.00,187.82,1187.82,1112.96,844.17,0.18,0
59572,5941,1000.00,1187.82,2187.82,87.67,920.90,0.41,1
59573,5941,0.00,1187.82,2187.82,0.00,0.00,0.01,0
59574,5941,1000.00,2187.82,3187.82,795.96,1391.86,0.28,1
59575,5941,1000.00,3187.82,4187.82,0.00,3187.82,0.03,1
59576,5941,1000.00,4187.82,5187.82,0.00,4187.82,0.13,1
59577,5941,1000.00,5187.82,6187.82,1327.40,2865.31,0.31,1
59578,5941,-1000.00,4187.82,5187.82,614.96,405.68,0.13,0
59579,5941,1000.00,5187.82,6187.82,2483.54,2704.28,0.16,1
59580,5941,1000.00,6187.82,7187.82,949.12,5238.70,0.03,1
59581,5941,1000.00,7187.82,8187.82,2192.56,4995.26,0.35,1
59582,5941,1000.00,8187.82,9187.82,0.00,8187.82,0.02,1
59583,5941,-1000.00,7187.82,8187.82,4441.98,699.71,0.10,0
59584,5941,1000.00,8187.82,9187.82,0.00,8187.82,0.08,1
59585,5941,1000.00,9187.82,10187.82,2933.59,4352.99,0.26,1
59586,5941,1000.00,10187.82,11187.82,0.00,2647.79,0.16,1
59587,5942,-1000.00,-1000.00,0.00,432.06,567.94,0.18,0
59588,5943,0.00,0.00,1000.00,0.00,0.00,0.05,0
59589,5943,-1000.00,-1000.00,0.00,441.94,558.06,0.19,0
59590,5944,-715.17,-715.17,284.83,0.00,715.17,0.10,0
59591,5944,-284.83,-1000.00,0.00,0.00,284.83,0.08,0
59592,5945,-1000.00,-1000.00,0.00,508.66,491.34,0.05,0
59593,5946,-1000.00,-1000.00,0.00,0.00,1000.00,0.39,0
59594,5947,-1000.00,-1000.00,0.00,277.14,722.86,0.37,0
59595,5947,-0.00,-1000.00,0.00,0.00,0.00,0.03,0
59596,5948,-563.00,-563.00,437.00,0.00,563.00,0.14,0
59597,5948,-437.00,-1000.00,0.00,178.72,258.28,0.23,0
59598,5949,0.00,0.00,1000.00,0.00,1000.00,0.09,0
59599,5949,0.00,0.00,1000.00,0.00,861.96,0.43,0
59600,5949,0.00,0.00,1000.00,294.35,705.65,0.34,0
59601,5949,0.00,0.00,1000.00,0.00,243.38,0.11,0
59602,5949,0.00,0.00,1000.00,0.00,1000.00,0.07,0
59603,5949,0.00,0.00,1000.00,0.00,1000.00,0.41,0
59604,5949,0.00,0.00,1000.00,500.00,500.00,0.00,0
59605,5949,0.00,0.00,1000.00,0.00,1000.00,0.35,0
59606,5949,0.00,0.00,1000.00,0.00,1000.00,0.31,0
59607,5949,-1000.00,-1000.00,0.00,544.25,455.75,0.05,0
59608,5950,1000.00,1000.00,2000.00,0.00,1000.00,0.11,1
59609,5950,1000.00,2000.00,3000.00,1000.00,1000.00,0.01,1
59610,5950,1000.00,3000.00,4000.00,0.00,3000.00,0.12,1
59611,5950,1000.00,4000.00,5000.00,0.00,4000.00,0.26,1
59612,5950,-1000.00,3000.00,4000.00,2617.97,2382.03,0.08,0
59613,5950,0.00,3000.00,4000.00,0.00,0.00,0.09,0
59614,5950,0.00,3000.00,4000.00,0.00,0.00,0.03,0
59615,5950,1000.00,4000.00,5000.00,5.16,2158.76,0.33,1
59616,5950,1000.00,5000.00,6000.00,665.32,1210.04,0.19,1
59617,5950,1000.00,6000.00,7000.00,461.10,5538.90,0.39,1
59618,5950,1000.00,7000.00,8000.00,842.72,1822.74,0.20,1
59619,5950,1000.00,8000.00,9000.00,1711.08,6288.92,0.01,1
59620,5950,1000.00,9000.00,10000.00,0.00,8860.30,0.44,1
59621,5950,1000.00,10000.00,11000.00,0.00,10000.00,0.20,1
59622,5950,1000.00,11000.00,12000.00,0.00,7071.32,0.33,1
59623,5950,1000.00,12000.00,13000.00,2026.56,9973.44,0.38,1
59624,5950,-1000.00,11000.00,12000.00,4808.48,8191.52,0.33,0
59625,5950,-1000.00,10000.00,11000.00,33.37,3088.18,0.40,0
59626,5950,-1000.00,9000.00,10000.00,4323.43,6676.57,0.29,0
59627,5950,-1000.00,8000.00,9000.00,0.00,7829.31,0.09,0
59628,5950,-1000.00,7000.00,8000.00,0.00,9000.00,0.24,0
59629,5950,-1000.00,6000.00,7000.00,0.00,8000.00,0.14,0
59630,5950,-1000.00,5000.00,6000.00,0.00,7000.00,0.33,0
59631,5950,-1000.00,4000.00,5000.00,1198.70,4801.30,0.16,0
59632,5950,-1000.00,3000.00,4000.00,0.00,5000.00,0.30,0
59633,5950,-1000.00,2000.00,3000.00,0.00,3322.24,0.02,0
59634,5950,-1000.00,1000.00,2000.00,0.00,1986.31,0.00,0
59635,5950,-1000.00,0.00,1000.00,0.00,674.75,0.24,0
59636,5950,-1000.00,-1000.00,0.00,848.05,151.95,0.02,0
59637,5951,-853.55,-853.55,146.45,0.00,853.55,0.36,0
59638,5951,-137.38,-990.93,9.07,33.37,104.02,0.39,0
59639,5951,-9.07,-1000.00,0.00,2.61,6.45,0.32,0
59640,5952,-1000.00,-1000.00,0.00,0.00,1000.00,0.08,0
59641,5953,-1000.00,-1000.00,0.00,376.79,623.21,0.02,0
59642,5954,-377.26,-377.26,622.74,0.00,377.26,0.23,0
59643,5954,-367.43,-744.69,255.31,0.00,367.43,0.20,0
59644,5954,-220.30,-964.99,35.01,68.15,152.15,0.32,0
59645,5954,0.00,-964.99,35.01,0.00,0.00,0.09,0
59646,5954,-22.35,-987.34,12.66,0.00,22.35,0.20,0
59647,5954,-1000.00,-1987.34,-987.34,10.07,2.59,0.04,0
59648,5955,-1000.00,-1000.00,0.00,0.00,485.30,0.19,0
59649,5956,1000.00,1000.00,2000.00,193.43,0.00,0.35,1
59650,5956,1000.00,2000.00,3000.00,1673.85,326.15,0.09,1
59651,5956,-692.10,1307.90,2307.90,0.00,692.10,0.40,0
59652,5956,0.00,1307.90,2307.90,0.00,0.00,0.04,0
59653,5956,-1000.00,307.90,1307.90,1152.33,1155.58,0.09,0
59654,5956,-1000.00,-692.10,307.90,364.18,943.72,0.37,0
59655,5956,-307.90,-1000.00,0.00,117.12,190.78,0.29,0
59656,5957,1000.00,1000.00,2000.00,0.00,1000.00,0.19,1
59657,5957,1000.00,2000.00,3000.00,0.00,495.41,0.14,1
59658,5957,1000.00,3000.00,4000.00,1422.58,1577.42,0.08,1
59659,5957,1000.00,4000.00,5000.00,1270.48,2729.52,0.26,1
59660,5957,1000.00,5000.00,6000.00,0.00,4130.90,0.17,1
59661,5957,1000.00,6000.00,7000.00,0.00,2231.28,0.26,1
59662,5957,1000.00,7000.00,8000.00,0.00,7000.00,0.30,1
59663,5957,1000.00,8000.00,9000.00,3146.72,4853.28,0.19,1
59664,5957,-1000.00,7000.00,8000.00,4639.00,4361.00,0.21,0
59665,5957,1000.00,8000.00,9000.00,0.00,8000.00,0.26,1
59666,5957,1000.00,9000.00,10000.00,0.00,9000.00,0.44,1
59667,5957,1000.00,10000.00,11000.00,0.00,5253.11,0.29,1
59668,5957,-1000.00,9000.00,10000.00,486.48,10311.85,0.44,0
59669,5957,-1000.00,8000.00,9000.00,1303.68,8696.32,0.37,0
59670,5957,-1000.00,7000.00,8000.00,2880.98,6119.02,0.01,0
59671,5957,-1000.00,6000.00,7000.00,84.48,7915.52,0.26,0
59672,5957,-1000.00,5000.00,6000.00,0.00,7000.00,0.14,0
59673,5957,-1000.00,4000.00,5000.00,0.00,5711.86,0.23,0
59674,5957,-1000.00,3000.00,4000.00,0.00,5000.00,0.29,0
59675,5957,-1000.00,2000.00,3000.00,1123.84,2876.16,0.34,0
59676,5957,-1000.00,1000.00,2000.00,0.00,1505.36,0.11,0
59677,5957,-1000.00,0.00,1000.00,0.00,1234.34,0.23,0
59678,5957,-1000.00,-1000.00,0.00,7.54,449.67,0.29,0
59679,5958,-1000.00,-1000.00,0.00,0.00,1000.00,0.20,0
59680,5959,1000.00,1000.00,2000.00,142.86,857.14,0.41,1
59681,5959,1000.00,2000.00,3000.00,0.00,995.67,0.00,1
59682,5959,1000.00,3000.00,4000.00,0.00,640.35,0.16,1
59683,5959,1000.00,4000.00,5000.00,22.33,3977.67,0.43,1
59684,5959,1000.00,5000.00,6000.00,0.00,5000.00,0.26,1
59685,5959,1000.00,6000.00,7000.00,0.00,6000.00,0.37,1
59686,5959,1000.00,7000.00,8000.00,0.00,2803.93,0.25,1
59687,5959,1000.00,8000.00,9000.00,2058.92,5941.08,0.35,1
59688,5959,-1000.00,7000.00,8000.00,6801.24,1849.21,0.08,0
59689,5959,1000.00,8000.00,9000.00,4000.00,4000.00,0.07,1
59690,5959,1000.00,9000.00,10000.00,0.00,9000.00,0.32,1
59691,5959,1000.00,10000.00,11000.00,0.00,6958.02,0.25,1
59692,5959,1000.00,11000.00,12000.00,4893.46,6106.54,0.17,1
59693,5959,1000.00,12000.00,13000.00,0.00,5198.80,0.28,1
59694,5959,1000.00,13000.00,14000.00,0.00,13000.00,0.30,1
59695,5959,1000.00,14000.00,15000.00,5594.68,8405.32,0.24,1
59696,5959,1000.00,15000.00,16000.00,5351.55,9648.45,0.26,1
59697,5959,1000.00,16000.00,17000.00,3888.52,12111.48,0.37,1
59698,5959,1000.00,17000.00,18000.00,3012.44,13987.56,0.32,1
59699,5959,1000.00,18000.00,19000.00,7049.59,10950.41,0.13,1
59700,5959,1000.00,19000.00,20000.00,0.00,19000.00,0.12,1
59701,5959,-1000.00,18000.00,19000.00,5634.46,2877.61,0.14,0
59702,5959,1000.00,19000.00,20000.00,7162.14,11837.86,0.01,1
59703,5959,1000.00,20000.00,21000.00,6420.82,13579.18,0.34,1
59704,5959,-1000.00,19000.00,20000.00,0.00,21000.00,0.11,0
59705,5959,-1000.00,18000.00,19000.00,0.00,20000.00,0.26,0
59706,5959,-1000.00,17000.00,18000.00,0.00,18463.18,0.44,0
59707,5959,-1000.00,16000.00,17000.00,6257.01,11742.99,0.15,0
59708,5959,-1000.00,15000.00,16000.00,5339.72,11660.28,0.19,0
59709,5959,-1000.00,14000.00,15000.00,0.00,16000.00,0.32,0
59710,5959,-1000.00,13000.00,14000.00,0.00,15000.00,0.08,0
59711,5959,-1000.00,12000.00,13000.00,2837.78,11162.22,0.40,0
59712,5959,-1000.00,11000.00,12000.00,1914.15,11085.85,0.32,0
59713,5959,-1000.00,10000.00,11000.00,0.00,10537.71,0.43,0
59714,5959,-1000.00,9000.00,10000.00,0.00,9166.07,0.39,0
59715,5959,-1000.00,8000.00,9000.00,3935.70,6064.30,0.29,0
59716,5959,-1000.00,7000.00,8000.00,0.00,6127.04,0.38,0
59717,5959,-1000.00,6000.00,7000.00,0.00,8000.00,0.23,0
59718,5959,-1000.00,5000.00,6000.00,2403.40,4596.60,0.28,0
59719,5959,-1000.00,4000.00,5000.00,0.00,6000.00,0.27,0
59720,5959,-1000.00,3000.00,4000.00,0.00,3312.72,0.26,0
59721,5959,-1000.00,2000.00,3000.00,1005.38,1572.94,0.24,0
59722,5959,-1000.00,1000.00,2000.00,0.00,3000.00,0.43,0
59723,5959,-999.81,0.19,1000.19,0.00,999.81,0.05,0
59724,5959,-1000.00,-999.81,0.19,376.84,623.35,0.27,0
59725,5960,-1000.00,-1000.00,0.00,334.72,665.28,0.07,0
59726,5961,-1000.00,-1000.00,0.00,29.34,970.66,0.26,0
59727,5962,1000.00,1000.00,2000.00,388.80,611.20,0.30,1
59728,5962,1000.00,2000.00,3000.00,0.00,2000.00,0.33,1
59729,5962,1000.00,3000.00,4000.00,732.50,2267.50,0.36,1
59730,5962,-1000.00,2000.00,3000.00,2083.00,1917.00,0.09,0
59731,5962,1000.00,3000.00,4000.00,0.00,3000.00,0.17,1
59732,5962,1000.00,4000.00,5000.00,0.00,1447.92,0.23,1
59733,5962,1000.00,5000.00,6000.00,1246.19,3241.93,0.34,1
59734,5962,1000.00,6000.00,7000.00,2265.13,3734.87,0.10,1
59735,5962,1000.00,7000.00,8000.00,0.00,565.06,0.13,1
59736,5962,1000.00,8000.00,9000.00,0.00,8000.00,0.11,1
59737,5962,1000.00,9000.00,10000.00,0.00,9000.00,0.31,1
59738,5962,1000.00,10000.00,11000.00,0.00,10000.00,0.25,1
59739,5962,1000.00,11000.00,12000.00,0.00,4491.59,0.27,1
59740,5962,1000.00,12000.00,13000.00,3068.40,8931.60,0.32,1
59741,5962,1000.00,13000.00,14000.00,4000.09,8999.91,0.33,1
59742,5962,1000.00,14000.00,15000.00,5741.87,8258.13,0.08,1
59743,5962,1000.00,15000.00,16000.00,3831.18,11168.82,0.22,1
59744,5962,1000.00,16000.00,17000.00,0.00,16000.00,0.09,1
59745,5962,1000.00,17000.00,18000.00,0.00,7067.82,0.22,1
59746,5962,-1000.00,16000.00,17000.00,7484.03,0.00,0.08,0
59747,5962,1000.00,17000.00,18000.00,0.00,17000.00,0.14,1
59748,5962,0.00,17000.00,18000.00,0.00,0.00,0.11,0
59749,5962,-1000.00,16000.00,17000.00,5633.12,4106.95,0.17,0
59750,5962,-1000.00,15000.00,16000.00,4187.62,12337.32,0.37,0
59751,5962,-1000.00,14000.00,15000.00,12472.95,0.00,0.01,0
59752,5962,-1000.00,13000.00,14000.00,0.00,15000.00,0.01,0
59753,5962,-1000.00,12000.00,13000.00,6693.74,1474.05,0.11,0
59754,5962,-1000.00,11000.00,12000.00,7179.33,4438.12,0.16,0
59755,5962,-1000.00,10000.00,11000.00,0.00,12000.00,0.00,0
59756,5962,-1000.00,9000.00,10000.00,0.00,6278.39,0.25,0
59757,5962,-1000.00,8000.00,9000.00,0.00,10000.00,0.27,0
59758,5962,-1000.00,7000.00,8000.00,0.00,9000.00,0.22,0
59759,5962,-1000.00,6000.00,7000.00,3293.48,1981.78,0.16,0
59760,5962,-1000.00,5000.00,6000.00,0.00,7000.00,0.03,0
59761,5962,-1000.00,4000.00,5000.00,0.00,6000.00,0.22,0
59762,5962,-1000.00,3000.00,4000.00,21.64,1459.02,0.22,0
59763,5962,-1000.00,2000.00,3000.00,573.21,3426.79,0.13,0
59764,5962,-1000.00,1000.00,2000.00,0.00,1832.18,0.33,0
59765,5962,-1000.00,0.00,1000.00,0.00,2000.00,0.32,0
59766,5962,-883.04,-883.04,116.96,0.00,883.04,0.16,0
59767,5962,-81.70,-964.74,35.26,33.89,47.81,0.24,0
59768,5962,-35.26,-1000.00,0.00,0.00,35.26,0.41,0
59769,5963,-229.99,-229.99,770.01,229.99,0.00,0.00,0
59770,5963,-1000.00,-1229.99,-229.99,0.00,248.61,0.14,0
59771,5964,1000.00,1000.00,2000.00,3.24,996.76,0.35,1
59772,5964,1000.00,2000.00,3000.00,0.00,2000.00,0.42,1
59773,5964,1000.00,3000.00,4000.00,0.00,2723.38,0.44,1
59774,5964,1000.00,4000.00,5000.00,1083.43,2916.57,0.37,1
59775,5964,1000.00,5000.00,6000.00,0.00,1337.26,0.11,1
59776,5964,1000.00,6000.00,7000.00,0.00,1930.87,0.23,1
59777,5964,1000.00,7000.00,8000.00,2480.87,4519.13,0.05,1
59778,5964,1000.00,8000.00,9000.00,0.00,1398.40,0.15,1
59779,5964,1000.00,9000.00,10000.00,0.00,9000.00,0.27,1
59780,5964,0.00,9000.00,10000.00,0.00,0.00,0.07,0
59781,5964,1000.00,10000.00,11000.00,0.00,6852.48,0.33,1
59782,5964,1000.00,11000.00,12000.00,0.00,11000.00,0.35,1
59783,5964,1000.00,12000.00,13000.00,0.00,3664.97,0.05,1
59784,5964,1000.00,13000.00,14000.00,0.00,13000.00,0.18,1
59785,5964,1000.00,14000.00,15000.00,0.00,14000.00,0.40,1
59786,5964,1000.00,15000.00,16000.00,7500.00,7500.00,0.09,1
59787,5964,1000.00,16000.00,17000.00,2742.49,5520.43,0.23,1
59788,5964,1000.00,17000.00,18000.00,1775.35,15224.65,0.40,1
59789,5964,1000.00,18000.00,19000.00,0.00,14853.96,0.38,1
59790,5964,1000.00,19000.00,20000.00,0.00,19000.00,0.08,1
59791,5964,1000.00,20000.00,21000.00,0.00,20000.00,0.43,1
59792,5964,1000.00,21000.00,22000.00,0.00,21000.00,0.26,1
59793,5964,1000.00,22000.00,23000.00,0.00,12220.28,0.28,1
59794,5964,1000.00,23000.00,24000.00,1395.77,21604.23,0.04,1
59795,5964,1000.00,24000.00,25000.00,0.00,23057.95,0.41,1
59796,5964,1000.00,25000.00,26000.00,0.00,7392.04,0.15,1
59797,5964,1000.00,26000.00,27000.00,0.00,26000.00,0.23,1
59798,5964,1000.00,27000.00,28000.00,0.00,27000.00,0.11,1
59799,5964,1000.00,28000.00,29000.00,11795.58,16204.42,0.12,1
59800,5964,1000.00,29000.00,30000.00,0.00,29000.00,0.26,1
59801,5964,0.00,29000.00,30000.00,0.00,0.00,0.02,0
59802,5964,1000.00,30000.00,31000.00,0.00,30000.00,0.42,1
59803,5964,1000.00,31000.00,32000.00,0.00,26627.06,0.43,1
59804,5964,1000.00,32000.00,33000.00,0.00,32000.00,0.21,1
59805,5964,1000.00,33000.00,34000.00,2031.02,2356.49,0.13,1
59806,5964,1000.00,34000.00,35000.00,0.00,25080.19,0.40,1
59807,5965,0.00,0.00,1000.00,0.00,0.00,0.07,0
59808,5965,1000.00,1000.00,2000.00,961.84,38.16,0.02,1
59809,5965,-1000.00,0.00,1000.00,0.00,2000.00,0.25,0
59810,5965,1000.00,1000.00,2000.00,693.51,306.49,0.15,1
59811,5965,-0.70,999.30,1999.30,0.00,0.70,0.07,0
59812,5965,1000.00,1999.30,2999.30,1157.28,589.54,0.16,1
59813,5965,-1000.00,999.30,1999.30,0.00,1265.29,0.14,0
59814,5965,-1000.00,-0.70,999.30,566.77,1432.53,0.26,0
59815,5965,-999.30,-1000.00,0.00,0.00,999.30,0.08,0
59816,5966,-1000.00,-1000.00,0.00,340.90,659.10,0.35,0
59817,5967,-288.02,-288.02,711.98,0.00,288.02,0.28,0
59818,5967,1000.00,711.98,1711.98,406.82,0.00,0.22,1
59819,5967,0.00,711.98,1711.98,0.00,0.00,0.03,0
59820,5967,-1000.00,-288.02,711.98,0.00,1711.98,0.24,0
59821,5967,-711.98,-1000.00,0.00,0.00,711.98,0.39,0
59822,5968,1000.00,1000.00,2000.00,482.93,493.19,0.22,1
59823,5968,1000.00,2000.00,3000.00,0.00,2000.00,0.35,1
59824,5968,-1000.00,1000.00,2000.00,1198.93,1133.54,0.21,0
59825,5968,1000.00,2000.00,3000.00,0.00,1585.94,0.17,1
59826,5968,1000.00,3000.00,4000.00,486.20,920.95,0.22,1
59827,5968,1000.00,4000.00,5000.00,0.00,1902.51,0.24,1
59828,5968,1000.00,5000.00,6000.00,1264.28,3735.72,0.37,1
59829,5968,1000.00,6000.00,7000.00,0.00,6000.00,0.33,1
59830,5968,1000.00,7000.00,8000.00,0.00,7000.00,0.39,1
59831,5968,1000.00,8000.00,9000.00,0.00,8000.00,0.24,1
59832,5968,-1000.00,7000.00,8000.00,4563.40,281.60,0.08,0
59833,5968,1000.00,8000.00,9000.00,0.00,4177.33,0.32,1
59834,5968,1000.00,9000.00,10000.00,1909.33,7090.67,0.40,1
59835,5968,1000.00,10000.00,11000.00,771.57,9228.43,0.10,1
59836,5968,-1000.00,9000.00,10000.00,6477.08,4522.92,0.11,0
59837,5968,1000.00,10000.00,11000.00,0.00,10000.00,0.28,1
59838,5968,1000.00,11000.00,12000.00,0.00,5530.80,0.31,1
59839,5968,1000.00,12000.00,13000.00,5395.33,6604.67,0.07,1
59840,5968,1000.00,13000.00,14000.00,0.00,7727.00,0.23,1
59841,5968,1000.00,14000.00,15000.00,0.00,14000.00,0.36,1
59842,5968,1000.00,15000.00,16000.00,0.00,15000.00,0.05,1
59843,5968,1000.00,16000.00,17000.00,0.00,3749.18,0.00,1
59844,5968,1000.00,17000.00,18000.00,0.00,14473.47,0.42,1
59845,5968,1000.00,18000.00,19000.00,5045.89,12954.11,0.34,1
59846,5968,1000.00,19000.00,20000.00,0.00,19000.00,0.25,1
59847,5968,0.00,19000.00,20000.00,0.00,0.00,0.02,0
59848,5968,1000.00,20000.00,21000.00,0.00,20000.00,0.37,1
59849,5968,1000.00,21000.00,22000.00,8992.73,12002.23,0.27,1
59850,5968,1000.00,22000.00,23000.00,0.00,22000.00,0.06,1
59851,5968,1000.00,23000.00,24000.00,2496.47,20503.53,0.43,1
59852,5968,1000.00,24000.00,25000.00,5505.19,18494.81,0.05,1
59853,5968,1000.00,25000.00,26000.00,0.00,23977.39,0.43,1
59854,5968,1000.00,26000.00,27000.00,0.00,26000.00,0.08,1
59855,5968,1000.00,27000.00,28000.00,0.00,27000.00,0.06,1
59856,5968,1000.00,28000.00,29000.00,0.00,27336.00,0.14,1
59857,5968,1000.00,29000.00,30000.00,0.00,29000.00,0.28,1
59858,5968,1000.00,30000.00,31000.00,0.00,20251.75,0.15,1
59859,5968,1000.00,31000.00,32000.00,3740.73,27259.27,0.04,1
59860,5968,1000.00,32000.00,33000.00,0.00,32000.00,0.23,1
59861,5968,1000.00,33000.00,34000.00,11080.56,21919.44,0.33,1
59862,5968,1000.00,34000.00,35000.00,0.00,34000.00,0.15,1
59863,5968,1000.00,35000.00,36000.00,11107.52,23892.48,0.30,1
59864,5968,1000.00,36000.00,37000.00,0.00,36000.00,0.13,1
59865,5968,1000.00,37000.00,38000.00,13878.11,23121.89,0.20,1
59866,5968,1000.00,38000.00,39000.00,19000.00,19000.00,0.00,1
59867,5968,1000.00,39000.00,40000.00,0.00,39000.00,0.07,1
59868,5968,1000.00,40000.00,41000.00,0.00,15855.02,0.13,1
59869,5968,0.00,40000.00,41000.00,0.00,0.00,0.04,0
59870,5968,-1000.00,39000.00,40000.00,0.00,35685.19,0.30,0
59871,5968,-1000.00,38000.00,39000.00,0.00,18350.78,0.29,0
59872,5968,-1000.00,37000.00,38000.00,13304.98,25695.02,0.17,0
59873,5968,-1000.00,36000.00,37000.00,0.00,28743.04,0.11,0
59874,5968,-1000.00,35000.00,36000.00,12324.27,24675.73,0.06,0
59875,5968,-1000.00,34000.00,35000.00,15365.61,20634.39,0.13,0
59876,5968,-1000.00,33000.00,34000.00,0.00,35000.00,0.10,0
59877,5968,-1000.00,32000.00,33000.00,0.00,16550.43,0.31,0
59878,5968,-1000.00,31000.00,32000.00,0.00,33000.00,0.17,0
59879,5968,-1000.00,30000.00,31000.00,0.00,32000.00,0.20,0
59880,5968,-1000.00,29000.00,30000.00,0.00,27776.57,0.17,0
59881,5968,-1000.00,28000.00,29000.00,0.00,30000.00,0.41,0
59882,5968,-1000.00,27000.00,28000.00,11228.45,17771.55,0.29,0
59883,5968,-1000.00,26000.00,27000.00,0.00,26188.59,0.20,0
59884,5968,-1000.00,25000.00,26000.00,2255.04,24744.96,0.42,0
59885,5968,-1000.00,24000.00,25000.00,20035.99,5964.01,0.04,0
59886,5968,-1000.00,23000.00,24000.00,3547.56,21275.77,0.42,0
59887,5968,-1000.00,22000.00,23000.00,10879.99,1704.30,0.10,0
59888,5968,-1000.00,21000.00,22000.00,0.00,23000.00,0.24,0
59889,5968,-1000.00,20000.00,21000.00,7402.20,14597.80,0.15,0
59890,5969,0.00,0.00,1000.00,0.00,0.00,0.42,0
59891,5969,-467.62,-467.62,532.38,467.62,0.00,0.29,0
59892,5969,-532.38,-1000.00,0.00,364.32,168.06,0.12,0
59893,5970,-1000.00,-1000.00,0.00,0.00,45.59,0.13,0
59894,5971,-1000.00,-1000.00,0.00,0.00,1000.00,0.33,0
59895,5972,-1000.00,-1000.00,0.00,500.00,500.00,0.01,0
59896,5973,0.00,0.00,1000.00,0.00,0.00,0.19,0
59897,5973,1000.00,1000.00,2000.00,651.25,348.75,0.18,1
59898,5973,-1000.00,0.00,1000.00,627.36,1372.64,0.28,0
59899,5973,-1000.00,-1000.00,0.00,500.00,500.00,0.07,0
59900,5974,0.00,0.00,1000.00,0.00,0.00,0.02,0
59901,5974,-1000.00,-1000.00,0.00,601.72,398.28,0.12,0
59902,5975,1000.00,1000.00,2000.00,0.00,1000.00,0.04,1
59903,5975,1000.00,2000.00,3000.00,0.00,2000.00,0.27,1
59904,5975,1000.00,3000.00,4000.00,364.87,2635.13,0.09,1
59905,5975,1000.00,4000.00,5000.00,1315.55,2684.45,0.11,1
59906,5975,1000.00,5000.00,6000.00,0.00,632.43,0.13,1
59907,5975,1000.00,6000.00,7000.00,1633.75,4366.25,0.16,1
59908,5975,1000.00,7000.00,8000.00,2032.45,3059.76,0.25,1
59909,5975,1000.00,8000.00,9000.00,1864.80,6135.20,0.33,1
59910,5975,1000.00,9000.00,10000.00,0.00,9000.00,0.27,1
59911,5975,1000.00,10000.00,11000.00,0.00,7509.37,0.39,1
59912,5975,1000.00,11000.00,12000.00,0.00,11000.00,0.01,1
59913,5975,1000.00,12000.00,13000.00,4610.89,7389.11,0.26,1
59914,5975,1000.00,13000.00,14000.00,0.00,13000.00,0.36,1
59915,5975,1000.00,14000.00,15000.00,1810.03,12189.97,0.33,1
59916,5975,1000.00,15000.00,16000.00,0.00,15000.00,0.15,1
59917,5975,1000.00,16000.00,17000.00,0.00,16000.00,0.28,1
59918,5975,1000.00,17000.00,18000.00,0.00,17000.00,0.10,1
59919,5975,-1000.00,16000.00,17000.00,6894.31,0.00,0.05,0
59920,5975,-1000.00,15000.00,16000.00,9711.41,7288.59,0.11,0
59921,5975,1000.00,16000.00,17000.00,4003.99,11996.01,0.26,1
59922,5975,-1000.00,15000.00,16000.00,5293.95,11706.05,0.30,0
59923,5975,-1000.00,14000.00,15000.00,9529.35,0.00,0.09,0
59924,5975,-1000.00,13000.00,14000.00,0.00,15000.00,0.03,0
59925,5975,-427.08,12572.92,13572.92,0.00,427.08,0.12,0
59926,5975,-1000.00,11572.92,12572.92,8438.80,1793.97,0.09,0
59927,5975,-1000.00,10572.92,11572.92,1682.91,3847.34,0.22,0
59928,5975,-1000.00,9572.92,10572.92,4678.01,2487.78,0.15,0
59929,5975,-1000.00,8572.92,9572.92,0.00,9227.23,0.33,0
59930,5975,-1000.00,7572.92,8572.92,4058.39,5514.52,0.16,0
59931,5975,-1000.00,6572.92,7572.92,3626.60,4946.32,0.21,0
59932,5975,-1000.00,5572.92,6572.92,0.00,3317.72,0.15,0
59933,5975,-1000.00,4572.92,5572.92,0.00,5292.58,0.24,0
59934,5975,-1000.00,3572.92,4572.92,0.00,5572.92,0.26,0
59935,5975,-1000.00,2572.92,3572.92,0.00,1685.17,0.01,0
59936,5975,-860.83,1712.08,2712.08,0.00,860.83,0.08,0
59937,5975,-1000.00,712.08,1712.08,1068.47,1478.98,0.27,0
59938,5975,-1000.00,-287.92,712.08,856.04,856.04,0.08,0
59939,5975,-712.08,-1000.00,0.00,291.64,420.45,0.19,0
59940,5976,-1000.00,-1000.00,0.00,318.06,681.94,0.33,0
59941,5976,-0.00,-1000.00,0.00,0.00,0.00,0.20,0
59942,5977,-52.99,-52.99,947.01,0.00,52.99,0.10,0
59943,5977,-947.01,-1000.00,0.00,59.22,887.79,0.38,0
59944,5978,-1000.00,-1000.00,0.00,231.02,768.98,0.27,0
59945,5978,-0.00,-1000.00,0.00,0.00,0.00,0.41,0
59946,5979,-1000.00,-1000.00,0.00,500.00,500.00,0.01,0
59947,5980,0.00,0.00,1000.00,0.00,0.00,0.44,0
59948,5980,-1000.00,-1000.00,0.00,0.00,1000.00,0.01,0
59949,5981,-556.47,-556.47,443.53,0.00,556.47,0.34,0
59950,5981,-443.53,-1000.00,0.00,155.82,287.71,0.23,0
59951,5982,-1000.00,-1000.00,0.00,400.66,599.34,0.21,0
59952,5983,-1000.00,-1000.00,0.00,492.09,507.91,0.15,0
59953,5984,-1000.00,-1000.00,0.00,336.37,663.63,0.09,0
59954,5985,-715.12,-715.12,284.88,715.12,0.00,0.22,0
59955,5985,-1000.00,-1715.12,-715.12,0.00,94.15,0.14,0
59956,5986,-1000.00,-1000.00,0.00,905.22,94.78,0.01,0
59957,5987,0.00,0.00,1000.00,0.00,0.00,0.22,0
59958,5987,-764.87,-764.87,235.13,0.00,764.87,0.10,0
59959,5987,1000.00,235.13,1235.13,48.50,0.00,0.41,1
59960,5987,1000.00,1235.13,2235.13,1003.53,0.00,0.17,1
59961,5987,-302.81,932.32,1932.32,0.00,302.81,0.31,0
59962,5987,0.00,932.32,1932.32,0.00,0.00,0.22,0
59963,5987,-1000.00,-67.68,932.32,879.24,1053.07,0.03,0
59964,5987,-932.32,-1000.00,0.00,0.00,932.32,0.09,0
59965,5988,-1000.00,-1000.00,0.00,464.90,535.10,0.13,0
59966,5989,-260.12,-260.12,739.88,0.00,260.12,0.32,0
59967,5989,-739.88,-1000.00,0.00,0.00,739.88,0.02,0
59968,5990,-1000.00,-1000.00,0.00,0.00,815.80,0.42,0
59969,5991,-1000.00,-1000.00,0.00,526.43,473.57,0.08,0
59970,5992,0.00,0.00,1000.00,0.00,0.00,0.01,0
59971,5992,0.00,0.00,1000.00,0.00,0.00,0.14,0
59972,5992,-1000.00,-1000.00,0.00,470.67,529.33,0.28,0
59973,5993,-663.87,-663.87,336.13,663.87,0.00,0.24,0
59974,5993,0.00,-663.87,336.13,0.00,0.00,0.25,0
59975,5993,1000.00,336.13,1336.13,87.23,248.90,0.37,1
59976,5993,1000.00,1336.13,2336.13,0.00,1014.50,0.34,1
59977,5993,0.00,1336.13,2336.13,0.00,0.00,0.02,0
59978,5993,1000.00,2336.13,3336.13,1013.29,1322.84,0.14,1
59979,5993,1000.00,3336.13,4336.13,0.00,1278.38,0.20,1
59980,5993,1000.00,4336.13,5336.13,2038.13,2298.00,0.12,1
59981,5993,0.00,4336.13,5336.13,0.00,0.00,0.03,0
59982,5993,1000.00,5336.13,6336.13,0.00,2850.42,0.12,1
59983,5993,1000.00,6336.13,7336.13,2739.11,3597.02,0.27,1
59984,5993,1000.00,7336.13,8336.13,0.00,7336.13,0.24,1
59985,5993,1000.00,8336.13,9336.13,0.00,8336.13,0.15,1
59986,5993,-1000.00,7336.13,8336.13,6517.19,2818.94,0.11,0
59987,5993,1000.00,8336.13,9336.13,0.00,6465.61,0.38,1
59988,5993,1000.00,9336.13,10336.13,0.00,9336.13,0.44,1
59989,5993,1000.00,10336.13,11336.13,0.00,10336.13,0.21,1
59990,5993,1000.00,11336.13,12336.13,3147.78,8188.35,0.36,1
59991,5993,0.00,11336.13,12336.13,0.00,0.00,0.10,0
59992,5993,1000.00,12336.13,13336.13,0.00,3830.43,0.23,1
59993,5993,1000.00,13336.13,14336.13,6331.47,7004.66,0.19,1
59994,5993,-1000.00,12336.13,13336.13,8973.08,5363.05,0.04,0
59995,5993,1000.00,13336.13,14336.13,0.00,8201.21,0.33,1
59996,5993,1000.00,14336.13,15336.13,0.00,14336.13,0.25,1
59997,5993,-1000.00,13336.13,14336.13,0.00,15060.10,0.42,0
59998,5993,-1000.00,12336.13,13336.13,3696.43,10639.70,0.38,0
59999,5993,-1000.00,11336.13,12336.13,6975.08,6361.05,0.19,0
60000,5993,0.00,11336.13,12336.13,0.00,0.00,0.00,0
60001,5993,-1000.00,10336.13,11336.13,0.00,12336.13,0.18,0
60002,5993,-1000.00,9336.13,10336.13,0.00,11336.13,0.26,0
60003,5993,-1000.00,8336.13,9336.13,0.00,3861.29,0.23,0
60004,5993,-1000.00,7336.13,8336.13,0.00,9336.13,0.06,0
60005,5993,-1000.00,6336.13,7336.13,0.00,1838.14,0.10,0
60006,5993,-1000.00,5336.13,6336.13,0.00,6406.83,0.39,0
60007,5993,-1000.00,4336.13,5336.13,1578.94,4605.91,0.37,0
60008,5993,-1000.00,3336.13,4336.13,0.00,3160.37,0.06,0
60009,5993,-1000.00,2336.13,3336.13,1056.66,3279.47,0.30,0
60010,5993,-1000.00,1336.13,2336.13,0.00,3046.31,0.39,0
60011,5993,-1000.00,336.13,1336.13,224.06,2112.07,0.41,0
60012,5993,-1000.00,-663.87,336.13,641.60,694.53,0.02,0
60013,5993,-336.13,-1000.00,0.00,0.00,336.13,0.30,0
60014,5994,1000.00,1000.00,2000.00,172.21,827.79,0.41,1
60015,5994,1000.00,2000.00,3000.00,120.03,1679.12,0.42,1
60016,5994,1000.00,3000.00,4000.00,1034.26,1965.74,0.33,1
60017,5994,-1000.00,2000.00,3000.00,2130.30,1287.00,0.16,0
60018,5994,1000.00,3000.00,4000.00,861.22,2138.78,0.33,1
60019,5994,1000.00,4000.00,5000.00,0.00,4000.00,0.03,1
60020,5994,1000.00,5000.00,6000.00,134.20,1037.59,0.18,1
60021,5994,1000.00,6000.00,7000.00,0.00,6000.00,0.17,1
60022,5994,1000.00,7000.00,8000.00,0.00,4929.80,0.14,1
60023,5994,1000.00,8000.00,9000.00,3458.96,4541.04,0.18,1
60024,5994,1000.00,9000.00,10000.00,3202.68,5797.32,0.28,1
60025,5994,1000.00,10000.00,11000.00,2873.63,7126.37,0.35,1
60026,5994,1000.00,11000.00,12000.00,0.00,8989.59,0.27,1
60027,5994,1000.00,12000.00,13000.00,4121.30,4954.55,0.23,1
60028,5994,1000.00,13000.00,14000.00,0.00,12484.28,0.16,1
60029,5994,1000.00,14000.00,15000.00,4157.12,9842.88,0.33,1
60030,5994,1000.00,15000.00,16000.00,3652.77,11347.23,0.36,1
60031,5994,1000.00,16000.00,17000.00,6068.65,9931.35,0.19,1
60032,5994,1000.00,17000.00,18000.00,0.00,17000.00,0.29,1
60033,5994,-1000.00,16000.00,17000.00,3139.93,0.00,0.02,0
60034,5994,1000.00,17000.00,18000.00,0.00,962.47,0.13,1
60035,5994,-1000.00,16000.00,17000.00,7855.45,0.00,0.05,0
60036,5994,1000.00,17000.00,18000.00,5810.25,11189.75,0.29,1
60037,5994,1000.00,18000.00,19000.00,5304.21,12695.79,0.11,1
60038,5994,1000.00,19000.00,20000.00,0.00,19000.00,0.07,1
60039,5994,1000.00,20000.00,21000.00,3799.69,16200.31,0.28,1
60040,5994,1000.00,21000.00,22000.00,0.00,21000.00,0.04,1
60041,5994,-1000.00,20000.00,21000.00,9835.97,4876.58,0.14,0
60042,5994,1000.00,21000.00,22000.00,560.54,20439.46,0.44,1
60043,5994,1000.00,22000.00,23000.00,0.00,22000.00,0.05,1
60044,5994,1000.00,23000.00,24000.00,0.00,23000.00,0.34,1
60045,5994,0.00,23000.00,24000.00,0.00,0.00,0.06,0
60046,5994,1000.00,24000.00,25000.00,0.00,24000.00,0.10,1
60047,5994,1000.00,25000.00,26000.00,5404.54,19595.46,0.34,1
60048,5994,1000.00,26000.00,27000.00,4176.60,21823.40,0.41,1
60049,5994,1000.00,27000.00,28000.00,0.00,5280.44,0.18,1
60050,5994,1000.00,28000.00,29000.00,0.00,19069.98,0.38,1
60051,5994,1000.00,29000.00,30000.00,2927.42,26072.58,0.40,1
60052,5994,-1000.00,28000.00,29000.00,23010.87,0.00,0.04,0
60053,5994,1000.00,29000.00,30000.00,0.00,29000.00,0.03,1
60054,5994,1000.00,30000.00,31000.00,13192.66,16807.34,0.24,1
60055,5994,1000.00,31000.00,32000.00,0.00,14846.85,0.21,1
60056,5994,1000.00,32000.00,33000.00,15065.89,16934.11,0.04,1
60057,5994,1000.00,33000.00,34000.00,2790.32,18387.18,0.33,1
60058,5994,1000.00,34000.00,35000.00,15108.67,18891.33,0.24,1
60059,5994,1000.00,35000.00,36000.00,6766.59,28233.41,0.41,1
60060,5994,1000.00,36000.00,37000.00,8313.94,27686.06,0.39,1
60061,5994,1000.00,37000.00,38000.00,0.00,24986.22,0.32,1
60062,5994,-1000.00,36000.00,37000.00,11861.59,26138.41,0.35,0
60063,5994,-1000.00,35000.00,36000.00,19772.70,17227.30,0.05,0
60064,5994,-1000.00,34000.00,35000.00,6128.26,23953.71,0.36,0
60065,5994,-1000.00,33000.00,34000.00,19744.03,15255.97,0.06,0
60066,5994,-1000.00,32000.00,33000.00,17738.69,16261.31,0.11,0
60067,5994,-1000.00,31000.00,32000.00,0.00,31088.04,0.21,0
60068,5994,-1000.00,30000.00,31000.00,9416.38,6130.99,0.16,0
60069,5994,-1000.00,29000.00,30000.00,13125.98,17874.02,0.22,0
60070,5994,-1000.00,28000.00,29000.00,11799.27,17011.69,0.27,0
60071,5994,-1000.00,27000.00,28000.00,0.00,14785.37,0.22,0
60072,5994,-1000.00,26000.00,27000.00,10011.17,17988.83,0.09,0
60073,5994,-1000.00,25000.00,26000.00,0.00,27000.00,0.15,0
60074,5994,-1000.00,24000.00,25000.00,5241.45,13306.33,0.30,0
60075,5994,-1000.00,23000.00,24000.00,0.00,18627.29,0.17,0
60076,5994,-1000.00,22000.00,23000.00,6424.09,10990.55,0.27,0
60077,5994,-1000.00,21000.00,22000.00,9392.54,13607.46,0.20,0
60078,5994,-1000.00,20000.00,21000.00,0.00,11312.94,0.17,0
60079,5994,-1000.00,19000.00,20000.00,0.00,21000.00,0.39,0
60080,5994,-1000.00,18000.00,19000.00,0.00,14450.34,0.37,0
60081,5994,-1000.00,17000.00,18000.00,9500.00,9500.00,0.06,0
60082,5994,-1000.00,16000.00,17000.00,10593.89,7406.11,0.06,0
60083,5994,-1000.00,15000.00,16000.00,0.00,11526.21,0.35,0
60084,5994,-1000.00,14000.00,15000.00,0.00,12341.81,0.09,0
60085,5995,0.00,0.00,1000.00,0.00,0.00,0.24,0
60086,5995,-1000.00,-1000.00,0.00,518.72,199.69,0.30,0
60087,5996,-518.43,-518.43,481.57,518.43,0.00,0.29,0
60088,5996,-1000.00,-1518.43,-518.43,0.00,231.32,0.32,0
60089,5997,-1000.00,-1000.00,0.00,0.00,1000.00,0.39,0
60090,5998,-1000.00,-1000.00,0.00,500.00,500.00,0.00,0
60091,5999,-1000.00,-1000.00,0.00,40.12,959.88,0.44,0
60092,6000,-1000.00,-1000.00,0.00,592.69,233.76,0.12,0
60093,6001,1000.00,1000.00,2000.00,500.00,500.00,0.04,1
60094,6001,-1000.00,0.00,1000.00,916.82,825.60,0.20,0
60095,6001,1000.00,1000.00,2000.00,472.11,527.89,0.03,1
60096,6001,-1000.00,0.00,1000.00,1357.61,642.39,0.09,0
60097,6001,-983.08,-983.08,16.92,983.08,0.00,0.00,0
60098,6001,1000.00,16.92,1016.92,0.00,16.92,0.02,1
60099,6001,1000.00,1016.92,2016.92,0.00,1016.92,0.24,1
60100,6001,-1000.00,16.92,1016.92,1218.66,798.26,0.10,0
60101,6001,1000.00,1016.92,2016.92,0.00,907.78,0.35,1
60102,6001,1000.00,2016.92,3016.92,0.00,1037.29,0.22,1
60103,6001,1000.00,3016.92,4016.92,0.00,2157.33,0.35,1
60104,6001,1000.00,4016.92,5016.92,0.00,4016.92,0.26,1
60105,6001,-1000.00,3016.92,4016.92,4110.67,0.00,0.02,0
60106,6001,1000.00,4016.92,5016.92,0.00,4016.92,0.06,1
60107,6001,-418.97,3597.95,4597.95,418.97,0.00,0.09,0
60108,6001,1000.00,4597.95,5597.95,0.00,4597.95,0.20,1
60109,6001,1000.00,5597.95,6597.95,1107.44,4490.51,0.27,1
60110,6001,-1000.00,4597.95,5597.95,3755.34,2842.61,0.02,0
60111,6001,-1000.00,3597.95,4597.95,574.87,486.08,0.14,0
60112,6001,-1000.00,2597.95,3597.95,0.00,3744.92,0.23,0
60113,6001,-1000.00,1597.95,2597.95,725.98,2871.97,0.24,0
60114,6001,-1000.00,597.95,1597.95,268.79,2329.16,0.43,0
60115,6001,-1000.00,-402.05,597.95,0.00,1025.79,0.30,0
60116,6001,1000.00,597.95,1597.95,0.00,153.64,0.19,1
60117,6001,1000.00,1597.95,2597.95,0.00,761.20,0.30,1
60118,6001,1000.00,2597.95,3597.95,586.09,2011.86,0.19,1
60119,6001,1000.00,3597.95,4597.95,1718.39,1879.57,0.12,1
60120,6001,1000.00,4597.95,5597.95,0.00,4597.95,0.35,1
60121,6001,1000.00,5597.95,6597.95,0.00,4612.65,0.12,1
60122,6001,-1000.00,4597.95,5597.95,3749.40,2848.55,0.08,0
60123,6001,1000.00,5597.95,6597.95,0.00,5597.95,0.28,1
60124,6001,1000.00,6597.95,7597.95,1553.12,5044.83,0.39,1
60125,6001,1000.00,7597.95,8597.95,2462.99,5134.96,0.32,1
60126,6001,1000.00,8597.95,9597.95,0.00,6012.04,0.07,1
60127,6001,1000.00,9597.95,10597.95,953.61,7570.52,0.41,1
60128,6001,1000.00,10597.95,11597.95,0.00,10597.95,0.34,1
60129,6001,1000.00,11597.95,12597.95,2711.00,8886.95,0.06,1
60130,6001,-1000.00,10597.95,11597.95,6498.67,5272.42,0.19,0
60131,6001,1000.00,11597.95,12597.95,0.00,11597.95,0.12,1
60132,6001,1000.00,12597.95,13597.95,6298.98,6298.98,0.04,1
60133,6001,1000.00,13597.95,14597.95,2366.76,9979.79,0.38,1
60134,6001,1000.00,14597.95,15597.95,0.00,11097.84,0.19,1
60135,6001,1000.00,15597.95,16597.95,0.00,7522.47,0.07,1
60136,6001,1000.00,16597.95,17597.95,0.00,16597.95,0.22,1
60137,6001,1000.00,17597.95,18597.95,4219.93,13378.02,0.06,1
60138,6001,1000.00,18597.95,19597.95,0.00,18597.95,0.08,1
60139,6001,1000.00,19597.95,20597.95,9792.31,9805.64,0.16,1
60140,6002,1000.00,1000.00,2000.00,0.00,1000.00,0.43,1
60141,6002,1000.00,2000.00,3000.00,0.00,1019.41,0.24,1
60142,6002,1000.00,3000.00,4000.00,1265.04,1734.96,0.27,1
60143,6002,1000.00,4000.00,5000.00,0.00,3386.26,0.13,1
60144,6002,1000.00,5000.00,6000.00,2045.26,2954.74,0.23,1
60145,6002,1000.00,6000.00,7000.00,86.19,5913.81,0.25,1
60146,6002,-1000.00,5000.00,6000.00,3606.30,1069.90,0.11,0
60147,6002,1000.00,6000.00,7000.00,0.00,6000.00,0.22,1
60148,6002,1000.00,7000.00,8000.00,0.00,6053.81,0.40,1
60149,6002,1000.00,8000.00,9000.00,0.00,8000.00,0.38,1
60150,6002,1000.00,9000.00,10000.00,0.00,8275.42,0.42,1
60151,6002,0.00,9000.00,10000.00,0.00,0.00,0.01,0
60152,6002,1000.00,10000.00,11000.00,0.00,10000.00,0.31,1
60153,6002,1000.00,11000.00,12000.00,0.00,6847.00,0.36,1
60154,6002,-1000.00,10000.00,11000.00,7154.56,3328.62,0.13,0
60155,6002,1000.00,11000.00,12000.00,5500.00,5500.00,0.05,1
60156,6002,1000.00,12000.00,13000.00,2701.25,3871.59,0.22,1
60157,6002,1000.00,13000.00,14000.00,0.00,13000.00,0.15,1
60158,6002,-1000.00,12000.00,13000.00,8527.97,5472.03,0.11,0
60159,6002,1000.00,13000.00,14000.00,0.00,13000.00,0.13,1
60160,6002,1000.00,14000.00,15000.00,0.00,14000.00,0.37,1
60161,6002,1000.00,15000.00,16000.00,0.00,15000.00,0.27,1
60162,6002,-1000.00,14000.00,15000.00,7958.11,8041.89,0.11,0
60163,6002,-1000.00,13000.00,14000.00,2439.26,12560.74,0.10,0
60164,6002,-1000.00,12000.00,13000.00,1513.46,12486.54,0.42,0
60165,6002,-1000.00,11000.00,12000.00,1314.42,11685.58,0.43,0
60166,6002,-1000.00,10000.00,11000.00,0.00,1795.89,0.12,0
60167,6002,-1000.00,9000.00,10000.00,2041.66,8958.34,0.16,0
60168,6002,-1000.00,8000.00,9000.00,4124.29,5875.71,0.22,0
60169,6002,-1000.00,7000.00,8000.00,0.00,9000.00,0.12,0
60170,6002,-1000.00,6000.00,7000.00,0.00,3438.24,0.27,0
60171,6002,-1000.00,5000.00,6000.00,3500.00,3500.00,0.04,0
60172,6002,-1000.00,4000.00,5000.00,621.21,1485.98,0.20,0
60173,6002,-1000.00,3000.00,4000.00,3550.11,1449.89,0.08,0
60174,6002,-1000.00,2000.00,3000.00,0.00,4000.00,0.35,0
60175,6002,-1000.00,1000.00,2000.00,1374.55,1625.45,0.15,0
60176,6002,-1000.00,0.00,1000.00,748.54,1251.46,0.01,0
60177,6002,-1000.00,-1000.00,0.00,324.66,675.34,0.34,0
60178,6003,1000.00,1000.00,2000.00,0.00,1000.00,0.20,1
60179,6003,1000.00,2000.00,3000.00,413.06,1586.94,0.18,1
60180,6003,1000.00,3000.00,4000.00,280.02,2719.98,0.23,1
60181,6003,1000.00,4000.00,5000.00,161.94,1661.35,0.27,1
60182,6003,-1000.00,3000.00,4000.00,3363.64,1636.36,0.12,0
60183,6003,1000.00,4000.00,5000.00,711.02,3288.98,0.41,1
60184,6003,1000.00,5000.00,6000.00,0.00,154.39,0.08,1
60185,6003,1000.00,6000.00,7000.00,1534.77,2477.45,0.25,1
60186,6003,1000.00,7000.00,8000.00,0.00,5339.85,0.39,1
60187,6003,1000.00,8000.00,9000.00,0.00,4562.75,0.34,1
60188,6003,1000.00,9000.00,10000.00,3123.70,5876.30,0.13,1
60189,6003,1000.00,10000.00,11000.00,0.00,7617.98,0.39,1
60190,6003,-1000.00,9000.00,10000.00,3762.60,1596.90,0.14,0
60191,6003,1000.00,10000.00,11000.00,5000.00,5000.00,0.09,1
60192,6003,1000.00,11000.00,12000.00,2920.42,8079.58,0.34,1
60193,6003,1000.00,12000.00,13000.00,1006.93,10993.07,0.44,1
60194,6003,1000.00,13000.00,14000.00,984.30,12015.70,0.44,1
60195,6003,1000.00,14000.00,15000.00,6213.35,7786.65,0.16,1
60196,6003,0.00,14000.00,15000.00,0.00,0.00,0.01,0
60197,6003,0.00,14000.00,15000.00,0.00,0.00,0.00,0
60198,6003,1000.00,15000.00,16000.00,0.00,15000.00,0.31,1
60199,6003,1000.00,16000.00,17000.00,0.00,10084.92,0.37,1
60200,6003,1000.00,17000.00,18000.00,5406.74,10846.69,0.32,1
60201,6003,1000.00,18000.00,19000.00,8562.10,9437.90,0.13,1
60202,6003,1000.00,19000.00,20000.00,0.00,19000.00,0.37,1
60203,6003,1000.00,20000.00,21000.00,0.00,4991.41,0.15,1
60204,6003,1000.00,21000.00,22000.00,0.00,17382.18,0.42,1
60205,6003,1000.00,22000.00,23000.00,0.00,21141.31,0.16,1
60206,6003,1000.00,23000.00,24000.00,8336.66,14663.34,0.17,1
60207,6003,1000.00,24000.00,25000.00,0.00,12209.16,0.31,1
60208,6003,1000.00,25000.00,26000.00,0.00,25000.00,0.38,1
60209,6003,1000.00,26000.00,27000.00,788.45,25211.55,0.06,1
60210,6003,1000.00,27000.00,28000.00,0.00,27000.00,0.16,1
60211,6003,1000.00,28000.00,29000.00,7685.99,20314.01,0.37,1
60212,6003,1000.00,29000.00,30000.00,0.00,13331.37,0.07,1
60213,6003,1000.00,30000.00,31000.00,2489.71,27510.29,0.24,1
60214,6003,-1000.00,29000.00,30000.00,17272.63,0.00,0.04,0
60215,6003,1000.00,30000.00,31000.00,7260.19,22739.81,0.33,1
60216,6003,1000.00,31000.00,32000.00,0.00,31000.00,0.37,1
60217,6003,1000.00,32000.00,33000.00,1453.40,27618.75,0.43,1
60218,6003,1000.00,33000.00,34000.00,16500.00,16500.00,0.01,1
60219,6004,1000.00,1000.00,2000.00,229.15,770.85,0.38,1
60220,6004,1000.00,2000.00,3000.00,0.00,1269.71,0.11,1
60221,6004,-1000.00,1000.00,2000.00,1510.56,1489.44,0.11,0
60222,6004,1000.00,2000.00,3000.00,0.00,1247.66,0.35,1
60223,6004,1000.00,3000.00,4000.00,896.20,2103.80,0.07,1
60224,6004,-1000.00,2000.00,3000.00,904.73,566.07,0.15,0
60225,6004,1000.00,3000.00,4000.00,1078.50,1921.50,0.29,1
60226,6004,1000.00,4000.00,5000.00,0.00,1137.28,0.03,1
60227,6004,1000.00,5000.00,6000.00,0.00,5000.00,0.16,1
60228,6004,1000.00,6000.00,7000.00,0.00,2318.46,0.18,1
60229,6004,1000.00,7000.00,8000.00,2738.61,4261.39,0.22,1
60230,6004,0.00,7000.00,8000.00,0.00,0.00,0.05,0
60231,6004,1000.00,8000.00,9000.00,0.00,6082.59,0.26,1
60232,6004,1000.00,9000.00,10000.00,0.00,5971.52,0.37,1
60233,6004,1000.00,10000.00,11000.00,0.00,10000.00,0.42,1
60234,6004,1000.00,11000.00,12000.00,0.00,7711.09,0.03,1
60235,6004,1000.00,12000.00,13000.00,6000.00,6000.00,0.04,1
60236,6004,1000.00,13000.00,14000.00,0.00,6264.03,0.06,1
60237,6004,1000.00,14000.00,15000.00,0.00,14000.00,0.42,1
60238,6004,1000.00,15000.00,16000.00,0.00,2760.15,0.17,1
60239,6004,1000.00,16000.00,17000.00,0.00,7399.78,0.20,1
60240,6004,1000.00,17000.00,18000.00,0.00,17000.00,0.22,1
60241,6004,1000.00,18000.00,19000.00,9000.00,9000.00,0.05,1
60242,6004,1000.00,19000.00,20000.00,911.64,18088.36,0.03,1
60243,6004,1000.00,20000.00,21000.00,0.00,15437.90,0.41,1
60244,6004,1000.00,21000.00,22000.00,8306.16,12693.84,0.09,1
60245,6004,1000.00,22000.00,23000.00,10506.43,11493.57,0.07,1
60246,6004,1000.00,23000.00,24000.00,0.00,23000.00,0.20,1
60247,6004,1000.00,24000.00,25000.00,8092.67,15907.33,0.33,1
60248,6004,1000.00,25000.00,26000.00,12500.00,12500.00,0.04,1
60249,6004,1000.00,26000.00,27000.00,0.00,16862.32,0.37,1
60250,6004,1000.00,27000.00,28000.00,0.00,27000.00,0.43,1
60251,6004,1000.00,28000.00,29000.00,9096.36,18903.64,0.13,1
60252,6004,1000.00,29000.00,30000.00,7665.15,21334.85,0.26,1
60253,6004,1000.00,30000.00,31000.00,0.00,30000.00,0.14,1
60254,6004,1000.00,31000.00,32000.00,0.00,25480.70,0.28,1
60255,6004,1000.00,32000.00,33000.00,0.00,32000.00,0.08,1
60256,6004,-1000.00,31000.00,32000.00,17729.52,15270.48,0.16,0
60257,6004,1000.00,32000.00,33000.00,0.00,7139.33,0.19,1
60258,6004,1000.00,33000.00,34000.00,3308.21,29691.79,0.43,1
60259,6005,1000.00,1000.00,2000.00,500.00,500.00,0.02,1
60260,6005,1000.00,2000.00,3000.00,0.00,2000.00,0.03,1
60261,6005,1000.00,3000.00,4000.00,0.00,3000.00,0.43,1
60262,6005,1000.00,4000.00,5000.00,0.00,4000.00,0.42,1
60263,6005,1000.00,5000.00,6000.00,0.00,2024.17,0.17,1
60264,6005,1000.00,6000.00,7000.00,0.00,3542.85,0.08,1
60265,6005,1000.00,7000.00,8000.00,0.00,2465.66,0.22,1
60266,6005,1000.00,8000.00,9000.00,103.71,7896.29,0.39,1
60267,6005,1000.00,9000.00,10000.00,530.89,8469.11,0.40,1
60268,6005,1000.00,10000.00,11000.00,0.00,10000.00,0.24,1
60269,6005,-1000.00,9000.00,10000.00,1278.03,0.00,0.04,0
60270,6005,1000.00,10000.00,11000.00,0.00,9189.39,0.34,1
60271,6005,1000.00,11000.00,12000.00,0.00,11000.00,0.33,1
60272,6005,1000.00,12000.00,13000.00,0.00,12000.00,0.03,1
60273,6005,-1000.00,11000.00,12000.00,10718.33,2281.67,0.03,0
60274,6005,1000.00,12000.00,13000.00,4307.33,7692.67,0.29,1
60275,6005,1000.00,13000.00,14000.00,0.00,4059.79,0.19,1
60276,6005,1000.00,14000.00,15000.00,0.00,11296.09,0.33,1
60277,6005,-1000.00,13000.00,14000.00,12644.32,2355.68,0.01,0
60278,6005,-1000.00,12000.00,13000.00,5992.73,962.18,0.10,0
60279,6005,1000.00,13000.00,14000.00,0.00,10983.35,0.42,1
60280,6005,1000.00,14000.00,15000.00,0.00,12518.66,0.34,1
60281,6005,1000.00,15000.00,16000.00,0.00,15000.00,0.39,1
60282,6005,0.00,15000.00,16000.00,0.00,0.00,0.08,0
60283,6005,1000.00,16000.00,17000.00,0.00,4939.83,0.11,1
60284,6005,1000.00,17000.00,18000.00,8500.00,8500.00,0.02,1
60285,6005,1000.00,18000.00,19000.00,0.00,12316.82,0.27,1
60286,6005,1000.00,19000.00,20000.00,251.10,15617.73,0.42,1
60287,6005,0.00,19000.00,20000.00,0.00,0.00,0.08,0
60288,6005,1000.00,20000.00,21000.00,0.00,6943.47,0.24,1
60289,6005,-1000.00,19000.00,20000.00,17784.10,0.00,0.02,0
60290,6005,1000.00,20000.00,21000.00,0.00,20000.00,0.25,1
60291,6005,1000.00,21000.00,22000.00,4224.60,7167.07,0.23,1
60292,6005,1000.00,22000.00,23000.00,8413.04,13586.96,0.18,1
60293,6005,1000.00,23000.00,24000.00,0.00,20560.96,0.43,1
60294,6005,1000.00,24000.00,25000.00,5731.98,18268.02,0.30,1
60295,6005,1000.00,25000.00,26000.00,0.00,25000.00,0.10,1
60296,6005,1000.00,26000.00,27000.00,11392.41,14607.59,0.15,1
60297,6005,1000.00,27000.00,28000.00,0.00,27000.00,0.06,1
60298,6005,1000.00,28000.00,29000.00,0.00,28000.00,0.19,1
60299,6005,1000.00,29000.00,30000.00,5596.94,23403.06,0.23,1
60300,6005,1000.00,30000.00,31000.00,0.00,30000.00,0.19,1
60301,6005,1000.00,31000.00,32000.00,4532.77,26467.23,0.42,1
60302,6005,1000.00,32000.00,33000.00,16000.00,16000.00,0.01,1
60303,6005,1000.00,33000.00,34000.00,0.00,19370.12,0.06,1
60304,6005,1000.00,34000.00,35000.00,0.00,34000.00,0.26,1
60305,6006,-1000.00,-1000.00,0.00,331.55,623.62,0.25,0
60306,6007,-1000.00,-1000.00,0.00,356.36,643.64,0.26,0
60307,6008,-487.46,-487.46,512.54,21.13,466.33,0.30,0
60308,6008,-78.70,-566.16,433.84,0.00,78.70,0.10,0
60309,6008,-433.84,-1000.00,0.00,0.00,433.84,0.31,0
60310,6009,-1000.00,-1000.00,0.00,0.00,393.11,0.26,0
60311,6010,-1000.00,-1000.00,0.00,256.36,743.64,0.23,0
60312,6011,1000.00,1000.00,2000.00,232.44,767.56,0.37,1
60313,6011,1000.00,2000.00,3000.00,245.55,1754.45,0.24,1
60314,6011,1000.00,3000.00,4000.00,381.41,2618.59,0.39,1
60315,6011,1000.00,4000.00,5000.00,1004.48,2984.45,0.37,1
60316,6011,-968.36,3031.64,4031.64,968.36,0.00,0.04,0
60317,6011,1000.00,4031.64,5031.64,1227.52,2804.11,0.08,1
60318,6011,1000.00,5031.64,6031.64,0.00,5031.64,0.11,1
60319,6011,1000.00,6031.64,7031.64,0.00,6031.64,0.18,1
60320,6011,1000.00,7031.64,8031.64,0.00,7031.64,0.04,1
60321,6011,1000.00,8031.64,9031.64,0.00,7413.55,0.21,1
60322,6011,1000.00,9031.64,10031.64,3125.92,5905.72,0.30,1
60323,6011,1000.00,10031.64,11031.64,0.00,10031.64,0.24,1
60324,6011,1000.00,11031.64,12031.64,0.00,11031.64,0.01,1
60325,6011,1000.00,12031.64,13031.64,0.00,4911.69,0.10,1
60326,6011,-103.57,11928.07,12928.07,103.57,0.00,0.08,0
60327,6011,1000.00,12928.07,13928.07,0.00,12928.07,0.26,1
60328,6011,-1000.00,11928.07,12928.07,11231.54,2696.53,0.02,0
60329,6011,1000.00,12928.07,13928.07,0.00,12928.07,0.41,1
60330,6011,1000.00,13928.07,14928.07,0.00,13928.07,0.29,1
60331,6011,-1000.00,12928.07,13928.07,6693.17,3578.35,0.15,0
60332,6011,1000.00,13928.07,14928.07,0.00,13928.07,0.26,1
60333,6011,1000.00,14928.07,15928.07,7298.56,7629.51,0.20,1
60334,6011,1000.00,15928.07,16928.07,6356.45,9571.62,0.24,1
60335,6011,1000.00,16928.07,17928.07,0.00,16928.07,0.09,1
60336,6011,1000.00,17928.07,18928.07,0.00,981.75,0.05,1
60337,6011,1000.00,18928.07,19928.07,8456.69,10471.38,0.26,1
60338,6011,-1000.00,17928.07,18928.07,11399.75,8528.32,0.02,0
60339,6011,1000.00,18928.07,19928.07,0.00,18928.07,0.40,1
60340,6011,1000.00,19928.07,20928.07,5187.39,14740.68,0.04,1
60341,6011,1000.00,20928.07,21928.07,10464.03,10464.03,0.11,1
60342,6011,1000.00,21928.07,22928.07,7541.76,14386.31,0.23,1
60343,6011,1000.00,22928.07,23928.07,0.00,10017.51,0.21,1
60344,6011,-1000.00,21928.07,22928.07,17730.30,6197.76,0.06,0
60345,6011,1000.00,22928.07,23928.07,9494.28,13433.78,0.19,1
60346,6011,1000.00,23928.07,24928.07,0.00,23862.28,0.29,1
60347,6011,1000.00,24928.07,25928.07,0.00,24928.07,0.26,1
60348,6011,1000.00,25928.07,26928.07,0.00,25928.07,0.25,1
60349,6011,1000.00,26928.07,27928.07,9508.31,17419.76,0.16,1
60350,6011,1000.00,27928.07,28928.07,5546.88,22381.18,0.34,1
60351,6011,1000.00,28928.07,29928.07,0.00,8290.18,0.22,1
60352,6011,1000.00,29928.07,30928.07,8296.87,21631.20,0.21,1
60353,6011,0.00,29928.07,30928.07,0.00,0.00,0.02,0
60354,6011,1000.00,30928.07,31928.07,0.00,20636.37,0.02,1
60355,6011,-1000.00,29928.07,30928.07,20350.34,3486.70,0.08,0
60356,6011,-1000.00,28928.07,29928.07,15464.03,15464.03,0.03,0
60357,6011,-1000.00,27928.07,28928.07,9158.65,20769.42,0.33,0
60358,6011,-1000.00,26928.07,27928.07,0.00,28928.07,0.08,0
60359,6011,-1000.00,25928.07,26928.07,0.00,11714.47,0.28,0
60360,6011,-1000.00,24928.07,25928.07,0.00,26928.07,0.16,0
60361,6011,-1000.00,23928.07,24928.07,9616.59,16311.48,0.09,0
60362,6011,-1000.00,22928.07,23928.07,0.00,24928.07,0.36,0
60363,6011,-1000.00,21928.07,22928.07,0.00,23928.07,0.27,0
60364,6011,-1000.00,20928.07,21928.07,7184.80,15743.27,0.34,0
60365,6011,-1000.00,19928.07,20928.07,0.00,17969.74,0.41,0
60366,6011,-1000.00,18928.07,19928.07,1513.36,16931.15,0.42,0
60367,6011,-1000.00,17928.07,18928.07,3962.17,15965.90,0.11,0
60368,6011,-1000.00,16928.07,17928.07,9464.03,9464.03,0.00,0
60369,6011,-1000.00,15928.07,16928.07,0.00,17928.07,0.20,0
60370,6011,-1000.00,14928.07,15928.07,2049.77,5157.77,0.22,0
60371,6011,-1000.00,13928.07,14928.07,2436.10,12048.01,0.39,0
60372,6011,-1000.00,12928.07,13928.07,6305.91,8622.16,0.27,0
60373,6011,-1000.00,11928.07,12928.07,0.00,13928.07,0.30,0
60374,6011,-1000.00,10928.07,11928.07,186.24,7012.23,0.33,0
60375,6011,-1000.00,9928.07,10928.07,0.00,11928.07,0.38,0
60376,6011,-1000.00,8928.07,9928.07,5132.30,5795.77,0.05,0
60377,6011,-1000.00,7928.07,8928.07,1916.71,8011.36,0.40,0
60378,6011,-1000.00,6928.07,7928.07,156.99,8771.08,0.03,0
60379,6011,-1000.00,5928.07,6928.07,0.00,7610.92,0.09,0
60380,6012,-912.29,-912.29,87.71,0.00,912.29,0.40,0
60381,6012,-87.71,-1000.00,0.00,39.06,48.65,0.25,0
60382,6013,-1000.00,-1000.00,0.00,498.46,501.54,0.07,0
60383,6014,-816.64,-816.64,183.36,816.64,0.00,0.14,0
60384,6014,-637.19,-1453.83,-453.83,0.00,4.76,0.13,0
60385,6015,-1000.00,-1000.00,0.00,521.34,332.99,0.16,0
60386,6016,-1000.00,-1000.00,0.00,613.11,386.89,0.14,0
60387,6017,-1000.00,-1000.00,0.00,0.00,1000.00,0.11,0
60388,6018,1000.00,1000.00,2000.00,219.51,780.49,0.37,1
60389,6018,1000.00,2000.00,3000.00,0.00,2000.00,0.28,1
60390,6018,1000.00,3000.00,4000.00,354.02,2645.98,0.12,1
60391,6018,1000.00,4000.00,5000.00,0.00,4000.00,0.02,1
60392,6018,1000.00,5000.00,6000.00,0.00,5000.00,0.43,1
60393,6018,1000.00,6000.00,7000.00,0.00,6000.00,0.35,1
60394,6018,1000.00,7000.00,8000.00,0.00,7000.00,0.04,1
60395,6018,1000.00,8000.00,9000.00,1474.09,6525.91,0.41,1
60396,6018,1000.00,9000.00,10000.00,0.00,7484.26,0.42,1
60397,6018,-811.75,8188.25,9188.25,811.75,0.00,0.08,0
60398,6018,1000.00,9188.25,10188.25,1826.31,5425.51,0.33,1
60399,6018,1000.00,10188.25,11188.25,0.00,10188.25,0.42,1
60400,6018,1000.00,11188.25,12188.25,5264.34,5923.91,0.09,1
60401,6018,1000.00,12188.25,13188.25,1877.66,10310.59,0.36,1
60402,6018,1000.00,13188.25,14188.25,0.00,8532.72,0.36,1
60403,6018,1000.00,14188.25,15188.25,4033.91,4954.76,0.22,1
60404,6018,0.00,14188.25,15188.25,0.00,0.00,0.03,0
60405,6018,-1000.00,13188.25,14188.25,11858.06,0.00,0.02,0
60406,6018,1000.00,14188.25,15188.25,5021.93,8160.99,0.29,1
60407,6018,1000.00,15188.25,16188.25,0.00,15188.25,0.36,1
60408,6018,1000.00,16188.25,17188.25,5620.68,10567.57,0.23,1
60409,6018,-1000.00,15188.25,16188.25,9935.99,7252.26,0.05,0
60410,6018,1000.00,16188.25,17188.25,0.00,8672.60,0.33,1
60411,6018,-1000.00,15188.25,16188.25,8771.84,8416.42,0.08,0
60412,6018,1000.00,16188.25,17188.25,5730.77,10074.11,0.30,1
60413,6018,0.00,16188.25,17188.25,0.00,0.00,0.08,0
60414,6018,1000.00,17188.25,18188.25,0.00,7790.27,0.14,1
60415,6018,-1000.00,16188.25,17188.25,2441.60,360.56,0.11,0
60416,6018,1000.00,17188.25,18188.25,0.00,17188.25,0.07,1
60417,6018,1000.00,18188.25,19188.25,0.00,13258.51,0.24,1
60418,6018,1000.00,19188.25,20188.25,1189.77,17998.48,0.44,1
60419,6018,1000.00,20188.25,21188.25,1551.46,18636.79,0.14,1
60420,6018,1000.00,21188.25,22188.25,3004.38,18183.87,0.40,1
60421,6018,1000.00,22188.25,23188.25,0.00,13488.58,0.14,1
60422,6018,1000.00,23188.25,24188.25,0.00,9265.95,0.18,1
60423,6018,1000.00,24188.25,25188.25,0.00,17750.40,0.23,1
60424,6018,-1000.00,23188.25,24188.25,14386.04,10802.21,0.13,0
60425,6018,1000.00,24188.25,25188.25,0.00,15030.43,0.30,1
60426,6018,0.00,24188.25,25188.25,0.00,0.00,0.04,0
60427,6019,-1000.00,-1000.00,0.00,0.00,1000.00,0.38,0
60428,6020,-1000.00,-1000.00,0.00,277.69,722.31,0.31,0
60429,6021,0.00,0.00,1000.00,0.00,0.00,0.08,0
60430,6021,-255.00,-255.00,745.00,255.00,0.00,0.22,0
60431,6021,-1000.00,-1255.00,-255.00,74.75,419.66,0.33,0
60432,6022,1000.00,1000.00,2000.00,0.00,1000.00,0.10,1
60433,6022,1000.00,2000.00,3000.00,0.00,2000.00,0.30,1
60434,6022,1000.00,3000.00,4000.00,1188.57,1811.43,0.26,1
60435,6022,1000.00,4000.00,5000.00,520.68,3479.32,0.42,1
60436,6022,-1000.00,3000.00,4000.00,3953.62,1046.38,0.01,0
60437,6022,-1000.00,2000.00,3000.00,2076.72,1923.28,0.15,0
60438,6022,1000.00,3000.00,4000.00,992.64,2007.36,0.33,1
60439,6022,1000.00,4000.00,5000.00,755.69,3244.31,0.09,1
60440,6022,1000.00,5000.00,6000.00,0.00,1974.37,0.25,1
60441,6022,1000.00,6000.00,7000.00,0.00,3154.49,0.31,1
60442,6022,1000.00,7000.00,8000.00,3338.90,3661.10,0.20,1
60443,6022,1000.00,8000.00,9000.00,1976.54,6023.46,0.30,1
60444,6022,1000.00,9000.00,10000.00,0.00,9000.00,0.03,1
60445,6022,1000.00,10000.00,11000.00,0.00,10000.00,0.16,1
60446,6022,1000.00,11000.00,12000.00,0.00,11000.00,0.30,1
60447,6022,1000.00,12000.00,13000.00,4674.04,7325.96,0.23,1
60448,6022,1000.00,13000.00,14000.00,3399.58,9600.42,0.34,1
60449,6022,1000.00,14000.00,15000.00,0.00,14000.00,0.01,1
60450,6022,1000.00,15000.00,16000.00,7500.00,7500.00,0.03,1
60451,6022,1000.00,16000.00,17000.00,4582.04,11417.96,0.36,1
60452,6022,-1000.00,15000.00,16000.00,0.00,10748.16,0.32,0
60453,6022,-1000.00,14000.00,15000.00,0.00,16000.00,0.20,0
60454,6022,-1000.00,13000.00,14000.00,3494.01,8384.67,0.31,0
60455,6022,-1000.00,12000.00,13000.00,6074.29,7925.71,0.26,0
60456,6022,-1000.00,11000.00,12000.00,0.00,13000.00,0.34,0
60457,6022,-1000.00,10000.00,11000.00,1322.29,10677.71,0.43,0
60458,6022,-1000.00,9000.00,10000.00,0.00,11000.00,0.42,0
60459,6022,-1000.00,8000.00,9000.00,10000.00,0.00,0.00,0
60460,6022,-1000.00,7000.00,8000.00,1645.05,5279.05,0.33,0
60461,6022,-1000.00,6000.00,7000.00,4769.23,3230.77,0.02,0
60462,6022,-1000.00,5000.00,6000.00,0.00,7000.00,0.05,0
60463,6022,-1000.00,4000.00,5000.00,0.00,6000.00,0.28,0
60464,6022,-1000.00,3000.00,4000.00,711.46,4288.54,0.42,0
60465,6022,-1000.00,2000.00,3000.00,0.00,3861.34,0.42,0
60466,6022,-1000.00,1000.00,2000.00,0.00,3000.00,0.13,0
60467,6022,-821.15,178.85,1178.85,0.00,821.15,0.16,0
60468,6022,-1000.00,-821.15,178.85,463.96,714.90,0.24,0
60469,6022,-178.85,-1000.00,0.00,0.00,178.85,0.18,0
60470,6023,-1000.00,-1000.00,0.00,113.61,886.39,0.10,0
60471,6024,1000.00,1000.00,2000.00,500.23,0.00,0.03,1
60472,6024,-259.59,740.41,1740.41,0.00,259.59,0.29,0
60473,6024,1000.00,1740.41,2740.41,1494.95,245.46,0.09,1
60474,6024,0.00,1740.41,2740.41,0.00,0.00,0.08,0
60475,6024,-1000.00,740.41,1740.41,0.00,2479.50,0.08,0
60476,6024,-364.31,376.10,1376.10,0.00,364.31,0.13,0
60477,6024,-773.14,-397.05,602.95,0.00,773.14,0.06,0
60478,6024,-305.02,-702.07,297.93,0.00,305.02,0.30,0
60479,6024,-297.93,-1000.00,0.00,95.38,202.55,0.32,0
60480,6025,-422.83,-422.83,577.17,422.83,0.00,0.07,0
60481,6025,1000.00,577.17,1577.17,0.00,415.02,0.20,1
60482,6025,1000.00,1577.17,2577.17,0.00,1577.17,0.35,1
60483,6025,1000.00,2577.17,3577.17,892.88,1684.28,0.28,1
60484,6025,1000.00,3577.17,4577.17,0.00,1601.34,0.03,1
60485,6025,1000.00,4577.17,5577.17,2288.58,2288.58,0.02,1
60486,6025,1000.00,5577.17,6577.17,61.13,5516.03,0.42,1
60487,6025,1000.00,6577.17,7577.17,2132.01,2141.75,0.20,1
60488,6025,1000.00,7577.17,8577.17,2779.14,4798.02,0.30,1
60489,6025,1000.00,8577.17,9577.17,0.00,8577.17,0.37,1
60490,6025,-1000.00,7577.17,8577.17,5850.89,3726.27,0.08,0
60491,6025,1000.00,8577.17,9577.17,3617.22,4959.95,0.02,1
60492,6025,1000.00,9577.17,10577.17,652.89,4262.86,0.29,1
60493,6025,1000.00,10577.17,11577.17,4107.29,6469.87,0.16,1
60494,6025,-1000.00,9577.17,10577.17,4327.58,986.44,0.11,0
60495,6025,1000.00,10577.17,11577.17,0.00,10577.17,0.06,1
60496,6025,1000.00,11577.17,12577.17,875.51,10701.66,0.04,1
60497,6025,1000.00,12577.17,13577.17,4262.86,8314.31,0.31,1
60498,6025,1000.00,13577.17,14577.17,0.00,12678.68,0.39,1
60499,6025,0.00,13577.17,14577.17,0.00,0.00,0.03,0
60500,6025,1000.00,14577.17,15577.17,2690.09,11887.08,0.41,1
60501,6026,-1000.00,-1000.00,0.00,355.17,644.83,0.28,0
60502,6027,-1000.00,-1000.00,0.00,350.54,649.46,0.29,0
60503,6027,-0.00,-1000.00,0.00,0.00,0.00,0.19,0
60504,6027,-0.00,-1000.00,0.00,0.00,0.00,0.37,0
60505,6028,-1000.00,-1000.00,0.00,402.86,597.14,0.03,0
60506,6029,-1000.00,-1000.00,0.00,0.00,1000.00,0.14,0
60507,6030,-1000.00,-1000.00,0.00,606.51,393.49,0.08,0
60508,6031,-1000.00,-1000.00,0.00,0.00,989.81,0.05,0
60509,6032,-983.93,-983.93,16.07,0.00,983.93,0.44,0
60510,6032,-16.07,-1000.00,0.00,3.21,12.86,0.39,0
60511,6033,-856.55,-856.55,143.45,595.43,261.12,0.13,0
60512,6033,1000.00,143.45,1143.45,34.08,109.37,0.33,1
60513,6033,1000.00,1143.45,2143.45,506.40,637.06,0.18,1
60514,6033,1000.00,2143.45,3143.45,0.00,1265.52,0.24,1
60515,6033,-1000.00,1143.45,2143.45,2801.53,341.92,0.00,0
60516,6033,1000.00,2143.45,3143.45,171.17,1972.28,0.37,1
60517,6033,1000.00,3143.45,4143.45,0.00,3143.45,0.31,1
60518,6033,1000.00,4143.45,5143.45,0.00,2831.27,0.22,1
60519,6033,-1000.00,3143.45,4143.45,2692.44,2451.01,0.16,0
60520,6033,1000.00,4143.45,5143.45,0.00,2935.18,0.33,1
60521,6033,-1000.00,3143.45,4143.45,2619.48,2523.97,0.02,0
60522,6033,1000.00,4143.45,5143.45,0.00,4143.45,0.09,1
60523,6033,1000.00,5143.45,6143.45,428.80,4714.65,0.26,1
60524,6033,1000.00,6143.45,7143.45,0.00,920.62,0.16,1
60525,6033,-1000.00,5143.45,6143.45,4276.40,2867.05,0.01,0
60526,6033,1000.00,6143.45,7143.45,0.00,6143.45,0.37,1
60527,6033,1000.00,7143.45,8143.45,336.44,6807.01,0.44,1
60528,6033,1000.00,8143.45,9143.45,0.00,8143.45,0.25,1
60529,6033,1000.00,9143.45,10143.45,0.00,6348.68,0.36,1
60530,6033,1000.00,10143.45,11143.45,3188.77,6954.68,0.35,1
60531,6033,1000.00,11143.45,12143.45,0.00,11143.45,0.30,1
60532,6033,1000.00,12143.45,13143.45,0.00,12143.45,0.09,1
60533,6033,1000.00,13143.45,14143.45,0.00,12236.82,0.02,1
60534,6033,1000.00,14143.45,15143.45,1764.61,12378.84,0.12,1
60535,6033,-1000.00,13143.45,14143.45,0.00,14742.94,0.43,0
60536,6033,-1000.00,12143.45,13143.45,4485.91,9657.55,0.30,0
60537,6033,-1000.00,11143.45,12143.45,0.00,8889.62,0.15,0
60538,6033,-1000.00,10143.45,11143.45,4917.91,7107.47,0.28,0
60539,6033,-1000.00,9143.45,10143.45,4380.08,6763.38,0.16,0
60540,6033,-1000.00,8143.45,9143.45,0.00,6373.50,0.36,0
60541,6033,-1000.00,7143.45,8143.45,4571.73,4571.73,0.06,0
60542,6033,-1000.00,6143.45,7143.45,1731.66,6411.79,0.13,0
60543,6033,-1000.00,5143.45,6143.45,1396.68,5746.78,0.41,0
60544,6033,-1000.00,4143.45,5143.45,1453.61,1060.90,0.16,0
60545,6033,-1000.00,3143.45,4143.45,236.49,3296.87,0.37,0
60546,6033,-581.34,2562.11,3562.11,0.00,581.34,0.13,0
60547,6033,-1000.00,1562.11,2562.11,2715.35,806.84,0.09,0
60548,6033,-1000.00,562.11,1562.11,1044.64,1517.48,0.19,0
60549,6033,-1000.00,-437.89,562.11,94.00,1468.11,0.18,0
60550,6033,-421.61,-859.50,140.50,0.00,421.61,0.13,0
60551,6033,-140.50,-1000.00,0.00,0.00,140.50,0.36,0
60552,6034,-1000.00,-1000.00,0.00,0.00,581.41,0.24,0
60553,6035,-664.61,-664.61,335.39,0.00,664.61,0.04,0
60554,6035,-335.39,-1000.00,0.00,93.68,241.71,0.17,0
60555,6036,-1000.00,-1000.00,0.00,0.00,728.01,0.40,0
60556,6037,-1000.00,-1000.00,0.00,140.96,859.04,0.27,0
60557,6038,-1000.00,-1000.00,0.00,460.47,539.53,0.25,0
60558,6039,-687.11,-687.11,312.89,0.00,687.11,0.21,0
60559,6039,-259.21,-946.32,53.68,21.55,237.67,0.41,0
60560,6039,-1000.00,-1946.32,-946.32,26.86,26.82,0.16,0
60561,6040,-650.28,-650.28,349.72,650.28,0.00,0.25,0
60562,6040,-1000.00,-1650.28,-650.28,122.54,174.21,0.26,0
60563,6041,-1000.00,-1000.00,0.00,509.79,490.21,0.18,0
60564,6042,-1000.00,-1000.00,0.00,868.34,131.66,0.10,0
60565,6042,-0.00,-1000.00,-0.00,0.00,0.00,0.31,0
60566,6043,-1000.00,-1000.00,0.00,0.00,1000.00,0.36,0
60567,6044,-1000.00,-1000.00,0.00,0.00,1000.00,0.36,0
60568,6045,1000.00,1000.00,2000.00,143.45,856.55,0.09,1
60569,6045,1000.00,2000.00,3000.00,474.09,1525.91,0.39,1
60570,6045,1000.00,3000.00,4000.00,0.00,3000.00,0.40,1
60571,6045,1000.00,4000.00,5000.00,0.00,3690.78,0.41,1
60572,6045,1000.00,5000.00,6000.00,0.00,5000.00,0.18,1
60573,6045,1000.00,6000.00,7000.00,0.00,6000.00,0.29,1
60574,6045,1000.00,7000.00,8000.00,2564.50,4435.50,0.27,1
60575,6045,1000.00,8000.00,9000.00,0.00,8000.00,0.35,1
60576,6045,1000.00,9000.00,10000.00,4500.00,4500.00,0.02,1
60577,6045,1000.00,10000.00,11000.00,0.00,10000.00,0.01,1
60578,6045,1000.00,11000.00,12000.00,3603.39,7396.61,0.34,1
60579,6045,1000.00,12000.00,13000.00,0.00,11718.76,0.44,1
60580,6045,-1000.00,11000.00,12000.00,4060.17,8939.83,0.35,0
60581,6045,-1000.00,10000.00,11000.00,0.00,12.44,0.10,0
60582,6045,-1000.00,9000.00,10000.00,2218.02,8781.98,0.14,0
60583,6045,-1000.00,8000.00,9000.00,0.00,10000.00,0.40,0
60584,6045,-1000.00,7000.00,8000.00,2264.72,6735.28,0.26,0
60585,6045,-1000.00,6000.00,7000.00,0.00,8000.00,0.10,0
60586,6045,-1000.00,5000.00,6000.00,0.00,3177.85,0.29,0
60587,6045,-1000.00,4000.00,5000.00,0.00,6000.00,0.15,0
60588,6045,-1000.00,3000.00,4000.00,0.00,5000.00,0.19,0
60589,6045,-1000.00,2000.00,3000.00,833.44,3166.56,0.36,0
60590,6045,-1000.00,1000.00,2000.00,0.00,3000.00,0.04,0
60591,6045,1000.00,2000.00,3000.00,289.08,0.00,0.15,1
60592,6045,-1000.00,1000.00,2000.00,1151.03,1848.97,0.06,0
60593,6045,-1000.00,0.00,1000.00,0.00,1085.35,0.28,0
60594,6045,-1000.00,-1000.00,0.00,273.60,726.40,0.36,0
60595,6046,0.00,0.00,1000.00,0.00,0.00,0.01,0
60596,6046,-402.86,-402.86,597.14,402.86,0.00,0.01,0
60597,6046,1000.00,597.14,1597.14,0.00,597.14,0.14,1
60598,6046,1000.00,1597.14,2597.14,212.37,1384.77,0.29,1
60599,6046,1000.00,2597.14,3597.14,0.00,2597.14,0.11,1
60600,6046,1000.00,3597.14,4597.14,1321.08,2276.06,0.31,1
60601,6046,1000.00,4597.14,5597.14,0.00,4597.14,0.11,1
60602,6046,-1000.00,3597.14,4597.14,2839.24,2757.90,0.21,0
60603,6046,1000.00,4597.14,5597.14,0.00,4597.14,0.06,1
60604,6046,1000.00,5597.14,6597.14,0.00,4832.66,0.33,1
60605,6046,1000.00,6597.14,7597.14,2052.46,4544.68,0.33,1
60606,6046,1000.00,7597.14,8597.14,1515.56,6081.58,0.34,1
60607,6046,1000.00,8597.14,9597.14,3775.54,4193.86,0.23,1
60608,6046,1000.00,9597.14,10597.14,4080.35,5516.78,0.18,1
60609,6046,1000.00,10597.14,11597.14,0.00,10597.14,0.27,1
60610,6046,1000.00,11597.14,12597.14,0.00,5720.62,0.08,1
60611,6046,1000.00,12597.14,13597.14,5532.40,7064.74,0.08,1
60612,6046,1000.00,13597.14,14597.14,0.00,12838.72,0.35,1
60613,6046,1000.00,14597.14,15597.14,4738.20,9858.94,0.28,1
60614,6046,-1000.00,13597.14,14597.14,0.00,15597.14,0.36,0
60615,6046,-1000.00,12597.14,13597.14,0.00,11243.47,0.32,0
60616,6046,-1000.00,11597.14,12597.14,4954.66,8642.48,0.31,0
60617,6046,-1000.00,10597.14,11597.14,0.00,12597.14,0.23,0
60618,6046,-1000.00,9597.14,10597.14,0.00,4581.25,0.25,0
60619,6046,-1000.00,8597.14,9597.14,0.00,7684.20,0.40,0
60620,6046,-1000.00,7597.14,8597.14,1148.59,4859.11,0.31,0
60621,6046,-1000.00,6597.14,7597.14,0.00,8597.14,0.01,0
60622,6046,-1000.00,5597.14,6597.14,3118.22,4478.92,0.23,0
60623,6046,-1000.00,4597.14,5597.14,118.62,0.00,0.09,0
60624,6046,-1000.00,3597.14,4597.14,0.00,2988.29,0.14,0
60625,6046,-1000.00,2597.14,3597.14,1752.68,2844.46,0.04,0
60626,6046,-1000.00,1597.14,2597.14,1346.96,2250.18,0.07,0
60627,6046,-1000.00,597.14,1597.14,1126.04,1471.10,0.26,0
60628,6046,-1000.00,-402.86,597.14,120.48,0.00,0.03,0
60629,6046,-536.77,-939.63,60.37,0.00,536.77,0.40,0
60630,6046,-59.19,-998.83,1.17,0.00,59.19,0.05,0
60631,6046,-33.26,-1032.09,-32.09,0.22,0.00,0.02,0
60632,6047,-1000.00,-1000.00,0.00,357.15,642.85,0.29,0
60633,6048,1000.00,1000.00,2000.00,223.23,221.30,0.39,1
60634,6048,1000.00,2000.00,3000.00,1011.06,988.94,0.09,1
60635,6048,-1000.00,1000.00,2000.00,1391.69,1608.31,0.16,0
60636,6048,1000.00,2000.00,3000.00,1847.18,0.00,0.13,1
60637,6048,1000.00,3000.00,4000.00,1902.50,1097.50,0.05,1
60638,6048,-1000.00,2000.00,3000.00,709.29,3290.71,0.40,0
60639,6048,-1000.00,1000.00,2000.00,1121.52,1878.48,0.07,0
60640,6048,-1000.00,0.00,1000.00,547.99,1452.01,0.07,0
60641,6048,-1000.00,-1000.00,0.00,500.00,500.00,0.11,0
60642,6049,-1000.00,-1000.00,0.00,0.00,1000.00,0.33,0
60643,6050,1000.00,1000.00,2000.00,455.12,103.79,0.33,1
60644,6050,0.00,1000.00,2000.00,0.00,0.00,0.31,0
60645,6050,-1000.00,0.00,1000.00,0.00,2000.00,0.14,0
60646,6050,0.00,0.00,1000.00,0.00,0.00,0.12,0
60647,6050,-917.06,-917.06,82.94,60.73,856.32,0.43,0
60648,6050,-82.94,-1000.00,0.00,0.00,82.94,0.44,0
60649,6051,1000.00,1000.00,2000.00,0.00,790.86,0.07,1
60650,6051,1000.00,2000.00,3000.00,0.00,2000.00,0.05,1
60651,6051,1000.00,3000.00,4000.00,1334.57,1665.43,0.10,1
60652,6051,0.00,3000.00,4000.00,0.00,0.00,0.05,0
60653,6051,1000.00,4000.00,5000.00,0.00,4000.00,0.14,1
60654,6051,1000.00,5000.00,6000.00,954.58,4045.42,0.30,1
60655,6051,1000.00,6000.00,7000.00,0.00,4471.59,0.17,1
60656,6051,1000.00,7000.00,8000.00,1713.69,5286.31,0.36,1
60657,6051,-1000.00,6000.00,7000.00,4088.73,3911.27,0.09,0
60658,6051,-1000.00,5000.00,6000.00,3859.68,3140.32,0.02,0
60659,6051,1000.00,6000.00,7000.00,0.00,6000.00,0.04,1
60660,6051,1000.00,7000.00,8000.00,1302.98,5697.02,0.41,1
60661,6051,-1000.00,6000.00,7000.00,5325.99,2674.01,0.11,0
60662,6051,1000.00,7000.00,8000.00,625.50,6374.50,0.15,1
60663,6051,1000.00,8000.00,9000.00,3387.69,4612.31,0.12,1
60664,6051,1000.00,9000.00,10000.00,1154.67,7845.33,0.43,1
60665,6051,1000.00,10000.00,11000.00,3261.40,6738.60,0.30,1
60666,6051,1000.00,11000.00,12000.00,0.00,2226.73,0.18,1
60667,6051,1000.00,12000.00,13000.00,0.00,12000.00,0.25,1
60668,6051,1000.00,13000.00,14000.00,3040.95,9959.05,0.05,1
60669,6051,1000.00,14000.00,15000.00,5739.23,8260.77,0.15,1
60670,6051,1000.00,15000.00,16000.00,7500.00,7500.00,0.03,1
60671,6051,1000.00,16000.00,17000.00,0.00,2711.48,0.00,1
60672,6051,1000.00,17000.00,18000.00,7037.39,9962.61,0.20,1
60673,6051,1000.00,18000.00,19000.00,0.00,18000.00,0.10,1
60674,6051,1000.00,19000.00,20000.00,3504.68,15495.32,0.27,1
60675,6051,1000.00,20000.00,21000.00,0.00,20000.00,0.37,1
60676,6051,1000.00,21000.00,22000.00,0.00,21000.00,0.13,1
60677,6051,1000.00,22000.00,23000.00,0.00,22000.00,0.42,1
60678,6051,1000.00,23000.00,24000.00,0.00,16293.80,0.25,1
60679,6051,1000.00,24000.00,25000.00,0.00,18459.23,0.39,1
60680,6051,1000.00,25000.00,26000.00,4643.26,20356.74,0.41,1
60681,6051,1000.00,26000.00,27000.00,501.06,10505.77,0.27,1
60682,6051,1000.00,27000.00,28000.00,0.00,23293.92,0.25,1
60683,6051,1000.00,28000.00,29000.00,4180.15,17884.68,0.36,1
60684,6051,1000.00,29000.00,30000.00,5064.70,23935.30,0.32,1
60685,6051,1000.00,30000.00,31000.00,0.00,30000.00,0.09,1
60686,6051,1000.00,31000.00,32000.00,3897.91,27102.09,0.26,1
60687,6051,1000.00,32000.00,33000.00,0.00,32000.00,0.25,1
60688,6051,-1000.00,31000.00,32000.00,27253.96,5746.04,0.04,0
60689,6051,1000.00,32000.00,33000.00,14980.59,17019.41,0.16,1
60690,6051,1000.00,33000.00,34000.00,0.00,31707.96,0.08,1
60691,6051,1000.00,34000.00,35000.00,12567.75,21432.25,0.29,1
60692,6051,1000.00,35000.00,36000.00,17380.56,17619.44,0.13,1
60693,6051,1000.00,36000.00,37000.00,17843.15,18156.85,0.21,1
60694,6051,1000.00,37000.00,38000.00,0.00,37000.00,0.02,1
60695,6051,1000.00,38000.00,39000.00,0.00,38000.00,0.25,1
60696,6051,-1000.00,37000.00,38000.00,0.00,39000.00,0.03,0
60697,6051,-1000.00,36000.00,37000.00,8084.72,29915.28,0.36,0
60698,6051,-1000.00,35000.00,36000.00,0.00,37000.00,0.29,0
60699,6051,-1000.00,34000.00,35000.00,0.00,36000.00,0.19,0
60700,6051,-1000.00,33000.00,34000.00,0.00,35000.00,0.09,0
60701,6051,-1000.00,32000.00,33000.00,17000.00,17000.00,0.06,0
60702,6051,-1000.00,31000.00,32000.00,0.00,26499.59,0.03,0
60703,6051,-1000.00,30000.00,31000.00,12475.08,18309.67,0.28,0
60704,6051,-1000.00,29000.00,30000.00,0.00,31000.00,0.29,0
60705,6051,-1000.00,28000.00,29000.00,4677.32,25322.68,0.33,0
60706,6051,-1000.00,27000.00,28000.00,0.00,29000.00,0.13,0
60707,6051,-1000.00,26000.00,27000.00,15362.30,12637.70,0.15,0
60708,6051,-1000.00,25000.00,26000.00,13500.00,13500.00,0.04,0
60709,6051,-897.29,24102.71,25102.71,0.00,897.29,0.04,0
60710,6051,-1000.00,23102.71,24102.71,0.00,25102.71,0.32,0
60711,6051,-1000.00,22102.71,23102.71,0.00,24102.71,0.09,0
60712,6051,-1000.00,21102.71,22102.71,0.00,17646.68,0.39,0
60713,6051,-1000.00,20102.71,21102.71,0.00,22102.71,0.40,0
60714,6051,-1000.00,19102.71,20102.71,0.00,21102.71,0.35,0
60715,6051,-1000.00,18102.71,19102.71,0.00,18468.75,0.18,0
60716,6051,-1000.00,17102.71,18102.71,0.00,19102.71,0.16,0
60717,6051,-1000.00,16102.71,17102.71,0.00,18102.71,0.06,0
60718,6051,-1000.00,15102.71,16102.71,0.00,15698.85,0.36,0
60719,6052,-1000.00,-1000.00,0.00,561.70,346.01,0.16,0
60720,6053,-1000.00,-1000.00,0.00,734.96,265.04,0.07,0
60721,6054,-139.95,-139.95,860.05,0.00,139.95,0.08,0
60722,6054,1000.00,860.05,1860.05,413.91,176.51,0.30,1
60723,6054,1000.00,1860.05,2860.05,201.22,0.00,0.42,1
60724,6054,-550.70,1309.35,2309.35,0.00,550.70,0.18,0
60725,6054,-1000.00,309.35,1309.35,0.00,2309.35,0.14,0
60726,6054,0.00,309.35,1309.35,0.00,0.00,0.02,0
60727,6054,-876.79,-567.44,432.56,0.00,876.79,0.31,0
60728,6054,1000.00,432.56,1432.56,225.70,0.00,0.03,1
60729,6054,-1000.00,-567.44,432.56,241.27,1191.28,0.02,0
60730,6054,-416.67,-984.11,15.89,0.00,416.67,0.14,0
60731,6054,0.00,-984.11,15.89,0.00,0.00,0.02,0
60732,6054,1000.00,15.89,1015.89,8.08,7.81,0.21,1
60733,6054,-171.31,-155.42,844.58,48.29,123.03,0.44,0
60734,6054,-844.58,-1000.00,0.00,0.00,844.58,0.09,0
60735,6055,-1000.00,-1000.00,0.00,0.00,1000.00,0.02,0
60736,6056,-354.34,-354.34,645.66,0.00,354.34,0.24,0
60737,6056,-567.83,-922.17,77.83,54.24,513.60,0.41,0
60738,6056,-77.83,-1000.00,0.00,32.33,45.50,0.14,0
60739,6057,-1000.00,-1000.00,0.00,0.00,1000.00,0.18,0
60740,6058,-1000.00,-1000.00,0.00,0.00,676.99,0.36,0
60741,6059,1000.00,1000.00,2000.00,300.29,699.71,0.31,1
60742,6059,1000.00,2000.00,3000.00,780.60,1219.40,0.22,1
60743,6059,1000.00,3000.00,4000.00,1417.93,1582.07,0.02,1
60744,6059,1000.00,4000.00,5000.00,1496.26,2503.74,0.27,1
60745,6059,1000.00,5000.00,6000.00,0.00,5000.00,0.37,1
60746,6059,1000.00,6000.00,7000.00,1378.82,4621.18,0.35,1
60747,6059,1000.00,7000.00,8000.00,0.00,6439.35,0.42,1
60748,6059,1000.00,8000.00,9000.00,3797.98,4202.02,0.23,1
60749,6059,1000.00,9000.00,10000.00,4044.39,4955.61,0.16,1
60750,6059,1000.00,10000.00,11000.00,0.00,10000.00,0.05,1
60751,6059,1000.00,11000.00,12000.00,0.00,10321.85,0.06,1
60752,6059,1000.00,12000.00,13000.00,5261.93,6738.07,0.26,1
60753,6059,1000.00,13000.00,14000.00,1827.50,11172.50,0.42,1
60754,6059,1000.00,14000.00,15000.00,0.00,14000.00,0.27,1
60755,6059,-1000.00,13000.00,14000.00,6762.62,5140.64,0.18,0
60756,6059,1000.00,14000.00,15000.00,6882.03,7117.97,0.11,1
60757,6059,1000.00,15000.00,16000.00,7500.00,7500.00,0.00,1
60758,6059,1000.00,16000.00,17000.00,0.00,16000.00,0.31,1
60759,6059,-1000.00,15000.00,16000.00,0.00,17000.00,0.44,0
60760,6059,-1000.00,14000.00,15000.00,0.00,16000.00,0.05,0
60761,6059,-1000.00,13000.00,14000.00,5300.86,9699.14,0.20,0
60762,6059,-1000.00,12000.00,13000.00,0.00,14000.00,0.28,0
60763,6059,-1000.00,11000.00,12000.00,0.00,13000.00,0.07,0
60764,6059,-1000.00,10000.00,11000.00,3029.43,8970.57,0.32,0
60765,6059,-1000.00,9000.00,10000.00,0.00,11000.00,0.31,0
60766,6059,-1000.00,8000.00,9000.00,4997.10,5002.90,0.07,0
60767,6059,-1000.00,7000.00,8000.00,0.00,5648.70,0.27,0
60768,6059,-1000.00,6000.00,7000.00,0.00,4392.09,0.22,0
60769,6059,-1000.00,5000.00,6000.00,1444.64,5555.36,0.39,0
60770,6059,-1000.00,4000.00,5000.00,1189.66,4810.34,0.41,0
60771,6059,-1000.00,3000.00,4000.00,0.00,3880.32,0.37,0
60772,6059,-1000.00,2000.00,3000.00,874.03,3125.97,0.39,0
60773,6059,-1000.00,1000.00,2000.00,0.00,1995.93,0.13,0
60774,6059,-1000.00,0.00,1000.00,1151.81,848.19,0.07,0
60775,6059,-732.39,-732.39,267.61,309.26,423.14,0.24,0
60776,6059,-267.61,-1000.00,0.00,39.55,228.05,0.42,0
60777,6060,-1000.00,-1000.00,0.00,338.14,661.86,0.11,0
60778,6061,-482.30,-482.30,517.70,15.83,466.47,0.32,0
60779,6061,-355.14,-837.44,162.56,0.00,355.14,0.40,0
60780,6061,-162.56,-1000.00,0.00,59.90,102.66,0.14,0
60781,6062,-189.25,-189.25,810.75,189.25,0.00,0.39,0
60782,6062,-1000.00,-1189.25,-189.25,75.99,734.75,0.13,0
60783,6063,1000.00,1000.00,2000.00,563.68,0.00,0.09,1
60784,6063,1000.00,2000.00,3000.00,1980.07,0.00,0.00,1
60785,6063,0.00,2000.00,3000.00,0.00,0.00,0.01,0
60786,6063,-1000.00,1000.00,2000.00,0.00,2446.00,0.37,0
60787,6063,-1000.00,0.00,1000.00,614.60,1111.96,0.31,0
60788,6063,-821.26,-821.26,178.74,188.36,632.91,0.35,0
60789,6063,0.00,-821.26,178.74,0.00,0.00,0.03,0
60790,6063,-97.28,-918.55,81.45,13.08,84.20,0.30,0
60791,6063,1000.00,81.45,1081.45,44.49,36.96,0.15,1
60792,6063,-1000.00,-918.55,81.45,0.00,1081.45,0.05,0
60793,6063,-1.45,-920.00,80.00,0.00,1.45,0.05,0
60794,6063,-80.00,-1000.00,0.00,0.00,80.00,0.33,0
60795,6064,-1000.00,-1000.00,0.00,262.36,737.64,0.30,0
60796,6065,-981.17,-981.17,18.83,0.00,981.17,0.44,0
60797,6065,-2.01,-983.18,16.82,0.00,2.01,0.09,0
60798,6065,-7.08,-990.26,9.74,0.00,7.08,0.26,0
60799,6065,-5.60,-995.86,4.14,0.00,5.60,0.30,0
60800,6065,-4.14,-1000.00,0.00,1.02,3.11,0.36,0
60801,6066,-1000.00,-1000.00,0.00,40.92,51.25,0.44,0
60802,6067,1000.00,1000.00,2000.00,114.95,885.05,0.27,1
60803,6067,-1000.00,0.00,1000.00,1152.69,847.31,0.04,0
60804,6067,1000.00,1000.00,2000.00,172.46,827.54,0.09,1
60805,6067,1000.00,2000.00,3000.00,0.00,1554.02,0.35,1
60806,6067,1000.00,3000.00,4000.00,0.00,2397.10,0.02,1
60807,6067,1000.00,4000.00,5000.00,1483.71,2516.29,0.21,1
60808,6067,1000.00,5000.00,6000.00,0.00,5000.00,0.39,1
60809,6067,1000.00,6000.00,7000.00,0.00,3401.24,0.25,1
60810,6067,1000.00,7000.00,8000.00,0.00,3044.48,0.23,1
60811,6067,1000.00,8000.00,9000.00,3014.08,4985.92,0.30,1
60812,6067,1000.00,9000.00,10000.00,0.00,6892.83,0.41,1
60813,6067,-1000.00,8000.00,9000.00,5583.54,4416.46,0.02,0
60814,6067,1000.00,9000.00,10000.00,1947.05,7052.95,0.01,1
60815,6067,1000.00,10000.00,11000.00,4415.49,5584.51,0.26,1
60816,6067,1000.00,11000.00,12000.00,0.00,11000.00,0.40,1
60817,6067,1000.00,12000.00,13000.00,2982.33,9017.67,0.38,1
60818,6067,1000.00,13000.00,14000.00,0.00,13000.00,0.10,1
60819,6067,1000.00,14000.00,15000.00,0.00,14000.00,0.14,1
60820,6067,1000.00,15000.00,16000.00,0.00,1319.09,0.14,1
60821,6067,1000.00,16000.00,17000.00,0.00,16000.00,0.09,1
60822,6067,1000.00,17000.00,18000.00,8500.00,8500.00,0.05,1
60823,6067,-1000.00,16000.00,17000.00,10180.17,7819.83,0.01,0
60824,6067,-1000.00,15000.00,16000.00,0.00,8307.85,0.30,0
60825,6067,-1000.00,14000.00,15000.00,0.00,7472.37,0.25,0
60826,6067,-1000.00,13000.00,14000.00,4179.45,10820.55,0.34,0
60827,6067,-1000.00,12000.00,13000.00,7086.96,6913.04,0.06,0
60828,6067,-1000.00,11000.00,12000.00,0.00,3108.85,0.19,0
60829,6067,-1000.00,10000.00,11000.00,5408.76,6591.24,0.19,0
60830,6067,-1000.00,9000.00,10000.00,3400.18,7599.82,0.16,0
60831,6067,-1000.00,8000.00,9000.00,0.00,10000.00,0.27,0
60832,6067,-1000.00,7000.00,8000.00,0.00,3482.69,0.20,0
60833,6067,-1000.00,6000.00,7000.00,0.00,8000.00,0.41,0
60834,6067,-1000.00,5000.00,6000.00,0.00,6374.73,0.09,0
60835,6067,-1000.00,4000.00,5000.00,0.00,5659.11,0.36,0
60836,6067,-1000.00,3000.00,4000.00,2500.00,2500.00,0.06,0
60837,6067,-1000.00,2000.00,3000.00,0.00,4000.00,0.02,0
60838,6067,-1000.00,1000.00,2000.00,1500.00,1500.00,0.04,0
60839,6067,-1000.00,0.00,1000.00,0.00,2000.00,0.23,0
60840,6067,-1000.00,-1000.00,0.00,246.39,753.61,0.17,0
60841,6068,-813.46,-813.46,186.54,0.00,813.46,0.13,0
60842,6068,1000.00,186.54,1186.54,82.95,0.00,0.02,1
60843,6068,-1000.00,-813.46,186.54,0.00,1186.54,0.05,0
60844,6068,1000.00,186.54,1186.54,96.93,89.61,0.07,1
60845,6068,-1000.00,-813.46,186.54,0.00,1186.54,0.03,0
60846,6068,-68.17,-881.63,118.37,0.00,68.17,0.22,0
60847,6068,-100.61,-982.24,17.76,32.34,68.26,0.31,0
60848,6068,-17.76,-1000.00,0.00,6.95,10.81,0.29,0
60849,6069,0.00,0.00,1000.00,0.00,0.00,0.10,0
60850,6069,-1000.00,-1000.00,0.00,623.38,376.62,0.13,0
60851,6070,-257.70,-257.70,742.30,257.70,0.00,0.33,0
60852,6070,0.00,-257.70,742.30,0.00,0.00,0.09,0
60853,6070,0.00,-257.70,742.30,0.00,0.00,0.23,0
60854,6070,-1000.00,-1257.70,-257.70,91.75,383.28,0.31,0
60855,6071,-263.45,-263.45,736.55,235.04,28.40,0.11,0
60856,6071,1000.00,736.55,1736.55,0.00,736.55,0.09,1
60857,6071,1000.00,1736.55,2736.55,0.00,1736.55,0.35,1
60858,6071,1000.00,2736.55,3736.55,841.41,1895.14,0.06,1
60859,6071,1000.00,3736.55,4736.55,0.00,740.22,0.13,1
60860,6071,1000.00,4736.55,5736.55,2012.71,2723.84,0.17,1
60861,6071,1000.00,5736.55,6736.55,0.00,5736.55,0.15,1
60862,6071,1000.00,6736.55,7736.55,0.00,6736.55,0.28,1
60863,6071,1000.00,7736.55,8736.55,0.00,7736.55,0.11,1
60864,6071,1000.00,8736.55,9736.55,1701.37,7035.18,0.40,1
60865,6071,1000.00,9736.55,10736.55,4528.77,5207.78,0.08,1
60866,6071,1000.00,10736.55,11736.55,3356.56,7379.99,0.33,1
60867,6071,1000.00,11736.55,12736.55,0.00,10830.34,0.43,1
60868,6071,1000.00,12736.55,13736.55,0.00,8770.98,0.34,1
60869,6071,1000.00,13736.55,14736.55,4541.29,9195.27,0.25,1
60870,6071,1000.00,14736.55,15736.55,5021.87,9714.68,0.33,1
60871,6071,1000.00,15736.55,16736.55,1704.36,14032.20,0.43,1
60872,6071,1000.00,16736.55,17736.55,8368.28,8368.28,0.04,1
60873,6071,1000.00,17736.55,18736.55,0.00,17736.55,0.30,1
60874,6071,1000.00,18736.55,19736.55,0.00,6948.69,0.21,1
60875,6071,1000.00,19736.55,20736.55,8212.21,11524.34,0.11,1
60876,6071,1000.00,20736.55,21736.55,0.00,14953.14,0.30,1
60877,6071,1000.00,21736.55,22736.55,0.00,21736.55,0.17,1
60878,6071,1000.00,22736.55,23736.55,0.00,22736.55,0.12,1
60879,6071,1000.00,23736.55,24736.55,0.00,23233.38,0.36,1
60880,6071,1000.00,24736.55,25736.55,0.00,24736.55,0.01,1
60881,6071,1000.00,25736.55,26736.55,0.00,25520.13,0.33,1
60882,6071,1000.00,26736.55,27736.55,9257.03,17479.52,0.16,1
60883,6071,1000.00,27736.55,28736.55,0.00,27736.55,0.38,1
60884,6071,1000.00,28736.55,29736.55,3416.47,19071.83,0.37,1
60885,6071,1000.00,29736.55,30736.55,11345.98,18390.58,0.17,1
60886,6071,1000.00,30736.55,31736.55,0.00,16870.40,0.28,1
60887,6071,1000.00,31736.55,32736.55,4812.79,26923.76,0.24,1
60888,6071,1000.00,32736.55,33736.55,0.00,32736.55,0.12,1
60889,6071,1000.00,33736.55,34736.55,8795.77,24940.78,0.37,1
60890,6071,1000.00,34736.55,35736.55,0.00,20393.92,0.17,1
60891,6071,1000.00,35736.55,36736.55,16453.86,19282.69,0.22,1
60892,6071,1000.00,36736.55,37736.55,0.00,31457.30,0.21,1
60893,6071,1000.00,37736.55,38736.55,0.00,9749.16,0.20,1
60894,6071,-1000.00,36736.55,37736.55,10364.96,9405.95,0.18,0
60895,6071,1000.00,37736.55,38736.55,0.00,37736.55,0.19,1
60896,6071,0.00,37736.55,38736.55,0.00,0.00,0.01,0
60897,6071,1000.00,38736.55,39736.55,9443.04,29293.51,0.33,1
60898,6072,-1000.00,-1000.00,0.00,0.00,468.49,0.29,0
60899,6073,-1000.00,-1000.00,0.00,0.00,1000.00,0.17,0
60900,6074,-987.17,-987.17,12.83,0.00,987.17,0.07,0
60901,6074,-12.83,-1000.00,0.00,0.00,12.83,0.14,0
60902,6075,0.00,0.00,1000.00,0.00,0.00,0.02,0
60903,6075,0.00,0.00,1000.00,0.00,0.00,0.23,0
60904,6075,-1000.00,-1000.00,0.00,0.00,1000.00,0.42,0
60905,6076,-970.52,-970.52,29.48,0.00,970.52,0.28,0
60906,6076,-16.77,-987.29,12.71,0.00,16.77,0.26,0
60907,6076,-12.71,-1000.00,0.00,4.89,7.82,0.02,0
60908,6077,1000.00,1000.00,2000.00,408.95,591.05,0.20,1
60909,6077,1000.00,2000.00,3000.00,0.00,776.12,0.02,1
60910,6077,1000.00,3000.00,4000.00,0.00,2088.31,0.35,1
60911,6077,1000.00,4000.00,5000.00,0.00,4000.00,0.27,1
60912,6077,1000.00,5000.00,6000.00,0.00,3961.55,0.34,1
60913,6077,1000.00,6000.00,7000.00,0.00,1513.56,0.09,1
60914,6077,1000.00,7000.00,8000.00,463.11,6536.89,0.44,1
60915,6077,-1000.00,6000.00,7000.00,4710.05,3244.10,0.17,0
60916,6077,-1000.00,5000.00,6000.00,6476.86,0.00,0.01,0
60917,6077,1000.00,6000.00,7000.00,1716.94,4283.06,0.36,1
60918,6077,1000.00,7000.00,8000.00,399.58,2753.65,0.26,1
60919,6077,1000.00,8000.00,9000.00,1952.39,6047.61,0.38,1
60920,6077,1000.00,9000.00,10000.00,1788.50,7211.50,0.18,1
60921,6077,1000.00,10000.00,11000.00,2929.28,7070.72,0.36,1
60922,6077,1000.00,11000.00,12000.00,0.00,10185.30,0.24,1
60923,6077,1000.00,12000.00,13000.00,2651.76,8192.41,0.36,1
60924,6077,1000.00,13000.00,14000.00,0.00,11652.92,0.19,1
60925,6077,1000.00,14000.00,15000.00,0.00,6690.81,0.29,1
60926,6077,1000.00,15000.00,16000.00,5497.05,9502.95,0.29,1
60927,6077,-1000.00,14000.00,15000.00,0.00,15659.87,0.25,0
60928,6077,-1000.00,13000.00,14000.00,2991.79,12008.21,0.40,0
60929,6077,-1000.00,12000.00,13000.00,0.00,10091.34,0.39,0
60930,6077,-1000.00,11000.00,12000.00,6500.00,6500.00,0.04,0
60931,6077,-1000.00,10000.00,11000.00,1702.45,10297.55,0.42,0
60932,6077,-827.40,9172.60,10172.60,163.46,663.94,0.13,0
60933,6077,-1000.00,8172.60,9172.60,0.00,7824.88,0.36,0
60934,6077,-1000.00,7172.60,8172.60,2804.25,6368.35,0.33,0
60935,6077,-1000.00,6172.60,7172.60,1358.37,5113.87,0.35,0
60936,6077,-1000.00,5172.60,6172.60,988.68,341.51,0.12,0
60937,6077,-1000.00,4172.60,5172.60,0.00,6172.60,0.03,0
60938,6077,-1000.00,3172.60,4172.60,0.00,5172.60,0.31,0
60939,6077,-1000.00,2172.60,3172.60,0.00,4172.60,0.02,0
60940,6077,-1000.00,1172.60,2172.60,0.00,1461.27,0.24,0
60941,6077,-1000.00,172.60,1172.60,13.35,2159.25,0.19,0
60942,6077,-1000.00,-827.40,172.60,0.00,1172.60,0.08,0
60943,6077,-1000.00,-1827.40,-827.40,136.84,35.76,0.07,0
60944,6078,1000.00,1000.00,2000.00,134.84,865.16,0.40,1
60945,6078,1000.00,2000.00,3000.00,0.00,2000.00,0.34,1
60946,6078,1000.00,3000.00,4000.00,388.90,2611.10,0.43,1
60947,6078,1000.00,4000.00,5000.00,905.33,2953.51,0.37,1
60948,6078,1000.00,5000.00,6000.00,649.61,3841.62,0.40,1
60949,6078,1000.00,6000.00,7000.00,167.46,4638.91,0.41,1
60950,6078,1000.00,7000.00,8000.00,0.00,4380.95,0.34,1
60951,6078,1000.00,8000.00,9000.00,0.00,8000.00,0.02,1
60952,6078,1000.00,9000.00,10000.00,1816.13,4679.29,0.30,1
60953,6078,1000.00,10000.00,11000.00,4403.80,5596.20,0.24,1
60954,6078,1000.00,11000.00,12000.00,0.00,6366.57,0.01,1
60955,6078,-1000.00,10000.00,11000.00,9789.80,0.00,0.02,0
60956,6078,1000.00,11000.00,12000.00,0.00,6765.02,0.22,1
60957,6078,1000.00,12000.00,13000.00,3467.24,8532.76,0.26,1
60958,6078,1000.00,13000.00,14000.00,0.00,13000.00,0.33,1
60959,6078,1000.00,14000.00,15000.00,0.00,12676.99,0.25,1
60960,6078,1000.00,15000.00,16000.00,7500.00,7500.00,0.06,1
60961,6078,1000.00,16000.00,17000.00,0.00,16000.00,0.44,1
60962,6078,1000.00,17000.00,18000.00,7558.78,9441.22,0.03,1
60963,6078,1000.00,18000.00,19000.00,3051.43,14179.07,0.40,1
60964,6078,1000.00,19000.00,20000.00,6310.07,12689.93,0.33,1
60965,6078,1000.00,20000.00,21000.00,3102.92,16897.08,0.37,1
60966,6078,-1000.00,19000.00,20000.00,14266.02,2597.47,0.08,0
60967,6078,1000.00,20000.00,21000.00,0.00,20000.00,0.05,1
60968,6078,-1000.00,19000.00,20000.00,3281.01,13362.73,0.36,0
60969,6078,0.00,19000.00,20000.00,0.00,0.00,0.04,0
60970,6078,0.00,19000.00,20000.00,0.00,0.00,0.05,0
60971,6078,-1000.00,18000.00,19000.00,3898.89,13849.49,0.37,0
60972,6078,0.00,18000.00,19000.00,0.00,0.00,0.02,0
60973,6078,-1000.00,17000.00,18000.00,0.00,19000.00,0.23,0
60974,6078,-1000.00,16000.00,17000.00,0.00,12370.43,0.38,0
60975,6078,-1000.00,15000.00,16000.00,5825.31,8407.82,0.26,0
60976,6078,-1000.00,14000.00,15000.00,5302.05,10697.95,0.30,0
60977,6078,-1000.00,13000.00,14000.00,0.00,15000.00,0.11,0
60978,6078,-1000.00,12000.00,13000.00,440.94,2556.41,0.17,0
60979,6078,0.00,12000.00,13000.00,0.00,0.00,0.11,0
60980,6078,-1000.00,11000.00,12000.00,5184.30,7815.70,0.11,0
60981,6078,-1000.00,10000.00,11000.00,0.00,3717.85,0.02,0
60982,6078,-1000.00,9000.00,10000.00,4366.25,2880.51,0.17,0
60983,6078,-1000.00,8000.00,9000.00,0.00,10000.00,0.21,0
60984,6078,-1000.00,7000.00,8000.00,236.10,8763.90,0.44,0
60985,6078,-1000.00,6000.00,7000.00,2650.03,5349.97,0.08,0
60986,6078,-1000.00,5000.00,6000.00,563.70,4928.34,0.39,0
60987,6078,-1000.00,4000.00,5000.00,3000.00,3000.00,0.07,0
60988,6078,-1000.00,3000.00,4000.00,0.00,5000.00,0.40,0
60989,6079,0.00,0.00,1000.00,0.00,0.00,0.02,0
60990,6079,-1000.00,-1000.00,0.00,378.67,621.33,0.27,0
60991,6080,-1000.00,-1000.00,0.00,49.89,950.11,0.40,0
60992,6080,-0.00,-1000.00,0.00,0.00,0.00,0.41,0
60993,6081,0.00,0.00,1000.00,0.00,0.00,0.40,0
60994,6081,0.00,0.00,1000.00,0.00,0.00,0.40,0
60995,6081,-1000.00,-1000.00,0.00,72.18,927.82,0.26,0
60996,6082,0.00,0.00,1000.00,0.00,0.00,0.38,0
60997,6082,1000.00,1000.00,2000.00,872.78,0.00,0.15,1
60998,6082,-1000.00,0.00,1000.00,0.00,2000.00,0.42,0
60999,6082,0.00,0.00,1000.00,0.00,0.00,0.23,0
61000,6082,-1000.00,-1000.00,0.00,0.00,1000.00,0.04,0
61001,6083,-1000.00,-1000.00,0.00,476.91,523.09,0.14,0
61002,6084,1000.00,1000.00,2000.00,0.00,1000.00,0.28,1
61003,6084,1000.00,2000.00,3000.00,745.56,1200.39,0.29,1
61004,6084,1000.00,3000.00,4000.00,533.62,2442.70,0.40,1
61005,6084,1000.00,4000.00,5000.00,1850.27,2149.73,0.16,1
61006,6084,1000.00,5000.00,6000.00,2046.36,2953.64,0.08,1
61007,6084,1000.00,6000.00,7000.00,0.00,6000.00,0.10,1
61008,6084,1000.00,7000.00,8000.00,1460.50,5539.50,0.27,1
61009,6084,1000.00,8000.00,9000.00,0.00,5627.89,0.33,1
61010,6084,1000.00,9000.00,10000.00,0.00,3985.87,0.10,1
61011,6084,1000.00,10000.00,11000.00,3524.07,6475.93,0.02,1
61012,6084,1000.00,11000.00,12000.00,0.00,9588.26,0.26,1
61013,6084,1000.00,12000.00,13000.00,960.74,9191.87,0.41,1
61014,6084,1000.00,13000.00,14000.00,0.00,13000.00,0.11,1
61015,6084,1000.00,14000.00,15000.00,0.00,14000.00,0.22,1
61016,6084,1000.00,15000.00,16000.00,142.45,14857.55,0.44,1
61017,6084,1000.00,16000.00,17000.00,0.00,16000.00,0.31,1
61018,6084,1000.00,17000.00,18000.00,1030.75,15969.25,0.35,1
61019,6084,1000.00,18000.00,19000.00,2882.67,15117.33,0.40,1
61020,6084,-1000.00,17000.00,18000.00,10754.87,8245.13,0.08,0
61021,6084,1000.00,18000.00,19000.00,0.00,18000.00,0.31,1
61022,6084,1000.00,19000.00,20000.00,0.00,744.35,0.12,1
61023,6084,1000.00,20000.00,21000.00,3549.38,16450.62,0.33,1
61024,6084,1000.00,21000.00,22000.00,3880.60,17119.40,0.16,1
61025,6084,1000.00,22000.00,23000.00,0.00,7577.12,0.23,1
61026,6084,1000.00,23000.00,24000.00,0.00,12447.00,0.23,1
61027,6084,-1000.00,22000.00,23000.00,19398.82,4601.18,0.04,0
61028,6084,-1000.00,21000.00,22000.00,1399.19,21600.81,0.42,0
61029,6084,-1000.00,20000.00,21000.00,0.00,22000.00,0.01,0
61030,6084,-1000.00,19000.00,20000.00,7652.34,13347.66,0.31,0
61031,6084,-1000.00,18000.00,19000.00,0.00,19720.61,0.29,0
61032,6084,-1000.00,17000.00,18000.00,7709.73,0.00,0.34,0
61033,6084,-1000.00,16000.00,17000.00,0.00,16772.20,0.39,0
61034,6084,-1000.00,15000.00,16000.00,0.00,9254.25,0.42,0
61035,6084,-1000.00,14000.00,15000.00,0.00,16000.00,0.38,0
61036,6084,0.00,14000.00,15000.00,0.00,0.00,0.00,0
61037,6084,-1000.00,13000.00,14000.00,183.04,13637.66,0.44,0
61038,6084,-1000.00,12000.00,13000.00,3898.37,10101.63,0.36,0
61039,6084,-1000.00,11000.00,12000.00,0.00,3572.04,0.16,0
61040,6084,-1000.00,10000.00,11000.00,3096.26,8903.74,0.29,0
61041,6084,-1000.00,9000.00,10000.00,0.00,11000.00,0.02,0
61042,6084,-1000.00,8000.00,9000.00,0.00,9311.10,0.10,0
61043,6084,-1000.00,7000.00,8000.00,0.00,2783.68,0.22,0
61044,6084,-1000.00,6000.00,7000.00,0.00,4627.12,0.26,0
61045,6084,-1000.00,5000.00,6000.00,0.00,7000.00,0.13,0
61046,6084,-1000.00,4000.00,5000.00,1701.64,4298.36,0.32,0
61047,6085,1000.00,1000.00,2000.00,563.95,436.05,0.19,1
61048,6085,-1000.00,0.00,1000.00,0.00,1004.90,0.31,0
61049,6085,1000.00,1000.00,2000.00,448.82,226.24,0.15,1
61050,6085,-1000.00,0.00,1000.00,123.93,1876.07,0.07,0
61051,6085,-1000.00,-1000.00,0.00,0.00,1000.00,0.19,0
61052,6086,-785.43,-785.43,214.57,0.00,785.43,0.41,0
61053,6086,-214.57,-1000.00,0.00,0.00,214.57,0.28,0
61054,6087,-1000.00,-1000.00,0.00,0.00,311.87,0.37,0
61055,6088,1000.00,1000.00,2000.00,0.00,1000.00,0.21,1
61056,6088,0.00,1000.00,2000.00,0.00,0.00,0.05,0
61057,6088,1000.00,2000.00,3000.00,0.00,2000.00,0.39,1
61058,6088,1000.00,3000.00,4000.00,0.00,1714.73,0.34,1
61059,6088,1000.00,4000.00,5000.00,930.88,3069.12,0.37,1
61060,6088,1000.00,5000.00,6000.00,0.00,2529.73,0.05,1
61061,6088,-417.28,4582.72,5582.72,417.28,0.00,0.10,0
61062,6088,1000.00,5582.72,6582.72,0.00,5582.72,0.25,1
61063,6088,1000.00,6582.72,7582.72,0.00,6160.99,0.34,1
61064,6088,1000.00,7582.72,8582.72,2549.80,5032.92,0.33,1
61065,6088,1000.00,8582.72,9582.72,0.00,8582.72,0.33,1
61066,6088,1000.00,9582.72,10582.72,545.68,9037.04,0.44,1
61067,6088,-1000.00,8582.72,9582.72,2729.70,1983.69,0.16,0
61068,6088,1000.00,9582.72,10582.72,0.00,9582.72,0.20,1
61069,6088,-1000.00,8582.72,9582.72,4304.85,0.00,0.05,0
61070,6088,-1000.00,7582.72,8582.72,3075.30,1861.24,0.16,0
61071,6088,1000.00,8582.72,9582.72,2816.02,2854.27,0.21,1
61072,6088,0.00,8582.72,9582.72,0.00,0.00,0.05,0
61073,6088,1000.00,9582.72,10582.72,1590.34,7075.36,0.39,1
61074,6088,1000.00,10582.72,11582.72,0.00,7867.97,0.15,1
61075,6088,1000.00,11582.72,12582.72,4245.15,7337.57,0.24,1
61076,6088,1000.00,12582.72,13582.72,6291.36,6291.36,0.06,1
61077,6088,1000.00,13582.72,14582.72,6791.36,6791.36,0.09,1
61078,6088,-1000.00,12582.72,13582.72,568.92,14013.80,0.35,0
61079,6088,-1000.00,11582.72,12582.72,0.00,13582.72,0.43,0
61080,6088,-1000.00,10582.72,11582.72,1155.45,0.00,0.05,0
61081,6088,-1000.00,9582.72,10582.72,908.31,10674.40,0.26,0
61082,6088,-1000.00,8582.72,9582.72,1773.93,8808.79,0.36,0
61083,6088,-1000.00,7582.72,8582.72,777.48,1654.15,0.17,0
61084,6088,-1000.00,6582.72,7582.72,0.00,5025.00,0.32,0
61085,6088,-1000.00,5582.72,6582.72,0.00,5154.97,0.33,0
61086,6088,-1000.00,4582.72,5582.72,1590.16,3637.52,0.31,0
61087,6088,-1000.00,3582.72,4582.72,3007.00,2575.72,0.12,0
61088,6088,-1000.00,2582.72,3582.72,1930.61,2652.11,0.20,0
61089,6088,-1000.00,1582.72,2582.72,1933.38,1649.34,0.15,0
61090,6088,-1000.00,582.72,1582.72,0.00,2582.72,0.23,0
61091,6088,-1000.00,-417.28,582.72,1573.42,0.00,0.03,0
61092,6088,-582.72,-1000.00,0.00,0.00,582.72,0.09,0
61093,6089,-1000.00,-1000.00,0.00,0.00,1000.00,0.41,0
61094,6090,-1000.00,-1000.00,0.00,299.16,700.84,0.35,0
61095,6091,-686.89,-686.89,313.11,0.00,686.89,0.39,0
61096,6091,-313.11,-1000.00,0.00,156.55,156.55,0.01,0
61097,6092,0.00,0.00,1000.00,0.00,0.00,0.26,0
61098,6092,1000.00,1000.00,2000.00,916.54,0.00,0.14,1
61099,6092,-929.01,70.99,1070.99,0.00,929.01,0.26,0
61100,6092,-621.32,-550.33,449.67,226.65,394.67,0.24,0
61101,6092,1000.00,449.67,1449.67,239.45,210.22,0.13,1
61102,6092,-1000.00,-550.33,449.67,466.00,983.67,0.32,0
61103,6092,-441.48,-991.81,8.19,0.00,441.48,0.44,0
61104,6092,-8.19,-1000.00,0.00,0.00,8.19,0.32,0
61105,6093,1000.00,1000.00,2000.00,155.08,0.00,0.39,1
61106,6093,-1000.00,0.00,1000.00,219.12,837.80,0.34,0
61107,6093,0.00,0.00,1000.00,0.00,0.00,0.12,0
61108,6093,1000.00,1000.00,2000.00,1000.00,0.00,0.01,1
61109,6093,-1000.00,0.00,1000.00,0.00,2000.00,0.02,0
61110,6093,-582.32,-582.32,417.68,0.00,582.32,0.22,0
61111,6093,0.00,-582.32,417.68,0.00,0.00,0.38,0
61112,6093,1000.00,417.68,1417.68,255.79,59.47,0.26,1
61113,6093,1000.00,1417.68,2417.68,1247.38,0.00,0.15,1
61114,6093,-379.02,1038.66,2038.66,51.76,327.27,0.43,0
61115,6093,-1000.00,38.66,1038.66,885.54,1153.11,0.21,0
61116,6093,0.00,38.66,1038.66,0.00,0.00,0.24,0
61117,6093,1000.00,1038.66,2038.66,1038.66,0.00,0.00,1
61118,6093,0.00,1038.66,2038.66,0.00,0.00,0.40,0
61119,6093,-1000.00,38.66,1038.66,0.00,2038.66,0.43,0
61120,6093,-49.66,-11.01,988.99,0.00,49.66,0.42,0
61121,6093,-988.99,-1000.00,0.00,0.00,988.99,0.09,0
61122,6094,-802.43,-802.43,197.57,0.00,802.43,0.21,0
61123,6094,-1000.00,-1802.43,-802.43,123.56,74.01,0.14,0
61124,6095,0.00,0.00,1000.00,0.00,0.00,0.13,0
61125,6095,-211.64,-211.64,788.36,211.64,0.00,0.04,0
61126,6095,-1000.00,-1211.64,-211.64,0.00,788.36,0.23,0
61127,6096,-1000.00,-1000.00,0.00,317.70,0.00,0.01,0
61128,6097,-1000.00,-1000.00,0.00,0.00,1000.00,0.04,0
61129,6098,-919.87,-919.87,80.13,919.87,0.00,0.13,0
61130,6098,-1000.00,-1919.87,-919.87,0.00,63.42,0.20,0
61131,6099,-1000.00,-1000.00,0.00,0.00,1000.00,0.20,0
61132,6100,-17.93,-17.93,982.07,17.93,0.00,0.44,0
61133,6100,-730.09,-748.02,251.98,730.09,0.00,0.12,0
61134,6100,1000.00,251.98,1251.98,0.00,135.94,0.01,1
61135,6100,1000.00,1251.98,2251.98,0.00,841.95,0.29,1
61136,6100,1000.00,2251.98,3251.98,663.69,1588.29,0.21,1
61137,6100,1000.00,3251.98,4251.98,1184.53,2067.45,0.31,1
61138,6100,1000.00,4251.98,5251.98,0.00,2075.10,0.19,1
61139,6100,1000.00,5251.98,6251.98,2084.99,3166.99,0.23,1
61140,6100,1000.00,6251.98,7251.98,0.00,6251.98,0.09,1
61141,6100,1000.00,7251.98,8251.98,0.00,6099.74,0.29,1
61142,6100,1000.00,8251.98,9251.98,3757.50,4494.48,0.14,1
61143,6100,1000.00,9251.98,10251.98,3530.02,5721.96,0.05,1
61144,6100,1000.00,10251.98,11251.98,4402.19,5849.79,0.16,1
61145,6100,1000.00,11251.98,12251.98,3980.81,7271.17,0.21,1
61146,6100,1000.00,12251.98,13251.98,1432.91,10819.07,0.43,1
61147,6100,1000.00,13251.98,14251.98,2651.38,10600.60,0.28,1
61148,6100,1000.00,14251.98,15251.98,0.00,12775.50,0.41,1
61149,6100,1000.00,15251.98,16251.98,7625.99,7625.99,0.06,1
61150,6100,-1000.00,14251.98,15251.98,0.00,16251.98,0.43,0
61151,6100,-1000.00,13251.98,14251.98,0.00,2323.26,0.08,0
61152,6100,-1000.00,12251.98,13251.98,5995.75,8256.23,0.27,0
61153,6100,-1000.00,11251.98,12251.98,0.00,13251.98,0.25,0
61154,6100,-1000.00,10251.98,11251.98,8199.11,4052.87,0.06,0
61155,6100,-1000.00,9251.98,10251.98,0.00,11251.98,0.15,0
61156,6100,-1000.00,8251.98,9251.98,1797.37,8454.61,0.39,0
61157,6100,-1000.00,7251.98,8251.98,445.68,7445.72,0.42,0
61158,6100,-1000.00,6251.98,7251.98,3360.89,4891.09,0.22,0
61159,6100,-1000.00,5251.98,6251.98,865.35,6386.63,0.43,0
61160,6100,-1000.00,4251.98,5251.98,0.00,4363.60,0.36,0
61161,6100,-1000.00,3251.98,4251.98,5167.41,84.57,0.03,0
61162,6100,-1000.00,2251.98,3251.98,0.00,4251.98,0.30,0
61163,6100,-1000.00,1251.98,2251.98,1625.99,1625.99,0.09,0
61164,6100,-1000.00,251.98,1251.98,1161.08,1090.90,0.21,0
61165,6100,-305.45,-53.47,946.53,0.00,305.45,0.18,0
61166,6100,-946.53,-1000.00,-0.00,296.97,649.56,0.35,0
61167,6101,-1000.00,-1000.00,0.00,896.80,0.00,0.09,0
61168,6102,-615.66,-615.66,384.34,0.00,615.66,0.29,0
61169,6102,-384.34,-1000.00,0.00,154.62,229.72,0.26,0
61170,6103,1000.00,1000.00,2000.00,0.00,690.26,0.16,1
61171,6103,1000.00,2000.00,3000.00,0.00,926.29,0.38,1
61172,6103,1000.00,3000.00,4000.00,0.00,3000.00,0.05,1
61173,6103,1000.00,4000.00,5000.00,1407.43,2592.57,0.08,1
61174,6103,-1000.00,3000.00,4000.00,1609.25,3390.75,0.33,0
61175,6103,-1000.00,2000.00,3000.00,164.11,2873.66,0.40,0
61176,6103,-1000.00,1000.00,2000.00,0.00,3000.00,0.31,0
61177,6103,-1000.00,0.00,1000.00,0.00,2000.00,0.36,0
61178,6103,-1000.00,-1000.00,0.00,92.79,907.21,0.35,0
61179,6104,1000.00,1000.00,2000.00,274.76,725.24,0.37,1
61180,6104,1000.00,2000.00,3000.00,0.00,1879.87,0.43,1
61181,6104,1000.00,3000.00,4000.00,0.00,2268.07,0.07,1
61182,6104,1000.00,4000.00,5000.00,0.00,1570.35,0.14,1
61183,6104,1000.00,5000.00,6000.00,0.00,4536.57,0.44,1
61184,6104,1000.00,6000.00,7000.00,0.00,6000.00,0.01,1
61185,6104,1000.00,7000.00,8000.00,0.00,7000.00,0.41,1
61186,6104,1000.00,8000.00,9000.00,4000.00,4000.00,0.06,1
61187,6104,1000.00,9000.00,10000.00,2814.28,6185.72,0.33,1
61188,6104,1000.00,10000.00,11000.00,1617.89,8382.11,0.09,1
61189,6104,1000.00,11000.00,12000.00,0.00,983.32,0.08,1
61190,6104,1000.00,12000.00,13000.00,0.00,4356.86,0.25,1
61191,6104,1000.00,13000.00,14000.00,0.00,12332.10,0.31,1
61192,6104,1000.00,14000.00,15000.00,0.00,14000.00,0.13,1
61193,6104,1000.00,15000.00,16000.00,0.00,15000.00,0.19,1
61194,6104,1000.00,16000.00,17000.00,0.00,16000.00,0.20,1
61195,6104,-1000.00,15000.00,16000.00,9089.12,7910.88,0.19,0
61196,6104,1000.00,16000.00,17000.00,0.00,7290.62,0.29,1
61197,6104,1000.00,17000.00,18000.00,0.00,17000.00,0.04,1
61198,6104,1000.00,18000.00,19000.00,9000.00,9000.00,0.04,1
61199,6104,1000.00,19000.00,20000.00,8579.25,10420.75,0.17,1
61200,6104,1000.00,20000.00,21000.00,7532.51,12467.49,0.26,1
61201,6104,1000.00,21000.00,22000.00,0.00,12655.63,0.33,1
61202,6104,1000.00,22000.00,23000.00,0.00,21181.64,0.37,1
61203,6104,1000.00,23000.00,24000.00,5339.94,17660.06,0.33,1
61204,6104,1000.00,24000.00,25000.00,0.00,20891.26,0.24,1
61205,6104,1000.00,25000.00,26000.00,119.72,24880.28,0.44,1
61206,6104,1000.00,26000.00,27000.00,13000.00,13000.00,0.07,1
61207,6104,1000.00,27000.00,28000.00,0.00,4351.36,0.16,1
61208,6104,1000.00,28000.00,29000.00,8198.56,19801.44,0.33,1
61209,6104,-1000.00,27000.00,28000.00,17199.61,11800.39,0.03,0
61210,6104,1000.00,28000.00,29000.00,0.00,9029.69,0.11,1
61211,6104,0.00,28000.00,29000.00,0.00,0.00,0.07,0
61212,6104,1000.00,29000.00,30000.00,0.00,15692.06,0.31,1
61213,6104,1000.00,30000.00,31000.00,15000.00,15000.00,0.04,1
61214,6104,1000.00,31000.00,32000.00,3209.07,27790.93,0.39,1
61215,6104,1000.00,32000.00,33000.00,0.00,21960.55,0.35,1
61216,6104,1000.00,33000.00,34000.00,2108.37,30891.63,0.32,1
61217,6104,1000.00,34000.00,35000.00,0.00,25891.64,0.40,1
61218,6105,1000.00,1000.00,2000.00,0.00,678.55,0.39,1
61219,6105,1000.00,2000.00,3000.00,0.00,1700.70,0.43,1
61220,6105,-264.59,1735.41,2735.41,264.59,0.00,0.00,0
61221,6105,1000.00,2735.41,3735.41,389.93,848.57,0.22,1
61222,6105,1000.00,3735.41,4735.41,0.00,3735.41,0.39,1
61223,6105,1000.00,4735.41,5735.41,2232.15,2503.26,0.21,1
61224,6105,1000.00,5735.41,6735.41,0.00,5491.01,0.44,1
61225,6105,1000.00,6735.41,7735.41,1675.46,5059.95,0.36,1
61226,6105,1000.00,7735.41,8735.41,0.00,7735.41,0.30,1
61227,6105,1000.00,8735.41,9735.41,0.00,8735.41,0.16,1
61228,6105,1000.00,9735.41,10735.41,1759.01,7976.40,0.21,1
61229,6105,1000.00,10735.41,11735.41,5367.70,5367.70,0.09,1
61230,6105,1000.00,11735.41,12735.41,294.51,11440.90,0.25,1
61231,6105,1000.00,12735.41,13735.41,0.00,2303.34,0.12,1
61232,6105,1000.00,13735.41,14735.41,0.00,13735.41,0.44,1
61233,6105,1000.00,14735.41,15735.41,0.00,10880.31,0.31,1
61234,6105,1000.00,15735.41,16735.41,0.00,15735.41,0.44,1
61235,6105,-1000.00,14735.41,15735.41,6390.57,6235.88,0.21,0
61236,6105,1000.00,15735.41,16735.41,3268.18,12467.23,0.27,1
61237,6105,1000.00,16735.41,17735.41,6896.80,9838.60,0.28,1
61238,6105,1000.00,17735.41,18735.41,4079.53,13655.88,0.08,1
61239,6105,-1000.00,16735.41,17735.41,10104.46,3957.70,0.12,0
61240,6105,0.00,16735.41,17735.41,0.00,0.00,0.05,0
61241,6105,1000.00,17735.41,18735.41,0.00,15953.00,0.18,1
61242,6105,1000.00,18735.41,19735.41,0.00,17175.42,0.44,1
61243,6105,1000.00,19735.41,20735.41,6618.23,10333.15,0.28,1
61244,6105,1000.00,20735.41,21735.41,10367.70,10367.70,0.02,1
61245,6105,1000.00,21735.41,22735.41,2661.65,19073.76,0.24,1
61246,6105,1000.00,22735.41,23735.41,0.00,22735.41,0.34,1
61247,6105,1000.00,23735.41,24735.41,5975.40,7659.40,0.21,1
61248,6105,1000.00,24735.41,25735.41,0.00,24735.41,0.37,1
61249,6105,1000.00,25735.41,26735.41,0.00,14823.82,0.22,1
61250,6105,1000.00,26735.41,27735.41,13367.70,13367.70,0.03,1
61251,6105,1000.00,27735.41,28735.41,0.00,27735.41,0.18,1
61252,6105,1000.00,28735.41,29735.41,0.00,19040.84,0.25,1
61253,6105,1000.00,29735.41,30735.41,0.00,26076.62,0.42,1
61254,6105,1000.00,30735.41,31735.41,0.00,30735.41,0.35,1
61255,6105,1000.00,31735.41,32735.41,5868.03,25867.37,0.41,1
61256,6105,1000.00,32735.41,33735.41,0.00,32735.41,0.06,1
61257,6105,1000.00,33735.41,34735.41,0.00,33735.41,0.17,1
61258,6105,1000.00,34735.41,35735.41,658.24,27694.82,0.42,1
61259,6105,1000.00,35735.41,36735.41,6883.73,10474.52,0.21,1
61260,6105,1000.00,36735.41,37735.41,10916.40,25819.01,0.35,1
61261,6105,1000.00,37735.41,38735.41,14497.19,16588.11,0.23,1
61262,6105,1000.00,38735.41,39735.41,3292.21,8218.09,0.18,1
61263,6105,1000.00,39735.41,40735.41,5197.18,34538.23,0.24,1
61264,6105,1000.00,40735.41,41735.41,4899.51,35835.90,0.40,1
61265,6105,-1000.00,39735.41,40735.41,0.00,41735.41,0.21,0
61266,6105,-1000.00,38735.41,39735.41,0.00,40735.41,0.22,0
61267,6105,-1000.00,37735.41,38735.41,23167.24,16568.17,0.01,0
61268,6105,-1000.00,36735.41,37735.41,0.00,38735.41,0.23,0
61269,6105,-1000.00,35735.41,36735.41,652.07,37083.34,0.27,0
61270,6105,-1000.00,34735.41,35735.41,0.00,36735.41,0.26,0
61271,6105,-1000.00,33735.41,34735.41,15949.28,18909.12,0.25,0
61272,6105,-1000.00,32735.41,33735.41,0.00,24850.95,0.31,0
61273,6105,-1000.00,31735.41,32735.41,0.00,33735.41,0.16,0
61274,6105,-1000.00,30735.41,31735.41,15825.46,16909.94,0.04,0
61275,6105,-1000.00,29735.41,30735.41,4578.01,27157.40,0.38,0
61276,6105,-1000.00,28735.41,29735.41,11674.44,5250.03,0.14,0
61277,6105,-1000.00,27735.41,28735.41,2844.80,26890.61,0.43,0
61278,6105,-1000.00,26735.41,27735.41,7370.85,21364.56,0.38,0
61279,6105,-1000.00,25735.41,26735.41,10219.83,17515.57,0.09,0
61280,6105,-1000.00,24735.41,25735.41,0.00,18288.43,0.27,0
61281,6105,-1000.00,23735.41,24735.41,0.00,22581.50,0.13,0
61282,6105,-1000.00,22735.41,23735.41,11082.94,13652.47,0.14,0
61283,6105,-1000.00,21735.41,22735.41,3835.54,4676.73,0.17,0
61284,6105,-1000.00,20735.41,21735.41,0.00,22735.41,0.07,0
61285,6105,-1000.00,19735.41,20735.41,7856.03,13879.38,0.28,0
61286,6105,-1000.00,18735.41,19735.41,4293.29,13075.43,0.34,0
61287,6105,-1000.00,17735.41,18735.41,0.00,11475.63,0.14,0
61288,6105,-1000.00,16735.41,17735.41,6707.51,12027.90,0.13,0
61289,6105,-1000.00,15735.41,16735.41,0.00,17735.41,0.05,0
61290,6105,-1000.00,14735.41,15735.41,0.00,16735.41,0.05,0
61291,6105,-1000.00,13735.41,14735.41,2487.87,12185.76,0.40,0
61292,6105,-1000.00,12735.41,13735.41,0.00,6672.11,0.18,0
61293,6105,-1000.00,11735.41,12735.41,9008.00,2661.06,0.10,0
61294,6105,-1000.00,10735.41,11735.41,0.00,6970.76,0.10,0
61295,6105,-1000.00,9735.41,10735.41,3013.27,8722.14,0.26,0
61296,6105,-1000.00,8735.41,9735.41,0.00,5078.90,0.29,0
61297,6105,-1000.00,7735.41,8735.41,1726.71,829.48,0.13,0
61298,6105,-1000.00,6735.41,7735.41,4435.28,4300.13,0.12,0
61299,6105,-1000.00,5735.41,6735.41,611.20,7124.21,0.01,0
61300,6105,-1000.00,4735.41,5735.41,2401.59,4333.82,0.25,0
61301,6105,-1000.00,3735.41,4735.41,0.00,5576.34,0.14,0
61302,6105,-1000.00,2735.41,3735.41,0.00,4735.41,0.33,0
61303,6105,-1000.00,1735.41,2735.41,1872.77,1862.64,0.21,0
61304,6105,-1000.00,735.41,1735.41,0.00,2146.43,0.23,0
61305,6105,-1000.00,-264.59,735.41,1018.61,716.79,0.10,0
61306,6105,-735.41,-1000.00,0.00,110.24,625.17,0.16,0
61307,6106,-1000.00,-1000.00,0.00,0.00,1000.00,0.37,0
61308,6107,-1000.00,-1000.00,0.00,333.34,666.66,0.18,0
61309,6108,1000.00,1000.00,2000.00,0.00,690.73,0.38,1
61310,6108,0.00,1000.00,2000.00,0.00,0.00,0.04,0
61311,6108,1000.00,2000.00,3000.00,649.30,1350.70,0.26,1
61312,6108,1000.00,3000.00,4000.00,1006.90,1993.10,0.30,1
61313,6108,1000.00,4000.00,5000.00,0.00,4000.00,0.19,1
61314,6108,1000.00,5000.00,6000.00,0.00,2828.28,0.18,1
61315,6108,1000.00,6000.00,7000.00,0.00,6000.00,0.38,1
61316,6108,1000.00,7000.00,8000.00,2325.26,4674.74,0.33,1
61317,6108,1000.00,8000.00,9000.00,2480.43,5519.57,0.27,1
61318,6108,1000.00,9000.00,10000.00,0.00,9000.00,0.11,1
61319,6108,1000.00,10000.00,11000.00,2129.60,3958.91,0.25,1
61320,6108,1000.00,11000.00,12000.00,0.00,11000.00,0.29,1
61321,6108,1000.00,12000.00,13000.00,0.00,3911.75,0.23,1
61322,6108,1000.00,13000.00,14000.00,0.00,10657.11,0.42,1
61323,6108,1000.00,14000.00,15000.00,507.65,13492.35,0.44,1
61324,6108,0.00,14000.00,15000.00,0.00,0.00,0.03,0
61325,6108,1000.00,15000.00,16000.00,4505.79,9677.88,0.33,1
61326,6108,1000.00,16000.00,17000.00,0.00,5559.79,0.22,1
61327,6108,1000.00,17000.00,18000.00,0.00,16046.83,0.19,1
61328,6108,1000.00,18000.00,19000.00,3995.20,12476.11,0.36,1
61329,6108,1000.00,19000.00,20000.00,0.00,9322.89,0.22,1
61330,6108,1000.00,20000.00,21000.00,157.53,11589.04,0.35,1
61331,6108,1000.00,21000.00,22000.00,0.00,15374.66,0.32,1
61332,6108,1000.00,22000.00,23000.00,0.00,22000.00,0.15,1
61333,6108,1000.00,23000.00,24000.00,0.00,8138.36,0.12,1
61334,6108,1000.00,24000.00,25000.00,6650.53,17349.47,0.35,1
61335,6108,1000.00,25000.00,26000.00,4515.31,20484.69,0.30,1
61336,6108,1000.00,26000.00,27000.00,0.00,18535.52,0.06,1
61337,6108,1000.00,27000.00,28000.00,7230.68,19769.32,0.26,1
61338,6108,-1000.00,26000.00,27000.00,14406.87,13593.13,0.03,0
61339,6108,1000.00,27000.00,28000.00,4071.42,22928.58,0.42,1
61340,6108,-1000.00,26000.00,27000.00,18788.79,5891.54,0.10,0
61341,6108,1000.00,27000.00,28000.00,0.00,3012.17,0.13,1
61342,6108,1000.00,28000.00,29000.00,0.00,16475.44,0.29,1
61343,6108,1000.00,29000.00,30000.00,0.00,18907.88,0.04,1
61344,6108,1000.00,30000.00,31000.00,0.00,13802.70,0.27,1
61345,6108,1000.00,31000.00,32000.00,0.00,31000.00,0.05,1
61346,6108,1000.00,32000.00,33000.00,0.00,32000.00,0.19,1
61347,6108,1000.00,33000.00,34000.00,0.00,14147.60,0.28,1
61348,6108,1000.00,34000.00,35000.00,923.00,23022.65,0.38,1
61349,6108,-1000.00,33000.00,34000.00,17764.99,17235.01,0.20,0
61350,6108,1000.00,34000.00,35000.00,480.34,33519.66,0.41,1
61351,6108,1000.00,35000.00,36000.00,13388.23,21611.77,0.25,1
61352,6108,1000.00,36000.00,37000.00,11019.37,24980.63,0.29,1
61353,6108,-1000.00,35000.00,36000.00,19628.46,17371.54,0.07,0
61354,6108,1000.00,36000.00,37000.00,0.00,13422.96,0.13,1
61355,6108,1000.00,37000.00,38000.00,0.00,32168.18,0.41,1
61356,6108,-1000.00,36000.00,37000.00,24227.86,13772.14,0.14,0
61357,6108,1000.00,37000.00,38000.00,0.00,32028.26,0.37,1
61358,6108,1000.00,38000.00,39000.00,14124.59,21216.96,0.28,1
61359,6108,1000.00,39000.00,40000.00,0.00,39000.00,0.23,1
61360,6108,1000.00,40000.00,41000.00,13299.40,26700.60,0.30,1
61361,6108,1000.00,41000.00,42000.00,15490.11,25509.89,0.26,1
61362,6108,1000.00,42000.00,43000.00,7173.66,34826.34,0.37,1
61363,6108,1000.00,43000.00,44000.00,0.00,43000.00,0.19,1
61364,6108,1000.00,44000.00,45000.00,18610.03,25389.97,0.12,1
61365,6108,1000.00,45000.00,46000.00,21570.68,23429.32,0.17,1
61366,6108,1000.00,46000.00,47000.00,0.00,7613.97,0.09,1
61367,6108,1000.00,47000.00,48000.00,0.00,47000.00,0.15,1
61368,6108,-1000.00,46000.00,47000.00,28853.85,19146.15,0.00,0
61369,6108,1000.00,47000.00,48000.00,0.00,47000.00,0.30,1
61370,6108,1000.00,48000.00,49000.00,0.00,1473.84,0.12,1
61371,6108,1000.00,49000.00,50000.00,0.00,49000.00,0.40,1
61372,6108,1000.00,50000.00,51000.00,0.00,50000.00,0.30,1
61373,6108,1000.00,51000.00,52000.00,14285.25,36714.75,0.35,1
61374,6108,1000.00,52000.00,53000.00,0.00,13017.65,0.18,1
61375,6108,-1000.00,51000.00,52000.00,20039.64,10049.50,0.15,0
61376,6108,1000.00,52000.00,53000.00,0.00,13317.61,0.04,1
61377,6108,1000.00,53000.00,54000.00,23228.98,24619.30,0.23,1
61378,6109,-1000.00,-1000.00,0.00,374.38,625.62,0.15,0
61379,6110,-1000.00,-1000.00,0.00,0.00,191.65,0.32,0
61380,6111,-261.97,-261.97,738.03,200.62,61.35,0.42,0
61381,6111,-634.57,-896.53,103.47,537.48,97.08,0.21,0
61382,6111,-1000.00,-1896.53,-896.53,11.80,91.67,0.43,0
61383,6112,-1000.00,-1000.00,0.00,0.00,1000.00,0.38,0
61384,6113,-1000.00,-1000.00,0.00,500.00,500.00,0.01,0
61385,6114,-1000.00,-1000.00,0.00,0.00,799.16,0.39,0
61386,6115,1000.00,1000.00,2000.00,0.00,721.25,0.39,1
61387,6115,1000.00,2000.00,3000.00,0.00,2000.00,0.11,1
61388,6115,1000.00,3000.00,4000.00,1201.83,1798.17,0.22,1
61389,6115,1000.00,4000.00,5000.00,0.00,4000.00,0.20,1
61390,6115,1000.00,5000.00,6000.00,0.00,3879.15,0.23,1
61391,6115,0.00,5000.00,6000.00,0.00,0.00,0.01,0
61392,6115,1000.00,6000.00,7000.00,0.00,6000.00,0.08,1
61393,6115,1000.00,7000.00,8000.00,0.00,7000.00,0.24,1
61394,6115,1000.00,8000.00,9000.00,1434.84,3727.64,0.28,1
61395,6115,1000.00,9000.00,10000.00,0.00,9000.00,0.10,1
61396,6115,1000.00,10000.00,11000.00,0.00,4775.80,0.30,1
61397,6115,1000.00,11000.00,12000.00,0.00,9471.76,0.31,1
61398,6115,1000.00,12000.00,13000.00,1719.32,4648.90,0.26,1
61399,6115,1000.00,13000.00,14000.00,0.00,13000.00,0.07,1
61400,6115,1000.00,14000.00,15000.00,0.00,14000.00,0.20,1
61401,6115,1000.00,15000.00,16000.00,0.00,15000.00,0.25,1
61402,6115,-1000.00,14000.00,15000.00,2000.37,362.22,0.11,0
61403,6115,1000.00,15000.00,16000.00,1559.62,13440.38,0.34,1
61404,6115,1000.00,16000.00,17000.00,3972.91,12027.09,0.35,1
61405,6115,1000.00,17000.00,18000.00,0.00,17000.00,0.19,1
61406,6115,1000.00,18000.00,19000.00,4624.79,13375.21,0.37,1
61407,6115,-1000.00,17000.00,18000.00,8538.62,5558.18,0.17,0
61408,6115,1000.00,18000.00,19000.00,0.00,18000.00,0.05,1
61409,6115,1000.00,19000.00,20000.00,6480.75,12519.25,0.09,1
61410,6115,1000.00,20000.00,21000.00,5021.21,14755.40,0.37,1
61411,6115,1000.00,21000.00,22000.00,9297.83,11702.17,0.25,1
61412,6115,1000.00,22000.00,23000.00,7539.74,14460.26,0.29,1
61413,6115,1000.00,23000.00,24000.00,0.00,13812.25,0.32,1
61414,6115,1000.00,24000.00,25000.00,5307.45,18692.55,0.17,1
61415,6115,1000.00,25000.00,26000.00,0.00,25000.00,0.06,1
61416,6115,1000.00,26000.00,27000.00,13000.00,13000.00,0.07,1
61417,6115,1000.00,27000.00,28000.00,0.00,14075.04,0.28,1
61418,6115,1000.00,28000.00,29000.00,0.00,28000.00,0.01,1
61419,6115,1000.00,29000.00,30000.00,9986.81,19013.19,0.32,1
61420,6115,1000.00,30000.00,31000.00,0.00,26085.99,0.28,1
61421,6115,1000.00,31000.00,32000.00,0.00,31000.00,0.22,1
61422,6115,1000.00,32000.00,33000.00,0.00,32000.00,0.09,1
61423,6115,1000.00,33000.00,34000.00,0.00,33000.00,0.12,1
61424,6115,1000.00,34000.00,35000.00,0.00,34000.00,0.36,1
61425,6115,1000.00,35000.00,36000.00,1855.02,33144.98,0.20,1
61426,6115,1000.00,36000.00,37000.00,0.00,20578.90,0.31,1
61427,6115,1000.00,37000.00,38000.00,9609.68,27390.32,0.35,1
61428,6115,1000.00,38000.00,39000.00,13017.87,13262.98,0.21,1
61429,6115,1000.00,39000.00,40000.00,0.00,39000.00,0.07,1
61430,6115,1000.00,40000.00,41000.00,0.00,35554.41,0.40,1
61431,6115,-1000.00,39000.00,40000.00,0.00,40934.69,0.20,0
61432,6115,-1000.00,38000.00,39000.00,68.08,38171.87,0.44,0
61433,6115,-1000.00,37000.00,38000.00,0.00,34155.39,0.43,0
61434,6115,-1000.00,36000.00,37000.00,17586.53,20413.47,0.01,0
61435,6115,-1000.00,35000.00,36000.00,14476.46,22523.54,0.02,0
61436,6115,-1000.00,34000.00,35000.00,5999.97,5834.40,0.16,0
61437,6115,-1000.00,33000.00,34000.00,0.00,35000.00,0.21,0
61438,6115,-1000.00,32000.00,33000.00,17041.59,16958.41,0.21,0
61439,6115,-1000.00,31000.00,32000.00,0.00,33000.00,0.14,0
61440,6115,-1000.00,30000.00,31000.00,0.00,32000.00,0.04,0
61441,6115,-1000.00,29000.00,30000.00,15166.13,15833.87,0.14,0
61442,6115,-1000.00,28000.00,29000.00,0.00,26995.91,0.35,0
61443,6115,-1000.00,27000.00,28000.00,13599.25,0.00,0.07,0
61444,6115,-1000.00,26000.00,27000.00,6630.25,21369.75,0.36,0
61445,6115,-1000.00,25000.00,26000.00,0.00,27000.00,0.14,0
61446,6115,-1000.00,24000.00,25000.00,14539.99,11460.01,0.17,0
61447,6115,-1000.00,23000.00,24000.00,0.00,25000.00,0.07,0
61448,6115,-1000.00,22000.00,23000.00,1470.68,16438.10,0.38,0
61449,6115,-1000.00,21000.00,22000.00,401.62,22598.38,0.32,0
61450,6116,-1000.00,-1000.00,0.00,253.70,746.30,0.38,0
61451,6117,-515.52,-515.52,484.48,318.32,197.19,0.16,0
61452,6117,1000.00,484.48,1484.48,70.61,413.87,0.00,1
61453,6117,1000.00,1484.48,2484.48,0.00,55.53,0.12,1
61454,6117,1000.00,2484.48,3484.48,0.00,2484.48,0.40,1
61455,6117,1000.00,3484.48,4484.48,0.00,3484.48,0.00,1
61456,6117,1000.00,4484.48,5484.48,749.75,3734.73,0.41,1
61457,6117,1000.00,5484.48,6484.48,0.00,5210.26,0.15,1
61458,6117,1000.00,6484.48,7484.48,877.46,5607.03,0.43,1
61459,6117,1000.00,7484.48,8484.48,0.00,1601.82,0.14,1
61460,6117,1000.00,8484.48,9484.48,1458.42,7026.06,0.34,1
61461,6117,-1000.00,7484.48,8484.48,5763.79,3720.70,0.05,0
61462,6117,1000.00,8484.48,9484.48,0.00,8316.32,0.04,1
61463,6117,1000.00,9484.48,10484.48,0.00,9484.48,0.08,1
61464,6117,1000.00,10484.48,11484.48,0.00,4739.31,0.19,1
61465,6117,1000.00,11484.48,12484.48,2834.32,8650.16,0.24,1
61466,6117,1000.00,12484.48,13484.48,0.00,12484.48,0.25,1
61467,6117,1000.00,13484.48,14484.48,5529.57,7954.91,0.25,1
61468,6117,-1000.00,12484.48,13484.48,9453.56,5030.93,0.10,0
61469,6117,1000.00,13484.48,14484.48,0.00,9403.40,0.28,1
61470,6117,1000.00,14484.48,15484.48,5019.52,9464.96,0.22,1
61471,6117,1000.00,15484.48,16484.48,4291.03,11193.45,0.36,1
61472,6117,1000.00,16484.48,17484.48,0.00,14505.09,0.39,1
61473,6117,1000.00,17484.48,18484.48,8262.97,9221.52,0.22,1
61474,6117,1000.00,18484.48,19484.48,5741.88,12742.61,0.03,1
61475,6117,1000.00,19484.48,20484.48,0.00,15384.60,0.41,1
61476,6117,1000.00,20484.48,21484.48,0.00,15014.19,0.34,1
61477,6117,1000.00,21484.48,22484.48,6140.54,11269.51,0.29,1
61478,6117,1000.00,22484.48,23484.48,0.00,22484.48,0.42,1
61479,6117,1000.00,23484.48,24484.48,11311.57,12172.91,0.21,1
61480,6117,1000.00,24484.48,25484.48,0.00,24484.48,0.21,1
61481,6117,1000.00,25484.48,26484.48,5507.35,5958.77,0.18,1
61482,6117,1000.00,26484.48,27484.48,11344.37,15140.12,0.24,1
61483,6117,0.00,26484.48,27484.48,0.00,0.00,0.06,0
61484,6117,1000.00,27484.48,28484.48,11932.83,15551.65,0.19,1
61485,6117,-1000.00,26484.48,27484.48,16341.01,12143.47,0.12,0
61486,6117,1000.00,27484.48,28484.48,0.00,27484.48,0.17,1
61487,6117,1000.00,28484.48,29484.48,0.00,19652.74,0.31,1
61488,6117,1000.00,29484.48,30484.48,0.00,29484.48,0.28,1
61489,6117,0.00,29484.48,30484.48,0.00,0.00,0.08,0
61490,6117,1000.00,30484.48,31484.48,0.00,26893.35,0.38,1
61491,6117,1000.00,31484.48,32484.48,11078.84,20405.64,0.16,1
61492,6118,-1000.00,-1000.00,0.00,93.83,906.17,0.38,0
61493,6119,-1000.00,-1000.00,0.00,441.22,558.78,0.13,0
61494,6120,-931.96,-931.96,68.04,0.00,931.96,0.09,0
61495,6120,-57.93,-989.89,10.11,2.92,55.01,0.42,0
61496,6120,-10.11,-1000.00,0.00,0.00,10.11,0.19,0
61497,6121,-477.87,-477.87,522.13,0.00,477.87,0.30,0
61498,6121,-450.74,-928.61,71.39,0.00,450.74,0.43,0
61499,6121,-71.39,-1000.00,0.00,2.59,68.80,0.44,0
61500,6122,-1000.00,-1000.00,0.00,0.00,1000.00,0.17,0
61501,6123,-1000.00,-1000.00,0.00,1000.00,0.00,0.01,0
61502,6124,-742.72,-742.72,257.28,9.69,733.03,0.40,0
61503,6124,-257.28,-1000.00,0.00,89.59,167.69,0.32,0
61504,6125,1000.00,1000.00,2000.00,464.39,535.61,0.15,1
61505,6125,1000.00,2000.00,3000.00,821.75,1178.25,0.21,1
61506,6125,1000.00,3000.00,4000.00,176.41,1487.85,0.31,1
61507,6125,1000.00,4000.00,5000.00,822.50,1303.35,0.22,1
61508,6125,1000.00,5000.00,6000.00,1576.57,2179.08,0.25,1
61509,6125,1000.00,6000.00,7000.00,0.00,6000.00,0.03,1
61510,6125,1000.00,7000.00,8000.00,2853.81,4146.19,0.04,1
61511,6125,1000.00,8000.00,9000.00,1666.98,6333.02,0.40,1
61512,6125,1000.00,9000.00,10000.00,1018.19,7981.81,0.41,1
61513,6125,1000.00,10000.00,11000.00,3398.76,6601.24,0.33,1
61514,6125,1000.00,11000.00,12000.00,0.00,7926.27,0.17,1
61515,6125,-1000.00,10000.00,11000.00,1733.85,1726.43,0.16,0
61516,6125,1000.00,11000.00,12000.00,1981.76,7910.20,0.38,1
61517,6125,1000.00,12000.00,13000.00,0.00,8345.04,0.33,1
61518,6125,1000.00,13000.00,14000.00,6071.51,6928.49,0.24,1
61519,6125,1000.00,14000.00,15000.00,5758.85,8241.15,0.22,1
61520,6125,1000.00,15000.00,16000.00,2019.41,2769.27,0.17,1
61521,6125,1000.00,16000.00,17000.00,0.00,12285.49,0.30,1
61522,6125,1000.00,17000.00,18000.00,8085.40,8914.60,0.14,1
61523,6125,1000.00,18000.00,19000.00,7021.43,10978.57,0.30,1
61524,6125,1000.00,19000.00,20000.00,0.00,8358.59,0.24,1
61525,6125,1000.00,20000.00,21000.00,994.38,19005.62,0.40,1
61526,6125,1000.00,21000.00,22000.00,3331.88,16125.80,0.40,1
61527,6125,1000.00,22000.00,23000.00,7906.99,14093.01,0.28,1
61528,6125,1000.00,23000.00,24000.00,0.00,23000.00,0.19,1
61529,6125,1000.00,24000.00,25000.00,1122.40,19811.38,0.42,1
61530,6125,1000.00,25000.00,26000.00,0.00,25000.00,0.03,1
61531,6125,1000.00,26000.00,27000.00,0.00,8525.24,0.06,1
61532,6125,1000.00,27000.00,28000.00,11608.45,15391.55,0.27,1
61533,6125,1000.00,28000.00,29000.00,12988.83,15011.17,0.05,1
61534,6125,1000.00,29000.00,30000.00,9460.21,19539.79,0.10,1
61535,6125,1000.00,30000.00,31000.00,0.00,23020.84,0.28,1
61536,6125,1000.00,31000.00,32000.00,10438.98,20561.02,0.21,1
61537,6125,1000.00,32000.00,33000.00,0.00,32000.00,0.08,1
61538,6125,1000.00,33000.00,34000.00,0.00,24716.45,0.10,1
61539,6125,1000.00,34000.00,35000.00,0.00,34000.00,0.15,1
61540,6125,-1000.00,33000.00,34000.00,17844.96,17155.04,0.17,0
61541,6126,1000.00,1000.00,2000.00,544.12,455.88,0.13,1
61542,6126,-843.10,156.90,1156.90,0.00,843.10,0.34,0
61543,6126,-757.66,-600.76,399.24,370.09,387.57,0.34,0
61544,6126,-17.74,-618.50,381.50,0.00,17.74,0.29,0
61545,6126,-381.50,-1000.00,0.00,0.00,381.50,0.14,0
61546,6127,-520.35,-520.35,479.65,13.03,507.32,0.32,0
61547,6127,-479.65,-1000.00,0.00,0.00,479.65,0.11,0
61548,6128,-1000.00,-1000.00,0.00,243.64,756.36,0.36,0
61549,6129,0.00,0.00,1000.00,0.00,0.00,0.41,0
61550,6129,-1000.00,-1000.00,0.00,0.00,403.98,0.16,0
61551,6130,-1000.00,-1000.00,0.00,0.00,1000.00,0.24,0
61552,6131,-1000.00,-1000.00,0.00,0.00,1000.00,0.13,0
61553,6132,1000.00,1000.00,2000.00,122.30,877.70,0.26,1
61554,6132,1000.00,2000.00,3000.00,0.00,2000.00,0.43,1
61555,6132,1000.00,3000.00,4000.00,271.52,2728.48,0.36,1
61556,6132,1000.00,4000.00,5000.00,0.00,4000.00,0.23,1
61557,6132,1000.00,5000.00,6000.00,0.00,5000.00,0.37,1
61558,6132,1000.00,6000.00,7000.00,0.00,6000.00,0.31,1
61559,6132,1000.00,7000.00,8000.00,2756.89,4243.11,0.03,1
61560,6132,1000.00,8000.00,9000.00,3031.83,4968.17,0.30,1
61561,6132,1000.00,9000.00,10000.00,1223.15,7023.72,0.40,1
61562,6132,1000.00,10000.00,11000.00,0.00,8723.21,0.15,1
61563,6132,1000.00,11000.00,12000.00,1386.56,9613.44,0.29,1
61564,6132,1000.00,12000.00,13000.00,4186.39,7813.61,0.27,1
61565,6132,1000.00,13000.00,14000.00,0.00,3626.84,0.09,1
61566,6132,-1000.00,12000.00,13000.00,10310.27,3689.73,0.02,0
61567,6132,1000.00,13000.00,14000.00,0.00,13000.00,0.42,1
61568,6132,1000.00,14000.00,15000.00,0.00,12249.81,0.39,1
61569,6132,1000.00,15000.00,16000.00,0.00,15000.00,0.39,1
61570,6132,1000.00,16000.00,17000.00,0.00,16000.00,0.14,1
61571,6132,1000.00,17000.00,18000.00,4149.84,12850.16,0.37,1
61572,6132,1000.00,18000.00,19000.00,0.00,2259.64,0.14,1
61573,6132,1000.00,19000.00,20000.00,0.00,16817.33,0.38,1
61574,6132,1000.00,20000.00,21000.00,0.00,12722.92,0.31,1
61575,6132,1000.00,21000.00,22000.00,0.00,21000.00,0.15,1
61576,6132,1000.00,22000.00,23000.00,2799.31,19200.69,0.24,1
61577,6132,-1000.00,21000.00,22000.00,0.00,23000.00,0.03,0
61578,6132,-1000.00,20000.00,21000.00,7310.25,14689.75,0.10,0
61579,6132,-1000.00,19000.00,20000.00,6256.78,14743.22,0.35,0
61580,6132,-1000.00,18000.00,19000.00,0.00,15685.23,0.23,0
61581,6132,-1000.00,17000.00,18000.00,0.00,16818.11,0.12,0
61582,6132,0.00,17000.00,18000.00,0.00,0.00,0.10,0
61583,6132,-1000.00,16000.00,17000.00,8045.88,9954.12,0.24,0
61584,6132,-1000.00,15000.00,16000.00,0.00,17000.00,0.08,0
61585,6132,-1000.00,14000.00,15000.00,0.00,11498.29,0.26,0
61586,6132,-1000.00,13000.00,14000.00,6763.86,8236.14,0.22,0
61587,6132,-1000.00,12000.00,13000.00,0.00,8871.40,0.21,0
61588,6132,-1000.00,11000.00,12000.00,534.52,12465.48,0.30,0
61589,6132,-1000.00,10000.00,11000.00,0.00,12000.00,0.26,0
61590,6132,-1000.00,9000.00,10000.00,4602.60,6397.40,0.21,0
61591,6132,-1000.00,8000.00,9000.00,0.00,10000.00,0.08,0
61592,6132,-1000.00,7000.00,8000.00,0.00,4773.21,0.16,0
61593,6132,-1000.00,6000.00,7000.00,0.00,5621.06,0.33,0
61594,6132,-1000.00,5000.00,6000.00,0.00,7000.00,0.14,0
61595,6132,-1000.00,4000.00,5000.00,403.01,5596.99,0.10,0
61596,6132,0.00,4000.00,5000.00,0.00,0.00,0.07,0
61597,6132,-1000.00,3000.00,4000.00,0.00,5000.00,0.26,0
61598,6132,-1000.00,2000.00,3000.00,480.07,2949.20,0.39,0
61599,6132,-1000.00,1000.00,2000.00,766.48,2233.52,0.27,0
61600,6132,-1000.00,0.00,1000.00,588.93,1156.93,0.31,0
61601,6132,-1000.00,-1000.00,0.00,476.44,271.13,0.15,0
61602,6133,-808.03,-808.03,191.97,461.85,346.18,0.18,0
61603,6133,-1000.00,-1808.03,-808.03,75.10,116.87,0.23,0
61604,6134,-1000.00,-1000.00,0.00,231.13,768.87,0.18,0
61605,6135,-1000.00,-1000.00,0.00,316.18,683.82,0.32,0
61606,6136,0.00,0.00,1000.00,0.00,0.00,0.12,0
61607,6136,1000.00,1000.00,2000.00,75.89,0.00,0.33,1
61608,6136,-1000.00,0.00,1000.00,0.00,2000.00,0.43,0
61609,6136,-1000.00,-1000.00,0.00,0.00,1000.00,0.04,0
61610,6137,0.00,0.00,1000.00,0.00,0.00,0.27,0
61611,6137,-1000.00,-1000.00,0.00,184.43,563.33,0.34,0
61612,6138,-1000.00,-1000.00,0.00,565.16,434.84,0.05,0
61613,6139,-1000.00,-1000.00,0.00,519.40,480.60,0.03,0
61614,6140,1000.00,1000.00,2000.00,0.00,1000.00,0.30,1
61615,6140,1000.00,2000.00,3000.00,1000.00,1000.00,0.03,1
61616,6140,1000.00,3000.00,4000.00,0.00,3000.00,0.28,1
61617,6140,1000.00,4000.00,5000.00,1372.06,2627.94,0.28,1
61618,6140,1000.00,5000.00,6000.00,0.00,5000.00,0.18,1
61619,6140,0.00,5000.00,6000.00,0.00,0.00,0.02,0
61620,6140,-1000.00,4000.00,5000.00,0.00,5606.19,0.43,0
61621,6140,-1000.00,3000.00,4000.00,0.00,5000.00,0.19,0
61622,6140,-1000.00,2000.00,3000.00,476.06,3523.94,0.43,0
61623,6140,-1000.00,1000.00,2000.00,283.70,614.39,0.18,0
61624,6140,-1000.00,0.00,1000.00,544.99,1455.01,0.30,0
61625,6140,-1000.00,-1000.00,0.00,0.00,1000.00,0.40,0
61626,6141,0.00,0.00,1000.00,0.00,0.00,0.42,0
61627,6141,0.00,0.00,1000.00,0.00,0.00,0.09,0
61628,6141,-1000.00,-1000.00,0.00,0.00,1000.00,0.21,0
61629,6142,-1000.00,-1000.00,0.00,742.90,0.00,0.11,0
61630,6143,-1000.00,-1000.00,0.00,0.00,1000.00,0.28,0
61631,6144,-1000.00,-1000.00,0.00,372.01,627.99,0.18,0
61632,6145,-1000.00,-1000.00,0.00,149.77,0.00,0.07,0
61633,6146,-1000.00,-1000.00,0.00,523.14,476.86,0.00,0
61634,6147,-1000.00,-1000.00,0.00,0.00,1000.00,0.12,0
61635,6148,-1000.00,-1000.00,0.00,345.55,654.45,0.14,0
61636,6149,1000.00,1000.00,2000.00,0.00,1000.00,0.30,1
61637,6149,-1000.00,0.00,1000.00,940.54,693.02,0.18,0
61638,6149,1000.00,1000.00,2000.00,0.00,1000.00,0.40,1
61639,6149,1000.00,2000.00,3000.00,0.00,2000.00,0.07,1
61640,6149,1000.00,3000.00,4000.00,0.00,2634.01,0.29,1
61641,6149,1000.00,4000.00,5000.00,0.00,1362.87,0.01,1
61642,6149,1000.00,5000.00,6000.00,2388.66,2611.34,0.17,1
61643,6149,1000.00,6000.00,7000.00,913.76,2760.14,0.29,1
61644,6149,1000.00,7000.00,8000.00,0.00,5756.04,0.02,1
61645,6149,1000.00,8000.00,9000.00,0.00,8000.00,0.26,1
61646,6149,1000.00,9000.00,10000.00,2356.35,6643.65,0.29,1
61647,6149,-1000.00,8000.00,9000.00,2108.63,0.00,0.02,0
61648,6149,1000.00,9000.00,10000.00,3496.53,5503.47,0.28,1
61649,6149,1000.00,10000.00,11000.00,0.00,10000.00,0.03,1
61650,6149,1000.00,11000.00,12000.00,0.00,7462.23,0.23,1
61651,6149,1000.00,12000.00,13000.00,0.00,12000.00,0.15,1
61652,6149,-1000.00,11000.00,12000.00,7529.08,1987.95,0.10,0
61653,6149,-1000.00,10000.00,11000.00,6984.68,5015.32,0.16,0
61654,6149,1000.00,11000.00,12000.00,0.00,4788.64,0.18,1
61655,6149,-1000.00,10000.00,11000.00,6000.00,6000.00,0.05,0
61656,6149,0.00,10000.00,11000.00,0.00,0.00,0.06,0
61657,6149,-1000.00,9000.00,10000.00,1759.47,3610.31,0.23,0
61658,6149,-1000.00,8000.00,9000.00,0.00,4759.49,0.29,0
61659,6149,-1000.00,7000.00,8000.00,5388.57,149.06,0.07,0
61660,6149,-1000.00,6000.00,7000.00,4000.00,4000.00,0.03,0
61661,6149,-1000.00,5000.00,6000.00,2936.32,1817.69,0.16,0
61662,6149,-1000.00,4000.00,5000.00,0.00,6000.00,0.22,0
61663,6149,-1000.00,3000.00,4000.00,0.00,2973.91,0.23,0
61664,6149,-1000.00,2000.00,3000.00,1988.42,0.00,0.05,0
61665,6149,-1000.00,1000.00,2000.00,0.00,3000.00,0.21,0
61666,6149,-1000.00,0.00,1000.00,0.00,1199.01,0.34,0
61667,6149,-964.42,-964.42,35.58,345.91,618.50,0.31,0
61668,6149,-35.58,-1000.00,0.00,0.00,35.58,0.21,0
61669,6150,-1000.00,-1000.00,0.00,0.00,1000.00,0.06,0
61670,6151,1000.00,1000.00,2000.00,712.95,287.05,0.16,1
61671,6151,-1000.00,0.00,1000.00,986.91,1013.09,0.22,0
61672,6151,-1000.00,-1000.00,0.00,0.00,1000.00,0.25,0
61673,6152,-13.55,-13.55,986.45,0.00,13.55,0.44,0
61674,6152,1000.00,986.45,1986.45,864.20,0.00,0.12,1
61675,6152,-872.25,114.20,1114.20,0.00,872.25,0.20,0
61676,6152,1000.00,1114.20,2114.20,142.29,0.00,0.16,1
61677,6152,1000.00,2114.20,3114.20,1292.10,822.11,0.07,1
61678,6152,-428.71,1685.49,2685.49,0.00,428.71,0.16,0
61679,6152,-1000.00,685.49,1685.49,1172.65,1512.84,0.19,0
61680,6152,0.00,685.49,1685.49,0.00,0.00,0.11,0
61681,6152,0.00,685.49,1685.49,0.00,0.00,0.00,0
61682,6152,-1000.00,-314.51,685.49,125.75,1559.74,0.44,0
61683,6152,0.00,-314.51,685.49,0.00,0.00,0.00,0
61684,6152,-427.17,-741.68,258.32,0.00,427.17,0.15,0
61685,6152,-233.71,-975.39,24.61,0.00,233.71,0.43,0
61686,6152,0.00,-975.39,24.61,0.00,0.00,0.14,0
61687,6152,-19.30,-994.68,5.32,2.94,16.36,0.23,0
61688,6152,-1.87,-996.55,3.45,0.00,1.87,0.24,0
61689,6152,-2.66,-999.21,0.79,0.90,1.76,0.29,0
61690,6152,-0.33,-999.54,0.46,0.00,0.33,0.27,0
61691,6152,-0.34,-999.88,0.12,0.00,0.34,0.25,0
61692,6152,13.87,-986.01,13.99,0.06,0.03,0.14,1
61693,6152,-13.99,-1000.00,0.00,4.74,9.25,0.33,0
61694,6153,-672.69,-672.69,327.31,672.69,0.00,0.13,0
61695,6153,0.00,-672.69,327.31,0.00,0.00,0.25,0
61696,6153,-1000.00,-1672.69,-672.69,0.00,123.18,0.24,0
61697,6154,-397.25,-397.25,602.75,279.86,117.39,0.13,0
61698,6154,1000.00,602.75,1602.75,50.82,551.93,0.18,1
61699,6154,1000.00,1602.75,2602.75,721.26,881.49,0.23,1
61700,6154,-1000.00,602.75,1602.75,1365.10,1237.65,0.06,0
61701,6154,1000.00,1602.75,2602.75,0.00,287.58,0.07,1
61702,6154,1000.00,2602.75,3602.75,379.52,2223.23,0.16,1
61703,6154,0.00,2602.75,3602.75,0.00,0.00,0.01,0
61704,6154,1000.00,3602.75,4602.75,0.00,1564.69,0.21,1
61705,6154,1000.00,4602.75,5602.75,0.00,4126.64,0.40,1
61706,6154,-1000.00,3602.75,4602.75,4122.67,1262.97,0.09,0
61707,6154,1000.00,4602.75,5602.75,0.00,1676.97,0.19,1
61708,6154,-1000.00,3602.75,4602.75,2814.44,2788.31,0.21,0
61709,6154,1000.00,4602.75,5602.75,0.00,3878.48,0.42,1
61710,6154,1000.00,5602.75,6602.75,2188.08,3414.67,0.20,1
61711,6154,1000.00,6602.75,7602.75,1778.20,4824.55,0.37,1
61712,6154,1000.00,7602.75,8602.75,0.00,7602.75,0.00,1
61713,6154,1000.00,8602.75,9602.75,0.00,8602.75,0.08,1
61714,6154,1000.00,9602.75,10602.75,0.00,9602.75,0.20,1
61715,6154,1000.00,10602.75,11602.75,5219.00,5383.75,0.12,1
61716,6154,1000.00,11602.75,12602.75,3376.35,8226.40,0.33,1
61717,6154,1000.00,12602.75,13602.75,0.00,6906.24,0.21,1
61718,6154,1000.00,13602.75,14602.75,3591.52,10011.23,0.10,1
61719,6154,1000.00,14602.75,15602.75,7301.38,7301.38,0.05,1
61720,6154,1000.00,15602.75,16602.75,0.00,8437.85,0.14,1
61721,6154,1000.00,16602.75,17602.75,3299.78,13302.97,0.41,1
61722,6154,1000.00,17602.75,18602.75,8396.69,9206.06,0.07,1
61723,6154,-1000.00,16602.75,17602.75,7919.40,0.00,0.06,0
61724,6154,1000.00,17602.75,18602.75,3324.02,14278.73,0.24,1
61725,6154,1000.00,18602.75,19602.75,7058.97,11543.78,0.23,1
61726,6154,1000.00,19602.75,20602.75,9290.46,10312.29,0.11,1
61727,6154,1000.00,20602.75,21602.75,0.00,16388.51,0.12,1
61728,6154,-1000.00,19602.75,20602.75,4593.48,0.00,0.07,0
61729,6154,1000.00,20602.75,21602.75,3505.06,5182.13,0.20,1
61730,6154,1000.00,21602.75,22602.75,0.00,4040.13,0.12,1
61731,6154,-1000.00,20602.75,21602.75,14868.97,7733.78,0.12,0
61732,6154,1000.00,21602.75,22602.75,0.00,21602.75,0.11,1
61733,6154,1000.00,22602.75,23602.75,0.00,6023.28,0.04,1
61734,6154,1000.00,23602.75,24602.75,3510.20,13025.03,0.32,1
61735,6154,1000.00,24602.75,25602.75,0.00,24602.75,0.26,1
61736,6154,1000.00,25602.75,26602.75,6510.30,19092.45,0.16,1
61737,6154,0.00,25602.75,26602.75,0.00,0.00,0.06,0
61738,6154,1000.00,26602.75,27602.75,0.00,26602.75,0.06,1
61739,6154,1000.00,27602.75,28602.75,0.00,16469.63,0.21,1
61740,6154,1000.00,28602.75,29602.75,0.00,28602.75,0.26,1
61741,6154,1000.00,29602.75,30602.75,0.00,22569.33,0.23,1
61742,6154,1000.00,30602.75,31602.75,3416.66,16892.67,0.33,1
61743,6154,1000.00,31602.75,32602.75,7943.72,23659.03,0.28,1
61744,6154,1000.00,32602.75,33602.75,0.00,32602.75,0.31,1
61745,6155,-1000.00,-1000.00,0.00,381.15,618.85,0.12,0
61746,6156,-1000.00,-1000.00,0.00,500.00,500.00,0.02,0
61747,6157,1000.00,1000.00,2000.00,108.04,428.47,0.28,1
61748,6157,1000.00,2000.00,3000.00,0.00,1726.41,0.39,1
61749,6157,1000.00,3000.00,4000.00,1382.51,1617.49,0.14,1
61750,6157,-1000.00,2000.00,3000.00,1122.21,567.50,0.14,0
61751,6157,1000.00,3000.00,4000.00,0.00,2058.78,0.25,1
61752,6157,1000.00,4000.00,5000.00,0.00,1560.88,0.02,1
61753,6157,1000.00,5000.00,6000.00,0.00,987.18,0.02,1
61754,6157,1000.00,6000.00,7000.00,0.00,1600.37,0.19,1
61755,6157,1000.00,7000.00,8000.00,3457.51,3542.49,0.22,1
61756,6157,1000.00,8000.00,9000.00,4000.00,4000.00,0.07,1
61757,6157,1000.00,9000.00,10000.00,0.00,9000.00,0.31,1
61758,6157,1000.00,10000.00,11000.00,4433.76,5566.24,0.15,1
61759,6157,1000.00,11000.00,12000.00,0.00,6008.42,0.33,1
61760,6157,1000.00,12000.00,13000.00,0.00,12000.00,0.29,1
61761,6157,1000.00,13000.00,14000.00,0.00,13000.00,0.18,1
61762,6157,1000.00,14000.00,15000.00,0.00,10786.95,0.28,1
61763,6157,1000.00,15000.00,16000.00,5323.86,9676.14,0.26,1
61764,6157,1000.00,16000.00,17000.00,5062.00,10938.00,0.22,1
61765,6157,1000.00,17000.00,18000.00,0.00,17000.00,0.37,1
61766,6157,1000.00,18000.00,19000.00,0.00,4422.54,0.04,1
61767,6157,1000.00,19000.00,20000.00,0.00,3521.84,0.03,1
61768,6157,-1000.00,18000.00,19000.00,11310.37,8689.63,0.16,0
61769,6157,-1000.00,17000.00,18000.00,0.00,5037.69,0.21,0
61770,6157,-1000.00,16000.00,17000.00,0.00,17343.89,0.34,0
61771,6157,-1000.00,15000.00,16000.00,0.00,17000.00,0.05,0
61772,6157,-1000.00,14000.00,15000.00,3674.06,12325.94,0.21,0
61773,6157,-1000.00,13000.00,14000.00,5027.98,9972.02,0.27,0
61774,6157,-1000.00,12000.00,13000.00,6083.31,7916.69,0.18,0
61775,6157,-1000.00,11000.00,12000.00,0.00,13000.00,0.39,0
61776,6157,-1000.00,10000.00,11000.00,0.00,11923.62,0.36,0
61777,6157,-1000.00,9000.00,10000.00,4475.07,6524.93,0.22,0
61778,6157,-1000.00,8000.00,9000.00,0.00,10000.00,0.24,0
61779,6157,-1000.00,7000.00,8000.00,430.95,7567.62,0.43,0
61780,6157,-1000.00,6000.00,7000.00,0.00,8000.00,0.10,0
61781,6157,-1000.00,5000.00,6000.00,0.00,7000.00,0.34,0
61782,6157,-1000.00,4000.00,5000.00,2483.24,3516.76,0.16,0
61783,6157,-1000.00,3000.00,4000.00,512.68,4456.75,0.43,0
61784,6157,1000.00,4000.00,5000.00,0.00,2340.34,0.21,1
61785,6157,1000.00,5000.00,6000.00,0.00,5000.00,0.03,1
61786,6157,1000.00,6000.00,7000.00,0.00,4622.31,0.36,1
61787,6157,1000.00,7000.00,8000.00,1142.79,5857.21,0.38,1
61788,6157,0.00,7000.00,8000.00,0.00,0.00,0.07,0
61789,6157,1000.00,8000.00,9000.00,0.00,4042.06,0.07,1
61790,6157,1000.00,9000.00,10000.00,4500.00,4500.00,0.03,1
61791,6157,1000.00,10000.00,11000.00,4670.42,5329.58,0.11,1
61792,6157,1000.00,11000.00,12000.00,543.04,9914.47,0.43,1
61793,6157,1000.00,12000.00,13000.00,4037.13,7962.87,0.16,1
61794,6157,1000.00,13000.00,14000.00,3523.06,9476.94,0.20,1
61795,6157,1000.00,14000.00,15000.00,1305.63,9591.28,0.38,1
61796,6157,1000.00,15000.00,16000.00,0.00,15000.00,0.31,1
61797,6157,1000.00,16000.00,17000.00,0.00,8917.26,0.31,1
61798,6157,1000.00,17000.00,18000.00,0.00,17000.00,0.16,1
61799,6157,1000.00,18000.00,19000.00,0.00,17938.69,0.24,1
61800,6158,0.00,0.00,1000.00,0.00,0.00,0.04,0
61801,6158,-1000.00,-1000.00,0.00,0.00,334.02,0.29,0
61802,6159,-1000.00,-1000.00,0.00,365.84,634.16,0.31,0
61803,6160,0.00,0.00,1000.00,0.00,0.00,0.29,0
61804,6160,-918.03,-918.03,81.97,342.47,575.56,0.24,0
61805,6160,1000.00,81.97,1081.97,49.68,0.00,0.06,1
61806,6160,-1000.00,-918.03,81.97,0.00,1081.97,0.29,0
61807,6160,-37.60,-955.62,44.38,0.00,37.60,0.18,0
61808,6160,-44.38,-1000.00,0.00,11.83,32.55,0.26,0
61809,6161,1000.00,1000.00,2000.00,438.01,561.99,0.09,1
61810,6161,-684.97,315.03,1315.03,534.71,150.26,0.40,0
61811,6161,1000.00,1315.03,2315.03,0.00,803.43,0.20,1
61812,6161,1000.00,2315.03,3315.03,298.09,2016.95,0.33,1
61813,6161,1000.00,3315.03,4315.03,1432.90,1882.13,0.13,1
61814,6161,-1000.00,2315.03,3315.03,3225.23,389.99,0.06,0
61815,6161,1000.00,3315.03,4315.03,0.00,3315.03,0.14,1
61816,6161,1000.00,4315.03,5315.03,0.00,4315.03,0.31,1
61817,6161,1000.00,5315.03,6315.03,0.00,749.32,0.01,1
61818,6161,1000.00,6315.03,7315.03,0.00,2410.39,0.25,1
61819,6161,1000.00,7315.03,8315.03,0.00,7315.03,0.21,1
61820,6161,1000.00,8315.03,9315.03,0.00,3441.28,0.15,1
61821,6161,1000.00,9315.03,10315.03,0.00,4848.13,0.27,1
61822,6161,1000.00,10315.03,11315.03,1427.83,8887.21,0.29,1
61823,6161,1000.00,11315.03,12315.03,3000.81,8314.22,0.29,1
61824,6161,1000.00,12315.03,13315.03,0.00,12315.03,0.41,1
61825,6161,1000.00,13315.03,14315.03,0.00,12358.81,0.25,1
61826,6161,1000.00,14315.03,15315.03,0.00,12714.73,0.40,1
61827,6161,1000.00,15315.03,16315.03,38.10,15276.93,0.14,1
61828,6161,1000.00,16315.03,17315.03,4330.55,11984.48,0.36,1
61829,6161,-1000.00,15315.03,16315.03,15495.05,1819.98,0.04,0
61830,6161,1000.00,16315.03,17315.03,0.00,7827.13,0.13,1
61831,6161,1000.00,17315.03,18315.03,0.00,17315.03,0.37,1
61832,6161,1000.00,18315.03,19315.03,0.00,15669.97,0.16,1
61833,6161,1000.00,19315.03,20315.03,2260.64,17054.39,0.43,1
61834,6161,1000.00,20315.03,21315.03,0.00,20315.03,0.19,1
61835,6161,1000.00,21315.03,22315.03,0.00,18755.54,0.43,1
61836,6161,1000.00,22315.03,23315.03,10443.90,11871.13,0.18,1
61837,6161,1000.00,23315.03,24315.03,0.00,23315.03,0.14,1
61838,6161,1000.00,24315.03,25315.03,4482.03,19833.00,0.22,1
61839,6161,-1000.00,23315.03,24315.03,6796.49,0.00,0.10,0
61840,6161,1000.00,24315.03,25315.03,0.00,24315.03,0.34,1
61841,6162,-1000.00,-1000.00,0.00,0.00,1000.00,0.44,0
61842,6163,0.00,0.00,1000.00,0.00,0.00,0.05,0
61843,6163,0.00,0.00,1000.00,0.00,0.00,0.16,0
61844,6163,1000.00,1000.00,2000.00,878.67,121.33,0.02,1
61845,6163,-1000.00,0.00,1000.00,7.42,1737.01,0.43,0
61846,6163,-1000.00,-1000.00,0.00,0.00,1000.00,0.43,0
61847,6164,-134.62,-134.62,865.38,0.00,134.62,0.09,0
61848,6164,-777.82,-912.44,87.56,0.00,777.82,0.35,0
61849,6164,-87.56,-1000.00,0.00,19.90,67.66,0.37,0
61850,6165,-271.57,-271.57,728.43,0.00,271.57,0.39,0
61851,6165,0.00,-271.57,728.43,0.00,0.00,0.17,0
61852,6165,-728.43,-1000.00,0.00,338.17,390.26,0.21,0
61853,6166,0.00,0.00,1000.00,0.00,0.00,0.34,0
61854,6166,0.00,0.00,1000.00,0.00,0.00,0.33,0
61855,6166,-1000.00,-1000.00,0.00,706.90,293.10,0.04,0
61856,6167,-414.22,-414.22,585.78,0.00,414.22,0.26,0
61857,6167,-90.00,-504.22,495.78,0.00,90.00,0.13,0
61858,6167,-495.78,-1000.00,0.00,164.65,331.13,0.31,0
61859,6168,1000.00,1000.00,2000.00,0.00,532.04,0.25,1
61860,6168,1000.00,2000.00,3000.00,290.87,1548.29,0.40,1
61861,6168,1000.00,3000.00,4000.00,851.33,2148.67,0.33,1
61862,6168,1000.00,4000.00,5000.00,0.00,4000.00,0.04,1
61863,6168,1000.00,5000.00,6000.00,0.00,1344.26,0.10,1
61864,6168,1000.00,6000.00,7000.00,0.00,6000.00,0.18,1
61865,6168,1000.00,7000.00,8000.00,2597.60,4402.40,0.30,1
61866,6168,-1000.00,6000.00,7000.00,5874.99,0.00,0.05,0
61867,6168,-1000.00,5000.00,6000.00,1166.64,0.00,0.07,0
61868,6168,1000.00,6000.00,7000.00,1413.69,4586.31,0.38,1
61869,6168,1000.00,7000.00,8000.00,0.00,6304.43,0.36,1
61870,6168,1000.00,8000.00,9000.00,0.00,8000.00,0.12,1
61871,6168,1000.00,9000.00,10000.00,4091.35,4908.65,0.15,1
61872,6168,1000.00,10000.00,11000.00,0.00,10000.00,0.43,1
61873,6168,1000.00,11000.00,12000.00,0.00,8878.89,0.35,1
61874,6168,1000.00,12000.00,13000.00,0.00,12000.00,0.14,1
61875,6168,1000.00,13000.00,14000.00,0.00,4479.19,0.04,1
61876,6168,1000.00,14000.00,15000.00,0.00,9139.21,0.18,1
61877,6168,1000.00,15000.00,16000.00,0.00,8462.44,0.02,1
61878,6168,1000.00,16000.00,17000.00,3094.33,12905.67,0.36,1
61879,6168,1000.00,17000.00,18000.00,0.00,3655.48,0.15,1
61880,6168,1000.00,18000.00,19000.00,9000.00,9000.00,0.02,1
61881,6168,1000.00,19000.00,20000.00,2103.13,16896.87,0.05,1
61882,6168,-1000.00,18000.00,19000.00,12634.55,7365.45,0.13,0
61883,6168,-1000.00,17000.00,18000.00,6968.50,12031.50,0.30,0
61884,6168,-1000.00,16000.00,17000.00,13281.08,0.00,0.12,0
61885,6168,-1000.00,15000.00,16000.00,7508.38,6075.54,0.28,0
61886,6168,-1000.00,14000.00,15000.00,0.00,1942.45,0.37,0
61887,6168,-1000.00,13000.00,14000.00,0.00,15000.00,0.16,0
61888,6168,-1000.00,12000.00,13000.00,1406.74,12593.26,0.33,0
61889,6168,-1000.00,11000.00,12000.00,9161.26,0.00,0.01,0
61890,6168,-1000.00,10000.00,11000.00,0.00,9902.05,0.17,0
61891,6168,-1000.00,9000.00,10000.00,5500.00,5500.00,0.01,0
61892,6168,-1000.00,8000.00,9000.00,0.00,10000.00,0.09,0
61893,6169,-625.75,-625.75,374.25,0.00,625.75,0.44,0
61894,6169,1000.00,374.25,1374.25,197.23,177.02,0.23,1
61895,6169,1000.00,1374.25,2374.25,924.43,438.27,0.12,1
61896,6169,0.00,1374.25,2374.25,0.00,0.00,0.13,0
61897,6169,-1000.00,374.25,1374.25,0.00,1594.64,0.09,0
61898,6169,-1000.00,-625.75,374.25,179.47,1194.78,0.13,0
61899,6169,-374.25,-1000.00,0.00,0.00,374.25,0.22,0
61900,6170,-1000.00,-1000.00,0.00,431.81,568.19,0.17,0
61901,6171,-648.75,-648.75,351.25,37.70,611.04,0.27,0
61902,6171,-107.12,-755.87,244.13,0.00,107.12,0.39,0
61903,6171,1000.00,244.13,1244.13,182.88,61.26,0.12,1
61904,6171,-1000.00,-755.87,244.13,0.00,1244.13,0.36,0
61905,6171,-244.13,-1000.00,0.00,0.00,244.13,0.40,0
61906,6172,-1000.00,-1000.00,0.00,90.09,909.91,0.36,0
61907,6173,1000.00,1000.00,2000.00,81.75,877.76,0.43,1
61908,6173,1000.00,2000.00,3000.00,0.00,2000.00,0.40,1
61909,6173,1000.00,3000.00,4000.00,0.00,3000.00,0.03,1
61910,6173,1000.00,4000.00,5000.00,0.00,3765.58,0.10,1
61911,6173,1000.00,5000.00,6000.00,367.74,4632.26,0.41,1
61912,6173,1000.00,6000.00,7000.00,2466.91,2910.11,0.24,1
61913,6173,1000.00,7000.00,8000.00,0.00,7000.00,0.37,1
61914,6173,1000.00,8000.00,9000.00,0.00,8000.00,0.25,1
61915,6173,1000.00,9000.00,10000.00,0.00,5209.82,0.06,1
61916,6173,1000.00,10000.00,11000.00,0.00,10000.00,0.40,1
61917,6173,1000.00,11000.00,12000.00,1160.20,9839.80,0.43,1
61918,6173,1000.00,12000.00,13000.00,0.00,12000.00,0.06,1
61919,6173,1000.00,13000.00,14000.00,2756.35,10243.65,0.07,1
61920,6173,-1000.00,12000.00,13000.00,7472.57,6527.43,0.18,0
61921,6173,1000.00,13000.00,14000.00,0.00,13000.00,0.31,1
61922,6173,1000.00,14000.00,15000.00,3147.89,10852.11,0.39,1
61923,6173,-1000.00,13000.00,14000.00,11925.21,3074.79,0.05,0
61924,6173,1000.00,14000.00,15000.00,4003.93,9996.07,0.25,1
61925,6173,1000.00,15000.00,16000.00,1625.16,13374.84,0.16,1
61926,6173,1000.00,16000.00,17000.00,0.00,6827.74,0.27,1
61927,6173,1000.00,17000.00,18000.00,0.00,17000.00,0.15,1
61928,6173,1000.00,18000.00,19000.00,525.04,17474.96,0.43,1
61929,6173,-1000.00,17000.00,18000.00,0.00,19000.00,0.25,0
61930,6173,-1000.00,16000.00,17000.00,7825.85,10174.15,0.22,0
61931,6173,-1000.00,15000.00,16000.00,0.00,17000.00,0.02,0
61932,6173,-1000.00,14000.00,15000.00,5715.16,10284.84,0.26,0
61933,6173,-1000.00,13000.00,14000.00,0.00,10653.56,0.39,0
61934,6173,-1000.00,12000.00,13000.00,6232.97,7767.03,0.14,0
61935,6173,-1000.00,11000.00,12000.00,0.00,4709.79,0.11,0
61936,6173,-1000.00,10000.00,11000.00,9703.60,0.00,0.02,0
61937,6173,-1000.00,9000.00,10000.00,965.23,10034.77,0.44,0
61938,6173,-1000.00,8000.00,9000.00,0.00,8140.18,0.42,0
61939,6173,-1000.00,7000.00,8000.00,0.00,9000.00,0.32,0
61940,6173,-1000.00,6000.00,7000.00,0.00,4763.77,0.35,0
61941,6173,-1000.00,5000.00,6000.00,0.00,7000.00,0.16,0
61942,6173,-1000.00,4000.00,5000.00,2565.27,3434.73,0.14,0
61943,6173,-1000.00,3000.00,4000.00,3846.57,1153.43,0.06,0
61944,6173,-1000.00,2000.00,3000.00,0.00,4000.00,0.29,0
61945,6173,-1000.00,1000.00,2000.00,125.52,2874.48,0.44,0
61946,6173,-1000.00,0.00,1000.00,1028.18,971.82,0.14,0
61947,6173,-34.20,-34.20,965.80,0.00,34.20,0.09,0
61948,6173,-188.43,-222.63,777.37,0.00,188.43,0.10,0
61949,6173,-1000.00,-1222.63,-222.63,468.15,309.22,0.00,0
61950,6174,1000.00,1000.00,2000.00,0.00,1000.00,0.03,1
61951,6174,-1000.00,0.00,1000.00,1067.13,526.93,0.14,0
61952,6174,1000.00,1000.00,2000.00,277.42,722.58,0.02,1
61953,6174,1000.00,2000.00,3000.00,517.43,1482.57,0.38,1
61954,6174,1000.00,3000.00,4000.00,0.00,3000.00,0.35,1
61955,6174,-1000.00,2000.00,3000.00,4000.00,0.00,0.01,0
61956,6174,1000.00,3000.00,4000.00,1364.56,1635.44,0.23,1
61957,6174,-1000.00,2000.00,3000.00,2086.07,1913.93,0.09,0
61958,6174,-769.22,1230.78,2230.78,627.03,142.20,0.12,0
61959,6174,1000.00,2230.78,3230.78,405.46,1825.32,0.23,1
61960,6174,1000.00,3230.78,4230.78,0.00,3230.78,0.01,1
61961,6174,1000.00,4230.78,5230.78,391.57,1124.15,0.21,1
61962,6174,1000.00,5230.78,6230.78,0.00,3712.34,0.38,1
61963,6174,1000.00,6230.78,7230.78,1701.55,4529.23,0.18,1
61964,6174,-1000.00,5230.78,6230.78,4492.53,2738.25,0.13,0
61965,6174,1000.00,6230.78,7230.78,2303.60,3927.18,0.12,1
61966,6174,1000.00,7230.78,8230.78,0.00,7230.78,0.06,1
61967,6174,1000.00,8230.78,9230.78,1017.09,7213.69,0.41,1
61968,6174,1000.00,9230.78,10230.78,0.00,3663.05,0.24,1
61969,6174,1000.00,10230.78,11230.78,0.00,6927.58,0.38,1
61970,6174,-1000.00,9230.78,10230.78,6414.59,4816.19,0.00,0
61971,6174,1000.00,10230.78,11230.78,1176.96,9053.82,0.33,1
61972,6174,1000.00,11230.78,12230.78,0.00,10735.36,0.34,1
61973,6174,1000.00,12230.78,13230.78,3398.06,8832.71,0.23,1
61974,6174,-1000.00,11230.78,12230.78,0.00,9660.08,0.24,0
61975,6174,-1000.00,10230.78,11230.78,1490.93,3425.70,0.21,0
61976,6174,-1000.00,9230.78,10230.78,1957.41,4613.53,0.26,0
61977,6174,-1000.00,8230.78,9230.78,0.00,8538.53,0.42,0
61978,6174,-1000.00,7230.78,8230.78,0.00,5283.38,0.33,0
61979,6174,-1000.00,6230.78,7230.78,0.00,6738.63,0.42,0
61980,6174,-1000.00,5230.78,6230.78,3767.39,3463.39,0.15,0
61981,6174,-1000.00,4230.78,5230.78,0.00,5407.94,0.32,0
61982,6174,-1000.00,3230.78,4230.78,0.00,5230.78,0.19,0
61983,6174,-1000.00,2230.78,3230.78,449.93,3780.85,0.32,0
61984,6174,-1000.00,1230.78,2230.78,1615.39,1615.39,0.07,0
61985,6174,-1000.00,230.78,1230.78,713.55,1517.23,0.34,0
61986,6174,-1000.00,-769.22,230.78,0.00,1230.78,0.13,0
61987,6174,-230.78,-1000.00,0.00,0.00,230.78,0.24,0
61988,6175,1000.00,1000.00,2000.00,285.38,516.34,0.29,1
61989,6175,-745.40,254.60,1254.60,745.40,0.00,0.09,0
61990,6175,1000.00,1254.60,2254.60,0.00,389.16,0.09,1
61991,6175,1000.00,2254.60,3254.60,0.00,975.99,0.26,1
61992,6175,1000.00,3254.60,4254.60,1498.54,1756.06,0.16,1
61993,6175,1000.00,4254.60,5254.60,0.00,1542.97,0.16,1
61994,6175,1000.00,5254.60,6254.60,2119.92,2338.50,0.23,1
61995,6175,1000.00,6254.60,7254.60,0.00,6254.60,0.12,1
61996,6175,1000.00,7254.60,8254.60,1038.12,6216.48,0.40,1
61997,6175,1000.00,8254.60,9254.60,2518.93,5735.67,0.35,1
61998,6175,1000.00,9254.60,10254.60,1267.97,7986.63,0.42,1
61999,6175,1000.00,10254.60,11254.60,4223.03,6031.57,0.23,1
62000,6175,1000.00,11254.60,12254.60,2521.16,8733.44,0.22,1
62001,6175,1000.00,12254.60,13254.60,0.00,10874.55,0.10,1
62002,6175,0.00,12254.60,13254.60,0.00,0.00,0.05,0
62003,6175,1000.00,13254.60,14254.60,0.00,13254.60,0.26,1
62004,6175,1000.00,14254.60,15254.60,0.00,14254.60,0.20,1
62005,6175,1000.00,15254.60,16254.60,0.00,15254.60,0.06,1
62006,6175,1000.00,16254.60,17254.60,3281.11,12973.49,0.41,1
62007,6175,0.00,16254.60,17254.60,0.00,0.00,0.02,0
62008,6175,1000.00,17254.60,18254.60,5553.20,11701.40,0.31,1
62009,6175,1000.00,18254.60,19254.60,3699.69,14554.91,0.41,1
62010,6175,1000.00,19254.60,20254.60,1.65,19252.95,0.17,1
62011,6175,-1000.00,18254.60,19254.60,4390.12,15864.48,0.26,0
62012,6175,-1000.00,17254.60,18254.60,0.00,15838.89,0.39,0
62013,6175,-1000.00,16254.60,17254.60,3331.83,14922.77,0.36,0
62014,6175,-1000.00,15254.60,16254.60,0.00,13555.35,0.38,0
62015,6175,-1000.00,14254.60,15254.60,0.00,16254.60,0.22,0
62016,6175,-1000.00,13254.60,14254.60,7431.43,7823.17,0.21,0
62017,6175,-1000.00,12254.60,13254.60,0.00,14254.60,0.16,0
62018,6175,-1000.00,11254.60,12254.60,0.00,13254.60,0.19,0
62019,6175,-1000.00,10254.60,11254.60,0.00,11098.19,0.23,0
62020,6175,-1000.00,9254.60,10254.60,1815.06,9439.54,0.02,0
62021,6175,-1000.00,8254.60,9254.60,0.00,3390.07,0.20,0
62022,6175,-1000.00,7254.60,8254.60,0.00,9254.60,0.18,0
62023,6175,-1000.00,6254.60,7254.60,2028.92,5150.53,0.33,0
62024,6175,0.00,6254.60,7254.60,0.00,0.00,0.04,0
62025,6175,-1000.00,5254.60,6254.60,399.95,6854.65,0.43,0
62026,6175,-1000.00,4254.60,5254.60,3609.81,2644.79,0.01,0
62027,6175,-1000.00,3254.60,4254.60,3257.08,1997.52,0.06,0
62028,6175,-1000.00,2254.60,3254.60,0.00,4254.60,0.21,0
62029,6175,-1000.00,1254.60,2254.60,0.00,3254.60,0.16,0
62030,6175,-1000.00,254.60,1254.60,0.00,2254.60,0.35,0
62031,6175,-1000.00,-745.40,254.60,210.19,1044.40,0.39,0
62032,6175,-228.04,-973.44,26.56,0.00,228.04,0.33,0
62033,6175,1000.00,26.56,1026.56,0.00,26.56,0.42,1
62034,6175,1000.00,1026.56,2026.56,0.00,299.18,0.16,1
62035,6175,1000.00,2026.56,3026.56,0.00,2026.56,0.12,1
62036,6175,1000.00,3026.56,4026.56,1513.28,1513.28,0.03,1
62037,6175,-1000.00,2026.56,3026.56,2428.53,1598.02,0.13,0
62038,6175,-1000.00,1026.56,2026.56,1033.75,1992.81,0.33,0
62039,6175,-1000.00,26.56,1026.56,637.56,1388.99,0.03,0
62040,6175,-1000.00,-973.44,26.56,0.00,1026.56,0.07,0
62041,6175,-26.56,-1000.00,0.00,14.83,11.73,0.04,0
62042,6176,1000.00,1000.00,2000.00,259.61,740.39,0.28,1
62043,6176,1000.00,2000.00,3000.00,265.33,1734.67,0.38,1
62044,6176,1000.00,3000.00,4000.00,0.00,2693.00,0.23,1
62045,6176,-1000.00,2000.00,3000.00,2736.56,1263.44,0.02,0
62046,6176,1000.00,3000.00,4000.00,0.00,2542.74,0.43,1
62047,6176,1000.00,4000.00,5000.00,0.00,4000.00,0.15,1
62048,6176,1000.00,5000.00,6000.00,0.00,5000.00,0.26,1
62049,6176,1000.00,6000.00,7000.00,0.00,5330.55,0.32,1
62050,6176,1000.00,7000.00,8000.00,2117.50,4882.50,0.34,1
62051,6176,1000.00,8000.00,9000.00,375.38,7624.62,0.37,1
62052,6176,1000.00,9000.00,10000.00,0.00,1755.63,0.15,1
62053,6176,1000.00,10000.00,11000.00,0.00,10000.00,0.29,1
62054,6176,1000.00,11000.00,12000.00,4553.38,6446.62,0.20,1
62055,6176,1000.00,12000.00,13000.00,0.00,12000.00,0.43,1
62056,6176,1000.00,13000.00,14000.00,0.00,9855.14,0.22,1
62057,6176,1000.00,14000.00,15000.00,0.00,12599.42,0.07,1
62058,6176,1000.00,15000.00,16000.00,0.00,14732.25,0.44,1
62059,6176,1000.00,16000.00,17000.00,4232.42,11767.58,0.34,1
62060,6176,1000.00,17000.00,18000.00,2423.11,13918.61,0.41,1
62061,6176,1000.00,18000.00,19000.00,949.63,17050.37,0.44,1
62062,6176,1000.00,19000.00,20000.00,0.00,19000.00,0.38,1
62063,6176,1000.00,20000.00,21000.00,0.00,12029.33,0.35,1
62064,6176,1000.00,21000.00,22000.00,282.46,20717.54,0.11,1
62065,6176,1000.00,22000.00,23000.00,0.00,22000.00,0.27,1
62066,6176,1000.00,23000.00,24000.00,0.00,23000.00,0.43,1
62067,6176,1000.00,24000.00,25000.00,8882.32,9182.84,0.22,1
62068,6176,1000.00,25000.00,26000.00,0.00,24286.43,0.42,1
62069,6176,1000.00,26000.00,27000.00,0.00,26000.00,0.01,1
62070,6176,1000.00,27000.00,28000.00,5829.34,21170.66,0.34,1
62071,6176,1000.00,28000.00,29000.00,0.00,28000.00,0.18,1
62072,6176,0.00,28000.00,29000.00,0.00,0.00,0.03,0
62073,6176,1000.00,29000.00,30000.00,12346.84,16653.16,0.23,1
62074,6176,1000.00,30000.00,31000.00,0.00,19042.26,0.36,1
62075,6176,1000.00,31000.00,32000.00,0.00,31000.00,0.40,1
62076,6176,1000.00,32000.00,33000.00,0.00,32000.00,0.07,1
62077,6176,1000.00,33000.00,34000.00,12915.98,20084.02,0.18,1
62078,6176,1000.00,34000.00,35000.00,0.00,17755.10,0.24,1
62079,6176,1000.00,35000.00,36000.00,0.00,35000.00,0.32,1
62080,6176,1000.00,36000.00,37000.00,12768.06,23231.94,0.23,1
62081,6176,1000.00,37000.00,38000.00,0.00,37000.00,0.23,1
62082,6176,1000.00,38000.00,39000.00,18999.98,19000.02,0.19,1
62083,6177,1000.00,1000.00,2000.00,285.58,714.42,0.35,1
62084,6177,1000.00,2000.00,3000.00,0.00,1358.94,0.24,1
62085,6177,-437.95,1562.05,2562.05,437.95,0.00,0.07,0
62086,6177,-1000.00,562.05,1562.05,1508.29,1053.75,0.02,0
62087,6177,-1000.00,-437.95,562.05,869.10,692.94,0.09,0
62088,6177,1000.00,562.05,1562.05,138.68,423.37,0.38,1
62089,6177,1000.00,1562.05,2562.05,600.71,961.33,0.25,1
62090,6177,-1000.00,562.05,1562.05,1596.84,965.21,0.13,0
62091,6177,1000.00,1562.05,2562.05,116.81,401.56,0.20,1
62092,6177,1000.00,2562.05,3562.05,0.00,2562.05,0.29,1
62093,6177,1000.00,3562.05,4562.05,904.53,2657.52,0.23,1
62094,6177,1000.00,4562.05,5562.05,0.00,4562.05,0.38,1
62095,6177,1000.00,5562.05,6562.05,0.00,5562.05,0.44,1
62096,6177,1000.00,6562.05,7562.05,0.00,6562.05,0.35,1
62097,6177,-1000.00,5562.05,6562.05,5510.93,891.45,0.07,0
62098,6177,1000.00,6562.05,7562.05,0.00,5865.11,0.13,1
62099,6177,-1000.00,5562.05,6562.05,4875.33,2686.72,0.08,0
62100,6177,1000.00,6562.05,7562.05,0.00,5048.13,0.39,1
62101,6177,0.00,6562.05,7562.05,0.00,0.00,0.04,0
62102,6177,1000.00,7562.05,8562.05,3740.50,3821.55,0.08,1
62103,6177,1000.00,8562.05,9562.05,3831.32,4730.73,0.16,1
62104,6177,1000.00,9562.05,10562.05,0.00,9562.05,0.09,1
62105,6177,-1000.00,8562.05,9562.05,1558.40,9003.65,0.42,0
62106,6177,-1000.00,7562.05,8562.05,4250.83,5311.22,0.21,0
62107,6177,-1000.00,6562.05,7562.05,0.00,1847.03,0.10,0
62108,6177,-1000.00,5562.05,6562.05,0.00,7562.05,0.33,0
62109,6177,-1000.00,4562.05,5562.05,1350.22,5211.83,0.34,0
62110,6177,-1000.00,3562.05,4562.05,0.00,3469.41,0.15,0
62111,6177,-1000.00,2562.05,3562.05,3997.26,0.00,0.01,0
62112,6177,-1000.00,1562.05,2562.05,0.00,3562.05,0.23,0
62113,6177,-1000.00,562.05,1562.05,189.13,2372.91,0.38,0
62114,6177,-1000.00,-437.95,562.05,0.00,1562.05,0.29,0
62115,6177,-562.05,-1000.00,0.00,0.00,562.05,0.09,0
62116,6178,-294.41,-294.41,705.59,294.41,0.00,0.34,0
62117,6178,1000.00,705.59,1705.59,264.05,320.43,0.27,1
62118,6178,1000.00,1705.59,2705.59,245.75,1459.84,0.29,1
62119,6178,1000.00,2705.59,3705.59,675.54,2030.05,0.38,1
62120,6178,1000.00,3705.59,4705.59,0.00,3705.59,0.43,1
62121,6178,1000.00,4705.59,5705.59,216.65,4488.94,0.44,1
62122,6178,-1000.00,3705.59,4705.59,3851.39,1854.20,0.04,0
62123,6178,1000.00,4705.59,5705.59,0.00,1783.38,0.02,1
62124,6178,1000.00,5705.59,6705.59,0.00,5705.59,0.22,1
62125,6178,1000.00,6705.59,7705.59,1180.08,5525.51,0.42,1
62126,6178,1000.00,7705.59,8705.59,1820.67,5884.92,0.39,1
62127,6178,1000.00,8705.59,9705.59,1134.73,4370.13,0.31,1
62128,6178,1000.00,9705.59,10705.59,3735.71,5969.88,0.30,1
62129,6178,-1000.00,8705.59,9705.59,6538.61,2546.56,0.12,0
62130,6178,1000.00,9705.59,10705.59,0.00,9705.59,0.03,1
62131,6178,1000.00,10705.59,11705.59,0.00,6956.75,0.36,1
62132,6178,1000.00,11705.59,12705.59,0.00,11705.59,0.03,1
62133,6178,1000.00,12705.59,13705.59,2086.40,10373.67,0.41,1
62134,6178,1000.00,13705.59,14705.59,0.00,3465.66,0.17,1
62135,6178,1000.00,14705.59,15705.59,582.90,7646.52,0.32,1
62136,6178,1000.00,15705.59,16705.59,0.00,13439.77,0.43,1
62137,6178,-1000.00,14705.59,15705.59,9552.59,0.00,0.05,0
62138,6178,-1000.00,13705.59,14705.59,0.00,15512.55,0.31,0
62139,6178,-1000.00,12705.59,13705.59,0.00,14705.59,0.31,0
62140,6178,-1000.00,11705.59,12705.59,2402.74,11302.85,0.19,0
62141,6178,-1000.00,10705.59,11705.59,1719.79,9663.44,0.40,0
62142,6178,-1000.00,9705.59,10705.59,0.00,11705.59,0.23,0
62143,6178,-1000.00,8705.59,9705.59,3543.38,7162.22,0.23,0
62144,6178,-1000.00,7705.59,8705.59,4852.80,4852.80,0.02,0
62145,6178,-1000.00,6705.59,7705.59,0.00,3562.03,0.21,0
62146,6178,-1000.00,5705.59,6705.59,3429.00,4276.60,0.18,0
62147,6178,-1000.00,4705.59,5705.59,1052.73,5652.86,0.40,0
62148,6178,-1000.00,3705.59,4705.59,0.00,5705.59,0.11,0
62149,6178,-1000.00,2705.59,3705.59,0.00,4705.59,0.33,0
62150,6178,-1000.00,1705.59,2705.59,0.00,3705.59,0.21,0
62151,6178,-1000.00,705.59,1705.59,275.43,832.32,0.22,0
62152,6178,0.00,705.59,1705.59,0.00,0.00,0.05,0
62153,6178,-1000.00,-294.41,705.59,0.00,1641.92,0.44,0
62154,6178,-705.59,-1000.00,0.00,185.56,520.03,0.06,0
62155,6179,-1000.00,-1000.00,0.00,0.00,1000.00,0.29,0
62156,6180,1000.00,1000.00,2000.00,376.39,102.83,0.36,1
62157,6180,-1000.00,0.00,1000.00,0.00,1167.78,0.25,0
62158,6180,0.00,0.00,1000.00,0.00,0.00,0.03,0
62159,6180,-1000.00,-1000.00,0.00,285.02,714.98,0.17,0
62160,6181,-1000.00,-1000.00,0.00,101.16,898.84,0.23,0
62161,6182,-1000.00,-1000.00,0.00,434.70,565.30,0.26,0
62162,6183,-1000.00,-1000.00,0.00,0.00,1000.00,0.10,0
62163,6184,1000.00,1000.00,2000.00,0.00,913.10,0.43,1
62164,6184,1000.00,2000.00,3000.00,0.00,1183.60,0.35,1
62165,6184,1000.00,3000.00,4000.00,0.00,3000.00,0.17,1
62166,6184,1000.00,4000.00,5000.00,0.00,3495.97,0.07,1
62167,6184,1000.00,5000.00,6000.00,1579.36,3420.64,0.35,1
62168,6184,1000.00,6000.00,7000.00,818.74,5181.26,0.04,1
62169,6184,0.00,6000.00,7000.00,0.00,0.00,0.09,0
62170,6184,-1000.00,5000.00,6000.00,4785.75,2214.25,0.02,0
62171,6184,1000.00,6000.00,7000.00,2113.98,3886.02,0.24,1
62172,6184,1000.00,7000.00,8000.00,3500.00,3500.00,0.09,1
62173,6184,1000.00,8000.00,9000.00,0.00,8000.00,0.21,1
62174,6184,1000.00,9000.00,10000.00,242.64,4317.12,0.30,1
62175,6184,1000.00,10000.00,11000.00,0.00,10000.00,0.19,1
62176,6184,1000.00,11000.00,12000.00,0.00,278.84,0.04,1
62177,6184,1000.00,12000.00,13000.00,3146.77,8853.23,0.31,1
62178,6184,1000.00,13000.00,14000.00,6480.39,6519.61,0.22,1
62179,6184,1000.00,14000.00,15000.00,0.00,14000.00,0.35,1
62180,6184,1000.00,15000.00,16000.00,3580.74,11419.26,0.38,1
62181,6184,1000.00,16000.00,17000.00,1869.83,14130.17,0.43,1
62182,6184,1000.00,17000.00,18000.00,0.00,10026.17,0.28,1
62183,6184,1000.00,18000.00,19000.00,5388.50,12611.50,0.22,1
62184,6184,1000.00,19000.00,20000.00,0.00,9510.68,0.30,1
62185,6184,1000.00,20000.00,21000.00,0.00,19865.96,0.41,1
62186,6184,1000.00,21000.00,22000.00,0.00,12685.01,0.34,1
62187,6184,-1000.00,20000.00,21000.00,0.00,22000.00,0.33,0
62188,6184,-1000.00,19000.00,20000.00,0.00,21000.00,0.29,0
62189,6184,-1000.00,18000.00,19000.00,0.00,16531.74,0.42,0
62190,6184,-1000.00,17000.00,18000.00,1742.99,17257.01,0.44,0
62191,6184,-1000.00,16000.00,17000.00,6478.50,4912.32,0.18,0
62192,6184,-1000.00,15000.00,16000.00,0.00,1574.77,0.14,0
62193,6184,-1000.00,14000.00,15000.00,0.00,16000.00,0.44,0
62194,6184,-1000.00,13000.00,14000.00,0.00,15000.00,0.39,0
62195,6184,-1000.00,12000.00,13000.00,745.34,13254.66,0.04,0
62196,6184,-1000.00,11000.00,12000.00,0.00,13000.00,0.41,0
62197,6184,-1000.00,10000.00,11000.00,1136.42,10863.58,0.24,0
62198,6184,-1000.00,9000.00,10000.00,7083.29,3916.71,0.06,0
62199,6184,-1000.00,8000.00,9000.00,5990.29,2532.18,0.12,0
62200,6184,-1000.00,7000.00,8000.00,0.00,4972.34,0.20,0
62201,6184,-1000.00,6000.00,7000.00,0.00,8000.00,0.36,0
62202,6184,-383.74,5616.26,6616.26,0.00,383.74,0.05,0
62203,6184,-1000.00,4616.26,5616.26,0.00,6616.26,0.18,0
62204,6184,-1000.00,3616.26,4616.26,0.00,5616.26,0.34,0
62205,6184,-1000.00,2616.26,3616.26,1383.55,3232.70,0.31,0
62206,6184,-1000.00,1616.26,2616.26,0.00,3204.17,0.29,0
62207,6184,-1000.00,616.26,1616.26,0.00,2616.26,0.12,0
62208,6184,-1000.00,-383.74,616.26,0.00,1616.26,0.35,0
62209,6184,-616.26,-1000.00,0.00,220.50,395.76,0.32,0
62210,6185,-1000.00,-1000.00,0.00,685.09,314.91,0.09,0
62211,6186,-1000.00,-1000.00,0.00,515.07,484.93,0.00,0
62212,6187,-506.55,-506.55,493.45,0.00,506.55,0.04,0
62213,6187,-493.45,-1000.00,0.00,0.00,493.45,0.19,0
62214,6188,-1000.00,-1000.00,0.00,689.28,310.72,0.10,0
62215,6189,-1000.00,-1000.00,0.00,960.47,39.53,0.03,0
62216,6190,-379.43,-379.43,620.57,0.00,379.43,0.07,0
62217,6190,-407.12,-786.55,213.45,0.00,407.12,0.29,0
62218,6190,1000.00,213.45,1213.45,120.82,22.11,0.28,1
62219,6190,1000.00,1213.45,2213.45,315.92,0.00,0.17,1
62220,6190,-965.30,248.15,1248.15,0.00,965.30,0.33,0
62221,6190,1000.00,1248.15,2248.15,645.02,603.13,0.16,1
62222,6190,-1000.00,248.15,1248.15,911.83,1336.32,0.21,0
62223,6190,-1000.00,-751.85,248.15,0.00,1248.15,0.24,0
62224,6190,-248.15,-1000.00,0.00,0.00,248.15,0.31,0
62225,6191,1000.00,1000.00,2000.00,0.00,1000.00,0.02,1
62226,6191,1000.00,2000.00,3000.00,912.39,1087.61,0.25,1
62227,6191,1000.00,3000.00,4000.00,0.00,3000.00,0.09,1
62228,6191,1000.00,4000.00,5000.00,1353.70,2646.30,0.22,1
62229,6191,1000.00,5000.00,6000.00,388.69,3712.92,0.40,1
62230,6191,1000.00,6000.00,7000.00,0.00,5235.92,0.41,1
62231,6191,1000.00,7000.00,8000.00,1607.34,2255.47,0.22,1
62232,6191,-1000.00,6000.00,7000.00,0.00,8000.00,0.08,0
62233,6191,-1000.00,5000.00,6000.00,0.00,6422.74,0.26,0
62234,6191,-1000.00,4000.00,5000.00,0.00,592.59,0.24,0
62235,6191,0.00,4000.00,5000.00,0.00,0.00,0.01,0
62236,6191,-1000.00,3000.00,4000.00,1742.20,3257.80,0.36,0
62237,6191,-1000.00,2000.00,3000.00,1661.29,333.13,0.11,0
62238,6191,0.00,2000.00,3000.00,0.00,0.00,0.24,0
62239,6191,-1000.00,1000.00,2000.00,846.64,2153.36,0.13,0
62240,6191,-192.25,807.75,1807.75,192.25,0.00,0.30,0
62241,6191,-1000.00,-192.25,807.75,0.00,1104.40,0.15,0
62242,6191,-1000.00,-1192.25,-192.25,0.00,303.60,0.22,0
62243,6192,-1000.00,-1000.00,0.00,0.00,1000.00,0.33,0
62244,6193,1000.00,1000.00,2000.00,1.55,998.45,0.38,1
62245,6193,1000.00,2000.00,3000.00,646.97,1353.03,0.34,1
62246,6193,1000.00,3000.00,4000.00,963.74,2036.26,0.32,1
62247,6193,1000.00,4000.00,5000.00,770.14,3229.86,0.18,1
62248,6193,-1000.00,3000.00,4000.00,3335.79,1664.21,0.06,0
62249,6193,-1000.00,2000.00,3000.00,3863.28,0.00,0.03,0
62250,6193,1000.00,3000.00,4000.00,840.47,2159.53,0.25,1
62251,6193,1000.00,4000.00,5000.00,647.92,3352.08,0.30,1
62252,6193,1000.00,5000.00,6000.00,0.00,5000.00,0.18,1
62253,6193,1000.00,6000.00,7000.00,2045.48,3954.52,0.13,1
62254,6193,1000.00,7000.00,8000.00,0.00,3952.18,0.24,1
62255,6193,1000.00,8000.00,9000.00,0.00,8000.00,0.40,1
62256,6193,1000.00,9000.00,10000.00,2674.51,6325.49,0.13,1
62257,6193,0.00,9000.00,10000.00,0.00,0.00,0.01,0
62258,6193,1000.00,10000.00,11000.00,0.00,6564.84,0.12,1
62259,6193,-1000.00,9000.00,10000.00,5763.63,5200.97,0.21,0
62260,6193,1000.00,10000.00,11000.00,0.00,3159.08,0.23,1
62261,6193,1000.00,11000.00,12000.00,0.00,11000.00,0.27,1
62262,6193,1000.00,12000.00,13000.00,0.00,12000.00,0.22,1
62263,6193,1000.00,13000.00,14000.00,0.00,12338.25,0.25,1
62264,6193,1000.00,14000.00,15000.00,0.00,6229.47,0.28,1
62265,6193,-1000.00,13000.00,14000.00,10533.28,0.00,0.02,0
62266,6193,1000.00,14000.00,15000.00,5460.98,8539.02,0.19,1
62267,6193,1000.00,15000.00,16000.00,3188.02,7147.41,0.28,1
62268,6193,-1000.00,14000.00,15000.00,4651.23,1.83,0.10,0
62269,6193,1000.00,15000.00,16000.00,0.00,15000.00,0.25,1
62270,6193,1000.00,16000.00,17000.00,6363.99,9636.01,0.22,1
62271,6193,1000.00,17000.00,18000.00,0.00,17000.00,0.43,1
62272,6193,1000.00,18000.00,19000.00,367.81,10976.39,0.36,1
62273,6193,1000.00,19000.00,20000.00,3940.58,15059.42,0.40,1
62274,6193,1000.00,20000.00,21000.00,0.00,5213.06,0.16,1
62275,6193,1000.00,21000.00,22000.00,0.00,21000.00,0.36,1
62276,6193,1000.00,22000.00,23000.00,0.00,22000.00,0.34,1
62277,6193,1000.00,23000.00,24000.00,0.00,23000.00,0.37,1
62278,6193,1000.00,24000.00,25000.00,0.00,19752.10,0.35,1
62279,6193,1000.00,25000.00,26000.00,8476.45,16523.55,0.21,1
62280,6193,1000.00,26000.00,27000.00,4739.64,13879.08,0.31,1
62281,6193,1000.00,27000.00,28000.00,11517.40,12644.38,0.23,1
62282,6194,1000.00,1000.00,2000.00,719.89,0.00,0.20,1
62283,6194,0.00,1000.00,2000.00,0.00,0.00,0.34,0
62284,6194,1000.00,2000.00,3000.00,315.53,0.00,0.43,1
62285,6194,-1000.00,1000.00,2000.00,388.69,2549.99,0.16,0
62286,6194,-173.35,826.65,1826.65,0.00,173.35,0.37,0
62287,6194,-1000.00,-173.35,826.65,393.97,1226.60,0.22,0
62288,6194,1000.00,826.65,1826.65,826.65,0.00,0.03,1
62289,6194,-1000.00,-173.35,826.65,201.84,1624.81,0.41,0
62290,6194,1000.00,826.65,1826.65,464.24,42.33,0.26,1
62291,6194,-779.96,46.69,1046.69,0.00,779.96,0.23,0
62292,6194,-1000.00,-953.31,46.69,0.00,1046.69,0.23,0
62293,6194,-21.27,-974.59,25.41,0.00,21.27,0.33,0
62294,6194,0.00,-974.59,25.41,0.00,0.00,0.13,0
62295,6194,1000.00,25.41,1025.41,19.19,6.23,0.14,1
62296,6194,1000.00,1025.41,2025.41,955.84,69.57,0.10,1
62297,6194,-1000.00,25.41,1025.41,0.00,2025.41,0.00,0
62298,6194,1000.00,1025.41,2025.41,600.95,424.46,0.10,1
62299,6194,0.00,1025.41,2025.41,0.00,0.00,0.15,0
62300,6194,1000.00,2025.41,3025.41,761.97,365.86,0.35,1
62301,6194,-845.23,1180.18,2180.18,10.89,834.33,0.40,0
62302,6194,-840.15,340.03,1340.03,0.00,840.15,0.28,0
62303,6194,-941.67,-601.64,398.36,88.87,852.80,0.25,0
62304,6194,1000.00,398.36,1398.36,145.55,0.00,0.28,1
62305,6194,0.00,398.36,1398.36,0.00,0.00,0.25,0
62306,6194,-1000.00,-601.64,398.36,1075.89,0.00,0.15,0
62307,6194,0.00,-601.64,398.36,0.00,0.00,0.10,0
62308,6194,-1000.00,-1601.64,-601.64,0.00,251.64,0.09,0
62309,6195,-1000.00,-1000.00,0.00,349.23,650.77,0.16,0
62310,6196,-1000.00,-1000.00,0.00,374.35,625.65,0.18,0
62311,6197,-1000.00,-1000.00,0.00,0.00,1000.00,0.44,0
62312,6198,-1000.00,-1000.00,0.00,500.00,500.00,0.08,0
62313,6199,-1000.00,-1000.00,0.00,274.76,725.24,0.23,0
62314,6200,-1000.00,-1000.00,0.00,0.00,1000.00,0.08,0
62315,6201,-1000.00,-1000.00,0.00,0.00,420.38,0.30,0
62316,6202,1000.00,1000.00,2000.00,0.00,906.89,0.44,1
62317,6202,1000.00,2000.00,3000.00,986.90,1013.10,0.16,1
62318,6202,1000.00,3000.00,4000.00,772.51,2227.49,0.10,1
62319,6202,1000.00,4000.00,5000.00,107.58,3892.42,0.19,1
62320,6202,1000.00,5000.00,6000.00,673.51,3475.57,0.38,1
62321,6202,1000.00,6000.00,7000.00,502.83,5497.17,0.43,1
62322,6202,1000.00,7000.00,8000.00,2170.59,4829.41,0.26,1
62323,6202,1000.00,8000.00,9000.00,4000.00,4000.00,0.05,1
62324,6202,-1000.00,7000.00,8000.00,9000.00,0.00,0.02,0
62325,6202,1000.00,8000.00,9000.00,0.00,5440.46,0.31,1
62326,6202,1000.00,9000.00,10000.00,4500.00,4500.00,0.11,1
62327,6202,1000.00,10000.00,11000.00,0.00,10000.00,0.18,1
62328,6202,-5.77,9994.23,10994.23,5.77,0.00,0.08,0
62329,6202,1000.00,10994.23,11994.23,0.00,26.92,0.10,1
62330,6202,-1000.00,9994.23,10994.23,4499.45,0.00,0.03,0
62331,6202,-1000.00,8994.23,9994.23,4643.30,6350.93,0.13,0
62332,6202,-1000.00,7994.23,8994.23,0.00,7933.55,0.26,0
62333,6202,-1000.00,6994.23,7994.23,0.00,8994.23,0.41,0
62334,6202,-1000.00,5994.23,6994.23,0.00,6510.49,0.15,0
62335,6202,-1000.00,4994.23,5994.23,1458.32,5535.92,0.38,0
62336,6202,-1000.00,3994.23,4994.23,0.00,5994.23,0.04,0
62337,6202,-1000.00,2994.23,3994.23,2497.12,2497.12,0.03,0
62338,6202,-1000.00,1994.23,2994.23,1566.98,2427.26,0.24,0
62339,6202,-1000.00,994.23,1994.23,0.00,1606.79,0.31,0
62340,6202,-1000.00,-5.77,994.23,0.00,1994.23,0.19,0
62341,6202,-861.64,-867.41,132.59,0.00,861.64,0.36,0
62342,6202,-132.59,-1000.00,0.00,26.70,105.89,0.41,0
62343,6203,-55.11,-55.11,944.89,55.11,0.00,0.37,0
62344,6203,134.34,79.23,1079.23,0.00,1.63,0.40,1
62345,6203,1000.00,1079.23,2079.23,0.00,1079.23,0.23,1
62346,6203,0.00,1079.23,2079.23,0.00,0.00,0.17,0
62347,6203,1000.00,2079.23,3079.23,0.00,1034.42,0.30,1
62348,6203,1000.00,3079.23,4079.23,1197.29,1881.94,0.25,1
62349,6203,1000.00,4079.23,5079.23,950.30,3128.93,0.39,1
62350,6203,1000.00,5079.23,6079.23,0.00,5079.23,0.31,1
62351,6203,1000.00,6079.23,7079.23,1595.45,4483.78,0.35,1
62352,6203,1000.00,7079.23,8079.23,1129.80,5949.43,0.20,1
62353,6203,1000.00,8079.23,9079.23,1376.94,6702.29,0.31,1
62354,6203,1000.00,9079.23,10079.23,2914.81,5948.09,0.32,1
62355,6203,1000.00,10079.23,11079.23,3304.20,6775.03,0.27,1
62356,6203,1000.00,11079.23,12079.23,3562.38,7516.84,0.27,1
62357,6203,1000.00,12079.23,13079.23,5964.69,6114.53,0.11,1
62358,6203,1000.00,13079.23,14079.23,4675.22,8404.01,0.31,1
62359,6203,-1000.00,12079.23,13079.23,9681.60,4397.63,0.11,0
62360,6203,1000.00,13079.23,14079.23,4761.11,8318.11,0.23,1
62361,6203,1000.00,14079.23,15079.23,0.00,14079.23,0.27,1
62362,6203,1000.00,15079.23,16079.23,0.00,15079.23,0.23,1
62363,6203,1000.00,16079.23,17079.23,2012.80,7796.59,0.30,1
62364,6203,1000.00,17079.23,18079.23,0.00,17079.23,0.15,1
62365,6203,1000.00,18079.23,19079.23,6959.23,11120.00,0.29,1
62366,6203,-1000.00,17079.23,18079.23,2749.01,0.00,0.10,0
62367,6203,-1000.00,16079.23,17079.23,3034.30,15044.93,0.09,0
62368,6203,-1000.00,15079.23,16079.23,722.30,13565.44,0.26,0
62369,6203,-1000.00,14079.23,15079.23,0.00,10160.06,0.33,0
62370,6203,-1000.00,13079.23,14079.23,0.00,13143.06,0.39,0
62371,6203,-1000.00,12079.23,13079.23,0.00,14079.23,0.43,0
62372,6203,-1000.00,11079.23,12079.23,3075.73,10003.50,0.39,0
62373,6203,-1000.00,10079.23,11079.23,2450.64,9628.59,0.41,0
62374,6203,-1000.00,9079.23,10079.23,0.00,11079.23,0.21,0
62375,6203,0.00,9079.23,10079.23,0.00,0.00,0.05,0
62376,6203,-1000.00,8079.23,9079.23,0.00,10079.23,0.15,0
62377,6203,-1000.00,7079.23,8079.23,0.00,9079.23,0.13,0
62378,6203,-1000.00,6079.23,7079.23,265.75,7813.48,0.35,0
62379,6203,-1000.00,5079.23,6079.23,0.00,7079.23,0.12,0
62380,6203,-1000.00,4079.23,5079.23,2824.01,3255.22,0.21,0
62381,6203,-1000.00,3079.23,4079.23,0.00,5079.23,0.16,0
62382,6203,-1000.00,2079.23,3079.23,1085.80,2993.42,0.32,0
62383,6203,-1000.00,1079.23,2079.23,0.00,2744.60,0.41,0
62384,6203,0.00,1079.23,2079.23,0.00,0.00,0.02,0
62385,6203,-29.50,1049.73,2049.73,0.00,29.50,0.32,0
62386,6204,0.00,0.00,1000.00,0.00,0.00,0.36,0
62387,6204,-248.22,-248.22,751.78,242.72,5.49,0.41,0
62388,6204,1000.00,751.78,1751.78,0.00,751.78,0.18,1
62389,6204,1000.00,1751.78,2751.78,166.57,1585.22,0.33,1
62390,6204,1000.00,2751.78,3751.78,0.00,2751.78,0.10,1
62391,6204,1000.00,3751.78,4751.78,1875.89,1875.89,0.07,1
62392,6204,-1000.00,2751.78,3751.78,2400.03,2351.75,0.07,0
62393,6204,-1000.00,1751.78,2751.78,2126.65,1625.13,0.02,0
62394,6204,1000.00,2751.78,3751.78,1375.89,1375.89,0.02,1
62395,6204,1000.00,3751.78,4751.78,0.00,3751.78,0.24,1
62396,6204,1000.00,4751.78,5751.78,0.00,4498.11,0.42,1
62397,6204,1000.00,5751.78,6751.78,1278.48,1817.09,0.22,1
62398,6204,1000.00,6751.78,7751.78,724.67,6027.11,0.06,1
62399,6204,1000.00,7751.78,8751.78,0.00,3331.99,0.21,1
62400,6204,1000.00,8751.78,9751.78,2408.35,5925.42,0.34,1
62401,6204,-1000.00,7751.78,8751.78,5203.99,0.00,0.06,0
62402,6204,0.00,7751.78,8751.78,0.00,0.00,0.01,0
62403,6204,1000.00,8751.78,9751.78,0.00,8751.78,0.07,1
62404,6204,1000.00,9751.78,10751.78,0.00,9751.78,0.08,1
62405,6204,1000.00,10751.78,11751.78,3023.92,7727.86,0.18,1
62406,6204,1000.00,11751.78,12751.78,0.00,10329.98,0.09,1
62407,6204,1000.00,12751.78,13751.78,0.00,7437.51,0.27,1
62408,6204,1000.00,13751.78,14751.78,0.00,13751.78,0.31,1
62409,6204,-340.26,13411.52,14411.52,340.26,0.00,0.04,0
62410,6204,1000.00,14411.52,15411.52,7063.56,7347.96,0.12,1
62411,6204,0.00,14411.52,15411.52,0.00,0.00,0.04,0
62412,6204,1000.00,15411.52,16411.52,718.13,5768.75,0.26,1
62413,6204,-1000.00,14411.52,15411.52,13857.63,2553.89,0.04,0
62414,6204,1000.00,15411.52,16411.52,0.00,15411.52,0.01,1
62415,6204,1000.00,16411.52,17411.52,6891.01,9520.51,0.19,1
62416,6204,1000.00,17411.52,18411.52,0.00,11538.22,0.37,1
62417,6204,1000.00,18411.52,19411.52,841.15,17570.37,0.43,1
62418,6204,1000.00,19411.52,20411.52,0.00,18821.66,0.19,1
62419,6204,-1000.00,18411.52,19411.52,10396.75,10014.77,0.21,0
62420,6204,-1000.00,17411.52,18411.52,10663.28,8748.24,0.08,0
62421,6204,1000.00,18411.52,19411.52,6449.61,11961.91,0.25,1
62422,6204,-1000.00,17411.52,18411.52,13423.75,947.29,0.06,0
62423,6204,1000.00,18411.52,19411.52,3872.10,14539.42,0.16,1
62424,6204,1000.00,19411.52,20411.52,0.00,19411.52,0.11,1
62425,6204,1000.00,20411.52,21411.52,0.00,4764.77,0.03,1
62426,6204,-1000.00,19411.52,20411.52,11948.79,9462.73,0.19,0
62427,6204,1000.00,20411.52,21411.52,0.00,20411.52,0.05,1
62428,6204,1000.00,21411.52,22411.52,0.00,1816.06,0.14,1
62429,6204,1000.00,22411.52,23411.52,377.86,12920.74,0.34,1
62430,6205,1000.00,1000.00,2000.00,69.88,930.12,0.39,1
62431,6205,-1000.00,0.00,1000.00,1179.80,717.71,0.15,0
62432,6205,1000.00,1000.00,2000.00,0.00,1000.00,0.33,1
62433,6205,1000.00,2000.00,3000.00,0.00,2000.00,0.28,1
62434,6205,1000.00,3000.00,4000.00,0.00,1828.39,0.33,1
62435,6205,1000.00,4000.00,5000.00,1186.82,2813.18,0.30,1
62436,6205,1000.00,5000.00,6000.00,0.00,5000.00,0.31,1
62437,6205,1000.00,6000.00,7000.00,0.00,3202.46,0.33,1
62438,6205,1000.00,7000.00,8000.00,0.00,1636.09,0.20,1
62439,6205,1000.00,8000.00,9000.00,2407.05,5592.95,0.36,1
62440,6205,1000.00,9000.00,10000.00,0.00,9000.00,0.31,1
62441,6205,1000.00,10000.00,11000.00,0.00,8788.94,0.34,1
62442,6205,1000.00,11000.00,12000.00,0.00,11000.00,0.27,1
62443,6205,1000.00,12000.00,13000.00,0.00,7274.44,0.34,1
62444,6205,1000.00,13000.00,14000.00,0.00,5847.44,0.03,1
62445,6205,1000.00,14000.00,15000.00,0.00,14000.00,0.07,1
62446,6205,1000.00,15000.00,16000.00,0.00,15000.00,0.24,1
62447,6205,1000.00,16000.00,17000.00,0.00,5842.40,0.22,1
62448,6205,1000.00,17000.00,18000.00,0.00,17000.00,0.21,1
62449,6205,1000.00,18000.00,19000.00,0.00,18000.00,0.26,1
62450,6205,-1000.00,17000.00,18000.00,9925.79,9074.21,0.11,0
62451,6205,1000.00,18000.00,19000.00,6025.18,11974.82,0.25,1
62452,6205,1000.00,19000.00,20000.00,0.00,8706.24,0.01,1
62453,6205,1000.00,20000.00,21000.00,10000.00,10000.00,0.02,1
62454,6205,1000.00,21000.00,22000.00,0.00,21000.00,0.18,1
62455,6205,1000.00,22000.00,23000.00,1854.60,20145.40,0.44,1
62456,6205,0.00,22000.00,23000.00,0.00,0.00,0.04,0
62457,6205,1000.00,23000.00,24000.00,0.00,23000.00,0.34,1
62458,6205,1000.00,24000.00,25000.00,0.00,24000.00,0.04,1
62459,6205,0.00,24000.00,25000.00,0.00,0.00,0.03,0
62460,6205,1000.00,25000.00,26000.00,1257.42,13500.31,0.33,1
62461,6205,1000.00,26000.00,27000.00,7885.01,18114.99,0.14,1
62462,6205,-1000.00,25000.00,26000.00,18851.20,0.00,0.01,0
62463,6205,1000.00,26000.00,27000.00,8179.44,17820.56,0.07,1
62464,6205,1000.00,27000.00,28000.00,0.00,12147.37,0.14,1
62465,6205,-1000.00,26000.00,27000.00,16253.47,11746.53,0.08,0
62466,6205,1000.00,27000.00,28000.00,0.00,27000.00,0.35,1
62467,6205,1000.00,28000.00,29000.00,6009.96,21990.04,0.39,1
62468,6205,1000.00,29000.00,30000.00,8117.98,20882.02,0.33,1
62469,6205,1000.00,30000.00,31000.00,0.00,30000.00,0.11,1
62470,6205,-1000.00,29000.00,30000.00,22048.58,8951.42,0.10,0
62471,6205,1000.00,30000.00,31000.00,0.00,30000.00,0.09,1
62472,6205,1000.00,31000.00,32000.00,3732.80,27267.20,0.33,1
62473,6205,1000.00,32000.00,33000.00,0.00,30466.56,0.43,1
62474,6205,1000.00,33000.00,34000.00,8599.47,24400.53,0.28,1
62475,6205,-1000.00,32000.00,33000.00,17797.50,0.00,0.05,0
62476,6205,1000.00,33000.00,34000.00,11885.05,21114.95,0.29,1
62477,6206,-1000.00,-1000.00,0.00,29.05,970.95,0.44,0
62478,6207,-1000.00,-1000.00,0.00,169.41,830.59,0.32,0
62479,6208,1000.00,1000.00,2000.00,0.00,224.74,0.15,1
62480,6208,1000.00,2000.00,3000.00,0.00,2000.00,0.37,1
62481,6208,1000.00,3000.00,4000.00,0.00,2391.82,0.17,1
62482,6208,1000.00,4000.00,5000.00,489.58,3510.42,0.37,1
62483,6208,1000.00,5000.00,6000.00,81.20,4918.80,0.30,1
62484,6208,1000.00,6000.00,7000.00,2114.66,3885.34,0.15,1
62485,6208,1000.00,7000.00,8000.00,2267.01,4732.99,0.32,1
62486,6208,1000.00,8000.00,9000.00,2896.63,5103.37,0.32,1
62487,6208,1000.00,9000.00,10000.00,305.69,8694.31,0.25,1
62488,6208,0.00,9000.00,10000.00,0.00,0.00,0.10,0
62489,6208,1000.00,10000.00,11000.00,0.00,10000.00,0.00,1
62490,6208,1000.00,11000.00,12000.00,0.00,6137.15,0.25,1
62491,6208,1000.00,12000.00,13000.00,5860.63,6139.37,0.20,1
62492,6208,1000.00,13000.00,14000.00,0.00,13000.00,0.13,1
62493,6208,1000.00,14000.00,15000.00,7000.00,7000.00,0.02,1
62494,6208,1000.00,15000.00,16000.00,1076.02,13923.98,0.43,1
62495,6208,1000.00,16000.00,17000.00,0.00,16000.00,0.28,1
62496,6208,1000.00,17000.00,18000.00,0.00,17000.00,0.25,1
62497,6208,1000.00,18000.00,19000.00,9000.00,9000.00,0.00,1
62498,6208,1000.00,19000.00,20000.00,0.00,5337.77,0.21,1
62499,6208,1000.00,20000.00,21000.00,0.00,7606.24,0.08,1
62500,6208,1000.00,21000.00,22000.00,8524.24,12475.76,0.28,1
62501,6208,1000.00,22000.00,23000.00,10997.73,11002.27,0.05,1
62502,6208,1000.00,23000.00,24000.00,9810.20,13189.80,0.17,1
62503,6208,-1000.00,22000.00,23000.00,1226.65,0.00,0.10,0
62504,6208,1000.00,23000.00,24000.00,0.00,23000.00,0.39,1
62505,6208,1000.00,24000.00,25000.00,0.00,24000.00,0.23,1
62506,6208,1000.00,25000.00,26000.00,1969.95,21281.15,0.43,1
62507,6208,1000.00,26000.00,27000.00,13000.00,13000.00,0.04,1
62508,6208,1000.00,27000.00,28000.00,0.00,1585.61,0.10,1
62509,6208,1000.00,28000.00,29000.00,0.00,28000.00,0.21,1
62510,6208,1000.00,29000.00,30000.00,0.00,29000.00,0.36,1
62511,6208,1000.00,30000.00,31000.00,0.00,30000.00,0.32,1
62512,6208,1000.00,31000.00,32000.00,0.00,31000.00,0.27,1
62513,6208,1000.00,32000.00,33000.00,0.00,32000.00,0.41,1
62514,6208,1000.00,33000.00,34000.00,12250.96,20749.04,0.30,1
62515,6208,1000.00,34000.00,35000.00,11063.00,22937.00,0.29,1
62516,6208,1000.00,35000.00,36000.00,0.00,25991.96,0.35,1
62517,6209,1000.00,1000.00,2000.00,786.38,0.00,0.15,1
62518,6209,-1000.00,0.00,1000.00,593.27,1109.44,0.26,0
62519,6209,-969.28,-969.28,30.72,0.00,969.28,0.43,0
62520,6209,-30.72,-1000.00,0.00,0.00,30.72,0.09,0
62521,6210,-1000.00,-1000.00,0.00,0.00,84.75,0.30,0
62522,6211,0.00,0.00,1000.00,0.00,0.00,0.08,0
62523,6211,-267.28,-267.28,732.72,151.81,115.48,0.42,0
62524,6211,-1000.00,-1267.28,-267.28,0.00,732.72,0.28,0
62525,6212,1000.00,1000.00,2000.00,0.00,1000.00,0.41,1
62526,6212,1000.00,2000.00,3000.00,0.00,1899.81,0.37,1
62527,6212,1000.00,3000.00,4000.00,0.00,3000.00,0.37,1
62528,6212,1000.00,4000.00,5000.00,0.00,2779.13,0.16,1
62529,6212,1000.00,5000.00,6000.00,247.05,2889.41,0.34,1
62530,6212,1000.00,6000.00,7000.00,1912.81,4087.19,0.04,1
62531,6212,1000.00,7000.00,8000.00,1934.17,5065.83,0.31,1
62532,6212,-1000.00,6000.00,7000.00,1493.18,844.00,0.14,0
62533,6212,1000.00,7000.00,8000.00,0.00,4495.40,0.33,1
62534,6212,1000.00,8000.00,9000.00,2073.50,2780.34,0.22,1
62535,6212,1000.00,9000.00,10000.00,1181.80,7818.20,0.16,1
62536,6212,1000.00,10000.00,11000.00,0.00,10000.00,0.33,1
62537,6212,1000.00,11000.00,12000.00,5500.00,5500.00,0.07,1
62538,6212,1000.00,12000.00,13000.00,4136.93,7863.07,0.30,1
62539,6212,1000.00,13000.00,14000.00,3759.76,9240.24,0.35,1
62540,6212,1000.00,14000.00,15000.00,0.00,14000.00,0.41,1
62541,6212,1000.00,15000.00,16000.00,0.00,3662.93,0.11,1
62542,6212,1000.00,16000.00,17000.00,0.00,16000.00,0.19,1
62543,6212,1000.00,17000.00,18000.00,0.00,17000.00,0.39,1
62544,6212,1000.00,18000.00,19000.00,4660.88,13339.12,0.38,1
62545,6212,1000.00,19000.00,20000.00,0.00,19000.00,0.08,1
62546,6212,1000.00,20000.00,21000.00,0.00,20000.00,0.25,1
62547,6212,-1000.00,19000.00,20000.00,0.00,21000.00,0.11,0
62548,6212,-1000.00,18000.00,19000.00,1592.76,18407.24,0.38,0
62549,6212,-1000.00,17000.00,18000.00,0.00,12138.71,0.29,0
62550,6212,-1000.00,16000.00,17000.00,7294.93,10705.07,0.20,0
62551,6212,-1000.00,15000.00,16000.00,0.00,17000.00,0.22,0
62552,6212,-1000.00,14000.00,15000.00,0.00,13610.72,0.10,0
62553,6212,-1000.00,13000.00,14000.00,5724.22,9275.78,0.30,0
62554,6212,-1000.00,12000.00,13000.00,6789.73,7210.27,0.16,0
62555,6212,-1000.00,11000.00,12000.00,5830.97,7169.03,0.03,0
62556,6212,-1000.00,10000.00,11000.00,8306.64,3693.36,0.08,0
62557,6212,0.00,10000.00,11000.00,0.00,0.00,0.01,0
62558,6212,-1000.00,9000.00,10000.00,4567.74,2031.97,0.14,0
62559,6212,-1000.00,8000.00,9000.00,0.00,6150.63,0.25,0
62560,6212,-1000.00,7000.00,8000.00,1827.87,7172.13,0.12,0
62561,6212,-1000.00,6000.00,7000.00,1702.47,6297.53,0.26,0
62562,6212,-1000.00,5000.00,6000.00,5863.52,1136.48,0.05,0
62563,6212,-1000.00,4000.00,5000.00,0.00,6000.00,0.14,0
62564,6212,-1000.00,3000.00,4000.00,172.99,4827.01,0.34,0
62565,6212,-1000.00,2000.00,3000.00,0.00,3695.03,0.22,0
62566,6212,-1000.00,1000.00,2000.00,157.41,1605.87,0.33,0
62567,6212,1000.00,2000.00,3000.00,378.03,1621.97,0.19,1
62568,6212,1000.00,3000.00,4000.00,0.00,1205.69,0.07,1
62569,6212,1000.00,4000.00,5000.00,0.00,1774.11,0.28,1
62570,6212,0.00,4000.00,5000.00,0.00,0.00,0.04,0
62571,6212,-1000.00,3000.00,4000.00,0.00,5000.00,0.22,0
62572,6212,-1000.00,2000.00,3000.00,1860.36,475.46,0.32,0
62573,6212,-1000.00,1000.00,2000.00,3000.00,0.00,0.01,0
62574,6212,-1000.00,0.00,1000.00,357.05,1642.95,0.39,0
62575,6212,-1000.00,-1000.00,0.00,0.00,1000.00,0.03,0
62576,6213,-1000.00,-1000.00,0.00,0.00,34.69,0.43,0
62577,6214,1000.00,1000.00,2000.00,94.91,905.09,0.17,1
62578,6214,1000.00,2000.00,3000.00,424.48,1575.52,0.40,1
62579,6214,1000.00,3000.00,4000.00,0.00,3000.00,0.44,1
62580,6214,1000.00,4000.00,5000.00,0.00,4000.00,0.40,1
62581,6214,1000.00,5000.00,6000.00,0.00,5000.00,0.41,1
62582,6214,1000.00,6000.00,7000.00,0.00,4737.50,0.18,1
62583,6214,1000.00,7000.00,8000.00,2264.96,4735.04,0.22,1
62584,6214,1000.00,8000.00,9000.00,67.39,1908.62,0.20,1
62585,6214,1000.00,9000.00,10000.00,3897.08,5102.92,0.19,1
62586,6214,1000.00,10000.00,11000.00,1988.33,8011.67,0.21,1
62587,6214,1000.00,11000.00,12000.00,0.00,6411.29,0.16,1
62588,6214,1000.00,12000.00,13000.00,6000.00,6000.00,0.03,1
62589,6214,1000.00,13000.00,14000.00,4054.01,8945.99,0.33,1
62590,6214,1000.00,14000.00,15000.00,6576.95,7423.05,0.06,1
62591,6214,1000.00,15000.00,16000.00,0.00,15000.00,0.24,1
62592,6214,1000.00,16000.00,17000.00,0.00,14088.83,0.21,1
62593,6214,-1000.00,15000.00,16000.00,10925.61,6074.39,0.08,0
62594,6214,1000.00,16000.00,17000.00,6441.43,9558.57,0.26,1
62595,6214,1000.00,17000.00,18000.00,8418.60,8581.40,0.14,1
62596,6214,1000.00,18000.00,19000.00,0.00,18000.00,0.37,1
62597,6214,1000.00,19000.00,20000.00,0.00,19000.00,0.15,1
62598,6214,1000.00,20000.00,21000.00,2140.20,17859.80,0.36,1
62599,6214,-1000.00,19000.00,20000.00,17503.01,0.00,0.02,0
62600,6214,1000.00,20000.00,21000.00,0.00,10190.41,0.24,1
62601,6214,-1000.00,19000.00,20000.00,5442.20,15557.80,0.37,0
62602,6214,-1000.00,18000.00,19000.00,16202.88,3797.12,0.01,0
62603,6214,-1000.00,17000.00,18000.00,0.00,19000.00,0.07,0
62604,6214,-1000.00,16000.00,17000.00,1442.17,16557.83,0.44,0
62605,6214,-1000.00,15000.00,16000.00,13810.24,3189.76,0.04,0
62606,6214,-1000.00,14000.00,15000.00,3480.74,12519.26,0.34,0
62607,6214,-1000.00,13000.00,14000.00,0.00,11150.09,0.37,0
62608,6214,-1000.00,12000.00,13000.00,4555.72,9444.28,0.07,0
62609,6214,-1000.00,11000.00,12000.00,8252.80,0.00,0.04,0
62610,6214,-1000.00,10000.00,11000.00,0.00,10230.38,0.40,0
62611,6214,-1000.00,9000.00,10000.00,5500.00,5500.00,0.03,0
62612,6214,-1000.00,8000.00,9000.00,0.00,9802.55,0.09,0
62613,6214,-1000.00,7000.00,8000.00,1574.85,6837.45,0.39,0
62614,6214,-1000.00,6000.00,7000.00,0.00,8000.00,0.20,0
62615,6214,-1000.00,5000.00,6000.00,0.00,5483.70,0.18,0
62616,6214,-1000.00,4000.00,5000.00,0.00,6000.00,0.18,0
62617,6214,-1000.00,3000.00,4000.00,0.00,3983.37,0.09,0
62618,6214,-1000.00,2000.00,3000.00,0.00,3935.27,0.44,0
62619,6214,-1000.00,1000.00,2000.00,871.17,2128.83,0.23,0
62620,6214,-1000.00,0.00,1000.00,0.00,1772.09,0.22,0
62621,6214,-1000.00,-1000.00,0.00,194.46,805.54,0.39,0
62622,6215,-436.84,-436.84,563.16,0.00,436.84,0.30,0
62623,6215,-22.70,-459.54,540.46,0.00,22.70,0.41,0
62624,6215,0.00,-459.54,540.46,0.00,0.00,0.30,0
62625,6215,-540.46,-1000.00,0.00,0.00,540.46,0.02,0
62626,6216,1000.00,1000.00,2000.00,374.91,625.09,0.24,1
62627,6216,1000.00,2000.00,3000.00,0.00,1984.43,0.10,1
62628,6216,1000.00,3000.00,4000.00,1.45,1780.64,0.35,1
62629,6216,1000.00,4000.00,5000.00,361.47,3638.53,0.14,1
62630,6216,1000.00,5000.00,6000.00,0.00,5000.00,0.22,1
62631,6216,1000.00,6000.00,7000.00,0.00,6000.00,0.00,1
62632,6216,-1000.00,5000.00,6000.00,2127.12,0.00,0.06,0
62633,6216,1000.00,6000.00,7000.00,0.00,6000.00,0.17,1
62634,6216,1000.00,7000.00,8000.00,0.00,7000.00,0.05,1
62635,6216,1000.00,8000.00,9000.00,0.00,8000.00,0.36,1
62636,6216,1000.00,9000.00,10000.00,3387.31,5612.69,0.21,1
62637,6216,1000.00,10000.00,11000.00,0.00,10000.00,0.00,1
62638,6216,1000.00,11000.00,12000.00,833.25,10166.75,0.14,1
62639,6216,1000.00,12000.00,13000.00,0.00,12000.00,0.13,1
62640,6216,1000.00,13000.00,14000.00,998.37,12001.63,0.23,1
62641,6216,1000.00,14000.00,15000.00,0.00,4425.38,0.16,1
62642,6216,1000.00,15000.00,16000.00,782.56,6594.83,0.28,1
62643,6216,1000.00,16000.00,17000.00,0.00,5400.33,0.23,1
62644,6216,1000.00,17000.00,18000.00,6047.81,10952.19,0.21,1
62645,6216,1000.00,18000.00,19000.00,0.00,18000.00,0.28,1
62646,6216,1000.00,19000.00,20000.00,0.00,19000.00,0.05,1
62647,6216,1000.00,20000.00,21000.00,0.00,20000.00,0.06,1
62648,6216,1000.00,21000.00,22000.00,8069.20,12930.80,0.29,1
62649,6216,1000.00,22000.00,23000.00,9262.79,12252.09,0.26,1
62650,6216,1000.00,23000.00,24000.00,0.00,18550.51,0.41,1
62651,6216,1000.00,24000.00,25000.00,0.00,7577.12,0.23,1
62652,6216,1000.00,25000.00,26000.00,0.00,25000.00,0.23,1
62653,6216,1000.00,26000.00,27000.00,0.00,5080.98,0.16,1
62654,6216,-1000.00,25000.00,26000.00,20520.65,5289.11,0.08,0
62655,6216,1000.00,26000.00,27000.00,0.00,26000.00,0.26,1
62656,6216,0.00,26000.00,27000.00,0.00,0.00,0.08,0
62657,6216,-1000.00,25000.00,26000.00,12408.29,14591.71,0.25,0
62658,6216,-1000.00,24000.00,25000.00,5523.51,11404.43,0.27,0
62659,6216,-1000.00,23000.00,24000.00,15842.29,5335.77,0.11,0
62660,6216,-1000.00,22000.00,23000.00,0.00,11932.19,0.11,0
62661,6216,-1000.00,21000.00,22000.00,0.00,23000.00,0.17,0
62662,6216,-1000.00,20000.00,21000.00,0.00,22000.00,0.36,0
62663,6216,-1000.00,19000.00,20000.00,14103.44,6896.56,0.03,0
62664,6216,-1000.00,18000.00,19000.00,13258.80,6741.20,0.12,0
62665,6216,-1000.00,17000.00,18000.00,1766.99,17233.01,0.20,0
62666,6216,-1000.00,16000.00,17000.00,0.00,5941.85,0.23,0
62667,6217,-1000.00,-1000.00,0.00,412.90,587.10,0.20,0
62668,6218,1000.00,1000.00,2000.00,500.00,500.00,0.05,1
62669,6218,-1000.00,0.00,1000.00,449.01,1550.99,0.30,0
62670,6218,-1000.00,-1000.00,0.00,339.32,660.68,0.07,0
62671,6219,0.00,0.00,1000.00,0.00,0.00,0.10,0
62672,6219,-215.53,-215.53,784.47,215.53,0.00,0.38,0
62673,6219,-1000.00,-1215.53,-215.53,0.00,784.47,0.20,0
62674,6220,-1000.00,-1000.00,0.00,0.00,1000.00,0.39,0
62675,6221,-1000.00,-1000.00,0.00,34.33,934.41,0.13,0
62676,6222,0.00,0.00,1000.00,0.00,0.00,0.03,0
62677,6222,-876.14,-876.14,123.86,60.99,815.15,0.20,0
62678,6222,0.00,-876.14,123.86,0.00,0.00,0.25,0
62679,6222,1000.00,123.86,1123.86,73.10,0.00,0.06,1
62680,6222,-738.89,-615.03,384.97,0.00,738.89,0.37,0
62681,6222,-384.97,-1000.00,0.00,162.32,222.65,0.10,0
62682,6223,-319.82,-319.82,680.18,319.82,0.00,0.28,0
62683,6223,0.00,-319.82,680.18,0.00,0.00,0.16,0
62684,6223,-1000.00,-1319.82,-319.82,53.41,189.42,0.39,0
62685,6224,1000.00,1000.00,2000.00,92.76,705.54,0.39,1
62686,6224,1000.00,2000.00,3000.00,0.00,948.42,0.23,1
62687,6224,1000.00,3000.00,4000.00,1025.89,1974.11,0.24,1
62688,6224,1000.00,4000.00,5000.00,0.00,4000.00,0.19,1
62689,6224,1000.00,5000.00,6000.00,911.45,4088.55,0.17,1
62690,6224,1000.00,6000.00,7000.00,549.28,4799.29,0.41,1
62691,6224,1000.00,7000.00,8000.00,0.00,2925.92,0.27,1
62692,6224,1000.00,8000.00,9000.00,1255.53,6744.47,0.25,1
62693,6224,1000.00,9000.00,10000.00,4500.00,4500.00,0.01,1
62694,6224,1000.00,10000.00,11000.00,997.70,8074.02,0.41,1
62695,6224,1000.00,11000.00,12000.00,0.00,9810.79,0.41,1
62696,6224,1000.00,12000.00,13000.00,2107.11,9892.89,0.42,1
62697,6224,1000.00,13000.00,14000.00,640.12,9787.63,0.40,1
62698,6224,1000.00,14000.00,15000.00,0.00,14000.00,0.13,1
62699,6224,1000.00,15000.00,16000.00,5561.38,9438.62,0.31,1
62700,6224,1000.00,16000.00,17000.00,0.00,16000.00,0.01,1
62701,6224,-1000.00,15000.00,16000.00,13154.12,3845.88,0.06,0
62702,6224,1000.00,16000.00,17000.00,979.59,1534.19,0.14,1
62703,6224,1000.00,17000.00,18000.00,0.00,17000.00,0.07,1
62704,6224,1000.00,18000.00,19000.00,0.00,9629.36,0.29,1
62705,6224,1000.00,19000.00,20000.00,0.00,19000.00,0.01,1
62706,6224,1000.00,20000.00,21000.00,0.00,19209.16,0.44,1
62707,6224,1000.00,21000.00,22000.00,0.00,21000.00,0.27,1
62708,6224,1000.00,22000.00,23000.00,0.00,13647.24,0.12,1
62709,6224,1000.00,23000.00,24000.00,8692.54,14307.46,0.26,1
62710,6224,1000.00,24000.00,25000.00,4026.66,19973.34,0.38,1
62711,6224,1000.00,25000.00,26000.00,0.00,25000.00,0.33,1
62712,6224,1000.00,26000.00,27000.00,3949.38,22050.62,0.24,1
62713,6224,1000.00,27000.00,28000.00,0.00,14228.56,0.25,1
62714,6224,1000.00,28000.00,29000.00,0.00,13168.71,0.29,1
62715,6224,1000.00,29000.00,30000.00,12286.39,16713.61,0.27,1
62716,6224,1000.00,30000.00,31000.00,1291.27,6507.92,0.19,1
62717,6224,1000.00,31000.00,32000.00,13465.52,17534.48,0.26,1
62718,6224,1000.00,32000.00,33000.00,487.16,25142.13,0.41,1
62719,6224,1000.00,33000.00,34000.00,0.00,33000.00,0.14,1
62720,6224,1000.00,34000.00,35000.00,0.00,34000.00,0.07,1
62721,6224,1000.00,35000.00,36000.00,0.00,35000.00,0.18,1
62722,6224,-1000.00,34000.00,35000.00,24061.99,11938.01,0.01,0
62723,6224,-1000.00,33000.00,34000.00,19436.02,15563.98,0.15,0
62724,6224,1000.00,34000.00,35000.00,0.00,11084.99,0.21,1
62725,6224,0.00,34000.00,35000.00,0.00,0.00,0.10,0
62726,6224,1000.00,35000.00,36000.00,0.00,5780.91,0.00,1
62727,6224,1000.00,36000.00,37000.00,0.00,16925.84,0.29,1
62728,6225,-1000.00,-1000.00,0.00,0.00,1000.00,0.26,0
62729,6226,1000.00,1000.00,2000.00,481.84,518.16,0.13,1
62730,6226,1000.00,2000.00,3000.00,0.00,627.77,0.04,1
62731,6226,1000.00,3000.00,4000.00,1214.00,1786.00,0.14,1
62732,6226,1000.00,4000.00,5000.00,993.52,3006.48,0.33,1
62733,6226,1000.00,5000.00,6000.00,0.00,5000.00,0.28,1
62734,6226,1000.00,6000.00,7000.00,0.00,4720.97,0.11,1
62735,6226,1000.00,7000.00,8000.00,2861.21,4138.79,0.20,1
62736,6226,1000.00,8000.00,9000.00,0.00,540.74,0.12,1
62737,6226,1000.00,9000.00,10000.00,0.00,6758.23,0.13,1
62738,6226,1000.00,10000.00,11000.00,3303.35,6696.65,0.33,1
62739,6226,1000.00,11000.00,12000.00,0.00,11000.00,0.31,1
62740,6226,0.00,11000.00,12000.00,0.00,0.00,0.06,0
62741,6226,1000.00,12000.00,13000.00,3301.39,8698.61,0.37,1
62742,6226,1000.00,13000.00,14000.00,0.00,13000.00,0.31,1
62743,6226,1000.00,14000.00,15000.00,0.00,14000.00,0.22,1
62744,6226,1000.00,15000.00,16000.00,7500.00,7500.00,0.09,1
62745,6226,1000.00,16000.00,17000.00,1982.87,7153.08,0.28,1
62746,6226,-1000.00,15000.00,16000.00,4961.58,12038.42,0.21,0
62747,6226,-1000.00,14000.00,15000.00,0.00,9892.28,0.18,0
62748,6226,-1000.00,13000.00,14000.00,3728.97,11271.03,0.13,0
62749,6226,-1000.00,12000.00,13000.00,1886.65,12113.35,0.40,0
62750,6226,-1000.00,11000.00,12000.00,0.00,13000.00,0.02,0
62751,6226,-1000.00,10000.00,11000.00,0.00,4687.93,0.16,0
62752,6226,-1000.00,9000.00,10000.00,3442.68,7557.32,0.33,0
62753,6226,-1000.00,8000.00,9000.00,6729.59,3270.41,0.08,0
62754,6226,-1000.00,7000.00,8000.00,913.93,8086.07,0.41,0
62755,6226,-1000.00,6000.00,7000.00,0.00,8000.00,0.41,0
62756,6226,-1000.00,5000.00,6000.00,0.00,7000.00,0.29,0
62757,6226,-1000.00,4000.00,5000.00,1829.05,3155.01,0.28,0
62758,6226,-1000.00,3000.00,4000.00,0.00,2698.67,0.33,0
62759,6226,-1000.00,2000.00,3000.00,1980.17,2019.83,0.20,0
62760,6226,-1000.00,1000.00,2000.00,734.57,2265.43,0.13,0
62761,6226,-1000.00,0.00,1000.00,168.79,1831.21,0.43,0
62762,6226,-994.40,-994.40,5.60,0.00,994.40,0.34,0
62763,6226,-4.10,-998.50,1.50,0.77,3.33,0.34,0
62764,6226,-1.50,-1000.00,0.00,0.75,0.75,0.00,0
62765,6227,0.00,0.00,1000.00,0.00,0.00,0.07,0
62766,6227,-577.77,-577.77,422.23,0.00,577.77,0.21,0
62767,6227,-422.23,-1000.00,0.00,32.11,390.12,0.27,0
62768,6228,1000.00,1000.00,2000.00,820.74,162.68,0.17,1
62769,6228,1000.00,2000.00,3000.00,708.30,0.00,0.37,1
62770,6228,-1000.00,1000.00,2000.00,0.00,2404.51,0.13,0
62771,6228,1000.00,2000.00,3000.00,1340.48,659.52,0.16,1
62772,6228,-1000.00,1000.00,2000.00,0.00,1783.29,0.22,0
62773,6228,1000.00,2000.00,3000.00,2000.00,0.00,0.02,1
62774,6228,-434.45,1565.55,2565.55,0.00,434.45,0.10,0
62775,6228,-1000.00,565.55,1565.55,760.05,1805.50,0.20,0
62776,6228,-1000.00,-434.45,565.55,0.00,1565.55,0.42,0
62777,6228,-565.55,-1000.00,-0.00,39.42,526.14,0.06,0
62778,6229,-461.86,-461.86,538.14,0.00,461.86,0.22,0
62779,6229,0.00,-461.86,538.14,0.00,0.00,0.16,0
62780,6229,1000.00,538.14,1538.14,279.48,258.66,0.21,1
62781,6229,1000.00,1538.14,2538.14,514.65,0.00,0.32,1
62782,6229,1000.00,2538.14,3538.14,622.55,0.00,0.31,1
62783,6229,1000.00,3538.14,4538.14,1521.82,0.00,0.34,1
62784,6229,-1000.00,2538.14,3538.14,0.00,3040.85,0.12,0
62785,6229,-1000.00,1538.14,2538.14,0.00,1738.43,0.29,0
62786,6229,1000.00,2538.14,3538.14,1679.49,296.71,0.08,1
62787,6229,-1000.00,1538.14,2538.14,0.00,3168.30,0.12,0
62788,6229,1000.00,2538.14,3538.14,1557.35,707.53,0.24,1
62789,6229,0.00,2538.14,3538.14,0.00,0.00,0.22,0
62790,6229,-1000.00,1538.14,2538.14,0.00,2059.67,0.20,0
62791,6229,-1000.00,538.14,1538.14,1153.86,1384.28,0.17,0
62792,6229,-1000.00,-461.86,538.14,0.00,1092.19,0.10,0
62793,6229,-538.14,-1000.00,0.00,0.00,538.14,0.03,0
62794,6230,-365.74,-365.74,634.26,0.00,365.74,0.25,0
62795,6230,-634.26,-1000.00,0.00,94.35,539.91,0.12,0
62796,6231,-743.15,-743.15,256.85,743.15,0.00,0.13,0
62797,6231,0.00,-743.15,256.85,0.00,0.00,0.33,0
62798,6231,-256.85,-1000.00,0.00,168.65,88.19,0.10,0
62799,6232,-886.23,-886.23,113.77,0.00,886.23,0.43,0
62800,6232,-113.77,-1000.00,0.00,0.00,113.77,0.31,0
62801,6233,-983.96,-983.96,16.04,401.61,582.35,0.28,0
62802,6233,-16.04,-1000.00,0.00,0.00,16.04,0.28,0
62803,6234,-1000.00,-1000.00,0.00,617.98,360.87,0.15,0
62804,6235,-1000.00,-1000.00,0.00,0.00,1000.00,0.10,0
62805,6236,-48.77,-48.77,951.23,48.77,0.00,0.38,0
62806,6236,-363.34,-412.10,587.90,363.34,0.00,0.36,0
62807,6236,1000.00,587.90,1587.90,0.00,330.68,0.34,1
62808,6236,1000.00,1587.90,2587.90,222.41,1365.48,0.13,1
62809,6236,1000.00,2587.90,3587.90,475.24,2112.65,0.15,1
62810,6236,1000.00,3587.90,4587.90,0.00,2281.07,0.33,1
62811,6236,1000.00,4587.90,5587.90,1905.50,2682.39,0.13,1
62812,6236,1000.00,5587.90,6587.90,0.00,2780.73,0.31,1
62813,6236,1000.00,6587.90,7587.90,1140.52,5447.38,0.10,1
62814,6236,1000.00,7587.90,8587.90,3472.09,4115.80,0.25,1
62815,6236,1000.00,8587.90,9587.90,2546.00,6041.90,0.27,1
62816,6236,1000.00,9587.90,10587.90,3702.53,5885.37,0.17,1
62817,6236,1000.00,10587.90,11587.90,0.00,8709.39,0.39,1
62818,6236,1000.00,11587.90,12587.90,1219.44,10368.46,0.14,1
62819,6236,1000.00,12587.90,13587.90,6146.23,6441.67,0.02,1
62820,6236,1000.00,13587.90,14587.90,0.00,13587.56,0.43,1
62821,6236,1000.00,14587.90,15587.90,4369.77,10218.13,0.35,1
62822,6236,1000.00,15587.90,16587.90,0.00,13839.43,0.36,1
62823,6236,1000.00,16587.90,17587.90,5092.27,11495.63,0.32,1
62824,6236,1000.00,17587.90,18587.90,6364.09,11223.80,0.31,1
62825,6236,1000.00,18587.90,19587.90,0.00,5252.79,0.15,1
62826,6236,1000.00,19587.90,20587.90,6372.22,13215.68,0.09,1
62827,6236,1000.00,20587.90,21587.90,8463.78,12124.12,0.22,1
62828,6236,1000.00,21587.90,22587.90,0.00,21587.90,0.09,1
62829,6236,1000.00,22587.90,23587.90,0.00,22587.90,0.12,1
62830,6236,1000.00,23587.90,24587.90,0.00,23587.90,0.42,1
62831,6236,1000.00,24587.90,25587.90,6102.95,18484.94,0.22,1
62832,6236,1000.00,25587.90,26587.90,7182.47,18405.43,0.36,1
62833,6236,1000.00,26587.90,27587.90,0.00,12181.47,0.13,1
62834,6236,1000.00,27587.90,28587.90,8923.42,18664.48,0.31,1
62835,6236,1000.00,28587.90,29587.90,4632.45,23955.44,0.42,1
62836,6236,1000.00,29587.90,30587.90,2015.63,27572.26,0.44,1
62837,6236,1000.00,30587.90,31587.90,9836.98,20574.35,0.38,1
62838,6236,1000.00,31587.90,32587.90,7273.11,24314.79,0.38,1
62839,6236,1000.00,32587.90,33587.90,14469.33,18118.57,0.26,1
62840,6236,1000.00,33587.90,34587.90,9013.09,24574.81,0.26,1
62841,6236,1000.00,34587.90,35587.90,0.00,34587.90,0.08,1
62842,6236,1000.00,35587.90,36587.90,14681.49,17163.63,0.24,1
62843,6236,1000.00,36587.90,37587.90,0.00,36587.90,0.18,1
62844,6236,1000.00,37587.90,38587.90,18793.95,18793.95,0.08,1
62845,6236,1000.00,38587.90,39587.90,364.33,38223.57,0.40,1
62846,6237,-376.93,-376.93,623.07,0.00,376.93,0.08,0
62847,6237,-1000.00,-1376.93,-376.93,197.69,0.00,0.02,0
62848,6238,1000.00,1000.00,2000.00,0.00,1000.00,0.25,1
62849,6238,1000.00,2000.00,3000.00,399.76,1266.96,0.35,1
62850,6238,1000.00,3000.00,4000.00,0.00,1585.19,0.30,1
62851,6238,1000.00,4000.00,5000.00,1630.39,2369.61,0.27,1
62852,6238,1000.00,5000.00,6000.00,0.00,3924.73,0.38,1
62853,6238,1000.00,6000.00,7000.00,1062.49,4656.26,0.39,1
62854,6238,-1000.00,5000.00,6000.00,2343.40,1831.69,0.18,0
62855,6238,1000.00,6000.00,7000.00,1837.31,4162.69,0.34,1
62856,6238,1000.00,7000.00,8000.00,0.00,6815.09,0.39,1
62857,6238,1000.00,8000.00,9000.00,876.50,7123.50,0.18,1
62858,6238,1000.00,9000.00,10000.00,0.00,9000.00,0.10,1
62859,6238,1000.00,10000.00,11000.00,0.00,8791.11,0.20,1
62860,6238,1000.00,11000.00,12000.00,0.00,11000.00,0.18,1
62861,6238,1000.00,12000.00,13000.00,3505.10,8494.90,0.35,1
62862,6238,-1000.00,11000.00,12000.00,1886.80,1092.62,0.13,0
62863,6238,1000.00,12000.00,13000.00,0.00,12000.00,0.35,1
62864,6238,1000.00,13000.00,14000.00,2212.31,10787.69,0.40,1
62865,6238,1000.00,14000.00,15000.00,1466.78,12390.40,0.43,1
62866,6238,1000.00,15000.00,16000.00,666.95,6222.86,0.27,1
62867,6238,1000.00,16000.00,17000.00,7102.39,8897.61,0.10,1
62868,6238,1000.00,17000.00,18000.00,0.00,7071.98,0.27,1
62869,6238,1000.00,18000.00,19000.00,0.00,14544.37,0.02,1
62870,6238,-1000.00,17000.00,18000.00,5622.64,696.34,0.11,0
62871,6238,1000.00,18000.00,19000.00,7576.43,10423.57,0.07,1
62872,6238,1000.00,19000.00,20000.00,0.00,10633.35,0.18,1
62873,6238,1000.00,20000.00,21000.00,9967.45,10032.55,0.10,1
62874,6238,1000.00,21000.00,22000.00,4425.84,16574.16,0.39,1
62875,6238,1000.00,22000.00,23000.00,5043.65,16956.35,0.33,1
62876,6238,-1000.00,21000.00,22000.00,19583.29,1849.69,0.05,0
62877,6238,1000.00,22000.00,23000.00,0.00,22000.00,0.07,1
62878,6238,1000.00,23000.00,24000.00,0.00,9128.26,0.19,1
62879,6238,1000.00,24000.00,25000.00,0.00,24000.00,0.29,1
62880,6238,1000.00,25000.00,26000.00,3216.40,21783.60,0.42,1
62881,6238,1000.00,26000.00,27000.00,11814.37,14185.63,0.11,1
62882,6238,1000.00,27000.00,28000.00,0.00,24192.92,0.26,1
62883,6238,1000.00,28000.00,29000.00,3072.84,6709.52,0.19,1
62884,6238,-1000.00,27000.00,28000.00,26717.67,0.00,0.02,0
62885,6238,-1000.00,26000.00,27000.00,16041.92,11958.08,0.13,0
62886,6238,1000.00,27000.00,28000.00,7074.04,19925.96,0.31,1
62887,6238,1000.00,28000.00,29000.00,0.00,20458.83,0.33,1
62888,6238,1000.00,29000.00,30000.00,2789.55,26210.45,0.35,1
62889,6238,1000.00,30000.00,31000.00,2626.39,27373.61,0.17,1
62890,6238,1000.00,31000.00,32000.00,6957.07,24042.93,0.33,1
62891,6238,1000.00,32000.00,33000.00,15177.68,16822.32,0.24,1
62892,6238,1000.00,33000.00,34000.00,10740.95,22259.05,0.30,1
62893,6239,-661.85,-661.85,338.15,0.00,661.85,0.09,0
62894,6239,-212.83,-874.68,125.32,0.00,212.83,0.34,0
62895,6239,-7.08,-881.76,118.24,0.00,7.08,0.12,0
62896,6239,-118.24,-1000.00,0.00,12.05,106.19,0.13,0
62897,6240,-375.96,-375.96,624.04,0.00,1.31,0.36,0
62898,6240,0.00,-375.96,624.04,0.00,0.00,0.39,0
62899,6240,0.00,-375.96,624.04,0.00,0.00,0.15,0
62900,6240,-58.40,-434.37,565.63,58.40,0.00,0.07,0
62901,6240,-1000.00,-1434.37,-434.37,0.00,565.63,0.06,0
62902,6241,-1000.00,-1000.00,0.00,581.12,418.88,0.14,0
62903,6242,-244.34,-244.34,755.66,244.34,0.00,0.09,0
62904,6242,1000.00,755.66,1755.66,0.00,420.06,0.33,1
62905,6242,1000.00,1755.66,2755.66,0.00,1480.94,0.35,1
62906,6242,1000.00,2755.66,3755.66,533.37,2222.29,0.18,1
62907,6242,1000.00,3755.66,4755.66,0.00,1879.84,0.26,1
62908,6242,0.00,3755.66,4755.66,0.00,0.00,0.08,0
62909,6242,1000.00,4755.66,5755.66,1113.62,3642.04,0.38,1
62910,6242,1000.00,5755.66,6755.66,2308.89,3446.77,0.23,1
62911,6242,-1000.00,4755.66,5755.66,3436.20,760.86,0.10,0
62912,6242,1000.00,5755.66,6755.66,800.69,4954.97,0.42,1
62913,6242,1000.00,6755.66,7755.66,3105.69,3649.97,0.22,1
62914,6242,1000.00,7755.66,8755.66,0.00,6872.58,0.43,1
62915,6242,1000.00,8755.66,9755.66,0.00,8755.66,0.42,1
62916,6242,1000.00,9755.66,10755.66,3983.44,5772.22,0.28,1
62917,6242,-1000.00,8755.66,9755.66,6333.96,4421.70,0.17,0
62918,6242,-1000.00,7755.66,8755.66,4019.99,5735.67,0.26,0
62919,6242,-1000.00,6755.66,7755.66,0.00,7287.87,0.41,0
62920,6242,-1000.00,5755.66,6755.66,0.00,7755.66,0.29,0
62921,6242,-1000.00,4755.66,5755.66,0.00,6755.66,0.09,0
62922,6242,0.00,4755.66,5755.66,0.00,0.00,0.01,0
62923,6242,-1000.00,3755.66,4755.66,3003.49,2752.17,0.20,0
62924,6242,-1000.00,2755.66,3755.66,310.03,4445.62,0.19,0
62925,6242,-1000.00,1755.66,2755.66,1604.85,2150.80,0.10,0
62926,6242,-1000.00,755.66,1755.66,0.00,2755.66,0.18,0
62927,6242,0.00,755.66,1755.66,0.00,0.00,0.01,0
62928,6242,-1000.00,-244.34,755.66,0.00,1381.54,0.11,0
62929,6242,-130.55,-374.89,625.11,0.00,130.55,0.10,0
62930,6242,-625.11,-1000.00,0.00,0.00,625.11,0.25,0
62931,6243,-1000.00,-1000.00,0.00,224.72,775.28,0.38,0
62932,6244,1000.00,1000.00,2000.00,399.68,600.32,0.20,1
62933,6244,1000.00,2000.00,3000.00,780.17,1219.83,0.06,1
62934,6244,1000.00,3000.00,4000.00,0.00,3000.00,0.14,1
62935,6244,1000.00,4000.00,5000.00,0.00,4000.00,0.15,1
62936,6244,1000.00,5000.00,6000.00,0.00,4942.82,0.31,1
62937,6244,1000.00,6000.00,7000.00,0.00,1701.03,0.14,1
62938,6244,1000.00,7000.00,8000.00,1863.38,5136.62,0.32,1
62939,6244,1000.00,8000.00,9000.00,1917.17,6082.83,0.39,1
62940,6244,-359.09,7640.91,8640.91,359.09,0.00,0.09,0
62941,6244,1000.00,8640.91,9640.91,0.00,8640.91,0.35,1
62942,6244,1000.00,9640.91,10640.91,0.00,9640.91,0.33,1
62943,6244,1000.00,10640.91,11640.91,0.00,1449.80,0.16,1
62944,6244,1000.00,11640.91,12640.91,0.00,11640.91,0.12,1
62945,6244,1000.00,12640.91,13640.91,0.00,12640.91,0.31,1
62946,6244,1000.00,13640.91,14640.91,5506.91,8133.99,0.28,1
62947,6244,1000.00,14640.91,15640.91,957.15,13683.75,0.44,1
62948,6244,1000.00,15640.91,16640.91,0.00,15640.91,0.15,1
62949,6244,1000.00,16640.91,17640.91,0.00,16640.91,0.15,1
62950,6244,1000.00,17640.91,18640.91,0.00,17640.91,0.07,1
62951,6244,1000.00,18640.91,19640.91,3708.65,14932.26,0.39,1
62952,6244,0.00,18640.91,19640.91,0.00,0.00,0.06,0
62953,6244,1000.00,19640.91,20640.91,7709.05,11931.86,0.29,1
62954,6244,1000.00,20640.91,21640.91,0.00,20640.91,0.15,1
62955,6244,1000.00,21640.91,22640.91,0.00,10552.22,0.23,1
62956,6244,1000.00,22640.91,23640.91,9441.93,13198.98,0.20,1
62957,6244,1000.00,23640.91,24640.91,0.00,4636.51,0.13,1
62958,6244,1000.00,24640.91,25640.91,11369.87,13271.04,0.22,1
62959,6244,-1000.00,23640.91,24640.91,22306.51,3334.40,0.05,0
62960,6244,1000.00,24640.91,25640.91,6435.91,18205.00,0.18,1
62961,6244,1000.00,25640.91,26640.91,8984.11,16656.80,0.21,1
62962,6244,1000.00,26640.91,27640.91,8851.81,17789.09,0.25,1
62963,6244,1000.00,27640.91,28640.91,0.00,17233.71,0.12,1
62964,6244,1000.00,28640.91,29640.91,0.00,28640.91,0.00,1
62965,6244,1000.00,29640.91,30640.91,101.83,29539.08,0.41,1
62966,6244,1000.00,30640.91,31640.91,0.00,29378.63,0.17,1
62967,6244,1000.00,31640.91,32640.91,0.00,31640.91,0.21,1
62968,6244,1000.00,32640.91,33640.91,0.00,2926.00,0.00,1
62969,6244,1000.00,33640.91,34640.91,9138.43,17360.10,0.29,1
62970,6244,-1000.00,32640.91,33640.91,32283.33,2341.77,0.04,0
62971,6244,1000.00,33640.91,34640.91,10924.06,22716.85,0.26,1
62972,6244,1000.00,34640.91,35640.91,8279.11,26361.79,0.39,1
62973,6244,-1000.00,33640.91,34640.91,35640.91,0.00,0.00,0
62974,6244,0.00,33640.91,34640.91,0.00,0.00,0.00,0
62975,6244,1000.00,34640.91,35640.91,0.00,18059.05,0.22,1
62976,6244,1000.00,35640.91,36640.91,0.00,12182.53,0.11,1
62977,6245,-1000.00,-1000.00,0.00,535.89,464.11,0.16,0
62978,6246,-502.64,-502.64,497.36,502.64,0.00,0.08,0
62979,6246,-1000.00,-1502.64,-502.64,49.37,61.55,0.43,0
62980,6247,-1000.00,-1000.00,0.00,105.98,894.02,0.21,0
62981,6248,-1000.00,-1000.00,0.00,196.15,803.85,0.29,0
62982,6249,-1000.00,-1000.00,0.00,525.14,474.86,0.20,0
62983,6250,0.00,0.00,1000.00,0.00,0.00,0.03,0
62984,6250,-654.05,-654.05,345.95,654.05,0.00,0.10,0
62985,6250,1000.00,345.95,1345.95,0.00,206.82,0.28,1
62986,6250,1000.00,1345.95,2345.95,108.20,1237.75,0.38,1
62987,6250,1000.00,2345.95,3345.95,1171.42,1174.52,0.22,1
62988,6250,1000.00,3345.95,4345.95,716.66,2629.29,0.04,1
62989,6250,-1000.00,2345.95,3345.95,3343.05,1002.90,0.02,0
62990,6250,1000.00,3345.95,4345.95,478.20,2867.74,0.42,1
62991,6250,1000.00,4345.95,5345.95,2064.84,2281.11,0.13,1
62992,6250,1000.00,5345.95,6345.95,461.85,4884.09,0.32,1
62993,6250,1000.00,6345.95,7345.95,0.00,6345.95,0.23,1
62994,6250,1000.00,7345.95,8345.95,2838.25,4507.70,0.32,1
62995,6250,1000.00,8345.95,9345.95,605.60,5198.82,0.36,1
62996,6250,1000.00,9345.95,10345.95,0.00,3926.56,0.11,1
62997,6250,1000.00,10345.95,11345.95,0.00,5613.57,0.26,1
62998,6250,1000.00,11345.95,12345.95,0.00,11345.95,0.11,1
62999,6250,1000.00,12345.95,13345.95,0.00,11509.86,0.05,1
63000,6250,1000.00,13345.95,14345.95,0.00,9232.89,0.18,1
63001,6250,1000.00,14345.95,15345.95,6339.88,8006.07,0.13,1
63002,6250,1000.00,15345.95,16345.95,2182.39,13163.55,0.26,1
63003,6250,1000.00,16345.95,17345.95,7362.66,8983.28,0.16,1
63004,6250,-1000.00,15345.95,16345.95,1052.55,0.00,0.10,0
63005,6250,1000.00,16345.95,17345.95,0.00,16345.95,0.24,1
63006,6250,1000.00,17345.95,18345.95,0.00,17345.95,0.05,1
63007,6250,1000.00,18345.95,19345.95,0.00,18345.95,0.41,1
63008,6250,1000.00,19345.95,20345.95,0.00,19345.95,0.29,1
63009,6250,1000.00,20345.95,21345.95,0.00,8649.83,0.18,1
63010,6250,1000.00,21345.95,22345.95,0.00,12498.44,0.34,1
63011,6250,1000.00,22345.95,23345.95,7289.51,15056.44,0.12,1
63012,6250,1000.00,23345.95,24345.95,0.00,23345.95,0.38,1
63013,6250,1000.00,24345.95,25345.95,448.16,23821.85,0.44,1
63014,6250,1000.00,25345.95,26345.95,3443.58,21902.36,0.42,1
63015,6250,1000.00,26345.95,27345.95,8916.43,17429.51,0.26,1
63016,6250,1000.00,27345.95,28345.95,5905.90,21440.05,0.24,1
63017,6250,1000.00,28345.95,29345.95,0.00,20231.34,0.15,1
63018,6250,1000.00,29345.95,30345.95,0.00,21399.87,0.37,1
63019,6250,-1000.00,28345.95,29345.95,25265.86,5080.09,0.03,0
63020,6250,1000.00,29345.95,30345.95,4526.85,24819.10,0.23,1
63021,6250,1000.00,30345.95,31345.95,2378.21,27967.74,0.43,1
63022,6250,1000.00,31345.95,32345.95,0.00,14311.08,0.06,1
63023,6250,1000.00,32345.95,33345.95,0.00,32345.95,0.06,1
63024,6250,1000.00,33345.95,34345.95,0.00,954.17,0.04,1
63025,6250,1000.00,34345.95,35345.95,0.00,34345.95,0.44,1
63026,6251,-547.78,-547.78,452.22,0.00,547.78,0.32,0
63027,6251,-80.51,-628.29,371.71,0.00,80.51,0.12,0
63028,6251,-371.71,-1000.00,0.00,0.00,371.71,0.01,0
63029,6252,-1000.00,-1000.00,0.00,892.54,0.00,0.15,0
63030,6253,1000.00,1000.00,2000.00,304.52,695.48,0.35,1
63031,6253,-1000.00,0.00,1000.00,1124.27,875.73,0.05,0
63032,6253,1000.00,1000.00,2000.00,0.00,890.16,0.43,1
63033,6253,1000.00,2000.00,3000.00,528.55,1471.45,0.34,1
63034,6253,1000.00,3000.00,4000.00,552.19,2447.81,0.38,1
63035,6253,1000.00,4000.00,5000.00,1150.66,2849.34,0.08,1
63036,6253,1000.00,5000.00,6000.00,0.00,4136.38,0.21,1
63037,6253,1000.00,6000.00,7000.00,2817.21,3182.79,0.12,1
63038,6253,1000.00,7000.00,8000.00,860.49,4579.27,0.37,1
63039,6253,1000.00,8000.00,9000.00,0.00,4784.85,0.28,1
63040,6253,1000.00,9000.00,10000.00,0.00,4371.00,0.29,1
63041,6253,1000.00,10000.00,11000.00,1956.10,6970.89,0.37,1
63042,6253,1000.00,11000.00,12000.00,0.00,11000.00,0.44,1
63043,6253,1000.00,12000.00,13000.00,0.00,11176.66,0.25,1
63044,6253,1000.00,13000.00,14000.00,6255.06,6744.94,0.13,1
63045,6253,1000.00,14000.00,15000.00,4908.31,9091.69,0.32,1
63046,6253,1000.00,15000.00,16000.00,4456.83,10543.17,0.28,1
63047,6253,-1000.00,14000.00,15000.00,9369.69,6630.31,0.15,0
63048,6253,1000.00,15000.00,16000.00,0.00,10097.37,0.36,1
63049,6253,1000.00,16000.00,17000.00,5015.78,10984.22,0.09,1
63050,6253,1000.00,17000.00,18000.00,6750.47,10249.53,0.29,1
63051,6253,0.00,17000.00,18000.00,0.00,0.00,0.01,0
63052,6253,1000.00,18000.00,19000.00,0.00,12941.99,0.38,1
63053,6253,1000.00,19000.00,20000.00,0.00,19000.00,0.41,1
63054,6253,-1000.00,18000.00,19000.00,2015.24,9623.05,0.30,0
63055,6253,-1000.00,17000.00,18000.00,12515.51,6484.49,0.15,0
63056,6253,-1000.00,16000.00,17000.00,0.00,6769.99,0.14,0
63057,6253,-1000.00,15000.00,16000.00,5907.03,11092.97,0.25,0
63058,6253,-1000.00,14000.00,15000.00,5434.58,10565.42,0.02,0
63059,6253,-1000.00,13000.00,14000.00,5560.08,9439.92,0.24,0
63060,6253,-1000.00,12000.00,13000.00,0.00,5710.72,0.02,0
63061,6253,-1000.00,11000.00,12000.00,10139.35,2860.65,0.00,0
63062,6253,-1000.00,10000.00,11000.00,0.00,8973.99,0.12,0
63063,6253,-1000.00,9000.00,10000.00,4938.63,6061.37,0.06,0
63064,6253,-1000.00,8000.00,9000.00,3075.72,6924.28,0.33,0
63065,6253,-1000.00,7000.00,8000.00,1921.90,7078.10,0.39,0
63066,6253,-1000.00,6000.00,7000.00,3757.21,4242.79,0.14,0
63067,6253,-1000.00,5000.00,6000.00,1321.69,5478.54,0.39,0
63068,6253,-1000.00,4000.00,5000.00,667.81,5332.19,0.29,0
63069,6253,-1000.00,3000.00,4000.00,0.00,5000.00,0.31,0
63070,6253,-1000.00,2000.00,3000.00,1185.58,1043.37,0.18,0
63071,6253,-1000.00,1000.00,2000.00,1279.93,1720.07,0.24,0
63072,6253,-1000.00,0.00,1000.00,0.00,2000.00,0.44,0
63073,6253,-1000.00,-1000.00,0.00,0.00,1000.00,0.32,0
63074,6254,-320.42,-320.42,679.58,0.00,320.42,0.16,0
63075,6254,-679.58,-1000.00,0.00,0.00,679.58,0.13,0
63076,6255,-1000.00,-1000.00,0.00,169.81,829.83,0.41,0
63077,6256,-1000.00,-1000.00,0.00,624.71,0.00,0.06,0
63078,6257,-1000.00,-1000.00,0.00,0.00,1000.00,0.42,0
63079,6258,-819.20,-819.20,180.80,188.95,630.24,0.35,0
63080,6258,-180.80,-1000.00,0.00,0.00,180.80,0.30,0
63081,6259,-602.31,-602.31,397.69,0.00,602.31,0.18,0
63082,6259,-397.69,-1000.00,0.00,198.84,198.84,0.07,0
63083,6260,-1000.00,-1000.00,0.00,282.02,717.98,0.36,0
63084,6261,-138.85,-138.85,861.15,0.00,138.85,0.14,0
63085,6261,-1000.00,-1138.85,-138.85,292.95,276.61,0.20,0
63086,6262,-1000.00,-1000.00,0.00,0.00,1000.00,0.41,0
63087,6263,1000.00,1000.00,2000.00,0.00,38.84,0.11,1
63088,6263,0.00,1000.00,2000.00,0.00,0.00,0.03,0
63089,6263,1000.00,2000.00,3000.00,612.37,1387.63,0.33,1
63090,6263,-1000.00,1000.00,2000.00,2294.78,176.98,0.06,0
63091,6263,1000.00,2000.00,3000.00,215.66,1784.34,0.35,1
63092,6263,1000.00,3000.00,4000.00,80.83,2919.17,0.44,1
63093,6263,1000.00,4000.00,5000.00,0.00,4000.00,0.33,1
63094,6263,1000.00,5000.00,6000.00,910.24,4089.76,0.41,1
63095,6263,1000.00,6000.00,7000.00,2055.30,3944.70,0.27,1
63096,6263,1000.00,7000.00,8000.00,1436.43,5563.57,0.36,1
63097,6263,1000.00,8000.00,9000.00,0.00,8000.00,0.21,1
63098,6263,1000.00,9000.00,10000.00,2756.03,6243.97,0.28,1
63099,6263,1000.00,10000.00,11000.00,3833.57,5807.96,0.28,1
63100,6263,1000.00,11000.00,12000.00,0.00,11000.00,0.04,1
63101,6263,1000.00,12000.00,13000.00,0.00,12000.00,0.23,1
63102,6263,1000.00,13000.00,14000.00,0.00,13000.00,0.44,1
63103,6263,1000.00,14000.00,15000.00,6569.80,7430.20,0.13,1
63104,6263,1000.00,15000.00,16000.00,3922.50,11077.50,0.37,1
63105,6263,1000.00,16000.00,17000.00,0.00,15501.86,0.26,1
63106,6263,1000.00,17000.00,18000.00,3222.93,13777.07,0.41,1
63107,6263,1000.00,18000.00,19000.00,0.00,6747.02,0.19,1
63108,6263,-1000.00,17000.00,18000.00,16865.89,0.00,0.03,0
63109,6263,1000.00,18000.00,19000.00,0.00,7011.43,0.26,1
63110,6263,1000.00,19000.00,20000.00,0.00,458.33,0.10,1
63111,6263,1000.00,20000.00,21000.00,0.00,18011.34,0.25,1
63112,6263,1000.00,21000.00,22000.00,10500.00,10500.00,0.03,1
63113,6263,1000.00,22000.00,23000.00,0.00,22000.00,0.18,1
63114,6263,1000.00,23000.00,24000.00,3632.38,19367.62,0.01,1
63115,6263,1000.00,24000.00,25000.00,1942.41,22057.59,0.31,1
63116,6263,1000.00,25000.00,26000.00,5197.67,19802.33,0.40,1
63117,6263,1000.00,26000.00,27000.00,6713.46,19286.54,0.33,1
63118,6263,1000.00,27000.00,28000.00,0.00,24893.61,0.44,1
63119,6263,1000.00,28000.00,29000.00,0.00,28000.00,0.41,1
63120,6263,1000.00,29000.00,30000.00,8803.80,20196.20,0.35,1
63121,6263,-1000.00,28000.00,29000.00,14123.51,11395.65,0.19,0
63122,6263,1000.00,29000.00,30000.00,0.00,29000.00,0.22,1
63123,6263,1000.00,30000.00,31000.00,0.00,29562.01,0.31,1
63124,6263,1000.00,31000.00,32000.00,15500.00,15500.00,0.06,1
63125,6263,1000.00,32000.00,33000.00,8519.96,23480.04,0.37,1
63126,6263,1000.00,33000.00,34000.00,0.00,33000.00,0.28,1
63127,6263,1000.00,34000.00,35000.00,0.00,34000.00,0.12,1
63128,6264,-979.67,-979.67,20.33,0.00,979.67,0.28,0
63129,6264,-20.33,-1000.00,0.00,0.00,20.33,0.05,0
63130,6265,-1000.00,-1000.00,0.00,0.00,1000.00,0.24,0
63131,6266,-1000.00,-1000.00,0.00,346.65,653.35,0.06,0
63132,6267,-1000.00,-1000.00,0.00,0.00,485.27,0.26,0
63133,6268,-1000.00,-1000.00,0.00,0.00,1000.00,0.22,0
63134,6269,-1000.00,-1000.00,0.00,0.00,236.58,0.33,0
63135,6270,-1000.00,-1000.00,0.00,423.09,22.91,0.09,0
63136,6271,-572.18,-572.18,427.82,0.00,572.18,0.10,0
63137,6271,-427.82,-1000.00,0.00,0.00,427.82,0.29,0
63138,6272,-781.56,-781.56,218.44,53.51,728.05,0.40,0
63139,6272,-218.44,-1000.00,0.00,101.90,116.54,0.07,0
63140,6273,1000.00,1000.00,2000.00,0.00,229.92,0.19,1
63141,6273,1000.00,2000.00,3000.00,0.00,2000.00,0.15,1
63142,6273,1000.00,3000.00,4000.00,0.00,2656.05,0.42,1
63143,6273,1000.00,4000.00,5000.00,0.00,4000.00,0.11,1
63144,6273,1000.00,5000.00,6000.00,0.00,5000.00,0.10,1
63145,6273,1000.00,6000.00,7000.00,2773.45,3226.55,0.18,1
63146,6273,1000.00,7000.00,8000.00,0.00,7000.00,0.07,1
63147,6273,0.00,7000.00,8000.00,0.00,0.00,0.01,0
63148,6273,1000.00,8000.00,9000.00,626.43,7373.57,0.40,1
63149,6273,-1000.00,7000.00,8000.00,3092.29,0.00,0.02,0
63150,6273,1000.00,8000.00,9000.00,3324.95,4675.05,0.27,1
63151,6273,-1000.00,7000.00,8000.00,2103.65,461.93,0.12,0
63152,6273,1000.00,8000.00,9000.00,0.00,7728.25,0.39,1
63153,6273,1000.00,9000.00,10000.00,4184.89,4815.11,0.03,1
63154,6273,1000.00,10000.00,11000.00,0.00,10000.00,0.40,1
63155,6273,-1000.00,9000.00,10000.00,9070.35,1929.65,0.06,0
63156,6273,1000.00,10000.00,11000.00,1377.03,8622.97,0.42,1
63157,6273,1000.00,11000.00,12000.00,932.58,5529.02,0.31,1
63158,6273,1000.00,12000.00,13000.00,0.00,5281.69,0.28,1
63159,6273,-1000.00,11000.00,12000.00,2706.79,0.00,0.01,0
63160,6273,1000.00,12000.00,13000.00,2577.76,9422.24,0.39,1
63161,6273,1000.00,13000.00,14000.00,0.00,13000.00,0.15,1
63162,6273,-1000.00,12000.00,13000.00,7000.00,7000.00,0.00,0
63163,6273,-1000.00,11000.00,12000.00,0.00,13000.00,0.21,0
63164,6273,-1000.00,10000.00,11000.00,0.00,12000.00,0.21,0
63165,6273,-1000.00,9000.00,10000.00,3224.22,3068.73,0.19,0
63166,6273,-1000.00,8000.00,9000.00,5755.17,4244.83,0.12,0
63167,6273,-1000.00,7000.00,8000.00,3950.96,5049.04,0.12,0
63168,6273,-1000.00,6000.00,7000.00,0.00,4038.64,0.03,0
63169,6273,-1000.00,5000.00,6000.00,2678.70,4321.30,0.23,0
63170,6273,-1000.00,4000.00,5000.00,0.00,6000.00,0.33,0
63171,6273,-1000.00,3000.00,4000.00,0.00,4491.58,0.37,0
63172,6273,-1000.00,2000.00,3000.00,362.30,3637.70,0.03,0
63173,6273,-1000.00,1000.00,2000.00,1383.52,1616.48,0.15,0
63174,6273,-1000.00,0.00,1000.00,821.60,1178.40,0.28,0
63175,6273,-1000.00,-1000.00,0.00,0.00,1000.00,0.33,0
63176,6274,1000.00,1000.00,2000.00,149.23,850.77,0.18,1
63177,6274,1000.00,2000.00,3000.00,0.00,2000.00,0.23,1
63178,6274,1000.00,3000.00,4000.00,0.00,3000.00,0.23,1
63179,6274,1000.00,4000.00,5000.00,0.00,2915.76,0.11,1
63180,6274,1000.00,5000.00,6000.00,0.00,5000.00,0.04,1
63181,6274,1000.00,6000.00,7000.00,0.00,6000.00,0.08,1
63182,6274,1000.00,7000.00,8000.00,2779.70,4220.30,0.27,1
63183,6274,1000.00,8000.00,9000.00,2877.42,5122.58,0.28,1
63184,6274,1000.00,9000.00,10000.00,0.00,1122.77,0.14,1
63185,6274,1000.00,10000.00,11000.00,4106.14,5893.86,0.24,1
63186,6274,1000.00,11000.00,12000.00,363.03,10636.97,0.41,1
63187,6274,1000.00,12000.00,13000.00,0.00,4821.37,0.27,1
63188,6274,-1000.00,11000.00,12000.00,7533.25,1569.31,0.09,0
63189,6274,1000.00,12000.00,13000.00,6000.00,6000.00,0.02,1
63190,6274,1000.00,13000.00,14000.00,5238.16,7761.84,0.23,1
63191,6274,-1000.00,12000.00,13000.00,5794.25,4646.27,0.19,0
63192,6274,1000.00,13000.00,14000.00,442.37,12557.63,0.35,1
63193,6274,1000.00,14000.00,15000.00,2909.19,9173.79,0.35,1
63194,6274,1000.00,15000.00,16000.00,0.00,2403.40,0.12,1
63195,6274,1000.00,16000.00,17000.00,0.00,16000.00,0.43,1
63196,6274,1000.00,17000.00,18000.00,5816.52,11183.48,0.23,1
63197,6274,1000.00,18000.00,19000.00,7149.21,10850.79,0.26,1
63198,6274,1000.00,19000.00,20000.00,0.00,19000.00,0.37,1
63199,6274,-1000.00,18000.00,19000.00,11679.23,1553.99,0.08,0
63200,6274,1000.00,19000.00,20000.00,2199.06,10055.20,0.32,1
63201,6274,1000.00,20000.00,21000.00,0.00,14741.42,0.31,1
63202,6274,1000.00,21000.00,22000.00,5820.92,15179.08,0.21,1
63203,6274,1000.00,22000.00,23000.00,0.00,22000.00,0.26,1
63204,6274,-1000.00,21000.00,22000.00,13655.02,9344.98,0.06,0
63205,6274,1000.00,22000.00,23000.00,2549.83,19450.17,0.40,1
63206,6274,1000.00,23000.00,24000.00,0.00,14655.34,0.35,1
63207,6274,0.00,23000.00,24000.00,0.00,0.00,0.10,0
63208,6274,1000.00,24000.00,25000.00,3514.89,10938.28,0.33,1
63209,6274,0.00,24000.00,25000.00,0.00,0.00,0.08,0
63210,6274,1000.00,25000.00,26000.00,0.00,16708.48,0.04,1
63211,6274,1000.00,26000.00,27000.00,10945.16,15054.84,0.06,1
63212,6274,1000.00,27000.00,28000.00,11568.21,15431.79,0.19,1
63213,6274,1000.00,28000.00,29000.00,0.00,7767.10,0.07,1
63214,6274,1000.00,29000.00,30000.00,8200.09,20799.91,0.36,1
63215,6275,1000.00,1000.00,2000.00,0.00,1000.00,0.20,1
63216,6275,1000.00,2000.00,3000.00,0.00,2000.00,0.15,1
63217,6275,1000.00,3000.00,4000.00,0.00,3000.00,0.32,1
63218,6275,1000.00,4000.00,5000.00,0.00,1208.88,0.16,1
63219,6275,1000.00,5000.00,6000.00,2150.73,2849.27,0.07,1
63220,6275,1000.00,6000.00,7000.00,809.50,4406.43,0.39,1
63221,6275,1000.00,7000.00,8000.00,0.00,5256.60,0.36,1
63222,6275,1000.00,8000.00,9000.00,1486.68,6513.32,0.41,1
63223,6275,1000.00,9000.00,10000.00,0.00,1136.00,0.01,1
63224,6275,1000.00,10000.00,11000.00,3659.37,6340.63,0.24,1
63225,6275,1000.00,11000.00,12000.00,0.00,11000.00,0.11,1
63226,6275,1000.00,12000.00,13000.00,1551.75,10448.25,0.10,1
63227,6275,1000.00,13000.00,14000.00,0.00,6371.89,0.24,1
63228,6275,1000.00,14000.00,15000.00,5647.56,8352.44,0.28,1
63229,6275,0.00,14000.00,15000.00,0.00,0.00,0.01,0
63230,6275,-1000.00,13000.00,14000.00,7548.33,7451.67,0.17,0
63231,6275,1000.00,14000.00,15000.00,0.00,10526.89,0.25,1
63232,6275,1000.00,15000.00,16000.00,2600.47,12399.53,0.34,1
63233,6275,1000.00,16000.00,17000.00,7258.92,8741.08,0.14,1
63234,6275,-1000.00,15000.00,16000.00,10398.06,6601.94,0.07,0
63235,6275,1000.00,16000.00,17000.00,181.85,15818.15,0.19,1
63236,6275,-1000.00,15000.00,16000.00,9256.95,7743.05,0.15,0
63237,6275,-1000.00,14000.00,15000.00,2743.47,0.00,0.07,0
63238,6275,-1000.00,13000.00,14000.00,2444.12,5971.63,0.26,0
63239,6275,-1000.00,12000.00,13000.00,0.00,9029.36,0.24,0
63240,6275,-1000.00,11000.00,12000.00,0.00,2501.09,0.16,0
63241,6275,-1000.00,10000.00,11000.00,0.00,12000.00,0.39,0
63242,6275,-1000.00,9000.00,10000.00,0.00,11000.00,0.06,0
63243,6275,-1000.00,8000.00,9000.00,0.00,3627.47,0.06,0
63244,6275,-1000.00,7000.00,8000.00,2956.70,6043.30,0.11,0
63245,6275,-1000.00,6000.00,7000.00,0.00,8000.00,0.31,0
63246,6275,-1000.00,5000.00,6000.00,271.98,0.00,0.08,0
63247,6275,-1000.00,4000.00,5000.00,0.00,5552.98,0.30,0
63248,6275,-1000.00,3000.00,4000.00,0.00,5000.00,0.33,0
63249,6275,-1000.00,2000.00,3000.00,0.00,1758.74,0.29,0
63250,6275,-1000.00,1000.00,2000.00,278.00,2722.00,0.07,0
63251,6275,0.00,1000.00,2000.00,0.00,0.00,0.00,0
63252,6275,-1000.00,0.00,1000.00,1003.85,996.15,0.02,0
63253,6275,-1000.00,-1000.00,0.00,0.00,1000.00,0.17,0
63254,6276,0.00,0.00,1000.00,0.00,0.00,0.25,0
63255,6276,0.00,0.00,1000.00,0.00,0.00,0.34,0
63256,6276,-1000.00,-1000.00,0.00,0.00,1000.00,0.33,0
63257,6277,1000.00,1000.00,2000.00,0.00,782.23,0.22,1
63258,6277,1000.00,2000.00,3000.00,584.39,1415.61,0.17,1
63259,6277,1000.00,3000.00,4000.00,317.33,2682.67,0.11,1
63260,6277,1000.00,4000.00,5000.00,0.00,4000.00,0.14,1
63261,6277,1000.00,5000.00,6000.00,0.00,2733.03,0.28,1
63262,6277,1000.00,6000.00,7000.00,0.00,5104.60,0.05,1
63263,6277,1000.00,7000.00,8000.00,0.00,2304.90,0.21,1
63264,6277,1000.00,8000.00,9000.00,2569.50,5430.50,0.26,1
63265,6277,1000.00,9000.00,10000.00,0.00,9000.00,0.40,1
63266,6277,1000.00,10000.00,11000.00,2735.29,7264.71,0.28,1
63267,6277,1000.00,11000.00,12000.00,0.00,6248.40,0.26,1
63268,6277,1000.00,12000.00,13000.00,0.00,12000.00,0.40,1
63269,6277,1000.00,13000.00,14000.00,0.00,13000.00,0.22,1
63270,6277,1000.00,14000.00,15000.00,0.00,14000.00,0.04,1
63271,6277,-1000.00,13000.00,14000.00,6742.21,6348.94,0.21,0
63272,6277,1000.00,14000.00,15000.00,0.00,14000.00,0.14,1
63273,6277,-1000.00,13000.00,14000.00,2741.77,2695.52,0.17,0
63274,6277,1000.00,14000.00,15000.00,0.00,878.72,0.01,1
63275,6277,1000.00,15000.00,16000.00,0.00,15000.00,0.19,1
63276,6277,1000.00,16000.00,17000.00,6282.09,9717.91,0.29,1
63277,6277,1000.00,17000.00,18000.00,0.00,10925.86,0.34,1
63278,6277,1000.00,18000.00,19000.00,7707.84,10292.16,0.25,1
63279,6277,1000.00,19000.00,20000.00,0.00,19000.00,0.23,1
63280,6277,-1000.00,18000.00,19000.00,7745.67,0.00,0.05,0
63281,6277,1000.00,19000.00,20000.00,656.63,14926.24,0.41,1
63282,6277,1000.00,20000.00,21000.00,0.00,20000.00,0.24,1
63283,6277,1000.00,21000.00,22000.00,3587.31,13557.21,0.36,1
63284,6277,-1000.00,20000.00,21000.00,14447.87,7552.13,0.12,0
63285,6277,1000.00,21000.00,22000.00,0.00,21000.00,0.15,1
63286,6277,1000.00,22000.00,23000.00,8455.08,13544.92,0.00,1
63287,6277,1000.00,23000.00,24000.00,0.00,491.28,0.08,1
63288,6277,1000.00,24000.00,25000.00,8898.21,15101.79,0.30,1
63289,6277,1000.00,25000.00,26000.00,7212.55,17787.45,0.11,1
63290,6277,1000.00,26000.00,27000.00,0.00,26000.00,0.33,1
63291,6277,1000.00,27000.00,28000.00,3858.91,11111.22,0.31,1
63292,6277,1000.00,28000.00,29000.00,10597.83,17402.17,0.25,1
63293,6277,1000.00,29000.00,30000.00,0.00,29000.00,0.07,1
63294,6277,1000.00,30000.00,31000.00,14851.56,15148.44,0.21,1
63295,6277,-1000.00,29000.00,30000.00,29814.32,1185.68,0.03,0
63296,6277,1000.00,30000.00,31000.00,7749.64,22250.36,0.38,1
63297,6277,1000.00,31000.00,32000.00,6219.72,19839.45,0.35,1
63298,6277,1000.00,32000.00,33000.00,0.00,7542.36,0.18,1
63299,6277,1000.00,33000.00,34000.00,0.00,10790.60,0.20,1
63300,6277,1000.00,34000.00,35000.00,17000.00,17000.00,0.04,1
63301,6277,1000.00,35000.00,36000.00,0.00,35000.00,0.21,1
63302,6277,1000.00,36000.00,37000.00,0.00,36000.00,0.38,1
63303,6277,-1000.00,35000.00,36000.00,36761.39,238.61,0.02,0
63304,6277,-1000.00,34000.00,35000.00,20802.41,7351.71,0.12,0
63305,6277,-1000.00,33000.00,34000.00,28834.80,6165.20,0.01,0
63306,6277,1000.00,34000.00,35000.00,7606.09,26393.91,0.15,1
63307,6277,1000.00,35000.00,36000.00,6274.06,9615.26,0.20,1
63308,6277,1000.00,36000.00,37000.00,0.00,36000.00,0.43,1
63309,6277,1000.00,37000.00,38000.00,0.00,20634.82,0.32,1
63310,6277,1000.00,38000.00,39000.00,0.00,38000.00,0.04,1
63311,6277,1000.00,39000.00,40000.00,0.00,39000.00,0.28,1
63312,6277,1000.00,40000.00,41000.00,18078.34,21921.66,0.17,1
63313,6277,1000.00,41000.00,42000.00,6671.58,34328.42,0.20,1
63314,6277,1000.00,42000.00,43000.00,6059.46,35940.54,0.33,1
63315,6277,1000.00,43000.00,44000.00,18100.05,24899.95,0.21,1
63316,6277,1000.00,44000.00,45000.00,0.00,44000.00,0.38,1
63317,6277,1000.00,45000.00,46000.00,0.00,45000.00,0.31,1
63318,6277,1000.00,46000.00,47000.00,0.00,12161.67,0.05,1
63319,6277,1000.00,47000.00,48000.00,0.00,31899.51,0.30,1
63320,6277,1000.00,48000.00,49000.00,0.00,48000.00,0.16,1
63321,6277,1000.00,49000.00,50000.00,20527.06,28472.94,0.16,1
63322,6277,1000.00,50000.00,51000.00,0.00,50000.00,0.02,1
63323,6277,1000.00,51000.00,52000.00,0.00,51000.00,0.15,1
63324,6277,1000.00,52000.00,53000.00,0.00,45292.19,0.43,1
63325,6277,1000.00,53000.00,54000.00,0.00,15312.57,0.22,1
63326,6278,-1000.00,-1000.00,0.00,16.13,0.00,0.10,0
63327,6279,0.00,0.00,1000.00,0.00,0.00,0.06,0
63328,6279,0.00,0.00,1000.00,0.00,0.00,0.24,0
63329,6279,-1000.00,-1000.00,0.00,306.03,693.97,0.34,0
63330,6280,-251.01,-251.01,748.99,251.01,0.00,0.36,0
63331,6280,0.00,-251.01,748.99,0.00,0.00,0.38,0
63332,6280,-1000.00,-1251.01,-251.01,0.00,142.62,0.17,0
63333,6281,1000.00,1000.00,2000.00,355.90,148.84,0.36,1
63334,6281,-1000.00,0.00,1000.00,649.53,1243.06,0.22,0
63335,6281,-231.96,-231.96,768.04,0.00,231.96,0.37,0
63336,6281,1000.00,768.04,1768.04,556.67,211.38,0.08,1
63337,6281,-1000.00,-231.96,768.04,0.00,1768.04,0.01,0
63338,6281,-768.04,-1000.00,0.00,0.00,768.04,0.42,0
63339,6282,-198.77,-198.77,801.23,0.00,198.77,0.17,0
63340,6282,-801.23,-1000.00,0.00,0.00,801.23,0.17,0
63341,6283,-1000.00,-1000.00,0.00,243.62,756.38,0.20,0
63342,6284,-1000.00,-1000.00,0.00,307.10,692.90,0.35,0
63343,6285,0.00,0.00,1000.00,0.00,0.00,0.16,0
63344,6285,-1000.00,-1000.00,0.00,0.00,253.35,0.41,0
63345,6286,-948.49,-948.49,51.51,0.00,948.49,0.07,0
63346,6286,-51.51,-1000.00,0.00,10.61,40.90,0.40,0
63347,6287,-1000.00,-1000.00,0.00,0.00,1000.00,0.35,0
63348,6288,-710.61,-710.61,289.39,710.61,0.00,0.12,0
63349,6288,-263.93,-974.54,25.46,263.93,0.00,0.13,0
63350,6288,-1000.00,-1974.54,-974.54,0.00,25.46,0.15,0
63351,6289,1000.00,1000.00,2000.00,90.42,909.58,0.00,1
63352,6289,0.00,1000.00,2000.00,0.00,0.00,0.04,0
63353,6289,1000.00,2000.00,3000.00,459.41,1540.59,0.37,1
63354,6289,-1000.00,1000.00,2000.00,1691.94,1308.06,0.13,0
63355,6289,1000.00,2000.00,3000.00,692.26,1307.74,0.32,1
63356,6289,1000.00,3000.00,4000.00,190.64,2658.51,0.43,1
63357,6289,1000.00,4000.00,5000.00,1945.28,2054.72,0.19,1
63358,6289,1000.00,5000.00,6000.00,0.00,5000.00,0.28,1
63359,6289,-1000.00,4000.00,5000.00,2315.15,0.00,0.06,0
63360,6289,1000.00,5000.00,6000.00,0.00,5000.00,0.11,1
63361,6289,1000.00,6000.00,7000.00,0.00,6000.00,0.03,1
63362,6289,1000.00,7000.00,8000.00,0.00,1764.12,0.18,1
63363,6289,1000.00,8000.00,9000.00,0.00,8000.00,0.24,1
63364,6289,1000.00,9000.00,10000.00,2444.58,6555.42,0.28,1
63365,6289,0.00,9000.00,10000.00,0.00,0.00,0.06,0
63366,6289,-1000.00,8000.00,9000.00,5669.42,0.00,0.12,0
63367,6289,1000.00,9000.00,10000.00,3557.37,5442.63,0.24,1
63368,6289,1000.00,10000.00,11000.00,0.00,10000.00,0.00,1
63369,6289,1000.00,11000.00,12000.00,5500.00,5500.00,0.03,1
63370,6289,-1000.00,10000.00,11000.00,8029.61,3970.39,0.04,0
63371,6289,1000.00,11000.00,12000.00,0.00,2363.79,0.06,1
63372,6289,1000.00,12000.00,13000.00,0.00,4698.08,0.20,1
63373,6289,-1000.00,11000.00,12000.00,5788.46,0.00,0.07,0
63374,6289,1000.00,12000.00,13000.00,336.97,11663.03,0.39,1
63375,6289,1000.00,13000.00,14000.00,0.00,8860.07,0.37,1
63376,6289,1000.00,14000.00,15000.00,4256.05,6201.66,0.26,1
63377,6289,-1000.00,13000.00,14000.00,3358.99,0.00,0.09,0
63378,6289,1000.00,14000.00,15000.00,442.29,13557.71,0.37,1
63379,6289,1000.00,15000.00,16000.00,0.00,15000.00,0.21,1
63380,6289,1000.00,16000.00,17000.00,8000.00,8000.00,0.02,1
63381,6289,1000.00,17000.00,18000.00,493.48,7324.24,0.28,1
63382,6289,1000.00,18000.00,19000.00,7731.59,10268.41,0.13,1
63383,6289,1000.00,19000.00,20000.00,8061.50,10938.50,0.17,1
63384,6289,1000.00,20000.00,21000.00,0.00,20000.00,0.29,1
63385,6289,1000.00,21000.00,22000.00,7969.38,13030.62,0.27,1
63386,6289,1000.00,22000.00,23000.00,0.00,22000.00,0.29,1
63387,6289,1000.00,23000.00,24000.00,0.00,15402.31,0.21,1
63388,6289,1000.00,24000.00,25000.00,0.00,24000.00,0.07,1
63389,6289,1000.00,25000.00,26000.00,7393.31,17606.69,0.31,1
63390,6289,1000.00,26000.00,27000.00,0.00,23365.23,0.36,1
63391,6289,1000.00,27000.00,28000.00,5405.20,21594.80,0.38,1
63392,6289,1000.00,28000.00,29000.00,6955.69,13260.95,0.28,1
63393,6289,1000.00,29000.00,30000.00,10765.68,18234.32,0.13,1
63394,6290,-791.49,-791.49,208.51,0.00,791.49,0.29,0
63395,6290,-139.86,-931.35,68.65,0.00,139.86,0.36,0
63396,6290,-67.75,-999.10,0.90,0.00,67.75,0.44,0
63397,6290,-0.90,-1000.00,0.00,0.16,0.74,0.41,0
63398,6291,-716.09,-716.09,283.91,14.98,701.11,0.39,0
63399,6291,-1000.00,-1716.09,-716.09,185.93,96.25,0.13,0
63400,6292,-238.10,-238.10,761.90,0.00,238.10,0.16,0
63401,6292,-575.88,-813.99,186.01,73.86,502.02,0.37,0
63402,6292,-46.10,-860.08,139.92,0.00,46.10,0.05,0
63403,6292,-139.92,-1000.00,0.00,0.00,139.92,0.16,0
63404,6293,1000.00,1000.00,2000.00,0.00,1000.00,0.01,1
63405,6293,0.00,1000.00,2000.00,0.00,0.00,0.01,0
63406,6293,1000.00,2000.00,3000.00,505.26,1494.74,0.37,1
63407,6293,1000.00,3000.00,4000.00,157.85,1570.75,0.32,1
63408,6293,-1000.00,2000.00,3000.00,2068.48,0.00,0.07,0
63409,6293,1000.00,3000.00,4000.00,295.88,2704.12,0.32,1
63410,6293,-1000.00,2000.00,3000.00,2207.19,1792.81,0.18,0
63411,6293,-1000.00,1000.00,2000.00,2795.71,0.00,0.01,0
63412,6293,1000.00,2000.00,3000.00,0.00,2000.00,0.39,1
63413,6293,1000.00,3000.00,4000.00,0.00,3000.00,0.38,1
63414,6293,1000.00,4000.00,5000.00,0.00,2434.07,0.31,1
63415,6293,1000.00,5000.00,6000.00,1074.07,3925.93,0.40,1
63416,6293,1000.00,6000.00,7000.00,2231.29,3768.71,0.26,1
63417,6293,1000.00,7000.00,8000.00,1626.26,5373.74,0.38,1
63418,6293,1000.00,8000.00,9000.00,1322.79,6677.21,0.40,1
63419,6293,1000.00,9000.00,10000.00,0.00,9000.00,0.13,1
63420,6293,1000.00,10000.00,11000.00,0.00,10000.00,0.25,1
63421,6293,1000.00,11000.00,12000.00,0.00,9991.56,0.25,1
63422,6293,1000.00,12000.00,13000.00,457.99,4213.14,0.25,1
63423,6293,-884.98,11115.02,12115.02,884.98,0.00,0.11,0
63424,6293,-1000.00,10115.02,11115.02,7486.12,4628.90,0.10,0
63425,6293,1000.00,11115.02,12115.02,4364.68,6750.34,0.23,1
63426,6293,-1000.00,10115.02,11115.02,2342.23,6676.96,0.32,0
63427,6293,-1000.00,9115.02,10115.02,5622.53,5492.49,0.04,0
63428,6293,-1000.00,8115.02,9115.02,0.00,10115.02,0.07,0
63429,6293,-1000.00,7115.02,8115.02,0.00,9115.02,0.12,0
63430,6293,-1000.00,6115.02,7115.02,4611.62,3503.40,0.16,0
63431,6293,-1000.00,5115.02,6115.02,0.00,7115.02,0.15,0
63432,6293,-1000.00,4115.02,5115.02,0.00,2522.03,0.24,0
63433,6293,-1000.00,3115.02,4115.02,0.00,5115.02,0.39,0
63434,6293,-1000.00,2115.02,3115.02,508.83,326.70,0.13,0
63435,6293,-1000.00,1115.02,2115.02,1238.47,1876.54,0.24,0
63436,6293,-1000.00,115.02,1115.02,0.00,1997.33,0.43,0
63437,6293,-980.93,-865.92,134.08,0.00,980.93,0.21,0
63438,6293,-134.08,-1000.00,0.00,21.40,112.69,0.13,0
63439,6294,-1000.00,-1000.00,0.00,94.95,0.00,0.06,0
63440,6295,1000.00,1000.00,2000.00,6.36,993.64,0.12,1
63441,6295,1000.00,2000.00,3000.00,0.00,2000.00,0.11,1
63442,6295,-1000.00,1000.00,2000.00,1022.98,150.26,0.11,0
63443,6295,-1000.00,0.00,1000.00,1214.59,785.41,0.14,0
63444,6295,1000.00,1000.00,2000.00,0.00,1000.00,0.30,1
63445,6295,1000.00,2000.00,3000.00,507.80,1492.20,0.38,1
63446,6295,1000.00,3000.00,4000.00,0.00,924.57,0.19,1
63447,6295,1000.00,4000.00,5000.00,0.00,3321.21,0.10,1
63448,6295,1000.00,5000.00,6000.00,756.37,1992.22,0.26,1
63449,6295,1000.00,6000.00,7000.00,1443.84,3857.57,0.34,1
63450,6295,1000.00,7000.00,8000.00,366.08,6633.92,0.44,1
63451,6295,1000.00,8000.00,9000.00,0.00,3808.19,0.17,1
63452,6295,1000.00,9000.00,10000.00,0.00,3018.95,0.21,1
63453,6295,-1000.00,8000.00,9000.00,5433.08,4566.92,0.10,0
63454,6295,1000.00,9000.00,10000.00,0.00,9000.00,0.14,1
63455,6295,1000.00,10000.00,11000.00,0.00,10000.00,0.14,1
63456,6295,1000.00,11000.00,12000.00,0.00,11000.00,0.07,1
63457,6295,-1000.00,10000.00,11000.00,7686.37,4313.63,0.12,0
63458,6295,1000.00,11000.00,12000.00,443.03,5660.18,0.32,1
63459,6295,1000.00,12000.00,13000.00,0.00,12000.00,0.29,1
63460,6295,1000.00,13000.00,14000.00,0.00,7930.64,0.36,1
63461,6295,1000.00,14000.00,15000.00,0.00,14000.00,0.04,1
63462,6295,1000.00,15000.00,16000.00,6279.70,6524.08,0.22,1
63463,6295,1000.00,16000.00,17000.00,0.00,16000.00,0.23,1
63464,6295,1000.00,17000.00,18000.00,2785.82,8689.80,0.31,1
63465,6295,1000.00,18000.00,19000.00,6993.35,11006.65,0.24,1
63466,6295,1000.00,19000.00,20000.00,0.00,19000.00,0.21,1
63467,6295,1000.00,20000.00,21000.00,2537.21,7343.98,0.25,1
63468,6295,1000.00,21000.00,22000.00,6884.63,14115.37,0.28,1
63469,6295,1000.00,22000.00,23000.00,6025.90,15974.10,0.27,1
63470,6295,1000.00,23000.00,24000.00,10687.08,12312.92,0.23,1
63471,6295,1000.00,24000.00,25000.00,3646.05,20353.95,0.40,1
63472,6295,1000.00,25000.00,26000.00,12500.00,12500.00,0.02,1
63473,6295,1000.00,26000.00,27000.00,5013.45,20986.55,0.41,1
63474,6295,1000.00,27000.00,28000.00,3818.68,23181.32,0.32,1
63475,6295,1000.00,28000.00,29000.00,5747.13,8956.14,0.22,1
63476,6295,-1000.00,27000.00,28000.00,0.00,22633.63,0.03,0
63477,6296,-658.66,-658.66,341.34,537.18,121.48,0.11,0
63478,6296,-1000.00,-1658.66,-658.66,0.00,341.34,0.41,0
63479,6297,-633.89,-633.89,366.11,548.72,85.17,0.29,0
63480,6297,-200.63,-834.52,165.48,200.63,0.00,0.26,0
63481,6297,0.00,-834.52,165.48,0.00,0.00,0.16,0
63482,6297,-165.48,-1000.00,0.00,111.51,53.97,0.05,0
63483,6298,-1000.00,-1000.00,0.00,938.10,61.90,0.01,0
63484,6299,-1000.00,-1000.00,0.00,383.70,616.30,0.13,0
63485,6300,-1000.00,-1000.00,0.00,1000.00,0.00,0.05,0
63486,6301,-1000.00,-1000.00,0.00,323.29,676.71,0.31,0
63487,6302,0.00,0.00,1000.00,0.00,1000.00,0.02,0
63488,6302,0.00,0.00,1000.00,0.00,1000.00,0.03,0
63489,6302,-1000.00,-1000.00,0.00,597.80,402.20,0.15,0
63490,6303,1000.00,1000.00,2000.00,0.00,1000.00,0.09,1
63491,6303,1000.00,2000.00,3000.00,0.00,1971.38,0.18,1
63492,6303,1000.00,3000.00,4000.00,572.78,2427.22,0.17,1
63493,6303,0.00,3000.00,4000.00,0.00,0.00,0.03,0
63494,6303,1000.00,4000.00,5000.00,1641.33,2358.67,0.16,1
63495,6303,1000.00,5000.00,6000.00,0.00,5000.00,0.29,1
63496,6303,1000.00,6000.00,7000.00,0.00,4392.18,0.39,1
63497,6303,1000.00,7000.00,8000.00,0.00,3726.12,0.23,1
63498,6303,1000.00,8000.00,9000.00,1873.44,6126.56,0.04,1
63499,6303,1000.00,9000.00,10000.00,2685.39,6314.61,0.34,1
63500,6303,1000.00,10000.00,11000.00,2631.09,7368.91,0.37,1
63501,6303,-1000.00,9000.00,10000.00,6036.18,4963.82,0.16,0
63502,6303,1000.00,10000.00,11000.00,0.00,8868.45,0.37,1
63503,6303,1000.00,11000.00,12000.00,0.00,11000.00,0.09,1
63504,6303,1000.00,12000.00,13000.00,2925.71,9074.29,0.38,1
63505,6303,1000.00,13000.00,14000.00,0.00,2244.38,0.17,1
63506,6303,1000.00,14000.00,15000.00,4578.20,7982.86,0.29,1
63507,6303,1000.00,15000.00,16000.00,0.00,15000.00,0.22,1
63508,6303,1000.00,16000.00,17000.00,4154.72,4813.94,0.20,1
63509,6303,1000.00,17000.00,18000.00,0.00,17000.00,0.33,1
63510,6303,-1000.00,16000.00,17000.00,7712.84,1997.90,0.11,0
63511,6303,1000.00,17000.00,18000.00,8482.29,8517.71,0.11,1
63512,6303,1000.00,18000.00,19000.00,5038.95,12961.05,0.27,1
63513,6303,1000.00,19000.00,20000.00,8780.04,10219.96,0.16,1
63514,6303,1000.00,20000.00,21000.00,0.00,2218.83,0.04,1
63515,6303,1000.00,21000.00,22000.00,2904.06,18095.94,0.39,1
63516,6303,1000.00,22000.00,23000.00,0.00,18719.55,0.39,1
63517,6303,1000.00,23000.00,24000.00,0.00,10348.88,0.29,1
63518,6303,1000.00,24000.00,25000.00,11633.18,12366.82,0.13,1
63519,6303,1000.00,25000.00,26000.00,0.00,11401.18,0.14,1
63520,6303,1000.00,26000.00,27000.00,1207.53,24792.47,0.24,1
63521,6303,1000.00,27000.00,28000.00,1018.48,25981.52,0.39,1
63522,6303,1000.00,28000.00,29000.00,0.00,23986.58,0.43,1
63523,6303,1000.00,29000.00,30000.00,0.00,29000.00,0.08,1
63524,6303,1000.00,30000.00,31000.00,0.00,30000.00,0.35,1
63525,6303,1000.00,31000.00,32000.00,0.00,9821.70,0.11,1
63526,6303,1000.00,32000.00,33000.00,0.00,32000.00,0.13,1
63527,6303,1000.00,33000.00,34000.00,1130.17,9994.59,0.22,1
63528,6303,1000.00,34000.00,35000.00,0.00,3609.66,0.14,1
63529,6303,1000.00,35000.00,36000.00,11193.05,17226.63,0.27,1
63530,6303,1000.00,36000.00,37000.00,7143.98,28856.02,0.07,1
63531,6304,-1000.00,-1000.00,0.00,0.00,1000.00,0.25,0
63532,6305,-1000.00,-1000.00,0.00,0.00,1000.00,0.21,0
63533,6306,-1000.00,-1000.00,0.00,0.00,1000.00,0.26,0
63534,6307,-1000.00,-1000.00,0.00,1000.00,0.00,0.03,0
63535,6308,-1000.00,-1000.00,0.00,0.00,1000.00,0.03,0
63536,6309,-1000.00,-1000.00,0.00,219.69,780.31,0.26,0
63537,6310,1000.00,1000.00,2000.00,529.44,294.47,0.28,1
63538,6310,-619.84,380.16,1380.16,0.00,619.84,0.35,0
63539,6310,-1000.00,-619.84,380.16,0.00,1077.78,0.38,0
63540,6310,-350.61,-970.45,29.55,0.00,350.61,0.36,0
63541,6310,-17.93,-988.38,11.62,0.00,17.93,0.35,0
63542,6310,-10.72,-999.10,0.90,0.17,10.55,0.44,0
63543,6310,119.58,-879.51,120.49,0.43,0.00,0.29,1
63544,6310,-47.37,-926.88,73.12,12.33,35.04,0.39,0
63545,6310,1000.00,73.12,1073.12,33.28,31.42,0.26,1
63546,6310,-291.65,-218.53,781.47,0.00,291.65,0.31,0
63547,6310,-22.10,-240.63,759.37,0.00,22.10,0.31,0
63548,6310,1000.00,759.37,1759.37,689.31,0.00,0.14,1
63549,6310,1000.00,1759.37,2759.37,356.49,300.52,0.42,1
63550,6310,1000.00,2759.37,3759.37,2102.85,656.52,0.02,1
63551,6310,-1000.00,1759.37,2759.37,0.00,1320.76,0.18,0
63552,6310,-80.02,1679.35,2679.35,0.00,80.02,0.41,0
63553,6310,-1000.00,679.35,1679.35,0.00,1250.74,0.01,0
63554,6310,-1000.00,-320.65,679.35,839.67,839.67,0.01,0
63555,6310,-452.40,-773.05,226.95,0.00,452.40,0.11,0
63556,6310,-226.95,-1000.00,0.00,65.04,161.92,0.22,0
63557,6311,1000.00,1000.00,2000.00,484.75,515.25,0.15,1
63558,6311,1000.00,2000.00,3000.00,0.00,2000.00,0.16,1
63559,6311,-1000.00,1000.00,2000.00,881.63,623.18,0.16,0
63560,6311,1000.00,2000.00,3000.00,334.30,1665.70,0.42,1
63561,6311,1000.00,3000.00,4000.00,1175.29,1824.71,0.24,1
63562,6311,1000.00,4000.00,5000.00,0.00,4000.00,0.43,1
63563,6311,1000.00,5000.00,6000.00,160.43,4839.57,0.32,1
63564,6311,1000.00,6000.00,7000.00,0.00,6000.00,0.12,1
63565,6311,1000.00,7000.00,8000.00,0.00,7000.00,0.14,1
63566,6311,1000.00,8000.00,9000.00,0.00,3889.67,0.13,1
63567,6311,1000.00,9000.00,10000.00,0.00,827.14,0.12,1
63568,6311,1000.00,10000.00,11000.00,3797.74,6202.26,0.26,1
63569,6311,1000.00,11000.00,12000.00,0.00,11000.00,0.14,1
63570,6311,1000.00,12000.00,13000.00,0.00,8425.35,0.13,1
63571,6311,1000.00,13000.00,14000.00,1022.27,8157.96,0.36,1
63572,6311,1000.00,14000.00,15000.00,0.00,14000.00,0.06,1
63573,6311,1000.00,15000.00,16000.00,2020.92,12979.08,0.42,1
63574,6311,1000.00,16000.00,17000.00,3829.94,12170.06,0.37,1
63575,6311,-1000.00,15000.00,16000.00,9039.16,7960.84,0.18,0
63576,6311,1000.00,16000.00,17000.00,0.00,15489.25,0.16,1
63577,6311,1000.00,17000.00,18000.00,0.00,5377.58,0.07,1
63578,6311,1000.00,18000.00,19000.00,4033.22,13966.78,0.34,1
63579,6311,-1000.00,17000.00,18000.00,9958.97,7916.15,0.19,0
63580,6311,-1000.00,16000.00,17000.00,1783.18,16216.82,0.43,0
63581,6311,-1000.00,15000.00,16000.00,0.00,14113.99,0.13,0
63582,6311,-1000.00,14000.00,15000.00,0.00,16000.00,0.31,0
63583,6311,-1000.00,13000.00,14000.00,1339.73,13660.27,0.44,0
63584,6311,0.00,13000.00,14000.00,0.00,0.00,0.05,0
63585,6311,-1000.00,12000.00,13000.00,0.00,14000.00,0.32,0
63586,6311,-1000.00,11000.00,12000.00,4596.81,8403.19,0.17,0
63587,6311,-1000.00,10000.00,11000.00,0.00,10138.60,0.43,0
63588,6311,-1000.00,9000.00,10000.00,4344.00,6656.00,0.14,0
63589,6311,-1000.00,8000.00,9000.00,0.00,9813.07,0.40,0
63590,6311,-1000.00,7000.00,8000.00,1217.15,6346.96,0.38,0
63591,6311,-1000.00,6000.00,7000.00,0.00,7619.93,0.44,0
63592,6311,-1000.00,5000.00,6000.00,0.00,6769.42,0.33,0
63593,6311,-1000.00,4000.00,5000.00,0.00,4310.51,0.04,0
63594,6311,-1000.00,3000.00,4000.00,0.00,5000.00,0.24,0
63595,6311,-1000.00,2000.00,3000.00,0.00,4000.00,0.23,0
63596,6311,-1000.00,1000.00,2000.00,1269.30,1730.70,0.01,0
63597,6311,-1000.00,0.00,1000.00,1613.56,386.44,0.00,0
63598,6311,-413.94,-413.94,586.06,0.00,413.94,0.25,0
63599,6311,-586.06,-1000.00,0.00,220.16,365.90,0.25,0
63600,6312,-1000.00,-1000.00,0.00,0.00,385.21,0.27,0
63601,6313,-1000.00,-1000.00,0.00,86.66,0.00,0.06,0
63602,6314,1000.00,1000.00,2000.00,0.00,1000.00,0.05,1
63603,6314,1000.00,2000.00,3000.00,0.00,2000.00,0.04,1
63604,6314,1000.00,3000.00,4000.00,0.00,1765.13,0.17,1
63605,6314,1000.00,4000.00,5000.00,0.00,934.74,0.19,1
63606,6314,1000.00,5000.00,6000.00,0.00,4542.92,0.33,1
63607,6314,1000.00,6000.00,7000.00,0.00,4665.72,0.09,1
63608,6314,1000.00,7000.00,8000.00,0.00,6783.14,0.17,1
63609,6314,1000.00,8000.00,9000.00,0.00,8000.00,0.34,1
63610,6314,1000.00,9000.00,10000.00,0.00,9000.00,0.28,1
63611,6314,1000.00,10000.00,11000.00,347.00,3568.42,0.25,1
63612,6314,1000.00,11000.00,12000.00,3503.10,7496.90,0.27,1
63613,6314,1000.00,12000.00,13000.00,0.00,12000.00,0.14,1
63614,6314,1000.00,13000.00,14000.00,0.00,349.60,0.04,1
63615,6314,1000.00,14000.00,15000.00,3540.88,10459.12,0.32,1
63616,6314,-1000.00,13000.00,14000.00,7792.44,7207.56,0.06,0
63617,6314,1000.00,14000.00,15000.00,0.00,11246.59,0.14,1
63618,6314,1000.00,15000.00,16000.00,0.00,15000.00,0.37,1
63619,6314,1000.00,16000.00,17000.00,0.00,16000.00,0.31,1
63620,6314,1000.00,17000.00,18000.00,3165.83,13834.17,0.16,1
63621,6314,1000.00,18000.00,19000.00,3211.25,14788.75,0.30,1
63622,6314,1000.00,19000.00,20000.00,0.00,8841.47,0.18,1
63623,6314,1000.00,20000.00,21000.00,7375.60,12624.40,0.18,1
63624,6314,1000.00,21000.00,22000.00,0.00,20559.78,0.44,1
63625,6314,1000.00,22000.00,23000.00,0.00,3739.78,0.07,1
63626,6314,1000.00,23000.00,24000.00,8524.57,10278.55,0.24,1
63627,6314,1000.00,24000.00,25000.00,0.00,24000.00,0.11,1
63628,6314,1000.00,25000.00,26000.00,0.00,25000.00,0.06,1
63629,6314,1000.00,26000.00,27000.00,0.00,26000.00,0.43,1
63630,6314,1000.00,27000.00,28000.00,6772.70,20227.30,0.38,1
63631,6314,1000.00,28000.00,29000.00,0.00,13716.66,0.31,1
63632,6314,1000.00,29000.00,30000.00,0.00,29000.00,0.29,1
63633,6314,1000.00,30000.00,31000.00,0.00,11518.27,0.26,1
63634,6314,1000.00,31000.00,32000.00,0.00,12596.35,0.22,1
63635,6314,1000.00,32000.00,33000.00,11565.20,20434.80,0.23,1
63636,6314,1000.00,33000.00,34000.00,0.00,33000.00,0.18,1
63637,6314,1000.00,34000.00,35000.00,0.00,34000.00,0.05,1
63638,6314,1000.00,35000.00,36000.00,0.00,26248.09,0.37,1
63639,6314,1000.00,36000.00,37000.00,4815.90,31184.10,0.37,1
63640,6315,1000.00,1000.00,2000.00,220.82,0.00,0.40,1
63641,6315,-1000.00,0.00,1000.00,0.00,1625.42,0.07,0
63642,6315,1000.00,1000.00,2000.00,701.83,298.17,0.09,1
63643,6315,-1000.00,0.00,1000.00,397.71,1378.28,0.40,0
63644,6315,-1000.00,-1000.00,0.00,0.00,1000.00,0.08,0
63645,6316,-508.36,-508.36,491.64,0.00,508.36,0.02,0
63646,6316,-1000.00,-1508.36,-508.36,273.61,216.34,0.28,0
63647,6317,-480.15,-480.15,519.85,0.00,480.15,0.36,0
63648,6317,-323.87,-804.02,195.98,0.00,323.87,0.36,0
63649,6317,-1000.00,-1804.02,-804.02,135.04,0.00,0.02,0
63650,6318,0.00,0.00,1000.00,0.00,0.00,0.22,0
63651,6318,-1000.00,-1000.00,0.00,128.48,577.98,0.27,0
63652,6319,1000.00,1000.00,2000.00,0.00,963.98,0.17,1
63653,6319,1000.00,2000.00,3000.00,655.30,1344.70,0.32,1
63654,6319,1000.00,3000.00,4000.00,1500.00,1500.00,0.05,1
63655,6319,1000.00,4000.00,5000.00,0.00,4000.00,0.24,1
63656,6319,1000.00,5000.00,6000.00,0.00,2684.73,0.12,1
63657,6319,-1000.00,4000.00,5000.00,2153.12,0.00,0.06,0
63658,6319,1000.00,5000.00,6000.00,2498.33,2501.67,0.10,1
63659,6319,1000.00,6000.00,7000.00,2710.03,3289.97,0.15,1
63660,6319,1000.00,7000.00,8000.00,0.00,5145.21,0.33,1
63661,6319,1000.00,8000.00,9000.00,0.00,4014.08,0.31,1
63662,6319,1000.00,9000.00,10000.00,2820.39,6179.61,0.34,1
63663,6319,1000.00,10000.00,11000.00,4166.20,5833.80,0.26,1
63664,6319,1000.00,11000.00,12000.00,521.89,10478.11,0.22,1
63665,6319,1000.00,12000.00,13000.00,0.00,7377.98,0.24,1
63666,6319,1000.00,13000.00,14000.00,4701.62,8298.38,0.25,1
63667,6319,1000.00,14000.00,15000.00,5480.11,8519.89,0.21,1
63668,6319,1000.00,15000.00,16000.00,0.00,13929.01,0.32,1
63669,6319,1000.00,16000.00,17000.00,0.00,16000.00,0.15,1
63670,6319,1000.00,17000.00,18000.00,0.00,6848.85,0.06,1
63671,6319,-1000.00,16000.00,17000.00,0.00,18000.00,0.05,0
63672,6319,-1000.00,15000.00,16000.00,7677.31,9322.69,0.16,0
63673,6319,-1000.00,14000.00,15000.00,9512.20,6461.82,0.17,0
63674,6319,-1000.00,13000.00,14000.00,0.00,4917.22,0.15,0
63675,6319,-1000.00,12000.00,13000.00,68.33,8119.20,0.35,0
63676,6319,-1000.00,11000.00,12000.00,3334.05,9665.95,0.34,0
63677,6319,-1000.00,10000.00,11000.00,0.00,12000.00,0.40,0
63678,6319,-1000.00,9000.00,10000.00,0.00,11000.00,0.02,0
63679,6319,-1000.00,8000.00,9000.00,595.11,5645.45,0.34,0
63680,6319,-1000.00,7000.00,8000.00,2304.56,6695.44,0.31,0
63681,6319,-1000.00,6000.00,7000.00,0.00,8000.00,0.44,0
63682,6319,-1000.00,5000.00,6000.00,0.00,7000.00,0.29,0
63683,6319,-1000.00,4000.00,5000.00,0.00,4539.16,0.38,0
63684,6319,-1000.00,3000.00,4000.00,0.00,5000.00,0.29,0
63685,6319,-1000.00,2000.00,3000.00,0.00,4000.00,0.02,0
63686,6319,-1000.00,1000.00,2000.00,1386.21,1613.79,0.15,0
63687,6319,-1000.00,0.00,1000.00,276.77,1723.23,0.32,0
63688,6319,-1000.00,-1000.00,0.00,0.00,1000.00,0.04,0
63689,6320,-645.11,-645.11,354.89,489.66,155.45,0.31,0
63690,6320,0.00,-645.11,354.89,0.00,0.00,0.26,0
63691,6320,-1000.00,-1645.11,-645.11,0.00,354.89,0.25,0
63692,6321,-501.71,-501.71,498.29,0.00,501.71,0.42,0
63693,6321,-415.56,-917.26,82.74,0.00,415.56,0.41,0
63694,6321,-82.74,-1000.00,0.00,41.01,41.73,0.17,0
63695,6322,-1000.00,-1000.00,0.00,475.30,524.70,0.06,0
63696,6323,-695.50,-695.50,304.50,0.00,695.50,0.31,0
63697,6323,-304.50,-1000.00,0.00,109.01,195.49,0.27,0
63698,6324,1000.00,1000.00,2000.00,279.73,720.27,0.31,1
63699,6324,0.00,1000.00,2000.00,0.00,0.00,0.01,0
63700,6324,1000.00,2000.00,3000.00,0.00,2000.00,0.30,1
63701,6324,1000.00,3000.00,4000.00,137.05,2862.95,0.44,1
63702,6324,1000.00,4000.00,5000.00,0.00,4000.00,0.33,1
63703,6324,1000.00,5000.00,6000.00,0.00,921.52,0.07,1
63704,6324,1000.00,6000.00,7000.00,0.00,5108.83,0.42,1
63705,6324,1000.00,7000.00,8000.00,0.00,7000.00,0.10,1
63706,6324,1000.00,8000.00,9000.00,2212.73,3300.82,0.25,1
63707,6324,1000.00,9000.00,10000.00,0.00,9000.00,0.30,1
63708,6324,-1000.00,8000.00,9000.00,7622.11,2377.89,0.07,0
63709,6324,1000.00,9000.00,10000.00,2540.78,6459.22,0.14,1
63710,6324,1000.00,10000.00,11000.00,0.00,10000.00,0.18,1
63711,6324,1000.00,11000.00,12000.00,2762.99,8237.01,0.16,1
63712,6324,1000.00,12000.00,13000.00,2782.28,9217.72,0.39,1
63713,6324,1000.00,13000.00,14000.00,3481.25,5581.10,0.25,1
63714,6324,1000.00,14000.00,15000.00,2721.32,11278.68,0.09,1
63715,6324,1000.00,15000.00,16000.00,0.00,6582.41,0.29,1
63716,6324,1000.00,16000.00,17000.00,8000.00,8000.00,0.06,1
63717,6324,1000.00,17000.00,18000.00,3971.46,13028.54,0.39,1
63718,6324,1000.00,18000.00,19000.00,1366.62,16633.38,0.41,1
63719,6324,1000.00,19000.00,20000.00,9500.00,9500.00,0.06,1
63720,6324,1000.00,20000.00,21000.00,0.00,4347.67,0.15,1
63721,6324,1000.00,21000.00,22000.00,0.00,21000.00,0.36,1
63722,6324,1000.00,22000.00,23000.00,0.00,22000.00,0.28,1
63723,6324,1000.00,23000.00,24000.00,0.00,23000.00,0.36,1
63724,6324,1000.00,24000.00,25000.00,0.00,20888.95,0.21,1
63725,6324,-1000.00,23000.00,24000.00,15945.68,9054.32,0.10,0
63726,6324,0.00,23000.00,24000.00,0.00,0.00,0.04,0
63727,6324,0.00,23000.00,24000.00,0.00,0.00,0.09,0
63728,6324,1000.00,24000.00,25000.00,0.00,24000.00,0.29,1
63729,6324,1000.00,25000.00,26000.00,400.79,11849.16,0.30,1
63730,6324,1000.00,26000.00,27000.00,0.00,13663.03,0.08,1
63731,6324,1000.00,27000.00,28000.00,0.00,16205.41,0.35,1
63732,6324,1000.00,28000.00,29000.00,0.00,28000.00,0.28,1
63733,6324,1000.00,29000.00,30000.00,0.00,16454.53,0.30,1
63734,6324,1000.00,30000.00,31000.00,0.00,28292.48,0.41,1
63735,6324,1000.00,31000.00,32000.00,0.00,15162.69,0.30,1
63736,6324,1000.00,32000.00,33000.00,1222.34,30777.66,0.38,1
63737,6324,1000.00,33000.00,34000.00,0.00,33000.00,0.28,1
63738,6324,1000.00,34000.00,35000.00,0.00,34000.00,0.41,1
63739,6324,1000.00,35000.00,36000.00,0.00,35000.00,0.19,1
63740,6324,-1000.00,34000.00,35000.00,9713.79,8580.15,0.18,0
63741,6324,1000.00,35000.00,36000.00,0.00,35000.00,0.29,1
63742,6324,1000.00,36000.00,37000.00,0.00,36000.00,0.17,1
63743,6324,1000.00,37000.00,38000.00,12368.78,24631.22,0.24,1
63744,6324,1000.00,38000.00,39000.00,0.00,24291.30,0.03,1
63745,6325,1000.00,1000.00,2000.00,0.00,1000.00,0.14,1
63746,6325,1000.00,2000.00,3000.00,0.00,337.54,0.16,1
63747,6325,-1000.00,1000.00,2000.00,2159.07,574.93,0.09,0
63748,6325,1000.00,2000.00,3000.00,0.00,2000.00,0.12,1
63749,6325,1000.00,3000.00,4000.00,1046.31,1953.69,0.32,1
63750,6325,1000.00,4000.00,5000.00,1098.55,2901.45,0.37,1
63751,6325,1000.00,5000.00,6000.00,0.00,5000.00,0.16,1
63752,6325,1000.00,6000.00,7000.00,2629.96,3370.04,0.18,1
63753,6325,1000.00,7000.00,8000.00,727.51,4685.31,0.37,1
63754,6325,1000.00,8000.00,9000.00,0.00,8000.00,0.37,1
63755,6325,1000.00,9000.00,10000.00,0.00,9000.00,0.39,1
63756,6325,-1000.00,8000.00,9000.00,5987.55,4012.45,0.03,0
63757,6325,1000.00,9000.00,10000.00,4500.00,4500.00,0.00,1
63758,6325,1000.00,10000.00,11000.00,0.00,10000.00,0.39,1
63759,6325,1000.00,11000.00,12000.00,2836.84,8163.16,0.30,1
63760,6325,1000.00,12000.00,13000.00,0.00,12000.00,0.24,1
63761,6325,1000.00,13000.00,14000.00,0.00,11534.14,0.43,1
63762,6325,1000.00,14000.00,15000.00,5589.64,8410.36,0.29,1
63763,6325,1000.00,15000.00,16000.00,3911.92,8363.38,0.31,1
63764,6325,1000.00,16000.00,17000.00,0.00,4053.30,0.16,1
63765,6325,1000.00,17000.00,18000.00,8500.00,8500.00,0.10,1
63766,6325,1000.00,18000.00,19000.00,1687.40,16312.60,0.43,1
63767,6325,1000.00,19000.00,20000.00,6671.44,12328.56,0.07,1
63768,6325,1000.00,20000.00,21000.00,0.00,20000.00,0.28,1
63769,6325,1000.00,21000.00,22000.00,0.00,3289.49,0.05,1
63770,6325,-1000.00,20000.00,21000.00,11331.51,10668.49,0.11,0
63771,6325,-1000.00,19000.00,20000.00,3495.86,17504.14,0.42,0
63772,6325,0.00,19000.00,20000.00,0.00,0.00,0.19,0
63773,6325,-1000.00,18000.00,19000.00,0.00,20000.00,0.21,0
63774,6325,-1000.00,17000.00,18000.00,1446.57,11411.02,0.44,0
63775,6325,-1000.00,16000.00,17000.00,18000.00,0.00,0.06,0
63776,6325,-1000.00,15000.00,16000.00,2215.12,14784.88,0.38,0
63777,6325,0.00,15000.00,16000.00,0.00,0.00,0.10,0
63778,6325,-1000.00,14000.00,15000.00,4804.45,11195.55,0.35,0
63779,6325,-1000.00,13000.00,14000.00,0.00,15000.00,0.43,0
63780,6325,-1000.00,12000.00,13000.00,0.00,14000.00,0.21,0
63781,6325,-1000.00,11000.00,12000.00,0.00,5637.73,0.06,0
63782,6325,-1000.00,10000.00,11000.00,152.33,11847.67,0.43,0
63783,6325,-1000.00,9000.00,10000.00,0.00,11000.00,0.01,0
63784,6325,-1000.00,8000.00,9000.00,2279.08,7720.92,0.40,0
63785,6325,-1000.00,7000.00,8000.00,0.00,8176.35,0.44,0
63786,6325,-1000.00,6000.00,7000.00,3587.12,4412.88,0.20,0
63787,6325,-1000.00,5000.00,6000.00,3308.69,3691.31,0.14,0
63788,6325,-1000.00,4000.00,5000.00,927.83,5072.17,0.19,0
63789,6325,-1000.00,3000.00,4000.00,0.00,5000.00,0.26,0
63790,6326,-1000.00,-1000.00,0.00,0.00,1000.00,0.26,0
63791,6327,0.00,0.00,1000.00,0.00,0.00,0.08,0
63792,6327,-1000.00,-1000.00,0.00,549.56,450.44,0.19,0
63793,6328,-193.31,-193.31,806.69,0.00,193.31,0.39,0
63794,6328,-806.69,-1000.00,0.00,283.29,523.40,0.17,0
63795,6329,-1000.00,-1000.00,0.00,291.89,708.11,0.31,0
63796,6330,0.00,0.00,1000.00,0.00,0.00,0.12,0
63797,6330,-1000.00,-1000.00,0.00,0.00,120.44,0.15,0
63798,6331,1000.00,1000.00,2000.00,0.00,561.72,0.41,1
63799,6331,1000.00,2000.00,3000.00,0.00,2000.00,0.27,1
63800,6331,1000.00,3000.00,4000.00,901.63,2098.37,0.33,1
63801,6331,-1000.00,2000.00,3000.00,2133.56,1866.44,0.15,0
63802,6331,1000.00,3000.00,4000.00,0.00,822.91,0.21,1
63803,6331,1000.00,4000.00,5000.00,1441.09,2558.91,0.28,1
63804,6331,1000.00,5000.00,6000.00,0.00,5000.00,0.02,1
63805,6331,1000.00,6000.00,7000.00,0.00,5879.91,0.35,1
63806,6331,1000.00,7000.00,8000.00,0.00,2976.71,0.25,1
63807,6331,1000.00,8000.00,9000.00,0.00,8000.00,0.20,1
63808,6331,1000.00,9000.00,10000.00,3947.95,5052.05,0.25,1
63809,6331,1000.00,10000.00,11000.00,4268.87,5731.13,0.12,1
63810,6331,-1000.00,9000.00,10000.00,11000.00,0.00,0.02,0
63811,6331,1000.00,10000.00,11000.00,0.00,10000.00,0.41,1
63812,6331,1000.00,11000.00,12000.00,3451.12,7548.88,0.07,1
63813,6331,1000.00,12000.00,13000.00,3210.90,8789.10,0.37,1
63814,6331,-1000.00,11000.00,12000.00,6217.89,5000.11,0.19,0
63815,6331,1000.00,12000.00,13000.00,0.00,4572.04,0.17,1
63816,6331,-1000.00,11000.00,12000.00,6655.91,6344.09,0.19,0
63817,6331,1000.00,12000.00,13000.00,3925.03,8074.97,0.25,1
63818,6331,1000.00,13000.00,14000.00,5944.97,7055.03,0.13,1
63819,6331,1000.00,14000.00,15000.00,0.00,7060.05,0.29,1
63820,6331,1000.00,15000.00,16000.00,0.00,15000.00,0.24,1
63821,6331,0.00,15000.00,16000.00,0.00,0.00,0.04,0
63822,6331,1000.00,16000.00,17000.00,5574.22,10425.78,0.21,1
63823,6331,1000.00,17000.00,18000.00,0.00,14107.07,0.41,1
63824,6331,1000.00,18000.00,19000.00,0.00,18000.00,0.29,1
63825,6331,1000.00,19000.00,20000.00,1560.74,17439.26,0.28,1
63826,6331,1000.00,20000.00,21000.00,0.00,20000.00,0.32,1
63827,6331,1000.00,21000.00,22000.00,0.00,21000.00,0.42,1
63828,6331,1000.00,22000.00,23000.00,9513.05,12486.95,0.19,1
63829,6331,1000.00,23000.00,24000.00,11352.38,11647.62,0.09,1
63830,6331,1000.00,24000.00,25000.00,7502.45,16497.55,0.33,1
63831,6331,1000.00,25000.00,26000.00,6874.93,18125.07,0.36,1
63832,6331,-1000.00,24000.00,25000.00,9737.68,0.00,0.07,0
63833,6331,1000.00,25000.00,26000.00,152.30,8026.46,0.23,1
63834,6331,1000.00,26000.00,27000.00,10991.09,15008.91,0.27,1
63835,6331,1000.00,27000.00,28000.00,7504.35,11063.04,0.24,1
63836,6331,1000.00,28000.00,29000.00,0.00,16019.04,0.33,1
63837,6331,1000.00,29000.00,30000.00,0.00,29000.00,0.27,1
63838,6331,1000.00,30000.00,31000.00,4453.70,25546.30,0.40,1
63839,6331,1000.00,31000.00,32000.00,0.00,15690.09,0.31,1
63840,6331,1000.00,32000.00,33000.00,0.00,32000.00,0.22,1
63841,6331,1000.00,33000.00,34000.00,38.12,6346.11,0.18,1
63842,6331,-1000.00,32000.00,33000.00,9645.88,7282.71,0.17,0
63843,6331,1000.00,33000.00,34000.00,0.00,33000.00,0.05,1
63844,6331,1000.00,34000.00,35000.00,0.00,34000.00,0.10,1
63845,6331,-1000.00,33000.00,34000.00,11307.85,0.00,0.07,0
63846,6331,-1000.00,32000.00,33000.00,0.00,32865.39,0.17,0
63847,6331,-1000.00,31000.00,32000.00,12965.22,20034.78,0.29,0
63848,6331,-1000.00,30000.00,31000.00,12141.77,19858.23,0.21,0
63849,6331,-1000.00,29000.00,30000.00,0.00,19179.04,0.32,0
63850,6331,-1000.00,28000.00,29000.00,118.97,29881.03,0.43,0
63851,6331,-1000.00,27000.00,28000.00,0.00,29000.00,0.14,0
63852,6331,-1000.00,26000.00,27000.00,13636.58,14363.42,0.11,0
63853,6331,-1000.00,25000.00,26000.00,0.00,27000.00,0.25,0
63854,6331,-1000.00,24000.00,25000.00,0.00,26000.00,0.11,0
63855,6331,-1000.00,23000.00,24000.00,0.00,22676.85,0.22,0
63856,6331,-1000.00,22000.00,23000.00,8051.67,15948.33,0.33,0
63857,6331,-1000.00,21000.00,22000.00,11500.00,11500.00,0.03,0
63858,6331,-1000.00,20000.00,21000.00,5791.77,16208.23,0.38,0
63859,6331,-1000.00,19000.00,20000.00,7860.30,13139.70,0.23,0
63860,6331,-1000.00,18000.00,19000.00,0.00,4550.22,0.11,0
63861,6331,-1000.00,17000.00,18000.00,0.00,19000.00,0.13,0
63862,6331,-1000.00,16000.00,17000.00,12780.47,3392.13,0.09,0
63863,6331,0.00,16000.00,17000.00,0.00,0.00,0.03,0
63864,6331,-1000.00,15000.00,16000.00,0.00,13942.37,0.42,0
63865,6331,-1000.00,14000.00,15000.00,0.00,16000.00,0.11,0
63866,6331,-1000.00,13000.00,14000.00,0.00,3066.92,0.17,0
63867,6331,-1000.00,12000.00,13000.00,7000.00,7000.00,0.04,0
63868,6331,-1000.00,11000.00,12000.00,6500.00,6500.00,0.02,0
63869,6331,-1000.00,10000.00,11000.00,5192.11,6807.89,0.16,0
63870,6331,-1000.00,9000.00,10000.00,1943.39,1685.58,0.19,0
63871,6331,-1000.00,8000.00,9000.00,0.00,8555.33,0.39,0
63872,6331,-1000.00,7000.00,8000.00,2335.22,4197.07,0.27,0
63873,6331,0.00,7000.00,8000.00,0.00,0.00,0.10,0
63874,6331,-1000.00,6000.00,7000.00,344.47,1670.73,0.18,0
63875,6331,-1000.00,5000.00,6000.00,0.00,7000.00,0.02,0
63876,6331,-1000.00,4000.00,5000.00,0.00,5984.61,0.19,0
63877,6331,0.00,4000.00,5000.00,0.00,0.00,0.08,0
63878,6331,-1000.00,3000.00,4000.00,0.00,4558.86,0.44,0
63879,6331,-1000.00,2000.00,3000.00,0.00,4000.00,0.34,0
63880,6331,-1000.00,1000.00,2000.00,0.00,2990.47,0.35,0
63881,6331,-1000.00,0.00,1000.00,0.00,2000.00,0.11,0
63882,6331,-1000.00,-1000.00,0.00,236.38,763.62,0.37,0
63883,6332,-1000.00,-1000.00,0.00,500.00,500.00,0.04,0
63884,6333,-1000.00,-1000.00,0.00,298.65,701.35,0.07,0
63885,6334,0.00,0.00,1000.00,0.00,0.00,0.38,0
63886,6334,1000.00,1000.00,2000.00,81.05,0.00,0.39,1
63887,6334,-214.04,785.96,1785.96,0.00,214.04,0.09,0
63888,6334,-1000.00,-214.04,785.96,529.83,1081.92,0.24,0
63889,6334,-459.79,-673.83,326.17,0.00,459.79,0.30,0
63890,6334,0.00,-673.83,326.17,0.00,0.00,0.14,0
63891,6334,-326.17,-1000.00,0.00,0.00,326.17,0.28,0
63892,6335,-539.31,-539.31,460.69,0.00,539.31,0.31,0
63893,6335,-168.54,-707.85,292.15,25.32,143.22,0.23,0
63894,6335,-292.15,-1000.00,0.00,35.04,257.11,0.12,0
63895,6336,-1000.00,-1000.00,0.00,447.61,552.39,0.15,0
63896,6337,-881.75,-881.75,118.25,881.75,0.00,0.15,0
63897,6337,-118.25,-1000.00,0.00,62.48,55.77,0.11,0
63898,6338,-1000.00,-1000.00,0.00,80.66,919.34,0.34,0
63899,6339,-1000.00,-1000.00,0.00,626.00,374.00,0.13,0
63900,6340,1000.00,1000.00,2000.00,0.00,1000.00,0.13,1
63901,6340,1000.00,2000.00,3000.00,611.59,1388.41,0.30,1
63902,6340,1000.00,3000.00,4000.00,0.00,2637.40,0.23,1
63903,6340,1000.00,4000.00,5000.00,1783.03,2216.97,0.01,1
63904,6340,1000.00,5000.00,6000.00,1108.06,3891.94,0.40,1
63905,6340,0.00,5000.00,6000.00,0.00,0.00,0.02,0
63906,6340,1000.00,6000.00,7000.00,659.57,5340.43,0.42,1
63907,6340,1000.00,7000.00,8000.00,0.00,7000.00,0.33,1
63908,6340,1000.00,8000.00,9000.00,634.73,2035.53,0.20,1
63909,6340,1000.00,9000.00,10000.00,776.13,8223.87,0.11,1
63910,6340,-1000.00,8000.00,9000.00,2395.32,0.00,0.10,0
63911,6340,1000.00,9000.00,10000.00,2179.89,6820.11,0.26,1
63912,6340,-323.45,8676.55,9676.55,323.45,0.00,0.05,0
63913,6340,1000.00,9676.55,10676.55,0.00,9676.55,0.11,1
63914,6340,1000.00,10676.55,11676.55,3061.69,7614.86,0.34,1
63915,6340,1000.00,11676.55,12676.55,4910.51,6766.04,0.06,1
63916,6340,1000.00,12676.55,13676.55,3775.69,8900.86,0.36,1
63917,6340,1000.00,13676.55,14676.55,0.00,6809.56,0.21,1
63918,6340,1000.00,14676.55,15676.55,0.00,14676.55,0.16,1
63919,6340,1000.00,15676.55,16676.55,2926.76,12749.79,0.40,1
63920,6340,-1000.00,14676.55,15676.55,9220.89,0.00,0.00,0
63921,6340,1000.00,15676.55,16676.55,0.00,15676.55,0.27,1
63922,6340,1000.00,16676.55,17676.55,0.00,16676.55,0.13,1
63923,6340,1000.00,17676.55,18676.55,5164.64,12511.91,0.35,1
63924,6340,-976.13,16700.41,17700.41,976.13,0.00,0.03,0
63925,6340,1000.00,17700.41,18700.41,0.00,12162.63,0.37,1
63926,6340,1000.00,18700.41,19700.41,0.00,7986.17,0.24,1
63927,6340,1000.00,19700.41,20700.41,0.00,14567.13,0.37,1
63928,6340,1000.00,20700.41,21700.41,0.00,20700.41,0.29,1
63929,6340,1000.00,21700.41,22700.41,0.00,21700.41,0.16,1
63930,6340,1000.00,22700.41,23700.41,0.00,1304.93,0.11,1
63931,6340,1000.00,23700.41,24700.41,0.00,23700.41,0.22,1
63932,6340,1000.00,24700.41,25700.41,7233.35,17467.06,0.35,1
63933,6340,1000.00,25700.41,26700.41,0.00,25700.41,0.16,1
63934,6340,1000.00,26700.41,27700.41,0.00,26700.41,0.20,1
63935,6340,1000.00,27700.41,28700.41,13850.21,13850.21,0.08,1
63936,6340,1000.00,28700.41,29700.41,7081.39,21619.03,0.37,1
63937,6340,1000.00,29700.41,30700.41,0.00,29700.41,0.34,1
63938,6340,1000.00,30700.41,31700.41,0.00,26402.95,0.20,1
63939,6340,1000.00,31700.41,32700.41,0.00,31700.41,0.09,1
63940,6340,1000.00,32700.41,33700.41,8584.51,20051.79,0.33,1
63941,6340,1000.00,33700.41,34700.41,15464.04,18236.37,0.24,1
63942,6340,1000.00,34700.41,35700.41,0.00,26301.03,0.26,1
63943,6340,1000.00,35700.41,36700.41,0.00,18469.87,0.29,1
63944,6340,1000.00,36700.41,37700.41,0.00,24136.80,0.08,1
63945,6341,-1000.00,-1000.00,0.00,487.97,512.03,0.18,0
63946,6342,1000.00,1000.00,2000.00,398.21,601.79,0.21,1
63947,6342,1000.00,2000.00,3000.00,529.80,1470.20,0.21,1
63948,6342,1000.00,3000.00,4000.00,146.91,2853.09,0.30,1
63949,6342,1000.00,4000.00,5000.00,0.00,3308.08,0.18,1
63950,6342,1000.00,5000.00,6000.00,0.00,2774.54,0.29,1
63951,6342,1000.00,6000.00,7000.00,2919.61,3080.39,0.18,1
63952,6342,1000.00,7000.00,8000.00,447.04,2783.87,0.27,1
63953,6342,-1000.00,6000.00,7000.00,2262.27,5737.73,0.32,0
63954,6342,-1000.00,5000.00,6000.00,0.00,4574.18,0.13,0
63955,6342,0.00,5000.00,6000.00,0.00,0.00,0.34,0
63956,6342,0.00,5000.00,6000.00,0.00,0.00,0.39,0
63957,6342,0.00,5000.00,6000.00,0.00,0.00,0.30,0
63958,6342,-1000.00,4000.00,5000.00,400.64,3082.44,0.32,0
63959,6342,-1000.00,3000.00,4000.00,4666.58,333.42,0.10,0
63960,6342,-645.16,2354.84,3354.84,645.16,0.00,0.36,0
63961,6342,-1000.00,1354.84,2354.84,0.00,1595.50,0.24,0
63962,6342,-1000.00,354.84,1354.84,1579.20,775.64,0.13,0
63963,6342,-1000.00,-645.16,354.84,0.00,258.93,0.33,0
63964,6342,0.00,-645.16,354.84,0.00,0.00,0.08,0
63965,6342,-183.13,-828.29,171.71,131.26,51.87,0.35,0
63966,6342,-42.37,-870.65,129.35,42.37,0.00,0.23,0
63967,6342,-1000.00,-1870.65,-870.65,0.00,129.35,0.04,0
63968,6343,-1000.00,-1000.00,0.00,1000.00,0.00,0.05,0
63969,6344,0.00,0.00,1000.00,0.00,0.00,0.08,0
63970,6344,1000.00,1000.00,2000.00,0.00,906.10,0.21,1
63971,6344,-255.29,744.71,1744.71,195.12,60.17,0.12,0
63972,6344,1000.00,1744.71,2744.71,0.00,1744.71,0.40,1
63973,6344,1000.00,2744.71,3744.71,0.00,1852.90,0.35,1
63974,6344,-1000.00,1744.71,2744.71,2129.31,1615.40,0.14,0
63975,6344,1000.00,2744.71,3744.71,165.94,2578.77,0.06,1
63976,6344,-1000.00,1744.71,2744.71,2948.03,0.00,0.03,0
63977,6344,-1000.00,744.71,1744.71,1547.61,1197.10,0.13,0
63978,6344,1000.00,1744.71,2744.71,237.88,1506.83,0.13,1
63979,6344,1000.00,2744.71,3744.71,503.64,1056.72,0.25,1
63980,6344,1000.00,3744.71,4744.71,0.00,753.00,0.18,1
63981,6344,1000.00,4744.71,5744.71,0.00,4686.77,0.36,1
63982,6344,1000.00,5744.71,6744.71,0.00,5744.71,0.43,1
63983,6344,1000.00,6744.71,7744.71,0.00,6744.71,0.08,1
63984,6344,-1000.00,5744.71,6744.71,3927.42,3817.29,0.20,0
63985,6344,1000.00,6744.71,7744.71,0.00,6512.62,0.18,1
63986,6344,1000.00,7744.71,8744.71,0.00,7744.71,0.09,1
63987,6344,-1000.00,6744.71,7744.71,4514.21,4230.50,0.03,0
63988,6344,1000.00,7744.71,8744.71,0.00,1321.11,0.16,1
63989,6344,1000.00,8744.71,9744.71,1483.20,7261.51,0.38,1
63990,6344,1000.00,9744.71,10744.71,2858.59,6886.12,0.30,1
63991,6344,1000.00,10744.71,11744.71,0.00,10744.71,0.06,1
63992,6344,1000.00,11744.71,12744.71,5872.36,5872.36,0.11,1
63993,6344,1000.00,12744.71,13744.71,2509.68,5114.15,0.25,1
63994,6344,1000.00,13744.71,14744.71,0.00,11583.20,0.38,1
63995,6344,1000.00,14744.71,15744.71,0.00,14744.71,0.18,1
63996,6344,1000.00,15744.71,16744.71,0.00,15744.71,0.22,1
63997,6344,1000.00,16744.71,17744.71,7296.64,9448.07,0.19,1
63998,6344,1000.00,17744.71,18744.71,156.38,17588.33,0.33,1
63999,6344,-1000.00,16744.71,17744.71,2966.60,0.00,0.07,0
64000,6344,-1000.00,15744.71,16744.71,9567.97,404.07,0.08,0
64001,6344,-1000.00,14744.71,15744.71,7760.53,6211.08,0.19,0
64002,6344,1000.00,15744.71,16744.71,0.00,15744.71,0.11,1
64003,6344,0.00,15744.71,16744.71,0.00,0.00,0.08,0
64004,6344,1000.00,16744.71,17744.71,898.85,14978.41,0.43,1
64005,6344,1000.00,17744.71,18744.71,0.00,17744.71,0.30,1
64006,6344,1000.00,18744.71,19744.71,2299.15,2539.79,0.15,1
64007,6344,1000.00,19744.71,20744.71,0.00,8393.39,0.27,1
64008,6344,1000.00,20744.71,21744.71,9834.72,10909.99,0.19,1
64009,6344,1000.00,21744.71,22744.71,7232.00,14512.71,0.15,1
64010,6344,1000.00,22744.71,23744.71,6802.49,15942.23,0.36,1
64011,6344,1000.00,23744.71,24744.71,0.00,23744.71,0.07,1
64012,6344,1000.00,24744.71,25744.71,0.00,24744.71,0.22,1
64013,6344,1000.00,25744.71,26744.71,5160.72,20016.34,0.39,1
64014,6344,-1000.00,24744.71,25744.71,0.00,26744.71,0.38,0
64015,6344,0.00,24744.71,25744.71,0.00,0.00,0.05,0
64016,6344,-1000.00,23744.71,24744.71,0.00,25744.71,0.02,0
64017,6344,-1000.00,22744.71,23744.71,0.00,24744.71,0.35,0
64018,6344,-1000.00,21744.71,22744.71,0.00,12134.58,0.32,0
64019,6344,-1000.00,20744.71,21744.71,5603.67,17141.04,0.35,0
64020,6344,-1000.00,19744.71,20744.71,3773.73,17970.98,0.28,0
64021,6344,-1000.00,18744.71,19744.71,0.00,12910.38,0.34,0
64022,6344,-1000.00,17744.71,18744.71,0.00,19744.71,0.25,0
64023,6344,-1000.00,16744.71,17744.71,0.00,17104.64,0.05,0
64024,6344,-1000.00,15744.71,16744.71,8075.46,9669.25,0.03,0
64025,6344,-1000.00,14744.71,15744.71,0.00,16744.71,0.17,0
64026,6344,-1000.00,13744.71,14744.71,0.00,15744.71,0.04,0
64027,6344,-1000.00,12744.71,13744.71,0.00,1122.27,0.15,0
64028,6344,-1000.00,11744.71,12744.71,0.00,9519.22,0.19,0
64029,6344,-1000.00,10744.71,11744.71,0.00,12388.03,0.34,0
64030,6344,-1000.00,9744.71,10744.71,4556.79,7187.92,0.30,0
64031,6344,-1000.00,8744.71,9744.71,5478.14,5266.57,0.17,0
64032,6344,-1000.00,7744.71,8744.71,0.00,3861.81,0.12,0
64033,6345,1000.00,1000.00,2000.00,534.78,465.22,0.10,1
64034,6345,0.00,1000.00,2000.00,0.00,0.00,0.01,0
64035,6345,-1000.00,0.00,1000.00,360.81,1639.19,0.41,0
64036,6345,1000.00,1000.00,2000.00,169.59,0.00,0.37,1
64037,6345,-1000.00,0.00,1000.00,385.21,1614.79,0.10,0
64038,6345,-881.77,-881.77,118.23,0.00,881.77,0.08,0
64039,6345,-118.23,-1000.00,0.00,0.00,118.23,0.16,0
64040,6346,1000.00,1000.00,2000.00,0.00,985.24,0.29,1
64041,6346,1000.00,2000.00,3000.00,0.00,1441.17,0.27,1
64042,6346,1000.00,3000.00,4000.00,619.67,2301.81,0.39,1
64043,6346,1000.00,4000.00,5000.00,1082.58,2917.42,0.26,1
64044,6346,1000.00,5000.00,6000.00,1629.42,3370.58,0.26,1
64045,6346,1000.00,6000.00,7000.00,0.00,6000.00,0.44,1
64046,6346,-1000.00,5000.00,6000.00,3677.34,3322.66,0.04,0
64047,6346,-1000.00,4000.00,5000.00,3131.14,2868.86,0.19,0
64048,6346,0.00,4000.00,5000.00,0.00,0.00,0.06,0
64049,6346,1000.00,5000.00,6000.00,0.00,5000.00,0.12,1
64050,6346,1000.00,6000.00,7000.00,0.00,6000.00,0.41,1
64051,6346,1000.00,7000.00,8000.00,0.00,7000.00,0.21,1
64052,6346,1000.00,8000.00,9000.00,2806.45,5193.55,0.28,1
64053,6346,1000.00,9000.00,10000.00,0.00,9000.00,0.09,1
64054,6346,1000.00,10000.00,11000.00,0.00,10000.00,0.43,1
64055,6346,1000.00,11000.00,12000.00,1467.46,9532.54,0.42,1
64056,6346,-1000.00,10000.00,11000.00,7265.31,4734.69,0.15,0
64057,6346,1000.00,11000.00,12000.00,0.00,10367.01,0.42,1
64058,6346,1000.00,12000.00,13000.00,4021.87,6483.76,0.28,1
64059,6346,-1000.00,11000.00,12000.00,7110.21,5889.79,0.18,0
64060,6346,1000.00,12000.00,13000.00,3463.33,8536.67,0.25,1
64061,6346,1000.00,13000.00,14000.00,5066.96,7933.04,0.24,1
64062,6346,0.00,13000.00,14000.00,0.00,0.00,0.08,0
64063,6346,-1000.00,12000.00,13000.00,1835.03,12164.97,0.42,0
64064,6346,-1000.00,11000.00,12000.00,0.00,12738.64,0.14,0
64065,6346,-1000.00,10000.00,11000.00,0.00,12000.00,0.20,0
64066,6346,-1000.00,9000.00,10000.00,807.50,8935.40,0.42,0
64067,6346,-977.45,8022.55,9022.55,0.00,977.45,0.07,0
64068,6346,-1000.00,7022.55,8022.55,926.31,7434.42,0.42,0
64069,6346,-1000.00,6022.55,7022.55,2066.95,5955.60,0.35,0
64070,6346,-1000.00,5022.55,6022.55,0.00,2113.46,0.09,0
64071,6346,-1000.00,4022.55,5022.55,0.00,5592.46,0.33,0
64072,6346,-244.05,3778.50,4778.50,0.00,244.05,0.11,0
64073,6346,-1000.00,2778.50,3778.50,1942.09,2836.41,0.22,0
64074,6346,-1000.00,1778.50,2778.50,0.00,2661.08,0.05,0
64075,6346,-1000.00,778.50,1778.50,920.33,1858.17,0.17,0
64076,6346,-1000.00,-221.50,778.50,0.00,1778.50,0.05,0
64077,6346,1000.00,778.50,1778.50,118.10,660.40,0.42,1
64078,6346,1000.00,1778.50,2778.50,0.00,1778.50,0.42,1
64079,6346,1000.00,2778.50,3778.50,0.00,2778.50,0.17,1
64080,6346,1000.00,3778.50,4778.50,875.67,2902.83,0.20,1
64081,6346,-1000.00,2778.50,3778.50,3081.97,1105.44,0.11,0
64082,6346,1000.00,3778.50,4778.50,1889.25,1889.25,0.01,1
64083,6346,1000.00,4778.50,5778.50,2389.25,2389.25,0.01,1
64084,6346,-1000.00,3778.50,4778.50,2619.70,2434.00,0.21,0
64085,6346,1000.00,4778.50,5778.50,1049.79,3728.71,0.40,1
64086,6346,-1000.00,3778.50,4778.50,3624.29,2154.21,0.03,0
64087,6346,1000.00,4778.50,5778.50,585.15,4193.35,0.43,1
64088,6346,1000.00,5778.50,6778.50,1874.56,3903.94,0.28,1
64089,6346,-1000.00,4778.50,5778.50,4192.37,2586.13,0.11,0
64090,6346,1000.00,5778.50,6778.50,1266.09,4512.41,0.34,1
64091,6346,-1000.00,4778.50,5778.50,4538.44,2240.06,0.12,0
64092,6346,1000.00,5778.50,6778.50,1654.40,3067.29,0.29,1
64093,6347,-1000.00,-1000.00,0.00,0.00,1000.00,0.22,0
64094,6348,-53.74,-53.74,946.26,0.00,53.74,0.12,0
64095,6348,-1000.00,-1053.74,-53.74,158.52,125.46,0.15,0
64096,6349,-1000.00,-1000.00,0.00,206.60,793.40,0.40,0
64097,6350,-1000.00,-1000.00,0.00,0.00,796.38,0.18,0
64098,6351,-1000.00,-1000.00,0.00,463.66,160.59,0.12,0
64099,6352,-1000.00,-1000.00,0.00,921.29,78.71,0.08,0
64100,6353,1000.00,1000.00,2000.00,83.50,916.50,0.36,1
64101,6353,-1000.00,0.00,1000.00,1033.69,966.31,0.13,0
64102,6353,1000.00,1000.00,2000.00,0.00,1000.00,0.19,1
64103,6353,1000.00,2000.00,3000.00,0.00,1246.65,0.26,1
64104,6353,1000.00,3000.00,4000.00,0.00,3000.00,0.16,1
64105,6353,1000.00,4000.00,5000.00,0.00,4000.00,0.27,1
64106,6353,1000.00,5000.00,6000.00,1420.61,3579.39,0.35,1
64107,6353,1000.00,6000.00,7000.00,0.00,5655.84,0.19,1
64108,6353,1000.00,7000.00,8000.00,1559.74,5440.26,0.39,1
64109,6353,1000.00,8000.00,9000.00,0.00,2273.61,0.19,1
64110,6353,1000.00,9000.00,10000.00,0.00,9000.00,0.42,1
64111,6353,1000.00,10000.00,11000.00,3750.27,6249.73,0.27,1
64112,6353,1000.00,11000.00,12000.00,0.00,10303.42,0.13,1
64113,6353,0.00,11000.00,12000.00,0.00,0.00,0.05,0
64114,6353,1000.00,12000.00,13000.00,0.00,12000.00,0.22,1
64115,6353,1000.00,13000.00,14000.00,2191.42,8155.02,0.35,1
64116,6353,1000.00,14000.00,15000.00,0.00,3430.38,0.16,1
64117,6353,1000.00,15000.00,16000.00,178.23,12326.46,0.42,1
64118,6353,1000.00,16000.00,17000.00,0.00,16000.00,0.10,1
64119,6353,1000.00,17000.00,18000.00,7238.87,9761.13,0.19,1
64120,6353,-1000.00,16000.00,17000.00,5920.76,5430.24,0.19,0
64121,6353,1000.00,17000.00,18000.00,0.00,17000.00,0.40,1
64122,6353,-1000.00,16000.00,17000.00,2920.16,1422.52,0.13,0
64123,6353,1000.00,17000.00,18000.00,0.00,17000.00,0.35,1
64124,6353,-1000.00,16000.00,17000.00,0.00,18000.00,0.03,0
64125,6353,-1000.00,15000.00,16000.00,4367.80,12632.20,0.38,0
64126,6353,-1000.00,14000.00,15000.00,3099.51,3107.42,0.17,0
64127,6353,-1000.00,13000.00,14000.00,0.00,15000.00,0.35,0
64128,6353,-1000.00,12000.00,13000.00,0.00,3487.73,0.12,0
64129,6353,-1000.00,11000.00,12000.00,6431.34,6568.66,0.19,0
64130,6353,-1000.00,10000.00,11000.00,6000.00,6000.00,0.03,0
64131,6353,-1000.00,9000.00,10000.00,1329.70,9670.30,0.42,0
64132,6353,-1000.00,8000.00,9000.00,3003.23,2977.37,0.20,0
64133,6353,-1000.00,7000.00,8000.00,0.00,9000.00,0.38,0
64134,6353,-1000.00,6000.00,7000.00,2741.20,5258.80,0.25,0
64135,6353,-1000.00,5000.00,6000.00,1131.07,5868.93,0.18,0
64136,6353,-1000.00,4000.00,5000.00,0.00,6000.00,0.17,0
64137,6353,-1000.00,3000.00,4000.00,0.00,5000.00,0.24,0
64138,6353,-1000.00,2000.00,3000.00,0.00,1942.83,0.29,0
64139,6353,-1000.00,1000.00,2000.00,0.00,3000.00,0.18,0
64140,6353,-1000.00,0.00,1000.00,0.00,1937.31,0.13,0
64141,6353,-1000.00,-1000.00,0.00,0.00,1000.00,0.09,0
64142,6354,-1000.00,-1000.00,0.00,122.43,877.57,0.40,0
64143,6354,-0.00,-1000.00,0.00,0.00,0.00,0.32,0
64144,6355,-1000.00,-1000.00,0.00,0.00,1000.00,0.07,0
64145,6356,-1000.00,-1000.00,0.00,0.00,1000.00,0.41,0
64146,6357,-1000.00,-1000.00,0.00,337.66,662.34,0.13,0
64147,6358,1000.00,1000.00,2000.00,317.71,682.29,0.32,1
64148,6358,-340.61,659.39,1659.39,340.61,0.00,0.09,0
64149,6358,1000.00,1659.39,2659.39,34.23,1625.15,0.43,1
64150,6358,-1000.00,659.39,1659.39,1844.94,814.45,0.01,0
64151,6358,-1000.00,-340.61,659.39,1095.27,0.00,0.05,0
64152,6358,-524.71,-865.33,134.67,524.71,0.00,0.02,0
64153,6358,0.00,-865.33,134.67,0.00,0.00,0.01,0
64154,6358,1000.00,134.67,1134.67,34.72,99.95,0.12,1
64155,6358,1000.00,1134.67,2134.67,0.00,1134.67,0.37,1
64156,6358,1000.00,2134.67,3134.67,760.85,1373.82,0.13,1
64157,6358,1000.00,3134.67,4134.67,0.00,3134.67,0.38,1
64158,6358,0.00,3134.67,4134.67,0.00,0.00,0.07,0
64159,6358,1000.00,4134.67,5134.67,0.00,4134.67,0.20,1
64160,6358,1000.00,5134.67,6134.67,348.49,632.99,0.15,1
64161,6358,1000.00,6134.67,7134.67,0.00,5799.76,0.19,1
64162,6358,1000.00,7134.67,8134.67,1015.87,1841.57,0.20,1
64163,6358,1000.00,8134.67,9134.67,0.00,8134.67,0.15,1
64164,6358,1000.00,9134.67,10134.67,2493.40,6641.28,0.28,1
64165,6358,0.00,9134.67,10134.67,0.00,0.00,0.02,0
64166,6358,1000.00,10134.67,11134.67,2071.19,8063.48,0.40,1
64167,6358,1000.00,11134.67,12134.67,4207.58,6927.09,0.27,1
64168,6358,-1000.00,10134.67,11134.67,6067.34,6067.34,0.10,0
64169,6358,-1000.00,9134.67,10134.67,1277.24,9857.44,0.33,0
64170,6358,-1000.00,8134.67,9134.67,4099.66,6035.02,0.28,0
64171,6358,-1000.00,7134.67,8134.67,6973.59,2161.08,0.08,0
64172,6358,-1000.00,6134.67,7134.67,0.00,8134.67,0.18,0
64173,6358,-1000.00,5134.67,6134.67,0.00,6209.80,0.38,0
64174,6358,-1000.00,4134.67,5134.67,0.00,6134.67,0.11,0
64175,6358,-1000.00,3134.67,4134.67,1540.03,2101.05,0.24,0
64176,6358,-1000.00,2134.67,3134.67,0.00,3434.81,0.23,0
64177,6358,-1000.00,1134.67,2134.67,607.03,2527.64,0.32,0
64178,6358,-1000.00,134.67,1134.67,109.78,2024.89,0.43,0
64179,6358,-553.30,-418.63,581.37,0.00,553.30,0.27,0
64180,6358,-494.49,-913.11,86.89,0.00,494.49,0.12,0
64181,6358,-86.89,-1000.00,0.00,31.24,55.64,0.24,0
64182,6359,-744.41,-744.41,255.59,157.49,586.92,0.34,0
64183,6359,-1000.00,-1744.41,-744.41,152.23,103.36,0.11,0
64184,6360,-1000.00,-1000.00,0.00,0.00,1000.00,0.34,0
64185,6361,1000.00,1000.00,2000.00,18.92,374.83,0.26,1
64186,6361,1000.00,2000.00,3000.00,310.39,1689.61,0.38,1
64187,6361,1000.00,3000.00,4000.00,247.31,2752.69,0.17,1
64188,6361,1000.00,4000.00,5000.00,0.00,4000.00,0.22,1
64189,6361,1000.00,5000.00,6000.00,0.00,2536.94,0.17,1
64190,6361,1000.00,6000.00,7000.00,0.00,6000.00,0.41,1
64191,6361,1000.00,7000.00,8000.00,0.00,6668.94,0.43,1
64192,6361,1000.00,8000.00,9000.00,0.00,7909.54,0.25,1
64193,6361,1000.00,9000.00,10000.00,2936.94,6063.06,0.28,1
64194,6361,1000.00,10000.00,11000.00,0.00,10000.00,0.37,1
64195,6361,1000.00,11000.00,12000.00,0.00,11000.00,0.43,1
64196,6361,1000.00,12000.00,13000.00,3325.94,8674.06,0.37,1
64197,6361,1000.00,13000.00,14000.00,4234.99,8765.01,0.32,1
64198,6361,1000.00,14000.00,15000.00,0.00,14000.00,0.10,1
64199,6361,1000.00,15000.00,16000.00,0.00,15000.00,0.09,1
64200,6361,1000.00,16000.00,17000.00,0.00,16000.00,0.27,1
64201,6361,1000.00,17000.00,18000.00,610.09,7567.71,0.29,1
64202,6361,1000.00,18000.00,19000.00,0.00,18000.00,0.28,1
64203,6361,1000.00,19000.00,20000.00,0.00,19000.00,0.43,1
64204,6361,1000.00,20000.00,21000.00,0.00,2637.43,0.03,1
64205,6361,1000.00,21000.00,22000.00,0.00,7362.61,0.22,1
64206,6361,1000.00,22000.00,23000.00,0.00,22000.00,0.33,1
64207,6361,1000.00,23000.00,24000.00,0.00,12591.60,0.31,1
64208,6361,1000.00,24000.00,25000.00,3262.18,20737.82,0.39,1
64209,6361,-1000.00,23000.00,24000.00,4968.95,20031.05,0.41,0
64210,6361,-1000.00,22000.00,23000.00,4953.16,10895.11,0.28,0
64211,6361,-1000.00,21000.00,22000.00,11839.03,11160.97,0.13,0
64212,6361,-1000.00,20000.00,21000.00,0.00,22000.00,0.44,0
64213,6361,-1000.00,19000.00,20000.00,4931.18,16068.82,0.36,0
64214,6361,-1000.00,18000.00,19000.00,376.49,15118.65,0.41,0
64215,6361,-1000.00,17000.00,18000.00,0.00,19000.00,0.01,0
64216,6361,0.00,17000.00,18000.00,0.00,0.00,0.01,0
64217,6361,-1000.00,16000.00,17000.00,0.00,8366.85,0.30,0
64218,6361,-1000.00,15000.00,16000.00,7129.21,9870.79,0.21,0
64219,6361,-1000.00,14000.00,15000.00,8000.00,8000.00,0.02,0
64220,6361,-1000.00,13000.00,14000.00,8489.92,6510.08,0.11,0
64221,6361,-1000.00,12000.00,13000.00,11555.01,0.00,0.04,0
64222,6361,-1000.00,11000.00,12000.00,820.44,7616.38,0.35,0
64223,6361,-1000.00,10000.00,11000.00,0.00,12000.00,0.43,0
64224,6361,-1000.00,9000.00,10000.00,3776.70,7223.30,0.09,0
64225,6361,-1000.00,8000.00,9000.00,0.00,10000.00,0.39,0
64226,6361,-1000.00,7000.00,8000.00,7134.27,0.00,0.00,0
64227,6361,-1000.00,6000.00,7000.00,1403.58,6596.42,0.22,0
64228,6361,-1000.00,5000.00,6000.00,589.79,6410.21,0.30,0
64229,6361,-1000.00,4000.00,5000.00,0.00,6000.00,0.19,0
64230,6361,-1000.00,3000.00,4000.00,0.00,5000.00,0.26,0
64231,6361,-1000.00,2000.00,3000.00,626.39,1268.88,0.22,0
64232,6361,-1000.00,1000.00,2000.00,996.36,187.87,0.11,0
64233,6361,-1000.00,0.00,1000.00,0.00,2000.00,0.36,0
64234,6361,-1000.00,-1000.00,0.00,294.79,705.21,0.27,0
64235,6362,-1000.00,-1000.00,0.00,0.00,871.63,0.42,0
64236,6363,-1000.00,-1000.00,0.00,0.00,1000.00,0.38,0
64237,6364,-1000.00,-1000.00,0.00,66.69,933.31,0.32,0
64238,6365,-1000.00,-1000.00,0.00,103.43,896.57,0.23,0
64239,6366,1000.00,1000.00,2000.00,0.00,414.18,0.13,1
64240,6366,1000.00,2000.00,3000.00,1000.00,1000.00,0.01,1
64241,6366,1000.00,3000.00,4000.00,0.00,3000.00,0.13,1
64242,6366,1000.00,4000.00,5000.00,0.00,4000.00,0.35,1
64243,6366,-1000.00,3000.00,4000.00,2569.57,2430.43,0.15,0
64244,6366,1000.00,4000.00,5000.00,0.00,4000.00,0.44,1
64245,6366,1000.00,5000.00,6000.00,1692.17,3307.83,0.32,1
64246,6366,1000.00,6000.00,7000.00,758.88,2327.44,0.26,1
64247,6366,1000.00,7000.00,8000.00,1786.52,5213.48,0.16,1
64248,6366,-1000.00,6000.00,7000.00,7566.23,433.77,0.01,0
64249,6366,1000.00,7000.00,8000.00,1619.15,5380.85,0.14,1
64250,6366,1000.00,8000.00,9000.00,4000.00,4000.00,0.10,1
64251,6366,1000.00,9000.00,10000.00,0.00,7748.83,0.34,1
64252,6366,1000.00,10000.00,11000.00,439.64,5308.13,0.32,1
64253,6366,1000.00,11000.00,12000.00,0.00,3126.87,0.10,1
64254,6366,1000.00,12000.00,13000.00,0.00,12000.00,0.07,1
64255,6366,1000.00,13000.00,14000.00,1999.00,11001.00,0.23,1
64256,6366,1000.00,14000.00,15000.00,0.00,14000.00,0.37,1
64257,6366,1000.00,15000.00,16000.00,0.00,661.24,0.12,1
64258,6366,1000.00,16000.00,17000.00,0.00,16000.00,0.11,1
64259,6366,-1000.00,15000.00,16000.00,0.00,6740.83,0.26,0
64260,6366,-1000.00,14000.00,15000.00,9151.28,6848.72,0.15,0
64261,6366,-1000.00,13000.00,14000.00,5309.81,9690.19,0.21,0
64262,6366,-1000.00,12000.00,13000.00,5532.15,8467.85,0.06,0
64263,6366,-1000.00,11000.00,12000.00,5732.59,7267.41,0.15,0
64264,6366,-1000.00,10000.00,11000.00,0.00,12000.00,0.15,0
64265,6366,-1000.00,9000.00,10000.00,69.37,10930.63,0.42,0
64266,6366,-1000.00,8000.00,9000.00,0.00,10000.00,0.10,0
64267,6366,-1000.00,7000.00,8000.00,2967.08,6032.92,0.31,0
64268,6366,-1000.00,6000.00,7000.00,0.00,8000.00,0.32,0
64269,6366,-1000.00,5000.00,6000.00,1975.81,5024.19,0.35,0
64270,6366,-1000.00,4000.00,5000.00,1190.17,4809.83,0.40,0
64271,6366,-1000.00,3000.00,4000.00,0.00,2423.18,0.22,0
64272,6366,-1000.00,2000.00,3000.00,2000.00,2000.00,0.01,0
64273,6366,-1000.00,1000.00,2000.00,0.00,1803.53,0.35,0
64274,6366,-1000.00,0.00,1000.00,824.68,1175.32,0.23,0
64275,6366,-1000.00,-1000.00,0.00,819.76,0.00,0.01,0
64276,6367,-1000.00,-1000.00,0.00,0.00,1000.00,0.10,0
64277,6368,-1000.00,-1000.00,0.00,454.36,545.64,0.22,0
64278,6369,-1000.00,-1000.00,0.00,435.72,564.28,0.09,0
64279,6370,1000.00,1000.00,2000.00,0.00,1000.00,0.34,1
64280,6370,1000.00,2000.00,3000.00,305.45,1694.55,0.42,1
64281,6370,1000.00,3000.00,4000.00,0.00,3000.00,0.21,1
64282,6370,-1000.00,2000.00,3000.00,750.91,696.82,0.16,0
64283,6370,1000.00,3000.00,4000.00,0.00,2085.98,0.35,1
64284,6370,1000.00,4000.00,5000.00,1093.19,2906.81,0.37,1
64285,6370,1000.00,5000.00,6000.00,2500.00,2500.00,0.03,1
64286,6370,1000.00,6000.00,7000.00,3000.00,3000.00,0.01,1
64287,6370,1000.00,7000.00,8000.00,3288.02,3711.98,0.11,1
64288,6370,0.00,7000.00,8000.00,0.00,0.00,0.02,0
64289,6370,1000.00,8000.00,9000.00,0.00,8000.00,0.23,1
64290,6370,1000.00,9000.00,10000.00,3108.71,5891.29,0.30,1
64291,6370,-1000.00,8000.00,9000.00,0.00,10000.00,0.35,0
64292,6370,-1000.00,7000.00,8000.00,3415.18,5584.82,0.26,0
64293,6370,-1000.00,6000.00,7000.00,3144.25,3671.21,0.24,0
64294,6370,-1000.00,5000.00,6000.00,0.00,7000.00,0.09,0
64295,6370,-1000.00,4000.00,5000.00,0.00,6000.00,0.22,0
64296,6370,-1000.00,3000.00,4000.00,0.00,4206.86,0.17,0
64297,6370,-1000.00,2000.00,3000.00,611.11,3388.89,0.42,0
64298,6370,-1000.00,1000.00,2000.00,0.00,3000.00,0.40,0
64299,6370,0.00,1000.00,2000.00,0.00,0.00,0.04,0
64300,6370,-1000.00,0.00,1000.00,524.12,844.89,0.25,0
64301,6370,-1000.00,-1000.00,0.00,332.51,665.39,0.32,0
64302,6371,-1000.00,-1000.00,0.00,351.19,648.81,0.27,0
64303,6372,-1000.00,-1000.00,0.00,366.15,633.85,0.31,0
64304,6372,-0.00,-1000.00,0.00,0.00,0.00,0.08,0
64305,6373,-1000.00,-1000.00,0.00,201.83,798.17,0.38,0
64306,6374,-1000.00,-1000.00,0.00,500.00,500.00,0.05,0
64307,6375,1000.00,1000.00,2000.00,501.56,498.44,0.21,1
64308,6375,-1000.00,0.00,1000.00,640.25,1359.75,0.31,0
64309,6375,-698.52,-698.52,301.48,0.00,698.52,0.13,0
64310,6375,-248.66,-947.18,52.82,0.00,248.66,0.13,0
64311,6375,-52.82,-1000.00,0.00,7.15,45.67,0.43,0
64312,6376,-389.45,-389.45,610.55,22.80,366.64,0.25,0
64313,6376,-390.75,-780.19,219.81,194.51,196.24,0.20,0
64314,6376,-211.60,-991.79,8.21,82.11,129.49,0.29,0
64315,6376,-8.20,-999.99,0.01,0.00,8.20,0.39,0
64316,6376,-0.01,-1000.00,0.00,0.00,0.01,0.32,0
64317,6376,-0.00,-1000.00,0.00,0.00,0.00,0.31,0
64318,6376,-0.00,-1000.00,0.00,0.00,0.00,0.24,0
64319,6377,-700.35,-700.35,299.65,0.00,700.35,0.16,0
64320,6377,-299.65,-1000.00,0.00,108.85,190.80,0.29,0
64321,6378,-1000.00,-1000.00,0.00,0.00,1000.00,0.03,0
64322,6379,-1000.00,-1000.00,0.00,0.00,1000.00,0.43,0
64323,6380,1000.00,1000.00,2000.00,177.19,822.81,0.39,1
64324,6380,1000.00,2000.00,3000.00,0.00,2000.00,0.08,1
64325,6380,1000.00,3000.00,4000.00,0.00,3000.00,0.34,1
64326,6380,1000.00,4000.00,5000.00,0.00,4000.00,0.28,1
64327,6380,1000.00,5000.00,6000.00,0.00,3900.29,0.41,1
64328,6380,1000.00,6000.00,7000.00,0.00,3520.72,0.16,1
64329,6380,-1000.00,5000.00,6000.00,2695.93,642.98,0.11,0
64330,6380,-1000.00,4000.00,5000.00,3378.77,2621.23,0.09,0
64331,6380,1000.00,5000.00,6000.00,1233.57,3766.43,0.38,1
64332,6380,-1000.00,4000.00,5000.00,3951.44,1946.98,0.13,0
64333,6380,1000.00,5000.00,6000.00,1654.01,3345.99,0.34,1
64334,6380,1000.00,6000.00,7000.00,0.00,6000.00,0.26,1
64335,6380,1000.00,7000.00,8000.00,0.00,7000.00,0.02,1
64336,6380,1000.00,8000.00,9000.00,4000.00,4000.00,0.02,1
64337,6380,1000.00,9000.00,10000.00,0.00,9000.00,0.04,1
64338,6380,1000.00,10000.00,11000.00,0.00,10000.00,0.32,1
64339,6380,1000.00,11000.00,12000.00,3562.84,7437.16,0.21,1
64340,6380,1000.00,12000.00,13000.00,4282.19,7717.81,0.28,1
64341,6380,-997.89,11002.11,12002.11,997.89,0.00,0.07,0
64342,6380,1000.00,12002.11,13002.11,0.00,11256.43,0.29,1
64343,6380,1000.00,13002.11,14002.11,6289.01,6713.10,0.15,1
64344,6380,-1000.00,12002.11,13002.11,2428.77,0.00,0.08,0
64345,6380,-1000.00,11002.11,12002.11,4216.16,8785.94,0.10,0
64346,6380,-1000.00,10002.11,11002.11,0.00,11680.90,0.41,0
64347,6380,-1000.00,9002.11,10002.11,0.00,11002.11,0.15,0
64348,6380,-1000.00,8002.11,9002.11,5157.33,1657.97,0.12,0
64349,6380,-1000.00,7002.11,8002.11,1374.61,7627.49,0.38,0
64350,6380,-1000.00,6002.11,7002.11,409.42,7592.69,0.42,0
64351,6380,-1000.00,5002.11,6002.11,946.16,6055.95,0.41,0
64352,6380,-1000.00,4002.11,5002.11,869.15,0.00,0.02,0
64353,6380,0.00,4002.11,5002.11,0.00,0.00,0.10,0
64354,6380,-1000.00,3002.11,4002.11,0.00,5002.11,0.08,0
64355,6380,-1000.00,2002.11,3002.11,2160.42,1841.68,0.20,0
64356,6380,-1000.00,1002.11,2002.11,768.34,2233.77,0.29,0
64357,6380,-1000.00,2.11,1002.11,0.00,2002.11,0.35,0
64358,6380,-1000.00,-997.89,2.11,338.64,663.47,0.17,0
64359,6380,-1.89,-999.78,0.22,0.00,1.89,0.36,0
64360,6380,-0.18,-999.96,0.04,0.00,0.18,0.31,0
64361,6380,-0.04,-1000.00,0.00,0.00,0.04,0.23,0
64362,6381,-396.73,-396.73,603.27,0.00,396.73,0.36,0
64363,6381,0.00,-396.73,603.27,0.00,0.00,0.43,0
64364,6381,-603.27,-1000.00,0.00,123.57,479.70,0.32,0
64365,6382,-690.75,-690.75,309.25,220.67,470.07,0.28,0
64366,6382,-116.94,-807.69,192.31,0.00,116.94,0.26,0
64367,6382,-39.66,-847.35,152.65,0.00,39.66,0.13,0
64368,6382,-152.65,-1000.00,0.00,58.81,93.84,0.30,0
64369,6383,-1000.00,-1000.00,0.00,0.00,1000.00,0.07,0
64370,6384,-1000.00,-1000.00,0.00,0.00,216.81,0.37,0
64371,6385,0.00,0.00,1000.00,0.00,0.00,0.15,0
64372,6385,-788.05,-788.05,211.95,788.05,0.00,0.09,0
64373,6385,-1000.00,-1788.05,-788.05,0.00,211.95,0.29,0
64374,6386,-1000.00,-1000.00,0.00,0.00,1000.00,0.10,0
64375,6387,-983.00,-983.00,17.00,0.00,983.00,0.08,0
64376,6387,0.00,-983.00,17.00,0.00,0.00,0.43,0
64377,6387,0.00,-983.00,17.00,0.00,0.00,0.41,0
64378,6387,-17.00,-1000.00,0.00,0.00,17.00,0.09,0
64379,6388,-1000.00,-1000.00,0.00,0.00,582.02,0.24,0
64380,6389,-1000.00,-1000.00,0.00,0.00,1000.00,0.32,0
64381,6390,1000.00,1000.00,2000.00,0.00,422.16,0.16,1
64382,6390,-583.32,416.68,1416.68,419.19,164.13,0.13,0
64383,6390,1000.00,1416.68,2416.68,0.00,1416.68,0.03,1
64384,6390,1000.00,2416.68,3416.68,1146.62,1270.07,0.10,1
64385,6390,1000.00,3416.68,4416.68,0.00,3090.62,0.24,1
64386,6390,1000.00,4416.68,5416.68,498.32,3918.36,0.42,1
64387,6390,1000.00,5416.68,6416.68,597.44,4819.24,0.42,1
64388,6390,1000.00,6416.68,7416.68,0.00,6416.68,0.21,1
64389,6390,1000.00,7416.68,8416.68,0.00,7416.68,0.39,1
64390,6390,1000.00,8416.68,9416.68,2500.60,5916.08,0.18,1
64391,6390,1000.00,9416.68,10416.68,0.00,9416.68,0.31,1
64392,6390,1000.00,10416.68,11416.68,750.16,8959.09,0.43,1
64393,6390,1000.00,11416.68,12416.68,1428.01,9988.67,0.39,1
64394,6390,1000.00,12416.68,13416.68,0.00,12416.68,0.34,1
64395,6390,1000.00,13416.68,14416.68,0.00,575.97,0.12,1
64396,6390,1000.00,14416.68,15416.68,2244.29,12172.40,0.42,1
64397,6390,1000.00,15416.68,16416.68,0.00,15416.68,0.15,1
64398,6390,1000.00,16416.68,17416.68,0.00,16416.68,0.22,1
64399,6390,1000.00,17416.68,18416.68,7694.12,9722.56,0.22,1
64400,6390,1000.00,18416.68,19416.68,597.98,7423.56,0.27,1
64401,6390,1000.00,19416.68,20416.68,0.00,8754.65,0.05,1
64402,6390,1000.00,20416.68,21416.68,0.00,20416.68,0.08,1
64403,6390,1000.00,21416.68,22416.68,10708.34,10708.34,0.03,1
64404,6390,1000.00,22416.68,23416.68,9771.89,12644.79,0.07,1
64405,6390,-1000.00,21416.68,22416.68,0.00,14492.17,0.15,0
64406,6390,-1000.00,20416.68,21416.68,0.00,20763.89,0.44,0
64407,6390,-1000.00,19416.68,20416.68,0.00,16520.77,0.12,0
64408,6390,-1000.00,18416.68,19416.68,8530.21,11886.48,0.22,0
64409,6390,-1000.00,17416.68,18416.68,0.00,19416.68,0.30,0
64410,6390,-1000.00,16416.68,17416.68,7496.15,10920.54,0.28,0
64411,6390,-1000.00,15416.68,16416.68,0.00,3614.13,0.18,0
64412,6390,-1000.00,14416.68,15416.68,9694.39,6722.30,0.13,0
64413,6390,-1000.00,13416.68,14416.68,1117.41,5407.00,0.24,0
64414,6390,0.00,13416.68,14416.68,0.00,0.00,0.09,0
64415,6390,-1000.00,12416.68,13416.68,518.10,6848.12,0.30,0
64416,6390,-1000.00,11416.68,12416.68,0.00,13416.68,0.43,0
64417,6390,-1000.00,10416.68,11416.68,0.00,12416.68,0.01,0
64418,6390,-1000.00,9416.68,10416.68,4448.63,6968.05,0.22,0
64419,6390,-1000.00,8416.68,9416.68,0.00,10416.68,0.09,0
64420,6390,-1000.00,7416.68,8416.68,4001.51,3116.40,0.18,0
64421,6390,-1000.00,6416.68,7416.68,0.00,8416.68,0.38,0
64422,6390,-1000.00,5416.68,6416.68,0.00,7416.68,0.29,0
64423,6390,-1000.00,4416.68,5416.68,0.00,4677.21,0.18,0
64424,6390,-1000.00,3416.68,4416.68,387.72,4916.99,0.43,0
64425,6390,1000.00,4416.68,5416.68,0.00,4416.68,0.39,1
64426,6390,-1000.00,3416.68,4416.68,4053.42,1020.10,0.08,0
64427,6390,1000.00,4416.68,5416.68,0.00,3095.73,0.05,1
64428,6390,1000.00,5416.68,6416.68,1396.32,4020.36,0.35,1
64429,6390,1000.00,6416.68,7416.68,0.00,1897.61,0.21,1
64430,6390,1000.00,7416.68,8416.68,3223.40,4193.28,0.24,1
64431,6390,1000.00,8416.68,9416.68,0.00,8416.68,0.24,1
64432,6390,1000.00,9416.68,10416.68,3845.13,5571.55,0.26,1
64433,6390,1000.00,10416.68,11416.68,1828.25,8588.43,0.09,1
64434,6390,1000.00,11416.68,12416.68,4968.67,6448.02,0.09,1
64435,6390,-1000.00,10416.68,11416.68,6495.47,3079.08,0.14,0
64436,6390,1000.00,11416.68,12416.68,0.00,11416.68,0.44,1
64437,6390,0.00,11416.68,12416.68,0.00,0.00,0.04,0
64438,6390,1000.00,12416.68,13416.68,0.00,12416.68,0.28,1
64439,6390,1000.00,13416.68,14416.68,0.00,11990.42,0.43,1
64440,6391,-1000.00,-1000.00,0.00,0.00,1000.00,0.44,0
64441,6392,-1000.00,-1000.00,0.00,0.00,731.01,0.16,0
64442,6393,-1000.00,-1000.00,0.00,366.04,633.96,0.24,0
64443,6394,-1000.00,-1000.00,0.00,417.77,582.23,0.21,0
64444,6395,-1000.00,-1000.00,0.00,0.00,255.04,0.19,0
64445,6396,-1000.00,-1000.00,0.00,558.03,441.97,0.09,0
64446,6397,-1000.00,-1000.00,0.00,8.70,991.30,0.44,0
64447,6398,-948.95,-948.95,51.05,0.00,948.95,0.09,0
64448,6398,-1000.00,-1948.95,-948.95,32.35,18.70,0.13,0
64449,6399,1000.00,1000.00,2000.00,575.64,424.36,0.23,1
64450,6399,-1000.00,0.00,1000.00,848.12,1151.88,0.26,0
64451,6399,-1000.00,-1000.00,0.00,465.35,534.65,0.24,0
64452,6399,0.00,-1000.00,0.00,0.00,0.00,0.01,0
64453,6399,-0.00,-1000.00,0.00,0.00,0.00,0.24,0
64454,6400,-596.21,-596.21,403.79,0.00,596.21,0.11,0
64455,6400,-271.49,-867.70,132.30,61.67,209.82,0.31,0
64456,6400,-132.30,-1000.00,0.00,47.65,84.65,0.32,0
64457,6401,0.00,0.00,1000.00,0.00,0.00,0.09,0
64458,6401,-1000.00,-1000.00,0.00,297.86,702.14,0.21,0
64459,6402,-551.37,-551.37,448.63,551.37,0.00,0.02,0
64460,6402,1000.00,448.63,1448.63,149.23,299.40,0.31,1
64461,6402,1000.00,1448.63,2448.63,430.74,1017.89,0.35,1
64462,6402,1000.00,2448.63,3448.63,739.93,997.28,0.24,1
64463,6402,-1000.00,1448.63,2448.63,2156.06,1292.56,0.14,0
64464,6402,1000.00,2448.63,3448.63,0.00,2448.63,0.01,1
64465,6402,1000.00,3448.63,4448.63,0.00,3448.63,0.11,1
64466,6402,-1000.00,2448.63,3448.63,2335.91,2112.72,0.10,0
64467,6402,1000.00,3448.63,4448.63,785.92,2662.71,0.39,1
64468,6402,1000.00,4448.63,5448.63,1831.74,2616.89,0.14,1
64469,6402,1000.00,5448.63,6448.63,0.00,5448.63,0.21,1
64470,6402,-1000.00,4448.63,5448.63,3328.71,3119.92,0.13,0
64471,6402,1000.00,5448.63,6448.63,0.00,2730.33,0.16,1
64472,6402,1000.00,6448.63,7448.63,0.00,420.08,0.02,1
64473,6402,1000.00,7448.63,8448.63,0.00,7448.63,0.22,1
64474,6402,-1000.00,6448.63,7448.63,4603.63,144.90,0.08,0
64475,6402,1000.00,7448.63,8448.63,0.00,7448.63,0.29,1
64476,6402,1000.00,8448.63,9448.63,1311.54,7137.09,0.40,1
64477,6402,1000.00,9448.63,10448.63,0.00,9448.63,0.06,1
64478,6402,1000.00,10448.63,11448.63,3008.42,7440.20,0.36,1
64479,6402,1000.00,11448.63,12448.63,0.00,11448.63,0.41,1
64480,6402,1000.00,12448.63,13448.63,1994.69,10001.45,0.40,1
64481,6402,1000.00,13448.63,14448.63,0.00,13448.63,0.04,1
64482,6402,-1000.00,12448.63,13448.63,5395.48,0.00,0.01,0
64483,6402,-1000.00,11448.63,12448.63,7212.98,6235.64,0.18,0
64484,6402,1000.00,12448.63,13448.63,4943.54,7505.09,0.27,1
64485,6402,0.00,12448.63,13448.63,0.00,0.00,0.06,0
64486,6402,1000.00,13448.63,14448.63,5538.18,7910.45,0.22,1
64487,6402,1000.00,14448.63,15448.63,0.00,14448.63,0.03,1
64488,6402,-1000.00,13448.63,14448.63,3871.84,2677.42,0.16,0
64489,6402,1000.00,14448.63,15448.63,5532.06,8916.57,0.30,1
64490,6402,1000.00,15448.63,16448.63,0.00,4929.47,0.01,1
64491,6402,1000.00,16448.63,17448.63,1.69,15523.69,0.44,1
64492,6402,1000.00,17448.63,18448.63,862.98,16585.64,0.40,1
64493,6402,0.00,17448.63,18448.63,0.00,0.00,0.06,0
64494,6402,-1000.00,16448.63,17448.63,2043.14,241.29,0.11,0
64495,6402,1000.00,17448.63,18448.63,0.00,11144.05,0.25,1
64496,6402,1000.00,18448.63,19448.63,9224.31,9224.31,0.06,1
64497,6402,1000.00,19448.63,20448.63,997.49,18451.14,0.04,1
64498,6402,1000.00,20448.63,21448.63,0.00,15635.98,0.35,1
64499,6402,1000.00,21448.63,22448.63,0.00,17829.21,0.42,1
64500,6402,1000.00,22448.63,23448.63,3047.75,19400.88,0.30,1
64501,6402,1000.00,23448.63,24448.63,5713.92,17734.71,0.28,1
64502,6402,1000.00,24448.63,25448.63,8403.44,16045.18,0.29,1
64503,6402,1000.00,25448.63,26448.63,0.00,6322.07,0.10,1
64504,6402,-1000.00,24448.63,25448.63,14771.72,11676.90,0.07,0
64505,6402,1000.00,25448.63,26448.63,9128.20,16320.43,0.04,1
64506,6402,-1000.00,24448.63,25448.63,0.00,17583.47,0.30,0
64507,6402,-1000.00,23448.63,24448.63,0.00,25448.63,0.39,0
64508,6402,-1000.00,22448.63,23448.63,0.00,24448.63,0.28,0
64509,6402,-1000.00,21448.63,22448.63,0.00,23448.63,0.11,0
64510,6402,-1000.00,20448.63,21448.63,0.00,22448.63,0.13,0
64511,6402,-1000.00,19448.63,20448.63,0.00,21448.63,0.21,0
64512,6402,-1000.00,18448.63,19448.63,0.00,14470.85,0.37,0
64513,6402,-1000.00,17448.63,18448.63,2928.66,16519.97,0.39,0
64514,6402,-1000.00,16448.63,17448.63,6691.28,11757.35,0.31,0
64515,6402,-1000.00,15448.63,16448.63,1459.98,12030.92,0.38,0
64516,6402,-1000.00,14448.63,15448.63,5032.34,11416.29,0.33,0
64517,6402,-1000.00,13448.63,14448.63,0.00,15448.63,0.13,0
64518,6402,-1000.00,12448.63,13448.63,5192.16,8468.70,0.29,0
64519,6402,-1000.00,11448.63,12448.63,0.00,4926.75,0.12,0
64520,6402,-1000.00,10448.63,11448.63,2869.72,9578.91,0.24,0
64521,6402,-1000.00,9448.63,10448.63,0.00,3295.77,0.06,0
64522,6402,-1000.00,8448.63,9448.63,0.00,10448.63,0.04,0
64523,6402,-1000.00,7448.63,8448.63,5497.87,3950.76,0.05,0
64524,6402,-1000.00,6448.63,7448.63,0.00,2646.46,0.23,0
64525,6402,-1000.00,5448.63,6448.63,0.00,4527.58,0.19,0
64526,6402,-1000.00,4448.63,5448.63,0.00,6448.63,0.21,0
64527,6403,1000.00,1000.00,2000.00,398.66,601.34,0.27,1
64528,6403,1000.00,2000.00,3000.00,480.07,1468.67,0.37,1
64529,6403,0.00,2000.00,3000.00,0.00,0.00,0.05,0
64530,6403,1000.00,3000.00,4000.00,0.00,3000.00,0.34,1
64531,6403,1000.00,4000.00,5000.00,0.00,4000.00,0.03,1
64532,6403,1000.00,5000.00,6000.00,0.00,3708.08,0.33,1
64533,6403,1000.00,6000.00,7000.00,0.00,3269.26,0.33,1
64534,6403,0.00,6000.00,7000.00,0.00,0.00,0.07,0
64535,6403,1000.00,7000.00,8000.00,0.00,5379.98,0.20,1
64536,6403,1000.00,8000.00,9000.00,0.00,8000.00,0.44,1
64537,6403,1000.00,9000.00,10000.00,3541.03,5458.97,0.25,1
64538,6403,1000.00,10000.00,11000.00,0.00,6434.20,0.36,1
64539,6403,1000.00,11000.00,12000.00,0.00,7153.19,0.36,1
64540,6403,1000.00,12000.00,13000.00,2151.74,9848.26,0.40,1
64541,6403,1000.00,13000.00,14000.00,1618.23,11381.77,0.00,1
64542,6403,1000.00,14000.00,15000.00,2272.34,9827.23,0.38,1
64543,6403,1000.00,15000.00,16000.00,0.00,15000.00,0.06,1
64544,6403,-1000.00,14000.00,15000.00,9061.44,6938.56,0.16,0
64545,6403,1000.00,15000.00,16000.00,0.00,15000.00,0.40,1
64546,6403,1000.00,16000.00,17000.00,2297.44,13106.27,0.41,1
64547,6403,1000.00,17000.00,18000.00,0.00,10476.74,0.30,1
64548,6403,1000.00,18000.00,19000.00,183.98,17816.02,0.44,1
64549,6403,1000.00,19000.00,20000.00,1528.21,17471.79,0.38,1
64550,6403,-1000.00,18000.00,19000.00,0.00,20000.00,0.20,0
64551,6403,-1000.00,17000.00,18000.00,0.00,9549.25,0.29,0
64552,6403,-1000.00,16000.00,17000.00,0.00,18000.00,0.07,0
64553,6403,-1000.00,15000.00,16000.00,0.00,17000.00,0.14,0
64554,6403,-1000.00,14000.00,15000.00,4035.64,11964.36,0.38,0
64555,6403,-1000.00,13000.00,14000.00,1442.73,13557.27,0.42,0
64556,6403,-1000.00,12000.00,13000.00,0.00,14000.00,0.19,0
64557,6403,-1000.00,11000.00,12000.00,0.00,8834.30,0.26,0
64558,6403,-1000.00,10000.00,11000.00,0.00,11857.49,0.22,0
64559,6403,-1000.00,9000.00,10000.00,0.00,11000.00,0.08,0
64560,6403,-1000.00,8000.00,9000.00,0.00,10000.00,0.27,0
64561,6403,-1000.00,7000.00,8000.00,0.00,6018.41,0.17,0
64562,6403,-1000.00,6000.00,7000.00,4300.42,3699.58,0.19,0
64563,6403,-1000.00,5000.00,6000.00,0.00,5680.90,0.42,0
64564,6403,-1000.00,4000.00,5000.00,4243.41,1756.59,0.07,0
64565,6403,-1000.00,3000.00,4000.00,0.00,2896.59,0.33,0
64566,6403,-1000.00,2000.00,3000.00,3576.52,423.48,0.04,0
64567,6403,-189.03,1810.97,2810.97,0.00,189.03,0.10,0
64568,6403,-1000.00,810.97,1810.97,0.00,2063.80,0.27,0
64569,6403,-1000.00,-189.03,810.97,553.99,1256.97,0.13,0
64570,6403,-810.97,-1000.00,0.00,0.00,810.97,0.24,0
64571,6404,-1000.00,-1000.00,0.00,0.00,1000.00,0.43,0
64572,6405,1000.00,1000.00,2000.00,0.00,994.27,0.40,1
64573,6405,-861.37,138.63,1138.63,555.35,306.02,0.15,0
64574,6405,1000.00,1138.63,2138.63,569.32,569.32,0.03,1
64575,6405,1000.00,2138.63,3138.63,571.60,1567.04,0.35,1
64576,6405,1000.00,3138.63,4138.63,0.00,2233.46,0.38,1
64577,6405,1000.00,4138.63,5138.63,0.00,1510.78,0.24,1
64578,6405,1000.00,5138.63,6138.63,1204.00,3934.63,0.39,1
64579,6405,1000.00,6138.63,7138.63,1798.92,4339.71,0.36,1
64580,6405,1000.00,7138.63,8138.63,1300.34,5838.29,0.15,1
64581,6405,1000.00,8138.63,9138.63,0.00,8138.63,0.27,1
64582,6405,1000.00,9138.63,10138.63,1684.84,6402.00,0.37,1
64583,6405,-1000.00,8138.63,9138.63,5043.58,4973.38,0.22,0
64584,6405,1000.00,9138.63,10138.63,2588.18,5889.13,0.33,1
64585,6405,1000.00,10138.63,11138.63,5069.32,5069.32,0.07,1
64586,6405,1000.00,11138.63,12138.63,0.00,4939.41,0.07,1
64587,6405,-1000.00,10138.63,11138.63,11607.41,0.00,0.01,0
64588,6405,1000.00,11138.63,12138.63,5569.32,5569.32,0.03,1
64589,6405,1000.00,12138.63,13138.63,0.00,12138.63,0.38,1
64590,6405,1000.00,13138.63,14138.63,5689.60,7449.03,0.17,1
64591,6405,1000.00,14138.63,15138.63,0.00,14138.63,0.33,1
64592,6405,1000.00,15138.63,16138.63,0.00,15138.63,0.20,1
64593,6405,1000.00,16138.63,17138.63,0.00,16138.63,0.09,1
64594,6405,1000.00,17138.63,18138.63,2658.61,14480.02,0.27,1
64595,6405,1000.00,18138.63,19138.63,0.00,7258.51,0.09,1
64596,6405,1000.00,19138.63,20138.63,4375.42,14763.21,0.39,1
64597,6405,1000.00,20138.63,21138.63,0.00,20138.63,0.13,1
64598,6405,1000.00,21138.63,22138.63,0.00,21138.63,0.14,1
64599,6405,1000.00,22138.63,23138.63,0.00,20867.66,0.04,1
64600,6405,1000.00,23138.63,24138.63,9583.76,11928.61,0.25,1
64601,6405,1000.00,24138.63,25138.63,0.00,6644.34,0.05,1
64602,6405,-1000.00,23138.63,24138.63,24015.81,0.00,0.01,0
64603,6405,1000.00,24138.63,25138.63,0.00,24138.63,0.42,1
64604,6405,1000.00,25138.63,26138.63,0.00,14794.37,0.32,1
64605,6405,1000.00,26138.63,27138.63,11431.26,14707.38,0.26,1
64606,6405,1000.00,27138.63,28138.63,0.00,27138.63,0.09,1
64607,6405,1000.00,28138.63,29138.63,2441.85,15260.80,0.33,1
64608,6405,1000.00,29138.63,30138.63,12658.23,16480.41,0.24,1
64609,6405,1000.00,30138.63,31138.63,0.00,30138.63,0.29,1
64610,6405,1000.00,31138.63,32138.63,10196.41,12939.90,0.24,1
64611,6405,1000.00,32138.63,33138.63,13391.01,16217.07,0.25,1
64612,6405,1000.00,33138.63,34138.63,9865.44,23273.20,0.34,1
64613,6406,-1000.00,-1000.00,0.00,0.00,843.32,0.42,0
64614,6407,-1000.00,-1000.00,0.00,0.00,480.64,0.25,0
64615,6408,-1000.00,-1000.00,0.00,391.50,608.50,0.26,0
64616,6409,-290.18,-290.18,709.82,269.12,21.06,0.11,0
64617,6409,0.00,-290.18,709.82,0.00,0.00,0.04,0
64618,6409,1000.00,709.82,1709.82,0.00,137.50,0.06,1
64619,6409,1000.00,1709.82,2709.82,850.58,859.24,0.08,1
64620,6409,1000.00,2709.82,3709.82,531.08,2178.74,0.40,1
64621,6409,1000.00,3709.82,4709.82,0.00,3709.82,0.07,1
64622,6409,-1000.00,2709.82,3709.82,2714.66,1995.16,0.14,0
64623,6409,1000.00,3709.82,4709.82,0.00,2331.53,0.09,1
64624,6409,1000.00,4709.82,5709.82,0.00,4709.82,0.40,1
64625,6409,1000.00,5709.82,6709.82,0.00,5709.82,0.43,1
64626,6409,1000.00,6709.82,7709.82,0.00,2537.54,0.23,1
64627,6409,1000.00,7709.82,8709.82,3331.96,4377.86,0.16,1
64628,6409,1000.00,8709.82,9709.82,287.10,8422.72,0.44,1
64629,6409,1000.00,9709.82,10709.82,0.00,6889.07,0.37,1
64630,6409,1000.00,10709.82,11709.82,0.00,10709.82,0.25,1
64631,6409,1000.00,11709.82,12709.82,334.07,11375.75,0.19,1
64632,6409,1000.00,12709.82,13709.82,0.00,12709.82,0.41,1
64633,6409,1000.00,13709.82,14709.82,0.00,13709.82,0.20,1
64634,6409,1000.00,14709.82,15709.82,0.00,14709.82,0.41,1
64635,6409,-1000.00,13709.82,14709.82,6146.35,3981.42,0.16,0
64636,6409,1000.00,14709.82,15709.82,7354.91,7354.91,0.05,1
64637,6409,1000.00,15709.82,16709.82,5225.18,10484.64,0.13,1
64638,6409,-1000.00,14709.82,15709.82,0.00,1153.95,0.13,0
64639,6409,-1000.00,13709.82,14709.82,0.00,14437.34,0.43,0
64640,6409,-1000.00,12709.82,13709.82,0.00,14684.49,0.19,0
64641,6409,-1000.00,11709.82,12709.82,6854.91,6854.91,0.03,0
64642,6409,-1000.00,10709.82,11709.82,0.00,5846.78,0.22,0
64643,6409,-1000.00,9709.82,10709.82,0.00,11709.82,0.21,0
64644,6409,-1000.00,8709.82,9709.82,0.00,10709.82,0.39,0
64645,6409,-1000.00,7709.82,8709.82,0.00,1869.20,0.17,0
64646,6409,-1000.00,6709.82,7709.82,0.00,8709.82,0.17,0
64647,6409,-1000.00,5709.82,6709.82,637.35,3757.86,0.30,0
64648,6409,-1000.00,4709.82,5709.82,0.00,4990.36,0.37,0
64649,6409,-1000.00,3709.82,4709.82,0.00,4500.90,0.16,0
64650,6409,-1000.00,2709.82,3709.82,0.00,3409.37,0.28,0
64651,6409,-1000.00,1709.82,2709.82,0.00,3353.06,0.29,0
64652,6409,-1000.00,709.82,1709.82,0.00,2709.82,0.31,0
64653,6409,-1000.00,-290.18,709.82,765.18,944.64,0.16,0
64654,6409,-709.82,-1000.00,0.00,0.00,709.82,0.30,0
64655,6410,-1000.00,-1000.00,0.00,0.00,1000.00,0.14,0
64656,6411,-1000.00,-1000.00,0.00,334.26,665.74,0.28,0
64657,6412,-44.98,-44.98,955.02,44.98,0.00,0.39,0
64658,6412,-955.02,-1000.00,-0.00,601.26,353.76,0.19,0
64659,6413,-1000.00,-1000.00,0.00,52.79,947.21,0.27,0
64660,6414,0.00,0.00,1000.00,0.00,0.00,0.24,0
64661,6414,-84.86,-84.86,915.14,0.00,84.86,0.24,0
64662,6414,-915.14,-1000.00,0.00,0.00,915.14,0.30,0
64663,6415,1000.00,1000.00,2000.00,215.30,784.70,0.24,1
64664,6415,1000.00,2000.00,3000.00,0.00,988.02,0.30,1
64665,6415,1000.00,3000.00,4000.00,0.00,3000.00,0.39,1
64666,6415,1000.00,4000.00,5000.00,0.00,2245.40,0.14,1
64667,6415,1000.00,5000.00,6000.00,0.00,5000.00,0.07,1
64668,6415,1000.00,6000.00,7000.00,1353.35,4646.65,0.40,1
64669,6415,1000.00,7000.00,8000.00,342.33,1292.02,0.17,1
64670,6415,1000.00,8000.00,9000.00,0.00,8000.00,0.26,1
64671,6415,1000.00,9000.00,10000.00,4410.69,4589.31,0.17,1
64672,6415,1000.00,10000.00,11000.00,0.00,10000.00,0.20,1
64673,6415,1000.00,11000.00,12000.00,1944.66,9055.34,0.23,1
64674,6415,1000.00,12000.00,13000.00,0.00,12000.00,0.27,1
64675,6415,1000.00,13000.00,14000.00,0.00,13000.00,0.06,1
64676,6415,1000.00,14000.00,15000.00,0.00,10557.18,0.36,1
64677,6415,1000.00,15000.00,16000.00,3433.07,11566.93,0.39,1
64678,6415,1000.00,16000.00,17000.00,4747.69,10948.80,0.34,1
64679,6415,1000.00,17000.00,18000.00,7850.58,9149.42,0.00,1
64680,6415,-1000.00,16000.00,17000.00,3119.48,0.00,0.07,0
64681,6415,-1000.00,15000.00,16000.00,0.00,17000.00,0.25,0
64682,6415,-1000.00,14000.00,15000.00,4853.47,11146.53,0.06,0
64683,6415,-1000.00,13000.00,14000.00,0.00,12265.08,0.03,0
64684,6415,-1000.00,12000.00,13000.00,3180.61,10819.39,0.40,0
64685,6415,0.00,12000.00,13000.00,0.00,0.00,0.03,0
64686,6415,-1000.00,11000.00,12000.00,4550.65,0.00,0.06,0
64687,6415,-1000.00,10000.00,11000.00,0.00,12000.00,0.10,0
64688,6415,-1000.00,9000.00,10000.00,0.00,3325.28,0.10,0
64689,6415,-1000.00,8000.00,9000.00,1620.58,8379.42,0.25,0
64690,6415,-1000.00,7000.00,8000.00,0.00,4416.80,0.31,0
64691,6415,-1000.00,6000.00,7000.00,3487.84,4512.16,0.25,0
64692,6415,-1000.00,5000.00,6000.00,0.00,7000.00,0.05,0
64693,6415,-1000.00,4000.00,5000.00,609.84,5390.16,0.29,0
64694,6415,-1000.00,3000.00,4000.00,1152.17,3847.83,0.34,0
64695,6415,-1000.00,2000.00,3000.00,1504.56,2495.44,0.23,0
64696,6415,-1000.00,1000.00,2000.00,1458.10,1541.90,0.02,0
64697,6415,-1000.00,0.00,1000.00,1131.21,868.79,0.17,0
64698,6415,0.00,0.00,1000.00,0.00,0.00,0.07,0
64699,6415,-698.29,-698.29,301.71,0.00,698.29,0.39,0
64700,6415,1000.00,301.71,1301.71,47.53,254.18,0.42,1
64701,6415,1000.00,1301.71,2301.71,292.58,419.55,0.22,1
64702,6415,1000.00,2301.71,3301.71,368.54,1933.17,0.19,1
64703,6415,1000.00,3301.71,4301.71,0.00,170.03,0.12,1
64704,6415,1000.00,4301.71,5301.71,0.00,4301.71,0.23,1
64705,6415,1000.00,5301.71,6301.71,2650.85,2650.85,0.05,1
64706,6415,-742.20,4559.51,5559.51,742.20,0.00,0.00,0
64707,6415,1000.00,5559.51,6559.51,0.00,2694.94,0.13,1
64708,6415,1000.00,6559.51,7559.51,2832.17,3727.34,0.14,1
64709,6415,1000.00,7559.51,8559.51,1589.98,5969.53,0.29,1
64710,6415,1000.00,8559.51,9559.51,0.00,8559.51,0.29,1
64711,6415,1000.00,9559.51,10559.51,2280.45,7279.06,0.33,1
64712,6415,-1000.00,8559.51,9559.51,6470.32,4089.19,0.04,0
64713,6415,1000.00,9559.51,10559.51,0.00,9559.51,0.07,1
64714,6415,1000.00,10559.51,11559.51,2879.83,5641.54,0.29,1
64715,6415,1000.00,11559.51,12559.51,5779.76,5779.76,0.05,1
64716,6415,1000.00,12559.51,13559.51,5541.31,7018.20,0.14,1
64717,6416,-1000.00,-1000.00,0.00,0.00,914.49,0.30,0
64718,6417,-1000.00,-1000.00,0.00,0.00,1000.00,0.10,0
64719,6418,1000.00,1000.00,2000.00,0.00,1000.00,0.35,1
64720,6418,1000.00,2000.00,3000.00,592.15,1407.85,0.08,1
64721,6418,1000.00,3000.00,4000.00,126.25,2873.75,0.29,1
64722,6418,1000.00,4000.00,5000.00,279.06,3720.94,0.20,1
64723,6418,1000.00,5000.00,6000.00,0.00,2861.08,0.27,1
64724,6418,1000.00,6000.00,7000.00,0.00,6000.00,0.17,1
64725,6418,1000.00,7000.00,8000.00,0.00,3802.37,0.31,1
64726,6418,1000.00,8000.00,9000.00,0.00,8000.00,0.44,1
64727,6418,1000.00,9000.00,10000.00,0.00,9000.00,0.44,1
64728,6418,-1000.00,8000.00,9000.00,5621.05,4378.95,0.12,0
64729,6418,1000.00,9000.00,10000.00,4265.35,4734.65,0.14,1
64730,6418,1000.00,10000.00,11000.00,0.00,8255.39,0.33,1
64731,6418,1000.00,11000.00,12000.00,0.00,10740.23,0.44,1
64732,6418,1000.00,12000.00,13000.00,2538.47,9461.53,0.13,1
64733,6418,1000.00,13000.00,14000.00,0.00,11871.99,0.43,1
64734,6418,1000.00,14000.00,15000.00,3737.99,10262.01,0.37,1
64735,6418,1000.00,15000.00,16000.00,0.00,15000.00,0.05,1
64736,6418,-1000.00,14000.00,15000.00,9014.85,6985.15,0.02,0
64737,6418,1000.00,15000.00,16000.00,650.66,7755.79,0.32,1
64738,6418,1000.00,16000.00,17000.00,0.00,11421.19,0.34,1
64739,6418,1000.00,17000.00,18000.00,4718.78,12281.22,0.23,1
64740,6418,1000.00,18000.00,19000.00,0.00,18000.00,0.12,1
64741,6418,1000.00,19000.00,20000.00,0.00,4381.56,0.19,1
64742,6418,-1000.00,18000.00,19000.00,0.00,1826.47,0.01,0
64743,6418,-1000.00,17000.00,18000.00,0.00,12943.94,0.36,0
64744,6418,-1000.00,16000.00,17000.00,9000.00,9000.00,0.04,0
64745,6418,-1000.00,15000.00,16000.00,0.00,17000.00,0.18,0
64746,6418,-1000.00,14000.00,15000.00,0.00,16000.00,0.05,0
64747,6418,-1000.00,13000.00,14000.00,9257.97,5742.03,0.11,0
64748,6418,-1000.00,12000.00,13000.00,6091.74,7908.26,0.18,0
64749,6418,-1000.00,11000.00,12000.00,5827.00,7173.00,0.10,0
64750,6418,-1000.00,10000.00,11000.00,0.00,12000.00,0.32,0
64751,6418,-1000.00,9000.00,10000.00,788.18,10211.82,0.02,0
64752,6418,-1000.00,8000.00,9000.00,0.00,10000.00,0.33,0
64753,6418,-1000.00,7000.00,8000.00,0.00,9000.00,0.23,0
64754,6418,-1000.00,6000.00,7000.00,3167.63,4832.37,0.29,0
64755,6418,-1000.00,5000.00,6000.00,595.61,6404.39,0.43,0
64756,6418,-1000.00,4000.00,5000.00,2595.04,3404.96,0.25,0
64757,6418,-1000.00,3000.00,4000.00,0.00,5000.00,0.25,0
64758,6418,-1000.00,2000.00,3000.00,0.00,4000.00,0.02,0
64759,6418,-689.15,1310.85,2310.85,0.00,689.15,0.07,0
64760,6418,-1000.00,310.85,1310.85,0.00,2310.85,0.34,0
64761,6418,-1000.00,-689.15,310.85,0.00,1097.38,0.21,0
64762,6418,-269.43,-958.57,41.43,0.00,269.43,0.33,0
64763,6418,-41.43,-1000.00,0.00,18.31,23.11,0.16,0
64764,6419,-1000.00,-1000.00,0.00,274.83,725.17,0.19,0
64765,6420,1000.00,1000.00,2000.00,360.63,449.57,0.24,1
64766,6420,1000.00,2000.00,3000.00,0.00,1275.47,0.11,1
64767,6420,1000.00,3000.00,4000.00,0.00,3000.00,0.35,1
64768,6420,1000.00,4000.00,5000.00,146.91,3853.09,0.44,1
64769,6420,-1000.00,3000.00,4000.00,1998.25,0.00,0.05,0
64770,6420,1000.00,4000.00,5000.00,2000.00,2000.00,0.02,1
64771,6420,-1000.00,3000.00,4000.00,3282.15,1717.85,0.04,0
64772,6420,-1000.00,2000.00,3000.00,2137.74,0.00,0.03,0
64773,6420,1000.00,3000.00,4000.00,0.00,1386.09,0.17,1
64774,6420,1000.00,4000.00,5000.00,0.00,4000.00,0.28,1
64775,6420,1000.00,5000.00,6000.00,793.14,4206.86,0.42,1
64776,6420,1000.00,6000.00,7000.00,0.00,6000.00,0.01,1
64777,6420,1000.00,7000.00,8000.00,0.00,7000.00,0.40,1
64778,6420,1000.00,8000.00,9000.00,398.25,4615.37,0.34,1
64779,6420,1000.00,9000.00,10000.00,3257.92,5742.08,0.28,1
64780,6420,1000.00,10000.00,11000.00,4336.87,5663.13,0.26,1
64781,6420,1000.00,11000.00,12000.00,0.00,11000.00,0.19,1
64782,6420,1000.00,12000.00,13000.00,0.00,4198.34,0.12,1
64783,6420,1000.00,13000.00,14000.00,0.00,10808.28,0.42,1
64784,6420,1000.00,14000.00,15000.00,7000.00,7000.00,0.09,1
64785,6420,1000.00,15000.00,16000.00,2874.47,12125.53,0.41,1
64786,6420,1000.00,16000.00,17000.00,0.00,16000.00,0.12,1
64787,6420,1000.00,17000.00,18000.00,0.00,2136.46,0.13,1
64788,6420,1000.00,18000.00,19000.00,0.00,18000.00,0.15,1
64789,6420,1000.00,19000.00,20000.00,0.00,19000.00,0.43,1
64790,6420,1000.00,20000.00,21000.00,0.00,20000.00,0.21,1
64791,6420,1000.00,21000.00,22000.00,10500.00,10500.00,0.01,1
64792,6420,1000.00,22000.00,23000.00,10444.00,11556.00,0.13,1
64793,6420,1000.00,23000.00,24000.00,3248.00,19752.00,0.05,1
64794,6420,1000.00,24000.00,25000.00,10965.72,13034.28,0.12,1
64795,6420,1000.00,25000.00,26000.00,0.00,25000.00,0.03,1
64796,6420,1000.00,26000.00,27000.00,3125.81,22874.19,0.40,1
64797,6420,1000.00,27000.00,28000.00,0.00,27000.00,0.15,1
64798,6420,1000.00,28000.00,29000.00,0.00,19687.60,0.16,1
64799,6420,1000.00,29000.00,30000.00,10303.83,18696.17,0.27,1
64800,6420,-1000.00,28000.00,29000.00,24932.12,5067.88,0.05,0
64801,6420,1000.00,29000.00,30000.00,0.00,24915.06,0.26,1
64802,6420,-1000.00,28000.00,29000.00,16309.14,13690.86,0.12,0
64803,6420,1000.00,29000.00,30000.00,0.00,9351.25,0.23,1
64804,6420,1000.00,30000.00,31000.00,15000.00,15000.00,0.02,1
64805,6420,1000.00,31000.00,32000.00,1320.70,29679.30,0.17,1
64806,6420,1000.00,32000.00,33000.00,16000.00,16000.00,0.07,1
64807,6420,1000.00,33000.00,34000.00,0.00,32351.43,0.28,1
64808,6420,1000.00,34000.00,35000.00,0.00,12082.09,0.21,1
64809,6420,-1000.00,33000.00,34000.00,35000.00,0.00,0.01,0
64810,6420,-1000.00,32000.00,33000.00,22850.79,11149.21,0.08,0
64811,6420,1000.00,33000.00,34000.00,0.00,31198.47,0.42,1
64812,6420,-1000.00,32000.00,33000.00,0.00,34000.00,0.25,0
64813,6420,-1000.00,31000.00,32000.00,11518.40,21481.60,0.28,0
64814,6420,-1000.00,30000.00,31000.00,8939.47,23060.53,0.35,0
64815,6420,-1000.00,29000.00,30000.00,25.96,25022.13,0.42,0
64816,6420,-1000.00,28000.00,29000.00,0.00,30000.00,0.04,0
64817,6420,-1000.00,27000.00,28000.00,8640.56,20359.44,0.28,0
64818,6420,-1000.00,26000.00,27000.00,0.00,10452.16,0.12,0
64819,6420,-1000.00,25000.00,26000.00,0.00,17257.25,0.25,0
64820,6420,-1000.00,24000.00,25000.00,4170.00,11321.07,0.27,0
64821,6420,-1000.00,23000.00,24000.00,3370.87,21629.13,0.42,0
64822,6420,-1000.00,22000.00,23000.00,7820.34,16179.66,0.34,0
64823,6420,-1000.00,21000.00,22000.00,0.00,15057.91,0.36,0
64824,6420,-1000.00,20000.00,21000.00,3894.84,18105.16,0.40,0
64825,6420,-1000.00,19000.00,20000.00,2631.93,18368.07,0.00,0
64826,6420,-1000.00,18000.00,19000.00,0.00,20000.00,0.15,0
64827,6420,-1000.00,17000.00,18000.00,6320.39,11943.49,0.31,0
64828,6420,-1000.00,16000.00,17000.00,0.00,5123.80,0.20,0
64829,6420,-1000.00,15000.00,16000.00,0.00,17000.00,0.41,0
64830,6420,-1000.00,14000.00,15000.00,0.00,16000.00,0.30,0
64831,6420,-1000.00,13000.00,14000.00,0.00,15000.00,0.31,0
64832,6421,1000.00,1000.00,2000.00,0.00,1000.00,0.05,1
64833,6421,1000.00,2000.00,3000.00,0.00,2000.00,0.43,1
64834,6421,1000.00,3000.00,4000.00,983.30,2016.70,0.26,1
64835,6421,1000.00,4000.00,5000.00,1207.73,2792.27,0.14,1
64836,6421,1000.00,5000.00,6000.00,1476.04,3523.96,0.16,1
64837,6421,1000.00,6000.00,7000.00,0.00,2930.97,0.25,1
64838,6421,1000.00,7000.00,8000.00,0.00,3134.09,0.15,1
64839,6421,1000.00,8000.00,9000.00,4000.00,4000.00,0.02,1
64840,6421,1000.00,9000.00,10000.00,1597.57,7402.43,0.09,1
64841,6421,1000.00,10000.00,11000.00,0.00,10000.00,0.00,1
64842,6421,0.00,10000.00,11000.00,0.00,0.00,0.07,0
64843,6421,1000.00,11000.00,12000.00,0.00,11000.00,0.12,1
64844,6421,1000.00,12000.00,13000.00,4058.95,7941.05,0.31,1
64845,6421,1000.00,13000.00,14000.00,6219.19,6780.81,0.13,1
64846,6421,1000.00,14000.00,15000.00,4932.02,9067.98,0.27,1
64847,6421,1000.00,15000.00,16000.00,0.00,11365.02,0.25,1
64848,6421,1000.00,16000.00,17000.00,0.00,16000.00,0.06,1
64849,6421,1000.00,17000.00,18000.00,0.00,17000.00,0.03,1
64850,6421,1000.00,18000.00,19000.00,0.00,18000.00,0.39,1
64851,6421,1000.00,19000.00,20000.00,0.00,4419.47,0.19,1
64852,6421,-1000.00,18000.00,19000.00,11833.21,8166.79,0.08,0
64853,6421,-1000.00,17000.00,18000.00,14024.44,4975.56,0.08,0
64854,6421,-1000.00,16000.00,17000.00,10017.02,7982.98,0.13,0
64855,6421,1000.00,17000.00,18000.00,6119.97,10880.03,0.23,1
64856,6421,1000.00,18000.00,19000.00,0.00,18000.00,0.07,1
64857,6421,1000.00,19000.00,20000.00,5664.38,13335.62,0.24,1
64858,6421,1000.00,20000.00,21000.00,764.25,19235.75,0.44,1
64859,6421,1000.00,21000.00,22000.00,0.00,12769.84,0.11,1
64860,6421,1000.00,22000.00,23000.00,0.00,22000.00,0.32,1
64861,6421,1000.00,23000.00,24000.00,0.00,4459.42,0.17,1
64862,6421,1000.00,24000.00,25000.00,0.00,24000.00,0.27,1
64863,6421,1000.00,25000.00,26000.00,1563.81,21460.45,0.43,1
64864,6421,1000.00,26000.00,27000.00,0.00,23421.99,0.18,1
64865,6421,1000.00,27000.00,28000.00,8068.46,18931.54,0.34,1
64866,6421,1000.00,28000.00,29000.00,0.00,28000.00,0.32,1
64867,6421,1000.00,29000.00,30000.00,0.00,29000.00,0.00,1
64868,6421,1000.00,30000.00,31000.00,10314.62,19685.38,0.23,1
64869,6421,-1000.00,29000.00,30000.00,17904.26,5214.54,0.11,0
64870,6421,1000.00,30000.00,31000.00,7075.22,22924.78,0.10,1
64871,6421,1000.00,31000.00,32000.00,1983.36,14378.08,0.29,1
64872,6421,1000.00,32000.00,33000.00,0.00,21714.96,0.17,1
64873,6421,1000.00,33000.00,34000.00,16500.00,16500.00,0.08,1
64874,6421,-1000.00,32000.00,33000.00,34000.00,0.00,0.01,0
64875,6421,1000.00,33000.00,34000.00,0.00,33000.00,0.30,1
64876,6421,1000.00,34000.00,35000.00,15940.40,18059.60,0.24,1
64877,6421,1000.00,35000.00,36000.00,2988.41,32011.59,0.19,1
64878,6422,-755.43,-755.43,244.57,0.00,755.43,0.39,0
64879,6422,-244.57,-1000.00,0.00,114.80,129.77,0.24,0
64880,6422,-0.00,-1000.00,0.00,0.00,0.00,0.22,0
64881,6422,-0.00,-1000.00,0.00,0.00,0.00,0.04,0
64882,6423,-1000.00,-1000.00,0.00,0.00,761.48,0.25,0
64883,6424,-1000.00,-1000.00,0.00,0.00,1000.00,0.07,0
64884,6425,-1000.00,-1000.00,0.00,0.00,1000.00,0.26,0
64885,6426,-1000.00,-1000.00,0.00,261.32,738.68,0.23,0
64886,6427,-1000.00,-1000.00,0.00,0.00,1000.00,0.40,0
64887,6428,0.00,0.00,1000.00,0.00,0.00,0.24,0
64888,6428,-463.34,-463.34,536.66,229.42,233.92,0.38,0
64889,6428,-536.66,-1000.00,0.00,0.00,536.66,0.05,0
64890,6429,-1000.00,-1000.00,0.00,0.00,1000.00,0.07,0
64891,6430,-1000.00,-1000.00,0.00,112.44,887.56,0.40,0
64892,6431,-1000.00,-1000.00,0.00,286.12,713.88,0.36,0
64893,6432,-1000.00,-1000.00,0.00,300.74,699.26,0.30,0
64894,6433,-918.14,-918.14,81.86,0.00,918.14,0.44,0
64895,6433,-67.72,-985.86,14.14,0.00,67.72,0.42,0
64896,6433,-1000.00,-1985.86,-985.86,7.36,6.78,0.16,0
64897,6434,-1000.00,-1000.00,0.00,0.00,1000.00,0.28,0
64898,6435,-1000.00,-1000.00,0.00,0.00,693.65,0.11,0
64899,6436,-1000.00,-1000.00,0.00,444.60,348.97,0.19,0
64900,6437,-1000.00,-1000.00,0.00,512.70,487.30,0.12,0
64901,6438,-524.64,-524.64,475.36,184.42,340.22,0.23,0
64902,6438,-475.36,-1000.00,0.00,237.52,237.84,0.21,0
64903,6439,-985.85,-985.85,14.15,985.85,0.00,0.11,0
64904,6439,-1000.00,-1985.85,-985.85,0.02,9.80,0.25,0
64905,6440,-1.38,-1.38,998.62,1.38,0.00,0.40,0
64906,6440,-1000.00,-1001.38,-1.38,408.57,590.05,0.01,0
64907,6441,-1000.00,-1000.00,0.00,0.00,1000.00,0.13,0
64908,6442,1000.00,1000.00,2000.00,294.21,705.79,0.35,1
64909,6442,1000.00,2000.00,3000.00,0.00,361.43,0.15,1
64910,6442,1000.00,3000.00,4000.00,1252.33,1674.96,0.26,1
64911,6442,1000.00,4000.00,5000.00,0.00,3532.05,0.05,1
64912,6442,1000.00,5000.00,6000.00,0.00,5000.00,0.35,1
64913,6442,-1000.00,4000.00,5000.00,3753.25,2246.75,0.11,0
64914,6442,1000.00,5000.00,6000.00,702.06,4297.94,0.40,1
64915,6442,-1000.00,4000.00,5000.00,4212.64,1018.44,0.09,0
64916,6442,1000.00,5000.00,6000.00,2377.93,2622.07,0.22,1
64917,6442,1000.00,6000.00,7000.00,2137.46,3862.54,0.25,1
64918,6442,1000.00,7000.00,8000.00,668.45,6331.55,0.19,1
64919,6442,1000.00,8000.00,9000.00,0.00,8000.00,0.31,1
64920,6442,1000.00,9000.00,10000.00,0.00,6490.25,0.36,1
64921,6442,1000.00,10000.00,11000.00,4043.96,5956.04,0.15,1
64922,6442,1000.00,11000.00,12000.00,0.00,6947.45,0.37,1
64923,6442,-1000.00,10000.00,11000.00,6019.17,5980.83,0.16,0
64924,6442,1000.00,11000.00,12000.00,3664.59,7103.08,0.32,1
64925,6442,1000.00,12000.00,13000.00,0.00,11408.83,0.06,1
64926,6442,1000.00,13000.00,14000.00,907.69,9467.15,0.40,1
64927,6442,1000.00,14000.00,15000.00,5539.86,8460.14,0.09,1
64928,6442,1000.00,15000.00,16000.00,5285.95,9714.05,0.32,1
64929,6442,1000.00,16000.00,17000.00,0.00,3930.17,0.11,1
64930,6442,-1000.00,15000.00,16000.00,0.00,14503.05,0.33,0
64931,6442,-1000.00,14000.00,15000.00,0.00,16000.00,0.02,0
64932,6442,-1000.00,13000.00,14000.00,3850.52,11149.48,0.02,0
64933,6442,-1000.00,12000.00,13000.00,5728.91,8271.09,0.05,0
64934,6442,-1000.00,11000.00,12000.00,0.00,3755.18,0.19,0
64935,6442,-1000.00,10000.00,11000.00,719.75,11280.25,0.24,0
64936,6442,-1000.00,9000.00,10000.00,0.00,11000.00,0.41,0
64937,6442,-1000.00,8000.00,9000.00,0.00,9996.16,0.44,0
64938,6442,-1000.00,7000.00,8000.00,4282.17,4717.83,0.14,0
64939,6442,-1000.00,6000.00,7000.00,0.00,1144.43,0.16,0
64940,6442,-1000.00,5000.00,6000.00,1532.90,5467.10,0.21,0
64941,6442,-1000.00,4000.00,5000.00,2097.15,3902.85,0.31,0
64942,6442,-1000.00,3000.00,4000.00,1124.35,3875.65,0.21,0
64943,6442,-1000.00,2000.00,3000.00,89.06,3910.94,0.24,0
64944,6442,-1000.00,1000.00,2000.00,0.00,3000.00,0.08,0
64945,6442,-1000.00,0.00,1000.00,467.44,1532.56,0.04,0
64946,6442,-1000.00,-1000.00,0.00,0.00,1000.00,0.00,0
64947,6443,-1000.00,-1000.00,0.00,0.00,1000.00,0.14,0
64948,6444,1000.00,1000.00,2000.00,0.00,1000.00,0.30,1
64949,6444,1000.00,2000.00,3000.00,0.00,1763.70,0.42,1
64950,6444,1000.00,3000.00,4000.00,23.35,2976.65,0.44,1
64951,6444,1000.00,4000.00,5000.00,0.00,4000.00,0.01,1
64952,6444,1000.00,5000.00,6000.00,0.00,5000.00,0.30,1
64953,6444,1000.00,6000.00,7000.00,2262.04,3549.13,0.29,1
64954,6444,-1000.00,5000.00,6000.00,4254.19,2745.81,0.15,0
64955,6444,1000.00,6000.00,7000.00,295.72,4304.83,0.39,1
64956,6444,1000.00,7000.00,8000.00,1222.13,5777.87,0.26,1
64957,6444,1000.00,8000.00,9000.00,0.00,1998.09,0.20,1
64958,6444,1000.00,9000.00,10000.00,201.49,8798.51,0.35,1
64959,6444,1000.00,10000.00,11000.00,0.00,7979.10,0.42,1
64960,6444,1000.00,11000.00,12000.00,2435.98,8564.02,0.40,1
64961,6444,1000.00,12000.00,13000.00,1220.46,10779.54,0.02,1
64962,6444,1000.00,13000.00,14000.00,0.00,636.98,0.10,1
64963,6444,1000.00,14000.00,15000.00,6284.55,7715.45,0.24,1
64964,6444,-1000.00,13000.00,14000.00,9825.31,1165.54,0.07,0
64965,6444,1000.00,14000.00,15000.00,0.00,7135.80,0.18,1
64966,6444,1000.00,15000.00,16000.00,0.00,15000.00,0.16,1
64967,6444,1000.00,16000.00,17000.00,988.53,15011.47,0.13,1
64968,6444,1000.00,17000.00,18000.00,0.00,12368.05,0.40,1
64969,6444,1000.00,18000.00,19000.00,8263.59,9736.41,0.15,1
64970,6444,-1000.00,17000.00,18000.00,6036.11,867.77,0.11,0
64971,6444,1000.00,18000.00,19000.00,0.00,7924.11,0.24,1
64972,6444,1000.00,19000.00,20000.00,0.00,6254.93,0.21,1
64973,6444,1000.00,20000.00,21000.00,7812.03,12187.97,0.28,1
64974,6444,1000.00,21000.00,22000.00,0.00,10296.16,0.05,1
64975,6444,-1000.00,20000.00,21000.00,12692.15,9307.85,0.08,0
64976,6444,1000.00,21000.00,22000.00,4580.45,16419.55,0.40,1
64977,6444,1000.00,22000.00,23000.00,10180.81,11819.19,0.13,1
64978,6444,1000.00,23000.00,24000.00,0.00,23000.00,0.25,1
64979,6444,1000.00,24000.00,25000.00,6085.35,17914.65,0.16,1
64980,6444,1000.00,25000.00,26000.00,5071.41,19928.59,0.41,1
64981,6444,1000.00,26000.00,27000.00,0.00,6662.92,0.08,1
64982,6444,1000.00,27000.00,28000.00,6436.00,20564.00,0.39,1
64983,6444,1000.00,28000.00,29000.00,13299.45,14700.55,0.19,1
64984,6444,1000.00,29000.00,30000.00,0.00,29000.00,0.10,1
64985,6444,1000.00,30000.00,31000.00,3701.15,16921.33,0.33,1
64986,6445,-1000.00,-1000.00,0.00,65.49,934.51,0.44,0
64987,6446,-1000.00,-1000.00,0.00,0.00,1000.00,0.14,0
64988,6447,1000.00,1000.00,2000.00,0.00,748.62,0.40,1
64989,6447,1000.00,2000.00,3000.00,123.13,1876.87,0.27,1
64990,6447,1000.00,3000.00,4000.00,0.00,1495.48,0.25,1
64991,6447,1000.00,4000.00,5000.00,0.00,3052.52,0.31,1
64992,6447,1000.00,5000.00,6000.00,1784.93,3215.07,0.30,1
64993,6447,1000.00,6000.00,7000.00,1602.25,2221.51,0.23,1
64994,6447,1000.00,7000.00,8000.00,1860.33,5139.67,0.34,1
64995,6447,-1000.00,6000.00,7000.00,4243.10,3756.90,0.02,0
64996,6447,1000.00,7000.00,8000.00,0.00,7000.00,0.42,1
64997,6447,1000.00,8000.00,9000.00,0.00,7160.14,0.27,1
64998,6447,1000.00,9000.00,10000.00,4203.57,4796.43,0.24,1
64999,6447,1000.00,10000.00,11000.00,2819.12,7180.88,0.36,1
65000,6447,1000.00,11000.00,12000.00,0.00,9620.57,0.38,1
65001,6447,1000.00,12000.00,13000.00,5163.13,6836.87,0.14,1
65002,6447,1000.00,13000.00,14000.00,5581.78,7418.22,0.19,1
65003,6447,1000.00,14000.00,15000.00,0.00,14000.00,0.01,1
65004,6447,1000.00,15000.00,16000.00,0.00,10670.88,0.30,1
65005,6447,1000.00,16000.00,17000.00,0.00,16000.00,0.40,1
65006,6447,1000.00,17000.00,18000.00,0.00,17000.00,0.39,1
65007,6447,1000.00,18000.00,19000.00,1778.08,16221.92,0.33,1
65008,6447,1000.00,19000.00,20000.00,5803.47,13196.53,0.19,1
65009,6447,1000.00,20000.00,21000.00,10000.00,10000.00,0.03,1
65010,6447,1000.00,21000.00,22000.00,0.00,21000.00,0.22,1
65011,6447,1000.00,22000.00,23000.00,0.00,22000.00,0.03,1
65012,6447,-1000.00,21000.00,22000.00,6719.67,10248.47,0.26,0
65013,6447,0.00,21000.00,22000.00,0.00,0.00,0.06,0
65014,6447,-1000.00,20000.00,21000.00,0.00,8905.48,0.03,0
65015,6447,-1000.00,19000.00,20000.00,0.00,14420.68,0.15,0
65016,6447,-1000.00,18000.00,19000.00,10000.00,10000.00,0.00,0
65017,6447,-1000.00,17000.00,18000.00,5321.30,13678.70,0.34,0
65018,6447,-1000.00,16000.00,17000.00,4404.43,13595.57,0.33,0
65019,6447,-1000.00,15000.00,16000.00,4392.43,12445.10,0.37,0
65020,6447,-1000.00,14000.00,15000.00,0.00,10978.57,0.37,0
65021,6447,0.00,14000.00,15000.00,0.00,0.00,0.09,0
65022,6448,-1000.00,-1000.00,0.00,0.00,1000.00,0.25,0
65023,6449,-1000.00,-1000.00,0.00,0.00,1000.00,0.12,0
65024,6450,-1000.00,-1000.00,0.00,477.03,522.97,0.13,0
65025,6451,-1000.00,-1000.00,0.00,15.55,984.45,0.44,0
65026,6452,-352.47,-352.47,647.53,352.47,0.00,0.33,0
65027,6452,-1000.00,-1352.47,-352.47,0.00,218.58,0.02,0
65028,6453,-1000.00,-1000.00,0.00,151.53,0.00,0.11,0
65029,6454,-158.79,-158.79,841.21,0.00,158.79,0.14,0
65030,6454,-435.44,-594.23,405.77,0.00,435.44,0.31,0
65031,6454,-405.77,-1000.00,0.00,0.00,405.77,0.16,0
65032,6455,1000.00,1000.00,2000.00,0.00,602.02,0.35,1
65033,6455,-1000.00,0.00,1000.00,1276.98,723.02,0.14,0
65034,6455,-255.26,-255.26,744.74,255.26,0.00,0.09,0
65035,6455,1000.00,744.74,1744.74,0.00,317.18,0.10,1
65036,6455,1000.00,1744.74,2744.74,0.00,1744.74,0.28,1
65037,6455,1000.00,2744.74,3744.74,0.00,2744.74,0.27,1
65038,6455,1000.00,3744.74,4744.74,1409.13,2335.61,0.30,1
65039,6455,1000.00,4744.74,5744.74,447.11,4297.63,0.44,1
65040,6455,1000.00,5744.74,6744.74,72.29,5672.45,0.20,1
65041,6455,1000.00,6744.74,7744.74,0.00,6744.74,0.14,1
65042,6455,1000.00,7744.74,8744.74,1744.72,3408.42,0.27,1
65043,6455,1000.00,8744.74,9744.74,4372.37,4372.37,0.09,1
65044,6455,-1000.00,7744.74,8744.74,1105.64,0.00,0.07,0
65045,6455,1000.00,8744.74,9744.74,1777.85,6966.89,0.28,1
65046,6455,1000.00,9744.74,10744.74,0.00,5176.51,0.32,1
65047,6455,-1000.00,8744.74,9744.74,5240.57,2910.89,0.15,0
65048,6455,1000.00,9744.74,10744.74,3722.25,6022.49,0.16,1
65049,6455,1000.00,10744.74,11744.74,0.00,8944.12,0.42,1
65050,6455,-1000.00,9744.74,10744.74,5318.49,6426.25,0.15,0
65051,6455,-1000.00,8744.74,9744.74,0.00,10744.74,0.31,0
65052,6455,-1000.00,7744.74,8744.74,1081.93,3117.02,0.23,0
65053,6455,-1000.00,6744.74,7744.74,3572.41,5172.33,0.25,0
65054,6455,-1000.00,5744.74,6744.74,2790.70,4954.04,0.28,0
65055,6455,-1000.00,4744.74,5744.74,3376.29,3368.45,0.18,0
65056,6455,-1000.00,3744.74,4744.74,0.00,5744.74,0.19,0
65057,6455,-997.22,2747.52,3747.52,0.00,997.22,0.18,0
65058,6455,-1000.00,1747.52,2747.52,1316.85,2430.67,0.30,0
65059,6455,-1000.00,747.52,1747.52,0.00,2747.52,0.43,0
65060,6455,-1000.00,-252.48,747.52,0.00,1747.52,0.43,0
65061,6455,-88.97,-341.44,658.56,0.00,88.97,0.09,0
65062,6455,-658.56,-1000.00,0.00,273.78,384.77,0.04,0
65063,6456,1000.00,1000.00,2000.00,146.68,0.00,0.42,1
65064,6456,-494.94,505.06,1505.06,0.00,494.94,0.34,0
65065,6456,-625.33,-120.27,879.73,0.00,625.33,0.31,0
65066,6456,-830.58,-950.85,49.15,0.00,830.58,0.33,0
65067,6456,1000.00,49.15,1049.15,33.33,15.82,0.02,1
65068,6456,-1000.00,-950.85,49.15,0.00,1049.15,0.35,0
65069,6456,-49.15,-1000.00,0.00,12.30,36.85,0.38,0
65070,6457,-563.24,-563.24,436.76,0.00,563.24,0.31,0
65071,6457,-265.31,-828.55,171.45,0.00,265.31,0.24,0
65072,6457,-171.45,-1000.00,0.00,40.25,131.20,0.13,0
65073,6457,-0.00,-1000.00,0.00,0.00,0.00,0.42,0
65074,6457,-0.00,-1000.00,0.00,0.00,0.00,0.34,0
65075,6458,1000.00,1000.00,2000.00,29.94,208.10,0.18,1
65076,6458,0.00,1000.00,2000.00,0.00,0.00,0.05,0
65077,6458,1000.00,2000.00,3000.00,37.88,1962.12,0.43,1
65078,6458,1000.00,3000.00,4000.00,929.70,1953.87,0.33,1
65079,6458,1000.00,4000.00,5000.00,0.00,4000.00,0.30,1
65080,6458,1000.00,5000.00,6000.00,2462.06,2537.94,0.12,1
65081,6458,1000.00,6000.00,7000.00,0.00,5286.48,0.27,1
65082,6458,1000.00,7000.00,8000.00,0.00,7000.00,0.01,1
65083,6458,-1000.00,6000.00,7000.00,6694.22,1305.78,0.01,0
65084,6458,1000.00,7000.00,8000.00,2707.54,4292.46,0.30,1
65085,6458,-1000.00,6000.00,7000.00,1148.91,59.04,0.11,0
65086,6458,1000.00,7000.00,8000.00,0.00,286.07,0.09,1
65087,6458,1000.00,8000.00,9000.00,0.00,8000.00,0.11,1
65088,6458,1000.00,9000.00,10000.00,0.00,9000.00,0.43,1
65089,6458,1000.00,10000.00,11000.00,0.00,10000.00,0.02,1
65090,6458,1000.00,11000.00,12000.00,2538.56,5841.83,0.30,1
65091,6458,1000.00,12000.00,13000.00,0.00,12000.00,0.11,1
65092,6458,1000.00,13000.00,14000.00,4489.62,8510.38,0.29,1
65093,6458,1000.00,14000.00,15000.00,0.00,9820.66,0.13,1
65094,6458,-1000.00,13000.00,14000.00,5614.92,9385.08,0.21,0
65095,6458,-1000.00,12000.00,13000.00,0.00,14000.00,0.02,0
65096,6458,-1000.00,11000.00,12000.00,6500.00,6500.00,0.04,0
65097,6458,-1000.00,10000.00,11000.00,5942.76,6057.24,0.11,0
65098,6458,-1000.00,9000.00,10000.00,0.00,11000.00,0.10,0
65099,6458,-1000.00,8000.00,9000.00,4666.33,5333.67,0.14,0
65100,6458,-1000.00,7000.00,8000.00,0.00,9000.00,0.30,0
65101,6458,-1000.00,6000.00,7000.00,2416.25,5583.75,0.35,0
65102,6458,-1000.00,5000.00,6000.00,2125.16,4874.84,0.35,0
65103,6458,-1000.00,4000.00,5000.00,1743.12,4256.88,0.10,0
65104,6458,-1000.00,3000.00,4000.00,1652.24,3347.76,0.29,0
65105,6458,-1000.00,2000.00,3000.00,0.00,1446.79,0.20,0
65106,6458,-879.87,1120.13,2120.13,0.00,879.87,0.22,0
65107,6458,-1000.00,120.13,1120.13,0.00,2120.13,0.15,0
65108,6458,-1000.00,-879.87,120.13,0.00,1120.13,0.08,0
65109,6458,-120.13,-1000.00,0.00,57.42,62.70,0.09,0
65110,6459,-1000.00,-1000.00,0.00,225.56,774.44,0.20,0
65111,6460,-1000.00,-1000.00,0.00,351.17,648.83,0.29,0
65112,6461,-1000.00,-1000.00,0.00,0.00,645.91,0.18,0
65113,6462,-564.91,-564.91,435.09,277.92,286.99,0.20,0
65114,6462,0.00,-564.91,435.09,0.00,0.00,0.10,0
65115,6462,-435.09,-1000.00,0.00,202.46,232.63,0.17,0
65116,6463,1000.00,1000.00,2000.00,0.00,118.78,0.17,1
65117,6463,-59.66,940.34,1940.34,30.17,29.48,0.44,0
65118,6463,1000.00,1940.34,2940.34,0.00,1006.87,0.32,1
65119,6463,1000.00,2940.34,3940.34,0.00,2940.34,0.23,1
65120,6463,1000.00,3940.34,4940.34,1464.20,2476.14,0.25,1
65121,6463,1000.00,4940.34,5940.34,1200.06,3740.28,0.33,1
65122,6463,1000.00,5940.34,6940.34,0.00,5940.34,0.40,1
65123,6463,1000.00,6940.34,7940.34,0.00,3663.27,0.32,1
65124,6463,1000.00,7940.34,8940.34,0.00,7940.34,0.38,1
65125,6463,1000.00,8940.34,9940.34,3304.03,5636.31,0.27,1
65126,6463,1000.00,9940.34,10940.34,3053.98,6886.36,0.35,1
65127,6463,1000.00,10940.34,11940.34,0.00,10940.34,0.31,1
65128,6463,1000.00,11940.34,12940.34,5701.05,6239.29,0.12,1
65129,6463,1000.00,12940.34,13940.34,0.00,12940.34,0.09,1
65130,6463,1000.00,13940.34,14940.34,6152.22,7788.12,0.18,1
65131,6463,1000.00,14940.34,15940.34,0.00,14940.34,0.00,1
65132,6463,1000.00,15940.34,16940.34,4697.32,11243.02,0.00,1
65133,6463,1000.00,16940.34,17940.34,6545.70,10394.64,0.24,1
65134,6463,-1000.00,15940.34,16940.34,0.00,17940.34,0.41,0
65135,6463,-1000.00,14940.34,15940.34,0.00,4149.56,0.06,0
65136,6463,-1000.00,13940.34,14940.34,1953.43,13986.91,0.43,0
65137,6463,-1000.00,12940.34,13940.34,4438.75,10501.59,0.34,0
65138,6463,-1000.00,11940.34,12940.34,0.00,13328.98,0.37,0
65139,6463,-1000.00,10940.34,11940.34,2196.61,0.00,0.05,0
65140,6463,-1000.00,9940.34,10940.34,4495.85,7444.49,0.20,0
65141,6463,-1000.00,8940.34,9940.34,396.07,10544.27,0.11,0
65142,6463,-1000.00,7940.34,8940.34,0.00,9940.34,0.38,0
65143,6463,-885.81,7054.53,8054.53,0.00,885.81,0.06,0
65144,6463,-1000.00,6054.53,7054.53,2801.12,5253.41,0.09,0
65145,6463,-1000.00,5054.53,6054.53,0.00,7054.53,0.20,0
65146,6463,-1000.00,4054.53,5054.53,0.00,6054.53,0.10,0
65147,6463,-1000.00,3054.53,4054.53,2184.35,0.00,0.05,0
65148,6463,-1000.00,2054.53,3054.53,1493.32,2561.21,0.25,0
65149,6463,-1000.00,1054.53,2054.53,1018.29,1882.16,0.31,0
65150,6463,-1000.00,54.53,1054.53,184.74,1869.79,0.43,0
65151,6463,-1000.00,-945.47,54.53,525.35,529.18,0.10,0
65152,6463,-54.53,-1000.00,0.00,5.39,49.13,0.19,0
65153,6464,-1000.00,-1000.00,0.00,0.00,1000.00,0.01,0
65154,6465,-1000.00,-1000.00,0.00,106.23,893.77,0.32,0
65155,6465,-0.00,-1000.00,0.00,0.00,0.00,0.21,0
65156,6466,-1000.00,-1000.00,0.00,508.38,491.62,0.22,0
65157,6467,-1000.00,-1000.00,0.00,0.00,45.32,0.07,0
65158,6468,1000.00,1000.00,2000.00,0.00,411.06,0.27,1
65159,6468,-1000.00,0.00,1000.00,319.81,1680.19,0.40,0
65160,6468,-1000.00,-1000.00,0.00,0.00,1000.00,0.30,0
65161,6469,-1000.00,-1000.00,0.00,678.31,321.69,0.05,0
65162,6470,-1000.00,-1000.00,0.00,0.00,1000.00,0.16,0
65163,6471,-405.72,-405.72,594.28,405.72,0.00,0.04,0
65164,6471,1000.00,594.28,1594.28,227.59,366.70,0.22,1
65165,6471,1000.00,1594.28,2594.28,0.00,1594.28,0.24,1
65166,6471,1000.00,2594.28,3594.28,165.84,1506.84,0.34,1
65167,6471,-1000.00,1594.28,2594.28,65.70,2832.40,0.42,0
65168,6471,-1000.00,594.28,1594.28,327.75,2266.54,0.40,0
65169,6471,-1000.00,-405.72,594.28,0.00,768.46,0.29,0
65170,6471,-1000.00,-1405.72,-405.72,0.00,439.40,0.21,0
65171,6472,-1000.00,-1000.00,0.00,195.72,609.23,0.34,0
65172,6473,-407.22,-407.22,592.78,0.00,407.22,0.34,0
65173,6473,-79.17,-486.38,513.62,0.00,79.17,0.35,0
65174,6473,0.00,-486.38,513.62,0.00,0.00,0.23,0
65175,6473,1000.00,513.62,1513.62,460.69,42.40,0.14,1
65176,6473,-776.66,-263.04,736.96,0.00,776.66,0.01,0
65177,6473,-736.96,-1000.00,0.00,368.48,368.48,0.01,0
65178,6474,-1000.00,-1000.00,0.00,31.85,409.68,0.36,0
65179,6475,-1000.00,-1000.00,0.00,0.00,1000.00,0.34,0
65180,6476,0.00,0.00,1000.00,0.00,0.00,0.06,0
65181,6476,-1000.00,-1000.00,0.00,12.36,987.64,0.28,0
65182,6477,1000.00,1000.00,2000.00,0.00,1000.00,0.29,1
65183,6477,1000.00,2000.00,3000.00,0.00,1345.72,0.32,1
65184,6477,1000.00,3000.00,4000.00,0.00,1538.51,0.31,1
65185,6477,1000.00,4000.00,5000.00,0.00,4000.00,0.30,1
65186,6477,1000.00,5000.00,6000.00,1684.55,3315.45,0.01,1
65187,6477,1000.00,6000.00,7000.00,0.00,1753.74,0.05,1
65188,6477,1000.00,7000.00,8000.00,2219.13,4780.87,0.33,1
65189,6477,1000.00,8000.00,9000.00,2460.70,5539.30,0.31,1
65190,6477,1000.00,9000.00,10000.00,2323.25,6676.75,0.37,1
65191,6477,1000.00,10000.00,11000.00,0.00,10000.00,0.29,1
65192,6477,1000.00,11000.00,12000.00,0.00,11000.00,0.30,1
65193,6477,1000.00,12000.00,13000.00,5012.09,6987.91,0.21,1
65194,6477,1000.00,13000.00,14000.00,666.70,3989.82,0.23,1
65195,6477,1000.00,14000.00,15000.00,0.00,14000.00,0.04,1
65196,6477,1000.00,15000.00,16000.00,7382.73,7617.27,0.14,1
65197,6477,1000.00,16000.00,17000.00,4697.36,11302.64,0.33,1
65198,6477,1000.00,17000.00,18000.00,1165.60,15834.40,0.44,1
65199,6477,1000.00,18000.00,19000.00,0.00,18000.00,0.44,1
65200,6477,-1000.00,17000.00,18000.00,16249.68,2750.32,0.05,0
65201,6477,1000.00,18000.00,19000.00,0.00,18000.00,0.39,1
65202,6477,1000.00,19000.00,20000.00,1280.29,11133.89,0.35,1
65203,6477,1000.00,20000.00,21000.00,0.00,16997.86,0.26,1
65204,6477,1000.00,21000.00,22000.00,0.00,21000.00,0.21,1
65205,6477,1000.00,22000.00,23000.00,1620.22,20379.78,0.30,1
65206,6477,1000.00,23000.00,24000.00,0.00,23000.00,0.16,1
65207,6477,1000.00,24000.00,25000.00,0.00,24000.00,0.23,1
65208,6477,1000.00,25000.00,26000.00,5633.07,19366.93,0.38,1
65209,6477,1000.00,26000.00,27000.00,3669.39,22330.61,0.28,1
65210,6477,1000.00,27000.00,28000.00,0.00,27000.00,0.10,1
65211,6477,1000.00,28000.00,29000.00,6559.69,21440.31,0.39,1
65212,6477,1000.00,29000.00,30000.00,8169.64,20830.36,0.07,1
65213,6477,1000.00,30000.00,31000.00,11379.89,18620.11,0.23,1
65214,6477,1000.00,31000.00,32000.00,0.00,31000.00,0.26,1
65215,6477,1000.00,32000.00,33000.00,2981.17,29018.83,0.12,1
65216,6477,1000.00,33000.00,34000.00,16051.18,16948.82,0.19,1
65217,6477,1000.00,34000.00,35000.00,10589.54,23265.36,0.34,1
65218,6477,1000.00,35000.00,36000.00,0.00,35000.00,0.42,1
65219,6477,1000.00,36000.00,37000.00,3483.75,32516.25,0.43,1
65220,6477,1000.00,37000.00,38000.00,10634.34,26365.66,0.36,1
65221,6477,-1000.00,36000.00,37000.00,13740.70,13235.35,0.20,0
65222,6477,1000.00,37000.00,38000.00,0.00,31999.80,0.24,1
65223,6478,-1000.00,-1000.00,0.00,0.00,988.80,0.40,0
65224,6479,-1000.00,-1000.00,0.00,0.00,1000.00,0.26,0
65225,6480,-1000.00,-1000.00,0.00,818.43,181.57,0.09,0
65226,6481,-1000.00,-1000.00,0.00,0.00,802.19,0.07,0
65227,6482,0.00,0.00,1000.00,0.00,0.00,0.05,0
65228,6482,-1000.00,-1000.00,0.00,63.72,936.28,0.43,0
65229,6483,-1000.00,-1000.00,0.00,23.14,976.86,0.41,0
65230,6484,1000.00,1000.00,2000.00,500.00,500.00,0.03,1
65231,6484,1000.00,2000.00,3000.00,787.53,1212.47,0.29,1
65232,6484,1000.00,3000.00,4000.00,0.00,90.56,0.08,1
65233,6484,1000.00,4000.00,5000.00,36.33,3722.37,0.44,1
65234,6484,-1000.00,3000.00,4000.00,2980.01,2019.16,0.16,0
65235,6484,1000.00,4000.00,5000.00,0.00,4000.00,0.28,1
65236,6484,1000.00,5000.00,6000.00,0.00,5000.00,0.02,1
65237,6484,1000.00,6000.00,7000.00,0.00,3886.78,0.24,1
65238,6484,1000.00,7000.00,8000.00,308.84,5699.73,0.42,1
65239,6484,1000.00,8000.00,9000.00,0.00,8000.00,0.01,1
65240,6484,1000.00,9000.00,10000.00,0.00,6734.34,0.40,1
65241,6484,1000.00,10000.00,11000.00,2304.98,7695.02,0.39,1
65242,6484,1000.00,11000.00,12000.00,2017.46,8982.54,0.39,1
65243,6484,1000.00,12000.00,13000.00,0.00,7238.11,0.28,1
65244,6484,1000.00,13000.00,14000.00,0.00,2563.07,0.12,1
65245,6484,1000.00,14000.00,15000.00,0.00,10842.83,0.27,1
65246,6484,-1000.00,13000.00,14000.00,6075.24,0.00,0.04,0
65247,6484,1000.00,14000.00,15000.00,0.00,3268.30,0.12,1
65248,6484,-1000.00,13000.00,14000.00,5195.10,2697.16,0.15,0
65249,6484,1000.00,14000.00,15000.00,0.00,9686.17,0.32,1
65250,6484,1000.00,15000.00,16000.00,0.00,12569.30,0.36,1
65251,6484,1000.00,16000.00,17000.00,3731.10,11854.26,0.37,1
65252,6484,-1000.00,15000.00,16000.00,6667.22,601.94,0.10,0
65253,6484,1000.00,16000.00,17000.00,0.00,5529.94,0.22,1
65254,6484,1000.00,17000.00,18000.00,0.00,7690.94,0.27,1
65255,6484,1000.00,18000.00,19000.00,1095.03,16871.54,0.44,1
65256,6484,1000.00,19000.00,20000.00,0.00,19000.00,0.06,1
65257,6484,1000.00,20000.00,21000.00,0.00,13743.04,0.39,1
65258,6484,1000.00,21000.00,22000.00,8156.07,12843.93,0.15,1
65259,6484,1000.00,22000.00,23000.00,4062.28,17937.72,0.35,1
65260,6484,1000.00,23000.00,24000.00,3241.18,12095.65,0.31,1
65261,6484,1000.00,24000.00,25000.00,0.00,8684.43,0.25,1
65262,6484,1000.00,25000.00,26000.00,9288.50,15711.50,0.01,1
65263,6484,-1000.00,24000.00,25000.00,21180.16,4819.84,0.01,0
65264,6484,0.00,24000.00,25000.00,0.00,0.00,0.02,0
65265,6484,1000.00,25000.00,26000.00,10955.93,14044.07,0.19,1
65266,6484,1000.00,26000.00,27000.00,0.00,20503.77,0.22,1
65267,6484,1000.00,27000.00,28000.00,13500.00,13500.00,0.08,1
65268,6484,1000.00,28000.00,29000.00,4059.04,23940.96,0.27,1
65269,6484,1000.00,29000.00,30000.00,0.00,29000.00,0.24,1
65270,6484,1000.00,30000.00,31000.00,0.00,30000.00,0.01,1
65271,6484,1000.00,31000.00,32000.00,0.00,30894.94,0.30,1
65272,6484,1000.00,32000.00,33000.00,0.00,32000.00,0.29,1
65273,6485,1000.00,1000.00,2000.00,433.65,566.35,0.21,1
65274,6485,1000.00,2000.00,3000.00,951.79,1048.21,0.02,1
65275,6485,1000.00,3000.00,4000.00,0.00,3000.00,0.36,1
65276,6485,1000.00,4000.00,5000.00,0.00,4000.00,0.01,1
65277,6485,-1000.00,3000.00,4000.00,3085.44,905.73,0.10,0
65278,6485,1000.00,4000.00,5000.00,1262.30,2737.70,0.27,1
65279,6485,1000.00,5000.00,6000.00,124.95,4875.05,0.22,1
65280,6485,0.00,5000.00,6000.00,0.00,0.00,0.04,0
65281,6485,1000.00,6000.00,7000.00,998.18,5001.82,0.30,1
65282,6485,1000.00,7000.00,8000.00,2080.55,4919.45,0.35,1
65283,6485,1000.00,8000.00,9000.00,3085.32,4914.68,0.08,1
65284,6485,1000.00,9000.00,10000.00,2789.17,6210.83,0.28,1
65285,6485,1000.00,10000.00,11000.00,3609.33,6390.67,0.28,1
65286,6485,1000.00,11000.00,12000.00,0.00,11000.00,0.12,1
65287,6485,1000.00,12000.00,13000.00,0.00,11975.59,0.40,1
65288,6485,1000.00,13000.00,14000.00,1711.69,9888.20,0.40,1
65289,6485,1000.00,14000.00,15000.00,0.00,14000.00,0.38,1
65290,6485,1000.00,15000.00,16000.00,165.62,14834.38,0.44,1
65291,6485,1000.00,16000.00,17000.00,0.00,6736.10,0.02,1
65292,6485,1000.00,17000.00,18000.00,0.00,17000.00,0.27,1
65293,6485,1000.00,18000.00,19000.00,1541.65,16458.35,0.41,1
65294,6485,1000.00,19000.00,20000.00,0.00,17159.10,0.32,1
65295,6485,1000.00,20000.00,21000.00,0.00,20000.00,0.27,1
65296,6485,1000.00,21000.00,22000.00,0.00,7418.83,0.23,1
65297,6485,1000.00,22000.00,23000.00,9750.80,12249.20,0.26,1
65298,6485,1000.00,23000.00,24000.00,10594.86,12405.14,0.04,1
65299,6485,1000.00,24000.00,25000.00,0.00,13562.52,0.19,1
65300,6485,1000.00,25000.00,26000.00,0.00,19310.87,0.33,1
65301,6485,1000.00,26000.00,27000.00,1955.34,18502.52,0.39,1
65302,6485,1000.00,27000.00,28000.00,11069.75,15930.25,0.22,1
65303,6485,1000.00,28000.00,29000.00,12431.73,15568.27,0.18,1
65304,6485,1000.00,29000.00,30000.00,11865.79,17134.21,0.23,1
65305,6485,1000.00,30000.00,31000.00,10347.67,19652.33,0.27,1
65306,6485,1000.00,31000.00,32000.00,0.00,31000.00,0.22,1
65307,6485,1000.00,32000.00,33000.00,9632.92,22367.08,0.35,1
65308,6485,1000.00,33000.00,34000.00,0.00,8392.99,0.20,1
65309,6485,1000.00,34000.00,35000.00,0.00,34000.00,0.18,1
65310,6485,1000.00,35000.00,36000.00,4912.84,23992.28,0.37,1
65311,6485,1000.00,36000.00,37000.00,12782.99,23217.01,0.14,1
65312,6485,1000.00,37000.00,38000.00,0.00,37000.00,0.05,1
65313,6485,1000.00,38000.00,39000.00,0.00,38000.00,0.14,1
65314,6486,-13.73,-13.73,986.27,0.00,13.73,0.01,0
65315,6486,-1000.00,-1013.73,-13.73,432.09,251.26,0.16,0
65316,6487,-972.01,-972.01,27.99,0.00,972.01,0.41,0
65317,6487,-27.99,-1000.00,0.00,0.00,27.99,0.23,0
65318,6488,-1000.00,-1000.00,0.00,0.00,1000.00,0.41,0
65319,6489,-1000.00,-1000.00,0.00,0.00,1000.00,0.42,0
65320,6490,-1000.00,-1000.00,0.00,254.32,745.68,0.13,0
65321,6490,-0.00,-1000.00,-0.00,0.00,0.00,0.06,0
65322,6491,-1000.00,-1000.00,0.00,0.00,1000.00,0.28,0
65323,6492,-967.79,-967.79,32.21,422.75,545.05,0.23,0
65324,6492,0.00,-967.79,32.21,0.00,0.00,0.38,0
65325,6492,1000.00,32.21,1032.21,19.69,12.52,0.08,1
65326,6492,-815.92,-783.71,216.29,392.19,423.72,0.29,0
65327,6492,-216.29,-1000.00,0.00,61.13,155.16,0.34,0
65328,6493,-1000.00,-1000.00,0.00,807.48,192.52,0.11,0
65329,6494,1000.00,1000.00,2000.00,429.18,570.64,0.26,1
65330,6494,0.00,1000.00,2000.00,0.00,0.00,0.07,0
65331,6494,1000.00,2000.00,3000.00,0.00,2000.00,0.29,1
65332,6494,1000.00,3000.00,4000.00,760.40,2239.60,0.38,1
65333,6494,1000.00,4000.00,5000.00,0.00,1196.54,0.15,1
65334,6494,1000.00,5000.00,6000.00,0.00,5000.00,0.18,1
65335,6494,1000.00,6000.00,7000.00,0.00,6000.00,0.26,1
65336,6494,1000.00,7000.00,8000.00,627.20,6372.80,0.44,1
65337,6494,1000.00,8000.00,9000.00,1892.36,6107.64,0.34,1
65338,6494,1000.00,9000.00,10000.00,3142.47,5857.53,0.27,1
65339,6494,1000.00,10000.00,11000.00,4267.85,5732.15,0.05,1
65340,6494,1000.00,11000.00,12000.00,0.00,11000.00,0.19,1
65341,6494,1000.00,12000.00,13000.00,0.00,12000.00,0.17,1
65342,6494,1000.00,13000.00,14000.00,0.00,4731.54,0.16,1
65343,6494,1000.00,14000.00,15000.00,0.00,14000.00,0.16,1
65344,6494,1000.00,15000.00,16000.00,3592.71,5081.48,0.22,1
65345,6494,1000.00,16000.00,17000.00,0.00,16000.00,0.00,1
65346,6494,1000.00,17000.00,18000.00,1744.22,15255.78,0.20,1
65347,6494,1000.00,18000.00,19000.00,2428.89,15571.11,0.27,1
65348,6494,1000.00,19000.00,20000.00,152.58,18847.42,0.15,1
65349,6494,1000.00,20000.00,21000.00,3388.52,16611.48,0.24,1
65350,6494,1000.00,21000.00,22000.00,5764.44,15235.56,0.14,1
65351,6494,1000.00,22000.00,23000.00,0.00,22000.00,0.06,1
65352,6494,1000.00,23000.00,24000.00,3212.28,14618.63,0.36,1
65353,6494,1000.00,24000.00,25000.00,0.00,17379.20,0.29,1
65354,6494,1000.00,25000.00,26000.00,11982.45,13017.55,0.18,1
65355,6494,1000.00,26000.00,27000.00,12535.04,13464.96,0.13,1
65356,6494,1000.00,27000.00,28000.00,10566.41,16433.59,0.29,1
65357,6494,1000.00,28000.00,29000.00,4112.86,23887.14,0.34,1
65358,6494,1000.00,29000.00,30000.00,1952.34,27047.66,0.33,1
65359,6494,1000.00,30000.00,31000.00,6292.00,23708.00,0.40,1
65360,6494,-1000.00,29000.00,30000.00,15424.89,0.00,0.02,0
65361,6494,1000.00,30000.00,31000.00,0.00,24302.25,0.06,1
65362,6494,1000.00,31000.00,32000.00,0.00,31000.00,0.21,1
65363,6494,1000.00,32000.00,33000.00,8171.12,23828.88,0.35,1
65364,6494,1000.00,33000.00,34000.00,15796.35,17203.65,0.17,1
65365,6494,1000.00,34000.00,35000.00,5725.69,21572.89,0.35,1
65366,6494,1000.00,35000.00,36000.00,0.00,35000.00,0.13,1
65367,6494,1000.00,36000.00,37000.00,5116.18,30883.82,0.08,1
65368,6494,1000.00,37000.00,38000.00,0.00,37000.00,0.42,1
65369,6494,1000.00,38000.00,39000.00,0.00,38000.00,0.03,1
65370,6495,-1000.00,-1000.00,0.00,0.00,1000.00,0.20,0
65371,6496,-1000.00,-1000.00,0.00,0.00,539.25,0.04,0
65372,6497,1000.00,1000.00,2000.00,98.65,581.95,0.34,1
65373,6497,1000.00,2000.00,3000.00,0.00,1870.75,0.34,1
65374,6497,0.00,2000.00,3000.00,0.00,0.00,0.01,0
65375,6497,1000.00,3000.00,4000.00,0.00,2686.34,0.38,1
65376,6497,1000.00,4000.00,5000.00,0.00,3763.18,0.17,1
65377,6497,-1000.00,3000.00,4000.00,953.35,155.81,0.11,0
65378,6497,1000.00,4000.00,5000.00,0.00,4000.00,0.07,1
65379,6497,1000.00,5000.00,6000.00,0.00,4244.02,0.30,1
65380,6497,1000.00,6000.00,7000.00,0.00,6000.00,0.39,1
65381,6497,1000.00,7000.00,8000.00,2712.42,4287.58,0.28,1
65382,6497,1000.00,8000.00,9000.00,0.00,3994.38,0.31,1
65383,6497,0.00,8000.00,9000.00,0.00,0.00,0.03,0
65384,6497,1000.00,9000.00,10000.00,0.00,1254.55,0.12,1
65385,6497,1000.00,10000.00,11000.00,0.00,2360.71,0.16,1
65386,6497,1000.00,11000.00,12000.00,0.00,2941.49,0.12,1
65387,6497,1000.00,12000.00,13000.00,5506.60,6493.40,0.16,1
65388,6497,1000.00,13000.00,14000.00,4394.39,8605.61,0.27,1
65389,6497,1000.00,14000.00,15000.00,2475.69,11524.31,0.38,1
65390,6497,1000.00,15000.00,16000.00,2549.59,12450.41,0.42,1
65391,6497,1000.00,16000.00,17000.00,0.00,11626.07,0.40,1
65392,6497,1000.00,17000.00,18000.00,0.00,17000.00,0.29,1
65393,6497,1000.00,18000.00,19000.00,0.00,18000.00,0.14,1
65394,6497,1000.00,19000.00,20000.00,0.00,16443.21,0.37,1
65395,6497,-1000.00,18000.00,19000.00,11898.95,8101.05,0.10,0
65396,6497,-1000.00,17000.00,18000.00,0.00,19000.00,0.42,0
65397,6497,-1000.00,16000.00,17000.00,2857.73,15142.27,0.03,0
65398,6497,-1000.00,15000.00,16000.00,3322.33,13677.67,0.15,0
65399,6497,-1000.00,14000.00,15000.00,0.00,16000.00,0.00,0
65400,6497,-1000.00,13000.00,14000.00,372.69,14627.31,0.32,0
65401,6497,-1000.00,12000.00,13000.00,1656.83,8439.79,0.35,0
65402,6497,-1000.00,11000.00,12000.00,2709.27,10290.73,0.40,0
65403,6497,-1000.00,10000.00,11000.00,0.00,10803.45,0.44,0
65404,6497,-1000.00,9000.00,10000.00,3316.81,7683.19,0.24,0
65405,6497,-1000.00,8000.00,9000.00,4534.15,5465.85,0.17,0
65406,6497,-1000.00,7000.00,8000.00,6652.01,2347.99,0.07,0
65407,6497,-1000.00,6000.00,7000.00,2637.49,1748.24,0.16,0
65408,6497,-1000.00,5000.00,6000.00,0.00,1546.43,0.18,0
65409,6497,-1000.00,4000.00,5000.00,0.00,5156.52,0.20,0
65410,6497,-1000.00,3000.00,4000.00,0.00,5000.00,0.16,0
65411,6497,-1000.00,2000.00,3000.00,599.36,3400.64,0.42,0
65412,6497,-1000.00,1000.00,2000.00,1021.37,1978.63,0.32,0
65413,6497,-1000.00,0.00,1000.00,263.67,847.85,0.27,0
65414,6497,-1000.00,-1000.00,0.00,633.85,366.15,0.12,0
65415,6498,0.00,0.00,1000.00,0.00,0.00,0.37,0
65416,6498,0.00,0.00,1000.00,0.00,0.00,0.17,0
65417,6498,1000.00,1000.00,2000.00,691.96,0.00,0.16,1
65418,6498,0.00,1000.00,2000.00,0.00,0.00,0.35,0
65419,6498,1000.00,2000.00,3000.00,408.35,0.00,0.26,1
65420,6498,-1000.00,1000.00,2000.00,0.00,3000.00,0.23,0
65421,6498,-764.88,235.12,1235.12,0.00,764.88,0.19,0
65422,6498,1000.00,1235.12,2235.12,620.92,614.19,0.15,1
65423,6498,1000.00,2235.12,3235.12,766.25,0.00,0.04,1
65424,6498,-1000.00,1235.12,2235.12,342.51,2892.60,0.01,0
65425,6498,-1000.00,235.12,1235.12,865.10,1370.02,0.25,0
65426,6498,-1000.00,-764.88,235.12,0.00,1235.12,0.26,0
65427,6498,1000.00,235.12,1235.12,108.50,91.70,0.27,1
65428,6498,1000.00,1235.12,2235.12,299.81,0.00,0.35,1
65429,6498,-1000.00,235.12,1235.12,189.51,1493.24,0.24,0
65430,6498,1000.00,1235.12,2235.12,479.91,0.00,0.06,1
65431,6498,-1000.00,235.12,1235.12,0.00,2235.12,0.11,0
65432,6498,-1000.00,-764.88,235.12,614.23,620.89,0.02,0
65433,6498,1000.00,235.12,1235.12,102.77,64.03,0.17,1
65434,6498,-1000.00,-764.88,235.12,577.32,657.80,0.15,0
65435,6498,-43.05,-807.93,192.07,6.69,36.36,0.16,0
65436,6498,1000.00,192.07,1192.07,82.31,55.11,0.31,1
65437,6498,-647.98,-455.92,544.08,0.00,647.98,0.18,0
65438,6498,1000.00,544.08,1544.08,400.69,143.39,0.02,1
65439,6498,0.00,544.08,1544.08,0.00,0.00,0.18,0
65440,6498,-1000.00,-455.92,544.08,1544.08,0.00,0.08,0
65441,6498,-151.83,-607.75,392.25,151.83,0.00,0.20,0
65442,6498,-1000.00,-1607.75,-607.75,0.00,374.60,0.12,0
65443,6499,-1000.00,-1000.00,0.00,500.00,500.00,0.05,0
65444,6500,-1000.00,-1000.00,0.00,410.30,589.70,0.28,0
65445,6501,1000.00,1000.00,2000.00,148.51,122.49,0.42,1
65446,6501,0.00,1000.00,2000.00,0.00,0.00,0.03,0
65447,6501,1000.00,2000.00,3000.00,1911.35,88.65,0.08,1
65448,6501,-1000.00,1000.00,2000.00,0.00,3000.00,0.34,0
65449,6501,1000.00,2000.00,3000.00,1135.70,864.30,0.06,1
65450,6501,1000.00,3000.00,4000.00,1428.51,0.00,0.02,1
65451,6501,-1000.00,2000.00,3000.00,0.00,2307.54,0.23,0
65452,6501,-1000.00,1000.00,2000.00,0.00,3000.00,0.04,0
65453,6501,1000.00,2000.00,3000.00,1219.74,300.03,0.10,1
65454,6501,-1000.00,1000.00,2000.00,1226.85,1773.15,0.22,0
65455,6501,-1000.00,0.00,1000.00,577.37,1422.63,0.23,0
65456,6501,-361.77,-361.77,638.23,0.00,361.77,0.25,0
65457,6501,-638.23,-1000.00,0.00,0.00,638.23,0.29,0
65458,6502,0.00,0.00,1000.00,0.00,0.00,0.14,0
65459,6502,-244.42,-244.42,755.58,244.42,0.00,0.12,0
65460,6502,-1000.00,-1244.42,-244.42,0.00,653.19,0.34,0
65461,6503,-292.37,-292.37,707.63,292.37,0.00,0.39,0
65462,6503,-1000.00,-1292.37,-292.37,48.62,650.32,0.14,0
65463,6504,-1000.00,-1000.00,0.00,291.86,708.14,0.15,0
65464,6505,0.00,0.00,1000.00,0.00,0.00,0.10,0
65465,6505,-1000.00,-1000.00,0.00,0.00,237.41,0.42,0
65466,6506,1000.00,1000.00,2000.00,452.42,136.10,0.32,1
65467,6506,-352.69,647.31,1647.31,0.00,352.69,0.41,0
65468,6506,1000.00,1647.31,2647.31,354.28,55.06,0.41,1
65469,6506,1000.00,2647.31,3647.31,1150.54,0.00,0.23,1
65470,6506,1000.00,3647.31,4647.31,1408.63,0.00,0.03,1
65471,6506,0.00,3647.31,4647.31,0.00,0.00,0.26,0
65472,6506,1000.00,4647.31,5647.31,1650.23,0.00,0.19,1
65473,6506,-1000.00,3647.31,4647.31,0.00,2499.35,0.22,0
65474,6506,-1000.00,2647.31,3647.31,0.00,4647.31,0.25,0
65475,6506,-1000.00,1647.31,2647.31,1044.66,2602.65,0.34,0
65476,6506,1000.00,2647.31,3647.31,1402.11,1245.21,0.19,1
65477,6506,-1000.00,1647.31,2647.31,0.00,3647.31,0.27,0
65478,6506,-1000.00,647.31,1647.31,1323.66,1323.66,0.02,0
65479,6506,-1000.00,-352.69,647.31,0.00,1549.67,0.17,0
65480,6506,-647.31,-1000.00,0.00,206.93,440.38,0.34,0
65481,6507,-821.04,-821.04,178.96,0.00,821.04,0.20,0
65482,6507,-178.96,-1000.00,0.00,0.00,178.96,0.07,0
65483,6508,1000.00,1000.00,2000.00,229.34,469.43,0.28,1
65484,6508,1000.00,2000.00,3000.00,178.63,1630.53,0.42,1
65485,6508,1000.00,3000.00,4000.00,0.00,126.88,0.12,1
65486,6508,1000.00,4000.00,5000.00,1692.14,2122.50,0.25,1
65487,6508,1000.00,5000.00,6000.00,567.18,2669.28,0.32,1
65488,6508,1000.00,6000.00,7000.00,0.00,5128.31,0.24,1
65489,6508,1000.00,7000.00,8000.00,0.00,3543.96,0.20,1
65490,6508,1000.00,8000.00,9000.00,1866.52,6133.48,0.35,1
65491,6508,1000.00,9000.00,10000.00,0.00,9000.00,0.13,1
65492,6508,1000.00,10000.00,11000.00,4625.95,5374.05,0.15,1
65493,6508,1000.00,11000.00,12000.00,3930.94,7069.06,0.29,1
65494,6508,1000.00,12000.00,13000.00,0.00,8285.06,0.11,1
65495,6508,1000.00,13000.00,14000.00,0.00,13000.00,0.26,1
65496,6508,-1000.00,12000.00,13000.00,4481.07,0.00,0.07,0
65497,6508,0.00,12000.00,13000.00,0.00,0.00,0.05,0
65498,6508,1000.00,13000.00,14000.00,6500.00,6500.00,0.00,1
65499,6508,1000.00,14000.00,15000.00,6425.99,7574.01,0.16,1
65500,6508,1000.00,15000.00,16000.00,6911.57,8088.43,0.01,1
65501,6508,0.00,15000.00,16000.00,0.00,0.00,0.02,0
65502,6508,1000.00,16000.00,17000.00,0.00,2039.16,0.02,1
65503,6508,1000.00,17000.00,18000.00,5294.44,11705.56,0.24,1
65504,6508,1000.00,18000.00,19000.00,0.00,17585.73,0.40,1
65505,6508,1000.00,19000.00,20000.00,0.00,19000.00,0.02,1
65506,6508,-1000.00,18000.00,19000.00,12960.96,3158.84,0.09,0
65507,6508,1000.00,19000.00,20000.00,0.00,19000.00,0.19,1
65508,6508,1000.00,20000.00,21000.00,1472.58,18527.42,0.30,1
65509,6508,1000.00,21000.00,22000.00,7019.47,13980.53,0.10,1
65510,6508,1000.00,22000.00,23000.00,6750.03,14442.55,0.33,1
65511,6508,1000.00,23000.00,24000.00,0.00,23000.00,0.09,1
65512,6508,1000.00,24000.00,25000.00,5682.51,18317.49,0.36,1
65513,6508,-1000.00,23000.00,24000.00,12213.63,0.00,0.02,0
65514,6508,1000.00,24000.00,25000.00,5347.66,18652.34,0.35,1
65515,6508,1000.00,25000.00,26000.00,5955.65,13911.43,0.31,1
65516,6508,1000.00,26000.00,27000.00,9681.79,16318.21,0.14,1
65517,6508,1000.00,27000.00,28000.00,0.00,27000.00,0.37,1
65518,6508,1000.00,28000.00,29000.00,0.00,28000.00,0.11,1
65519,6508,1000.00,29000.00,30000.00,0.00,29000.00,0.30,1
65520,6508,1000.00,30000.00,31000.00,0.00,23462.98,0.41,1
65521,6508,1000.00,31000.00,32000.00,11309.71,19690.29,0.28,1
65522,6508,1000.00,32000.00,33000.00,0.00,32000.00,0.03,1
65523,6508,1000.00,33000.00,34000.00,0.00,33000.00,0.05,1
65524,6508,1000.00,34000.00,35000.00,8043.37,25956.63,0.35,1
65525,6508,1000.00,35000.00,36000.00,0.00,2505.75,0.09,1
65526,6508,1000.00,36000.00,37000.00,0.00,36000.00,0.09,1
65527,6508,1000.00,37000.00,38000.00,0.00,1583.75,0.09,1
65528,6508,1000.00,38000.00,39000.00,0.00,21365.85,0.24,1
65529,6508,1000.00,39000.00,40000.00,0.00,20004.36,0.07,1
65530,6508,-1000.00,38000.00,39000.00,0.00,40000.00,0.11,0
65531,6508,-1000.00,37000.00,38000.00,8291.32,30708.68,0.11,0
65532,6508,-1000.00,36000.00,37000.00,0.00,38000.00,0.04,0
65533,6508,-1000.00,35000.00,36000.00,0.00,11688.42,0.19,0
65534,6508,-1000.00,34000.00,35000.00,0.00,36000.00,0.43,0
65535,6508,-1000.00,33000.00,34000.00,9516.74,25483.26,0.11,0
65536,6508,-1000.00,32000.00,33000.00,0.00,34000.00,0.09,0
65537,6508,-1000.00,31000.00,32000.00,2785.03,7969.44,0.20,0
65538,6508,-1000.00,30000.00,31000.00,0.00,12311.97,0.22,0
65539,6508,-1000.00,29000.00,30000.00,1725.58,25236.88,0.42,0
65540,6508,-1000.00,28000.00,29000.00,11144.39,18855.61,0.28,0
65541,6508,-1000.00,27000.00,28000.00,0.00,11205.21,0.05,0
65542,6508,-1000.00,26000.00,27000.00,14000.00,14000.00,0.08,0
65543,6508,-1000.00,25000.00,26000.00,3229.93,13194.59,0.30,0
65544,6508,-1000.00,24000.00,25000.00,0.00,26000.00,0.21,0
65545,6508,-1000.00,23000.00,24000.00,14049.40,10950.60,0.17,0
65546,6508,-1000.00,22000.00,23000.00,7141.04,16858.96,0.36,0
65547,6508,-1000.00,21000.00,22000.00,0.00,23000.00,0.38,0
65548,6508,-1000.00,20000.00,21000.00,0.00,16561.77,0.40,0
65549,6508,-1000.00,19000.00,20000.00,10892.72,10107.28,0.20,0
65550,6508,-1000.00,18000.00,19000.00,0.00,7785.80,0.15,0
65551,6508,-1000.00,17000.00,18000.00,3238.44,15761.56,0.42,0
65552,6508,-1000.00,16000.00,17000.00,0.00,11957.75,0.28,0
65553,6509,-1000.00,-1000.00,0.00,470.66,529.34,0.22,0
65554,6510,-1000.00,-1000.00,0.00,0.00,1000.00,0.04,0
65555,6511,-1000.00,-1000.00,0.00,0.00,904.69,0.10,0
65556,6512,1000.00,1000.00,2000.00,202.25,797.75,0.22,1
65557,6512,1000.00,2000.00,3000.00,0.00,2000.00,0.26,1
65558,6512,1000.00,3000.00,4000.00,0.00,3000.00,0.32,1
65559,6512,1000.00,4000.00,5000.00,1262.92,2737.08,0.34,1
65560,6512,-1000.00,3000.00,4000.00,2223.38,1889.99,0.20,0
65561,6512,1000.00,4000.00,5000.00,0.00,4000.00,0.03,1
65562,6512,1000.00,5000.00,6000.00,0.00,3429.68,0.30,1
65563,6512,1000.00,6000.00,7000.00,2329.00,3671.00,0.02,1
65564,6512,1000.00,7000.00,8000.00,1576.28,5423.72,0.15,1
65565,6512,1000.00,8000.00,9000.00,1692.09,6307.91,0.37,1
65566,6512,1000.00,9000.00,10000.00,3153.47,5846.53,0.28,1
65567,6512,1000.00,10000.00,11000.00,1387.29,8612.71,0.37,1
65568,6512,1000.00,11000.00,12000.00,5500.00,5500.00,0.10,1
65569,6512,1000.00,12000.00,13000.00,0.00,12000.00,0.19,1
65570,6512,1000.00,13000.00,14000.00,0.00,11625.11,0.33,1
65571,6512,-1000.00,12000.00,13000.00,9668.44,4331.56,0.05,0
65572,6512,1000.00,13000.00,14000.00,1583.37,11416.63,0.34,1
65573,6512,1000.00,14000.00,15000.00,0.00,8707.98,0.32,1
65574,6512,1000.00,15000.00,16000.00,7500.00,7500.00,0.02,1
65575,6512,-1000.00,14000.00,15000.00,0.00,4468.82,0.20,0
65576,6512,-1000.00,13000.00,14000.00,6708.10,8291.90,0.14,0
65577,6512,-1000.00,12000.00,13000.00,4892.71,9107.29,0.27,0
65578,6512,-1000.00,11000.00,12000.00,0.00,13000.00,0.24,0
65579,6512,-1000.00,10000.00,11000.00,4486.37,7513.63,0.28,0
65580,6512,0.00,10000.00,11000.00,0.00,0.00,0.01,0
65581,6512,-1000.00,9000.00,10000.00,0.00,7126.66,0.07,0
65582,6512,-1000.00,8000.00,9000.00,1227.02,8772.98,0.31,0
65583,6512,-1000.00,7000.00,8000.00,0.00,6858.48,0.34,0
65584,6512,-1000.00,6000.00,7000.00,0.00,8000.00,0.41,0
65585,6512,-1000.00,5000.00,6000.00,1412.48,3944.63,0.32,0
65586,6512,-1000.00,4000.00,5000.00,0.00,2368.24,0.22,0
65587,6512,-1000.00,3000.00,4000.00,1082.81,3917.19,0.40,0
65588,6512,0.00,3000.00,4000.00,0.00,0.00,0.08,0
65589,6512,-1000.00,2000.00,3000.00,0.00,2242.21,0.34,0
65590,6512,-1000.00,1000.00,2000.00,3.78,2996.22,0.17,0
65591,6512,-1000.00,0.00,1000.00,731.97,1268.03,0.22,0
65592,6512,-1000.00,-1000.00,0.00,0.00,1000.00,0.12,0
65593,6513,-1000.00,-1000.00,0.00,79.21,920.79,0.42,0
65594,6514,-1000.00,-1000.00,0.00,113.37,886.63,0.28,0
65595,6515,1000.00,1000.00,2000.00,914.53,39.52,0.14,1
65596,6515,-1000.00,0.00,1000.00,667.31,1332.69,0.07,0
65597,6515,1000.00,1000.00,2000.00,882.46,111.28,0.15,1
65598,6515,-1000.00,0.00,1000.00,246.33,1386.27,0.38,0
65599,6515,-540.20,-540.20,459.80,0.00,540.20,0.27,0
65600,6515,-459.80,-1000.00,0.00,0.00,459.80,0.37,0
65601,6516,-1000.00,-1000.00,0.00,516.98,483.02,0.12,0
65602,6517,-380.49,-380.49,619.51,0.00,380.49,0.25,0
65603,6517,-1000.00,-1380.49,-380.49,619.51,0.00,0.00,0
65604,6518,-254.82,-254.82,745.18,0.00,254.82,0.39,0
65605,6518,1000.00,745.18,1745.18,425.55,0.00,0.28,1
65606,6518,-1000.00,-254.82,745.18,0.00,1725.43,0.06,0
65607,6518,-745.18,-1000.00,0.00,0.00,745.18,0.22,0
65608,6519,-1000.00,-1000.00,0.00,500.00,500.00,0.02,0
65609,6520,1000.00,1000.00,2000.00,181.54,818.46,0.41,1
65610,6520,1000.00,2000.00,3000.00,0.00,2000.00,0.31,1
65611,6520,1000.00,3000.00,4000.00,0.00,3000.00,0.38,1
65612,6520,1000.00,4000.00,5000.00,0.00,4000.00,0.13,1
65613,6520,1000.00,5000.00,6000.00,1366.33,3633.67,0.35,1
65614,6520,1000.00,6000.00,7000.00,0.00,5362.54,0.15,1
65615,6520,0.00,6000.00,7000.00,0.00,0.00,0.06,0
65616,6520,1000.00,7000.00,8000.00,0.00,7000.00,0.11,1
65617,6520,1000.00,8000.00,9000.00,0.00,8000.00,0.04,1
65618,6520,1000.00,9000.00,10000.00,3408.57,5591.43,0.30,1
65619,6520,-1000.00,8000.00,9000.00,6090.30,1428.25,0.10,0
65620,6520,-1000.00,7000.00,8000.00,3829.53,2776.46,0.18,0
65621,6520,1000.00,8000.00,9000.00,3144.55,4855.45,0.12,1
65622,6520,1000.00,9000.00,10000.00,0.00,6610.24,0.27,1
65623,6520,1000.00,10000.00,11000.00,1550.23,8449.77,0.39,1
65624,6520,-1000.00,9000.00,10000.00,7137.53,2241.10,0.10,0
65625,6520,-1000.00,8000.00,9000.00,5988.21,4011.79,0.03,0
65626,6520,1000.00,9000.00,10000.00,0.00,9000.00,0.43,1
65627,6520,1000.00,10000.00,11000.00,0.00,10000.00,0.14,1
65628,6520,1000.00,11000.00,12000.00,0.00,11000.00,0.26,1
65629,6520,1000.00,12000.00,13000.00,0.00,4909.12,0.27,1
65630,6520,1000.00,13000.00,14000.00,0.00,9757.44,0.33,1
65631,6520,1000.00,14000.00,15000.00,2049.74,11950.26,0.42,1
65632,6520,1000.00,15000.00,16000.00,0.00,7710.02,0.30,1
65633,6520,-1000.00,14000.00,15000.00,0.00,7822.06,0.29,0
65634,6520,-1000.00,13000.00,14000.00,0.00,15000.00,0.35,0
65635,6520,-1000.00,12000.00,13000.00,3970.20,10029.80,0.37,0
65636,6520,-1000.00,11000.00,12000.00,0.00,13000.00,0.13,0
65637,6520,-1000.00,10000.00,11000.00,802.40,8350.09,0.39,0
65638,6520,-1000.00,9000.00,10000.00,0.00,11000.00,0.33,0
65639,6520,-1000.00,8000.00,9000.00,0.00,10000.00,0.33,0
65640,6520,-506.14,7493.86,8493.86,0.00,506.14,0.02,0
65641,6520,-1000.00,6493.86,7493.86,0.00,8493.86,0.15,0
65642,6520,-1000.00,5493.86,6493.86,0.00,7493.86,0.17,0
65643,6520,-1000.00,4493.86,5493.86,721.28,3484.56,0.32,0
65644,6520,-1000.00,3493.86,4493.86,622.48,3840.49,0.38,0
65645,6520,-1000.00,2493.86,3493.86,955.95,1369.88,0.21,0
65646,6520,-1000.00,1493.86,2493.86,1225.04,509.84,0.14,0
65647,6520,-1000.00,493.86,1493.86,0.00,1877.34,0.35,0
65648,6520,-1000.00,-506.14,493.86,352.75,1141.12,0.25,0
65649,6520,-493.86,-1000.00,0.00,226.97,266.89,0.07,0
65650,6521,-723.58,-723.58,276.42,12.33,711.26,0.39,0
65651,6521,-276.42,-1000.00,0.00,96.09,180.33,0.17,0
65652,6522,0.00,0.00,1000.00,0.00,0.00,0.17,0
65653,6522,1000.00,1000.00,2000.00,800.37,0.00,0.06,1
65654,6522,-1000.00,0.00,1000.00,1000.00,1000.00,0.04,0
65655,6522,-786.71,-786.71,213.29,0.00,786.71,0.41,0
65656,6522,-213.29,-1000.00,0.00,69.90,143.38,0.12,0
65657,6522,0.00,-1000.00,0.00,0.00,0.00,0.06,1
65658,6522,-0.00,-1000.00,0.00,0.00,0.00,0.07,0
65659,6523,-1000.00,-1000.00,0.00,0.00,527.63,0.25,0
65660,6524,-585.36,-585.36,414.64,0.00,585.36,0.17,0
65661,6524,-265.08,-850.43,149.57,0.00,265.08,0.36,0
65662,6524,-134.25,-984.69,15.31,0.00,134.25,0.28,0
65663,6524,-6.38,-991.07,8.93,0.85,5.53,0.25,0
65664,6524,-8.23,-999.30,0.70,0.00,8.23,0.35,0
65665,6524,-0.70,-1000.00,0.00,0.26,0.44,0.31,0
65666,6525,-1000.00,-1000.00,0.00,375.59,98.14,0.26,0
65667,6526,-452.62,-452.62,547.38,0.00,452.62,0.19,0
65668,6526,-1000.00,-1452.62,-452.62,339.61,207.77,0.12,0
65669,6527,-736.62,-736.62,263.38,715.17,21.45,0.06,0
65670,6527,-1000.00,-1736.62,-736.62,0.00,263.38,0.42,0
65671,6528,-66.93,-66.93,933.07,0.00,66.93,0.11,0
65672,6528,-556.90,-623.82,376.18,0.00,556.90,0.02,0
65673,6528,-376.18,-1000.00,0.00,62.12,314.06,0.26,0
65674,6528,-0.00,-1000.00,0.00,0.00,0.00,0.44,0
65675,6528,-0.00,-1000.00,0.00,0.00,0.00,0.28,0
65676,6529,-1000.00,-1000.00,0.00,0.00,1000.00,0.22,0
65677,6530,-1000.00,-1000.00,0.00,0.00,1000.00,0.20,0
65678,6531,-581.98,-581.98,418.02,0.00,581.98,0.22,0
65679,6531,1000.00,418.02,1418.02,258.16,0.00,0.20,1
65680,6531,-1000.00,-581.98,418.02,0.00,1418.02,0.28,0
65681,6531,-381.57,-963.55,36.45,0.00,381.57,0.41,0
65682,6531,-36.45,-1000.00,0.00,7.45,28.99,0.40,0
65683,6532,-1000.00,-1000.00,0.00,259.85,740.15,0.25,0
65684,6533,-1000.00,-1000.00,0.00,0.00,1000.00,0.40,0
65685,6534,0.00,0.00,1000.00,0.00,0.00,0.37,0
65686,6534,-349.60,-349.60,650.40,0.00,349.60,0.37,0
65687,6534,0.00,-349.60,650.40,0.00,0.00,0.15,0
65688,6534,-650.40,-1000.00,0.00,0.00,650.40,0.21,0
65689,6535,1000.00,1000.00,2000.00,104.91,895.09,0.43,1
65690,6535,1000.00,2000.00,3000.00,1000.00,1000.00,0.06,1
65691,6535,1000.00,3000.00,4000.00,0.00,3000.00,0.35,1
65692,6535,1000.00,4000.00,5000.00,1684.31,2315.69,0.27,1
65693,6535,1000.00,5000.00,6000.00,0.00,5000.00,0.20,1
65694,6535,1000.00,6000.00,7000.00,2061.48,3938.52,0.26,1
65695,6535,1000.00,7000.00,8000.00,605.53,6394.47,0.11,1
65696,6535,1000.00,8000.00,9000.00,0.00,3451.80,0.27,1
65697,6535,1000.00,9000.00,10000.00,3930.16,5069.84,0.26,1
65698,6535,-1000.00,8000.00,9000.00,3946.25,566.20,0.10,0
65699,6535,1000.00,9000.00,10000.00,3918.69,5081.31,0.16,1
65700,6535,1000.00,10000.00,11000.00,2416.05,7583.95,0.39,1
65701,6535,1000.00,11000.00,12000.00,1276.73,9723.27,0.43,1
65702,6535,1000.00,12000.00,13000.00,0.00,4954.28,0.24,1
65703,6535,1000.00,13000.00,14000.00,0.00,13000.00,0.29,1
65704,6535,1000.00,14000.00,15000.00,6827.74,7172.26,0.21,1
65705,6535,1000.00,15000.00,16000.00,2992.12,12007.88,0.17,1
65706,6535,-1000.00,14000.00,15000.00,6160.79,9839.21,0.26,0
65707,6535,-1000.00,13000.00,14000.00,0.00,15000.00,0.41,0
65708,6535,-1000.00,12000.00,13000.00,2180.86,11819.14,0.42,0
65709,6535,-1000.00,11000.00,12000.00,0.00,12244.23,0.44,0
65710,6535,-1000.00,10000.00,11000.00,0.00,12000.00,0.23,0
65711,6535,-1000.00,9000.00,10000.00,0.00,11000.00,0.35,0
65712,6535,-1000.00,8000.00,9000.00,0.00,2622.07,0.21,0
65713,6535,-1000.00,7000.00,8000.00,0.00,9000.00,0.08,0
65714,6535,-436.65,6563.35,7563.35,0.00,436.65,0.13,0
65715,6535,-1000.00,5563.35,6563.35,4394.57,1936.86,0.13,0
65716,6535,-1000.00,4563.35,5563.35,0.00,6424.75,0.43,0
65717,6535,-1000.00,3563.35,4563.35,3770.44,0.00,0.05,0
65718,6535,-1000.00,2563.35,3563.35,1427.23,3136.12,0.26,0
65719,6535,-1000.00,1563.35,2563.35,0.00,3401.39,0.31,0
65720,6535,-1000.00,563.35,1563.35,1127.68,1435.67,0.18,0
65721,6535,-1000.00,-436.65,563.35,641.04,922.31,0.26,0
65722,6535,-563.35,-1000.00,0.00,0.00,563.35,0.08,0
65723,6536,-1000.00,-1000.00,0.00,0.00,1000.00,0.30,0
65724,6537,-128.82,-128.82,871.18,0.00,128.82,0.15,0
65725,6537,-871.18,-1000.00,0.00,148.62,722.56,0.42,0
65726,6538,-1000.00,-1000.00,0.00,244.87,755.13,0.32,0
65727,6539,-1000.00,-1000.00,0.00,0.00,1000.00,0.21,0
65728,6540,-1000.00,-1000.00,0.00,0.00,209.68,0.18,0
65729,6541,-170.54,-170.54,829.46,0.00,170.54,0.16,0
65730,6541,-829.46,-1000.00,0.00,0.00,829.46,0.29,0
65731,6542,1000.00,1000.00,2000.00,0.00,1000.00,0.12,1
65732,6542,1000.00,2000.00,3000.00,0.00,2000.00,0.10,1
65733,6542,1000.00,3000.00,4000.00,621.07,2378.93,0.09,1
65734,6542,-1000.00,2000.00,3000.00,2071.56,1928.44,0.15,0
65735,6542,1000.00,3000.00,4000.00,770.49,2229.51,0.28,1
65736,6542,1000.00,4000.00,5000.00,411.33,1747.10,0.28,1
65737,6542,1000.00,5000.00,6000.00,0.00,5000.00,0.42,1
65738,6542,1000.00,6000.00,7000.00,3000.00,3000.00,0.05,1
65739,6542,1000.00,7000.00,8000.00,754.84,6245.16,0.43,1
65740,6542,1000.00,8000.00,9000.00,0.00,8000.00,0.01,1
65741,6542,1000.00,9000.00,10000.00,0.00,1012.20,0.06,1
65742,6542,1000.00,10000.00,11000.00,964.52,9035.48,0.16,1
65743,6542,1000.00,11000.00,12000.00,0.00,11000.00,0.26,1
65744,6542,1000.00,12000.00,13000.00,1746.63,7602.14,0.36,1
65745,6542,1000.00,13000.00,14000.00,1344.76,10925.28,0.42,1
65746,6542,1000.00,14000.00,15000.00,3962.24,10037.76,0.36,1
65747,6542,1000.00,15000.00,16000.00,0.00,14581.86,0.13,1
65748,6542,1000.00,16000.00,17000.00,0.00,16000.00,0.34,1
65749,6542,-1000.00,15000.00,16000.00,3847.91,13152.09,0.38,0
65750,6542,-1000.00,14000.00,15000.00,5285.79,10714.21,0.34,0
65751,6542,-1000.00,13000.00,14000.00,0.00,2558.58,0.05,0
65752,6542,-1000.00,12000.00,13000.00,305.31,13694.69,0.25,0
65753,6542,-1000.00,11000.00,12000.00,4675.91,8324.09,0.28,0
65754,6542,1000.00,12000.00,13000.00,0.00,2746.43,0.19,1
65755,6542,1000.00,13000.00,14000.00,1744.10,9789.56,0.40,1
65756,6542,1000.00,14000.00,15000.00,2017.50,11982.50,0.42,1
65757,6542,1000.00,15000.00,16000.00,7500.00,7500.00,0.07,1
65758,6542,1000.00,16000.00,17000.00,0.00,254.39,0.09,1
65759,6542,-1000.00,15000.00,16000.00,3302.70,1246.93,0.13,0
65760,6542,0.00,15000.00,16000.00,0.00,0.00,0.06,0
65761,6542,1000.00,16000.00,17000.00,0.00,16000.00,0.11,1
65762,6542,1000.00,17000.00,18000.00,0.00,17000.00,0.01,1
65763,6542,1000.00,18000.00,19000.00,0.00,18000.00,0.16,1
65764,6542,1000.00,19000.00,20000.00,0.00,11408.13,0.13,1
65765,6542,1000.00,20000.00,21000.00,1352.55,10762.81,0.33,1
65766,6542,-1000.00,19000.00,20000.00,10845.11,10154.89,0.18,0
65767,6542,1000.00,20000.00,21000.00,0.00,15578.17,0.01,1
65768,6542,-1000.00,19000.00,20000.00,11059.30,9940.70,0.17,0
65769,6542,1000.00,20000.00,21000.00,4463.21,15536.79,0.39,1
65770,6542,1000.00,21000.00,22000.00,7541.87,13458.13,0.15,1
65771,6542,1000.00,22000.00,23000.00,0.00,15744.40,0.33,1
65772,6542,1000.00,23000.00,24000.00,0.00,21762.78,0.29,1
65773,6542,-1000.00,22000.00,23000.00,12477.25,11522.75,0.06,0
65774,6542,1000.00,23000.00,24000.00,646.48,9732.50,0.28,1
65775,6542,1000.00,24000.00,25000.00,5886.68,18113.32,0.29,1
65776,6542,1000.00,25000.00,26000.00,3487.31,21512.69,0.27,1
65777,6542,1000.00,26000.00,27000.00,11362.06,14637.94,0.22,1
65778,6543,-1000.00,-1000.00,0.00,134.22,865.78,0.42,0
65779,6544,-1000.00,-1000.00,0.00,0.00,1000.00,0.26,0
65780,6545,-201.24,-201.24,798.76,201.24,0.00,0.34,0
65781,6545,-555.64,-756.88,243.12,452.96,102.68,0.28,0
65782,6545,-1000.00,-1756.88,-756.88,78.43,89.21,0.22,0
65783,6546,-834.95,-834.95,165.05,469.50,365.45,0.19,0
65784,6546,-165.05,-1000.00,0.00,111.78,53.27,0.03,0
65785,6547,1000.00,1000.00,2000.00,0.00,959.85,0.42,1
65786,6547,1000.00,2000.00,3000.00,0.00,1934.50,0.38,1
65787,6547,-1000.00,1000.00,2000.00,1609.92,1390.08,0.14,0
65788,6547,1000.00,2000.00,3000.00,117.11,1882.89,0.39,1
65789,6547,1000.00,3000.00,4000.00,0.00,3000.00,0.08,1
65790,6547,1000.00,4000.00,5000.00,1589.53,2410.47,0.16,1
65791,6547,1000.00,5000.00,6000.00,0.00,5000.00,0.32,1
65792,6547,1000.00,6000.00,7000.00,0.00,4104.00,0.25,1
65793,6547,1000.00,7000.00,8000.00,3500.00,3500.00,0.02,1
65794,6547,1000.00,8000.00,9000.00,0.00,8000.00,0.01,1
65795,6547,1000.00,9000.00,10000.00,0.00,2901.28,0.16,1
65796,6547,1000.00,10000.00,11000.00,5000.00,5000.00,0.08,1
65797,6547,1000.00,11000.00,12000.00,5407.38,5592.62,0.16,1
65798,6547,1000.00,12000.00,13000.00,2185.92,9814.08,0.38,1
65799,6547,1000.00,13000.00,14000.00,0.00,6922.87,0.33,1
65800,6547,1000.00,14000.00,15000.00,0.00,14000.00,0.35,1
65801,6547,1000.00,15000.00,16000.00,4938.32,10061.68,0.30,1
65802,6547,1000.00,16000.00,17000.00,0.00,2612.16,0.16,1
65803,6547,1000.00,17000.00,18000.00,0.00,12539.62,0.18,1
65804,6547,1000.00,18000.00,19000.00,5072.94,12927.06,0.28,1
65805,6547,-1000.00,17000.00,18000.00,4764.21,0.00,0.09,0
65806,6547,-1000.00,16000.00,17000.00,0.00,18000.00,0.15,0
65807,6547,-1000.00,15000.00,16000.00,7969.63,9030.37,0.04,0
65808,6547,-1000.00,14000.00,15000.00,0.00,11274.94,0.16,0
65809,6547,-1000.00,13000.00,14000.00,0.00,14762.17,0.39,0
65810,6547,-1000.00,12000.00,13000.00,3118.27,10881.73,0.05,0
65811,6547,-1000.00,11000.00,12000.00,0.00,13000.00,0.42,0
65812,6547,-1000.00,10000.00,11000.00,0.00,9379.85,0.04,0
65813,6547,-1000.00,9000.00,10000.00,5500.00,5500.00,0.08,0
65814,6547,-1000.00,8000.00,9000.00,0.00,10000.00,0.07,0
65815,6547,-1000.00,7000.00,8000.00,5785.13,3214.87,0.09,0
65816,6547,-1000.00,6000.00,7000.00,1900.23,6099.77,0.18,0
65817,6547,0.00,6000.00,7000.00,0.00,0.00,0.04,0
65818,6547,-1000.00,5000.00,6000.00,0.00,7000.00,0.33,0
65819,6547,-1000.00,4000.00,5000.00,0.00,6000.00,0.23,0
65820,6547,-1000.00,3000.00,4000.00,0.00,5000.00,0.22,0
65821,6547,-1000.00,2000.00,3000.00,2799.93,1200.07,0.05,0
65822,6547,-1000.00,1000.00,2000.00,0.00,1944.87,0.32,0
65823,6547,-1000.00,0.00,1000.00,670.19,1329.81,0.22,0
65824,6547,-1000.00,-1000.00,0.00,0.00,1000.00,0.01,0
65825,6548,-474.06,-474.06,525.94,97.21,376.86,0.25,0
65826,6548,-525.94,-1000.00,0.00,0.00,525.94,0.39,0
65827,6549,0.00,0.00,1000.00,0.00,0.00,0.19,0
65828,6549,-1000.00,-1000.00,0.00,1000.00,0.00,0.02,0
65829,6550,1000.00,1000.00,2000.00,40.45,959.55,0.40,1
65830,6550,-432.11,567.89,1567.89,432.11,0.00,0.02,0
65831,6550,-1000.00,-432.11,567.89,1432.48,135.41,0.02,0
65832,6550,1000.00,567.89,1567.89,153.05,414.84,0.03,1
65833,6550,1000.00,1567.89,2567.89,543.12,1024.76,0.05,1
65834,6550,1000.00,2567.89,3567.89,433.35,1328.91,0.31,1
65835,6550,1000.00,3567.89,4567.89,899.62,2584.35,0.36,1
65836,6550,1000.00,4567.89,5567.89,0.00,4567.89,0.08,1
65837,6550,0.00,4567.89,5567.89,0.00,0.00,0.04,0
65838,6550,1000.00,5567.89,6567.89,0.00,4120.84,0.36,1
65839,6550,1000.00,6567.89,7567.89,0.00,5060.28,0.34,1
65840,6550,1000.00,7567.89,8567.89,0.00,7567.89,0.32,1
65841,6550,1000.00,8567.89,9567.89,3755.76,4812.13,0.10,1
65842,6550,-1000.00,7567.89,8567.89,6237.72,1148.38,0.08,0
65843,6550,-1000.00,6567.89,7567.89,7187.57,91.05,0.04,0
65844,6550,1000.00,7567.89,8567.89,3756.05,3811.84,0.15,1
65845,6550,1000.00,8567.89,9567.89,375.16,1056.65,0.15,1
65846,6550,1000.00,9567.89,10567.89,2435.37,7132.52,0.37,1
65847,6550,1000.00,10567.89,11567.89,3438.45,7129.44,0.24,1
65848,6550,-1000.00,9567.89,10567.89,6492.49,0.00,0.06,0
65849,6550,1000.00,10567.89,11567.89,3296.71,7271.18,0.14,1
65850,6550,1000.00,11567.89,12567.89,5238.59,6329.30,0.22,1
65851,6550,1000.00,12567.89,13567.89,0.00,12567.89,0.25,1
65852,6550,1000.00,13567.89,14567.89,0.00,13567.89,0.11,1
65853,6550,1000.00,14567.89,15567.89,0.00,14567.89,0.10,1
65854,6550,1000.00,15567.89,16567.89,7579.79,7988.10,0.18,1
65855,6550,1000.00,16567.89,17567.89,7305.60,9262.28,0.05,1
65856,6550,0.00,16567.89,17567.89,0.00,0.00,0.03,0
65857,6550,1000.00,17567.89,18567.89,0.00,17567.89,0.02,1
65858,6550,1000.00,18567.89,19567.89,0.00,18567.89,0.28,1
65859,6550,1000.00,19567.89,20567.89,6546.88,13021.01,0.30,1
65860,6550,-1000.00,18567.89,19567.89,17285.12,0.00,0.04,0
65861,6550,1000.00,19567.89,20567.89,7218.97,12348.92,0.31,1
65862,6550,1000.00,20567.89,21567.89,0.00,20567.89,0.42,1
65863,6550,-1000.00,19567.89,20567.89,6999.16,6257.58,0.19,0
65864,6550,1000.00,20567.89,21567.89,0.00,18145.03,0.42,1
65865,6550,1000.00,21567.89,22567.89,0.00,21567.89,0.11,1
65866,6550,1000.00,22567.89,23567.89,0.00,22567.89,0.28,1
65867,6550,1000.00,23567.89,24567.89,0.00,17330.29,0.15,1
65868,6550,1000.00,24567.89,25567.89,9524.44,15043.45,0.28,1
65869,6550,1000.00,25567.89,26567.89,0.00,18886.56,0.32,1
65870,6550,1000.00,26567.89,27567.89,9038.14,17529.75,0.09,1
65871,6550,1000.00,27567.89,28567.89,9420.11,18147.78,0.24,1
65872,6550,1000.00,28567.89,29567.89,7767.08,20800.81,0.37,1
65873,6550,-1000.00,27567.89,28567.89,27003.49,2564.40,0.03,0
65874,6550,0.00,27567.89,28567.89,0.00,0.00,0.07,0
65875,6550,1000.00,28567.89,29567.89,11817.96,16749.93,0.14,1
65876,6550,1000.00,29567.89,30567.89,0.00,15282.10,0.31,1
65877,6550,-1000.00,28567.89,29567.89,9456.31,21111.58,0.21,0
65878,6550,-1000.00,27567.89,28567.89,9547.74,20020.15,0.31,0
65879,6550,-1000.00,26567.89,27567.89,13617.39,14950.49,0.15,0
65880,6550,-1000.00,25567.89,26567.89,0.00,27567.89,0.15,0
65881,6550,-1000.00,24567.89,25567.89,7156.28,19411.60,0.37,0
65882,6550,-1000.00,23567.89,24567.89,0.00,19393.50,0.27,0
65883,6550,-1000.00,22567.89,23567.89,0.00,17757.19,0.28,0
65884,6550,-1000.00,21567.89,22567.89,585.33,15703.59,0.38,0
65885,6550,-1000.00,20567.89,21567.89,0.00,22567.89,0.42,0
65886,6550,-1000.00,19567.89,20567.89,0.00,18404.53,0.13,0
65887,6550,-1000.00,18567.89,19567.89,0.00,14323.41,0.36,0
65888,6550,-1000.00,17567.89,18567.89,7378.42,12189.47,0.07,0
65889,6550,-1000.00,16567.89,17567.89,0.00,18567.89,0.43,0
65890,6550,-1000.00,15567.89,16567.89,8792.61,8775.28,0.20,0
65891,6550,-1000.00,14567.89,15567.89,0.00,14139.47,0.42,0
65892,6550,-1000.00,13567.89,14567.89,6377.30,9190.59,0.23,0
65893,6550,-1000.00,12567.89,13567.89,7283.94,7283.94,0.09,0
65894,6550,-1000.00,11567.89,12567.89,0.00,13567.89,0.38,0
65895,6550,-1000.00,10567.89,11567.89,0.00,12567.89,0.29,0
65896,6550,-1000.00,9567.89,10567.89,1480.15,3500.57,0.22,0
65897,6550,-1000.00,8567.89,9567.89,0.00,10567.89,0.17,0
65898,6550,-1000.00,7567.89,8567.89,0.00,9567.89,0.39,0
65899,6550,-1000.00,6567.89,7567.89,307.54,1658.01,0.18,0
65900,6551,1000.00,1000.00,2000.00,0.00,1000.00,0.11,1
65901,6551,1000.00,2000.00,3000.00,164.35,1835.65,0.33,1
65902,6551,1000.00,3000.00,4000.00,0.00,2973.76,0.43,1
65903,6551,1000.00,4000.00,5000.00,537.22,3462.78,0.39,1
65904,6551,1000.00,5000.00,6000.00,0.00,5000.00,0.44,1
65905,6551,1000.00,6000.00,7000.00,0.00,5940.29,0.44,1
65906,6551,1000.00,7000.00,8000.00,0.00,5605.70,0.40,1
65907,6551,1000.00,8000.00,9000.00,1696.50,6303.50,0.38,1
65908,6551,1000.00,9000.00,10000.00,2563.08,6436.92,0.36,1
65909,6551,1000.00,10000.00,11000.00,1067.90,8932.10,0.09,1
65910,6551,1000.00,11000.00,12000.00,0.00,10793.51,0.34,1
65911,6551,1000.00,12000.00,13000.00,0.00,11145.72,0.39,1
65912,6551,-1000.00,11000.00,12000.00,6799.01,6200.99,0.20,0
65913,6551,1000.00,12000.00,13000.00,0.00,7898.82,0.16,1
65914,6551,1000.00,13000.00,14000.00,0.00,8092.30,0.35,1
65915,6551,-1000.00,12000.00,13000.00,0.00,14000.00,0.19,0
65916,6551,-1000.00,11000.00,12000.00,6500.00,6500.00,0.02,0
65917,6551,-1000.00,10000.00,11000.00,688.56,0.00,0.00,0
65918,6551,-1000.00,9000.00,10000.00,94.28,10905.72,0.42,0
65919,6551,-1000.00,8000.00,9000.00,2874.26,7125.74,0.36,0
65920,6551,-1000.00,7000.00,8000.00,0.00,3119.62,0.21,0
65921,6551,-1000.00,6000.00,7000.00,2545.51,5454.49,0.34,0
65922,6551,-1000.00,5000.00,6000.00,0.00,7000.00,0.25,0
65923,6551,-1000.00,4000.00,5000.00,0.00,4583.14,0.35,0
65924,6551,-1000.00,3000.00,4000.00,0.00,2710.87,0.33,0
65925,6551,-1000.00,2000.00,3000.00,1408.55,2591.45,0.06,0
65926,6551,-1000.00,1000.00,2000.00,379.31,2620.69,0.13,0
65927,6551,-1000.00,0.00,1000.00,0.00,2000.00,0.30,0
65928,6551,-1000.00,-1000.00,0.00,107.62,0.00,0.30,0
65929,6552,-1000.00,-1000.00,0.00,569.25,0.00,0.16,0
65930,6553,-463.04,-463.04,536.96,0.00,463.04,0.30,0
65931,6553,-536.96,-1000.00,0.00,156.60,380.36,0.33,0
65932,6554,-551.04,-551.04,448.96,0.00,551.04,0.26,0
65933,6554,-448.96,-1000.00,0.00,162.21,286.74,0.31,0
65934,6555,-822.38,-822.38,177.62,0.00,822.38,0.42,0
65935,6555,-1000.00,-1822.38,-822.38,10.72,0.00,0.04,0
65936,6556,1000.00,1000.00,2000.00,0.00,1000.00,0.39,1
65937,6556,0.00,1000.00,2000.00,0.00,0.00,0.07,0
65938,6556,1000.00,2000.00,3000.00,141.72,1858.28,0.11,1
65939,6556,1000.00,3000.00,4000.00,0.00,2445.59,0.30,1
65940,6556,1000.00,4000.00,5000.00,0.00,4000.00,0.05,1
65941,6556,0.00,4000.00,5000.00,0.00,0.00,0.08,0
65942,6556,-1000.00,3000.00,4000.00,2676.54,2323.46,0.02,0
65943,6556,1000.00,4000.00,5000.00,0.00,2008.11,0.31,1
65944,6556,1000.00,5000.00,6000.00,1548.87,3451.13,0.35,1
65945,6556,1000.00,6000.00,7000.00,369.05,4084.03,0.38,1
65946,6556,-1000.00,5000.00,6000.00,3758.65,3241.35,0.19,0
65947,6556,-1000.00,4000.00,5000.00,4046.96,1953.04,0.12,0
65948,6556,1000.00,5000.00,6000.00,0.00,5.30,0.07,1
65949,6556,1000.00,6000.00,7000.00,0.00,6000.00,0.15,1
65950,6556,1000.00,7000.00,8000.00,897.00,6103.00,0.42,1
65951,6556,1000.00,8000.00,9000.00,0.00,8000.00,0.14,1
65952,6556,1000.00,9000.00,10000.00,0.00,4942.20,0.32,1
65953,6556,-1000.00,8000.00,9000.00,5374.76,4625.24,0.12,0
65954,6556,1000.00,9000.00,10000.00,0.00,4802.66,0.08,1
65955,6556,1000.00,10000.00,11000.00,0.00,10000.00,0.40,1
65956,6556,1000.00,11000.00,12000.00,553.19,10446.81,0.41,1
65957,6556,-1000.00,10000.00,11000.00,6508.71,5491.29,0.11,0
65958,6556,1000.00,11000.00,12000.00,0.00,7783.59,0.37,1
65959,6556,-1000.00,10000.00,11000.00,0.00,12000.00,0.16,0
65960,6556,-1000.00,9000.00,10000.00,4110.79,6889.21,0.29,0
65961,6556,-1000.00,8000.00,9000.00,0.00,7031.43,0.08,0
65962,6556,-1000.00,7000.00,8000.00,0.00,9000.00,0.02,0
65963,6556,-1000.00,6000.00,7000.00,0.00,4713.49,0.06,0
65964,6556,-1000.00,5000.00,6000.00,3500.00,3500.00,0.01,0
65965,6556,-1000.00,4000.00,5000.00,254.64,5745.36,0.28,0
65966,6556,-1000.00,3000.00,4000.00,2327.14,2672.86,0.05,0
65967,6556,-1000.00,2000.00,3000.00,516.38,3483.62,0.04,0
65968,6556,-1000.00,1000.00,2000.00,0.00,3000.00,0.20,0
65969,6556,-1000.00,0.00,1000.00,0.00,2000.00,0.24,0
65970,6556,-1000.00,-1000.00,0.00,415.42,584.58,0.21,0
65971,6557,-1000.00,-1000.00,0.00,64.42,658.67,0.37,0
65972,6558,-53.97,-53.97,946.03,53.97,0.00,0.17,0
65973,6558,0.00,-53.97,946.03,0.00,0.00,0.35,0
65974,6558,-1000.00,-1053.97,-53.97,0.00,623.24,0.31,0
65975,6559,-225.54,-225.54,774.46,0.00,225.54,0.23,0
65976,6559,-140.55,-366.09,633.91,0.00,140.55,0.42,0
65977,6559,1000.00,633.91,1633.91,189.14,0.00,0.38,1
65978,6559,-1000.00,-366.09,633.91,0.00,1633.91,0.28,0
65979,6559,1000.00,633.91,1633.91,418.85,215.06,0.12,1
65980,6559,-1000.00,-366.09,633.91,681.14,952.77,0.20,0
65981,6559,-633.91,-1000.00,0.00,61.66,572.25,0.04,0
65982,6560,-1000.00,-1000.00,0.00,441.49,558.51,0.14,0
65983,6561,-204.74,-204.74,795.26,204.74,0.00,0.41,0
65984,6561,-1000.00,-1204.74,-204.74,74.91,270.25,0.37,0
65985,6562,1000.00,1000.00,2000.00,346.28,653.72,0.27,1
65986,6562,1000.00,2000.00,3000.00,0.00,2000.00,0.43,1
65987,6562,1000.00,3000.00,4000.00,0.00,2195.03,0.24,1
65988,6562,1000.00,4000.00,5000.00,0.00,739.03,0.02,1
65989,6562,-1000.00,3000.00,4000.00,4568.05,431.95,0.02,0
65990,6562,1000.00,4000.00,5000.00,0.00,1603.34,0.20,1
65991,6562,1000.00,5000.00,6000.00,0.00,5000.00,0.23,1
65992,6562,1000.00,6000.00,7000.00,1898.44,4101.56,0.34,1
65993,6562,1000.00,7000.00,8000.00,3374.43,3625.57,0.23,1
65994,6562,1000.00,8000.00,9000.00,0.00,8000.00,0.35,1
65995,6562,1000.00,9000.00,10000.00,0.00,6647.05,0.25,1
65996,6562,1000.00,10000.00,11000.00,2444.53,7555.47,0.12,1
65997,6562,1000.00,11000.00,12000.00,0.00,11000.00,0.20,1
65998,6562,1000.00,12000.00,13000.00,0.00,12000.00,0.18,1
65999,6562,1000.00,13000.00,14000.00,2093.75,10906.25,0.16,1
66000,6562,1000.00,14000.00,15000.00,5561.14,8438.86,0.29,1
66001,6562,1000.00,15000.00,16000.00,0.00,12025.94,0.00,1
66002,6562,1000.00,16000.00,17000.00,0.00,16000.00,0.10,1
66003,6562,1000.00,17000.00,18000.00,6487.20,10512.80,0.26,1
66004,6562,-1000.00,16000.00,17000.00,2168.20,0.00,0.03,0
66005,6562,-1000.00,15000.00,16000.00,7359.83,9640.17,0.16,0
66006,6562,-1000.00,14000.00,15000.00,5467.03,10532.97,0.33,0
66007,6562,-1000.00,13000.00,14000.00,0.00,15000.00,0.04,0
66008,6562,-1000.00,12000.00,13000.00,0.00,8926.76,0.11,0
66009,6562,-1000.00,11000.00,12000.00,7099.58,0.00,0.00,0
66010,6562,-1000.00,10000.00,11000.00,4453.42,7546.58,0.12,0
66011,6562,-1000.00,9000.00,10000.00,975.38,5345.83,0.30,0
66012,6562,-1000.00,8000.00,9000.00,0.00,10000.00,0.21,0
66013,6562,-159.66,7840.34,8840.34,0.00,159.66,0.08,0
66014,6562,-1000.00,6840.34,7840.34,0.00,1973.19,0.09,0
66015,6562,-1000.00,5840.34,6840.34,0.00,1721.33,0.18,0
66016,6562,-1000.00,4840.34,5840.34,3701.73,3138.62,0.15,0
66017,6562,-1000.00,3840.34,4840.34,0.00,4272.22,0.32,0
66018,6562,-1000.00,2840.34,3840.34,0.00,4840.34,0.16,0
66019,6562,-1000.00,1840.34,2840.34,905.33,2935.02,0.15,0
66020,6562,-1000.00,840.34,1840.34,0.00,1152.68,0.27,0
66021,6562,-1000.00,-159.66,840.34,249.26,1591.08,0.40,0
66022,6562,-840.34,-1000.00,0.00,0.00,840.34,0.20,0
66023,6563,-260.82,-260.82,739.18,161.37,99.45,0.14,0
66024,6563,-1000.00,-1260.82,-260.82,0.00,739.18,0.23,0
66025,6564,1000.00,1000.00,2000.00,87.67,912.33,0.34,1
66026,6564,1000.00,2000.00,3000.00,785.14,1214.86,0.03,1
66027,6564,-1000.00,1000.00,2000.00,1821.01,1178.99,0.04,0
66028,6564,1000.00,2000.00,3000.00,0.00,1455.14,0.34,1
66029,6564,-1000.00,1000.00,2000.00,2813.28,0.00,0.01,0
66030,6564,-1000.00,0.00,1000.00,1371.51,324.78,0.09,0
66031,6564,1000.00,1000.00,2000.00,0.00,521.78,0.23,1
66032,6564,1000.00,2000.00,3000.00,0.00,2000.00,0.07,1
66033,6564,1000.00,3000.00,4000.00,729.23,2270.77,0.29,1
66034,6564,1000.00,4000.00,5000.00,1907.03,2092.97,0.09,1
66035,6564,1000.00,5000.00,6000.00,0.00,5000.00,0.07,1
66036,6564,1000.00,6000.00,7000.00,3000.00,3000.00,0.05,1
66037,6564,1000.00,7000.00,8000.00,2565.39,4434.61,0.16,1
66038,6564,1000.00,8000.00,9000.00,2639.11,5360.89,0.32,1
66039,6564,1000.00,9000.00,10000.00,4124.73,4875.27,0.16,1
66040,6564,1000.00,10000.00,11000.00,2724.30,7275.70,0.32,1
66041,6564,-1000.00,9000.00,10000.00,0.00,11000.00,0.14,0
66042,6564,-1000.00,8000.00,9000.00,0.00,10000.00,0.04,0
66043,6564,-1000.00,7000.00,8000.00,0.00,2453.44,0.05,0
66044,6564,-1000.00,6000.00,7000.00,5155.46,0.00,0.04,0
66045,6564,-1000.00,5000.00,6000.00,0.00,1274.00,0.05,0
66046,6564,-1000.00,4000.00,5000.00,3000.00,3000.00,0.03,0
66047,6564,-347.08,3652.92,4652.92,347.08,0.00,0.02,0
66048,6564,-1000.00,2652.92,3652.92,2080.57,2572.35,0.14,0
66049,6564,-1000.00,1652.92,2652.92,1967.33,1685.59,0.15,0
66050,6564,-1000.00,652.92,1652.92,1101.48,1551.44,0.22,0
66051,6564,-1000.00,-347.08,652.92,0.00,1116.88,0.01,0
66052,6564,-1000.00,-1347.08,-347.08,296.30,356.63,0.14,0
66053,6565,1000.00,1000.00,2000.00,0.00,1000.00,0.24,1
66054,6565,1000.00,2000.00,3000.00,0.00,1719.11,0.42,1
66055,6565,-1000.00,1000.00,2000.00,2448.75,496.09,0.07,0
66056,6565,1000.00,2000.00,3000.00,0.00,2000.00,0.32,1
66057,6565,1000.00,3000.00,4000.00,0.00,1034.19,0.08,1
66058,6565,1000.00,4000.00,5000.00,1697.43,2302.57,0.04,1
66059,6565,1000.00,5000.00,6000.00,0.00,5000.00,0.14,1
66060,6565,1000.00,6000.00,7000.00,1190.76,4809.24,0.40,1
66061,6565,1000.00,7000.00,8000.00,0.00,7000.00,0.34,1
66062,6565,1000.00,8000.00,9000.00,208.69,7791.31,0.21,1
66063,6565,1000.00,9000.00,10000.00,3520.10,5479.90,0.10,1
66064,6565,1000.00,10000.00,11000.00,0.00,10000.00,0.32,1
66065,6565,1000.00,11000.00,12000.00,0.00,10605.69,0.38,1
66066,6565,1000.00,12000.00,13000.00,3181.20,8818.80,0.13,1
66067,6565,1000.00,13000.00,14000.00,0.00,13000.00,0.26,1
66068,6565,-1000.00,12000.00,13000.00,0.00,12251.02,0.40,0
66069,6565,-1000.00,11000.00,12000.00,0.00,9415.93,0.36,0
66070,6565,1000.00,12000.00,13000.00,6441.84,5558.16,0.14,1
66071,6565,-1000.00,11000.00,12000.00,0.00,13000.00,0.41,0
66072,6565,-1000.00,10000.00,11000.00,0.00,5846.31,0.27,0
66073,6565,-1000.00,9000.00,10000.00,0.00,11000.00,0.43,0
66074,6565,0.00,9000.00,10000.00,0.00,0.00,0.05,0
66075,6565,-1000.00,8000.00,9000.00,4203.82,5796.18,0.27,0
66076,6565,-1000.00,7000.00,8000.00,0.00,4483.66,0.25,0
66077,6565,-1000.00,6000.00,7000.00,0.00,8000.00,0.04,0
66078,6565,-1000.00,5000.00,6000.00,0.00,4638.96,0.23,0
66079,6565,-1000.00,4000.00,5000.00,0.00,1852.44,0.20,0
66080,6565,-1000.00,3000.00,4000.00,771.78,4228.22,0.39,0
66081,6565,-1000.00,2000.00,3000.00,1238.58,2761.42,0.29,0
66082,6565,-1000.00,1000.00,2000.00,61.41,2938.59,0.17,0
66083,6565,-1000.00,0.00,1000.00,1000.00,1000.00,0.01,0
66084,6565,-576.26,-576.26,423.74,105.65,470.61,0.29,0
66085,6565,-307.41,-883.67,116.33,119.83,187.58,0.26,0
66086,6565,-110.69,-994.36,5.64,20.28,90.40,0.40,0
66087,6565,-5.64,-1000.00,0.00,2.71,2.93,0.20,0
66088,6566,1000.00,1000.00,2000.00,495.69,504.31,0.10,1
66089,6566,1000.00,2000.00,3000.00,980.11,1019.89,0.19,1
66090,6566,1000.00,3000.00,4000.00,1107.63,1892.37,0.04,1
66091,6566,1000.00,4000.00,5000.00,569.14,3430.86,0.43,1
66092,6566,1000.00,5000.00,6000.00,0.00,806.42,0.16,1
66093,6566,1000.00,6000.00,7000.00,303.02,3524.88,0.35,1
66094,6566,1000.00,7000.00,8000.00,3025.06,3974.94,0.00,1
66095,6566,1000.00,8000.00,9000.00,1901.84,6098.16,0.37,1
66096,6566,1000.00,9000.00,10000.00,1063.53,1184.61,0.15,1
66097,6566,1000.00,10000.00,11000.00,3532.64,6467.36,0.31,1
66098,6566,1000.00,11000.00,12000.00,0.00,11000.00,0.38,1
66099,6566,1000.00,12000.00,13000.00,1747.46,10252.54,0.42,1
66100,6566,1000.00,13000.00,14000.00,0.00,8670.42,0.29,1
66101,6566,1000.00,14000.00,15000.00,4380.62,9522.04,0.33,1
66102,6566,1000.00,15000.00,16000.00,5456.83,9543.17,0.03,1
66103,6566,1000.00,16000.00,17000.00,6569.65,9430.35,0.22,1
66104,6566,1000.00,17000.00,18000.00,0.00,17000.00,0.33,1
66105,6566,-1000.00,16000.00,17000.00,12392.70,5607.30,0.07,0
66106,6566,1000.00,17000.00,18000.00,7254.51,9745.49,0.19,1
66107,6566,1000.00,18000.00,19000.00,5106.25,12893.75,0.36,1
66108,6566,1000.00,19000.00,20000.00,2491.61,12967.55,0.38,1
66109,6567,-1000.00,-1000.00,0.00,0.00,1000.00,0.20,0
66110,6568,-1000.00,-1000.00,0.00,173.48,826.52,0.09,0
66111,6569,-1000.00,-1000.00,0.00,401.27,598.73,0.16,0
66112,6570,0.00,0.00,1000.00,0.00,0.00,0.03,0
66113,6570,-1000.00,-1000.00,0.00,687.03,312.97,0.12,0
66114,6571,-918.01,-918.01,81.99,0.00,918.01,0.25,0
66115,6571,-69.81,-987.81,12.19,15.34,54.47,0.36,0
66116,6571,-11.16,-998.97,1.03,0.00,11.16,0.12,0
66117,6571,-1.03,-1000.00,0.00,0.31,0.72,0.31,0
66118,6572,-1000.00,-1000.00,0.00,0.00,1000.00,0.07,0
66119,6573,-981.78,-981.78,18.22,0.00,981.78,0.23,0
66120,6573,-18.22,-1000.00,0.00,7.72,10.50,0.25,0
66121,6574,-107.57,-107.57,892.43,0.00,107.57,0.02,0
66122,6574,-892.43,-1000.00,0.00,13.10,879.33,0.44,0
66123,6575,1000.00,1000.00,2000.00,107.81,787.06,0.41,1
66124,6575,1000.00,2000.00,3000.00,0.00,2000.00,0.07,1
66125,6575,1000.00,3000.00,4000.00,1500.00,1500.00,0.01,1
66126,6575,-743.01,2256.99,3256.99,743.01,0.00,0.03,0
66127,6575,1000.00,3256.99,4256.99,0.00,3256.99,0.26,1
66128,6575,1000.00,4256.99,5256.99,0.00,4256.99,0.35,1
66129,6575,-1000.00,3256.99,4256.99,2022.15,0.00,0.04,0
66130,6575,1000.00,4256.99,5256.99,434.31,3822.68,0.39,1
66131,6575,1000.00,5256.99,6256.99,0.00,5256.99,0.28,1
66132,6575,1000.00,6256.99,7256.99,1182.23,4930.14,0.40,1
66133,6575,-1000.00,5256.99,6256.99,3734.19,1189.13,0.12,0
66134,6575,1000.00,6256.99,7256.99,0.00,6256.99,0.21,1
66135,6575,1000.00,7256.99,8256.99,1319.16,4992.25,0.37,1
66136,6575,1000.00,8256.99,9256.99,0.00,8256.99,0.43,1
66137,6575,-1000.00,7256.99,8256.99,4857.29,1086.09,0.10,0
66138,6575,1000.00,8256.99,9256.99,1872.30,6384.69,0.12,1
66139,6575,1000.00,9256.99,10256.99,4628.49,4628.49,0.02,1
66140,6575,1000.00,10256.99,11256.99,0.00,10256.99,0.13,1
66141,6575,1000.00,11256.99,12256.99,0.00,395.41,0.11,1
66142,6575,1000.00,12256.99,13256.99,0.00,9331.97,0.30,1
66143,6575,1000.00,13256.99,14256.99,0.00,9742.67,0.40,1
66144,6575,1000.00,14256.99,15256.99,0.00,6587.12,0.20,1
66145,6575,1000.00,15256.99,16256.99,4594.22,10662.77,0.28,1
66146,6575,1000.00,16256.99,17256.99,8128.49,8128.49,0.04,1
66147,6575,1000.00,17256.99,18256.99,3687.68,5617.36,0.22,1
66148,6575,-1000.00,16256.99,17256.99,11215.28,7041.71,0.02,0
66149,6575,0.00,16256.99,17256.99,0.00,0.00,0.06,0
66150,6575,1000.00,17256.99,18256.99,1895.25,8766.89,0.31,1
66151,6575,1000.00,18256.99,19256.99,0.00,18256.99,0.12,1
66152,6575,0.00,18256.99,19256.99,0.00,0.00,0.02,0
66153,6575,1000.00,19256.99,20256.99,0.00,7832.65,0.14,1
66154,6575,1000.00,20256.99,21256.99,2298.11,5183.06,0.20,1
66155,6575,1000.00,21256.99,22256.99,6801.94,14455.05,0.06,1
66156,6575,1000.00,22256.99,23256.99,2652.72,19604.27,0.30,1
66157,6575,1000.00,23256.99,24256.99,0.00,23256.99,0.11,1
66158,6575,1000.00,24256.99,25256.99,6259.48,17997.51,0.15,1
66159,6576,-1000.00,-1000.00,0.00,0.00,1000.00,0.30,0
66160,6577,-447.63,-447.63,552.37,0.00,447.63,0.27,0
66161,6577,-552.37,-1000.00,0.00,0.00,552.37,0.03,0
66162,6578,-1000.00,-1000.00,0.00,0.00,1000.00,0.32,0
66163,6579,-383.25,-383.25,616.75,0.00,383.25,0.22,0
66164,6579,-1000.00,-1383.25,-383.25,616.75,0.00,0.00,0
66165,6580,1000.00,1000.00,2000.00,492.55,507.45,0.08,1
66166,6580,1000.00,2000.00,3000.00,0.00,2000.00,0.05,1
66167,6580,1000.00,3000.00,4000.00,836.56,2163.44,0.08,1
66168,6580,1000.00,4000.00,5000.00,0.00,3379.18,0.38,1
66169,6580,1000.00,5000.00,6000.00,238.63,4761.37,0.44,1
66170,6580,1000.00,6000.00,7000.00,0.00,6000.00,0.11,1
66171,6580,1000.00,7000.00,8000.00,2752.60,4247.40,0.20,1
66172,6580,1000.00,8000.00,9000.00,1247.37,6752.63,0.42,1
66173,6580,1000.00,9000.00,10000.00,3322.90,5677.10,0.23,1
66174,6580,1000.00,10000.00,11000.00,2746.52,7253.48,0.37,1
66175,6580,0.00,10000.00,11000.00,0.00,0.00,0.07,0
66176,6580,1000.00,11000.00,12000.00,0.00,5396.74,0.27,1
66177,6580,1000.00,12000.00,13000.00,0.00,12000.00,0.27,1
66178,6580,1000.00,13000.00,14000.00,5869.32,7130.68,0.18,1
66179,6580,1000.00,14000.00,15000.00,1008.74,8105.33,0.34,1
66180,6580,1000.00,15000.00,16000.00,4433.43,10566.57,0.32,1
66181,6580,0.00,15000.00,16000.00,0.00,0.00,0.07,0
66182,6580,1000.00,16000.00,17000.00,0.00,7619.11,0.29,1
66183,6580,1000.00,17000.00,18000.00,2253.79,14746.21,0.16,1
66184,6580,1000.00,18000.00,19000.00,785.10,7832.04,0.28,1
66185,6580,1000.00,19000.00,20000.00,0.00,17452.91,0.43,1
66186,6580,1000.00,20000.00,21000.00,8716.67,11283.33,0.17,1
66187,6580,1000.00,21000.00,22000.00,0.00,16217.12,0.40,1
66188,6580,1000.00,22000.00,23000.00,4096.27,17903.73,0.37,1
66189,6580,-1000.00,21000.00,22000.00,4875.50,3789.14,0.16,0
66190,6580,1000.00,22000.00,23000.00,0.00,15938.14,0.37,1
66191,6580,1000.00,23000.00,24000.00,0.00,23000.00,0.20,1
66192,6580,0.00,23000.00,24000.00,0.00,0.00,0.07,0
66193,6580,1000.00,24000.00,25000.00,0.00,24000.00,0.23,1
66194,6580,1000.00,25000.00,26000.00,0.00,25000.00,0.07,1
66195,6580,1000.00,26000.00,27000.00,0.00,26000.00,0.29,1
66196,6580,1000.00,27000.00,28000.00,0.00,27000.00,0.19,1
66197,6580,1000.00,28000.00,29000.00,1464.47,26535.53,0.26,1
66198,6580,1000.00,29000.00,30000.00,0.00,22524.02,0.41,1
66199,6580,-1000.00,28000.00,29000.00,15583.93,14416.07,0.10,0
66200,6580,1000.00,29000.00,30000.00,14038.53,14961.47,0.15,1
66201,6580,1000.00,30000.00,31000.00,0.00,17381.71,0.31,1
66202,6580,1000.00,31000.00,32000.00,5014.63,25985.37,0.41,1
66203,6580,1000.00,32000.00,33000.00,0.00,32000.00,0.28,1
66204,6580,1000.00,33000.00,34000.00,0.00,4787.60,0.13,1
66205,6580,-1000.00,32000.00,33000.00,27643.38,0.00,0.02,0
66206,6580,1000.00,33000.00,34000.00,4314.66,28685.34,0.43,1
66207,6580,1000.00,34000.00,35000.00,0.00,31418.86,0.43,1
66208,6580,1000.00,35000.00,36000.00,0.00,35000.00,0.17,1
66209,6580,-1000.00,34000.00,35000.00,0.00,36000.00,0.01,0
66210,6580,-1000.00,33000.00,34000.00,4903.03,30096.97,0.27,0
66211,6580,0.00,33000.00,34000.00,0.00,0.00,0.00,0
66212,6580,-1000.00,32000.00,33000.00,28935.65,1673.78,0.05,0
66213,6580,-1000.00,31000.00,32000.00,14303.85,18696.15,0.23,0
66214,6580,-1000.00,30000.00,31000.00,0.00,10059.15,0.21,0
66215,6580,-1000.00,29000.00,30000.00,14514.10,16485.90,0.17,0
66216,6580,-1000.00,28000.00,29000.00,4.06,23061.80,0.41,0
66217,6580,-1000.00,27000.00,28000.00,14500.00,14500.00,0.05,0
66218,6580,-1000.00,26000.00,27000.00,11129.28,16870.72,0.24,0
66219,6580,-1000.00,25000.00,26000.00,2338.67,24661.33,0.40,0
66220,6580,-1000.00,24000.00,25000.00,0.00,26000.00,0.30,0
66221,6580,-1000.00,23000.00,24000.00,3797.18,21202.82,0.38,0
66222,6580,-1000.00,22000.00,23000.00,10528.83,0.00,0.02,0
66223,6580,-1000.00,21000.00,22000.00,8760.52,14239.48,0.22,0
66224,6580,-1000.00,20000.00,21000.00,0.00,19382.43,0.32,0
66225,6580,-1000.00,19000.00,20000.00,0.00,21000.00,0.40,0
66226,6580,-1000.00,18000.00,19000.00,6363.90,13636.10,0.32,0
66227,6580,-1000.00,17000.00,18000.00,13024.50,5975.50,0.09,0
66228,6580,-1000.00,16000.00,17000.00,0.00,18000.00,0.25,0
66229,6580,-1000.00,15000.00,16000.00,11027.78,0.00,0.04,0
66230,6580,-1000.00,14000.00,15000.00,0.00,11343.21,0.36,0
66231,6580,-1000.00,13000.00,14000.00,0.00,15000.00,0.09,0
66232,6580,-1000.00,12000.00,13000.00,0.00,13258.99,0.23,0
66233,6581,1000.00,1000.00,2000.00,0.00,930.35,0.24,1
66234,6581,1000.00,2000.00,3000.00,0.00,2000.00,0.26,1
66235,6581,1000.00,3000.00,4000.00,0.00,292.00,0.11,1
66236,6581,1000.00,4000.00,5000.00,89.08,2680.11,0.38,1
66237,6581,1000.00,5000.00,6000.00,0.00,5000.00,0.25,1
66238,6581,1000.00,6000.00,7000.00,2306.91,3693.09,0.25,1
66239,6581,1000.00,7000.00,8000.00,0.00,7000.00,0.14,1
66240,6581,1000.00,8000.00,9000.00,0.00,1658.70,0.17,1
66241,6581,1000.00,9000.00,10000.00,2137.38,6862.62,0.34,1
66242,6581,1000.00,10000.00,11000.00,0.00,10000.00,0.17,1
66243,6581,-1000.00,9000.00,10000.00,4000.12,2895.14,0.17,0
66244,6581,1000.00,10000.00,11000.00,0.00,9689.46,0.26,1
66245,6581,1000.00,11000.00,12000.00,0.00,11000.00,0.24,1
66246,6581,1000.00,12000.00,13000.00,4464.29,7535.71,0.30,1
66247,6581,1000.00,13000.00,14000.00,0.00,13000.00,0.26,1
66248,6581,1000.00,14000.00,15000.00,0.00,10569.51,0.41,1
66249,6581,1000.00,15000.00,16000.00,0.00,15000.00,0.22,1
66250,6581,1000.00,16000.00,17000.00,7526.68,8473.32,0.19,1
66251,6581,1000.00,17000.00,18000.00,0.00,17000.00,0.33,1
66252,6581,1000.00,18000.00,19000.00,3980.33,14019.67,0.27,1
66253,6581,1000.00,19000.00,20000.00,7110.07,11889.93,0.30,1
66254,6581,1000.00,20000.00,21000.00,0.00,20000.00,0.29,1
66255,6581,1000.00,21000.00,22000.00,9414.69,11585.31,0.18,1
66256,6581,1000.00,22000.00,23000.00,1152.59,20847.41,0.44,1
66257,6581,1000.00,23000.00,24000.00,0.00,12264.81,0.32,1
66258,6581,1000.00,24000.00,25000.00,0.00,19724.95,0.02,1
66259,6581,1000.00,25000.00,26000.00,1409.21,23590.79,0.21,1
66260,6581,1000.00,26000.00,27000.00,0.00,22178.20,0.43,1
66261,6581,1000.00,27000.00,28000.00,0.00,24875.15,0.43,1
66262,6581,1000.00,28000.00,29000.00,0.00,28000.00,0.27,1
66263,6581,1000.00,29000.00,30000.00,10301.31,18698.69,0.32,1
66264,6581,-1000.00,28000.00,29000.00,8038.78,21961.22,0.37,0
66265,6581,-1000.00,27000.00,28000.00,340.69,23255.59,0.42,0
66266,6581,-1000.00,26000.00,27000.00,0.00,28000.00,0.33,0
66267,6581,-1000.00,25000.00,26000.00,13510.63,13489.37,0.16,0
66268,6581,0.00,25000.00,26000.00,0.00,0.00,0.06,0
66269,6581,-1000.00,24000.00,25000.00,17295.94,8704.06,0.07,0
66270,6581,-1000.00,23000.00,24000.00,0.00,25000.00,0.00,0
66271,6581,-1000.00,22000.00,23000.00,0.00,6565.57,0.21,0
66272,6581,-1000.00,21000.00,22000.00,8715.78,14284.22,0.30,0
66273,6581,-1000.00,20000.00,21000.00,4831.72,17168.28,0.36,0
66274,6582,-1000.00,-1000.00,0.00,373.70,248.01,0.17,0
66275,6583,-1000.00,-1000.00,0.00,591.35,408.65,0.14,0
66276,6584,-1000.00,-1000.00,0.00,860.66,139.34,0.05,0
66277,6585,-1000.00,-1000.00,0.00,106.11,639.23,0.25,0
66278,6586,-1000.00,-1000.00,0.00,0.00,1000.00,0.11,0
66279,6587,-254.44,-254.44,745.56,0.00,254.44,0.39,0
66280,6587,-628.10,-882.54,117.46,233.79,394.30,0.26,0
66281,6587,1000.00,117.46,1117.46,41.92,0.00,0.08,1
66282,6587,-1000.00,-882.54,117.46,108.75,1008.71,0.15,0
66283,6587,-26.00,-908.54,91.46,0.00,26.00,0.19,0
66284,6587,-55.70,-964.24,35.76,0.00,55.70,0.06,0
66285,6587,0.00,-964.24,35.76,0.00,0.00,0.00,0
66286,6587,-35.76,-1000.00,0.00,0.00,35.76,0.09,0
66287,6588,-1000.00,-1000.00,0.00,280.33,719.67,0.26,0
66288,6589,1000.00,1000.00,2000.00,0.00,581.40,0.17,1
66289,6589,1000.00,2000.00,3000.00,0.00,2000.00,0.00,1
66290,6589,-1000.00,1000.00,2000.00,1766.60,230.11,0.08,0
66291,6589,1000.00,2000.00,3000.00,0.00,2000.00,0.01,1
66292,6589,1000.00,3000.00,4000.00,0.00,2406.36,0.21,1
66293,6589,-1000.00,2000.00,3000.00,1040.18,0.00,0.03,0
66294,6589,1000.00,3000.00,4000.00,132.77,1504.82,0.31,1
66295,6589,1000.00,4000.00,5000.00,0.00,2662.81,0.16,1
66296,6589,1000.00,5000.00,6000.00,0.00,2389.22,0.02,1
66297,6589,1000.00,6000.00,7000.00,2200.35,3799.65,0.24,1
66298,6589,1000.00,7000.00,8000.00,0.00,7000.00,0.19,1
66299,6589,1000.00,8000.00,9000.00,0.00,8000.00,0.20,1
66300,6589,1000.00,9000.00,10000.00,0.00,9000.00,0.14,1
66301,6589,1000.00,10000.00,11000.00,286.76,9713.24,0.12,1
66302,6589,1000.00,11000.00,12000.00,1853.05,9146.95,0.29,1
66303,6589,1000.00,12000.00,13000.00,0.00,12000.00,0.14,1
66304,6589,-1000.00,11000.00,12000.00,7701.33,5298.67,0.11,0
66305,6589,1000.00,12000.00,13000.00,0.00,12000.00,0.21,1
66306,6589,1000.00,13000.00,14000.00,0.00,2432.04,0.04,1
66307,6589,1000.00,14000.00,15000.00,146.01,7784.44,0.34,1
66308,6589,1000.00,15000.00,16000.00,0.00,15000.00,0.25,1
66309,6589,1000.00,16000.00,17000.00,5024.66,10975.34,0.21,1
66310,6589,1000.00,17000.00,18000.00,7602.51,9397.49,0.06,1
66311,6589,-1000.00,16000.00,17000.00,1807.89,444.91,0.12,0
66312,6589,-1000.00,15000.00,16000.00,0.00,13890.32,0.42,0
66313,6589,-1000.00,14000.00,15000.00,0.00,9705.18,0.12,0
66314,6589,-1000.00,13000.00,14000.00,0.00,12492.94,0.39,0
66315,6589,-1000.00,12000.00,13000.00,0.00,14000.00,0.11,0
66316,6589,-1000.00,11000.00,12000.00,9178.85,3821.15,0.04,0
66317,6589,-1000.00,10000.00,11000.00,0.00,8736.70,0.33,0
66318,6589,-1000.00,9000.00,10000.00,5897.23,5102.77,0.17,0
66319,6589,-1000.00,8000.00,9000.00,0.00,3270.54,0.09,0
66320,6589,-1000.00,7000.00,8000.00,4164.57,4835.43,0.23,0
66321,6589,-1000.00,6000.00,7000.00,3827.72,4172.28,0.15,0
66322,6589,-1000.00,5000.00,6000.00,0.00,7000.00,0.37,0
66323,6589,-1000.00,4000.00,5000.00,0.00,4042.88,0.38,0
66324,6589,-360.38,3639.62,4639.62,0.00,360.38,0.08,0
66325,6589,-783.71,2855.91,3855.91,0.00,783.71,0.16,0
66326,6589,-1000.00,1855.91,2855.91,1518.48,2337.43,0.22,0
66327,6589,-1000.00,855.91,1855.91,1427.96,1427.96,0.09,0
66328,6589,-1000.00,-144.09,855.91,286.83,867.24,0.29,0
66329,6589,-1000.00,-1144.09,-144.09,513.37,342.54,0.04,0
66330,6590,-991.72,-991.72,8.28,855.55,136.18,0.06,0
66331,6590,-1000.00,-1991.72,-991.72,1.73,6.54,0.26,0
66332,6591,-1000.00,-1000.00,0.00,213.68,786.32,0.37,0
66333,6592,-1000.00,-1000.00,0.00,0.00,1000.00,0.05,0
66334,6593,-1000.00,-1000.00,0.00,0.00,1000.00,0.31,0
66335,6594,1000.00,1000.00,2000.00,418.91,581.09,0.26,1
66336,6594,1000.00,2000.00,3000.00,0.00,2000.00,0.23,1
66337,6594,1000.00,3000.00,4000.00,0.00,2535.82,0.39,1
66338,6594,1000.00,4000.00,5000.00,384.22,3615.78,0.43,1
66339,6594,1000.00,5000.00,6000.00,1560.94,3439.06,0.32,1
66340,6594,1000.00,6000.00,7000.00,1269.35,4730.65,0.40,1
66341,6594,1000.00,7000.00,8000.00,0.00,2174.05,0.23,1
66342,6594,1000.00,8000.00,9000.00,1481.61,6518.39,0.27,1
66343,6594,1000.00,9000.00,10000.00,0.00,2967.35,0.21,1
66344,6594,1000.00,10000.00,11000.00,1519.76,8480.24,0.41,1
66345,6594,1000.00,11000.00,12000.00,4933.05,6066.95,0.13,1
66346,6594,-1000.00,10000.00,11000.00,6526.82,4735.86,0.18,0
66347,6594,1000.00,11000.00,12000.00,605.29,4673.59,0.28,1
66348,6594,1000.00,12000.00,13000.00,574.90,11425.10,0.19,1
66349,6594,1000.00,13000.00,14000.00,0.00,13000.00,0.23,1
66350,6594,-1000.00,12000.00,13000.00,8539.39,5460.61,0.15,0
66351,6594,1000.00,13000.00,14000.00,101.54,11819.45,0.44,1
66352,6594,1000.00,14000.00,15000.00,0.00,4172.01,0.21,1
66353,6594,1000.00,15000.00,16000.00,0.00,15000.00,0.42,1
66354,6594,-1000.00,14000.00,15000.00,3049.18,12950.82,0.10,0
66355,6594,-1000.00,13000.00,14000.00,1055.45,13944.55,0.42,0
66356,6594,-1000.00,12000.00,13000.00,7134.64,6865.36,0.05,0
66357,6594,-1000.00,11000.00,12000.00,5778.44,7221.56,0.17,0
66358,6594,-1000.00,10000.00,11000.00,0.00,12000.00,0.11,0
66359,6594,-1000.00,9000.00,10000.00,2888.00,8112.00,0.25,0
66360,6594,-1000.00,8000.00,9000.00,0.00,4094.70,0.03,0
66361,6594,-1000.00,7000.00,8000.00,0.00,5998.03,0.28,0
66362,6594,-1000.00,6000.00,7000.00,0.00,8000.00,0.43,0
66363,6594,-1000.00,5000.00,6000.00,626.38,6373.62,0.27,0
66364,6594,0.00,5000.00,6000.00,0.00,0.00,0.09,0
66365,6594,-1000.00,4000.00,5000.00,0.00,4922.32,0.40,0
66366,6594,-1000.00,3000.00,4000.00,0.00,5000.00,0.36,0
66367,6594,-1000.00,2000.00,3000.00,97.74,3902.26,0.22,0
66368,6594,-1000.00,1000.00,2000.00,1508.20,1491.80,0.01,0
66369,6594,-1000.00,0.00,1000.00,985.34,1014.66,0.19,0
66370,6594,-1000.00,-1000.00,0.00,641.56,358.44,0.12,0
66371,6595,1000.00,1000.00,2000.00,311.00,689.00,0.20,1
66372,6595,-1000.00,0.00,1000.00,1253.29,162.26,0.08,0
66373,6595,1000.00,1000.00,2000.00,139.16,860.84,0.37,1
66374,6595,1000.00,2000.00,3000.00,988.48,1011.52,0.12,1
66375,6595,-1000.00,1000.00,2000.00,1118.42,0.00,0.05,0
66376,6595,-1000.00,0.00,1000.00,1017.94,982.06,0.13,0
66377,6595,1000.00,1000.00,2000.00,76.21,923.79,0.36,1
66378,6595,-1000.00,0.00,1000.00,1845.56,154.44,0.02,0
66379,6595,1000.00,1000.00,2000.00,308.19,691.81,0.23,1
66380,6595,0.00,1000.00,2000.00,0.00,0.00,0.00,0
66381,6595,1000.00,2000.00,3000.00,259.98,1740.02,0.42,1
66382,6595,1000.00,3000.00,4000.00,0.00,3000.00,0.05,1
66383,6595,0.00,3000.00,4000.00,0.00,0.00,0.02,0
66384,6595,1000.00,4000.00,5000.00,1905.35,2094.65,0.23,1
66385,6595,1000.00,5000.00,6000.00,2196.25,2803.75,0.05,1
66386,6595,-1000.00,4000.00,5000.00,3350.70,2649.30,0.16,0
66387,6595,1000.00,5000.00,6000.00,577.13,1938.58,0.26,1
66388,6595,1000.00,6000.00,7000.00,2371.03,3628.97,0.06,1
66389,6595,1000.00,7000.00,8000.00,0.00,7000.00,0.39,1
66390,6595,1000.00,8000.00,9000.00,3268.05,4731.95,0.11,1
66391,6595,1000.00,9000.00,10000.00,4031.38,4968.62,0.15,1
66392,6595,1000.00,10000.00,11000.00,0.00,1283.07,0.07,1
66393,6595,0.00,10000.00,11000.00,0.00,0.00,0.02,0
66394,6595,1000.00,11000.00,12000.00,0.00,11000.00,0.14,1
66395,6595,-1000.00,10000.00,11000.00,0.00,12000.00,0.22,0
66396,6595,-1000.00,9000.00,10000.00,1254.89,8554.40,0.41,0
66397,6595,-1000.00,8000.00,9000.00,0.00,10000.00,0.35,0
66398,6595,-1000.00,7000.00,8000.00,3442.79,5557.21,0.29,0
66399,6595,0.00,7000.00,8000.00,0.00,0.00,0.01,0
66400,6595,-1000.00,6000.00,7000.00,1303.29,6696.71,0.37,0
66401,6595,-1000.00,5000.00,6000.00,1873.48,5126.52,0.37,0
66402,6595,-1000.00,4000.00,5000.00,127.84,5872.16,0.21,0
66403,6595,-1000.00,3000.00,4000.00,2500.00,2500.00,0.04,0
66404,6595,-1000.00,2000.00,3000.00,0.00,4000.00,0.11,0
66405,6595,-1000.00,1000.00,2000.00,610.76,2389.24,0.40,0
66406,6595,-1000.00,0.00,1000.00,0.00,2000.00,0.37,0
66407,6595,-592.41,-592.41,407.59,0.00,592.41,0.34,0
66408,6595,-407.59,-1000.00,0.00,161.67,245.92,0.28,0
66409,6596,-1000.00,-1000.00,0.00,460.34,539.66,0.19,0
66410,6597,1000.00,1000.00,2000.00,0.00,30.47,0.04,1
66411,6597,1000.00,2000.00,3000.00,0.00,1446.21,0.25,1
66412,6597,1000.00,3000.00,4000.00,1307.40,1692.60,0.13,1
66413,6597,1000.00,4000.00,5000.00,0.00,3567.68,0.42,1
66414,6597,1000.00,5000.00,6000.00,0.00,1852.36,0.25,1
66415,6597,1000.00,6000.00,7000.00,0.00,5970.76,0.32,1
66416,6597,1000.00,7000.00,8000.00,86.64,6913.36,0.14,1
66417,6597,1000.00,8000.00,9000.00,0.00,8000.00,0.08,1
66418,6597,1000.00,9000.00,10000.00,0.00,9000.00,0.08,1
66419,6597,1000.00,10000.00,11000.00,623.40,9376.60,0.39,1
66420,6597,1000.00,11000.00,12000.00,0.00,4031.93,0.22,1
66421,6597,1000.00,12000.00,13000.00,4986.31,7013.69,0.19,1
66422,6597,-1000.00,11000.00,12000.00,7578.99,5421.01,0.17,0
66423,6597,-1000.00,10000.00,11000.00,6843.59,5156.41,0.15,0
66424,6597,1000.00,11000.00,12000.00,0.00,11000.00,0.00,1
66425,6597,1000.00,12000.00,13000.00,0.00,12000.00,0.10,1
66426,6597,1000.00,13000.00,14000.00,3085.57,9914.43,0.27,1
66427,6597,1000.00,14000.00,15000.00,0.00,10436.67,0.39,1
66428,6597,1000.00,15000.00,16000.00,7500.00,7500.00,0.02,1
66429,6597,1000.00,16000.00,17000.00,0.00,11907.98,0.39,1
66430,6597,1000.00,17000.00,18000.00,0.00,17000.00,0.22,1
66431,6597,-1000.00,16000.00,17000.00,9003.10,8996.90,0.18,0
66432,6597,1000.00,17000.00,18000.00,4854.17,8014.72,0.27,1
66433,6597,1000.00,18000.00,19000.00,0.00,4092.88,0.16,1
66434,6597,0.00,18000.00,19000.00,0.00,0.00,0.00,0
66435,6597,-1000.00,17000.00,18000.00,821.35,11232.08,0.43,0
66436,6597,-1000.00,16000.00,17000.00,0.00,18000.00,0.37,0
66437,6597,-1000.00,15000.00,16000.00,4049.04,12950.96,0.08,0
66438,6597,-1000.00,14000.00,15000.00,0.00,9850.46,0.07,0
66439,6597,-1000.00,13000.00,14000.00,0.00,15000.00,0.32,0
66440,6597,-1000.00,12000.00,13000.00,0.00,14000.00,0.40,0
66441,6597,-1000.00,11000.00,12000.00,2010.25,9988.49,0.40,0
66442,6597,-1000.00,10000.00,11000.00,3506.72,8493.28,0.35,0
66443,6597,-1000.00,9000.00,10000.00,6242.30,4757.70,0.17,0
66444,6597,-1000.00,8000.00,9000.00,1516.74,2211.06,0.18,0
66445,6597,-1000.00,7000.00,8000.00,1724.91,7275.09,0.09,0
66446,6597,-1000.00,6000.00,7000.00,0.00,7320.03,0.43,0
66447,6597,-1000.00,5000.00,6000.00,355.47,4519.78,0.37,0
66448,6597,-736.55,4263.45,5263.45,0.00,736.55,0.11,0
66449,6597,-1000.00,3263.45,4263.45,1286.94,3738.65,0.36,0
66450,6597,-1000.00,2263.45,3263.45,0.00,3032.74,0.13,0
66451,6597,-1000.00,1263.45,2263.45,1731.69,751.25,0.13,0
66452,6597,-1000.00,263.45,1263.45,902.58,1360.87,0.22,0
66453,6597,-1000.00,-736.55,263.45,0.00,1263.45,0.23,0
66454,6597,-263.45,-1000.00,0.00,41.86,221.59,0.39,0
66455,6598,-664.69,-664.69,335.31,294.38,370.32,0.37,0
66456,6598,-335.31,-1000.00,0.00,0.00,335.31,0.07,0
66457,6599,-45.18,-45.18,954.82,0.00,45.18,0.02,0
66458,6599,-954.82,-1000.00,0.00,187.55,767.27,0.41,0
66459,6600,1000.00,1000.00,2000.00,138.60,861.40,0.16,1
66460,6600,1000.00,2000.00,3000.00,0.00,2000.00,0.33,1
66461,6600,1000.00,3000.00,4000.00,1017.52,1982.48,0.14,1
66462,6600,1000.00,4000.00,5000.00,0.00,4000.00,0.20,1
66463,6600,1000.00,5000.00,6000.00,355.50,4644.50,0.29,1
66464,6600,1000.00,6000.00,7000.00,736.19,5263.81,0.27,1
66465,6600,1000.00,7000.00,8000.00,0.00,7000.00,0.40,1
66466,6600,1000.00,8000.00,9000.00,0.00,8000.00,0.18,1
66467,6600,1000.00,9000.00,10000.00,781.56,3579.61,0.26,1
66468,6600,1000.00,10000.00,11000.00,2472.18,7527.82,0.26,1
66469,6600,1000.00,11000.00,12000.00,3720.23,7279.77,0.15,1
66470,6600,1000.00,12000.00,13000.00,0.00,12000.00,0.40,1
66471,6600,1000.00,13000.00,14000.00,0.00,13000.00,0.38,1
66472,6600,1000.00,14000.00,15000.00,0.00,7729.95,0.31,1
66473,6600,1000.00,15000.00,16000.00,7500.00,7500.00,0.02,1
66474,6600,1000.00,16000.00,17000.00,4941.87,11058.13,0.33,1
66475,6600,1000.00,17000.00,18000.00,0.00,17000.00,0.24,1
66476,6600,-1000.00,16000.00,17000.00,2387.91,0.00,0.10,0
66477,6600,1000.00,17000.00,18000.00,0.00,17000.00,0.44,1
66478,6600,-1000.00,16000.00,17000.00,9868.06,7326.22,0.18,0
66479,6600,-1000.00,15000.00,16000.00,0.00,17000.00,0.37,0
66480,6600,-1000.00,14000.00,15000.00,0.00,14857.09,0.44,0
66481,6600,-1000.00,13000.00,14000.00,4086.30,10913.70,0.29,0
66482,6600,-1000.00,12000.00,13000.00,3129.81,10870.19,0.39,0
66483,6600,-1000.00,11000.00,12000.00,0.00,13000.00,0.07,0
66484,6600,0.00,11000.00,12000.00,0.00,0.00,0.08,0
66485,6600,-1000.00,10000.00,11000.00,0.00,12000.00,0.08,0
66486,6600,-1000.00,9000.00,10000.00,0.00,11000.00,0.23,0
66487,6600,-1000.00,8000.00,9000.00,0.00,10000.00,0.18,0
66488,6600,-1000.00,7000.00,8000.00,0.00,9000.00,0.16,0
66489,6600,-1000.00,6000.00,7000.00,2954.83,5045.17,0.31,0
66490,6600,-1000.00,5000.00,6000.00,0.00,3896.37,0.26,0
66491,6600,-1000.00,4000.00,5000.00,3000.00,3000.00,0.08,0
66492,6600,-1000.00,3000.00,4000.00,2500.00,2500.00,0.09,0
66493,6600,-1000.00,2000.00,3000.00,1524.25,1708.08,0.23,0
66494,6600,-1000.00,1000.00,2000.00,0.00,3000.00,0.42,0
66495,6600,-1000.00,0.00,1000.00,685.62,1297.97,0.32,0
66496,6600,-1000.00,-1000.00,0.00,274.33,196.07,0.16,0
66497,6601,1000.00,1000.00,2000.00,0.00,1000.00,0.25,1
66498,6601,1000.00,2000.00,3000.00,67.82,1932.18,0.37,1
66499,6601,1000.00,3000.00,4000.00,0.00,2755.37,0.44,1
66500,6601,1000.00,4000.00,5000.00,1028.33,2971.67,0.38,1
66501,6601,1000.00,5000.00,6000.00,0.00,5000.00,0.12,1
66502,6601,-1000.00,4000.00,5000.00,2581.49,1357.32,0.15,0
66503,6601,1000.00,5000.00,6000.00,0.00,4359.33,0.35,1
66504,6601,1000.00,6000.00,7000.00,0.00,4208.03,0.33,1
66505,6601,1000.00,7000.00,8000.00,0.00,7000.00,0.05,1
66506,6601,-1000.00,6000.00,7000.00,4289.24,3710.76,0.06,0
66507,6601,1000.00,7000.00,8000.00,0.00,7000.00,0.29,1
66508,6601,0.00,7000.00,8000.00,0.00,0.00,0.07,0
66509,6601,1000.00,8000.00,9000.00,0.00,637.00,0.14,1
66510,6601,1000.00,9000.00,10000.00,0.00,2979.86,0.22,1
66511,6601,1000.00,10000.00,11000.00,0.00,1720.46,0.16,1
66512,6601,1000.00,11000.00,12000.00,0.00,11000.00,0.06,1
66513,6601,1000.00,12000.00,13000.00,410.61,11589.39,0.07,1
66514,6601,1000.00,13000.00,14000.00,0.00,13000.00,0.39,1
66515,6601,1000.00,14000.00,15000.00,0.00,14000.00,0.39,1
66516,6601,1000.00,15000.00,16000.00,4071.51,10928.49,0.16,1
66517,6601,1000.00,16000.00,17000.00,0.00,10062.38,0.36,1
66518,6601,1000.00,17000.00,18000.00,6387.04,10612.96,0.30,1
66519,6601,0.00,17000.00,18000.00,0.00,0.00,0.07,0
66520,6601,-1000.00,16000.00,17000.00,0.00,18000.00,0.40,0
66521,6601,-1000.00,15000.00,16000.00,0.00,17000.00,0.34,0
66522,6601,-1000.00,14000.00,15000.00,0.00,15790.01,0.44,0
66523,6601,-1000.00,13000.00,14000.00,4054.04,10945.96,0.27,0
66524,6601,-1000.00,12000.00,13000.00,0.00,14000.00,0.11,0
66525,6601,-1000.00,11000.00,12000.00,0.00,13000.00,0.17,0
66526,6601,-1000.00,10000.00,11000.00,0.00,1829.23,0.07,0
66527,6601,-1000.00,9000.00,10000.00,4171.52,1319.87,0.12,0
66528,6601,-1000.00,8000.00,9000.00,0.00,10000.00,0.10,0
66529,6601,-1000.00,7000.00,8000.00,2013.67,6986.33,0.39,0
66530,6601,-1000.00,6000.00,7000.00,0.00,6500.57,0.42,0
66531,6601,-1000.00,5000.00,6000.00,2536.57,4463.43,0.27,0
66532,6601,-1000.00,4000.00,5000.00,0.00,3232.12,0.19,0
66533,6601,-1000.00,3000.00,4000.00,0.00,3581.57,0.23,0
66534,6601,-1000.00,2000.00,3000.00,1039.10,1361.93,0.22,0
66535,6601,0.00,2000.00,3000.00,0.00,0.00,0.02,0
66536,6601,-1000.00,1000.00,2000.00,368.36,1196.26,0.26,0
66537,6601,-1000.00,0.00,1000.00,953.06,1046.94,0.13,0
66538,6601,-1000.00,-1000.00,0.00,19.18,980.82,0.12,0
66539,6602,-1000.00,-1000.00,0.00,0.00,1000.00,0.24,0
66540,6603,1000.00,1000.00,2000.00,0.00,1000.00,0.41,1
66541,6603,1000.00,2000.00,3000.00,0.00,2000.00,0.11,1
66542,6603,1000.00,3000.00,4000.00,1306.53,1693.47,0.19,1
66543,6603,1000.00,4000.00,5000.00,0.00,4000.00,0.21,1
66544,6603,1000.00,5000.00,6000.00,0.00,5000.00,0.10,1
66545,6603,1000.00,6000.00,7000.00,0.00,4182.52,0.32,1
66546,6603,1000.00,7000.00,8000.00,186.03,6813.97,0.41,1
66547,6603,1000.00,8000.00,9000.00,0.00,8000.00,0.04,1
66548,6603,1000.00,9000.00,10000.00,1537.28,7336.64,0.40,1
66549,6603,1000.00,10000.00,11000.00,1751.61,7777.69,0.40,1
66550,6603,1000.00,11000.00,12000.00,0.00,11000.00,0.38,1
66551,6603,1000.00,12000.00,13000.00,0.00,12000.00,0.17,1
66552,6603,1000.00,13000.00,14000.00,0.00,13000.00,0.43,1
66553,6603,-1000.00,12000.00,13000.00,8160.94,5839.06,0.14,0
66554,6603,1000.00,13000.00,14000.00,1111.77,11888.23,0.44,1
66555,6603,1000.00,14000.00,15000.00,3190.00,10810.00,0.39,1
66556,6603,0.00,14000.00,15000.00,0.00,0.00,0.03,0
66557,6603,1000.00,15000.00,16000.00,2715.53,12284.47,0.35,1
66558,6603,0.00,15000.00,16000.00,0.00,0.00,0.04,0
66559,6603,1000.00,16000.00,17000.00,0.00,11713.76,0.08,1
66560,6603,1000.00,17000.00,18000.00,3572.22,13427.78,0.39,1
66561,6603,1000.00,18000.00,19000.00,0.00,4504.58,0.17,1
66562,6603,1000.00,19000.00,20000.00,0.00,10444.58,0.33,1
66563,6603,1000.00,20000.00,21000.00,0.00,20000.00,0.08,1
66564,6603,1000.00,21000.00,22000.00,0.00,21000.00,0.31,1
66565,6603,1000.00,22000.00,23000.00,0.00,22000.00,0.25,1
66566,6603,1000.00,23000.00,24000.00,0.00,23000.00,0.43,1
66567,6603,1000.00,24000.00,25000.00,0.00,7976.29,0.23,1
66568,6603,1000.00,25000.00,26000.00,0.00,25000.00,0.22,1
66569,6603,1000.00,26000.00,27000.00,8649.40,17350.60,0.31,1
66570,6603,1000.00,27000.00,28000.00,4860.07,22139.93,0.41,1
66571,6603,1000.00,28000.00,29000.00,13284.27,14715.73,0.07,1
66572,6603,1000.00,29000.00,30000.00,0.00,29000.00,0.33,1
66573,6603,1000.00,30000.00,31000.00,0.00,30000.00,0.25,1
66574,6603,1000.00,31000.00,32000.00,0.00,31000.00,0.09,1
66575,6603,1000.00,32000.00,33000.00,4973.89,27026.11,0.33,1
66576,6603,1000.00,33000.00,34000.00,0.00,17535.87,0.28,1
66577,6603,-1000.00,32000.00,33000.00,2860.65,195.10,0.11,0
66578,6603,1000.00,33000.00,34000.00,0.00,27479.97,0.34,1
66579,6603,0.00,33000.00,34000.00,0.00,0.00,0.01,0
66580,6603,1000.00,34000.00,35000.00,0.00,34000.00,0.20,1
66581,6603,1000.00,35000.00,36000.00,0.00,17688.82,0.30,1
66582,6603,1000.00,36000.00,37000.00,0.00,36000.00,0.02,1
66583,6603,-1000.00,35000.00,36000.00,35223.27,0.00,0.02,0
66584,6603,0.00,35000.00,36000.00,0.00,0.00,0.02,0
66585,6604,1000.00,1000.00,2000.00,0.00,1000.00,0.10,1
66586,6604,1000.00,2000.00,3000.00,0.00,2000.00,0.33,1
66587,6604,1000.00,3000.00,4000.00,0.00,2430.16,0.29,1
66588,6604,1000.00,4000.00,5000.00,0.00,4000.00,0.25,1
66589,6604,1000.00,5000.00,6000.00,225.08,4694.96,0.44,1
66590,6604,1000.00,6000.00,7000.00,2193.95,3806.05,0.03,1
66591,6604,1000.00,7000.00,8000.00,2781.02,4218.98,0.16,1
66592,6604,-1000.00,6000.00,7000.00,1305.85,1144.73,0.15,0
66593,6604,1000.00,7000.00,8000.00,0.00,7000.00,0.02,1
66594,6604,1000.00,8000.00,9000.00,3795.28,4204.72,0.13,1
66595,6604,1000.00,9000.00,10000.00,0.00,9000.00,0.39,1
66596,6604,1000.00,10000.00,11000.00,0.00,10000.00,0.21,1
66597,6604,1000.00,11000.00,12000.00,0.00,11000.00,0.19,1
66598,6604,1000.00,12000.00,13000.00,5364.81,6635.19,0.01,1
66599,6604,1000.00,13000.00,14000.00,1891.99,11108.01,0.42,1
66600,6604,1000.00,14000.00,15000.00,3336.33,10663.67,0.38,1
66601,6604,1000.00,15000.00,16000.00,3499.22,11500.78,0.19,1
66602,6604,1000.00,16000.00,17000.00,4667.91,11332.09,0.25,1
66603,6604,1000.00,17000.00,18000.00,4621.36,12378.64,0.21,1
66604,6604,1000.00,18000.00,19000.00,5226.58,12773.42,0.27,1
66605,6604,1000.00,19000.00,20000.00,0.00,12004.64,0.36,1
66606,6604,1000.00,20000.00,21000.00,0.00,1900.63,0.07,1
66607,6604,0.00,20000.00,21000.00,0.00,0.00,0.02,0
66608,6604,1000.00,21000.00,22000.00,11.58,3163.64,0.16,1
66609,6604,-1000.00,20000.00,21000.00,11079.01,10920.99,0.10,0
66610,6604,1000.00,21000.00,22000.00,6002.97,14997.03,0.36,1
66611,6604,1000.00,22000.00,23000.00,0.00,14865.36,0.32,1
66612,6604,1000.00,23000.00,24000.00,1864.09,21135.91,0.44,1
66613,6604,1000.00,24000.00,25000.00,0.00,24000.00,0.04,1
66614,6604,1000.00,25000.00,26000.00,12043.89,12956.11,0.16,1
66615,6604,1000.00,26000.00,27000.00,0.00,17427.84,0.28,1
66616,6604,1000.00,27000.00,28000.00,0.00,26970.31,0.32,1
66617,6604,1000.00,28000.00,29000.00,0.00,28000.00,0.02,1
66618,6604,1000.00,29000.00,30000.00,0.00,12554.39,0.25,1
66619,6604,1000.00,30000.00,31000.00,9434.59,20565.41,0.35,1
66620,6604,1000.00,31000.00,32000.00,3503.97,27496.03,0.15,1
66621,6604,-1000.00,30000.00,31000.00,18144.56,13855.44,0.09,0
66622,6604,-1000.00,29000.00,30000.00,12589.01,5142.03,0.13,0
66623,6604,-1000.00,28000.00,29000.00,1278.59,0.00,0.08,0
66624,6604,1000.00,29000.00,30000.00,0.00,29000.00,0.28,1
66625,6604,1000.00,30000.00,31000.00,0.00,13885.30,0.22,1
66626,6604,1000.00,31000.00,32000.00,14189.41,16810.59,0.14,1
66627,6604,1000.00,32000.00,33000.00,0.00,32000.00,0.12,1
66628,6605,0.00,0.00,1000.00,0.00,0.00,0.02,0
66629,6605,-1000.00,-1000.00,0.00,187.68,812.32,0.06,0
66630,6606,-1000.00,-1000.00,0.00,397.57,602.43,0.19,0
66631,6607,-1000.00,-1000.00,0.00,160.13,684.21,0.37,0
66632,6608,-1000.00,-1000.00,0.00,472.54,527.46,0.05,0
66633,6609,-1000.00,-1000.00,0.00,382.72,617.28,0.20,0
66634,6610,-1000.00,-1000.00,0.00,408.28,591.72,0.18,0
66635,6611,-337.84,-337.84,662.16,0.00,337.84,0.05,0
66636,6611,-462.66,-800.50,199.50,0.00,462.66,0.10,0
66637,6611,-199.50,-1000.00,0.00,90.12,109.38,0.13,0
66638,6612,1000.00,1000.00,2000.00,0.00,704.65,0.15,1
66639,6612,1000.00,2000.00,3000.00,0.00,1222.25,0.26,1
66640,6612,1000.00,3000.00,4000.00,1096.72,1903.28,0.31,1
66641,6612,1000.00,4000.00,5000.00,103.69,3896.31,0.03,1
66642,6612,1000.00,5000.00,6000.00,2500.00,2500.00,0.05,1
66643,6612,1000.00,6000.00,7000.00,0.00,345.37,0.02,1
66644,6612,-1000.00,5000.00,6000.00,3793.12,3206.88,0.10,0
66645,6612,-1000.00,4000.00,5000.00,3220.74,2779.26,0.13,0
66646,6612,1000.00,5000.00,6000.00,2231.36,2768.64,0.06,1
66647,6612,1000.00,6000.00,7000.00,0.00,4763.17,0.41,1
66648,6612,1000.00,7000.00,8000.00,0.00,4606.52,0.36,1
66649,6612,1000.00,8000.00,9000.00,0.00,8000.00,0.05,1
66650,6612,1000.00,9000.00,10000.00,0.00,9000.00,0.40,1
66651,6612,0.00,9000.00,10000.00,0.00,0.00,0.04,0
66652,6612,1000.00,10000.00,11000.00,0.00,1546.98,0.07,1
66653,6612,1000.00,11000.00,12000.00,0.00,9276.22,0.42,1
66654,6612,-1000.00,10000.00,11000.00,1852.32,1760.36,0.16,0
66655,6612,1000.00,11000.00,12000.00,0.00,11000.00,0.38,1
66656,6612,1000.00,12000.00,13000.00,0.00,7375.17,0.20,1
66657,6612,1000.00,13000.00,14000.00,3873.88,7410.68,0.30,1
66658,6612,1000.00,14000.00,15000.00,1122.47,12877.53,0.44,1
66659,6612,1000.00,15000.00,16000.00,6859.47,8140.53,0.16,1
66660,6612,-1000.00,14000.00,15000.00,325.29,3808.84,0.20,0
66661,6612,-1000.00,13000.00,14000.00,0.00,9114.44,0.21,0
66662,6612,-1000.00,12000.00,13000.00,2923.36,11076.64,0.32,0
66663,6612,0.00,12000.00,13000.00,0.00,0.00,0.01,0
66664,6612,-1000.00,11000.00,12000.00,3866.48,9133.52,0.23,0
66665,6612,0.00,11000.00,12000.00,0.00,0.00,0.06,0
66666,6612,-1000.00,10000.00,11000.00,0.00,4889.37,0.24,0
66667,6612,-1000.00,9000.00,10000.00,0.00,2168.59,0.15,0
66668,6612,-1000.00,8000.00,9000.00,1438.93,8561.07,0.29,0
66669,6612,-1000.00,7000.00,8000.00,0.00,7163.03,0.39,0
66670,6612,-1000.00,6000.00,7000.00,4776.20,3223.80,0.08,0
66671,6612,-1000.00,5000.00,6000.00,0.00,5707.97,0.40,0
66672,6612,-1000.00,4000.00,5000.00,0.00,1205.53,0.18,0
66673,6612,-1000.00,3000.00,4000.00,0.00,5000.00,0.03,0
66674,6612,-1000.00,2000.00,3000.00,0.00,4000.00,0.29,0
66675,6612,-270.78,1729.22,2729.22,0.00,270.78,0.14,0
66676,6612,-1000.00,729.22,1729.22,0.00,2729.22,0.23,0
66677,6612,-1000.00,-270.78,729.22,0.00,1729.22,0.24,0
66678,6612,-344.04,-614.82,385.18,0.00,344.04,0.16,0
66679,6612,-385.18,-1000.00,0.00,192.59,192.59,0.01,0
66680,6613,-1000.00,-1000.00,0.00,645.33,0.00,0.13,0
66681,6614,-1000.00,-1000.00,0.00,33.29,966.71,0.25,0
66682,6615,1000.00,1000.00,2000.00,0.00,1000.00,0.33,1
66683,6615,-1000.00,0.00,1000.00,1329.53,670.47,0.11,0
66684,6615,1000.00,1000.00,2000.00,0.00,1000.00,0.23,1
66685,6615,1000.00,2000.00,3000.00,0.00,2000.00,0.01,1
66686,6615,1000.00,3000.00,4000.00,514.71,1564.05,0.31,1
66687,6615,1000.00,4000.00,5000.00,368.39,3631.61,0.25,1
66688,6615,-1000.00,3000.00,4000.00,2488.32,2511.68,0.05,0
66689,6615,-1000.00,2000.00,3000.00,0.00,2869.04,0.31,0
66690,6615,-1000.00,1000.00,2000.00,1753.85,1246.15,0.07,0
66691,6615,-1000.00,0.00,1000.00,0.00,1567.27,0.40,0
66692,6615,-1000.00,-1000.00,0.00,221.28,778.72,0.39,0
66693,6616,-804.25,-804.25,195.75,0.00,804.25,0.39,0
66694,6616,-195.75,-1000.00,-0.00,49.48,146.27,0.35,0
66695,6617,-1000.00,-1000.00,0.00,157.53,842.47,0.35,0
66696,6618,0.00,0.00,1000.00,0.00,0.00,0.29,0
66697,6618,-492.43,-492.43,507.57,0.00,492.43,0.07,0
66698,6618,1000.00,507.57,1507.57,296.70,210.87,0.01,1
66699,6618,-1000.00,-492.43,507.57,524.29,983.28,0.30,0
66700,6618,-507.57,-1000.00,0.00,125.21,382.35,0.07,0
66701,6619,1000.00,1000.00,2000.00,0.00,532.72,0.23,1
66702,6619,-892.74,107.26,1107.26,892.74,0.00,0.05,0
66703,6619,1000.00,1107.26,2107.26,72.31,756.22,0.38,1
66704,6619,1000.00,2107.26,3107.26,1053.63,1053.63,0.05,1
66705,6619,1000.00,3107.26,4107.26,1124.16,1983.10,0.27,1
66706,6619,1000.00,4107.26,5107.26,0.00,4107.26,0.01,1
66707,6619,1000.00,5107.26,6107.26,0.00,5107.26,0.05,1
66708,6619,1000.00,6107.26,7107.26,2697.59,3409.67,0.18,1
66709,6619,1000.00,7107.26,8107.26,0.00,1988.54,0.17,1
66710,6619,1000.00,8107.26,9107.26,0.00,5846.13,0.08,1
66711,6619,1000.00,9107.26,10107.26,0.00,9107.26,0.29,1
66712,6619,1000.00,10107.26,11107.26,0.00,10107.26,0.25,1
66713,6619,1000.00,11107.26,12107.26,0.00,11107.26,0.11,1
66714,6619,1000.00,12107.26,13107.26,2322.47,9784.79,0.36,1
66715,6619,1000.00,13107.26,14107.26,342.78,12260.04,0.44,1
66716,6619,1000.00,14107.26,15107.26,0.00,307.18,0.12,1
66717,6619,1000.00,15107.26,16107.26,2280.60,12826.66,0.14,1
66718,6619,1000.00,16107.26,17107.26,0.00,7944.46,0.28,1
66719,6619,1000.00,17107.26,18107.26,0.00,17107.26,0.15,1
66720,6619,1000.00,18107.26,19107.26,0.00,13701.95,0.32,1
66721,6619,0.00,18107.26,19107.26,0.00,0.00,0.02,0
66722,6619,1000.00,19107.26,20107.26,3248.79,15858.48,0.12,1
66723,6619,1000.00,20107.26,21107.26,0.00,12936.46,0.30,1
66724,6619,1000.00,21107.26,22107.26,10553.63,10553.63,0.02,1
66725,6619,1000.00,22107.26,23107.26,0.00,22107.26,0.38,1
66726,6619,1000.00,23107.26,24107.26,0.00,17017.01,0.10,1
66727,6619,1000.00,24107.26,25107.26,8420.94,15686.32,0.22,1
66728,6619,1000.00,25107.26,26107.26,0.00,25107.26,0.00,1
66729,6619,1000.00,26107.26,27107.26,0.00,25690.27,0.29,1
66730,6619,1000.00,27107.26,28107.26,0.00,9651.64,0.25,1
66731,6619,1000.00,28107.26,29107.26,0.00,10848.74,0.25,1
66732,6619,1000.00,29107.26,30107.26,7319.96,21787.30,0.31,1
66733,6619,-1000.00,28107.26,29107.26,15965.28,0.00,0.07,0
66734,6619,1000.00,29107.26,30107.26,5360.07,23747.19,0.23,1
66735,6619,1000.00,30107.26,31107.26,8574.85,21532.41,0.34,1
66736,6619,1000.00,31107.26,32107.26,0.00,21152.20,0.38,1
66737,6619,1000.00,32107.26,33107.26,474.94,12889.99,0.27,1
66738,6619,1000.00,33107.26,34107.26,1671.62,31435.65,0.26,1
66739,6619,1000.00,34107.26,35107.26,0.00,34107.26,0.07,1
66740,6619,1000.00,35107.26,36107.26,16085.64,19021.62,0.21,1
66741,6620,-1000.00,-1000.00,0.00,826.63,0.00,0.12,0
66742,6621,-1000.00,-1000.00,0.00,0.00,1000.00,0.29,0
66743,6622,-820.61,-820.61,179.39,119.99,700.62,0.38,0
66744,6622,-110.03,-930.63,69.37,0.00,110.03,0.28,0
66745,6622,-59.43,-990.06,9.94,13.16,46.27,0.36,0
66746,6622,-8.89,-998.95,1.05,0.00,8.89,0.01,0
66747,6622,-1.05,-1000.00,0.00,0.11,0.94,0.35,0
66748,6623,-434.11,-434.11,565.89,0.00,434.11,0.23,0
66749,6623,0.00,-434.11,565.89,0.00,0.00,0.03,0
66750,6623,-231.73,-665.84,334.16,91.75,139.98,0.19,0
66751,6623,-334.16,-1000.00,0.00,149.70,184.46,0.22,0
66752,6624,1000.00,1000.00,2000.00,80.08,735.28,0.40,1
66753,6624,1000.00,2000.00,3000.00,0.00,2000.00,0.28,1
66754,6624,0.00,2000.00,3000.00,0.00,0.00,0.02,0
66755,6624,1000.00,3000.00,4000.00,74.39,2918.61,0.44,1
66756,6624,1000.00,4000.00,5000.00,1162.74,2837.26,0.34,1
66757,6624,1000.00,5000.00,6000.00,0.00,5000.00,0.05,1
66758,6624,1000.00,6000.00,7000.00,2134.63,3865.37,0.32,1
66759,6624,1000.00,7000.00,8000.00,2003.98,4996.02,0.20,1
66760,6624,-1000.00,6000.00,7000.00,4549.55,3450.45,0.08,0
66761,6624,1000.00,7000.00,8000.00,0.00,7000.00,0.08,1
66762,6624,1000.00,8000.00,9000.00,659.31,3813.90,0.30,1
66763,6624,1000.00,9000.00,10000.00,0.00,1664.74,0.17,1
66764,6624,1000.00,10000.00,11000.00,905.87,9094.13,0.43,1
66765,6624,1000.00,11000.00,12000.00,4966.46,6033.54,0.17,1
66766,6624,1000.00,12000.00,13000.00,0.00,7043.94,0.19,1
66767,6624,-1000.00,11000.00,12000.00,13000.00,0.00,0.01,0
66768,6624,1000.00,12000.00,13000.00,0.00,12000.00,0.30,1
66769,6624,1000.00,13000.00,14000.00,0.00,12280.15,0.44,1
66770,6624,1000.00,14000.00,15000.00,5880.94,8119.06,0.13,1
66771,6624,1000.00,15000.00,16000.00,0.00,15000.00,0.01,1
66772,6624,1000.00,16000.00,17000.00,6819.40,9180.60,0.27,1
66773,6624,1000.00,17000.00,18000.00,0.00,3519.52,0.18,1
66774,6624,1000.00,18000.00,19000.00,0.00,18000.00,0.31,1
66775,6624,0.00,18000.00,19000.00,0.00,0.00,0.01,0
66776,6624,1000.00,19000.00,20000.00,0.00,19000.00,0.15,1
66777,6624,1000.00,20000.00,21000.00,6824.26,7339.49,0.22,1
66778,6624,-1000.00,19000.00,20000.00,10740.22,10259.78,0.06,0
66779,6624,-1000.00,18000.00,19000.00,11811.19,8188.81,0.13,0
66780,6624,1000.00,19000.00,20000.00,0.00,7883.17,0.14,1
66781,6624,1000.00,20000.00,21000.00,0.00,18624.00,0.16,1
66782,6624,1000.00,21000.00,22000.00,3055.40,17944.60,0.42,1
66783,6624,1000.00,22000.00,23000.00,0.00,16359.77,0.40,1
66784,6624,1000.00,23000.00,24000.00,0.00,5455.74,0.11,1
66785,6624,1000.00,24000.00,25000.00,0.00,24000.00,0.37,1
66786,6624,1000.00,25000.00,26000.00,0.00,7000.20,0.20,1
66787,6624,1000.00,26000.00,27000.00,0.00,21891.47,0.42,1
66788,6624,1000.00,27000.00,28000.00,0.00,791.38,0.10,1
66789,6624,1000.00,28000.00,29000.00,2777.72,18449.80,0.37,1
66790,6624,-1000.00,27000.00,28000.00,6903.31,0.00,0.04,0
66791,6624,-1000.00,26000.00,27000.00,7656.52,0.00,0.04,0
66792,6624,1000.00,27000.00,28000.00,0.00,27000.00,0.13,1
66793,6624,1000.00,28000.00,29000.00,14000.00,14000.00,0.05,1
66794,6624,1000.00,29000.00,30000.00,9031.86,19968.14,0.35,1
66795,6624,1000.00,30000.00,31000.00,0.00,20659.98,0.37,1
66796,6624,1000.00,31000.00,32000.00,0.00,31000.00,0.15,1
66797,6624,-1000.00,30000.00,31000.00,26639.60,5222.90,0.06,0
66798,6625,1000.00,1000.00,2000.00,606.20,338.18,0.14,1
66799,6625,-721.47,278.53,1278.53,0.00,721.47,0.25,0
66800,6625,-1000.00,-721.47,278.53,101.83,1040.53,0.42,0
66801,6625,-278.53,-1000.00,0.00,0.00,278.53,0.39,0
66802,6626,-976.69,-976.69,23.31,97.75,878.94,0.43,0
66803,6626,-23.31,-1000.00,0.00,0.00,23.31,0.23,0
66804,6627,-1000.00,-1000.00,0.00,0.00,1000.00,0.43,0
66805,6628,1000.00,1000.00,2000.00,0.00,1000.00,0.01,1
66806,6628,1000.00,2000.00,3000.00,863.08,1136.92,0.20,1
66807,6628,1000.00,3000.00,4000.00,0.00,1906.40,0.35,1
66808,6628,-750.29,2249.71,3249.71,750.29,0.00,0.04,0
66809,6628,1000.00,3249.71,4249.71,1374.02,1875.69,0.27,1
66810,6628,1000.00,4249.71,5249.71,0.00,4249.71,0.03,1
66811,6628,1000.00,5249.71,6249.71,0.00,5249.71,0.43,1
66812,6628,1000.00,6249.71,7249.71,0.00,6249.71,0.43,1
66813,6628,-1000.00,5249.71,6249.71,4126.12,3123.59,0.15,0
66814,6628,1000.00,6249.71,7249.71,0.00,5936.85,0.24,1
66815,6628,1000.00,7249.71,8249.71,1564.07,3573.04,0.29,1
66816,6628,1000.00,8249.71,9249.71,2194.95,4088.29,0.28,1
66817,6628,-1000.00,7249.71,8249.71,0.00,1543.42,0.15,0
66818,6628,-1000.00,6249.71,7249.71,4711.66,3538.05,0.09,0
66819,6628,-1000.00,5249.71,6249.71,0.00,7249.71,0.34,0
66820,6628,-1000.00,4249.71,5249.71,3747.97,2501.73,0.08,0
66821,6628,-1000.00,3249.71,4249.71,1348.97,3900.74,0.38,0
66822,6628,-1000.00,2249.71,3249.71,0.00,4249.71,0.09,0
66823,6628,-1000.00,1249.71,2249.71,0.00,1937.54,0.33,0
66824,6628,-1000.00,249.71,1249.71,0.00,992.42,0.27,0
66825,6628,-1000.00,-750.29,249.71,0.00,1249.71,0.40,0
66826,6628,-85.64,-835.94,164.06,0.00,85.64,0.13,0
66827,6628,0.00,-835.94,164.06,0.00,0.00,0.35,0
66828,6628,-164.06,-1000.00,0.00,0.00,164.06,0.28,0
66829,6629,-1000.00,-1000.00,0.00,89.80,910.20,0.44,0
66830,6630,-1000.00,-1000.00,0.00,411.10,588.90,0.22,0
66831,6631,0.00,0.00,1000.00,0.00,0.00,0.30,0
66832,6631,-1000.00,-1000.00,0.00,562.63,437.37,0.10,0
66833,6632,-13.63,-13.63,986.37,0.00,13.63,0.31,0
66834,6632,-351.99,-365.62,634.38,117.80,234.19,0.40,0
66835,6632,0.00,-365.62,634.38,0.00,0.00,0.04,0
66836,6632,-57.10,-422.72,577.28,0.00,57.10,0.03,0
66837,6632,0.00,-422.72,577.28,0.00,0.00,0.41,0
66838,6632,0.00,-422.72,577.28,0.00,0.00,0.26,0
66839,6632,-527.95,-950.67,49.33,27.12,500.83,0.30,0
66840,6632,-49.33,-1000.00,0.00,23.95,25.38,0.09,0
66841,6633,1000.00,1000.00,2000.00,369.49,630.51,0.24,1
66842,6633,1000.00,2000.00,3000.00,0.00,2000.00,0.25,1
66843,6633,1000.00,3000.00,4000.00,1349.36,1650.64,0.24,1
66844,6633,1000.00,4000.00,5000.00,1097.86,2902.14,0.12,1
66845,6633,1000.00,5000.00,6000.00,0.00,1018.19,0.12,1
66846,6633,-1000.00,4000.00,5000.00,3917.25,2082.75,0.09,0
66847,6633,1000.00,5000.00,6000.00,1807.74,3192.26,0.02,1
66848,6633,1000.00,6000.00,7000.00,749.66,2970.75,0.30,1
66849,6633,1000.00,7000.00,8000.00,1063.77,5936.23,0.34,1
66850,6633,1000.00,8000.00,9000.00,0.00,8000.00,0.22,1
66851,6633,1000.00,9000.00,10000.00,0.00,2286.53,0.20,1
66852,6633,1000.00,10000.00,11000.00,0.00,10000.00,0.21,1
66853,6633,1000.00,11000.00,12000.00,3174.81,7825.19,0.35,1
66854,6633,1000.00,12000.00,13000.00,0.00,11555.57,0.32,1
66855,6633,1000.00,13000.00,14000.00,0.00,13000.00,0.13,1
66856,6633,-1000.00,12000.00,13000.00,8726.42,927.50,0.08,0
66857,6633,1000.00,13000.00,14000.00,0.00,13000.00,0.38,1
66858,6633,1000.00,14000.00,15000.00,254.74,13745.26,0.44,1
66859,6633,1000.00,15000.00,16000.00,0.00,15000.00,0.18,1
66860,6633,1000.00,16000.00,17000.00,0.00,3600.50,0.18,1
66861,6633,1000.00,17000.00,18000.00,0.00,17000.00,0.10,1
66862,6633,-1000.00,16000.00,17000.00,8853.45,8812.47,0.22,0
66863,6633,1000.00,17000.00,18000.00,0.00,17000.00,0.13,1
66864,6633,0.00,17000.00,18000.00,0.00,0.00,0.01,0
66865,6633,-1000.00,16000.00,17000.00,0.00,18000.00,0.10,0
66866,6633,-1000.00,15000.00,16000.00,0.00,17000.00,0.13,0
66867,6633,-1000.00,14000.00,15000.00,0.00,10389.57,0.19,0
66868,6633,-1000.00,13000.00,14000.00,0.00,12534.40,0.26,0
66869,6633,-1000.00,12000.00,13000.00,0.00,14000.00,0.31,0
66870,6633,-1000.00,11000.00,12000.00,907.34,12092.66,0.32,0
66871,6633,-1000.00,10000.00,11000.00,0.00,12000.00,0.40,0
66872,6633,-1000.00,9000.00,10000.00,0.00,3318.82,0.15,0
66873,6633,-1000.00,8000.00,9000.00,0.00,10000.00,0.39,0
66874,6633,-1000.00,7000.00,8000.00,0.00,8025.85,0.07,0
66875,6633,-1000.00,6000.00,7000.00,0.00,8000.00,0.34,0
66876,6633,-1000.00,5000.00,6000.00,0.00,5858.75,0.19,0
66877,6633,-1000.00,4000.00,5000.00,3864.09,2135.91,0.12,0
66878,6633,-1000.00,3000.00,4000.00,0.00,5000.00,0.22,0
66879,6633,-1000.00,2000.00,3000.00,960.82,3039.18,0.05,0
66880,6633,-1000.00,1000.00,2000.00,331.61,2668.39,0.43,0
66881,6633,-1000.00,0.00,1000.00,125.52,963.51,0.30,0
66882,6633,0.00,0.00,1000.00,0.00,0.00,0.00,0
66883,6633,-1000.00,-1000.00,0.00,0.00,1000.00,0.03,0
66884,6634,-246.28,-246.28,753.72,231.11,15.17,0.11,0
66885,6634,-1000.00,-1246.28,-246.28,343.13,410.59,0.14,0
66886,6635,-1000.00,-1000.00,0.00,1000.00,0.00,0.00,0
66887,6636,-1000.00,-1000.00,0.00,413.02,586.98,0.27,0
66888,6637,1000.00,1000.00,2000.00,0.00,591.74,0.25,1
66889,6637,0.00,1000.00,2000.00,0.00,0.00,0.03,0
66890,6637,0.00,1000.00,2000.00,0.00,0.00,0.06,0
66891,6637,1000.00,2000.00,3000.00,0.00,2000.00,0.00,1
66892,6637,1000.00,3000.00,4000.00,0.00,3000.00,0.42,1
66893,6637,1000.00,4000.00,5000.00,1036.51,2739.85,0.35,1
66894,6637,1000.00,5000.00,6000.00,0.00,4366.65,0.42,1
66895,6637,1000.00,6000.00,7000.00,0.00,2323.77,0.26,1
66896,6637,1000.00,7000.00,8000.00,2365.98,4634.02,0.24,1
66897,6637,1000.00,8000.00,9000.00,2436.59,5563.41,0.05,1
66898,6637,1000.00,9000.00,10000.00,533.84,8466.16,0.44,1
66899,6637,1000.00,10000.00,11000.00,2541.56,7458.44,0.38,1
66900,6637,1000.00,11000.00,12000.00,2382.12,8615.71,0.39,1
66901,6637,1000.00,12000.00,13000.00,4480.05,7519.95,0.29,1
66902,6637,1000.00,13000.00,14000.00,4719.85,8280.15,0.28,1
66903,6637,-1000.00,12000.00,13000.00,6233.73,0.00,0.08,0
66904,6637,1000.00,13000.00,14000.00,3021.98,6582.09,0.29,1
66905,6637,1000.00,14000.00,15000.00,2445.70,11554.30,0.32,1
66906,6637,1000.00,15000.00,16000.00,4634.34,10365.66,0.33,1
66907,6637,1000.00,16000.00,17000.00,4816.60,11183.40,0.35,1
66908,6637,-1000.00,15000.00,16000.00,2397.76,2227.56,0.15,0
66909,6637,-1000.00,14000.00,15000.00,0.00,16000.00,0.10,0
66910,6637,-1000.00,13000.00,14000.00,3192.33,11807.67,0.40,0
66911,6637,-1000.00,12000.00,13000.00,357.06,13642.94,0.39,0
66912,6637,-1000.00,11000.00,12000.00,6724.99,6275.01,0.03,0
66913,6637,-1000.00,10000.00,11000.00,0.00,12000.00,0.24,0
66914,6637,-1000.00,9000.00,10000.00,3814.36,7185.64,0.07,0
66915,6637,-1000.00,8000.00,9000.00,0.00,6974.70,0.16,0
66916,6637,-1000.00,7000.00,8000.00,0.00,5742.55,0.28,0
66917,6637,-1000.00,6000.00,7000.00,2774.30,5225.70,0.25,0
66918,6637,-1000.00,5000.00,6000.00,0.00,5850.95,0.32,0
66919,6637,-1000.00,4000.00,5000.00,556.45,5443.55,0.44,0
66920,6637,-1000.00,3000.00,4000.00,569.53,4430.47,0.21,0
66921,6637,-334.95,2665.05,3665.05,0.00,334.95,0.12,0
66922,6637,-1000.00,1665.05,2665.05,734.51,2930.53,0.40,0
66923,6637,-1000.00,665.05,1665.05,1503.43,279.32,0.09,0
66924,6637,-1000.00,-334.95,665.05,0.00,1665.05,0.19,0
66925,6637,-665.05,-1000.00,0.00,0.00,665.05,0.24,0
66926,6638,-1000.00,-1000.00,0.00,393.07,606.93,0.07,0
66927,6639,-1000.00,-1000.00,0.00,500.00,500.00,0.04,0
66928,6640,-19.88,-19.88,980.12,0.00,19.88,0.04,0
66929,6640,-980.12,-1000.00,0.00,0.00,980.12,0.28,0
66930,6641,1000.00,1000.00,2000.00,952.17,47.83,0.09,1
66931,6641,-699.73,300.27,1300.27,0.00,699.73,0.37,0
66932,6641,-1000.00,-699.73,300.27,298.15,1002.12,0.35,0
66933,6641,0.00,-699.73,300.27,0.00,0.00,0.43,0
66934,6641,-300.27,-1000.00,0.00,0.00,300.27,0.08,0
66935,6642,-1000.00,-1000.00,0.00,106.80,893.20,0.27,0
66936,6643,1000.00,1000.00,2000.00,770.72,153.48,0.19,1
66937,6643,0.00,1000.00,2000.00,0.00,0.00,0.35,0
66938,6643,-1000.00,0.00,1000.00,0.00,1261.33,0.16,0
66939,6643,-915.76,-915.76,84.24,0.00,915.76,0.32,0
66940,6643,-72.73,-988.48,11.52,0.00,72.73,0.40,0
66941,6643,-11.52,-1000.00,0.00,0.00,11.52,0.24,0
66942,6644,-580.98,-580.98,419.02,0.00,580.98,0.30,0
66943,6644,-419.02,-1000.00,0.00,196.74,222.27,0.23,0
66944,6645,0.00,0.00,1000.00,0.00,0.00,0.05,0
66945,6645,1000.00,1000.00,2000.00,39.47,0.00,0.20,1
66946,6645,0.00,1000.00,2000.00,0.00,0.00,0.01,0
66947,6645,-1000.00,0.00,1000.00,962.74,1037.26,0.13,0
66948,6645,-649.95,-649.95,350.05,0.00,649.95,0.28,0
66949,6645,-350.05,-1000.00,0.00,0.00,350.05,0.05,0
66950,6646,-1000.00,-1000.00,0.00,0.00,454.83,0.00,0
66951,6647,-1000.00,-1000.00,0.00,0.00,1000.00,0.23,0
66952,6648,1000.00,1000.00,2000.00,21.44,978.56,0.17,1
66953,6648,1000.00,2000.00,3000.00,0.00,1951.71,0.09,1
66954,6648,1000.00,3000.00,4000.00,0.00,3000.00,0.32,1
66955,6648,1000.00,4000.00,5000.00,0.00,4000.00,0.13,1
66956,6648,1000.00,5000.00,6000.00,177.50,3401.90,0.38,1
66957,6648,1000.00,6000.00,7000.00,1012.29,4987.71,0.41,1
66958,6648,1000.00,7000.00,8000.00,1098.77,2456.16,0.24,1
66959,6648,1000.00,8000.00,9000.00,0.00,6560.42,0.16,1
66960,6648,1000.00,9000.00,10000.00,0.00,9000.00,0.17,1
66961,6648,1000.00,10000.00,11000.00,0.00,7383.73,0.40,1
66962,6648,1000.00,11000.00,12000.00,0.00,11000.00,0.07,1
66963,6648,1000.00,12000.00,13000.00,0.00,12000.00,0.35,1
66964,6648,1000.00,13000.00,14000.00,1295.81,11704.19,0.22,1
66965,6648,1000.00,14000.00,15000.00,6039.91,7960.09,0.23,1
66966,6648,1000.00,15000.00,16000.00,6338.46,8661.54,0.27,1
66967,6648,1000.00,16000.00,17000.00,7449.90,8550.10,0.15,1
66968,6648,1000.00,17000.00,18000.00,2314.09,14685.91,0.38,1
66969,6648,1000.00,18000.00,19000.00,0.00,18000.00,0.25,1
66970,6648,-1000.00,17000.00,18000.00,12652.75,6347.25,0.11,0
66971,6648,1000.00,18000.00,19000.00,0.00,18000.00,0.31,1
66972,6648,-1000.00,17000.00,18000.00,10317.68,4454.36,0.13,0
66973,6648,1000.00,18000.00,19000.00,0.00,10239.09,0.18,1
66974,6648,1000.00,19000.00,20000.00,0.00,10962.84,0.31,1
66975,6648,-1000.00,18000.00,19000.00,10267.47,9732.53,0.08,0
66976,6648,0.00,18000.00,19000.00,0.00,0.00,0.03,0
66977,6648,1000.00,19000.00,20000.00,506.16,10549.14,0.34,1
66978,6648,1000.00,20000.00,21000.00,4572.75,15427.25,0.37,1
66979,6648,1000.00,21000.00,22000.00,0.00,11130.95,0.23,1
66980,6648,1000.00,22000.00,23000.00,6038.26,15961.74,0.36,1
66981,6648,1000.00,23000.00,24000.00,7750.42,15249.58,0.27,1
66982,6648,-1000.00,22000.00,23000.00,14351.51,9648.49,0.16,0
66983,6648,1000.00,23000.00,24000.00,0.00,23000.00,0.20,1
66984,6648,1000.00,24000.00,25000.00,3532.20,19510.25,0.41,1
66985,6648,1000.00,25000.00,26000.00,0.00,25000.00,0.09,1
66986,6648,-1000.00,24000.00,25000.00,13832.88,0.00,0.00,0
66987,6648,1000.00,25000.00,26000.00,12500.00,12500.00,0.00,1
66988,6648,-1000.00,24000.00,25000.00,13148.82,12851.18,0.15,0
66989,6648,1000.00,25000.00,26000.00,0.00,2626.45,0.09,1
66990,6648,-1000.00,24000.00,25000.00,14747.32,11252.68,0.00,0
66991,6648,1000.00,25000.00,26000.00,9375.54,15624.46,0.20,1
66992,6648,1000.00,26000.00,27000.00,0.00,23863.26,0.30,1
66993,6649,-1000.00,-1000.00,0.00,500.00,500.00,0.04,0
66994,6650,-1000.00,-1000.00,0.00,0.00,546.44,0.30,0
66995,6651,-1000.00,-1000.00,0.00,110.48,889.52,0.43,0
66996,6652,-1000.00,-1000.00,0.00,0.00,1000.00,0.09,0
66997,6653,-806.82,-806.82,193.18,0.00,806.82,0.37,0
66998,6653,-193.18,-1000.00,0.00,0.00,193.18,0.09,0
66999,6654,-366.96,-366.96,633.04,0.00,366.96,0.26,0
67000,6654,-633.04,-1000.00,0.00,9.42,623.62,0.31,0
67001,6654,-0.00,-1000.00,0.00,0.00,0.00,0.01,0
67002,6655,-1000.00,-1000.00,0.00,500.00,500.00,0.02,0
67003,6656,-1000.00,-1000.00,0.00,0.00,480.12,0.27,0
67004,6657,-1000.00,-1000.00,0.00,0.00,1000.00,0.41,0
67005,6658,1000.00,1000.00,2000.00,53.13,946.87,0.28,1
67006,6658,1000.00,2000.00,3000.00,849.34,1150.66,0.16,1
67007,6658,1000.00,3000.00,4000.00,0.00,1837.42,0.21,1
67008,6658,1000.00,4000.00,5000.00,562.74,639.76,0.16,1
67009,6658,1000.00,5000.00,6000.00,0.00,1913.26,0.11,1
67010,6658,1000.00,6000.00,7000.00,0.00,4275.79,0.31,1
67011,6658,-1000.00,5000.00,6000.00,3876.86,0.00,0.05,0
67012,6658,1000.00,6000.00,7000.00,0.00,4734.54,0.38,1
67013,6658,1000.00,7000.00,8000.00,2365.12,4634.88,0.11,1
67014,6658,1000.00,8000.00,9000.00,2751.98,5248.02,0.27,1
67015,6658,1000.00,9000.00,10000.00,0.00,9000.00,0.27,1
67016,6658,1000.00,10000.00,11000.00,0.00,10000.00,0.35,1
67017,6658,0.00,10000.00,11000.00,0.00,0.00,0.01,0
67018,6658,1000.00,11000.00,12000.00,4886.96,6113.04,0.22,1
67019,6658,1000.00,12000.00,13000.00,5343.91,6656.09,0.22,1
67020,6658,1000.00,13000.00,14000.00,0.00,10288.28,0.38,1
67021,6658,1000.00,14000.00,15000.00,6734.95,7265.05,0.07,1
67022,6658,1000.00,15000.00,16000.00,0.00,12305.92,0.18,1
67023,6658,1000.00,16000.00,17000.00,0.00,16000.00,0.29,1
67024,6658,0.00,16000.00,17000.00,0.00,0.00,0.06,0
67025,6658,1000.00,17000.00,18000.00,3723.51,13276.49,0.26,1
67026,6658,1000.00,18000.00,19000.00,9000.00,9000.00,0.08,1
67027,6658,1000.00,19000.00,20000.00,0.00,19000.00,0.17,1
67028,6658,1000.00,20000.00,21000.00,2902.93,17097.07,0.09,1
67029,6658,1000.00,21000.00,22000.00,5090.26,15909.74,0.27,1
67030,6658,1000.00,22000.00,23000.00,5543.67,16456.33,0.10,1
67031,6658,-1000.00,21000.00,22000.00,0.00,20553.63,0.32,0
67032,6658,-1000.00,20000.00,21000.00,0.00,18565.86,0.25,0
67033,6658,-1000.00,19000.00,20000.00,15926.81,856.18,0.06,0
67034,6658,0.00,19000.00,20000.00,0.00,0.00,0.01,0
67035,6658,-1000.00,18000.00,19000.00,10318.65,0.00,0.06,0
67036,6658,-1000.00,17000.00,18000.00,10250.32,8749.68,0.07,0
67037,6658,-1000.00,16000.00,17000.00,9901.84,8098.16,0.12,0
67038,6658,-1000.00,15000.00,16000.00,1330.33,12589.40,0.40,0
67039,6658,-1000.00,14000.00,15000.00,0.00,13876.17,0.43,0
67040,6658,-1000.00,13000.00,14000.00,7070.74,7929.26,0.04,0
67041,6658,-1000.00,12000.00,13000.00,0.00,14000.00,0.07,0
67042,6658,-1000.00,11000.00,12000.00,5192.19,7807.81,0.29,0
67043,6658,-1000.00,10000.00,11000.00,0.00,8476.21,0.39,0
67044,6658,-1000.00,9000.00,10000.00,2097.03,8902.97,0.41,0
67045,6658,-1000.00,8000.00,9000.00,0.00,6591.68,0.30,0
67046,6658,-1000.00,7000.00,8000.00,4090.33,1753.25,0.13,0
67047,6658,-1000.00,6000.00,7000.00,2148.17,2898.56,0.23,0
67048,6658,-1000.00,5000.00,6000.00,4579.81,2420.19,0.12,0
67049,6658,-1000.00,4000.00,5000.00,0.00,6000.00,0.22,0
67050,6659,-206.75,-206.75,793.25,0.00,206.75,0.11,0
67051,6659,-793.25,-1000.00,0.00,215.98,577.27,0.29,0
67052,6660,-692.31,-692.31,307.69,57.80,634.51,0.37,0
67053,6660,-307.69,-1000.00,0.00,36.62,271.07,0.36,0
67054,6661,1000.00,1000.00,2000.00,102.15,897.85,0.41,1
67055,6661,1000.00,2000.00,3000.00,709.43,1290.57,0.06,1
67056,6661,1000.00,3000.00,4000.00,999.80,2000.20,0.28,1
67057,6661,1000.00,4000.00,5000.00,652.21,3347.79,0.42,1
67058,6661,1000.00,5000.00,6000.00,0.00,2456.29,0.30,1
67059,6661,-1000.00,4000.00,5000.00,4837.82,1050.05,0.07,0
67060,6661,-1000.00,3000.00,4000.00,4229.18,11.49,0.04,0
67061,6661,1000.00,4000.00,5000.00,0.00,3707.92,0.37,1
67062,6661,1000.00,5000.00,6000.00,0.00,5000.00,0.32,1
67063,6661,1000.00,6000.00,7000.00,0.00,4054.97,0.15,1
67064,6661,1000.00,7000.00,8000.00,3500.00,3500.00,0.01,1
67065,6661,-1000.00,6000.00,7000.00,2814.31,0.00,0.06,0
67066,6661,1000.00,7000.00,8000.00,0.00,6968.54,0.26,1
67067,6661,1000.00,8000.00,9000.00,0.00,7257.49,0.42,1
67068,6661,1000.00,9000.00,10000.00,2603.06,6396.94,0.08,1
67069,6661,1000.00,10000.00,11000.00,0.00,10000.00,0.19,1
67070,6661,1000.00,11000.00,12000.00,4770.08,6229.92,0.23,1
67071,6661,1000.00,12000.00,13000.00,0.00,8844.76,0.40,1
67072,6661,1000.00,13000.00,14000.00,0.00,13000.00,0.11,1
67073,6661,1000.00,14000.00,15000.00,4196.17,9803.83,0.21,1
67074,6661,-1000.00,13000.00,14000.00,15000.00,0.00,0.01,0
67075,6661,1000.00,14000.00,15000.00,2983.16,11016.84,0.40,1
67076,6661,1000.00,15000.00,16000.00,0.00,15000.00,0.24,1
67077,6661,1000.00,16000.00,17000.00,1386.11,14613.89,0.36,1
67078,6661,0.00,16000.00,17000.00,0.00,0.00,0.10,0
67079,6661,-1000.00,15000.00,16000.00,0.00,5783.48,0.20,0
67080,6661,-1000.00,14000.00,15000.00,0.00,16000.00,0.34,0
67081,6661,-1000.00,13000.00,14000.00,3455.96,8708.94,0.32,0
67082,6661,-1000.00,12000.00,13000.00,528.23,13471.77,0.31,0
67083,6661,-1000.00,11000.00,12000.00,2109.83,2040.74,0.16,0
67084,6661,-1000.00,10000.00,11000.00,0.00,9157.62,0.31,0
67085,6661,-1000.00,9000.00,10000.00,2949.79,4278.16,0.24,0
67086,6661,-1000.00,8000.00,9000.00,0.00,10000.00,0.28,0
67087,6661,-1000.00,7000.00,8000.00,0.00,2096.92,0.15,0
67088,6661,-1000.00,6000.00,7000.00,1636.84,6363.16,0.39,0
67089,6661,-1000.00,5000.00,6000.00,1364.85,5635.15,0.40,0
67090,6661,-1000.00,4000.00,5000.00,0.00,5300.26,0.29,0
67091,6661,-1000.00,3000.00,4000.00,0.00,3557.97,0.39,0
67092,6661,-1000.00,2000.00,3000.00,1735.27,2264.73,0.24,0
67093,6661,-1000.00,1000.00,2000.00,268.20,2731.80,0.35,0
67094,6661,-1000.00,0.00,1000.00,1000.00,1000.00,0.08,0
67095,6661,-1000.00,-1000.00,0.00,223.79,776.21,0.38,0
67096,6662,-1000.00,-1000.00,0.00,0.00,1000.00,0.02,0
67097,6663,-449.90,-449.90,550.10,0.00,449.90,0.32,0
67098,6663,-111.54,-561.44,438.56,40.17,71.37,0.43,0
67099,6663,0.00,-561.44,438.56,0.00,0.00,0.26,0
67100,6663,-438.56,-1000.00,0.00,155.12,283.44,0.29,0
67101,6664,-547.46,-547.46,452.54,547.46,0.00,0.29,0
67102,6664,0.00,-547.46,452.54,0.00,0.00,0.01,0
67103,6664,-0.98,-548.43,451.57,0.98,0.00,0.38,0
67104,6664,-1000.00,-1548.43,-548.43,194.63,256.94,0.16,0
67105,6665,-590.55,-590.55,409.45,0.00,590.55,0.27,0
67106,6665,0.00,-590.55,409.45,0.00,0.00,0.22,0
67107,6665,-11.30,-601.84,398.16,0.00,11.30,0.22,0
67108,6665,-398.16,-1000.00,0.00,158.91,239.24,0.23,0
67109,6666,-157.12,-157.12,842.88,157.12,0.00,0.42,0
67110,6666,-299.70,-456.81,543.19,299.70,0.00,0.13,0
67111,6666,-1000.00,-1456.81,-456.81,0.00,315.55,0.04,0
67112,6667,-1000.00,-1000.00,0.00,433.96,566.04,0.26,0
67113,6667,-0.00,-1000.00,0.00,0.00,0.00,0.35,0
67114,6668,1000.00,1000.00,2000.00,469.55,530.45,0.24,1
67115,6668,1000.00,2000.00,3000.00,0.00,1271.94,0.14,1
67116,6668,1000.00,3000.00,4000.00,905.94,2094.06,0.34,1
67117,6668,1000.00,4000.00,5000.00,0.00,4000.00,0.02,1
67118,6668,1000.00,5000.00,6000.00,0.00,5000.00,0.26,1
67119,6668,-1000.00,4000.00,5000.00,3299.26,2700.74,0.18,0
67120,6668,0.00,4000.00,5000.00,0.00,0.00,0.05,0
67121,6668,1000.00,5000.00,6000.00,0.00,5000.00,0.42,1
67122,6668,1000.00,6000.00,7000.00,2262.20,3737.80,0.29,1
67123,6668,1000.00,7000.00,8000.00,2701.12,4298.88,0.15,1
67124,6668,1000.00,8000.00,9000.00,4000.00,4000.00,0.06,1
67125,6668,1000.00,9000.00,10000.00,2401.42,6598.58,0.36,1
67126,6668,1000.00,10000.00,11000.00,4209.45,5790.55,0.23,1
67127,6668,1000.00,11000.00,12000.00,2323.61,8676.39,0.33,1
67128,6668,1000.00,12000.00,13000.00,4598.52,7401.48,0.24,1
67129,6668,1000.00,13000.00,14000.00,0.00,6205.37,0.28,1
67130,6668,1000.00,14000.00,15000.00,0.00,13338.97,0.40,1
67131,6668,1000.00,15000.00,16000.00,6727.07,8272.93,0.07,1
67132,6668,1000.00,16000.00,17000.00,0.00,13197.58,0.23,1
67133,6668,1000.00,17000.00,18000.00,6098.98,10901.02,0.29,1
67134,6668,1000.00,18000.00,19000.00,0.00,5826.81,0.22,1
67135,6668,1000.00,19000.00,20000.00,0.00,10605.65,0.09,1
67136,6668,1000.00,20000.00,21000.00,7637.57,12362.43,0.30,1
67137,6668,1000.00,21000.00,22000.00,1483.74,19516.26,0.30,1
67138,6668,1000.00,22000.00,23000.00,4964.83,17035.17,0.39,1
67139,6668,1000.00,23000.00,24000.00,3853.35,19146.65,0.42,1
67140,6668,1000.00,24000.00,25000.00,0.00,24000.00,0.22,1
67141,6668,1000.00,25000.00,26000.00,0.00,19427.00,0.40,1
67142,6668,1000.00,26000.00,27000.00,0.00,26000.00,0.34,1
67143,6668,-1000.00,25000.00,26000.00,20599.08,5815.78,0.08,0
67144,6668,1000.00,26000.00,27000.00,0.00,9328.47,0.01,1
67145,6668,1000.00,27000.00,28000.00,0.00,27000.00,0.10,1
67146,6668,1000.00,28000.00,29000.00,13624.55,14375.45,0.16,1
67147,6668,1000.00,29000.00,30000.00,4236.31,12187.05,0.27,1
67148,6668,1000.00,30000.00,31000.00,0.00,16362.81,0.17,1
67149,6668,1000.00,31000.00,32000.00,0.00,11809.41,0.23,1
67150,6668,1000.00,32000.00,33000.00,0.00,32000.00,0.25,1
67151,6668,1000.00,33000.00,34000.00,0.00,32018.79,0.09,1
67152,6669,-1000.00,-1000.00,0.00,622.74,228.71,0.11,0
67153,6670,-1000.00,-1000.00,0.00,141.66,835.69,0.41,0
67154,6671,-1000.00,-1000.00,0.00,410.65,589.35,0.25,0
67155,6672,1000.00,1000.00,2000.00,70.29,505.75,0.31,1
67156,6672,-1000.00,0.00,1000.00,1874.53,125.47,0.02,0
67157,6672,1000.00,1000.00,2000.00,0.00,1000.00,0.05,1
67158,6672,1000.00,2000.00,3000.00,0.00,2000.00,0.34,1
67159,6672,1000.00,3000.00,4000.00,0.00,2953.76,0.44,1
67160,6672,1000.00,4000.00,5000.00,0.00,3270.70,0.25,1
67161,6672,-1000.00,3000.00,4000.00,2880.34,2119.66,0.02,0
67162,6672,1000.00,4000.00,5000.00,893.19,3106.81,0.40,1
67163,6672,1000.00,5000.00,6000.00,0.00,4508.35,0.15,1
67164,6672,1000.00,6000.00,7000.00,0.00,1875.13,0.22,1
67165,6672,-1000.00,5000.00,6000.00,5060.52,1939.48,0.09,0
67166,6672,-1000.00,4000.00,5000.00,3400.25,133.02,0.08,0
67167,6672,1000.00,5000.00,6000.00,0.00,5000.00,0.41,1
67168,6672,1000.00,6000.00,7000.00,900.32,5099.68,0.16,1
67169,6672,1000.00,7000.00,8000.00,2233.15,4766.85,0.34,1
67170,6672,1000.00,8000.00,9000.00,1553.01,6446.99,0.35,1
67171,6672,1000.00,9000.00,10000.00,0.00,9000.00,0.15,1
67172,6672,-1000.00,8000.00,9000.00,4929.42,2207.62,0.14,0
67173,6672,1000.00,9000.00,10000.00,2208.71,6791.29,0.38,1
67174,6672,1000.00,10000.00,11000.00,1334.46,8665.54,0.43,1
67175,6672,1000.00,11000.00,12000.00,245.64,4377.85,0.27,1
67176,6672,1000.00,12000.00,13000.00,0.00,12000.00,0.22,1
67177,6672,-1000.00,11000.00,12000.00,11916.98,1083.02,0.04,0
67178,6672,1000.00,12000.00,13000.00,0.00,12000.00,0.02,1
67179,6672,-1000.00,11000.00,12000.00,1590.26,11409.74,0.38,0
67180,6672,-1000.00,10000.00,11000.00,4686.12,0.00,0.01,0
67181,6672,-1000.00,9000.00,10000.00,739.30,8920.18,0.42,0
67182,6672,-1000.00,8000.00,9000.00,3780.78,6219.22,0.30,0
67183,6672,-1000.00,7000.00,8000.00,0.00,4309.66,0.14,0
67184,6672,-1000.00,6000.00,7000.00,2225.93,4182.50,0.29,0
67185,6672,-1000.00,5000.00,6000.00,1000.92,5999.08,0.37,0
67186,6672,-1000.00,4000.00,5000.00,0.00,6000.00,0.19,0
67187,6672,-1000.00,3000.00,4000.00,1490.25,3509.75,0.32,0
67188,6672,0.00,3000.00,4000.00,0.00,0.00,0.09,0
67189,6672,-1000.00,2000.00,3000.00,0.00,4000.00,0.06,0
67190,6672,-1000.00,1000.00,2000.00,0.00,3000.00,0.33,0
67191,6672,-1000.00,0.00,1000.00,0.00,1757.59,0.26,0
67192,6672,-622.70,-622.70,377.30,0.00,622.70,0.36,0
67193,6672,-377.30,-1000.00,0.00,39.88,337.42,0.34,0
67194,6673,1000.00,1000.00,2000.00,581.06,418.94,0.13,1
67195,6673,1000.00,2000.00,3000.00,203.28,9.07,0.44,1
67196,6673,0.00,2000.00,3000.00,0.00,0.00,0.16,0
67197,6673,1000.00,3000.00,4000.00,2555.78,0.00,0.11,1
67198,6673,-1000.00,2000.00,3000.00,0.00,4000.00,0.16,0
67199,6673,-1000.00,1000.00,2000.00,0.00,2028.25,0.27,0
67200,6673,-1000.00,0.00,1000.00,540.74,953.80,0.30,0
67201,6673,1000.00,1000.00,2000.00,538.01,0.00,0.28,1
67202,6673,1000.00,2000.00,3000.00,1029.18,970.82,0.07,1
67203,6673,1000.00,3000.00,4000.00,130.86,0.00,0.21,1
67204,6673,-1000.00,2000.00,3000.00,1461.99,2538.01,0.21,0
67205,6673,1000.00,3000.00,4000.00,2267.86,0.00,0.13,1
67206,6673,-1000.00,2000.00,3000.00,0.00,1555.46,0.17,0
67207,6673,-550.75,1449.25,2449.25,0.00,550.75,0.39,0
67208,6673,-1000.00,449.25,1449.25,0.00,2449.25,0.02,0
67209,6673,-1000.00,-550.75,449.25,291.42,772.96,0.31,0
67210,6673,-224.34,-775.09,224.91,88.37,135.97,0.21,0
67211,6673,-224.91,-1000.00,0.00,0.00,224.91,0.38,0
67212,6674,-1000.00,-1000.00,0.00,158.50,841.50,0.25,0
67213,6675,-1000.00,-1000.00,0.00,278.70,721.30,0.37,0
67214,6676,-1000.00,-1000.00,0.00,353.33,646.67,0.24,0
67215,6677,-445.59,-445.59,554.41,441.34,4.25,0.09,0
67216,6677,-1000.00,-1445.59,-445.59,98.67,455.75,0.04,0
67217,6678,-56.37,-56.37,943.63,0.00,56.37,0.03,0
67218,6678,0.00,-56.37,943.63,0.00,0.00,0.07,0
67219,6678,-943.63,-1000.00,0.00,0.00,943.63,0.30,0
67220,6679,1000.00,1000.00,2000.00,0.00,1000.00,0.09,1
67221,6679,1000.00,2000.00,3000.00,900.39,1099.61,0.04,1
67222,6679,1000.00,3000.00,4000.00,0.00,1377.79,0.20,1
67223,6679,1000.00,4000.00,5000.00,0.00,1946.11,0.06,1
67224,6679,1000.00,5000.00,6000.00,2099.06,2900.94,0.18,1
67225,6679,1000.00,6000.00,7000.00,0.00,4106.05,0.38,1
67226,6679,1000.00,7000.00,8000.00,0.00,7000.00,0.23,1
67227,6679,1000.00,8000.00,9000.00,0.00,5490.13,0.17,1
67228,6679,0.00,8000.00,9000.00,0.00,0.00,0.03,0
67229,6679,1000.00,9000.00,10000.00,1540.58,7459.42,0.42,1
67230,6679,1000.00,10000.00,11000.00,0.00,10000.00,0.20,1
67231,6679,1000.00,11000.00,12000.00,3559.67,7440.33,0.32,1
67232,6679,1000.00,12000.00,13000.00,0.00,7890.73,0.35,1
67233,6679,1000.00,13000.00,14000.00,0.00,11304.80,0.38,1
67234,6679,1000.00,14000.00,15000.00,7000.00,7000.00,0.00,1
67235,6679,1000.00,15000.00,16000.00,6430.82,8569.18,0.12,1
67236,6679,1000.00,16000.00,17000.00,0.00,16000.00,0.14,1
67237,6679,1000.00,17000.00,18000.00,531.43,16468.57,0.44,1
67238,6679,1000.00,18000.00,19000.00,6244.42,11755.58,0.32,1
67239,6679,1000.00,19000.00,20000.00,0.00,13575.30,0.39,1
67240,6679,1000.00,20000.00,21000.00,0.00,20000.00,0.15,1
67241,6679,1000.00,21000.00,22000.00,0.00,21000.00,0.09,1
67242,6679,1000.00,22000.00,23000.00,10034.50,11965.50,0.22,1
67243,6679,1000.00,23000.00,24000.00,11500.00,11500.00,0.02,1
67244,6679,1000.00,24000.00,25000.00,0.00,16456.14,0.14,1
67245,6679,1000.00,25000.00,26000.00,0.00,25000.00,0.30,1
67246,6679,-1000.00,24000.00,25000.00,14277.80,11722.20,0.03,0
67247,6679,1000.00,25000.00,26000.00,0.00,7911.51,0.22,1
67248,6679,1000.00,26000.00,27000.00,4376.89,21623.11,0.36,1
67249,6679,1000.00,27000.00,28000.00,0.00,20231.18,0.31,1
67250,6679,1000.00,28000.00,29000.00,0.00,27706.80,0.39,1
67251,6679,1000.00,29000.00,30000.00,0.00,29000.00,0.19,1
67252,6679,1000.00,30000.00,31000.00,8968.41,21031.59,0.36,1
67253,6679,1000.00,31000.00,32000.00,11019.21,19980.79,0.32,1
67254,6679,1000.00,32000.00,33000.00,7195.91,24804.09,0.21,1
67255,6679,1000.00,33000.00,34000.00,15918.87,17081.13,0.16,1
67256,6679,-1000.00,32000.00,33000.00,0.00,30164.59,0.32,0
67257,6680,-1000.00,-1000.00,0.00,781.22,218.78,0.07,0
67258,6681,0.00,0.00,1000.00,0.00,0.00,0.27,0
67259,6681,0.00,0.00,1000.00,0.00,0.00,0.03,0
67260,6681,-522.62,-522.62,477.38,0.00,522.62,0.26,0
67261,6681,1000.00,477.38,1477.38,335.51,141.88,0.05,1
67262,6681,1000.00,1477.38,2477.38,235.13,61.71,0.12,1
67263,6681,-593.15,884.23,1884.23,0.00,593.15,0.33,0
67264,6681,-78.24,805.98,1805.98,0.00,78.24,0.39,0
67265,6681,1000.00,1805.98,2805.98,1315.40,0.00,0.04,1
67266,6681,-1000.00,805.98,1805.98,0.00,2805.98,0.36,0
67267,6681,-1000.00,-194.02,805.98,430.61,1375.38,0.38,0
67268,6681,-805.98,-1000.00,0.00,0.00,805.98,0.01,0
67269,6682,1000.00,1000.00,2000.00,500.00,500.00,0.04,1
67270,6682,1000.00,2000.00,3000.00,247.09,1752.91,0.42,1
67271,6682,-1000.00,1000.00,2000.00,2187.00,813.00,0.06,0
67272,6682,-1000.00,0.00,1000.00,1122.84,877.16,0.16,0
67273,6682,-1000.00,-1000.00,0.00,645.99,354.01,0.06,0
67274,6683,-1000.00,-1000.00,0.00,0.00,1000.00,0.08,0
67275,6684,1000.00,1000.00,2000.00,0.00,1000.00,0.03,1
67276,6684,1000.00,2000.00,3000.00,530.95,1469.05,0.38,1
67277,6684,1000.00,3000.00,4000.00,956.62,2043.38,0.28,1
67278,6684,1000.00,4000.00,5000.00,1095.45,2904.55,0.17,1
67279,6684,1000.00,5000.00,6000.00,1879.70,3120.30,0.26,1
67280,6684,1000.00,6000.00,7000.00,2511.10,3194.04,0.26,1
67281,6684,1000.00,7000.00,8000.00,1319.19,5680.81,0.38,1
67282,6684,1000.00,8000.00,9000.00,0.00,5127.67,0.25,1
67283,6684,1000.00,9000.00,10000.00,0.00,3762.85,0.09,1
67284,6684,1000.00,10000.00,11000.00,0.00,10000.00,0.16,1
67285,6684,1000.00,11000.00,12000.00,4271.68,6728.32,0.11,1
67286,6684,1000.00,12000.00,13000.00,1445.69,10554.31,0.18,1
67287,6684,1000.00,13000.00,14000.00,6372.66,6627.34,0.03,1
67288,6684,1000.00,14000.00,15000.00,0.00,14000.00,0.40,1
67289,6684,1000.00,15000.00,16000.00,6209.34,8790.66,0.27,1
67290,6684,1000.00,16000.00,17000.00,0.00,4653.28,0.17,1
67291,6684,1000.00,17000.00,18000.00,6457.45,10542.55,0.14,1
67292,6684,1000.00,18000.00,19000.00,0.00,18000.00,0.36,1
67293,6684,1000.00,19000.00,20000.00,0.00,10667.71,0.33,1
67294,6684,1000.00,20000.00,21000.00,2274.40,10478.99,0.32,1
67295,6684,1000.00,21000.00,22000.00,1922.84,19077.16,0.43,1
67296,6684,1000.00,22000.00,23000.00,450.05,21549.95,0.19,1
67297,6684,1000.00,23000.00,24000.00,0.00,23000.00,0.11,1
67298,6684,1000.00,24000.00,25000.00,3281.10,20573.34,0.42,1
67299,6684,1000.00,25000.00,26000.00,8869.72,16130.28,0.28,1
67300,6684,1000.00,26000.00,27000.00,0.00,14994.12,0.34,1
67301,6684,1000.00,27000.00,28000.00,0.00,27000.00,0.08,1
67302,6684,1000.00,28000.00,29000.00,13870.12,14129.88,0.09,1
67303,6684,-1000.00,27000.00,28000.00,17176.75,11823.25,0.13,0
67304,6684,1000.00,28000.00,29000.00,2490.98,4493.52,0.16,1
67305,6684,1000.00,29000.00,30000.00,3374.91,25625.09,0.39,1
67306,6684,1000.00,30000.00,31000.00,13263.27,16736.73,0.05,1
67307,6684,1000.00,31000.00,32000.00,11389.78,19610.22,0.27,1
67308,6684,1000.00,32000.00,33000.00,0.00,30858.72,0.23,1
67309,6684,1000.00,33000.00,34000.00,5988.67,27011.33,0.41,1
67310,6684,-1000.00,32000.00,33000.00,9728.26,9107.62,0.19,0
67311,6684,1000.00,33000.00,34000.00,7376.49,25623.51,0.35,1
67312,6684,1000.00,34000.00,35000.00,0.00,26040.45,0.26,1
67313,6684,1000.00,35000.00,36000.00,17500.00,17500.00,0.05,1
67314,6684,1000.00,36000.00,37000.00,2406.05,33593.95,0.32,1
67315,6684,1000.00,37000.00,38000.00,13731.34,23268.66,0.12,1
67316,6684,1000.00,38000.00,39000.00,0.00,450.60,0.11,1
67317,6684,-1000.00,37000.00,38000.00,20285.67,18714.33,0.18,0
67318,6685,-678.21,-678.21,321.79,0.00,678.21,0.38,0
67319,6685,-321.79,-1000.00,0.00,123.75,198.04,0.30,0
67320,6686,-1000.00,-1000.00,0.00,0.00,1000.00,0.16,0
67321,6687,-1000.00,-1000.00,0.00,1000.00,0.00,0.01,0
67322,6688,0.00,0.00,1000.00,0.00,0.00,0.26,0
67323,6688,-1000.00,-1000.00,0.00,0.00,706.49,0.20,0
67324,6689,-1000.00,-1000.00,0.00,0.00,1000.00,0.17,0
67325,6690,-1000.00,-1000.00,0.00,70.98,394.05,0.35,0
67326,6691,-310.07,-310.07,689.93,0.00,310.07,0.18,0
67327,6691,-582.77,-892.84,107.16,0.00,582.77,0.35,0
67328,6691,-107.16,-1000.00,0.00,0.00,107.16,0.16,0
67329,6692,-149.23,-149.23,850.77,37.31,0.00,0.12,0
67330,6692,-1000.00,-1149.23,-149.23,558.88,0.00,0.22,0
67331,6693,-556.08,-556.08,443.92,329.66,226.43,0.35,0
67332,6693,0.00,-556.08,443.92,0.00,0.00,0.43,0
67333,6693,-1000.00,-1556.08,-556.08,0.00,388.88,0.43,0
67334,6694,-912.25,-912.25,87.75,178.46,733.80,0.38,0
67335,6694,-87.75,-1000.00,0.00,0.00,87.75,0.30,0
67336,6695,1000.00,1000.00,2000.00,354.54,645.46,0.09,1
67337,6695,1000.00,2000.00,3000.00,0.00,2000.00,0.31,1
67338,6695,1000.00,3000.00,4000.00,0.00,1085.59,0.14,1
67339,6695,1000.00,4000.00,5000.00,0.00,4000.00,0.42,1
67340,6695,1000.00,5000.00,6000.00,2186.26,2813.74,0.19,1
67341,6695,0.00,5000.00,6000.00,0.00,0.00,0.05,0
67342,6695,1000.00,6000.00,7000.00,280.95,5719.05,0.28,1
67343,6695,1000.00,7000.00,8000.00,0.00,4072.66,0.25,1
67344,6695,1000.00,8000.00,9000.00,1316.97,6683.03,0.20,1
67345,6695,1000.00,9000.00,10000.00,3224.16,5775.84,0.21,1
67346,6695,1000.00,10000.00,11000.00,0.00,9385.63,0.36,1
67347,6695,1000.00,11000.00,12000.00,0.00,11000.00,0.36,1
67348,6695,1000.00,12000.00,13000.00,5526.56,6473.44,0.22,1
67349,6695,1000.00,13000.00,14000.00,0.00,5844.75,0.29,1
67350,6695,1000.00,14000.00,15000.00,0.00,14000.00,0.02,1
67351,6695,1000.00,15000.00,16000.00,3115.46,3392.80,0.18,1
67352,6695,1000.00,16000.00,17000.00,7082.38,8917.62,0.10,1
67353,6695,1000.00,17000.00,18000.00,0.00,17000.00,0.25,1
67354,6695,1000.00,18000.00,19000.00,3404.57,14595.43,0.41,1
67355,6695,1000.00,19000.00,20000.00,3461.09,15538.91,0.20,1
67356,6695,1000.00,20000.00,21000.00,0.00,20000.00,0.13,1
67357,6695,-1000.00,19000.00,20000.00,14965.70,6034.30,0.03,0
67358,6695,1000.00,20000.00,21000.00,7489.11,12510.89,0.05,1
67359,6695,1000.00,21000.00,22000.00,9128.43,11871.57,0.16,1
67360,6695,1000.00,22000.00,23000.00,0.00,21675.78,0.27,1
67361,6695,1000.00,23000.00,24000.00,0.00,20838.22,0.20,1
67362,6695,1000.00,24000.00,25000.00,0.00,3733.14,0.06,1
67363,6695,1000.00,25000.00,26000.00,2099.76,22900.24,0.27,1
67364,6695,1000.00,26000.00,27000.00,3918.06,19273.77,0.39,1
67365,6695,1000.00,27000.00,28000.00,0.00,27000.00,0.04,1
67366,6695,1000.00,28000.00,29000.00,0.00,20921.27,0.30,1
67367,6695,1000.00,29000.00,30000.00,0.00,24336.83,0.24,1
67368,6695,1000.00,30000.00,31000.00,0.00,30000.00,0.00,1
67369,6695,1000.00,31000.00,32000.00,15500.00,15500.00,0.08,1
67370,6695,1000.00,32000.00,33000.00,0.00,8249.06,0.14,1
67371,6695,1000.00,33000.00,34000.00,14363.96,18636.04,0.21,1
67372,6695,1000.00,34000.00,35000.00,1965.43,32034.57,0.36,1
67373,6695,1000.00,35000.00,36000.00,16731.12,18268.88,0.06,1
67374,6695,1000.00,36000.00,37000.00,16856.51,19143.49,0.18,1
67375,6695,1000.00,37000.00,38000.00,8451.15,28548.85,0.37,1
67376,6695,1000.00,38000.00,39000.00,0.00,38000.00,0.27,1
67377,6695,1000.00,39000.00,40000.00,0.00,36870.59,0.37,1
67378,6695,1000.00,40000.00,41000.00,0.00,15565.22,0.26,1
67379,6695,1000.00,41000.00,42000.00,0.00,19569.03,0.12,1
67380,6695,1000.00,42000.00,43000.00,1749.11,40250.89,0.32,1
67381,6695,-1000.00,41000.00,42000.00,0.00,43000.00,0.06,0
67382,6695,-1000.00,40000.00,41000.00,0.00,32706.47,0.41,0
67383,6695,-1000.00,39000.00,40000.00,6162.53,34837.47,0.42,0
67384,6695,-1000.00,38000.00,39000.00,0.00,1921.15,0.12,0
67385,6695,-1000.00,37000.00,38000.00,5465.77,33534.23,0.35,0
67386,6695,-1000.00,36000.00,37000.00,0.00,22734.70,0.34,0
67387,6695,-1000.00,35000.00,36000.00,0.00,37000.00,0.37,0
67388,6695,-1000.00,34000.00,35000.00,0.00,36000.00,0.13,0
67389,6695,-1000.00,33000.00,34000.00,527.66,29172.48,0.43,0
67390,6695,-1000.00,32000.00,33000.00,4237.98,29762.02,0.42,0
67391,6695,-1000.00,31000.00,32000.00,5285.49,27714.51,0.38,0
67392,6695,-1000.00,30000.00,31000.00,0.00,29239.04,0.43,0
67393,6695,-1000.00,29000.00,30000.00,29171.90,1828.10,0.03,0
67394,6695,-1000.00,28000.00,29000.00,12460.88,3783.80,0.21,0
67395,6695,-1000.00,27000.00,28000.00,0.00,11000.70,0.25,0
67396,6695,-1000.00,26000.00,27000.00,15680.38,12319.62,0.08,0
67397,6695,-1000.00,25000.00,26000.00,16833.05,10166.95,0.02,0
67398,6695,-1000.00,24000.00,25000.00,0.00,26000.00,0.25,0
67399,6695,-1000.00,23000.00,24000.00,5397.59,0.00,0.08,0
67400,6696,-1000.00,-1000.00,0.00,555.65,444.35,0.09,0
67401,6697,1000.00,1000.00,2000.00,0.00,1000.00,0.23,1
67402,6697,1000.00,2000.00,3000.00,970.52,1029.48,0.07,1
67403,6697,1000.00,3000.00,4000.00,122.92,2877.08,0.17,1
67404,6697,1000.00,4000.00,5000.00,0.00,208.05,0.10,1
67405,6697,1000.00,5000.00,6000.00,0.00,5000.00,0.38,1
67406,6697,1000.00,6000.00,7000.00,0.00,6000.00,0.03,1
67407,6697,1000.00,7000.00,8000.00,2931.20,4068.80,0.21,1
67408,6697,1000.00,8000.00,9000.00,3359.94,4640.06,0.16,1
67409,6697,1000.00,9000.00,10000.00,727.32,919.60,0.14,1
67410,6697,1000.00,10000.00,11000.00,0.00,9746.89,0.44,1
67411,6697,1000.00,11000.00,12000.00,3794.16,7205.84,0.28,1
67412,6697,1000.00,12000.00,13000.00,924.21,6495.77,0.33,1
67413,6697,1000.00,13000.00,14000.00,0.00,3126.35,0.10,1
67414,6697,1000.00,14000.00,15000.00,1800.43,12199.57,0.31,1
67415,6697,1000.00,15000.00,16000.00,0.00,15000.00,0.22,1
67416,6697,1000.00,16000.00,17000.00,3748.82,12251.18,0.38,1
67417,6697,1000.00,17000.00,18000.00,0.00,17000.00,0.16,1
67418,6697,1000.00,18000.00,19000.00,9000.00,9000.00,0.06,1
67419,6697,1000.00,19000.00,20000.00,0.00,19000.00,0.11,1
67420,6697,1000.00,20000.00,21000.00,2964.86,13066.36,0.36,1
67421,6697,1000.00,21000.00,22000.00,4312.02,16687.98,0.40,1
67422,6697,1000.00,22000.00,23000.00,0.00,22000.00,0.17,1
67423,6697,1000.00,23000.00,24000.00,2240.50,20759.50,0.12,1
67424,6697,1000.00,24000.00,25000.00,10210.27,13789.73,0.27,1
67425,6697,1000.00,25000.00,26000.00,0.00,25000.00,0.42,1
67426,6697,1000.00,26000.00,27000.00,10818.58,15181.42,0.24,1
67427,6697,-1000.00,25000.00,26000.00,8677.75,0.00,0.02,0
67428,6697,1000.00,26000.00,27000.00,1926.82,8336.54,0.23,1
67429,6697,1000.00,27000.00,28000.00,8286.28,18713.72,0.16,1
67430,6697,1000.00,28000.00,29000.00,0.00,8241.61,0.20,1
67431,6697,1000.00,29000.00,30000.00,0.00,29000.00,0.04,1
67432,6697,1000.00,30000.00,31000.00,6167.09,10125.59,0.23,1
67433,6697,1000.00,31000.00,32000.00,0.00,16851.21,0.14,1
67434,6697,1000.00,32000.00,33000.00,0.00,8682.54,0.21,1
67435,6697,1000.00,33000.00,34000.00,12610.86,20389.14,0.27,1
67436,6697,1000.00,34000.00,35000.00,2215.53,31784.47,0.30,1
67437,6697,1000.00,35000.00,36000.00,0.00,34173.78,0.39,1
67438,6697,1000.00,36000.00,37000.00,0.00,22218.91,0.34,1
67439,6697,-1000.00,35000.00,36000.00,14408.73,6810.68,0.14,0
67440,6697,1000.00,36000.00,37000.00,0.00,36000.00,0.17,1
67441,6697,1000.00,37000.00,38000.00,0.00,31146.71,0.40,1
67442,6698,0.00,0.00,1000.00,0.00,0.00,0.43,0
67443,6698,-276.39,-276.39,723.61,276.39,0.00,0.29,0
67444,6698,0.00,-276.39,723.61,0.00,0.00,0.23,0
67445,6698,-1000.00,-1276.39,-276.39,32.30,691.31,0.44,0
67446,6699,1000.00,1000.00,2000.00,0.00,1000.00,0.11,1
67447,6699,-1000.00,0.00,1000.00,1128.69,871.31,0.17,0
67448,6699,1000.00,1000.00,2000.00,500.00,500.00,0.01,1
67449,6699,1000.00,2000.00,3000.00,444.53,1555.47,0.39,1
67450,6699,1000.00,3000.00,4000.00,0.00,3000.00,0.39,1
67451,6699,1000.00,4000.00,5000.00,0.00,2975.18,0.27,1
67452,6699,1000.00,5000.00,6000.00,2108.87,2891.13,0.09,1
67453,6699,1000.00,6000.00,7000.00,2984.16,3015.84,0.19,1
67454,6699,1000.00,7000.00,8000.00,0.00,2372.34,0.21,1
67455,6699,1000.00,8000.00,9000.00,3448.23,4241.90,0.25,1
67456,6699,1000.00,9000.00,10000.00,0.00,9000.00,0.38,1
67457,6699,1000.00,10000.00,11000.00,3278.33,6721.67,0.02,1
67458,6699,1000.00,11000.00,12000.00,0.00,11000.00,0.15,1
67459,6699,1000.00,12000.00,13000.00,1837.76,3234.22,0.20,1
67460,6699,1000.00,13000.00,14000.00,4309.47,8690.53,0.33,1
67461,6699,1000.00,14000.00,15000.00,3343.55,10656.45,0.25,1
67462,6699,1000.00,15000.00,16000.00,847.82,14152.18,0.20,1
67463,6699,-1000.00,14000.00,15000.00,10081.56,5918.44,0.13,0
67464,6699,-1000.00,13000.00,14000.00,0.00,15000.00,0.04,0
67465,6699,-1000.00,12000.00,13000.00,0.00,14000.00,0.31,0
67466,6699,-1000.00,11000.00,12000.00,0.00,13000.00,0.22,0
67467,6699,-1000.00,10000.00,11000.00,0.00,10731.87,0.28,0
67468,6699,-1000.00,9000.00,10000.00,143.55,10856.45,0.38,0
67469,6699,-1000.00,8000.00,9000.00,0.00,10000.00,0.37,0
67470,6699,-1000.00,7000.00,8000.00,580.45,8419.55,0.44,0
67471,6699,-1000.00,6000.00,7000.00,0.00,8000.00,0.35,0
67472,6699,-1000.00,5000.00,6000.00,0.00,7000.00,0.26,0
67473,6699,-1000.00,4000.00,5000.00,0.00,3249.25,0.15,0
67474,6699,-1000.00,3000.00,4000.00,0.00,2272.63,0.23,0
67475,6699,-1000.00,2000.00,3000.00,757.09,3242.91,0.32,0
67476,6699,-1000.00,1000.00,2000.00,843.98,1512.54,0.28,0
67477,6699,-1000.00,0.00,1000.00,91.35,1908.65,0.30,0
67478,6699,-454.04,-454.04,545.96,0.00,454.04,0.27,0
67479,6699,-545.96,-1000.00,0.00,0.00,545.96,0.40,0
67480,6700,-749.85,-749.85,250.15,180.79,569.06,0.35,0
67481,6700,-187.58,-937.43,62.57,0.00,187.58,0.27,0
67482,6700,-35.06,-972.49,27.51,2.97,32.08,0.32,0
67483,6700,-27.51,-1000.00,0.00,0.00,27.51,0.41,0
67484,6701,-233.03,-233.03,766.97,0.00,233.03,0.12,0
67485,6701,-766.97,-1000.00,0.00,0.00,766.97,0.24,0
67486,6702,-853.24,-853.24,146.76,0.00,853.24,0.40,0
67487,6702,0.00,-853.24,146.76,0.00,0.00,0.01,0
67488,6702,-1000.00,-1853.24,-853.24,129.95,16.80,0.03,0
67489,6703,1000.00,1000.00,2000.00,259.29,740.71,0.13,1
67490,6703,1000.00,2000.00,3000.00,424.14,918.62,0.28,1
67491,6703,1000.00,3000.00,4000.00,0.00,1328.55,0.20,1
67492,6703,1000.00,4000.00,5000.00,2000.00,2000.00,0.10,1
67493,6703,1000.00,5000.00,6000.00,0.00,5000.00,0.03,1
67494,6703,1000.00,6000.00,7000.00,0.00,6000.00,0.09,1
67495,6703,1000.00,7000.00,8000.00,3087.18,3912.82,0.26,1
67496,6703,1000.00,8000.00,9000.00,0.00,8000.00,0.18,1
67497,6703,1000.00,9000.00,10000.00,4205.99,4794.01,0.24,1
67498,6703,-1000.00,8000.00,9000.00,6224.38,3441.26,0.14,0
67499,6703,1000.00,9000.00,10000.00,0.00,9000.00,0.23,1
67500,6703,1000.00,10000.00,11000.00,3710.49,6289.51,0.15,1
67501,6703,1000.00,11000.00,12000.00,0.00,11000.00,0.30,1
67502,6703,1000.00,12000.00,13000.00,3399.97,8600.03,0.07,1
67503,6703,1000.00,13000.00,14000.00,0.00,13000.00,0.40,1
67504,6703,1000.00,14000.00,15000.00,894.63,13105.37,0.26,1
67505,6703,1000.00,15000.00,16000.00,0.00,13650.06,0.40,1
67506,6703,-1000.00,14000.00,15000.00,9807.15,6192.85,0.07,0
67507,6703,1000.00,15000.00,16000.00,0.00,15000.00,0.37,1
67508,6703,1000.00,16000.00,17000.00,0.00,16000.00,0.42,1
67509,6703,1000.00,17000.00,18000.00,5859.27,11140.73,0.28,1
67510,6703,1000.00,18000.00,19000.00,0.00,18000.00,0.06,1
67511,6703,1000.00,19000.00,20000.00,0.00,10998.78,0.27,1
67512,6703,1000.00,20000.00,21000.00,2930.08,17069.92,0.25,1
67513,6703,1000.00,21000.00,22000.00,0.00,21000.00,0.03,1
67514,6703,1000.00,22000.00,23000.00,4033.45,17966.55,0.41,1
67515,6703,1000.00,23000.00,24000.00,0.00,22911.54,0.42,1
67516,6703,1000.00,24000.00,25000.00,0.00,18660.74,0.38,1
67517,6703,1000.00,25000.00,26000.00,5509.61,19490.39,0.38,1
67518,6703,1000.00,26000.00,27000.00,9591.86,16408.14,0.31,1
67519,6703,1000.00,27000.00,28000.00,0.00,27000.00,0.16,1
67520,6703,1000.00,28000.00,29000.00,5309.17,22690.83,0.25,1
67521,6703,1000.00,29000.00,30000.00,0.00,29000.00,0.06,1
67522,6703,1000.00,30000.00,31000.00,0.00,27478.58,0.44,1
67523,6703,1000.00,31000.00,32000.00,0.00,3740.22,0.13,1
67524,6703,1000.00,32000.00,33000.00,7770.42,24229.58,0.28,1
67525,6703,1000.00,33000.00,34000.00,12288.33,20711.67,0.27,1
67526,6703,1000.00,34000.00,35000.00,14069.77,19930.23,0.16,1
67527,6703,1000.00,35000.00,36000.00,3500.82,31499.18,0.28,1
67528,6703,1000.00,36000.00,37000.00,0.00,36000.00,0.31,1
67529,6703,1000.00,37000.00,38000.00,16665.10,20334.90,0.18,1
67530,6704,-1000.00,-1000.00,0.00,226.65,773.35,0.37,0
67531,6705,-1000.00,-1000.00,0.00,0.00,181.82,0.14,0
67532,6706,-1000.00,-1000.00,0.00,111.16,888.84,0.43,0
67533,6707,-633.09,-633.09,366.91,0.00,633.09,0.34,0
67534,6707,0.00,-633.09,366.91,0.00,0.00,0.07,0
67535,6707,-227.71,-860.80,139.20,4.30,223.40,0.36,0
67536,6707,-139.20,-1000.00,0.00,0.00,139.20,0.12,0
67537,6708,-1000.00,-1000.00,0.00,484.43,515.57,0.21,0
67538,6709,-1000.00,-1000.00,0.00,0.00,1000.00,0.26,0
67539,6710,-1000.00,-1000.00,0.00,465.01,534.99,0.26,0
67540,6711,1000.00,1000.00,2000.00,336.04,663.96,0.06,1
67541,6711,1000.00,2000.00,3000.00,0.00,1120.16,0.18,1
67542,6711,1000.00,3000.00,4000.00,0.00,3000.00,0.33,1
67543,6711,1000.00,4000.00,5000.00,0.00,4000.00,0.03,1
67544,6711,-1000.00,3000.00,4000.00,3936.61,799.42,0.07,0
67545,6711,1000.00,4000.00,5000.00,420.22,3579.78,0.27,1
67546,6711,1000.00,5000.00,6000.00,0.00,4301.00,0.41,1
67547,6711,1000.00,6000.00,7000.00,0.00,6000.00,0.21,1
67548,6711,1000.00,7000.00,8000.00,0.00,4592.16,0.08,1
67549,6711,1000.00,8000.00,9000.00,1927.37,6072.63,0.14,1
67550,6711,1000.00,9000.00,10000.00,0.00,9000.00,0.27,1
67551,6711,1000.00,10000.00,11000.00,0.00,10000.00,0.28,1
67552,6711,1000.00,11000.00,12000.00,2340.00,8660.00,0.24,1
67553,6711,1000.00,12000.00,13000.00,0.00,12000.00,0.13,1
67554,6711,1000.00,13000.00,14000.00,0.00,13000.00,0.07,1
67555,6711,1000.00,14000.00,15000.00,0.00,14000.00,0.08,1
67556,6711,1000.00,15000.00,16000.00,7198.96,7801.04,0.11,1
67557,6711,1000.00,16000.00,17000.00,1767.34,14232.66,0.22,1
67558,6711,-1000.00,15000.00,16000.00,1089.87,3691.38,0.19,0
67559,6711,-1000.00,14000.00,15000.00,0.00,16000.00,0.26,0
67560,6711,-1000.00,13000.00,14000.00,0.00,15000.00,0.09,0
67561,6711,-1000.00,12000.00,13000.00,2214.12,11785.88,0.33,0
67562,6711,-1000.00,11000.00,12000.00,0.00,13000.00,0.35,0
67563,6711,-1000.00,10000.00,11000.00,0.00,11169.15,0.44,0
67564,6711,-1000.00,9000.00,10000.00,0.00,5251.25,0.08,0
67565,6711,-1000.00,8000.00,9000.00,0.00,10000.00,0.36,0
67566,6711,-1000.00,7000.00,8000.00,0.00,5251.61,0.17,0
67567,6711,-164.23,6835.77,7835.77,0.00,164.23,0.12,0
67568,6711,-1000.00,5835.77,6835.77,0.00,6061.25,0.39,0
67569,6711,-1000.00,4835.77,5835.77,0.00,6835.77,0.34,0
67570,6711,-1000.00,3835.77,4835.77,1323.39,4512.38,0.18,0
67571,6711,-1000.00,2835.77,3835.77,0.00,4835.77,0.20,0
67572,6711,-1000.00,1835.77,2835.77,0.00,3835.77,0.26,0
67573,6711,-1000.00,835.77,1835.77,666.89,2168.88,0.27,0
67574,6711,-1000.00,-164.23,835.77,130.65,1705.12,0.44,0
67575,6711,-835.77,-1000.00,0.00,290.46,545.31,0.28,0
67576,6712,-1000.00,-1000.00,0.00,532.99,467.01,0.08,0
67577,6713,-1000.00,-1000.00,0.00,452.37,547.63,0.22,0
67578,6714,-1000.00,-1000.00,0.00,355.69,644.31,0.11,0
67579,6715,-1000.00,-1000.00,0.00,500.00,500.00,0.04,0
67580,6716,-737.55,-737.55,262.45,0.00,737.55,0.40,0
67581,6716,-262.45,-1000.00,0.00,131.23,131.23,0.05,0
67582,6717,-674.92,-674.92,325.08,0.00,674.92,0.37,0
67583,6717,-177.55,-852.48,147.52,23.30,154.25,0.30,0
67584,6717,-147.52,-1000.00,0.00,0.00,147.52,0.43,0
67585,6718,-1000.00,-1000.00,0.00,0.00,1000.00,0.20,0
67586,6719,0.00,0.00,1000.00,0.00,0.00,0.04,0
67587,6719,-1000.00,-1000.00,0.00,0.00,1000.00,0.22,0
67588,6720,-1000.00,-1000.00,0.00,404.49,0.00,0.08,0
67589,6721,-1000.00,-1000.00,0.00,0.00,1000.00,0.31,0
67590,6722,-1000.00,-1000.00,0.00,322.45,677.55,0.22,0
67591,6723,-263.81,-263.81,736.19,263.81,0.00,0.06,0
67592,6723,-1000.00,-1263.81,-263.81,321.23,414.95,0.24,0
67593,6724,-565.16,-565.16,434.84,0.00,565.16,0.28,0
67594,6724,-367.32,-932.48,67.52,18.80,348.52,0.18,0
67595,6724,1000.00,67.52,1067.52,53.48,14.04,0.07,1
67596,6724,1000.00,1067.52,2067.52,348.69,245.36,0.17,1
67597,6724,0.00,1067.52,2067.52,0.00,0.00,0.00,0
67598,6724,-1000.00,67.52,1067.52,0.00,1046.22,0.31,0
67599,6724,-580.08,-512.56,487.44,0.00,580.08,0.26,0
67600,6724,-311.29,-823.84,176.16,17.09,294.19,0.35,0
67601,6724,1000.00,176.16,1176.16,95.35,61.16,0.16,1
67602,6724,-1000.00,-823.84,176.16,196.68,979.48,0.21,0
67603,6724,-176.16,-1000.00,0.00,31.49,144.67,0.41,0
67604,6725,-1000.00,-1000.00,0.00,500.00,500.00,0.02,0
67605,6726,-387.56,-387.56,612.44,378.58,8.97,0.09,0
67606,6726,-1000.00,-1387.56,-387.56,134.04,436.17,0.37,0
67607,6727,-723.94,-723.94,276.06,254.87,469.07,0.27,0
67608,6727,-276.06,-1000.00,0.00,110.73,165.33,0.25,0
67609,6728,1000.00,1000.00,2000.00,0.00,1000.00,0.43,1
67610,6728,-1000.00,0.00,1000.00,1123.92,876.08,0.05,0
67611,6728,1000.00,1000.00,2000.00,0.00,947.94,0.09,1
67612,6728,1000.00,2000.00,3000.00,0.00,1105.66,0.25,1
67613,6728,1000.00,3000.00,4000.00,838.42,2161.58,0.21,1
67614,6728,-1000.00,2000.00,3000.00,1771.37,414.52,0.11,0
67615,6728,1000.00,3000.00,4000.00,0.00,3000.00,0.09,1
67616,6728,1000.00,4000.00,5000.00,873.94,3126.06,0.38,1
67617,6728,1000.00,5000.00,6000.00,644.11,4355.89,0.32,1
67618,6728,1000.00,6000.00,7000.00,2319.80,3680.20,0.30,1
67619,6728,1000.00,7000.00,8000.00,736.62,4419.20,0.36,1
67620,6728,1000.00,8000.00,9000.00,4000.00,4000.00,0.06,1
67621,6728,1000.00,9000.00,10000.00,0.00,9000.00,0.08,1
67622,6728,1000.00,10000.00,11000.00,0.00,2243.86,0.18,1
67623,6728,1000.00,11000.00,12000.00,3909.64,7090.36,0.17,1
67624,6728,1000.00,12000.00,13000.00,670.06,11329.94,0.44,1
67625,6728,-1000.00,11000.00,12000.00,6878.83,0.00,0.00,0
67626,6728,1000.00,12000.00,13000.00,0.00,11896.60,0.32,1
67627,6728,1000.00,13000.00,14000.00,0.00,8727.82,0.38,1
67628,6728,1000.00,14000.00,15000.00,680.54,13319.46,0.44,1
67629,6728,1000.00,15000.00,16000.00,0.00,15000.00,0.11,1
67630,6728,1000.00,16000.00,17000.00,0.00,8398.74,0.32,1
67631,6728,-1000.00,15000.00,16000.00,9900.60,7099.40,0.13,0
67632,6728,-1000.00,14000.00,15000.00,4024.71,11975.29,0.36,0
67633,6728,-1000.00,13000.00,14000.00,2498.70,12501.30,0.31,0
67634,6728,-1000.00,12000.00,13000.00,0.00,9408.63,0.11,0
67635,6728,-1000.00,11000.00,12000.00,0.00,2291.06,0.16,0
67636,6728,-1000.00,10000.00,11000.00,6685.90,850.99,0.09,0
67637,6728,-1000.00,9000.00,10000.00,0.00,9310.78,0.43,0
67638,6728,-1000.00,8000.00,9000.00,8794.26,0.00,0.03,0
67639,6728,-1000.00,7000.00,8000.00,0.00,8663.76,0.41,0
67640,6728,-1000.00,6000.00,7000.00,0.00,1612.48,0.05,0
67641,6728,-1000.00,5000.00,6000.00,1236.34,5763.66,0.40,0
67642,6728,-1000.00,4000.00,5000.00,0.00,6000.00,0.36,0
67643,6728,-1000.00,3000.00,4000.00,1684.47,1197.11,0.17,0
67644,6728,-1000.00,2000.00,3000.00,1733.39,2266.61,0.21,0
67645,6728,-1000.00,1000.00,2000.00,603.48,2396.52,0.40,0
67646,6728,-1000.00,0.00,1000.00,618.33,1381.67,0.17,0
67647,6728,-962.99,-962.99,37.01,0.00,962.99,0.08,0
67648,6728,-37.01,-1000.00,0.00,6.22,30.79,0.09,0
67649,6729,1000.00,1000.00,2000.00,129.96,509.89,0.36,1
67650,6729,1000.00,2000.00,3000.00,0.00,1511.07,0.16,1
67651,6729,1000.00,3000.00,4000.00,0.00,3000.00,0.03,1
67652,6729,0.00,3000.00,4000.00,0.00,0.00,0.02,0
67653,6729,1000.00,4000.00,5000.00,1566.59,2433.41,0.21,1
67654,6729,1000.00,5000.00,6000.00,719.47,1477.67,0.22,1
67655,6729,1000.00,6000.00,7000.00,0.00,466.09,0.12,1
67656,6729,1000.00,7000.00,8000.00,0.00,7000.00,0.30,1
67657,6729,1000.00,8000.00,9000.00,4000.00,4000.00,0.06,1
67658,6729,1000.00,9000.00,10000.00,4500.00,4500.00,0.02,1
67659,6729,1000.00,10000.00,11000.00,0.00,10000.00,0.33,1
67660,6729,1000.00,11000.00,12000.00,0.00,8471.28,0.37,1
67661,6729,1000.00,12000.00,13000.00,0.00,6674.07,0.24,1
67662,6729,1000.00,13000.00,14000.00,0.00,8410.93,0.36,1
67663,6729,1000.00,14000.00,15000.00,0.00,7355.22,0.12,1
67664,6729,1000.00,15000.00,16000.00,0.00,15000.00,0.16,1
67665,6729,1000.00,16000.00,17000.00,0.00,16000.00,0.10,1
67666,6729,0.00,16000.00,17000.00,0.00,0.00,0.00,0
67667,6729,1000.00,17000.00,18000.00,0.00,15058.55,0.33,1
67668,6729,1000.00,18000.00,19000.00,2319.83,15680.17,0.40,1
67669,6729,1000.00,19000.00,20000.00,3841.01,15158.99,0.39,1
67670,6729,1000.00,20000.00,21000.00,0.00,10699.45,0.33,1
67671,6729,1000.00,21000.00,22000.00,0.00,15102.71,0.35,1
67672,6729,1000.00,22000.00,23000.00,4504.03,15911.06,0.37,1
67673,6729,1000.00,23000.00,24000.00,4350.81,11252.86,0.29,1
67674,6729,1000.00,24000.00,25000.00,0.00,24000.00,0.28,1
67675,6729,1000.00,25000.00,26000.00,0.00,25000.00,0.02,1
67676,6729,1000.00,26000.00,27000.00,10942.23,15057.77,0.14,1
67677,6729,1000.00,27000.00,28000.00,0.00,27000.00,0.19,1
67678,6729,1000.00,28000.00,29000.00,0.00,19882.92,0.37,1
67679,6729,1000.00,29000.00,30000.00,0.00,29000.00,0.30,1
67680,6729,-1000.00,28000.00,29000.00,16523.42,13476.58,0.09,0
67681,6730,1000.00,1000.00,2000.00,243.86,756.14,0.38,1
67682,6730,1000.00,2000.00,3000.00,0.00,1685.46,0.41,1
67683,6730,1000.00,3000.00,4000.00,568.42,921.32,0.22,1
67684,6730,1000.00,4000.00,5000.00,0.00,4000.00,0.29,1
67685,6730,1000.00,5000.00,6000.00,882.04,4117.96,0.37,1
67686,6730,1000.00,6000.00,7000.00,1588.30,4411.70,0.36,1
67687,6730,1000.00,7000.00,8000.00,0.00,4748.87,0.36,1
67688,6730,1000.00,8000.00,9000.00,742.31,7257.69,0.43,1
67689,6730,1000.00,9000.00,10000.00,0.00,9000.00,0.12,1
67690,6730,1000.00,10000.00,11000.00,4598.10,5401.90,0.04,1
67691,6730,1000.00,11000.00,12000.00,3362.70,6822.68,0.32,1
67692,6730,1000.00,12000.00,13000.00,0.00,3900.15,0.22,1
67693,6730,1000.00,13000.00,14000.00,5827.75,7172.25,0.25,1
67694,6730,1000.00,14000.00,15000.00,5136.47,8863.53,0.31,1
67695,6730,1000.00,15000.00,16000.00,4050.77,10949.23,0.08,1
67696,6730,1000.00,16000.00,17000.00,0.00,16000.00,0.22,1
67697,6730,1000.00,17000.00,18000.00,6895.05,10104.95,0.02,1
67698,6730,1000.00,18000.00,19000.00,0.00,11568.75,0.29,1
67699,6730,1000.00,19000.00,20000.00,0.00,19000.00,0.28,1
67700,6730,1000.00,20000.00,21000.00,3656.53,16343.47,0.23,1
67701,6730,1000.00,21000.00,22000.00,9181.70,11818.30,0.19,1
67702,6730,1000.00,22000.00,23000.00,11000.00,11000.00,0.06,1
67703,6730,1000.00,23000.00,24000.00,6641.63,16358.37,0.34,1
67704,6730,1000.00,24000.00,25000.00,10070.90,13929.10,0.02,1
67705,6730,-1000.00,23000.00,24000.00,0.00,22447.11,0.43,0
67706,6730,-1000.00,22000.00,23000.00,0.00,24000.00,0.07,0
67707,6730,-1000.00,21000.00,22000.00,0.00,23000.00,0.12,0
67708,6730,-1000.00,20000.00,21000.00,2504.78,19495.22,0.36,0
67709,6730,-1000.00,19000.00,20000.00,0.00,19455.63,0.31,0
67710,6730,-1000.00,18000.00,19000.00,0.00,20000.00,0.11,0
67711,6730,-1000.00,17000.00,18000.00,2032.79,16967.21,0.33,0
67712,6730,-1000.00,16000.00,17000.00,0.00,18000.00,0.32,0
67713,6730,-1000.00,15000.00,16000.00,0.00,17000.00,0.20,0
67714,6730,-1000.00,14000.00,15000.00,6065.06,9934.94,0.30,0
67715,6730,-1000.00,13000.00,14000.00,0.00,15000.00,0.18,0
67716,6730,-1000.00,12000.00,13000.00,7608.31,4482.69,0.15,0
67717,6730,-1000.00,11000.00,12000.00,2447.07,10552.93,0.41,0
67718,6730,-1000.00,10000.00,11000.00,0.00,10751.97,0.43,0
67719,6730,-1000.00,9000.00,10000.00,0.00,7415.30,0.32,0
67720,6730,-1000.00,8000.00,9000.00,595.56,5089.88,0.31,0
67721,6730,-1000.00,7000.00,8000.00,4186.87,4813.13,0.24,0
67722,6730,-1000.00,6000.00,7000.00,3776.77,3168.23,0.20,0
67723,6730,-1000.00,5000.00,6000.00,0.00,2552.78,0.01,0
67724,6730,-1000.00,4000.00,5000.00,3160.04,2839.96,0.01,0
67725,6730,-1000.00,3000.00,4000.00,0.00,5000.00,0.26,0
67726,6730,-1000.00,2000.00,3000.00,0.00,1606.27,0.22,0
67727,6730,-1000.00,1000.00,2000.00,0.00,3000.00,0.13,0
67728,6730,-1000.00,0.00,1000.00,0.00,2000.00,0.20,0
67729,6730,-765.18,-765.18,234.82,243.74,521.44,0.30,0
67730,6730,-153.63,-918.81,81.19,0.00,153.63,0.35,0
67731,6730,-81.19,-1000.00,0.00,0.00,81.19,0.06,0
67732,6731,-1000.00,-1000.00,0.00,0.00,1000.00,0.42,0
67733,6732,-1000.00,-1000.00,0.00,627.37,372.63,0.12,0
67734,6733,-1000.00,-1000.00,0.00,180.25,819.75,0.39,0
67735,6734,1000.00,1000.00,2000.00,0.00,685.10,0.36,1
67736,6734,1000.00,2000.00,3000.00,0.00,2000.00,0.10,1
67737,6734,1000.00,3000.00,4000.00,671.46,2328.54,0.30,1
67738,6734,1000.00,4000.00,5000.00,493.61,3506.39,0.13,1
67739,6734,1000.00,5000.00,6000.00,1121.46,3878.54,0.40,1
67740,6734,1000.00,6000.00,7000.00,0.00,6000.00,0.18,1
67741,6734,1000.00,7000.00,8000.00,0.00,7000.00,0.42,1
67742,6734,-1000.00,6000.00,7000.00,3920.33,3421.90,0.20,0
67743,6734,1000.00,7000.00,8000.00,0.00,3927.75,0.32,1
67744,6734,1000.00,8000.00,9000.00,0.00,8000.00,0.09,1
67745,6734,1000.00,9000.00,10000.00,0.00,7702.07,0.21,1
67746,6734,1000.00,10000.00,11000.00,0.00,9495.57,0.44,1
67747,6734,1000.00,11000.00,12000.00,0.00,1078.27,0.14,1
67748,6734,1000.00,12000.00,13000.00,0.00,7473.02,0.28,1
67749,6734,1000.00,13000.00,14000.00,1905.43,11094.57,0.38,1
67750,6734,1000.00,14000.00,15000.00,3234.12,10765.88,0.26,1
67751,6734,1000.00,15000.00,16000.00,7478.65,7521.35,0.09,1
67752,6734,1000.00,16000.00,17000.00,0.00,16000.00,0.06,1
67753,6734,1000.00,17000.00,18000.00,3920.50,13079.50,0.39,1
67754,6734,1000.00,18000.00,19000.00,0.00,18000.00,0.17,1
67755,6734,1000.00,19000.00,20000.00,3654.78,15345.22,0.39,1
67756,6734,1000.00,20000.00,21000.00,8807.27,11192.73,0.12,1
67757,6734,1000.00,21000.00,22000.00,0.00,21000.00,0.40,1
67758,6734,1000.00,22000.00,23000.00,2855.01,5996.96,0.21,1
67759,6734,1000.00,23000.00,24000.00,0.00,23000.00,0.30,1
67760,6734,1000.00,24000.00,25000.00,5357.75,18642.25,0.32,1
67761,6734,1000.00,25000.00,26000.00,0.00,5638.14,0.18,1
67762,6734,1000.00,26000.00,27000.00,0.00,22287.27,0.18,1
67763,6734,1000.00,27000.00,28000.00,3488.35,23511.65,0.43,1
67764,6734,1000.00,28000.00,29000.00,5561.47,22438.53,0.40,1
67765,6734,1000.00,29000.00,30000.00,11806.10,17193.90,0.28,1
67766,6734,-1000.00,28000.00,29000.00,8528.06,0.00,0.09,0
67767,6734,-1000.00,27000.00,28000.00,7582.66,1264.02,0.11,0
67768,6734,1000.00,28000.00,29000.00,7502.11,20497.89,0.37,1
67769,6734,1000.00,29000.00,30000.00,4190.70,15222.36,0.31,1
67770,6734,-1000.00,28000.00,29000.00,17491.35,7770.56,0.13,0
67771,6734,1000.00,29000.00,30000.00,0.00,11846.63,0.23,1
67772,6734,1000.00,30000.00,31000.00,0.00,4874.25,0.17,1
67773,6734,1000.00,31000.00,32000.00,0.00,31000.00,0.11,1
67774,6734,1000.00,32000.00,33000.00,0.00,31201.32,0.13,1
67775,6734,1000.00,33000.00,34000.00,0.00,8502.63,0.20,1
67776,6734,1000.00,34000.00,35000.00,0.00,34000.00,0.41,1
67777,6734,1000.00,35000.00,36000.00,4575.43,30424.57,0.40,1
67778,6734,1000.00,36000.00,37000.00,0.00,36000.00,0.12,1
67779,6734,1000.00,37000.00,38000.00,0.00,37000.00,0.34,1
67780,6734,1000.00,38000.00,39000.00,4827.69,33172.31,0.33,1
67781,6734,1000.00,39000.00,40000.00,5069.13,9430.47,0.19,1
67782,6735,-1000.00,-1000.00,0.00,500.00,500.00,0.07,0
67783,6736,1000.00,1000.00,2000.00,537.56,462.44,0.17,1
67784,6736,1000.00,2000.00,3000.00,1168.78,0.00,0.25,1
67785,6736,-1000.00,1000.00,2000.00,0.00,2421.37,0.42,0
67786,6736,-1000.00,0.00,1000.00,730.77,1269.23,0.15,0
67787,6736,-1000.00,-1000.00,0.00,0.00,1000.00,0.27,0
67788,6737,-1000.00,-1000.00,0.00,357.50,642.50,0.32,0
67789,6738,-1000.00,-1000.00,0.00,687.62,312.38,0.03,0
67790,6739,-1000.00,-1000.00,0.00,0.00,681.46,0.37,0
67791,6740,0.00,0.00,1000.00,0.00,0.00,0.24,0
67792,6740,-221.42,-221.42,778.58,221.42,0.00,0.14,0
67793,6740,-1000.00,-1221.42,-221.42,226.21,552.38,0.35,0
67794,6741,1000.00,1000.00,2000.00,170.64,0.00,0.02,1
67795,6741,1000.00,2000.00,3000.00,65.28,0.00,0.42,1
67796,6741,-1000.00,1000.00,2000.00,0.00,3000.00,0.06,0
67797,6741,-1000.00,0.00,1000.00,0.00,1535.08,0.41,0
67798,6741,-1000.00,-1000.00,0.00,264.49,735.51,0.36,0
67799,6742,-1000.00,-1000.00,0.00,347.28,652.72,0.30,0
67800,6743,-301.43,-301.43,698.57,0.00,301.43,0.18,0
67801,6743,-698.57,-1000.00,0.00,0.00,698.57,0.01,0
67802,6744,0.00,0.00,1000.00,0.00,0.00,0.09,0
67803,6744,0.00,0.00,1000.00,0.00,0.00,0.07,0
67804,6744,-1000.00,-1000.00,0.00,358.19,641.81,0.29,0
67805,6745,-1000.00,-1000.00,0.00,0.00,1000.00,0.36,0
67806,6746,0.00,0.00,1000.00,0.00,0.00,0.02,0
67807,6746,-946.77,-946.77,53.23,0.00,946.77,0.21,0
67808,6746,0.00,-946.77,53.23,0.00,0.00,0.00,0
67809,6746,-51.47,-998.24,1.76,21.32,30.15,0.27,0
67810,6746,-1.30,-999.53,0.47,0.00,1.30,0.05,0
67811,6746,-0.47,-1000.00,0.00,0.00,0.47,0.05,0
67812,6747,-861.62,-861.62,138.38,0.00,861.62,0.35,0
67813,6747,1000.00,138.38,1138.38,67.09,50.46,0.18,1
67814,6747,-1000.00,-861.62,138.38,340.35,798.03,0.34,0
67815,6747,1000.00,138.38,1138.38,82.79,55.60,0.06,1
67816,6747,1000.00,1138.38,2138.38,643.85,494.53,0.15,1
67817,6747,0.00,1138.38,2138.38,0.00,0.00,0.01,0
67818,6747,-1000.00,138.38,1138.38,0.00,1204.32,0.06,0
67819,6747,-760.16,-621.78,378.22,0.00,760.16,0.27,0
67820,6747,0.00,-621.78,378.22,0.00,0.00,0.15,0
67821,6747,-378.22,-1000.00,0.00,0.00,378.22,0.41,0
67822,6748,-661.90,-661.90,338.10,0.00,661.90,0.31,0
67823,6748,-338.10,-1000.00,0.00,0.00,338.10,0.23,0
67824,6749,-493.54,-493.54,506.46,0.00,493.54,0.20,0
67825,6749,0.00,-493.54,506.46,0.00,0.00,0.41,0
67826,6749,1000.00,506.46,1506.46,322.15,101.99,0.10,1
67827,6749,-1000.00,-493.54,506.46,0.00,1343.31,0.44,0
67828,6749,-506.46,-1000.00,0.00,202.11,304.35,0.23,0
67829,6750,-281.28,-281.28,718.72,281.28,0.00,0.22,0
67830,6750,-611.55,-892.83,107.17,574.10,37.45,0.18,0
67831,6750,1000.00,107.17,1107.17,0.00,25.40,0.02,1
67832,6750,1000.00,1107.17,2107.17,257.64,673.96,0.33,1
67833,6750,1000.00,2107.17,3107.17,981.09,1126.08,0.16,1
67834,6750,1000.00,3107.17,4107.17,0.00,3107.17,0.43,1
67835,6750,-1000.00,2107.17,3107.17,2396.33,672.33,0.10,0
67836,6750,-1000.00,1107.17,2107.17,1684.98,1422.19,0.11,0
67837,6750,1000.00,2107.17,3107.17,0.00,1342.14,0.35,1
67838,6750,1000.00,3107.17,4107.17,0.00,3107.17,0.42,1
67839,6750,1000.00,4107.17,5107.17,1059.36,3047.82,0.36,1
67840,6750,1000.00,5107.17,6107.17,2553.59,2553.59,0.04,1
67841,6750,-1000.00,4107.17,5107.17,3147.93,2959.24,0.20,0
67842,6750,1000.00,5107.17,6107.17,0.00,5107.17,0.25,1
67843,6750,-1000.00,4107.17,5107.17,1115.93,1055.28,0.16,0
67844,6750,1000.00,5107.17,6107.17,2327.55,2779.62,0.23,1
67845,6750,1000.00,6107.17,7107.17,0.00,6107.17,0.07,1
67846,6750,1000.00,7107.17,8107.17,0.00,99.26,0.10,1
67847,6750,-1000.00,6107.17,7107.17,5146.70,2960.47,0.06,0
67848,6750,1000.00,7107.17,8107.17,2790.23,4316.95,0.28,1
67849,6750,1000.00,8107.17,9107.17,0.00,8107.17,0.11,1
67850,6750,1000.00,9107.17,10107.17,2190.19,5943.38,0.35,1
67851,6750,1000.00,10107.17,11107.17,3791.97,6315.21,0.25,1
67852,6750,1000.00,11107.17,12107.17,0.00,11041.95,0.42,1
67853,6750,-1000.00,10107.17,11107.17,0.00,12107.17,0.20,0
67854,6750,-1000.00,9107.17,10107.17,0.00,11107.17,0.24,0
67855,6750,-1000.00,8107.17,9107.17,0.00,10107.17,0.23,0
67856,6750,-1000.00,7107.17,8107.17,0.00,9107.17,0.03,0
67857,6750,-1000.00,6107.17,7107.17,0.00,2692.92,0.04,0
67858,6750,-1000.00,5107.17,6107.17,1060.49,6046.68,0.42,0
67859,6750,-1000.00,4107.17,5107.17,0.00,6107.17,0.25,0
67860,6750,-1000.00,3107.17,4107.17,3351.92,1755.26,0.06,0
67861,6750,-1000.00,2107.17,3107.17,0.00,3403.18,0.32,0
67862,6750,-1000.00,1107.17,2107.17,731.41,1422.39,0.27,0
67863,6750,-1000.00,107.17,1107.17,822.87,118.73,0.10,0
67864,6750,-1000.00,-892.83,107.17,0.00,1107.17,0.29,0
67865,6750,-86.79,-979.61,20.39,0.00,86.79,0.39,0
67866,6750,-7.15,-986.76,13.24,0.00,7.15,0.06,0
67867,6750,-13.24,-1000.00,0.00,2.37,10.87,0.41,0
67868,6751,-1000.00,-1000.00,0.00,0.00,1000.00,0.13,0
67869,6752,1000.00,1000.00,2000.00,0.00,886.76,0.38,1
67870,6752,1000.00,2000.00,3000.00,0.00,2000.00,0.04,1
67871,6752,1000.00,3000.00,4000.00,0.00,712.02,0.16,1
67872,6752,1000.00,4000.00,5000.00,1239.92,1445.81,0.22,1
67873,6752,1000.00,5000.00,6000.00,0.00,689.97,0.02,1
67874,6752,1000.00,6000.00,7000.00,0.00,5559.35,0.23,1
67875,6752,1000.00,7000.00,8000.00,2874.92,4125.08,0.12,1
67876,6752,1000.00,8000.00,9000.00,3105.53,3914.26,0.25,1
67877,6752,1000.00,9000.00,10000.00,3321.62,5678.38,0.26,1
67878,6752,-1000.00,8000.00,9000.00,5243.27,4756.73,0.20,0
67879,6752,1000.00,9000.00,10000.00,1718.51,7281.49,0.41,1
67880,6752,-1000.00,8000.00,9000.00,6938.06,3061.94,0.09,0
67881,6752,1000.00,9000.00,10000.00,750.77,7208.15,0.41,1
67882,6752,1000.00,10000.00,11000.00,171.08,4982.14,0.31,1
67883,6752,1000.00,11000.00,12000.00,3617.20,5356.48,0.26,1
67884,6752,1000.00,12000.00,13000.00,3203.13,6663.98,0.30,1
67885,6752,1000.00,13000.00,14000.00,0.00,13000.00,0.01,1
67886,6752,1000.00,14000.00,15000.00,5347.07,8652.93,0.25,1
67887,6752,1000.00,15000.00,16000.00,0.00,12394.39,0.42,1
67888,6752,1000.00,16000.00,17000.00,2763.36,13236.64,0.41,1
67889,6752,1000.00,17000.00,18000.00,2032.00,14968.00,0.41,1
67890,6752,-1000.00,16000.00,17000.00,9180.86,8819.14,0.06,0
67891,6752,-1000.00,15000.00,16000.00,5769.06,11230.94,0.26,0
67892,6752,-1000.00,14000.00,15000.00,9755.69,6244.31,0.12,0
67893,6752,-1000.00,13000.00,14000.00,0.00,15000.00,0.16,0
67894,6752,-1000.00,12000.00,13000.00,1986.63,0.00,0.02,0
67895,6752,-1000.00,11000.00,12000.00,8551.29,4448.71,0.13,0
67896,6752,-1000.00,10000.00,11000.00,0.00,12000.00,0.23,0
67897,6752,-1000.00,9000.00,10000.00,0.00,11000.00,0.02,0
67898,6752,-1000.00,8000.00,9000.00,1434.65,8565.35,0.42,0
67899,6752,-1000.00,7000.00,8000.00,3643.68,5356.32,0.25,0
67900,6752,-1000.00,6000.00,7000.00,2822.70,4234.19,0.27,0
67901,6752,-1000.00,5000.00,6000.00,1171.24,4686.38,0.37,0
67902,6752,-1000.00,4000.00,5000.00,1532.32,4467.68,0.29,0
67903,6752,-1000.00,3000.00,4000.00,0.00,5000.00,0.34,0
67904,6752,-1000.00,2000.00,3000.00,0.00,4000.00,0.35,0
67905,6752,-1000.00,1000.00,2000.00,0.00,3000.00,0.22,0
67906,6752,-1000.00,0.00,1000.00,0.00,2000.00,0.31,0
67907,6752,-1000.00,-1000.00,0.00,335.95,664.05,0.05,0
67908,6753,1000.00,1000.00,2000.00,0.00,563.73,0.34,1
67909,6753,1000.00,2000.00,3000.00,540.94,1459.06,0.30,1
67910,6753,1000.00,3000.00,4000.00,711.48,1443.11,0.28,1
67911,6753,1000.00,4000.00,5000.00,1152.20,2847.80,0.35,1
67912,6753,1000.00,5000.00,6000.00,228.04,4771.96,0.37,1
67913,6753,-1000.00,4000.00,5000.00,5044.76,955.24,0.06,0
67914,6753,1000.00,5000.00,6000.00,0.00,5000.00,0.26,1
67915,6753,1000.00,6000.00,7000.00,0.00,695.32,0.13,1
67916,6753,1000.00,7000.00,8000.00,0.00,7000.00,0.31,1
67917,6753,1000.00,8000.00,9000.00,0.00,4195.45,0.07,1
67918,6753,1000.00,9000.00,10000.00,1323.97,7676.03,0.37,1
67919,6753,1000.00,10000.00,11000.00,548.84,9451.16,0.29,1
67920,6753,1000.00,11000.00,12000.00,4462.40,6537.60,0.28,1
67921,6753,1000.00,12000.00,13000.00,0.00,12000.00,0.36,1
67922,6753,1000.00,13000.00,14000.00,0.00,13000.00,0.07,1
67923,6753,1000.00,14000.00,15000.00,0.00,14000.00,0.06,1
67924,6753,-1000.00,13000.00,14000.00,8023.03,0.00,0.07,0
67925,6753,1000.00,14000.00,15000.00,0.00,6879.82,0.17,1
67926,6753,1000.00,15000.00,16000.00,0.00,15000.00,0.06,1
67927,6753,1000.00,16000.00,17000.00,0.00,16000.00,0.18,1
67928,6753,1000.00,17000.00,18000.00,7378.57,9621.43,0.21,1
67929,6753,1000.00,18000.00,19000.00,2390.64,15609.36,0.37,1
67930,6753,1000.00,19000.00,20000.00,0.00,15739.91,0.38,1
67931,6753,1000.00,20000.00,21000.00,0.00,20000.00,0.24,1
67932,6753,1000.00,21000.00,22000.00,8420.23,12579.77,0.28,1
67933,6753,1000.00,22000.00,23000.00,0.00,11689.51,0.28,1
67934,6753,1000.00,23000.00,24000.00,599.07,22400.93,0.33,1
67935,6753,1000.00,24000.00,25000.00,9102.53,14897.47,0.29,1
67936,6753,-1000.00,23000.00,24000.00,9896.59,6021.85,0.16,0
67937,6753,1000.00,24000.00,25000.00,0.00,24000.00,0.22,1
67938,6753,1000.00,25000.00,26000.00,0.00,10876.10,0.10,1
67939,6753,1000.00,26000.00,27000.00,2133.90,9454.96,0.25,1
67940,6753,1000.00,27000.00,28000.00,0.00,14579.79,0.03,1
67941,6753,1000.00,28000.00,29000.00,9534.81,18465.19,0.16,1
67942,6753,1000.00,29000.00,30000.00,0.00,9511.02,0.20,1
67943,6753,1000.00,30000.00,31000.00,4462.70,25537.30,0.03,1
67944,6753,1000.00,31000.00,32000.00,0.00,31000.00,0.29,1
67945,6753,1000.00,32000.00,33000.00,0.00,32000.00,0.20,1
67946,6753,1000.00,33000.00,34000.00,0.00,33000.00,0.21,1
67947,6754,-359.66,-359.66,640.34,0.00,359.66,0.37,0
67948,6754,1000.00,640.34,1640.34,237.86,0.00,0.36,1
67949,6754,-1000.00,-359.66,640.34,675.54,964.79,0.06,0
67950,6754,-640.34,-1000.00,0.00,302.98,337.35,0.14,0
67951,6755,1000.00,1000.00,2000.00,0.00,736.59,0.01,1
67952,6755,1000.00,2000.00,3000.00,0.00,405.40,0.07,1
67953,6755,1000.00,3000.00,4000.00,0.00,2377.49,0.37,1
67954,6755,-1000.00,2000.00,3000.00,1377.44,0.00,0.08,0
67955,6755,1000.00,3000.00,4000.00,205.68,2794.32,0.26,1
67956,6755,1000.00,4000.00,5000.00,1299.95,2700.05,0.34,1
67957,6755,1000.00,5000.00,6000.00,546.53,4453.47,0.42,1
67958,6755,1000.00,6000.00,7000.00,1945.98,4054.02,0.19,1
67959,6755,1000.00,7000.00,8000.00,2277.78,4722.22,0.31,1
67960,6755,0.00,7000.00,8000.00,0.00,0.00,0.01,0
67961,6755,-1000.00,6000.00,7000.00,5488.53,0.00,0.04,0
67962,6755,1000.00,7000.00,8000.00,3031.06,3968.94,0.19,1
67963,6755,-1000.00,6000.00,7000.00,4446.91,3553.09,0.18,0
67964,6755,1000.00,7000.00,8000.00,2293.91,4706.09,0.27,1
67965,6755,1000.00,8000.00,9000.00,0.00,4969.24,0.34,1
67966,6755,1000.00,9000.00,10000.00,3447.18,5552.82,0.25,1
67967,6755,1000.00,10000.00,11000.00,4864.92,5135.08,0.14,1
67968,6755,1000.00,11000.00,12000.00,0.00,4428.99,0.03,1
67969,6755,1000.00,12000.00,13000.00,1043.47,7964.96,0.37,1
67970,6755,1000.00,13000.00,14000.00,0.00,13000.00,0.21,1
67971,6755,1000.00,14000.00,15000.00,1000.24,4495.17,0.23,1
67972,6755,1000.00,15000.00,16000.00,0.00,15000.00,0.15,1
67973,6755,1000.00,16000.00,17000.00,0.00,16000.00,0.31,1
67974,6755,0.00,16000.00,17000.00,0.00,0.00,0.00,0
67975,6755,1000.00,17000.00,18000.00,0.00,14716.98,0.14,1
67976,6755,1000.00,18000.00,19000.00,2670.16,15329.84,0.42,1
67977,6755,1000.00,19000.00,20000.00,6634.12,7155.33,0.22,1
67978,6755,-1000.00,18000.00,19000.00,12462.21,7537.79,0.04,0
67979,6755,-1000.00,17000.00,18000.00,2223.71,0.00,0.07,0
67980,6755,1000.00,18000.00,19000.00,2546.26,15453.74,0.21,1
67981,6755,1000.00,19000.00,20000.00,0.00,19000.00,0.06,1
67982,6755,1000.00,20000.00,21000.00,9844.60,10155.40,0.23,1
67983,6755,1000.00,21000.00,22000.00,0.00,21000.00,0.09,1
67984,6755,1000.00,22000.00,23000.00,0.00,21178.61,0.30,1
67985,6755,-1000.00,21000.00,22000.00,20026.13,0.00,0.02,0
67986,6755,1000.00,22000.00,23000.00,271.17,6858.16,0.23,1
67987,6755,1000.00,23000.00,24000.00,0.00,7062.43,0.21,1
67988,6755,1000.00,24000.00,25000.00,0.00,22298.13,0.25,1
67989,6755,1000.00,25000.00,26000.00,4767.48,20232.52,0.41,1
67990,6756,-1000.00,-1000.00,0.00,0.00,1000.00,0.35,0
67991,6757,-1000.00,-1000.00,0.00,0.00,1000.00,0.30,0
67992,6758,1000.00,1000.00,2000.00,131.39,151.47,0.16,1
67993,6758,1000.00,2000.00,3000.00,0.00,2000.00,0.03,1
67994,6758,1000.00,3000.00,4000.00,1097.62,1902.38,0.24,1
67995,6758,0.00,3000.00,4000.00,0.00,0.00,0.03,0
67996,6758,1000.00,4000.00,5000.00,0.00,4000.00,0.18,1
67997,6758,1000.00,5000.00,6000.00,195.44,4804.56,0.13,1
67998,6758,1000.00,6000.00,7000.00,2555.35,3444.65,0.19,1
67999,6758,-1000.00,5000.00,6000.00,5242.22,1757.78,0.02,0
68000,6758,1000.00,6000.00,7000.00,0.00,3313.39,0.11,1
68001,6758,1000.00,7000.00,8000.00,0.00,5597.30,0.41,1
68002,6758,1000.00,8000.00,9000.00,2064.31,5935.69,0.35,1
68003,6758,1000.00,9000.00,10000.00,0.00,9000.00,0.38,1
68004,6758,1000.00,10000.00,11000.00,0.00,10000.00,0.39,1
68005,6758,1000.00,11000.00,12000.00,4589.30,6410.70,0.23,1
68006,6758,1000.00,12000.00,13000.00,0.00,12000.00,0.01,1
68007,6758,1000.00,13000.00,14000.00,4433.77,8566.23,0.27,1
68008,6758,1000.00,14000.00,15000.00,2328.38,11671.62,0.42,1
68009,6758,1000.00,15000.00,16000.00,1690.18,12161.44,0.41,1
68010,6758,1000.00,16000.00,17000.00,0.00,16000.00,0.16,1
68011,6758,1000.00,17000.00,18000.00,0.00,6723.03,0.26,1
68012,6758,1000.00,18000.00,19000.00,0.00,18000.00,0.38,1
68013,6759,-1000.00,-1000.00,0.00,0.00,113.20,0.35,0
68014,6760,-1000.00,-1000.00,0.00,0.00,1000.00,0.26,0
68015,6761,-1000.00,-1000.00,0.00,332.30,667.70,0.31,0
68016,6762,-668.69,-668.69,331.31,668.69,0.00,0.15,0
68017,6762,-331.31,-1000.00,0.00,280.89,50.43,0.15,0
68018,6762,-0.00,-1000.00,-0.00,0.00,0.00,0.03,0
68019,6763,-134.91,-134.91,865.09,0.00,134.91,0.15,0
68020,6763,-865.09,-1000.00,0.00,0.00,865.09,0.41,0
68021,6764,-1000.00,-1000.00,0.00,500.00,500.00,0.00,0
68022,6765,-1000.00,-1000.00,0.00,256.25,743.75,0.37,0
68023,6766,-1000.00,-1000.00,0.00,0.00,1000.00,0.03,0
68024,6767,-1000.00,-1000.00,0.00,650.49,349.51,0.03,0
68025,6768,-1000.00,-1000.00,0.00,0.00,1000.00,0.14,0
68026,6769,1000.00,1000.00,2000.00,254.70,745.30,0.35,1
68027,6769,1000.00,2000.00,3000.00,309.08,1690.92,0.37,1
68028,6769,-1000.00,1000.00,2000.00,2133.96,0.00,0.03,0
68029,6769,1000.00,2000.00,3000.00,165.48,1834.52,0.37,1
68030,6769,-1000.00,1000.00,2000.00,1903.02,1096.98,0.10,0
68031,6769,-1000.00,0.00,1000.00,2000.00,0.00,0.00,0
68032,6769,1000.00,1000.00,2000.00,215.10,784.90,0.40,1
68033,6769,1000.00,2000.00,3000.00,0.96,1999.04,0.43,1
68034,6769,-1000.00,1000.00,2000.00,1646.42,1353.58,0.18,0
68035,6769,1000.00,2000.00,3000.00,644.19,1355.81,0.34,1
68036,6769,1000.00,3000.00,4000.00,0.00,3000.00,0.26,1
68037,6769,1000.00,4000.00,5000.00,0.00,740.61,0.17,1
68038,6769,1000.00,5000.00,6000.00,521.32,4478.68,0.42,1
68039,6769,1000.00,6000.00,7000.00,1978.85,4021.15,0.29,1
68040,6769,1000.00,7000.00,8000.00,905.29,6094.71,0.40,1
68041,6769,1000.00,8000.00,9000.00,0.00,8000.00,0.28,1
68042,6769,1000.00,9000.00,10000.00,0.00,9000.00,0.30,1
68043,6769,1000.00,10000.00,11000.00,0.00,10000.00,0.05,1
68044,6769,1000.00,11000.00,12000.00,197.63,10802.37,0.14,1
68045,6769,1000.00,12000.00,13000.00,0.00,12000.00,0.06,1
68046,6769,1000.00,13000.00,14000.00,0.00,13000.00,0.34,1
68047,6769,1000.00,14000.00,15000.00,0.00,14000.00,0.30,1
68048,6769,1000.00,15000.00,16000.00,6797.11,8202.89,0.16,1
68049,6769,1000.00,16000.00,17000.00,0.00,16000.00,0.18,1
68050,6769,1000.00,17000.00,18000.00,0.00,15113.27,0.43,1
68051,6769,1000.00,18000.00,19000.00,0.00,18000.00,0.21,1
68052,6769,1000.00,19000.00,20000.00,0.00,19000.00,0.02,1
68053,6769,-1000.00,18000.00,19000.00,12154.72,1508.26,0.08,0
68054,6769,1000.00,19000.00,20000.00,0.00,19000.00,0.28,1
68055,6769,1000.00,20000.00,21000.00,0.00,16152.25,0.41,1
68056,6769,-1000.00,19000.00,20000.00,15947.12,5052.88,0.04,0
68057,6769,1000.00,20000.00,21000.00,4105.58,15894.42,0.23,1
68058,6769,1000.00,21000.00,22000.00,2689.30,18310.70,0.28,1
68059,6769,1000.00,22000.00,23000.00,7406.99,9772.79,0.25,1
68060,6769,1000.00,23000.00,24000.00,0.00,2837.37,0.08,1
68061,6769,1000.00,24000.00,25000.00,6014.17,17985.83,0.32,1
68062,6769,1000.00,25000.00,26000.00,0.00,25000.00,0.34,1
68063,6769,1000.00,26000.00,27000.00,9798.84,16201.16,0.23,1
68064,6769,1000.00,27000.00,28000.00,0.00,8459.80,0.20,1
68065,6769,1000.00,28000.00,29000.00,0.00,25499.01,0.05,1
68066,6769,1000.00,29000.00,30000.00,0.00,29000.00,0.34,1
68067,6769,1000.00,30000.00,31000.00,0.00,29192.97,0.38,1
68068,6769,1000.00,31000.00,32000.00,0.00,31000.00,0.21,1
68069,6769,1000.00,32000.00,33000.00,0.00,8817.56,0.21,1
68070,6769,-1000.00,31000.00,32000.00,19181.51,13818.49,0.15,0
68071,6770,1000.00,1000.00,2000.00,455.89,544.11,0.12,1
68072,6770,1000.00,2000.00,3000.00,0.00,2000.00,0.03,1
68073,6770,1000.00,3000.00,4000.00,0.00,3000.00,0.12,1
68074,6770,1000.00,4000.00,5000.00,0.00,4000.00,0.08,1
68075,6770,1000.00,5000.00,6000.00,0.00,783.51,0.16,1
68076,6770,1000.00,6000.00,7000.00,1333.52,4666.48,0.32,1
68077,6770,1000.00,7000.00,8000.00,0.00,3018.44,0.28,1
68078,6770,1000.00,8000.00,9000.00,0.00,8000.00,0.16,1
68079,6770,1000.00,9000.00,10000.00,0.00,8743.64,0.41,1
68080,6770,1000.00,10000.00,11000.00,0.00,10000.00,0.22,1
68081,6770,1000.00,11000.00,12000.00,0.00,3437.80,0.14,1
68082,6770,1000.00,12000.00,13000.00,264.33,11735.67,0.25,1
68083,6770,1000.00,13000.00,14000.00,0.00,6645.53,0.32,1
68084,6770,1000.00,14000.00,15000.00,1698.43,10333.75,0.39,1
68085,6770,1000.00,15000.00,16000.00,1737.01,13262.99,0.31,1
68086,6770,1000.00,16000.00,17000.00,7472.23,8527.77,0.24,1
68087,6770,1000.00,17000.00,18000.00,5702.15,11297.85,0.14,1
68088,6770,0.00,17000.00,18000.00,0.00,0.00,0.05,0
68089,6770,1000.00,18000.00,19000.00,0.00,18000.00,0.35,1
68090,6770,1000.00,19000.00,20000.00,8263.09,10736.91,0.23,1
68091,6770,1000.00,20000.00,21000.00,0.00,7907.78,0.18,1
68092,6770,1000.00,21000.00,22000.00,0.00,15070.10,0.37,1
68093,6770,1000.00,22000.00,23000.00,5720.64,7180.24,0.21,1
68094,6770,1000.00,23000.00,24000.00,0.00,23000.00,0.12,1
68095,6770,1000.00,24000.00,25000.00,5013.78,18986.22,0.28,1
68096,6770,1000.00,25000.00,26000.00,0.00,25000.00,0.05,1
68097,6770,1000.00,26000.00,27000.00,0.00,14438.34,0.34,1
68098,6770,1000.00,27000.00,28000.00,0.00,23476.06,0.38,1
68099,6770,1000.00,28000.00,29000.00,7269.53,20730.47,0.37,1
68100,6770,1000.00,29000.00,30000.00,11975.75,17024.25,0.02,1
68101,6770,1000.00,30000.00,31000.00,5937.00,24063.00,0.41,1
68102,6770,0.00,30000.00,31000.00,0.00,0.00,0.04,0
68103,6770,1000.00,31000.00,32000.00,0.00,31000.00,0.04,1
68104,6770,1000.00,32000.00,33000.00,0.00,32000.00,0.12,1
68105,6770,-1000.00,31000.00,32000.00,16646.40,16353.60,0.16,0
68106,6770,1000.00,32000.00,33000.00,1023.27,22772.29,0.39,1
68107,6770,1000.00,33000.00,34000.00,9765.83,23234.17,0.09,1
68108,6770,-1000.00,32000.00,33000.00,6187.34,1083.52,0.11,0
68109,6770,1000.00,33000.00,34000.00,10442.47,22557.53,0.32,1
68110,6770,1000.00,34000.00,35000.00,0.00,21123.37,0.05,1
68111,6770,1000.00,35000.00,36000.00,0.00,35000.00,0.18,1
68112,6770,1000.00,36000.00,37000.00,0.00,36000.00,0.15,1
68113,6770,1000.00,37000.00,38000.00,0.00,37000.00,0.25,1
68114,6770,1000.00,38000.00,39000.00,7669.60,30330.40,0.26,1
68115,6770,1000.00,39000.00,40000.00,12245.85,26754.15,0.18,1
68116,6770,1000.00,40000.00,41000.00,0.00,40000.00,0.31,1
68117,6770,1000.00,41000.00,42000.00,2999.34,38000.66,0.30,1
68118,6770,-1000.00,40000.00,41000.00,2780.66,39219.34,0.26,0
68119,6770,-1000.00,39000.00,40000.00,25579.40,15420.60,0.06,0
68120,6770,-1000.00,38000.00,39000.00,6656.27,18419.41,0.28,0
68121,6770,-1000.00,37000.00,38000.00,0.00,34008.43,0.04,0
68122,6770,-1000.00,36000.00,37000.00,0.00,38000.00,0.16,0
68123,6770,-1000.00,35000.00,36000.00,16723.69,20276.31,0.06,0
68124,6770,-1000.00,34000.00,35000.00,0.00,35436.06,0.34,0
68125,6770,-1000.00,33000.00,34000.00,0.00,35000.00,0.27,0
68126,6770,-1000.00,32000.00,33000.00,15326.79,3700.51,0.11,0
68127,6770,-1000.00,31000.00,32000.00,13608.61,323.33,0.09,0
68128,6770,-1000.00,30000.00,31000.00,0.00,32000.00,0.38,0
68129,6770,-1000.00,29000.00,30000.00,0.00,25514.26,0.42,0
68130,6770,-1000.00,28000.00,29000.00,0.00,27149.24,0.43,0
68131,6770,-1000.00,27000.00,28000.00,0.00,17688.99,0.25,0
68132,6770,-1000.00,26000.00,27000.00,13181.96,14818.04,0.22,0
68133,6770,-1000.00,25000.00,26000.00,11755.61,15244.39,0.14,0
68134,6770,-1000.00,24000.00,25000.00,0.00,13220.97,0.08,0
68135,6770,-1000.00,23000.00,24000.00,0.00,25000.00,0.21,0
68136,6770,-1000.00,22000.00,23000.00,0.00,19043.58,0.39,0
68137,6770,-1000.00,21000.00,22000.00,10932.86,12067.14,0.17,0
68138,6770,0.00,21000.00,22000.00,0.00,0.00,0.01,0
68139,6770,-1000.00,20000.00,21000.00,9855.72,12144.28,0.18,0
68140,6770,-1000.00,19000.00,20000.00,2954.02,18045.98,0.21,0
68141,6771,-915.95,-915.95,84.05,0.00,915.95,0.18,0
68142,6771,-84.05,-1000.00,0.00,0.00,84.05,0.04,0
68143,6772,-818.21,-818.21,181.79,0.00,818.21,0.28,0
68144,6772,-127.10,-945.30,54.70,0.00,127.10,0.29,0
68145,6772,-5.35,-950.65,49.35,0.00,5.35,0.14,0
68146,6772,-49.35,-1000.00,0.00,0.00,49.35,0.24,0
68147,6773,-934.29,-934.29,65.71,0.00,934.29,0.14,0
68148,6773,-65.71,-1000.00,0.00,25.59,40.11,0.29,0
68149,6774,-1000.00,-1000.00,0.00,380.73,619.27,0.17,0
68150,6775,-874.76,-874.76,125.24,96.00,778.77,0.41,0
68151,6775,-125.24,-1000.00,0.00,0.00,125.24,0.41,0
68152,6776,1000.00,1000.00,2000.00,117.84,882.16,0.39,1
68153,6776,1000.00,2000.00,3000.00,136.31,1863.69,0.32,1
68154,6776,1000.00,3000.00,4000.00,0.00,3000.00,0.05,1
68155,6776,-1000.00,2000.00,3000.00,2128.65,1871.35,0.06,0
68156,6776,1000.00,3000.00,4000.00,0.00,3000.00,0.43,1
68157,6776,-1000.00,2000.00,3000.00,1272.28,0.00,0.01,0
68158,6776,1000.00,3000.00,4000.00,0.00,2230.10,0.30,1
68159,6776,1000.00,4000.00,5000.00,0.00,4000.00,0.39,1
68160,6776,1000.00,5000.00,6000.00,0.00,4940.36,0.32,1
68161,6776,1000.00,6000.00,7000.00,1076.12,4923.88,0.25,1
68162,6776,1000.00,7000.00,8000.00,953.57,6046.43,0.37,1
68163,6776,-1000.00,6000.00,7000.00,1599.40,0.00,0.08,0
68164,6776,1000.00,7000.00,8000.00,0.00,7000.00,0.19,1
68165,6776,1000.00,8000.00,9000.00,0.00,8000.00,0.43,1
68166,6776,-602.01,7397.99,8397.99,602.01,0.00,0.10,0
68167,6776,1000.00,8397.99,9397.99,648.36,7749.63,0.37,1
68168,6776,1000.00,9397.99,10397.99,0.00,6619.84,0.13,1
68169,6776,1000.00,10397.99,11397.99,3667.65,5202.82,0.26,1
68170,6776,1000.00,11397.99,12397.99,0.00,7221.51,0.23,1
68171,6776,1000.00,12397.99,13397.99,0.00,12397.99,0.14,1
68172,6776,1000.00,13397.99,14397.99,262.22,11727.20,0.43,1
68173,6776,1000.00,14397.99,15397.99,6210.98,8187.01,0.18,1
68174,6776,1000.00,15397.99,16397.99,0.00,8036.31,0.16,1
68175,6776,1000.00,16397.99,17397.99,0.00,11405.36,0.25,1
68176,6776,-1000.00,15397.99,16397.99,7816.00,6511.26,0.19,0
68177,6776,1000.00,16397.99,17397.99,5831.65,10566.34,0.24,1
68178,6776,1000.00,17397.99,18397.99,0.00,17397.99,0.30,1
68179,6776,1000.00,18397.99,19397.99,5880.36,12517.63,0.34,1
68180,6776,1000.00,19397.99,20397.99,0.00,14568.64,0.28,1
68181,6776,1000.00,20397.99,21397.99,0.00,14287.47,0.37,1
68182,6776,1000.00,21397.99,22397.99,0.00,21397.99,0.32,1
68183,6776,1000.00,22397.99,23397.99,10576.96,11821.03,0.04,1
68184,6776,1000.00,23397.99,24397.99,0.00,23397.99,0.19,1
68185,6776,1000.00,24397.99,25397.99,0.00,24397.99,0.14,1
68186,6776,1000.00,25397.99,26397.99,0.00,8863.54,0.25,1
68187,6776,1000.00,26397.99,27397.99,0.00,3885.80,0.15,1
68188,6776,1000.00,27397.99,28397.99,0.00,27397.99,0.30,1
68189,6776,1000.00,28397.99,29397.99,10298.11,18099.88,0.31,1
68190,6776,1000.00,29397.99,30397.99,0.00,29397.99,0.31,1
68191,6776,1000.00,30397.99,31397.99,0.00,30397.99,0.06,1
68192,6776,1000.00,31397.99,32397.99,0.00,29305.98,0.07,1
68193,6776,1000.00,32397.99,33397.99,14086.59,18311.41,0.19,1
68194,6776,0.00,32397.99,33397.99,0.00,0.00,0.00,0
68195,6776,1000.00,33397.99,34397.99,0.00,24574.00,0.40,1
68196,6776,-1000.00,32397.99,33397.99,17338.54,17059.45,0.13,0
68197,6776,1000.00,33397.99,34397.99,1910.82,31487.17,0.16,1
68198,6776,1000.00,34397.99,35397.99,0.00,31857.33,0.38,1
68199,6776,-1000.00,33397.99,34397.99,21277.38,14120.61,0.13,0
68200,6777,-1000.00,-1000.00,0.00,46.96,953.04,0.04,0
68201,6778,-353.54,-353.54,646.46,0.00,353.54,0.10,0
68202,6778,-646.46,-1000.00,0.00,145.83,500.63,0.26,0
68203,6779,-1000.00,-1000.00,0.00,0.00,1000.00,0.26,0
68204,6780,-1000.00,-1000.00,0.00,0.00,1000.00,0.28,0
68205,6781,-711.74,-711.74,288.26,120.10,591.63,0.34,0
68206,6781,-288.26,-1000.00,0.00,0.00,288.26,0.17,0
68207,6782,0.00,0.00,1000.00,0.00,0.00,0.22,0
68208,6782,1000.00,1000.00,2000.00,265.42,0.00,0.27,1
68209,6782,-1000.00,0.00,1000.00,0.00,1058.58,0.29,0
68210,6782,-972.81,-972.81,27.19,0.00,972.81,0.18,0
68211,6782,1000.00,27.19,1027.19,4.08,1.58,0.12,1
68212,6782,-718.32,-691.13,308.87,0.00,718.32,0.14,0
68213,6782,-308.87,-1000.00,0.00,45.92,262.95,0.31,0
68214,6783,-1000.00,-1000.00,0.00,542.76,457.24,0.19,0
68215,6784,-1000.00,-1000.00,0.00,319.71,680.29,0.25,0
68216,6785,-1000.00,-1000.00,0.00,479.38,520.62,0.09,0
68217,6786,-929.19,-929.19,70.81,0.00,929.19,0.43,0
68218,6786,-70.81,-1000.00,0.00,0.00,70.81,0.38,0
68219,6787,-1000.00,-1000.00,0.00,168.22,0.00,0.10,0
68220,6788,-798.80,-798.80,201.20,22.37,776.42,0.41,0
68221,6788,-161.79,-960.58,39.42,0.00,161.79,0.12,0
68222,6788,-39.42,-1000.00,0.00,19.47,19.95,0.17,0
68223,6789,1000.00,1000.00,2000.00,0.00,1000.00,0.05,1
68224,6789,1000.00,2000.00,3000.00,0.00,2000.00,0.35,1
68225,6789,1000.00,3000.00,4000.00,0.00,3000.00,0.18,1
68226,6789,-1000.00,2000.00,3000.00,2692.04,1307.96,0.03,0
68227,6789,1000.00,3000.00,4000.00,1298.33,1701.67,0.19,1
68228,6789,1000.00,4000.00,5000.00,0.00,4000.00,0.07,1
68229,6789,-1000.00,3000.00,4000.00,3082.75,1239.19,0.12,0
68230,6789,1000.00,4000.00,5000.00,1103.58,2896.42,0.33,1
68231,6789,1000.00,5000.00,6000.00,0.00,1299.65,0.14,1
68232,6789,1000.00,6000.00,7000.00,1497.02,4502.98,0.23,1
68233,6789,1000.00,7000.00,8000.00,2291.32,4708.68,0.18,1
68234,6789,1000.00,8000.00,9000.00,0.00,6418.76,0.02,1
68235,6789,1000.00,9000.00,10000.00,0.00,9000.00,0.08,1
68236,6789,1000.00,10000.00,11000.00,0.00,5424.38,0.27,1
68237,6789,0.00,10000.00,11000.00,0.00,0.00,0.09,0
68238,6789,1000.00,11000.00,12000.00,0.00,9087.86,0.35,1
68239,6789,1000.00,12000.00,13000.00,5749.09,6250.91,0.13,1
68240,6789,1000.00,13000.00,14000.00,0.00,4407.32,0.03,1
68241,6789,1000.00,14000.00,15000.00,0.00,14000.00,0.06,1
68242,6789,1000.00,15000.00,16000.00,0.00,10219.75,0.38,1
68243,6789,1000.00,16000.00,17000.00,0.00,16000.00,0.08,1
68244,6789,1000.00,17000.00,18000.00,3480.71,6674.37,0.25,1
68245,6789,1000.00,18000.00,19000.00,4524.38,13475.62,0.38,1
68246,6789,1000.00,19000.00,20000.00,7182.56,11817.44,0.25,1
68247,6789,-1000.00,18000.00,19000.00,0.00,20000.00,0.24,0
68248,6789,-1000.00,17000.00,18000.00,9500.00,9500.00,0.04,0
68249,6789,-1000.00,16000.00,17000.00,1263.73,16736.27,0.42,0
68250,6789,-1000.00,15000.00,16000.00,0.00,3656.81,0.16,0
68251,6789,-1000.00,14000.00,15000.00,0.00,16000.00,0.35,0
68252,6789,-1000.00,13000.00,14000.00,0.00,15000.00,0.11,0
68253,6789,-1000.00,12000.00,13000.00,0.00,12006.62,0.20,0
68254,6789,-1000.00,11000.00,12000.00,5821.81,3068.15,0.15,0
68255,6789,-1000.00,10000.00,11000.00,4563.47,7436.53,0.09,0
68256,6789,-1000.00,9000.00,10000.00,0.00,11000.00,0.36,0
68257,6789,-1000.00,8000.00,9000.00,0.00,8892.69,0.29,0
68258,6789,-1000.00,7000.00,8000.00,0.00,7245.35,0.41,0
68259,6789,-1000.00,6000.00,7000.00,228.85,4331.95,0.33,0
68260,6789,-1000.00,5000.00,6000.00,270.60,6729.40,0.42,0
68261,6789,-1000.00,4000.00,5000.00,0.00,1877.45,0.19,0
68262,6789,-1000.00,3000.00,4000.00,0.00,2300.88,0.28,0
68263,6789,-1000.00,2000.00,3000.00,0.00,4000.00,0.15,0
68264,6789,-1000.00,1000.00,2000.00,1164.11,1835.89,0.28,0
68265,6789,-1000.00,0.00,1000.00,465.72,1534.28,0.20,0
68266,6789,-1000.00,-1000.00,0.00,390.00,610.00,0.25,0
68267,6790,-1000.00,-1000.00,0.00,489.42,510.58,0.15,0
68268,6791,1000.00,1000.00,2000.00,0.00,1000.00,0.10,1
68269,6791,1000.00,2000.00,3000.00,0.00,2000.00,0.25,1
68270,6791,1000.00,3000.00,4000.00,0.00,3000.00,0.30,1
68271,6791,1000.00,4000.00,5000.00,2000.00,2000.00,0.05,1
68272,6791,1000.00,5000.00,6000.00,2193.20,2806.80,0.23,1
68273,6791,1000.00,6000.00,7000.00,0.00,6000.00,0.17,1
68274,6791,1000.00,7000.00,8000.00,2517.91,4482.09,0.13,1
68275,6791,-1000.00,6000.00,7000.00,4211.13,3788.87,0.17,0
68276,6791,1000.00,7000.00,8000.00,28.35,4683.70,0.38,1
68277,6791,1000.00,8000.00,9000.00,1823.89,6176.11,0.36,1
68278,6791,1000.00,9000.00,10000.00,0.00,4295.16,0.29,1
68279,6791,1000.00,10000.00,11000.00,0.00,10000.00,0.20,1
68280,6791,-1000.00,9000.00,10000.00,4108.04,6891.96,0.30,0
68281,6791,-1000.00,8000.00,9000.00,0.00,76.26,0.11,0
68282,6791,-1000.00,7000.00,8000.00,0.00,9000.00,0.11,0
68283,6791,-1000.00,6000.00,7000.00,0.00,8000.00,0.14,0
68284,6791,-1000.00,5000.00,6000.00,3209.92,3790.08,0.11,0
68285,6791,-1000.00,4000.00,5000.00,2707.34,3292.66,0.16,0
68286,6791,-1000.00,3000.00,4000.00,57.46,4942.54,0.18,0
68287,6791,-1000.00,2000.00,3000.00,0.00,4000.00,0.28,0
68288,6791,-1000.00,1000.00,2000.00,0.00,2482.75,0.39,0
68289,6791,-1000.00,0.00,1000.00,473.34,1526.66,0.38,0
68290,6791,0.00,0.00,1000.00,0.00,0.00,0.41,0
68291,6791,1000.00,1000.00,2000.00,690.46,193.24,0.09,1
68292,6791,1000.00,2000.00,3000.00,475.36,0.00,0.08,1
68293,6791,-1000.00,1000.00,2000.00,0.00,3000.00,0.24,0
68294,6791,-1000.00,0.00,1000.00,1000.00,1000.00,0.09,0
68295,6791,-456.59,-456.59,543.41,0.00,456.59,0.27,0
68296,6791,-543.41,-1000.00,0.00,0.00,543.41,0.31,0
68297,6792,1000.00,1000.00,2000.00,16.60,686.73,0.39,1
68298,6792,-1000.00,0.00,1000.00,662.50,491.13,0.17,0
68299,6792,1000.00,1000.00,2000.00,0.00,1000.00,0.26,1
68300,6792,1000.00,2000.00,3000.00,822.64,1177.36,0.01,1
68301,6792,-366.30,1633.70,2633.70,366.30,0.00,0.05,0
68302,6792,1000.00,2633.70,3633.70,0.00,2633.70,0.33,1
68303,6792,1000.00,3633.70,4633.70,0.00,1437.72,0.05,1
68304,6792,-1000.00,2633.70,3633.70,2375.13,274.61,0.09,0
68305,6792,1000.00,3633.70,4633.70,0.00,3633.70,0.28,1
68306,6792,1000.00,4633.70,5633.70,0.00,4633.70,0.33,1
68307,6792,1000.00,5633.70,6633.70,0.00,5633.70,0.29,1
68308,6792,1000.00,6633.70,7633.70,0.00,6633.70,0.09,1
68309,6792,1000.00,7633.70,8633.70,0.00,7633.70,0.36,1
68310,6792,1000.00,8633.70,9633.70,0.00,7476.49,0.02,1
68311,6792,1000.00,9633.70,10633.70,0.00,9633.70,0.02,1
68312,6792,1000.00,10633.70,11633.70,1996.56,8637.14,0.36,1
68313,6792,-1000.00,9633.70,10633.70,6036.18,5597.52,0.19,0
68314,6792,1000.00,10633.70,11633.70,4.57,10629.13,0.23,1
68315,6792,-1000.00,9633.70,10633.70,7596.10,0.00,0.03,0
68316,6792,1000.00,10633.70,11633.70,0.00,10633.70,0.25,1
68317,6792,-1000.00,9633.70,10633.70,7570.77,4062.93,0.08,0
68318,6792,1000.00,10633.70,11633.70,5203.02,5430.67,0.06,1
68319,6792,-1000.00,9633.70,10633.70,0.00,11633.70,0.14,0
68320,6792,-1000.00,8633.70,9633.70,3470.70,7163.00,0.34,0
68321,6792,-1000.00,7633.70,8633.70,0.00,9633.70,0.34,0
68322,6792,-132.11,7501.59,8501.59,0.00,132.11,0.00,0
68323,6792,-1000.00,6501.59,7501.59,4059.23,4442.36,0.02,0
68324,6792,-1000.00,5501.59,6501.59,2940.50,4561.09,0.29,0
68325,6792,-1000.00,4501.59,5501.59,0.00,6501.59,0.25,0
68326,6792,-1000.00,3501.59,4501.59,2181.41,3320.18,0.22,0
68327,6792,-1000.00,2501.59,3501.59,0.00,4501.59,0.39,0
68328,6792,-1000.00,1501.59,2501.59,0.00,1199.07,0.24,0
68329,6792,-1000.00,501.59,1501.59,0.00,2501.59,0.14,0
68330,6792,-1000.00,-498.41,501.59,789.04,712.55,0.20,0
68331,6792,-237.68,-736.09,263.91,0.00,237.68,0.21,0
68332,6792,-263.91,-1000.00,0.00,131.95,131.95,0.03,0
68333,6793,-1000.00,-1000.00,0.00,0.00,1000.00,0.01,0
68334,6794,-1000.00,-1000.00,0.00,0.00,992.24,0.28,0
68335,6795,-1000.00,-1000.00,0.00,0.00,493.52,0.31,0
68336,6796,0.00,0.00,1000.00,0.00,0.00,0.07,0
68337,6796,-1000.00,-1000.00,0.00,571.65,381.57,0.17,0
68338,6797,0.00,0.00,1000.00,0.00,0.00,0.34,0
68339,6797,-252.55,-252.55,747.45,0.00,252.55,0.44,0
68340,6797,-747.45,-1000.00,0.00,0.00,747.45,0.29,0
68341,6798,1000.00,1000.00,2000.00,0.00,961.58,0.12,1
68342,6798,-1000.00,0.00,1000.00,900.83,726.46,0.20,0
68343,6798,1000.00,1000.00,2000.00,0.00,429.32,0.27,1
68344,6798,1000.00,2000.00,3000.00,0.00,2000.00,0.20,1
68345,6798,-1000.00,1000.00,2000.00,675.12,1907.68,0.34,0
68346,6798,-1000.00,0.00,1000.00,0.00,2000.00,0.36,0
68347,6798,-1000.00,-1000.00,0.00,0.00,1000.00,0.15,0
68348,6799,-1000.00,-1000.00,0.00,267.42,732.58,0.17,0
68349,6800,-1000.00,-1000.00,0.00,687.84,0.00,0.04,0
68350,6801,-734.95,-734.95,265.05,98.78,636.16,0.36,0
68351,6801,-221.37,-956.31,43.69,0.00,221.37,0.30,0
68352,6801,-1000.00,-1956.31,-956.31,9.47,0.00,0.04,0
68353,6802,-1000.00,-1000.00,0.00,296.22,703.78,0.34,0
68354,6803,-615.46,-615.46,384.54,0.00,615.46,0.34,0
68355,6803,-384.54,-1000.00,0.00,0.00,384.54,0.04,0
68356,6804,1000.00,1000.00,2000.00,0.00,1000.00,0.13,1
68357,6804,1000.00,2000.00,3000.00,0.00,1667.52,0.43,1
68358,6804,1000.00,3000.00,4000.00,0.00,1693.88,0.32,1
68359,6804,-1000.00,2000.00,3000.00,1072.12,560.56,0.14,0
68360,6804,1000.00,3000.00,4000.00,0.00,2322.04,0.40,1
68361,6804,1000.00,4000.00,5000.00,0.00,3853.61,0.27,1
68362,6804,-1000.00,3000.00,4000.00,2624.32,0.00,0.05,0
68363,6804,1000.00,4000.00,5000.00,1396.96,2603.04,0.32,1
68364,6804,1000.00,5000.00,6000.00,171.32,4828.68,0.40,1
68365,6804,1000.00,6000.00,7000.00,0.00,3198.94,0.17,1
68366,6804,1000.00,7000.00,8000.00,0.00,7000.00,0.01,1
68367,6804,-1000.00,6000.00,7000.00,5262.59,1933.61,0.11,0
68368,6804,1000.00,7000.00,8000.00,0.00,7000.00,0.34,1
68369,6804,1000.00,8000.00,9000.00,3363.86,4636.14,0.27,1
68370,6804,1000.00,9000.00,10000.00,0.00,7682.38,0.08,1
68371,6804,-1000.00,8000.00,9000.00,7130.84,2869.16,0.05,0
68372,6804,1000.00,9000.00,10000.00,0.00,9000.00,0.44,1
68373,6804,1000.00,10000.00,11000.00,4347.33,5652.67,0.12,1
68374,6804,1000.00,11000.00,12000.00,1745.29,9254.71,0.19,1
68375,6804,1000.00,12000.00,13000.00,0.00,12000.00,0.02,1
68376,6804,1000.00,13000.00,14000.00,947.16,12052.84,0.32,1
68377,6804,1000.00,14000.00,15000.00,0.00,14000.00,0.34,1
68378,6804,-1000.00,13000.00,14000.00,11773.22,3226.78,0.04,0
68379,6804,1000.00,14000.00,15000.00,4567.94,9432.06,0.32,1
68380,6804,1000.00,15000.00,16000.00,4963.43,10036.57,0.31,1
68381,6804,-1000.00,14000.00,15000.00,16000.00,0.00,0.00,0
68382,6804,1000.00,15000.00,16000.00,0.00,9175.86,0.36,1
68383,6804,1000.00,16000.00,17000.00,1364.84,14635.16,0.21,1
68384,6804,-1000.00,15000.00,16000.00,10763.06,0.00,0.02,0
68385,6804,1000.00,16000.00,17000.00,3470.63,12529.37,0.19,1
68386,6804,1000.00,17000.00,18000.00,0.00,17000.00,0.34,1
68387,6804,1000.00,18000.00,19000.00,0.00,18000.00,0.18,1
68388,6804,1000.00,19000.00,20000.00,0.00,13646.26,0.31,1
68389,6804,1000.00,20000.00,21000.00,0.00,20000.00,0.14,1
68390,6804,1000.00,21000.00,22000.00,4908.56,16091.44,0.28,1
68391,6804,1000.00,22000.00,23000.00,0.00,18627.24,0.38,1
68392,6804,1000.00,23000.00,24000.00,0.00,23000.00,0.00,1
68393,6804,1000.00,24000.00,25000.00,4915.06,19084.94,0.36,1
68394,6804,1000.00,25000.00,26000.00,0.00,25000.00,0.44,1
68395,6804,1000.00,26000.00,27000.00,0.00,26000.00,0.14,1
68396,6804,1000.00,27000.00,28000.00,0.00,24298.89,0.40,1
68397,6805,-185.82,-185.82,814.18,0.00,185.82,0.15,0
68398,6805,-814.18,-1000.00,0.00,0.00,814.18,0.25,0
68399,6806,-1000.00,-1000.00,0.00,0.00,1000.00,0.43,0
68400,6807,-1000.00,-1000.00,0.00,560.22,439.78,0.15,0
68401,6808,-1000.00,-1000.00,0.00,0.00,1000.00,0.27,0
68402,6809,1000.00,1000.00,2000.00,860.71,139.29,0.05,1
68403,6809,-284.03,715.97,1715.97,0.00,284.03,0.39,0
68404,6809,-1000.00,-284.03,715.97,667.68,1048.29,0.29,0
68405,6809,-715.97,-1000.00,0.00,203.14,512.83,0.35,0
68406,6810,-1000.00,-1000.00,0.00,323.60,676.40,0.30,0
68407,6811,-1000.00,-1000.00,0.00,0.00,1000.00,0.03,0
68408,6812,-1000.00,-1000.00,0.00,0.00,1000.00,0.13,0
68409,6813,-1000.00,-1000.00,0.00,0.00,1000.00,0.16,0
68410,6814,1000.00,1000.00,2000.00,0.00,785.86,0.20,1
68411,6814,1000.00,2000.00,3000.00,0.00,220.46,0.13,1
68412,6814,1000.00,3000.00,4000.00,0.00,3000.00,0.06,1
68413,6814,1000.00,4000.00,5000.00,0.00,4000.00,0.44,1
68414,6814,1000.00,5000.00,6000.00,1690.07,3309.93,0.18,1
68415,6814,1000.00,6000.00,7000.00,2453.15,3546.85,0.27,1
68416,6814,1000.00,7000.00,8000.00,0.00,6928.06,0.10,1
68417,6814,1000.00,8000.00,9000.00,1257.13,6742.87,0.39,1
68418,6814,1000.00,9000.00,10000.00,0.00,5175.30,0.23,1
68419,6814,1000.00,10000.00,11000.00,0.00,10000.00,0.00,1
68420,6814,1000.00,11000.00,12000.00,5120.49,5879.51,0.14,1
68421,6814,1000.00,12000.00,13000.00,5671.65,6328.35,0.08,1
68422,6814,1000.00,13000.00,14000.00,0.00,13000.00,0.25,1
68423,6814,1000.00,14000.00,15000.00,0.00,10785.31,0.13,1
68424,6814,1000.00,15000.00,16000.00,3005.14,11994.86,0.23,1
68425,6814,1000.00,16000.00,17000.00,0.00,16000.00,0.35,1
68426,6814,1000.00,17000.00,18000.00,0.00,17000.00,0.38,1
68427,6814,1000.00,18000.00,19000.00,6602.52,11397.48,0.31,1
68428,6814,1000.00,19000.00,20000.00,1278.88,8484.33,0.29,1
68429,6814,1000.00,20000.00,21000.00,0.00,10588.13,0.29,1
68430,6814,1000.00,21000.00,22000.00,9320.63,11679.37,0.18,1
68431,6814,1000.00,22000.00,23000.00,0.00,22000.00,0.31,1
68432,6814,1000.00,23000.00,24000.00,0.00,12636.53,0.13,1
68433,6814,1000.00,24000.00,25000.00,0.00,24000.00,0.40,1
68434,6814,1000.00,25000.00,26000.00,3299.17,21700.83,0.30,1
68435,6814,1000.00,26000.00,27000.00,10432.19,15567.81,0.29,1
68436,6814,1000.00,27000.00,28000.00,0.00,27000.00,0.42,1
68437,6814,1000.00,28000.00,29000.00,0.00,28000.00,0.42,1
68438,6814,1000.00,29000.00,30000.00,0.00,27585.05,0.25,1
68439,6814,1000.00,30000.00,31000.00,1821.60,28178.40,0.44,1
68440,6814,1000.00,31000.00,32000.00,1882.40,29117.60,0.44,1
68441,6814,1000.00,32000.00,33000.00,6112.36,25887.64,0.41,1
68442,6814,1000.00,33000.00,34000.00,5870.01,27129.99,0.05,1
68443,6814,1000.00,34000.00,35000.00,11192.46,22807.54,0.12,1
68444,6814,1000.00,35000.00,36000.00,11112.31,23887.69,0.33,1
68445,6814,1000.00,36000.00,37000.00,5504.15,30495.85,0.38,1
68446,6814,1000.00,37000.00,38000.00,16840.73,20159.27,0.14,1
68447,6814,-1000.00,36000.00,37000.00,19510.25,16587.67,0.20,0
68448,6815,-836.32,-836.32,163.68,56.53,779.79,0.41,0
68449,6815,-163.68,-1000.00,0.00,0.00,163.68,0.06,0
68450,6816,-1000.00,-1000.00,0.00,202.96,797.04,0.39,0
68451,6817,-1000.00,-1000.00,0.00,499.53,500.47,0.14,0
68452,6818,-374.13,-374.13,625.87,0.00,374.13,0.23,0
68453,6818,-441.25,-815.39,184.61,113.05,328.20,0.31,0
68454,6818,-1000.00,-1815.39,-815.39,116.61,16.98,0.08,0
68455,6819,1000.00,1000.00,2000.00,0.00,702.57,0.14,1
68456,6819,1000.00,2000.00,3000.00,0.00,1877.34,0.40,1
68457,6819,1000.00,3000.00,4000.00,230.72,2769.28,0.16,1
68458,6819,1000.00,4000.00,5000.00,695.98,3243.15,0.40,1
68459,6819,1000.00,5000.00,6000.00,0.00,5000.00,0.39,1
68460,6819,1000.00,6000.00,7000.00,0.00,6000.00,0.13,1
68461,6819,1000.00,7000.00,8000.00,3500.00,3500.00,0.05,1
68462,6819,1000.00,8000.00,9000.00,2283.94,5716.06,0.35,1
68463,6819,1000.00,9000.00,10000.00,0.00,9000.00,0.30,1
68464,6819,1000.00,10000.00,11000.00,0.00,10000.00,0.36,1
68465,6819,1000.00,11000.00,12000.00,0.00,3316.56,0.19,1
68466,6819,-1000.00,10000.00,11000.00,7839.13,4160.87,0.09,0
68467,6819,1000.00,11000.00,12000.00,0.00,8140.61,0.36,1
68468,6819,1000.00,12000.00,13000.00,0.00,1882.45,0.16,1
68469,6819,1000.00,13000.00,14000.00,1125.38,11874.62,0.43,1
68470,6819,1000.00,14000.00,15000.00,0.00,14000.00,0.43,1
68471,6819,1000.00,15000.00,16000.00,453.43,13705.84,0.44,1
68472,6819,1000.00,16000.00,17000.00,1766.47,14233.53,0.43,1
68473,6819,1000.00,17000.00,18000.00,7947.00,9053.00,0.04,1
68474,6819,1000.00,18000.00,19000.00,1224.89,16775.11,0.38,1
68475,6819,-1000.00,17000.00,18000.00,15398.63,0.00,0.01,0
68476,6819,1000.00,18000.00,19000.00,0.00,18000.00,0.12,1
68477,6819,1000.00,19000.00,20000.00,2880.85,16119.15,0.06,1
68478,6819,1000.00,20000.00,21000.00,0.00,20000.00,0.18,1
68479,6819,-1000.00,19000.00,20000.00,0.00,21000.00,0.30,0
68480,6819,-1000.00,18000.00,19000.00,15737.49,4262.51,0.01,0
68481,6819,-1000.00,17000.00,18000.00,19000.00,0.00,0.01,0
68482,6819,-1000.00,16000.00,17000.00,6664.40,0.00,0.16,0
68483,6819,-1000.00,15000.00,16000.00,9545.35,6791.99,0.17,0
68484,6819,-1000.00,14000.00,15000.00,9129.72,1674.39,0.09,0
68485,6819,-1000.00,13000.00,14000.00,6871.41,8128.59,0.13,0
68486,6819,-1000.00,12000.00,13000.00,4035.94,9964.06,0.30,0
68487,6819,-1000.00,11000.00,12000.00,3825.54,9174.46,0.35,0
68488,6819,-1000.00,10000.00,11000.00,0.00,11829.88,0.44,0
68489,6820,-1000.00,-1000.00,0.00,0.00,1000.00,0.13,0
68490,6821,0.00,0.00,1000.00,0.00,0.00,0.23,0
68491,6821,1000.00,1000.00,2000.00,564.82,435.18,0.09,1
68492,6821,0.00,1000.00,2000.00,0.00,0.00,0.00,0
68493,6821,-1000.00,0.00,1000.00,0.00,2000.00,0.12,0
68494,6821,-1000.00,-1000.00,0.00,0.00,1000.00,0.33,0
68495,6822,0.00,0.00,1000.00,19.58,657.34,0.38,0
68496,6822,0.00,0.00,1000.00,0.00,1000.00,0.15,0
68497,6822,0.00,0.00,1000.00,0.00,707.59,0.37,0
68498,6822,0.00,0.00,1000.00,168.13,831.87,0.35,0
68499,6822,0.00,0.00,1000.00,0.00,601.01,0.35,0
68500,6822,0.00,0.00,1000.00,1.60,998.40,0.40,0
68501,6822,0.00,0.00,1000.00,170.32,829.68,0.10,0
68502,6822,0.00,0.00,1000.00,0.00,0.00,0.00,0
68503,6822,0.00,0.00,1000.00,0.00,716.65,0.27,0
68504,6822,0.00,0.00,1000.00,0.00,371.23,0.16,0
68505,6822,0.00,0.00,1000.00,426.73,573.27,0.20,0
68506,6822,0.00,0.00,1000.00,385.77,614.23,0.24,0
68507,6822,0.00,0.00,1000.00,91.78,236.22,0.19,0
68508,6822,0.00,0.00,1000.00,0.00,1000.00,0.43,0
68509,6822,0.00,0.00,1000.00,0.00,358.09,0.08,0
68510,6822,0.00,0.00,1000.00,0.00,1000.00,0.31,0
68511,6822,0.00,0.00,1000.00,320.51,679.49,0.31,0
68512,6822,0.00,0.00,1000.00,121.99,878.01,0.41,0
68513,6822,0.00,0.00,1000.00,12.54,651.52,0.37,0
68514,6822,0.00,0.00,1000.00,96.65,903.35,0.44,0
68515,6822,0.00,0.00,1000.00,259.86,740.14,0.37,0
68516,6822,0.00,0.00,1000.00,0.00,654.86,0.36,0
68517,6822,0.00,0.00,1000.00,0.00,1000.00,0.42,0
68518,6822,0.00,0.00,1000.00,0.00,1000.00,0.10,0
68519,6822,0.00,0.00,1000.00,0.00,1000.00,0.20,0
68520,6822,-841.28,-841.28,158.72,437.60,403.68,0.21,0
68521,6822,0.00,-841.28,158.72,76.09,82.63,0.06,0
68522,6822,0.00,-841.28,158.72,42.33,116.39,0.27,0
68523,6822,0.00,-841.28,158.72,0.00,158.72,0.43,0
68524,6822,-142.67,-983.95,16.05,89.78,52.89,0.15,0
68525,6822,0.00,-983.95,16.05,0.00,5.76,0.24,0
68526,6822,0.00,-983.95,16.05,0.00,8.74,0.09,0
68527,6822,0.00,-983.95,16.05,0.00,16.05,0.24,0
68528,6822,0.00,-983.95,16.05,0.00,16.05,0.09,0
68529,6822,0.00,-983.95,16.05,3.69,4.92,0.21,0
68530,6822,0.00,-983.95,16.05,0.00,16.05,0.21,0
68531,6822,-4.35,-988.30,11.70,4.30,0.05,0.10,0
68532,6822,0.00,-988.30,11.70,0.00,4.52,0.25,0
68533,6822,0.00,-988.30,11.70,0.00,4.30,0.25,0
68534,6822,0.00,-988.30,11.70,2.61,9.09,0.40,0
68535,6822,0.00,-988.30,11.70,0.00,11.70,0.27,0
68536,6822,0.00,-988.30,11.70,1.95,9.75,0.42,0
68537,6823,-1000.00,-1000.00,0.00,0.00,1000.00,0.25,0
68538,6824,-1000.00,-1000.00,0.00,0.00,1000.00,0.23,0
68539,6825,-1000.00,-1000.00,0.00,230.57,769.43,0.38,0
68540,6826,-757.97,-757.97,242.03,144.05,613.92,0.37,0
68541,6826,-242.03,-1000.00,0.00,50.83,191.20,0.40,0
68542,6826,-0.00,-1000.00,0.00,0.00,0.00,0.04,0
68543,6826,-0.00,-1000.00,-0.00,0.00,0.00,0.09,0
68544,6827,-1000.00,-1000.00,0.00,169.15,830.85,0.40,0
68545,6828,-1000.00,-1000.00,0.00,0.00,1000.00,0.33,0
68546,6829,-1000.00,-1000.00,0.00,626.06,373.94,0.14,0
68547,6830,-1000.00,-1000.00,0.00,0.00,1000.00,0.40,0
68548,6831,-1000.00,-1000.00,0.00,0.00,1000.00,0.44,0
68549,6832,-1000.00,-1000.00,0.00,500.00,500.00,0.04,0
68550,6833,-500.31,-500.31,499.69,0.00,500.31,0.20,0
68551,6833,-1000.00,-1500.31,-500.31,202.14,0.00,0.08,0
68552,6834,-1000.00,-1000.00,0.00,787.45,136.44,0.07,0
68553,6835,1000.00,1000.00,2000.00,498.80,501.20,0.11,1
68554,6835,0.00,1000.00,2000.00,0.00,0.00,0.00,0
68555,6835,-1000.00,0.00,1000.00,1101.99,776.14,0.17,0
68556,6835,1000.00,1000.00,2000.00,360.76,639.24,0.18,1
68557,6835,1000.00,2000.00,3000.00,0.00,2000.00,0.31,1
68558,6835,1000.00,3000.00,4000.00,0.00,3000.00,0.36,1
68559,6835,1000.00,4000.00,5000.00,0.00,2648.76,0.36,1
68560,6835,1000.00,5000.00,6000.00,0.00,63.73,0.06,1
68561,6835,1000.00,6000.00,7000.00,556.06,1686.05,0.21,1
68562,6835,1000.00,7000.00,8000.00,0.00,1531.14,0.07,1
68563,6835,1000.00,8000.00,9000.00,0.00,8000.00,0.14,1
68564,6835,1000.00,9000.00,10000.00,0.00,9000.00,0.06,1
68565,6835,1000.00,10000.00,11000.00,0.00,4937.88,0.26,1
68566,6835,1000.00,11000.00,12000.00,523.47,10476.53,0.44,1
68567,6835,1000.00,12000.00,13000.00,0.00,6957.26,0.24,1
68568,6835,1000.00,13000.00,14000.00,3623.30,9376.70,0.15,1
68569,6835,1000.00,14000.00,15000.00,0.00,14000.00,0.41,1
68570,6835,1000.00,15000.00,16000.00,3135.64,11864.36,0.01,1
68571,6835,1000.00,16000.00,17000.00,1902.18,14097.82,0.23,1
68572,6835,1000.00,17000.00,18000.00,0.00,17000.00,0.18,1
68573,6835,1000.00,18000.00,19000.00,5913.08,12086.92,0.13,1
68574,6835,-1000.00,17000.00,18000.00,7980.33,11019.67,0.25,0
68575,6835,-1000.00,16000.00,17000.00,5289.08,12710.92,0.35,0
68576,6835,-1000.00,15000.00,16000.00,0.00,11814.60,0.28,0
68577,6835,-1000.00,14000.00,15000.00,190.81,15353.80,0.44,0
68578,6835,-1000.00,13000.00,14000.00,3208.12,11791.88,0.14,0
68579,6835,-1000.00,12000.00,13000.00,0.00,13801.07,0.44,0
68580,6835,-1000.00,11000.00,12000.00,7038.52,0.00,0.05,0
68581,6835,-1000.00,10000.00,11000.00,0.00,11128.15,0.43,0
68582,6835,-1000.00,9000.00,10000.00,0.00,4560.38,0.20,0
68583,6835,-1000.00,8000.00,9000.00,3475.33,6236.38,0.31,0
68584,6835,-1000.00,7000.00,8000.00,2938.96,6061.04,0.31,0
68585,6835,0.00,7000.00,8000.00,0.00,0.00,0.02,0
68586,6835,-1000.00,6000.00,7000.00,0.00,6575.92,0.38,0
68587,6835,-1000.00,5000.00,6000.00,0.00,7000.00,0.26,0
68588,6835,-1000.00,4000.00,5000.00,0.00,6000.00,0.44,0
68589,6835,-1000.00,3000.00,4000.00,758.16,362.79,0.13,0
68590,6835,-1000.00,2000.00,3000.00,2750.72,1249.28,0.11,0
68591,6835,1000.00,3000.00,4000.00,0.00,3000.00,0.25,1
68592,6835,1000.00,4000.00,5000.00,0.00,4000.00,0.08,1
68593,6835,1000.00,5000.00,6000.00,1416.82,3583.18,0.30,1
68594,6835,1000.00,6000.00,7000.00,0.00,6000.00,0.39,1
68595,6835,1000.00,7000.00,8000.00,0.00,5294.44,0.12,1
68596,6835,1000.00,8000.00,9000.00,868.29,7131.71,0.30,1
68597,6835,1000.00,9000.00,10000.00,0.00,9000.00,0.29,1
68598,6835,1000.00,10000.00,11000.00,5000.00,5000.00,0.01,1
68599,6835,1000.00,11000.00,12000.00,5039.87,5960.13,0.09,1
68600,6835,-1000.00,10000.00,11000.00,7412.60,4587.40,0.06,0
68601,6835,1000.00,11000.00,12000.00,395.93,8248.64,0.40,1
68602,6835,1000.00,12000.00,13000.00,0.00,12000.00,0.20,1
68603,6835,1000.00,13000.00,14000.00,1903.49,11096.51,0.41,1
68604,6835,1000.00,14000.00,15000.00,6782.72,7217.28,0.10,1
68605,6835,1000.00,15000.00,16000.00,5314.74,9685.26,0.31,1
68606,6835,1000.00,16000.00,17000.00,0.00,9214.33,0.34,1
68607,6835,1000.00,17000.00,18000.00,0.00,17000.00,0.34,1
68608,6835,1000.00,18000.00,19000.00,0.00,18000.00,0.24,1
68609,6835,1000.00,19000.00,20000.00,7879.39,11120.61,0.22,1
68610,6835,1000.00,20000.00,21000.00,0.00,20000.00,0.15,1
68611,6835,1000.00,21000.00,22000.00,0.00,21000.00,0.06,1
68612,6836,-1000.00,-1000.00,0.00,391.93,608.07,0.27,0
68613,6837,-1000.00,-1000.00,0.00,498.32,501.68,0.04,0
68614,6838,-1000.00,-1000.00,0.00,144.29,855.71,0.34,0
68615,6839,0.00,0.00,1000.00,0.00,0.00,0.31,0
68616,6839,1000.00,1000.00,2000.00,735.16,0.00,0.12,1
68617,6839,-1000.00,0.00,1000.00,908.80,1091.20,0.25,0
68618,6839,0.00,0.00,1000.00,0.00,0.00,0.36,0
68619,6839,-599.36,-599.36,400.64,0.00,599.36,0.11,0
68620,6839,-400.64,-1000.00,0.00,0.00,400.64,0.23,0
68621,6840,-1000.00,-1000.00,0.00,0.00,1000.00,0.36,0
68622,6841,-771.28,-771.28,228.72,0.00,771.28,0.33,0
68623,6841,-185.01,-956.29,43.71,0.00,185.01,0.15,0
68624,6841,-1000.00,-1956.29,-956.29,31.57,12.14,0.02,0
68625,6842,-1000.00,-1000.00,0.00,0.00,1000.00,0.01,0
68626,6843,-1000.00,-1000.00,0.00,500.00,500.00,0.09,0
68627,6844,-1000.00,-1000.00,0.00,618.44,381.56,0.14,0
68628,6845,-350.33,-350.33,649.67,350.33,0.00,0.09,0
68629,6845,1000.00,649.67,1649.67,0.00,487.02,0.39,1
68630,6845,1000.00,1649.67,2649.67,210.34,1439.33,0.23,1
68631,6845,1000.00,2649.67,3649.67,725.88,1923.79,0.32,1
68632,6845,1000.00,3649.67,4649.67,0.00,1896.63,0.29,1
68633,6845,1000.00,4649.67,5649.67,796.04,3550.48,0.39,1
68634,6845,1000.00,5649.67,6649.67,0.00,5649.67,0.41,1
68635,6845,1000.00,6649.67,7649.67,135.15,2247.07,0.24,1
68636,6845,1000.00,7649.67,8649.67,0.00,7649.67,0.33,1
68637,6845,1000.00,8649.67,9649.67,0.00,8649.67,0.19,1
68638,6845,1000.00,9649.67,10649.67,3684.91,5964.76,0.30,1
68639,6845,1000.00,10649.67,11649.67,0.00,6564.79,0.36,1
68640,6845,0.00,10649.67,11649.67,0.00,0.00,0.09,0
68641,6845,1000.00,11649.67,12649.67,0.00,11649.67,0.36,1
68642,6845,1000.00,12649.67,13649.67,1236.19,11413.48,0.18,1
68643,6845,1000.00,13649.67,14649.67,3370.56,10279.11,0.39,1
68644,6845,1000.00,14649.67,15649.67,6706.78,7942.89,0.11,1
68645,6845,1000.00,15649.67,16649.67,6222.70,9426.97,0.25,1
68646,6845,1000.00,16649.67,17649.67,2154.31,13145.30,0.41,1
68647,6845,1000.00,17649.67,18649.67,0.00,17649.67,0.08,1
68648,6845,1000.00,18649.67,19649.67,6261.40,12388.27,0.19,1
68649,6845,1000.00,19649.67,20649.67,2665.06,16984.61,0.14,1
68650,6845,-1000.00,18649.67,19649.67,0.00,16826.76,0.33,0
68651,6845,-1000.00,17649.67,18649.67,5340.70,6872.21,0.22,0
68652,6845,-1000.00,16649.67,17649.67,9915.33,8734.34,0.19,0
68653,6845,-1000.00,15649.67,16649.67,0.00,12754.18,0.39,0
68654,6845,-1000.00,14649.67,15649.67,0.00,16649.67,0.24,0
68655,6845,-1000.00,13649.67,14649.67,10746.44,4903.22,0.05,0
68656,6845,-1000.00,12649.67,13649.67,1228.44,8185.21,0.33,0
68657,6845,-1000.00,11649.67,12649.67,608.99,9868.94,0.40,0
68658,6845,-1000.00,10649.67,11649.67,3203.33,9446.34,0.21,0
68659,6845,0.00,10649.67,11649.67,0.00,0.00,0.08,0
68660,6845,-1000.00,9649.67,10649.67,0.00,11649.67,0.32,0
68661,6845,-1000.00,8649.67,9649.67,1841.77,8807.90,0.17,0
68662,6845,-1000.00,7649.67,8649.67,1759.22,7890.45,0.09,0
68663,6845,-1000.00,6649.67,7649.67,0.00,8649.67,0.26,0
68664,6845,-1000.00,5649.67,6649.67,2780.20,4869.47,0.18,0
68665,6845,-1000.00,4649.67,5649.67,4717.89,1931.78,0.10,0
68666,6845,1000.00,5649.67,6649.67,1148.01,4501.66,0.06,1
68667,6845,1000.00,6649.67,7649.67,0.00,2925.76,0.27,1
68668,6845,-1000.00,5649.67,6649.67,4690.28,2959.39,0.01,0
68669,6845,-1000.00,4649.67,5649.67,4280.82,0.00,0.06,0
68670,6845,1000.00,5649.67,6649.67,0.00,5649.67,0.12,1
68671,6845,1000.00,6649.67,7649.67,406.92,4688.34,0.39,1
68672,6845,1000.00,7649.67,8649.67,0.00,7649.67,0.44,1
68673,6845,1000.00,8649.67,9649.67,0.00,3297.42,0.24,1
68674,6845,1000.00,9649.67,10649.67,2915.28,6734.39,0.24,1
68675,6845,1000.00,10649.67,11649.67,0.00,10649.67,0.09,1
68676,6845,1000.00,11649.67,12649.67,0.00,11649.67,0.11,1
68677,6845,1000.00,12649.67,13649.67,4534.10,8115.57,0.29,1
68678,6845,1000.00,13649.67,14649.67,0.00,8803.98,0.29,1
68679,6845,-1000.00,12649.67,13649.67,8492.29,6157.38,0.11,0
68680,6845,1000.00,13649.67,14649.67,0.00,13649.67,0.16,1
68681,6846,-1000.00,-1000.00,0.00,0.00,804.02,0.43,0
68682,6847,-1000.00,-1000.00,0.00,24.34,975.66,0.27,0
68683,6848,-1000.00,-1000.00,0.00,469.56,530.44,0.23,0
68684,6849,-944.09,-944.09,55.91,351.80,592.29,0.30,0
68685,6849,-1000.00,-1944.09,-944.09,36.62,19.29,0.10,0
68686,6850,-1000.00,-1000.00,0.00,0.00,436.02,0.08,0
68687,6851,1000.00,1000.00,2000.00,0.00,1000.00,0.34,1
68688,6851,1000.00,2000.00,3000.00,0.00,2000.00,0.30,1
68689,6851,1000.00,3000.00,4000.00,52.98,1254.20,0.28,1
68690,6851,1000.00,4000.00,5000.00,1640.43,2359.57,0.06,1
68691,6851,1000.00,5000.00,6000.00,0.00,5000.00,0.31,1
68692,6851,1000.00,6000.00,7000.00,1987.79,3837.16,0.32,1
68693,6851,1000.00,7000.00,8000.00,2113.87,4886.13,0.05,1
68694,6851,0.00,7000.00,8000.00,0.00,0.00,0.07,0
68695,6851,0.00,7000.00,8000.00,0.00,0.00,0.01,0
68696,6851,1000.00,8000.00,9000.00,0.00,8000.00,0.05,1
68697,6851,1000.00,9000.00,10000.00,2995.82,6004.18,0.15,1
68698,6851,-1000.00,8000.00,9000.00,7506.27,2493.73,0.01,0
68699,6851,1000.00,9000.00,10000.00,0.00,9000.00,0.36,1
68700,6851,1000.00,10000.00,11000.00,0.00,7514.33,0.39,1
68701,6851,1000.00,11000.00,12000.00,0.00,11000.00,0.33,1
68702,6851,1000.00,12000.00,13000.00,0.00,12000.00,0.29,1
68703,6851,1000.00,13000.00,14000.00,0.00,13000.00,0.18,1
68704,6851,1000.00,14000.00,15000.00,0.00,14000.00,0.38,1
68705,6851,1000.00,15000.00,16000.00,0.00,13814.77,0.30,1
68706,6851,-1000.00,14000.00,15000.00,12077.22,3922.78,0.03,0
68707,6851,-1000.00,13000.00,14000.00,12511.96,2488.04,0.03,0
68708,6851,1000.00,14000.00,15000.00,3512.09,10487.91,0.38,1
68709,6851,1000.00,15000.00,16000.00,0.00,15000.00,0.23,1
68710,6851,1000.00,16000.00,17000.00,0.00,16000.00,0.03,1
68711,6851,-1000.00,15000.00,16000.00,7525.20,9474.80,0.18,0
68712,6851,-1000.00,14000.00,15000.00,8000.00,8000.00,0.04,0
68713,6851,-1000.00,13000.00,14000.00,0.00,15000.00,0.05,0
68714,6851,-1000.00,12000.00,13000.00,0.00,14000.00,0.33,0
68715,6851,-1000.00,11000.00,12000.00,0.00,9029.75,0.05,0
68716,6851,-1000.00,10000.00,11000.00,289.43,11710.57,0.21,0
68717,6851,-1000.00,9000.00,10000.00,332.00,10668.00,0.42,0
68718,6851,-1000.00,8000.00,9000.00,0.00,8159.52,0.16,0
68719,6851,-1000.00,7000.00,8000.00,4500.00,4500.00,0.01,0
68720,6851,-1000.00,6000.00,7000.00,0.00,7327.19,0.36,0
68721,6851,-1000.00,5000.00,6000.00,1877.81,5122.19,0.33,0
68722,6851,-1000.00,4000.00,5000.00,1908.18,1317.04,0.16,0
68723,6851,-1000.00,3000.00,4000.00,1796.34,0.00,0.07,0
68724,6851,-1000.00,2000.00,3000.00,1876.70,1301.71,0.17,0
68725,6851,-1000.00,1000.00,2000.00,1366.36,1473.30,0.23,0
68726,6851,-1000.00,0.00,1000.00,1664.72,66.51,0.05,0
68727,6851,-1000.00,-1000.00,0.00,284.51,0.00,0.04,0
68728,6852,0.00,0.00,1000.00,0.00,0.00,0.03,0
68729,6852,-1000.00,-1000.00,0.00,546.69,453.31,0.01,0
68730,6853,-691.70,-691.70,308.30,0.00,691.70,0.35,0
68731,6853,-125.94,-817.64,182.36,0.00,125.94,0.27,0
68732,6853,-182.36,-1000.00,0.00,85.28,97.08,0.14,0
68733,6854,1000.00,1000.00,2000.00,12.05,987.95,0.26,1
68734,6854,1000.00,2000.00,3000.00,0.00,1439.14,0.37,1
68735,6854,1000.00,3000.00,4000.00,1086.73,1913.27,0.29,1
68736,6854,1000.00,4000.00,5000.00,0.00,3760.41,0.22,1
68737,6854,1000.00,5000.00,6000.00,0.00,5000.00,0.41,1
68738,6854,0.00,5000.00,6000.00,0.00,0.00,0.10,0
68739,6854,1000.00,6000.00,7000.00,968.14,5031.86,0.22,1
68740,6854,1000.00,7000.00,8000.00,2706.57,4293.43,0.12,1
68741,6854,1000.00,8000.00,9000.00,0.00,8000.00,0.39,1
68742,6854,1000.00,9000.00,10000.00,0.00,8329.18,0.36,1
68743,6854,1000.00,10000.00,11000.00,3361.54,6638.46,0.30,1
68744,6854,0.00,10000.00,11000.00,0.00,0.00,0.02,0
68745,6854,1000.00,11000.00,12000.00,0.00,11000.00,0.22,1
68746,6854,1000.00,12000.00,13000.00,5087.84,6912.16,0.27,1
68747,6854,1000.00,13000.00,14000.00,0.00,1064.21,0.09,1
68748,6854,1000.00,14000.00,15000.00,0.00,8220.15,0.30,1
68749,6854,1000.00,15000.00,16000.00,1084.63,7663.51,0.31,1
68750,6854,1000.00,16000.00,17000.00,0.00,9372.73,0.03,1
68751,6854,1000.00,17000.00,18000.00,0.00,14845.20,0.42,1
68752,6854,1000.00,18000.00,19000.00,3729.08,13516.20,0.38,1
68753,6854,1000.00,19000.00,20000.00,0.00,19000.00,0.11,1
68754,6854,1000.00,20000.00,21000.00,0.00,20000.00,0.09,1
68755,6854,-1000.00,19000.00,20000.00,5077.39,15922.61,0.38,0
68756,6854,-1000.00,18000.00,19000.00,0.00,20000.00,0.19,0
68757,6854,-1000.00,17000.00,18000.00,0.00,19000.00,0.40,0
68758,6854,-1000.00,16000.00,17000.00,2023.68,9145.05,0.31,0
68759,6854,-1000.00,15000.00,16000.00,461.91,16538.09,0.42,0
68760,6854,-663.05,14336.95,15336.95,0.00,663.05,0.11,0
68761,6854,-1000.00,13336.95,14336.95,8860.86,6476.10,0.15,0
68762,6854,-1000.00,12336.95,13336.95,0.00,14336.95,0.28,0
68763,6854,-1000.00,11336.95,12336.95,0.00,13336.95,0.33,0
68764,6854,-1000.00,10336.95,11336.95,3313.84,9023.11,0.32,0
68765,6854,-1000.00,9336.95,10336.95,1854.95,7552.76,0.36,0
68766,6854,-1000.00,8336.95,9336.95,852.81,1843.86,0.17,0
68767,6854,-1000.00,7336.95,8336.95,0.00,9336.95,0.21,0
68768,6854,-1000.00,6336.95,7336.95,3149.47,5187.49,0.01,0
68769,6854,-1000.00,5336.95,6336.95,294.18,6192.93,0.43,0
68770,6854,-1000.00,4336.95,5336.95,650.39,5686.57,0.39,0
68771,6854,-1000.00,3336.95,4336.95,2898.82,2438.13,0.18,0
68772,6854,-1000.00,2336.95,3336.95,0.00,3648.12,0.43,0
68773,6854,-1000.00,1336.95,2336.95,242.45,3094.50,0.43,0
68774,6854,-1000.00,336.95,1336.95,937.39,1399.57,0.06,0
68775,6854,-1000.00,-663.05,336.95,948.57,388.39,0.09,0
68776,6854,-336.95,-1000.00,0.00,0.00,336.95,0.01,0
68777,6855,-603.61,-603.61,396.39,0.00,603.61,0.15,0
68778,6855,-229.66,-833.27,166.73,88.36,141.29,0.35,0
68779,6855,-166.73,-1000.00,0.00,40.67,126.06,0.31,0
68780,6856,-1000.00,-1000.00,0.00,0.00,914.42,0.10,0
68781,6857,-1000.00,-1000.00,0.00,626.31,0.00,0.01,0
68782,6858,-1000.00,-1000.00,0.00,500.00,500.00,0.03,0
68783,6859,-1000.00,-1000.00,0.00,507.27,492.73,0.14,0
68784,6860,-1000.00,-1000.00,0.00,0.00,64.19,0.19,0
68785,6861,0.00,0.00,1000.00,0.00,0.00,0.06,0
68786,6861,1000.00,1000.00,2000.00,66.10,778.57,0.41,1
68787,6861,1000.00,2000.00,3000.00,0.00,2000.00,0.20,1
68788,6861,1000.00,3000.00,4000.00,0.00,3000.00,0.11,1
68789,6861,1000.00,4000.00,5000.00,0.00,3103.21,0.40,1
68790,6861,-1000.00,3000.00,4000.00,3360.14,0.00,0.03,0
68791,6861,-1000.00,2000.00,3000.00,0.00,3097.04,0.21,0
68792,6861,-1000.00,1000.00,2000.00,1503.44,1496.56,0.09,0
68793,6861,-763.76,236.24,1236.24,713.00,50.75,0.10,0
68794,6861,-910.86,-674.62,325.38,548.25,362.61,0.17,0
68795,6861,-325.38,-1000.00,0.00,184.15,141.23,0.16,0
68796,6862,-1000.00,-1000.00,0.00,500.00,500.00,0.05,0
68797,6863,-576.74,-576.74,423.26,0.00,576.74,0.33,0
68798,6863,-302.02,-878.75,121.25,61.57,240.45,0.33,0
68799,6863,-1000.00,-1878.75,-878.75,14.66,0.00,0.10,0
68800,6864,-1000.00,-1000.00,0.00,350.20,649.80,0.30,0
68801,6865,-1000.00,-1000.00,0.00,417.92,582.08,0.15,0
68802,6866,-1000.00,-1000.00,0.00,0.00,1000.00,0.43,0
68803,6867,-1000.00,-1000.00,0.00,239.91,760.09,0.19,0
68804,6868,1000.00,1000.00,2000.00,0.00,91.65,0.11,1
68805,6868,1000.00,2000.00,3000.00,0.00,1432.44,0.39,1
68806,6868,1000.00,3000.00,4000.00,683.90,2011.95,0.35,1
68807,6868,1000.00,4000.00,5000.00,0.00,3356.12,0.40,1
68808,6868,1000.00,5000.00,6000.00,0.00,2966.34,0.32,1
68809,6868,1000.00,6000.00,7000.00,2209.22,3790.78,0.30,1
68810,6868,-1000.00,5000.00,6000.00,5525.33,1474.67,0.01,0
68811,6868,1000.00,6000.00,7000.00,1295.98,4704.02,0.30,1
68812,6868,1000.00,7000.00,8000.00,3462.83,3537.17,0.03,1
68813,6868,1000.00,8000.00,9000.00,0.00,8000.00,0.29,1
68814,6868,1000.00,9000.00,10000.00,4152.97,4847.03,0.24,1
68815,6868,1000.00,10000.00,11000.00,855.91,9144.09,0.44,1
68816,6868,1000.00,11000.00,12000.00,0.00,9449.61,0.36,1
68817,6868,-1000.00,10000.00,11000.00,6135.06,5864.94,0.13,0
68818,6868,1000.00,11000.00,12000.00,0.00,11000.00,0.43,1
68819,6868,1000.00,12000.00,13000.00,0.00,12000.00,0.06,1
68820,6868,1000.00,13000.00,14000.00,0.00,5513.46,0.26,1
68821,6868,1000.00,14000.00,15000.00,0.00,5098.52,0.18,1
68822,6868,1000.00,15000.00,16000.00,0.00,15000.00,0.33,1
68823,6868,1000.00,16000.00,17000.00,0.00,16000.00,0.17,1
68824,6868,1000.00,17000.00,18000.00,5326.05,11673.95,0.33,1
68825,6868,1000.00,18000.00,19000.00,0.00,18000.00,0.11,1
68826,6868,1000.00,19000.00,20000.00,4575.19,14424.81,0.26,1
68827,6868,1000.00,20000.00,21000.00,0.00,20000.00,0.21,1
68828,6868,-1000.00,19000.00,20000.00,11054.33,9945.67,0.19,0
68829,6868,-1000.00,18000.00,19000.00,0.00,20000.00,0.17,0
68830,6868,-1000.00,17000.00,18000.00,5108.21,12350.86,0.34,0
68831,6868,-1000.00,16000.00,17000.00,0.00,10387.73,0.33,0
68832,6868,-1000.00,15000.00,16000.00,4168.16,12831.84,0.38,0
68833,6868,-1000.00,14000.00,15000.00,0.00,6034.75,0.20,0
68834,6868,-1000.00,13000.00,14000.00,3293.35,11706.65,0.18,0
68835,6868,-1000.00,12000.00,13000.00,3628.15,10371.85,0.36,0
68836,6868,-1000.00,11000.00,12000.00,0.00,8042.54,0.29,0
68837,6868,-1000.00,10000.00,11000.00,4003.51,7996.49,0.31,0
68838,6868,-1000.00,9000.00,10000.00,0.00,10356.93,0.44,0
68839,6868,-1000.00,8000.00,9000.00,2348.63,7651.37,0.36,0
68840,6868,-1000.00,7000.00,8000.00,0.00,4191.38,0.20,0
68841,6868,-1000.00,6000.00,7000.00,3605.22,4394.78,0.11,0
68842,6868,-1000.00,5000.00,6000.00,0.00,5721.43,0.42,0
68843,6868,-1000.00,4000.00,5000.00,4440.44,1559.56,0.06,0
68844,6868,-1000.00,3000.00,4000.00,0.00,5000.00,0.24,0
68845,6868,-1000.00,2000.00,3000.00,2530.15,1469.85,0.10,0
68846,6868,-1000.00,1000.00,2000.00,0.00,3000.00,0.29,0
68847,6868,-1000.00,0.00,1000.00,0.00,1189.76,0.24,0
68848,6868,-1000.00,-1000.00,0.00,61.25,938.75,0.18,0
68849,6869,-1000.00,-1000.00,0.00,0.00,1000.00,0.18,0
68850,6870,1000.00,1000.00,2000.00,0.00,1000.00,0.32,1
68851,6870,1000.00,2000.00,3000.00,0.00,1769.04,0.28,1
68852,6870,1000.00,3000.00,4000.00,0.00,2134.77,0.18,1
68853,6870,-1000.00,2000.00,3000.00,2492.47,1507.53,0.07,0
68854,6870,1000.00,3000.00,4000.00,0.00,2884.75,0.24,1
68855,6870,1000.00,4000.00,5000.00,0.00,434.33,0.14,1
68856,6870,1000.00,5000.00,6000.00,401.53,4598.47,0.38,1
68857,6870,1000.00,6000.00,7000.00,0.00,6000.00,0.06,1
68858,6870,1000.00,7000.00,8000.00,0.00,5482.83,0.41,1
68859,6870,1000.00,8000.00,9000.00,4000.00,4000.00,0.06,1
68860,6870,-1000.00,7000.00,8000.00,5105.97,2307.02,0.13,0
68861,6870,1000.00,8000.00,9000.00,0.00,4037.10,0.09,1
68862,6870,1000.00,9000.00,10000.00,0.00,9000.00,0.31,1
68863,6870,1000.00,10000.00,11000.00,3479.80,6520.20,0.30,1
68864,6870,1000.00,11000.00,12000.00,0.00,3980.78,0.18,1
68865,6870,-1000.00,10000.00,11000.00,0.00,9508.11,0.35,0
68866,6870,-1000.00,9000.00,10000.00,0.00,11000.00,0.28,0
68867,6870,-1000.00,8000.00,9000.00,0.00,7047.39,0.28,0
68868,6870,-1000.00,7000.00,8000.00,2448.76,6551.24,0.22,0
68869,6870,-1000.00,6000.00,7000.00,2647.01,5352.99,0.33,0
68870,6870,-1000.00,5000.00,6000.00,0.00,7000.00,0.44,0
68871,6870,-1000.00,4000.00,5000.00,50.87,5949.13,0.30,0
68872,6870,-1000.00,3000.00,4000.00,268.37,4731.63,0.44,0
68873,6870,-1000.00,2000.00,3000.00,1079.80,1781.02,0.26,0
68874,6870,-1000.00,1000.00,2000.00,1114.29,1885.71,0.27,0
68875,6870,-1000.00,0.00,1000.00,0.00,1831.92,0.06,0
68876,6870,-1000.00,-1000.00,0.00,280.93,719.07,0.37,0
68877,6871,-1000.00,-1000.00,0.00,500.00,500.00,0.04,0
68878,6872,-1000.00,-1000.00,0.00,0.00,568.38,0.25,0
68879,6873,-1000.00,-1000.00,0.00,178.02,821.98,0.41,0
68880,6874,1000.00,1000.00,2000.00,0.00,1000.00,0.09,1
68881,6874,1000.00,2000.00,3000.00,0.00,426.78,0.09,1
68882,6874,-891.42,1108.58,2108.58,891.42,0.00,0.06,0
68883,6874,1000.00,2108.58,3108.58,623.96,1484.62,0.36,1
68884,6874,1000.00,3108.58,4108.58,0.00,3108.03,0.32,1
68885,6874,1000.00,4108.58,5108.58,0.00,3062.01,0.30,1
68886,6874,1000.00,5108.58,6108.58,0.00,2941.67,0.18,1
68887,6874,1000.00,6108.58,7108.58,1267.81,4840.77,0.38,1
68888,6874,1000.00,7108.58,8108.58,0.00,3326.73,0.29,1
68889,6874,1000.00,8108.58,9108.58,0.00,8108.58,0.40,1
68890,6874,1000.00,9108.58,10108.58,4326.96,4781.62,0.24,1
68891,6874,1000.00,10108.58,11108.58,0.00,8902.67,0.41,1
68892,6874,1000.00,11108.58,12108.58,4921.77,6186.81,0.22,1
68893,6874,1000.00,12108.58,13108.58,1774.55,10334.03,0.41,1
68894,6874,1000.00,13108.58,14108.58,0.00,13108.58,0.06,1
68895,6874,1000.00,14108.58,15108.58,2222.97,11885.61,0.42,1
68896,6874,1000.00,15108.58,16108.58,0.00,11934.65,0.41,1
68897,6874,1000.00,16108.58,17108.58,4797.39,11311.19,0.34,1
68898,6874,1000.00,17108.58,18108.58,0.00,7553.65,0.08,1
68899,6874,-1000.00,16108.58,17108.58,9036.55,2096.28,0.11,0
68900,6874,1000.00,17108.58,18108.58,7382.17,9726.41,0.12,1
68901,6874,1000.00,18108.58,19108.58,0.00,18108.58,0.06,1
68902,6874,1000.00,19108.58,20108.58,8769.97,10338.61,0.25,1
68903,6874,1000.00,20108.58,21108.58,0.00,20108.58,0.41,1
68904,6874,-1000.00,19108.58,20108.58,0.00,12987.29,0.35,0
68905,6874,-1000.00,18108.58,19108.58,5383.09,14725.49,0.33,0
68906,6874,-1000.00,17108.58,18108.58,0.00,19108.58,0.26,0
68907,6874,-1000.00,16108.58,17108.58,0.00,12543.62,0.17,0
68908,6874,-1000.00,15108.58,16108.58,0.00,17108.58,0.02,0
68909,6874,-1000.00,14108.58,15108.58,0.00,15121.38,0.43,0
68910,6874,-1000.00,13108.58,14108.58,6237.40,8871.18,0.03,0
68911,6874,-1000.00,12108.58,13108.58,9233.92,4874.66,0.06,0
68912,6874,-1000.00,11108.58,12108.58,0.00,13108.58,0.14,0
68913,6874,-1000.00,10108.58,11108.58,0.00,12108.58,0.02,0
68914,6874,-1000.00,9108.58,10108.58,0.00,6016.06,0.29,0
68915,6874,-1000.00,8108.58,9108.58,2622.84,5958.51,0.32,0
68916,6874,-1000.00,7108.58,8108.58,1450.25,7658.33,0.40,0
68917,6874,-1000.00,6108.58,7108.58,0.00,4000.09,0.29,0
68918,6874,-1000.00,5108.58,6108.58,0.00,1805.23,0.20,0
68919,6874,-1000.00,4108.58,5108.58,1093.53,5015.05,0.38,0
68920,6874,-1000.00,3108.58,4108.58,0.00,2345.18,0.06,0
68921,6874,1000.00,4108.58,5108.58,2274.58,0.00,0.25,1
68922,6874,-1000.00,3108.58,4108.58,0.00,5108.58,0.34,0
68923,6875,0.00,0.00,1000.00,0.00,0.00,0.30,0
68924,6875,-569.71,-569.71,430.29,385.93,183.79,0.33,0
68925,6875,-430.29,-1000.00,0.00,267.27,163.02,0.08,0
68926,6876,1000.00,1000.00,2000.00,329.79,670.21,0.29,1
68927,6876,1000.00,2000.00,3000.00,672.35,1327.65,0.08,1
68928,6876,1000.00,3000.00,4000.00,721.23,1631.38,0.31,1
68929,6876,1000.00,4000.00,5000.00,0.00,2608.03,0.34,1
68930,6876,1000.00,5000.00,6000.00,355.40,4644.60,0.14,1
68931,6876,1000.00,6000.00,7000.00,122.40,5877.60,0.30,1
68932,6876,1000.00,7000.00,8000.00,1205.66,5794.34,0.38,1
68933,6876,1000.00,8000.00,9000.00,0.00,8000.00,0.28,1
68934,6876,1000.00,9000.00,10000.00,4342.09,4657.91,0.15,1
68935,6876,1000.00,10000.00,11000.00,2097.04,7902.96,0.40,1
68936,6876,-1000.00,9000.00,10000.00,2865.20,2143.22,0.16,0
68937,6876,1000.00,10000.00,11000.00,0.00,3488.54,0.18,1
68938,6876,1000.00,11000.00,12000.00,0.00,11000.00,0.05,1
68939,6876,1000.00,12000.00,13000.00,0.00,12000.00,0.41,1
68940,6876,1000.00,13000.00,14000.00,2872.99,10127.01,0.22,1
68941,6876,-1000.00,12000.00,13000.00,7591.10,6408.90,0.10,0
68942,6876,1000.00,13000.00,14000.00,733.27,12266.73,0.33,1
68943,6876,1000.00,14000.00,15000.00,0.00,12820.45,0.43,1
68944,6876,1000.00,15000.00,16000.00,3017.65,11982.35,0.41,1
68945,6876,1000.00,16000.00,17000.00,0.00,249.15,0.11,1
68946,6876,1000.00,17000.00,18000.00,0.00,17000.00,0.38,1
68947,6876,1000.00,18000.00,19000.00,0.00,18000.00,0.11,1
68948,6876,1000.00,19000.00,20000.00,0.00,19000.00,0.41,1
68949,6876,1000.00,20000.00,21000.00,6835.53,13164.47,0.33,1
68950,6876,0.00,20000.00,21000.00,0.00,0.00,0.03,0
68951,6876,1000.00,21000.00,22000.00,0.00,21000.00,0.01,1
68952,6876,1000.00,22000.00,23000.00,0.00,8348.82,0.24,1
68953,6876,1000.00,23000.00,24000.00,0.00,23000.00,0.19,1
68954,6876,1000.00,24000.00,25000.00,0.00,19889.94,0.34,1
68955,6876,1000.00,25000.00,26000.00,0.00,23814.17,0.36,1
68956,6876,1000.00,26000.00,27000.00,0.00,18103.07,0.38,1
68957,6876,0.00,26000.00,27000.00,0.00,0.00,0.02,0
68958,6876,1000.00,27000.00,28000.00,0.00,27000.00,0.31,1
68959,6876,-1000.00,26000.00,27000.00,17502.16,0.00,0.04,0
68960,6876,1000.00,27000.00,28000.00,0.00,27000.00,0.17,1
68961,6876,1000.00,28000.00,29000.00,0.00,15403.09,0.23,1
68962,6877,1000.00,1000.00,2000.00,0.00,613.54,0.40,1
68963,6877,-977.67,22.33,1022.33,744.35,233.33,0.16,0
68964,6877,1000.00,1022.33,2022.33,0.00,755.18,0.22,1
68965,6877,1000.00,2022.33,3022.33,419.09,1603.23,0.33,1
68966,6877,1000.00,3022.33,4022.33,974.46,2047.87,0.10,1
68967,6877,1000.00,4022.33,5022.33,0.00,4022.33,0.12,1
68968,6877,1000.00,5022.33,6022.33,449.91,3210.74,0.36,1
68969,6877,0.00,5022.33,6022.33,0.00,0.00,0.06,0
68970,6877,1000.00,6022.33,7022.33,0.00,2107.18,0.09,1
68971,6877,-1000.00,5022.33,6022.33,5266.92,0.00,0.04,0
68972,6877,1000.00,6022.33,7022.33,2685.18,3337.14,0.24,1
68973,6877,1000.00,7022.33,8022.33,1665.52,5356.80,0.26,1
68974,6877,1000.00,8022.33,9022.33,0.00,8022.33,0.22,1
68975,6877,1000.00,9022.33,10022.33,0.00,1953.19,0.18,1
68976,6877,-1000.00,8022.33,9022.33,5506.00,4516.33,0.12,0
68977,6877,1000.00,9022.33,10022.33,4455.33,4566.99,0.13,1
68978,6877,1000.00,10022.33,11022.33,460.07,9562.26,0.39,1
68979,6877,-1000.00,9022.33,10022.33,6044.42,4977.90,0.12,0
68980,6877,1000.00,10022.33,11022.33,4379.63,5642.69,0.01,1
68981,6877,1000.00,11022.33,12022.33,4029.26,6993.07,0.28,1
68982,6877,1000.00,12022.33,13022.33,5140.66,6881.66,0.27,1
68983,6877,-1000.00,11022.33,12022.33,235.66,12786.66,0.29,0
68984,6877,-1000.00,10022.33,11022.33,2528.70,9493.63,0.35,0
68985,6877,-1000.00,9022.33,10022.33,2569.58,8452.75,0.39,0
68986,6877,-1000.00,8022.33,9022.33,5011.16,5011.16,0.02,0
68987,6877,-1000.00,7022.33,8022.33,0.00,9022.33,0.06,0
68988,6877,-1000.00,6022.33,7022.33,2588.37,5433.96,0.34,0
68989,6877,-1000.00,5022.33,6022.33,0.00,7022.33,0.33,0
68990,6877,-1000.00,4022.33,5022.33,1507.54,4514.79,0.37,0
68991,6877,-1000.00,3022.33,4022.33,0.00,4402.88,0.42,0
68992,6877,-1000.00,2022.33,3022.33,1549.05,2473.28,0.15,0
68993,6877,-1000.00,1022.33,2022.33,0.00,2472.90,0.39,0
68994,6877,-421.01,601.31,1601.31,0.00,421.01,0.14,0
68995,6877,-989.22,-387.91,612.09,0.00,989.22,0.34,0
68996,6877,-612.09,-1000.00,0.00,255.19,356.90,0.14,0
68997,6878,-1000.00,-1000.00,0.00,0.00,1000.00,0.00,0
68998,6879,-933.74,-933.74,66.26,0.00,933.74,0.33,0
68999,6879,-66.26,-1000.00,0.00,0.00,66.26,0.17,0
69000,6880,-1000.00,-1000.00,0.00,607.82,0.00,0.19,0
69001,6881,-1000.00,-1000.00,0.00,190.84,809.16,0.24,0
69002,6882,-1000.00,-1000.00,0.00,0.00,1000.00,0.04,0
69003,6883,-1000.00,-1000.00,0.00,0.00,1000.00,0.18,0
69004,6884,-1000.00,-1000.00,0.00,0.00,1000.00,0.09,0
69005,6885,-1000.00,-1000.00,0.00,380.84,619.16,0.26,0
69006,6886,-1000.00,-1000.00,0.00,0.00,1000.00,0.11,0
69007,6887,-1000.00,-1000.00,0.00,0.00,1000.00,0.26,0
69008,6888,1000.00,1000.00,2000.00,0.00,1000.00,0.37,1
69009,6888,1000.00,2000.00,3000.00,356.51,1643.49,0.41,1
69010,6888,1000.00,3000.00,4000.00,1004.90,1995.10,0.11,1
69011,6888,0.00,3000.00,4000.00,0.00,0.00,0.06,0
69012,6888,1000.00,4000.00,5000.00,0.00,4000.00,0.02,1
69013,6888,1000.00,5000.00,6000.00,1252.18,2143.39,0.26,1
69014,6888,1000.00,6000.00,7000.00,1776.67,4223.33,0.36,1
69015,6888,1000.00,7000.00,8000.00,0.00,5073.35,0.40,1
69016,6888,0.00,7000.00,8000.00,0.00,0.00,0.03,0
69017,6888,1000.00,8000.00,9000.00,3155.24,4844.76,0.11,1
69018,6888,1000.00,9000.00,10000.00,660.94,4921.80,0.33,1
69019,6888,1000.00,10000.00,11000.00,557.16,8247.80,0.42,1
69020,6888,-1000.00,9000.00,10000.00,6645.56,3109.21,0.13,0
69021,6888,1000.00,10000.00,11000.00,0.00,6994.19,0.36,1
69022,6888,1000.00,11000.00,12000.00,5036.39,5086.60,0.22,1
69023,6888,1000.00,12000.00,13000.00,3600.57,8399.43,0.18,1
69024,6888,-1000.00,11000.00,12000.00,0.00,13000.00,0.34,0
69025,6888,-1000.00,10000.00,11000.00,0.00,6156.26,0.18,0
69026,6888,-1000.00,9000.00,10000.00,1088.67,9911.33,0.34,0
69027,6888,-1000.00,8000.00,9000.00,0.00,10000.00,0.11,0
69028,6888,-1000.00,7000.00,8000.00,0.00,9000.00,0.03,0
69029,6888,-1000.00,6000.00,7000.00,0.00,8000.00,0.09,0
69030,6888,-1000.00,5000.00,6000.00,0.00,5691.97,0.05,0
69031,6888,-1000.00,4000.00,5000.00,0.00,6000.00,0.24,0
69032,6888,-1000.00,3000.00,4000.00,0.00,1049.15,0.17,0
69033,6888,-1000.00,2000.00,3000.00,0.00,4000.00,0.01,0
69034,6888,-1000.00,1000.00,2000.00,678.39,2321.61,0.37,0
69035,6888,-1000.00,0.00,1000.00,993.58,279.59,0.11,0
69036,6888,-1000.00,-1000.00,0.00,435.97,564.03,0.19,0
69037,6889,1000.00,1000.00,2000.00,0.00,1000.00,0.17,1
69038,6889,1000.00,2000.00,3000.00,0.00,2000.00,0.03,1
69039,6889,1000.00,3000.00,4000.00,0.00,3000.00,0.43,1
69040,6889,-1000.00,2000.00,3000.00,2580.46,1419.54,0.01,0
69041,6889,1000.00,3000.00,4000.00,340.87,2659.13,0.41,1
69042,6889,1000.00,4000.00,5000.00,1102.81,2897.19,0.20,1
69043,6889,1000.00,5000.00,6000.00,1113.56,3886.44,0.40,1
69044,6889,-1000.00,4000.00,5000.00,1290.30,967.75,0.16,0
69045,6889,1000.00,5000.00,6000.00,0.00,5000.00,0.27,1
69046,6889,1000.00,6000.00,7000.00,3000.00,3000.00,0.09,1
69047,6889,0.00,6000.00,7000.00,0.00,0.00,0.02,0
69048,6889,1000.00,7000.00,8000.00,0.00,7000.00,0.00,1
69049,6889,1000.00,8000.00,9000.00,849.64,7150.36,0.37,1
69050,6889,-1000.00,7000.00,8000.00,4862.89,4137.11,0.18,0
69051,6889,1000.00,8000.00,9000.00,0.00,5326.96,0.38,1
69052,6889,1000.00,9000.00,10000.00,0.00,9000.00,0.35,1
69053,6889,1000.00,10000.00,11000.00,0.00,10000.00,0.00,1
69054,6889,-1000.00,9000.00,10000.00,6258.23,0.00,0.05,0
69055,6889,1000.00,10000.00,11000.00,0.00,2481.00,0.16,1
69056,6889,1000.00,11000.00,12000.00,0.00,7961.75,0.15,1
69057,6889,-1000.00,10000.00,11000.00,8782.40,3217.60,0.09,0
69058,6889,1000.00,11000.00,12000.00,0.00,5742.47,0.31,1
69059,6889,-1000.00,10000.00,11000.00,5071.48,4023.78,0.19,0
69060,6889,1000.00,11000.00,12000.00,0.00,11000.00,0.17,1
69061,6889,1000.00,12000.00,13000.00,4492.85,7507.15,0.26,1
69062,6889,1000.00,13000.00,14000.00,2233.88,5455.40,0.27,1
69063,6889,1000.00,14000.00,15000.00,0.00,14000.00,0.30,1
69064,6889,1000.00,15000.00,16000.00,7162.98,7837.02,0.10,1
69065,6889,1000.00,16000.00,17000.00,2230.27,13769.73,0.42,1
69066,6889,1000.00,17000.00,18000.00,0.00,17000.00,0.12,1
69067,6889,1000.00,18000.00,19000.00,2935.04,6694.94,0.25,1
69068,6889,1000.00,19000.00,20000.00,6515.00,12485.00,0.32,1
69069,6889,1000.00,20000.00,21000.00,5.87,19994.13,0.22,1
69070,6889,-1000.00,19000.00,20000.00,3795.20,0.00,0.09,0
69071,6889,1000.00,20000.00,21000.00,7097.83,12902.17,0.30,1
69072,6889,0.00,20000.00,21000.00,0.00,0.00,0.09,0
69073,6889,1000.00,21000.00,22000.00,0.00,21000.00,0.12,1
69074,6889,-1000.00,20000.00,21000.00,13256.36,2888.02,0.09,0
69075,6889,1000.00,21000.00,22000.00,6894.17,14105.83,0.32,1
69076,6889,1000.00,22000.00,23000.00,0.00,16393.14,0.33,1
69077,6889,1000.00,23000.00,24000.00,0.00,20416.65,0.43,1
69078,6889,1000.00,24000.00,25000.00,0.00,24000.00,0.03,1
69079,6889,1000.00,25000.00,26000.00,0.00,94.04,0.06,1
69080,6890,-1000.00,-1000.00,0.00,0.00,1000.00,0.42,0
69081,6891,1000.00,1000.00,2000.00,492.17,507.83,0.07,1
69082,6891,-1000.00,0.00,1000.00,988.13,902.49,0.21,0
69083,6891,1000.00,1000.00,2000.00,462.05,537.95,0.10,1
69084,6891,1000.00,2000.00,3000.00,0.00,1179.49,0.09,1
69085,6891,1000.00,3000.00,4000.00,0.00,3000.00,0.43,1
69086,6891,1000.00,4000.00,5000.00,0.00,4000.00,0.26,1
69087,6891,1000.00,5000.00,6000.00,1048.83,3951.17,0.39,1
69088,6891,-1000.00,4000.00,5000.00,3191.85,2808.15,0.13,0
69089,6891,1000.00,5000.00,6000.00,0.00,5000.00,0.13,1
69090,6891,1000.00,6000.00,7000.00,1054.57,4945.43,0.34,1
69091,6891,1000.00,7000.00,8000.00,1131.13,5868.87,0.37,1
69092,6891,1000.00,8000.00,9000.00,0.00,3301.24,0.01,1
69093,6891,-1000.00,7000.00,8000.00,6752.37,1002.56,0.07,0
69094,6891,1000.00,8000.00,9000.00,0.00,6739.79,0.40,1
69095,6891,1000.00,9000.00,10000.00,0.00,9000.00,0.12,1
69096,6891,1000.00,10000.00,11000.00,1917.96,7918.22,0.40,1
69097,6891,1000.00,11000.00,12000.00,1412.44,9587.56,0.43,1
69098,6891,1000.00,12000.00,13000.00,0.00,12000.00,0.20,1
69099,6891,1000.00,13000.00,14000.00,3454.94,9545.06,0.18,1
69100,6891,1000.00,14000.00,15000.00,3372.82,10627.18,0.39,1
69101,6891,1000.00,15000.00,16000.00,0.00,12420.68,0.42,1
69102,6891,-1000.00,14000.00,15000.00,8288.85,7711.15,0.03,0
69103,6891,1000.00,15000.00,16000.00,5800.21,9199.79,0.25,1
69104,6891,1000.00,16000.00,17000.00,0.00,4097.26,0.10,1
69105,6891,-1000.00,15000.00,16000.00,0.00,4714.75,0.15,0
69106,6891,-1000.00,14000.00,15000.00,0.00,4867.00,0.21,0
69107,6891,-1000.00,13000.00,14000.00,0.00,7397.85,0.20,0
69108,6891,-1000.00,12000.00,13000.00,0.00,10234.04,0.39,0
69109,6891,-1000.00,11000.00,12000.00,3186.78,2672.37,0.17,0
69110,6891,-1000.00,10000.00,11000.00,0.00,12000.00,0.41,0
69111,6891,-1000.00,9000.00,10000.00,1457.53,9542.47,0.39,0
69112,6891,-1000.00,8000.00,9000.00,0.00,6502.66,0.28,0
69113,6891,-1000.00,7000.00,8000.00,0.00,8199.28,0.39,0
69114,6891,-1000.00,6000.00,7000.00,3430.10,4569.90,0.27,0
69115,6891,-1000.00,5000.00,6000.00,0.00,4145.84,0.33,0
69116,6891,-1000.00,4000.00,5000.00,1196.07,4803.93,0.41,0
69117,6891,-1000.00,3000.00,4000.00,0.00,5000.00,0.12,0
69118,6891,-1000.00,2000.00,3000.00,0.00,4000.00,0.24,0
69119,6891,-1000.00,1000.00,2000.00,9.13,2168.15,0.40,0
69120,6891,-1000.00,0.00,1000.00,0.00,2000.00,0.10,0
69121,6891,-1000.00,-1000.00,0.00,0.00,1000.00,0.44,0
69122,6892,-1000.00,-1000.00,0.00,246.29,753.71,0.16,0
69123,6893,-1000.00,-1000.00,0.00,0.00,1000.00,0.14,0
69124,6894,1000.00,1000.00,2000.00,123.78,876.22,0.09,1
69125,6894,1000.00,2000.00,3000.00,0.00,2000.00,0.04,1
69126,6894,1000.00,3000.00,4000.00,0.00,1606.30,0.28,1
69127,6894,1000.00,4000.00,5000.00,691.23,3308.77,0.31,1
69128,6894,1000.00,5000.00,6000.00,1027.09,3972.91,0.40,1
69129,6894,1000.00,6000.00,7000.00,0.00,4145.68,0.12,1
69130,6894,1000.00,7000.00,8000.00,3186.06,3813.94,0.19,1
69131,6894,1000.00,8000.00,9000.00,964.47,7035.53,0.43,1
69132,6894,1000.00,9000.00,10000.00,2761.02,6238.98,0.24,1
69133,6894,1000.00,10000.00,11000.00,1071.72,8928.28,0.10,1
69134,6894,1000.00,11000.00,12000.00,3552.79,7447.21,0.08,1
69135,6894,1000.00,12000.00,13000.00,0.00,12000.00,0.34,1
69136,6894,1000.00,13000.00,14000.00,6500.00,6500.00,0.03,1
69137,6894,1000.00,14000.00,15000.00,0.00,13394.39,0.37,1
69138,6894,1000.00,15000.00,16000.00,0.00,15000.00,0.25,1
69139,6894,1000.00,16000.00,17000.00,4842.94,11157.06,0.34,1
69140,6894,1000.00,17000.00,18000.00,0.00,17000.00,0.37,1
69141,6894,-1000.00,16000.00,17000.00,11735.86,6264.14,0.07,0
69142,6894,1000.00,17000.00,18000.00,920.49,6454.27,0.26,1
69143,6894,1000.00,18000.00,19000.00,6118.33,11881.67,0.30,1
69144,6894,1000.00,19000.00,20000.00,3316.38,9898.49,0.31,1
69145,6894,1000.00,20000.00,21000.00,0.00,20000.00,0.33,1
69146,6894,1000.00,21000.00,22000.00,0.00,9804.26,0.11,1
69147,6894,1000.00,22000.00,23000.00,0.00,22000.00,0.27,1
69148,6894,1000.00,23000.00,24000.00,0.00,23000.00,0.43,1
69149,6894,1000.00,24000.00,25000.00,6316.94,17683.06,0.20,1
69150,6894,1000.00,25000.00,26000.00,0.00,25000.00,0.40,1
69151,6894,0.00,25000.00,26000.00,0.00,0.00,0.02,0
69152,6894,1000.00,26000.00,27000.00,2980.79,21186.70,0.41,1
69153,6894,1000.00,27000.00,28000.00,3490.59,23509.41,0.37,1
69154,6894,1000.00,28000.00,29000.00,0.00,26121.43,0.38,1
69155,6894,1000.00,29000.00,30000.00,0.00,15462.26,0.20,1
69156,6894,1000.00,30000.00,31000.00,9220.22,20779.78,0.26,1
69157,6894,1000.00,31000.00,32000.00,13714.07,17285.93,0.05,1
69158,6894,1000.00,32000.00,33000.00,0.00,32000.00,0.03,1
69159,6894,1000.00,33000.00,34000.00,0.00,33000.00,0.09,1
69160,6894,1000.00,34000.00,35000.00,0.00,19048.68,0.12,1
69161,6894,1000.00,35000.00,36000.00,0.00,22525.78,0.37,1
69162,6894,1000.00,36000.00,37000.00,0.00,36000.00,0.05,1
69163,6894,-1000.00,35000.00,36000.00,37000.00,0.00,0.00,0
69164,6894,1000.00,36000.00,37000.00,0.00,6713.20,0.15,1
69165,6894,1000.00,37000.00,38000.00,0.00,33409.93,0.06,1
69166,6894,1000.00,38000.00,39000.00,10853.29,27146.71,0.29,1
69167,6894,1000.00,39000.00,40000.00,12912.45,26087.55,0.05,1
69168,6894,-1000.00,38000.00,39000.00,17214.95,12771.57,0.18,0
69169,6895,1000.00,1000.00,2000.00,476.13,0.00,0.16,1
69170,6895,0.00,1000.00,2000.00,0.00,0.00,0.03,0
69171,6895,1000.00,2000.00,3000.00,1381.54,618.46,0.17,1
69172,6895,1000.00,3000.00,4000.00,1880.67,1119.33,0.12,1
69173,6895,1000.00,4000.00,5000.00,985.54,0.00,0.26,1
69174,6895,-1000.00,3000.00,4000.00,840.44,3804.90,0.19,0
69175,6895,-1000.00,2000.00,3000.00,0.00,3139.42,0.15,0
69176,6895,1000.00,3000.00,4000.00,2008.88,0.00,0.09,1
69177,6895,0.00,3000.00,4000.00,0.00,0.00,0.14,0
69178,6895,-1000.00,2000.00,3000.00,1495.21,2504.79,0.22,0
69179,6895,1000.00,3000.00,4000.00,1107.03,716.22,0.16,1
69180,6895,0.00,3000.00,4000.00,0.00,0.00,0.05,0
69181,6895,-1000.00,2000.00,3000.00,146.35,3853.65,0.07,0
69182,6895,-311.59,1688.41,2688.41,0.00,311.59,0.40,0
69183,6895,-459.65,1228.76,2228.76,0.00,459.65,0.15,0
69184,6895,1000.00,2228.76,3228.76,1273.01,920.34,0.22,1
69185,6895,-1000.00,1228.76,2228.76,1265.25,1963.50,0.12,0
69186,6895,-680.18,548.57,1548.57,0.00,680.18,0.35,0
69187,6895,-1000.00,-451.43,548.57,605.47,943.11,0.22,0
69188,6895,-548.57,-1000.00,0.00,101.74,446.83,0.31,0
69189,6896,-1000.00,-1000.00,0.00,374.59,363.01,0.21,0
69190,6897,-1000.00,-1000.00,0.00,214.35,785.65,0.22,0
69191,6898,1000.00,1000.00,2000.00,0.00,1000.00,0.14,1
69192,6898,1000.00,2000.00,3000.00,326.36,1673.64,0.35,1
69193,6898,1000.00,3000.00,4000.00,1245.03,1754.97,0.20,1
69194,6898,1000.00,4000.00,5000.00,318.74,3681.26,0.44,1
69195,6898,1000.00,5000.00,6000.00,1014.97,2734.02,0.31,1
69196,6898,-1000.00,4000.00,5000.00,4083.10,1916.90,0.02,0
69197,6898,1000.00,5000.00,6000.00,0.00,2528.69,0.31,1
69198,6898,1000.00,6000.00,7000.00,0.00,6000.00,0.23,1
69199,6898,0.00,6000.00,7000.00,0.00,0.00,0.02,0
69200,6898,1000.00,7000.00,8000.00,970.06,6029.94,0.43,1
69201,6898,1000.00,8000.00,9000.00,0.00,4769.54,0.27,1
69202,6898,1000.00,9000.00,10000.00,0.00,1348.01,0.13,1
69203,6898,-1000.00,8000.00,9000.00,3658.28,759.82,0.11,0
69204,6898,1000.00,9000.00,10000.00,0.00,4114.97,0.26,1
69205,6898,1000.00,10000.00,11000.00,2616.15,7383.85,0.35,1
69206,6898,1000.00,11000.00,12000.00,0.00,11000.00,0.06,1
69207,6898,1000.00,12000.00,13000.00,0.00,11398.20,0.43,1
69208,6898,1000.00,13000.00,14000.00,3204.94,9795.06,0.39,1
69209,6898,-1000.00,12000.00,13000.00,7254.84,6745.16,0.18,0
69210,6898,1000.00,13000.00,14000.00,0.00,8817.84,0.32,1
69211,6898,-1000.00,12000.00,13000.00,0.00,14000.00,0.32,0
69212,6898,-1000.00,11000.00,12000.00,5862.30,7137.70,0.25,0
69213,6898,-1000.00,10000.00,11000.00,3249.16,8750.84,0.27,0
69214,6898,-1000.00,9000.00,10000.00,4772.18,6227.82,0.03,0
69215,6898,-1000.00,8000.00,9000.00,1729.75,8270.25,0.41,0
69216,6898,-1000.00,7000.00,8000.00,0.00,9000.00,0.37,0
69217,6898,-1000.00,6000.00,7000.00,0.00,2835.43,0.22,0
69218,6898,-1000.00,5000.00,6000.00,0.00,7000.00,0.00,0
69219,6898,-1000.00,4000.00,5000.00,0.00,6000.00,0.41,0
69220,6898,-1000.00,3000.00,4000.00,2500.00,2500.00,0.00,0
69221,6898,-1000.00,2000.00,3000.00,0.00,1712.57,0.22,0
69222,6898,-1000.00,1000.00,2000.00,1373.51,1626.49,0.07,0
69223,6898,-1000.00,0.00,1000.00,0.00,2000.00,0.18,0
69224,6898,-930.54,-930.54,69.46,81.96,848.58,0.42,0
69225,6898,-57.74,-988.28,11.72,0.00,57.74,0.10,0
69226,6898,-11.72,-1000.00,0.00,1.40,10.32,0.38,0
69227,6899,-1000.00,-1000.00,0.00,0.00,1000.00,0.12,0
69228,6900,-1000.00,-1000.00,0.00,622.52,41.63,0.07,0
69229,6901,-1000.00,-1000.00,0.00,447.68,552.32,0.24,0
69230,6902,-1000.00,-1000.00,0.00,0.00,1000.00,0.17,0
69231,6903,1000.00,1000.00,2000.00,867.08,0.00,0.15,1
69232,6903,1000.00,2000.00,3000.00,838.70,0.00,0.25,1
69233,6903,-1000.00,1000.00,2000.00,0.00,1838.33,0.18,0
69234,6903,-857.56,142.44,1142.44,162.29,695.27,0.27,0
69235,6903,-1000.00,-857.56,142.44,219.29,923.15,0.26,0
69236,6903,-142.44,-1000.00,0.00,71.22,71.22,0.03,0
69237,6904,-473.54,-473.54,526.46,0.00,473.54,0.25,0
69238,6904,-142.18,-615.72,384.28,0.00,142.18,0.20,0
69239,6904,-384.28,-1000.00,0.00,185.24,199.04,0.13,0
69240,6905,1000.00,1000.00,2000.00,192.49,807.51,0.16,1
69241,6905,1000.00,2000.00,3000.00,0.00,2000.00,0.20,1
69242,6905,1000.00,3000.00,4000.00,727.19,2272.81,0.14,1
69243,6905,1000.00,4000.00,5000.00,1308.54,2691.46,0.30,1
69244,6905,1000.00,5000.00,6000.00,0.00,5000.00,0.18,1
69245,6905,-1000.00,4000.00,5000.00,5373.14,626.86,0.04,0
69246,6905,1000.00,5000.00,6000.00,0.00,5000.00,0.41,1
69247,6905,1000.00,6000.00,7000.00,394.03,5605.97,0.36,1
69248,6905,1000.00,7000.00,8000.00,0.00,2978.68,0.27,1
69249,6905,-1000.00,6000.00,7000.00,6137.83,1862.17,0.09,0
69250,6905,1000.00,7000.00,8000.00,2961.48,4038.52,0.20,1
69251,6905,1000.00,8000.00,9000.00,0.00,8000.00,0.14,1
69252,6905,1000.00,9000.00,10000.00,0.00,9000.00,0.08,1
69253,6905,1000.00,10000.00,11000.00,4454.00,5546.00,0.24,1
69254,6905,-1000.00,9000.00,10000.00,1401.66,453.17,0.12,0
69255,6905,1000.00,10000.00,11000.00,0.00,8789.28,0.20,1
69256,6905,1000.00,11000.00,12000.00,3860.84,7139.16,0.30,1
69257,6905,0.00,11000.00,12000.00,0.00,0.00,0.06,0
69258,6905,1000.00,12000.00,13000.00,0.00,11153.98,0.43,1
69259,6905,1000.00,13000.00,14000.00,0.00,11083.56,0.41,1
69260,6905,-1000.00,12000.00,13000.00,0.00,12040.11,0.42,0
69261,6905,-1000.00,11000.00,12000.00,0.00,13000.00,0.43,0
69262,6905,-1000.00,10000.00,11000.00,0.00,8888.96,0.05,0
69263,6905,-1000.00,9000.00,10000.00,0.00,8274.29,0.35,0
69264,6905,-1000.00,8000.00,9000.00,2392.99,7607.01,0.14,0
69265,6905,-1000.00,7000.00,8000.00,4968.58,4031.42,0.02,0
69266,6905,-1000.00,6000.00,7000.00,3681.53,4318.47,0.15,0
69267,6905,-1000.00,5000.00,6000.00,0.00,7000.00,0.41,0
69268,6905,-1000.00,4000.00,5000.00,1593.88,4406.12,0.36,0
69269,6905,-1000.00,3000.00,4000.00,1717.39,3282.61,0.28,0
69270,6905,-1000.00,2000.00,3000.00,1208.96,2791.04,0.34,0
69271,6905,-1000.00,1000.00,2000.00,0.00,1402.05,0.02,0
69272,6905,-1000.00,0.00,1000.00,0.00,1356.26,0.05,0
69273,6905,-573.98,-573.98,426.02,0.00,573.98,0.19,0
69274,6905,-214.19,-788.17,211.83,35.72,178.47,0.27,0
69275,6905,-144.22,-932.39,67.61,0.00,144.22,0.25,0
69276,6905,-67.61,-1000.00,0.00,24.27,43.34,0.31,0
69277,6906,1000.00,1000.00,2000.00,0.00,1000.00,0.15,1
69278,6906,1000.00,2000.00,3000.00,571.23,1428.77,0.10,1
69279,6906,1000.00,3000.00,4000.00,0.00,3000.00,0.40,1
69280,6906,1000.00,4000.00,5000.00,0.00,2223.51,0.06,1
69281,6906,1000.00,5000.00,6000.00,0.00,5000.00,0.26,1
69282,6906,1000.00,6000.00,7000.00,658.88,5341.12,0.35,1
69283,6906,1000.00,7000.00,8000.00,0.00,5201.50,0.39,1
69284,6906,1000.00,8000.00,9000.00,132.37,2645.38,0.24,1
69285,6906,1000.00,9000.00,10000.00,0.00,5311.55,0.31,1
69286,6906,1000.00,10000.00,11000.00,0.00,2974.22,0.21,1
69287,6906,1000.00,11000.00,12000.00,0.00,11000.00,0.29,1
69288,6906,1000.00,12000.00,13000.00,4078.02,7921.98,0.25,1
69289,6906,1000.00,13000.00,14000.00,0.00,13000.00,0.43,1
69290,6906,1000.00,14000.00,15000.00,0.00,14000.00,0.05,1
69291,6906,1000.00,15000.00,16000.00,1795.61,13204.39,0.27,1
69292,6906,1000.00,16000.00,17000.00,0.00,16000.00,0.11,1
69293,6906,1000.00,17000.00,18000.00,0.00,10293.04,0.20,1
69294,6906,1000.00,18000.00,19000.00,0.00,14584.30,0.06,1
69295,6906,1000.00,19000.00,20000.00,0.00,19000.00,0.25,1
69296,6906,-1000.00,18000.00,19000.00,2403.30,8182.02,0.27,0
69297,6906,-1000.00,17000.00,18000.00,0.00,19000.00,0.22,0
69298,6906,-1000.00,16000.00,17000.00,2698.05,12269.67,0.37,0
69299,6906,-1000.00,15000.00,16000.00,3964.95,13035.05,0.39,0
69300,6906,-1000.00,14000.00,15000.00,0.00,16000.00,0.26,0
69301,6906,-1000.00,13000.00,14000.00,0.00,11518.89,0.41,0
69302,6906,-1000.00,12000.00,13000.00,0.00,14000.00,0.44,0
69303,6906,-1000.00,11000.00,12000.00,1930.17,11069.83,0.28,0
69304,6906,-1000.00,10000.00,11000.00,0.00,12000.00,0.19,0
69305,6906,-1000.00,9000.00,10000.00,26.99,10973.01,0.43,0
69306,6906,-1000.00,8000.00,9000.00,0.00,10000.00,0.25,0
69307,6906,-1000.00,7000.00,8000.00,2947.60,6052.40,0.34,0
69308,6906,-1000.00,6000.00,7000.00,3651.02,4348.98,0.15,0
69309,6906,-1000.00,5000.00,6000.00,899.63,6100.37,0.22,0
69310,6906,-1000.00,4000.00,5000.00,0.00,5007.72,0.40,0
69311,6906,-1000.00,3000.00,4000.00,1618.42,3381.58,0.21,0
69312,6906,-1000.00,2000.00,3000.00,2000.00,2000.00,0.02,0
69313,6906,-1000.00,1000.00,2000.00,697.53,481.57,0.15,0
69314,6906,-1000.00,0.00,1000.00,168.78,1831.22,0.41,0
69315,6906,-1000.00,-1000.00,0.00,463.60,536.40,0.15,0
69316,6907,-209.55,-209.55,790.45,0.00,209.55,0.13,0
69317,6907,-790.45,-1000.00,0.00,366.16,424.29,0.24,0
69318,6908,-1000.00,-1000.00,0.00,311.11,240.75,0.17,0
69319,6909,-474.68,-474.68,525.32,0.00,474.68,0.30,0
69320,6909,0.00,-474.68,525.32,0.00,0.00,0.04,0
69321,6909,-525.32,-1000.00,0.00,135.52,389.79,0.32,0
69322,6910,-1000.00,-1000.00,0.00,31.92,968.08,0.39,0
69323,6910,-0.00,-1000.00,0.00,0.00,0.00,0.13,0
69324,6910,-0.00,-1000.00,0.00,0.00,0.00,0.12,0
69325,6910,-0.00,-1000.00,0.00,0.00,0.00,0.24,0
69326,6911,1000.00,1000.00,2000.00,0.00,1000.00,0.01,1
69327,6911,-1000.00,0.00,1000.00,809.13,408.23,0.15,0
69328,6911,-1000.00,-1000.00,0.00,296.55,410.97,0.24,0
69329,6912,-29.97,-29.97,970.03,29.97,0.00,0.03,0
69330,6912,1000.00,970.03,1970.03,0.00,970.03,0.03,1
69331,6912,-1000.00,-29.97,970.03,1577.33,392.70,0.00,0
69332,6912,1000.00,970.03,1970.03,279.64,690.40,0.36,1
69333,6912,1000.00,1970.03,2970.03,0.00,1032.50,0.01,1
69334,6912,1000.00,2970.03,3970.03,0.00,2829.59,0.38,1
69335,6912,1000.00,3970.03,4970.03,1145.20,2824.84,0.34,1
69336,6912,1000.00,4970.03,5970.03,0.00,4834.90,0.26,1
69337,6912,1000.00,5970.03,6970.03,0.00,4810.55,0.33,1
69338,6912,1000.00,6970.03,7970.03,3012.28,3957.75,0.11,1
69339,6912,1000.00,7970.03,8970.03,0.00,2000.99,0.10,1
69340,6912,1000.00,8970.03,9970.03,1296.28,7673.75,0.33,1
69341,6912,-1000.00,7970.03,8970.03,6243.94,3726.09,0.15,0
69342,6912,1000.00,8970.03,9970.03,4485.02,4485.02,0.03,1
69343,6912,1000.00,9970.03,10970.03,0.00,9970.03,0.14,1
69344,6912,1000.00,10970.03,11970.03,4453.74,6516.30,0.27,1
69345,6912,1000.00,11970.03,12970.03,248.51,7092.35,0.35,1
69346,6912,1000.00,12970.03,13970.03,0.00,9003.83,0.25,1
69347,6912,-1000.00,11970.03,12970.03,3361.86,0.00,0.10,0
69348,6912,1000.00,12970.03,13970.03,0.00,9910.17,0.40,1
69349,6912,-1000.00,11970.03,12970.03,9622.42,4347.61,0.08,0
69350,6912,1000.00,12970.03,13970.03,0.00,12276.02,0.44,1
69351,6912,1000.00,13970.03,14970.03,0.00,13970.03,0.18,1
69352,6912,1000.00,14970.03,15970.03,0.00,14970.03,0.42,1
69353,6912,1000.00,15970.03,16970.03,0.00,15970.03,0.37,1
69354,6912,1000.00,16970.03,17970.03,7012.20,9957.84,0.16,1
69355,6912,1000.00,17970.03,18970.03,0.00,17970.03,0.41,1
69356,6912,1000.00,18970.03,19970.03,0.00,18970.03,0.30,1
69357,6912,1000.00,19970.03,20970.03,0.00,19970.03,0.07,1
69358,6912,1000.00,20970.03,21970.03,0.00,20970.03,0.15,1
69359,6912,-1000.00,19970.03,20970.03,5848.07,4145.36,0.16,0
69360,6912,1000.00,20970.03,21970.03,0.00,18188.21,0.28,1
69361,6912,1000.00,21970.03,22970.03,0.00,21970.03,0.14,1
69362,6912,1000.00,22970.03,23970.03,0.00,22970.03,0.25,1
69363,6912,1000.00,23970.03,24970.03,0.00,22107.03,0.43,1
69364,6912,1000.00,24970.03,25970.03,0.00,24970.03,0.44,1
69365,6912,-1000.00,23970.03,24970.03,16250.47,9719.57,0.09,0
69366,6912,1000.00,24970.03,25970.03,9647.19,15322.84,0.21,1
69367,6912,1000.00,25970.03,26970.03,7676.87,18293.16,0.12,1
69368,6912,1000.00,26970.03,27970.03,0.00,26970.03,0.26,1
69369,6912,1000.00,27970.03,28970.03,0.00,27970.03,0.39,1
69370,6912,1000.00,28970.03,29970.03,0.00,28970.03,0.04,1
69371,6912,1000.00,29970.03,30970.03,11332.87,18637.16,0.02,1
69372,6912,1000.00,30970.03,31970.03,0.00,30970.03,0.39,1
69373,6912,1000.00,31970.03,32970.03,0.00,8521.98,0.18,1
69374,6912,-1000.00,30970.03,31970.03,14855.19,2805.55,0.10,0
69375,6912,1000.00,31970.03,32970.03,11579.86,20390.18,0.22,1
69376,6912,-1000.00,30970.03,31970.03,0.00,32970.03,0.02,0
69377,6912,-1000.00,29970.03,30970.03,0.00,9694.31,0.23,0
69378,6912,-1000.00,28970.03,29970.03,14693.53,9252.88,0.16,0
69379,6912,-1000.00,27970.03,28970.03,7735.68,12794.11,0.26,0
69380,6912,-1000.00,26970.03,27970.03,25455.54,3514.49,0.02,0
69381,6912,-1000.00,25970.03,26970.03,12640.08,15329.95,0.17,0
69382,6912,-1000.00,24970.03,25970.03,1961.37,0.00,0.02,0
69383,6912,-1000.00,23970.03,24970.03,0.00,25970.03,0.10,0
69384,6912,0.00,23970.03,24970.03,0.00,0.00,0.01,0
69385,6912,-1000.00,22970.03,23970.03,9376.97,15593.06,0.30,0
69386,6912,-1000.00,21970.03,22970.03,0.00,23970.03,0.40,0
69387,6912,-1000.00,20970.03,21970.03,7133.58,15836.46,0.35,0
69388,6912,-1000.00,19970.03,20970.03,0.00,21970.03,0.24,0
69389,6912,-1000.00,18970.03,19970.03,0.00,18569.58,0.12,0
69390,6912,-1000.00,17970.03,18970.03,3724.31,16245.72,0.31,0
69391,6912,-1000.00,16970.03,17970.03,528.56,16425.35,0.43,0
69392,6912,-1000.00,15970.03,16970.03,8535.53,9434.50,0.02,0
69393,6912,-1000.00,14970.03,15970.03,6360.91,10609.12,0.31,0
69394,6912,-1000.00,13970.03,14970.03,6520.11,9449.93,0.16,0
69395,6912,-1000.00,12970.03,13970.03,0.00,14970.03,0.01,0
69396,6913,-1000.00,-1000.00,0.00,0.00,1000.00,0.13,0
69397,6914,-1000.00,-1000.00,0.00,500.00,500.00,0.10,0
69398,6915,-1000.00,-1000.00,0.00,0.00,1000.00,0.38,0
69399,6916,1000.00,1000.00,2000.00,251.93,748.07,0.06,1
69400,6916,1000.00,2000.00,3000.00,987.18,1012.82,0.19,1
69401,6916,-1000.00,1000.00,2000.00,1998.00,646.78,0.10,0
69402,6916,1000.00,2000.00,3000.00,0.00,2000.00,0.44,1
69403,6916,1000.00,3000.00,4000.00,0.00,3000.00,0.03,1
69404,6916,1000.00,4000.00,5000.00,0.00,4000.00,0.43,1
69405,6916,1000.00,5000.00,6000.00,0.00,5000.00,0.08,1
69406,6916,1000.00,6000.00,7000.00,753.01,5246.99,0.29,1
69407,6916,1000.00,7000.00,8000.00,0.00,6629.42,0.40,1
69408,6916,1000.00,8000.00,9000.00,1592.21,6407.79,0.38,1
69409,6916,1000.00,9000.00,10000.00,258.06,4595.08,0.32,1
69410,6916,1000.00,10000.00,11000.00,0.00,10000.00,0.17,1
69411,6916,1000.00,11000.00,12000.00,3896.11,6654.28,0.30,1
69412,6916,1000.00,12000.00,13000.00,0.00,12000.00,0.09,1
69413,6916,1000.00,13000.00,14000.00,0.00,2033.06,0.03,1
69414,6916,-1000.00,12000.00,13000.00,12180.30,1470.32,0.05,0
69415,6916,1000.00,13000.00,14000.00,4338.62,8661.38,0.24,1
69416,6916,1000.00,14000.00,15000.00,0.00,5412.87,0.25,1
69417,6916,-1000.00,13000.00,14000.00,4733.21,4094.71,0.18,0
69418,6916,1000.00,14000.00,15000.00,0.00,9782.46,0.39,1
69419,6916,1000.00,15000.00,16000.00,0.00,14849.45,0.15,1
69420,6916,1000.00,16000.00,17000.00,4851.24,11148.76,0.35,1
69421,6916,1000.00,17000.00,18000.00,0.00,10050.81,0.34,1
69422,6916,-1000.00,16000.00,17000.00,3853.10,14146.90,0.39,0
69423,6916,-1000.00,15000.00,16000.00,6441.78,10558.22,0.30,0
69424,6916,-1000.00,14000.00,15000.00,5319.36,10680.64,0.26,0
69425,6916,-1000.00,13000.00,14000.00,4225.37,10774.63,0.10,0
69426,6916,-1000.00,12000.00,13000.00,357.33,13642.67,0.42,0
69427,6916,-1000.00,11000.00,12000.00,0.00,6181.07,0.29,0
69428,6916,-1000.00,10000.00,11000.00,0.00,11744.53,0.39,0
69429,6916,-1000.00,9000.00,10000.00,2716.94,8283.06,0.38,0
69430,6916,-1000.00,8000.00,9000.00,6739.40,2472.36,0.11,0
69431,6916,-1000.00,7000.00,8000.00,3621.18,5378.82,0.23,0
69432,6916,-1000.00,6000.00,7000.00,2624.31,4682.28,0.30,0
69433,6916,-1000.00,5000.00,6000.00,1935.02,5064.98,0.13,0
69434,6916,-1000.00,4000.00,5000.00,937.96,5062.04,0.42,0
69435,6916,-1000.00,3000.00,4000.00,743.74,1140.15,0.19,0
69436,6916,-1000.00,2000.00,3000.00,0.00,3810.80,0.24,0
69437,6916,-1000.00,1000.00,2000.00,0.00,2817.03,0.44,0
69438,6916,-1000.00,0.00,1000.00,0.00,1075.81,0.05,0
69439,6916,-1000.00,-1000.00,0.00,0.00,1000.00,0.11,0
69440,6917,-1000.00,-1000.00,0.00,0.00,772.55,0.30,0
69441,6918,-950.95,-950.95,49.05,0.00,950.95,0.43,0
69442,6918,-49.05,-1000.00,0.00,24.52,24.52,0.03,0
69443,6919,1000.00,1000.00,2000.00,0.00,828.04,0.37,1
69444,6919,1000.00,2000.00,3000.00,267.91,1732.09,0.42,1
69445,6919,1000.00,3000.00,4000.00,1464.37,1535.63,0.20,1
69446,6919,1000.00,4000.00,5000.00,1403.75,2596.25,0.30,1
69447,6919,1000.00,5000.00,6000.00,1457.94,3542.06,0.36,1
69448,6919,1000.00,6000.00,7000.00,0.00,6000.00,0.04,1
69449,6919,1000.00,7000.00,8000.00,3500.00,3500.00,0.02,1
69450,6919,1000.00,8000.00,9000.00,3059.45,4940.55,0.27,1
69451,6919,1000.00,9000.00,10000.00,0.00,2298.82,0.20,1
69452,6919,1000.00,10000.00,11000.00,0.00,10000.00,0.30,1
69453,6919,1000.00,11000.00,12000.00,5500.00,5500.00,0.06,1
69454,6919,1000.00,12000.00,13000.00,431.25,11568.75,0.30,1
69455,6919,1000.00,13000.00,14000.00,0.00,13000.00,0.15,1
69456,6919,1000.00,14000.00,15000.00,0.00,14000.00,0.30,1
69457,6919,1000.00,15000.00,16000.00,7478.99,7521.01,0.03,1
69458,6919,1000.00,16000.00,17000.00,6235.95,9764.05,0.24,1
69459,6919,-1000.00,15000.00,16000.00,9994.37,7005.63,0.05,0
69460,6919,1000.00,16000.00,17000.00,0.00,16000.00,0.02,1
69461,6919,-1000.00,15000.00,16000.00,0.00,6974.98,0.26,0
69462,6919,-1000.00,14000.00,15000.00,0.00,16000.00,0.39,0
69463,6919,-1000.00,13000.00,14000.00,0.00,15000.00,0.12,0
69464,6919,-1000.00,12000.00,13000.00,0.00,14000.00,0.25,0
69465,6919,-1000.00,11000.00,12000.00,2321.84,5268.75,0.26,0
69466,6919,-1000.00,10000.00,11000.00,0.00,12000.00,0.38,0
69467,6919,-1000.00,9000.00,10000.00,0.00,11000.00,0.35,0
69468,6919,-1000.00,8000.00,9000.00,3939.16,6060.84,0.10,0
69469,6919,-1000.00,7000.00,8000.00,0.00,9000.00,0.24,0
69470,6919,-1000.00,6000.00,7000.00,2626.84,5373.16,0.06,0
69471,6919,-1000.00,5000.00,6000.00,2145.57,4854.43,0.32,0
69472,6919,-1000.00,4000.00,5000.00,0.00,6000.00,0.15,0
69473,6919,-1000.00,3000.00,4000.00,0.00,5000.00,0.19,0
69474,6919,-1000.00,2000.00,3000.00,1391.30,2608.70,0.33,0
69475,6919,-1000.00,1000.00,2000.00,0.00,1739.14,0.19,0
69476,6919,-1000.00,0.00,1000.00,0.00,2000.00,0.26,0
69477,6919,-722.61,-722.61,277.39,0.00,722.61,0.34,0
69478,6919,-277.39,-1000.00,0.00,135.34,142.05,0.08,0
69479,6920,-1000.00,-1000.00,0.00,0.00,120.03,0.41,0
69480,6921,1000.00,1000.00,2000.00,0.00,597.24,0.35,1
69481,6921,-1000.00,0.00,1000.00,602.29,504.06,0.18,0
69482,6921,-665.95,-665.95,334.05,570.52,95.44,0.09,0
69483,6921,1000.00,334.05,1334.05,0.00,334.05,0.04,1
69484,6921,1000.00,1334.05,2334.05,0.00,1334.05,0.13,1
69485,6921,-1000.00,334.05,1334.05,1265.31,1068.73,0.19,0
69486,6921,1000.00,1334.05,2334.05,0.00,1334.05,0.06,1
69487,6921,1000.00,2334.05,3334.05,252.68,634.93,0.21,1
69488,6921,1000.00,3334.05,4334.05,245.65,3088.40,0.13,1
69489,6921,1000.00,4334.05,5334.05,1789.05,2544.99,0.19,1
69490,6921,0.00,4334.05,5334.05,0.00,0.00,0.03,0
69491,6921,1000.00,5334.05,6334.05,0.00,5334.05,0.23,1
69492,6921,1000.00,6334.05,7334.05,877.29,5456.75,0.37,1
69493,6921,1000.00,7334.05,8334.05,3486.67,3847.38,0.14,1
69494,6921,1000.00,8334.05,9334.05,0.00,6432.05,0.31,1
69495,6921,1000.00,9334.05,10334.05,0.00,9334.05,0.40,1
69496,6921,1000.00,10334.05,11334.05,1796.98,8537.07,0.41,1
69497,6921,1000.00,11334.05,12334.05,1356.21,9920.63,0.42,1
69498,6921,1000.00,12334.05,13334.05,3539.92,8794.13,0.33,1
69499,6921,1000.00,13334.05,14334.05,0.00,6674.23,0.29,1
69500,6921,1000.00,14334.05,15334.05,4850.43,9483.61,0.20,1
69501,6921,1000.00,15334.05,16334.05,0.00,11297.81,0.17,1
69502,6921,1000.00,16334.05,17334.05,5983.96,10350.09,0.28,1
69503,6921,1000.00,17334.05,18334.05,7975.08,8704.37,0.23,1
69504,6921,-1000.00,16334.05,17334.05,9852.74,8481.31,0.02,0
69505,6921,1000.00,17334.05,18334.05,0.00,11582.21,0.38,1
69506,6921,1000.00,18334.05,19334.05,0.00,17697.20,0.43,1
69507,6921,1000.00,19334.05,20334.05,0.00,11277.62,0.34,1
69508,6921,1000.00,20334.05,21334.05,0.00,20169.12,0.15,1
69509,6921,1000.00,21334.05,22334.05,6729.70,14604.35,0.33,1
69510,6921,-1000.00,20334.05,21334.05,12056.56,10277.49,0.13,0
69511,6921,1000.00,21334.05,22334.05,893.32,20440.73,0.40,1
69512,6921,1000.00,22334.05,23334.05,3809.11,9369.67,0.27,1
69513,6921,1000.00,23334.05,24334.05,0.00,20787.94,0.35,1
69514,6921,1000.00,24334.05,25334.05,0.00,20310.26,0.08,1
69515,6921,1000.00,25334.05,26334.05,12667.02,12667.02,0.08,1
69516,6921,1000.00,26334.05,27334.05,0.00,26334.05,0.39,1
69517,6921,1000.00,27334.05,28334.05,0.00,27334.05,0.09,1
69518,6921,1000.00,28334.05,29334.05,0.00,28334.05,0.27,1
69519,6921,1000.00,29334.05,30334.05,0.00,29334.05,0.37,1
69520,6921,1000.00,30334.05,31334.05,4688.31,25645.74,0.30,1
69521,6921,1000.00,31334.05,32334.05,13610.31,17723.73,0.26,1
69522,6921,-1000.00,30334.05,31334.05,24640.77,1937.18,0.06,0
69523,6921,1000.00,31334.05,32334.05,8591.84,11034.47,0.22,1
69524,6921,1000.00,32334.05,33334.05,0.00,6638.94,0.18,1
69525,6921,-1000.00,31334.05,32334.05,22766.70,10567.35,0.12,0
69526,6921,1000.00,32334.05,33334.05,13800.09,18533.95,0.13,1
69527,6921,1000.00,33334.05,34334.05,14878.69,18455.36,0.17,1
69528,6921,-1000.00,32334.05,33334.05,0.00,31239.53,0.41,0
69529,6921,-1000.00,31334.05,32334.05,0.00,33334.05,0.12,0
69530,6921,-1000.00,30334.05,31334.05,0.00,23617.73,0.32,0
69531,6921,-1000.00,29334.05,30334.05,13563.96,17770.09,0.26,0
69532,6921,-1000.00,28334.05,29334.05,0.00,30334.05,0.06,0
69533,6921,-1000.00,27334.05,28334.05,0.00,21279.22,0.12,0
69534,6921,-1000.00,26334.05,27334.05,7399.71,16190.18,0.31,0
69535,6921,-1000.00,25334.05,26334.05,1549.88,22221.07,0.42,0
69536,6921,-1000.00,24334.05,25334.05,0.00,11350.93,0.23,0
69537,6921,-1000.00,23334.05,24334.05,0.00,25334.05,0.34,0
69538,6921,-1000.00,22334.05,23334.05,2365.84,21968.20,0.22,0
69539,6921,-1000.00,21334.05,22334.05,7868.32,15465.73,0.25,0
69540,6921,-1000.00,20334.05,21334.05,0.00,8377.71,0.09,0
69541,6921,-1000.00,19334.05,20334.05,8050.33,13283.72,0.09,0
69542,6921,-1000.00,18334.05,19334.05,0.00,14934.81,0.34,0
69543,6921,-1000.00,17334.05,18334.05,0.00,14136.79,0.25,0
69544,6921,-1000.00,16334.05,17334.05,6385.13,11948.92,0.32,0
69545,6921,-1000.00,15334.05,16334.05,3715.74,13618.31,0.34,0
69546,6921,-1000.00,14334.05,15334.05,11789.74,4544.31,0.07,0
69547,6921,-1000.00,13334.05,14334.05,0.00,7811.53,0.28,0
69548,6921,-1000.00,12334.05,13334.05,5841.20,8492.85,0.20,0
69549,6921,-1000.00,11334.05,12334.05,4383.25,8950.79,0.25,0
69550,6921,-1000.00,10334.05,11334.05,2074.06,10259.99,0.30,0
69551,6922,-1000.00,-1000.00,0.00,0.00,566.17,0.33,0
69552,6923,1000.00,1000.00,2000.00,516.88,0.00,0.29,1
69553,6923,1000.00,2000.00,3000.00,545.46,0.00,0.37,1
69554,6923,-1000.00,1000.00,2000.00,1263.05,1736.95,0.07,0
69555,6923,-408.10,591.90,1591.90,0.00,408.10,0.41,0
69556,6923,0.00,591.90,1591.90,0.00,0.00,0.08,0
69557,6923,-1000.00,-408.10,591.90,0.00,1591.90,0.23,0
69558,6923,-121.89,-529.99,470.01,52.86,69.03,0.15,0
69559,6923,-357.72,-887.71,112.29,0.00,357.72,0.40,0
69560,6923,-112.29,-1000.00,0.00,0.00,112.29,0.32,0
69561,6924,1000.00,1000.00,2000.00,746.56,0.00,0.17,1
69562,6924,1000.00,2000.00,3000.00,772.64,323.93,0.35,1
69563,6924,-1000.00,1000.00,2000.00,1431.12,1568.88,0.23,0
69564,6924,-1000.00,0.00,1000.00,0.00,1768.75,0.05,0
69565,6924,1000.00,1000.00,2000.00,634.30,365.70,0.04,1
69566,6924,-1000.00,0.00,1000.00,1000.00,1000.00,0.01,0
69567,6924,1000.00,1000.00,2000.00,703.59,296.41,0.01,1
69568,6924,-1000.00,0.00,1000.00,0.00,1292.98,0.24,0
69569,6924,-909.16,-909.16,90.84,82.61,826.56,0.42,0
69570,6924,-90.84,-1000.00,0.00,0.00,90.84,0.04,0
69571,6925,-1000.00,-1000.00,0.00,0.00,1000.00,0.22,0
69572,6926,1000.00,1000.00,2000.00,198.63,801.37,0.31,1
69573,6926,1000.00,2000.00,3000.00,0.00,633.78,0.23,1
69574,6926,1000.00,3000.00,4000.00,75.97,2924.03,0.44,1
69575,6926,1000.00,4000.00,5000.00,0.00,4000.00,0.31,1
69576,6926,1000.00,5000.00,6000.00,0.00,5000.00,0.40,1
69577,6926,1000.00,6000.00,7000.00,0.00,6000.00,0.11,1
69578,6926,1000.00,7000.00,8000.00,581.13,2040.84,0.22,1
69579,6926,0.00,7000.00,8000.00,0.00,0.00,0.02,0
69580,6926,1000.00,8000.00,9000.00,0.00,8000.00,0.24,1
69581,6926,1000.00,9000.00,10000.00,0.00,2195.15,0.13,1
69582,6926,1000.00,10000.00,11000.00,2904.80,7095.20,0.30,1
69583,6926,0.00,10000.00,11000.00,0.00,0.00,0.00,0
69584,6926,1000.00,11000.00,12000.00,0.00,11000.00,0.18,1
69585,6926,1000.00,12000.00,13000.00,0.00,2590.01,0.02,1
69586,6926,1000.00,13000.00,14000.00,0.00,13000.00,0.24,1
69587,6926,1000.00,14000.00,15000.00,0.00,12538.08,0.20,1
69588,6926,1000.00,15000.00,16000.00,4674.93,10325.07,0.33,1
69589,6926,-198.58,14801.42,15801.42,103.54,95.04,0.11,0
69590,6926,1000.00,15801.42,16801.42,6576.24,9225.19,0.14,1
69591,6926,-1000.00,14801.42,15801.42,4870.18,4027.21,0.18,0
69592,6926,-1000.00,13801.42,14801.42,7493.31,5298.14,0.18,0
69593,6926,1000.00,14801.42,15801.42,0.00,14801.42,0.10,1
69594,6926,-1000.00,13801.42,14801.42,1147.38,0.00,0.02,0
69595,6926,1000.00,14801.42,15801.42,3670.07,8179.51,0.31,1
69596,6926,1000.00,15801.42,16801.42,2302.90,13498.52,0.41,1
69597,6926,1000.00,16801.42,17801.42,5903.60,7364.06,0.24,1
69598,6926,1000.00,17801.42,18801.42,0.00,17801.42,0.39,1
69599,6926,1000.00,18801.42,19801.42,0.00,18801.42,0.30,1
69600,6926,1000.00,19801.42,20801.42,0.00,19801.42,0.17,1
69601,6926,0.00,19801.42,20801.42,0.00,0.00,0.07,0
69602,6926,1000.00,20801.42,21801.42,5505.45,15295.97,0.29,1
69603,6926,1000.00,21801.42,22801.42,0.00,15747.93,0.35,1
69604,6926,1000.00,22801.42,23801.42,4686.14,8916.89,0.25,1
69605,6926,1000.00,23801.42,24801.42,6790.99,17010.43,0.27,1
69606,6926,1000.00,24801.42,25801.42,0.00,24801.42,0.41,1
69607,6926,1000.00,25801.42,26801.42,0.00,25532.32,0.42,1
69608,6926,1000.00,26801.42,27801.42,0.00,26801.42,0.38,1
69609,6926,1000.00,27801.42,28801.42,11246.62,16554.80,0.08,1
69610,6926,1000.00,28801.42,29801.42,0.00,23204.07,0.26,1
69611,6926,1000.00,29801.42,30801.42,0.00,29801.42,0.16,1
69612,6926,0.00,29801.42,30801.42,0.00,0.00,0.08,0
69613,6926,1000.00,30801.42,31801.42,0.00,30801.42,0.23,1
69614,6926,1000.00,31801.42,32801.42,0.00,31801.42,0.39,1
69615,6926,0.00,31801.42,32801.42,0.00,0.00,0.00,0
69616,6926,1000.00,32801.42,33801.42,0.00,8334.12,0.18,1
69617,6926,1000.00,33801.42,34801.42,0.00,23661.01,0.19,1
69618,6926,1000.00,34801.42,35801.42,0.00,21986.98,0.36,1
69619,6926,0.00,34801.42,35801.42,0.00,0.00,0.00,0
69620,6926,1000.00,35801.42,36801.42,17900.71,17900.71,0.02,1
69621,6926,1000.00,36801.42,37801.42,9698.22,27103.21,0.29,1
69622,6926,1000.00,37801.42,38801.42,0.00,37801.42,0.37,1
69623,6926,1000.00,38801.42,39801.42,0.00,38801.42,0.08,1
69624,6926,1000.00,39801.42,40801.42,0.00,24920.90,0.32,1
69625,6926,1000.00,40801.42,41801.42,8065.79,32735.63,0.14,1
69626,6926,1000.00,41801.42,42801.42,19664.21,22137.21,0.12,1
69627,6926,-1000.00,40801.42,41801.42,23982.24,18819.19,0.07,0
69628,6926,1000.00,41801.42,42801.42,0.00,41801.42,0.43,1
69629,6926,1000.00,42801.42,43801.42,0.00,33180.01,0.25,1
69630,6926,1000.00,43801.42,44801.42,0.00,36056.70,0.31,1
69631,6926,1000.00,44801.42,45801.42,17564.74,27236.69,0.28,1
69632,6926,-1000.00,43801.42,44801.42,25244.97,20556.46,0.09,0
69633,6926,1000.00,44801.42,45801.42,0.00,44801.42,0.20,1
69634,6926,-1000.00,43801.42,44801.42,15754.10,12633.92,0.18,0
69635,6926,1000.00,44801.42,45801.42,20899.06,23902.36,0.12,1
69636,6926,1000.00,45801.42,46801.42,0.00,20693.32,0.26,1
69637,6926,1000.00,46801.42,47801.42,0.00,44505.83,0.21,1
69638,6926,1000.00,47801.42,48801.42,0.00,40329.30,0.42,1
69639,6926,1000.00,48801.42,49801.42,0.00,48801.42,0.22,1
69640,6926,1000.00,49801.42,50801.42,16078.50,33722.92,0.08,1
69641,6927,-1000.00,-1000.00,0.00,0.00,1000.00,0.40,0
69642,6928,-1000.00,-1000.00,0.00,0.00,495.85,0.24,0
69643,6929,-278.12,-278.12,721.88,278.12,0.00,0.09,0
69644,6929,1000.00,721.88,1721.88,304.54,417.34,0.04,1
69645,6929,1000.00,1721.88,2721.88,546.68,1175.20,0.30,1
69646,6929,1000.00,2721.88,3721.88,0.00,2721.88,0.17,1
69647,6929,1000.00,3721.88,4721.88,250.97,3470.91,0.14,1
69648,6929,1000.00,4721.88,5721.88,1458.99,3262.89,0.25,1
69649,6929,1000.00,5721.88,6721.88,0.00,4048.18,0.36,1
69650,6929,1000.00,6721.88,7721.88,2190.03,4531.85,0.33,1
69651,6929,1000.00,7721.88,8721.88,0.00,7409.53,0.37,1
69652,6929,1000.00,8721.88,9721.88,0.00,1541.47,0.16,1
69653,6929,1000.00,9721.88,10721.88,2766.24,6955.64,0.35,1
69654,6929,1000.00,10721.88,11721.88,0.00,4936.27,0.23,1
69655,6929,1000.00,11721.88,12721.88,0.00,11721.88,0.27,1
69656,6929,1000.00,12721.88,13721.88,0.00,12721.88,0.18,1
69657,6929,1000.00,13721.88,14721.88,2481.20,11240.68,0.17,1
69658,6929,1000.00,14721.88,15721.88,0.00,3219.90,0.18,1
69659,6929,1000.00,15721.88,16721.88,0.00,14636.09,0.34,1
69660,6929,1000.00,16721.88,17721.88,8360.94,8360.94,0.02,1
69661,6929,1000.00,17721.88,18721.88,0.00,17721.88,0.00,1
69662,6929,1000.00,18721.88,19721.88,6564.35,12157.53,0.25,1
69663,6929,-1000.00,17721.88,18721.88,1418.42,0.00,0.00,0
69664,6929,1000.00,18721.88,19721.88,0.00,17761.30,0.02,1
69665,6929,1000.00,19721.88,20721.88,2705.55,3083.49,0.16,1
69666,6929,-1000.00,18721.88,19721.88,0.00,10904.80,0.16,0
69667,6929,-1000.00,17721.88,18721.88,0.00,1957.63,0.14,0
69668,6929,-1000.00,16721.88,17721.88,862.49,17859.39,0.44,0
69669,6929,-1000.00,15721.88,16721.88,0.00,17721.88,0.02,0
69670,6929,-1000.00,14721.88,15721.88,0.00,10488.42,0.31,0
69671,6929,-1000.00,13721.88,14721.88,0.00,7079.84,0.22,0
69672,6929,-1000.00,12721.88,13721.88,7970.73,0.00,0.07,0
69673,6929,-1000.00,11721.88,12721.88,0.00,12802.24,0.24,0
69674,6929,-1000.00,10721.88,11721.88,19.07,12702.81,0.33,0
69675,6929,-1000.00,9721.88,10721.88,0.00,11721.88,0.38,0
69676,6929,-1000.00,8721.88,9721.88,1757.74,8964.14,0.36,0
69677,6929,-1000.00,7721.88,8721.88,3786.52,5935.36,0.16,0
69678,6929,-1000.00,6721.88,7721.88,0.00,5118.88,0.33,0
69679,6929,-1000.00,5721.88,6721.88,1489.94,6231.94,0.40,0
69680,6929,-1000.00,4721.88,5721.88,3280.82,3441.06,0.12,0
69681,6929,-1000.00,3721.88,4721.88,3371.45,2345.13,0.17,0
69682,6929,-1000.00,2721.88,3721.88,1359.92,3046.38,0.33,0
69683,6929,-1000.00,1721.88,2721.88,0.00,3721.88,0.26,0
69684,6929,-1000.00,721.88,1721.88,1439.19,1282.69,0.01,0
69685,6929,-1000.00,-278.12,721.88,0.00,1721.88,0.19,0
69686,6929,-721.88,-1000.00,0.00,85.40,636.48,0.20,0
69687,6930,-324.37,-324.37,675.63,0.00,324.37,0.23,0
69688,6930,-671.62,-995.99,4.01,0.00,671.62,0.32,0
69689,6930,371.77,-624.22,375.78,2.11,1.89,0.02,1
69690,6930,-194.88,-819.11,180.89,5.49,189.40,0.31,0
69691,6930,-180.89,-1000.00,0.00,0.00,180.89,0.31,0
69692,6931,-1000.00,-1000.00,0.00,403.13,596.87,0.06,0
69693,6932,-1000.00,-1000.00,0.00,0.00,1000.00,0.33,0
69694,6933,-1000.00,-1000.00,0.00,549.52,450.48,0.19,0
69695,6934,-1000.00,-1000.00,0.00,0.00,1000.00,0.04,0
69696,6935,1000.00,1000.00,2000.00,498.18,501.82,0.06,1
69697,6935,1000.00,2000.00,3000.00,0.00,2000.00,0.16,1
69698,6935,1000.00,3000.00,4000.00,0.00,3000.00,0.10,1
69699,6935,1000.00,4000.00,5000.00,0.00,4000.00,0.06,1
69700,6935,1000.00,5000.00,6000.00,0.00,5000.00,0.13,1
69701,6935,1000.00,6000.00,7000.00,3000.00,3000.00,0.00,1
69702,6935,1000.00,7000.00,8000.00,0.00,7000.00,0.41,1
69703,6935,-1000.00,6000.00,7000.00,5024.82,2975.18,0.00,0
69704,6935,1000.00,7000.00,8000.00,0.00,6291.89,0.39,1
69705,6935,1000.00,8000.00,9000.00,88.67,7911.33,0.28,1
69706,6935,1000.00,9000.00,10000.00,455.20,8544.80,0.24,1
69707,6935,1000.00,10000.00,11000.00,1617.44,8382.56,0.41,1
69708,6935,1000.00,11000.00,12000.00,3471.72,7528.28,0.32,1
69709,6935,1000.00,12000.00,13000.00,0.00,12000.00,0.35,1
69710,6935,1000.00,13000.00,14000.00,3271.99,9728.01,0.38,1
69711,6935,1000.00,14000.00,15000.00,2416.91,11583.09,0.34,1
69712,6935,1000.00,15000.00,16000.00,0.00,8672.53,0.30,1
69713,6935,1000.00,16000.00,17000.00,0.00,14890.70,0.43,1
69714,6935,1000.00,17000.00,18000.00,7503.10,9496.90,0.13,1
69715,6935,1000.00,18000.00,19000.00,6103.15,11896.85,0.22,1
69716,6935,1000.00,19000.00,20000.00,0.00,19000.00,0.11,1
69717,6935,1000.00,20000.00,21000.00,0.00,20000.00,0.34,1
69718,6935,1000.00,21000.00,22000.00,910.92,5628.08,0.21,1
69719,6935,1000.00,22000.00,23000.00,0.00,22000.00,0.28,1
69720,6935,1000.00,23000.00,24000.00,0.00,2908.23,0.03,1
69721,6935,1000.00,24000.00,25000.00,0.00,24000.00,0.26,1
69722,6935,1000.00,25000.00,26000.00,0.00,25000.00,0.07,1
69723,6935,1000.00,26000.00,27000.00,0.00,26000.00,0.21,1
69724,6935,1000.00,27000.00,28000.00,13500.00,13500.00,0.07,1
69725,6935,1000.00,28000.00,29000.00,0.00,28000.00,0.31,1
69726,6935,1000.00,29000.00,30000.00,2576.90,26423.10,0.10,1
69727,6935,-1000.00,28000.00,29000.00,22841.73,7158.27,0.03,0
69728,6935,1000.00,29000.00,30000.00,0.00,29000.00,0.40,1
69729,6935,1000.00,30000.00,31000.00,0.00,30000.00,0.26,1
69730,6935,1000.00,31000.00,32000.00,0.00,30096.81,0.28,1
69731,6935,1000.00,32000.00,33000.00,861.29,31138.71,0.23,1
69732,6935,1000.00,33000.00,34000.00,0.00,5642.41,0.01,1
69733,6935,-1000.00,32000.00,33000.00,20622.76,1464.21,0.07,0
69734,6935,1000.00,33000.00,34000.00,0.00,30080.22,0.26,1
69735,6935,-1000.00,32000.00,33000.00,20736.78,3458.18,0.09,0
69736,6935,1000.00,33000.00,34000.00,0.00,28662.69,0.43,1
69737,6935,1000.00,34000.00,35000.00,0.00,34000.00,0.02,1
69738,6935,1000.00,35000.00,36000.00,0.00,35000.00,0.09,1
69739,6935,1000.00,36000.00,37000.00,0.00,36000.00,0.12,1
69740,6935,1000.00,37000.00,38000.00,11684.14,25315.86,0.23,1
69741,6935,1000.00,38000.00,39000.00,8593.24,29406.76,0.23,1
69742,6935,1000.00,39000.00,40000.00,0.00,18630.60,0.19,1
69743,6935,-1000.00,38000.00,39000.00,3500.36,9904.03,0.20,0
69744,6935,-1000.00,37000.00,38000.00,0.00,39000.00,0.34,0
69745,6935,-1000.00,36000.00,37000.00,0.00,23716.85,0.23,0
69746,6935,-1000.00,35000.00,36000.00,32632.47,4367.53,0.04,0
69747,6935,-1000.00,34000.00,35000.00,0.00,36000.00,0.33,0
69748,6935,-1000.00,33000.00,34000.00,23178.05,11821.95,0.07,0
69749,6935,-1000.00,32000.00,33000.00,13397.04,20602.96,0.20,0
69750,6935,-1000.00,31000.00,32000.00,0.00,26778.57,0.37,0
69751,6935,-1000.00,30000.00,31000.00,13671.52,18328.48,0.26,0
69752,6935,-1000.00,29000.00,30000.00,0.00,31000.00,0.03,0
69753,6935,-1000.00,28000.00,29000.00,15000.00,15000.00,0.05,0
69754,6935,-1000.00,27000.00,28000.00,0.00,24955.31,0.25,0
69755,6935,-1000.00,26000.00,27000.00,0.00,22856.60,0.42,0
69756,6935,-1000.00,25000.00,26000.00,8545.43,18454.57,0.34,0
69757,6935,-1000.00,24000.00,25000.00,0.00,13148.89,0.31,0
69758,6935,-1000.00,23000.00,24000.00,0.00,4278.42,0.12,0
69759,6935,-1000.00,22000.00,23000.00,10905.67,13094.33,0.25,0
69760,6935,-1000.00,21000.00,22000.00,0.00,7377.23,0.06,0
69761,6935,-1000.00,20000.00,21000.00,0.00,12830.50,0.31,0
69762,6935,-1000.00,19000.00,20000.00,0.00,11271.32,0.32,0
69763,6935,-1000.00,18000.00,19000.00,0.00,17661.23,0.28,0
69764,6935,-1000.00,17000.00,18000.00,10326.71,0.00,0.07,0
69765,6935,-1000.00,16000.00,17000.00,1452.71,0.00,0.09,0
69766,6935,-1000.00,15000.00,16000.00,8500.00,8500.00,0.07,0
69767,6935,-1000.00,14000.00,15000.00,0.00,16000.00,0.29,0
69768,6935,-1000.00,13000.00,14000.00,0.00,11867.14,0.24,0
69769,6935,-1000.00,12000.00,13000.00,0.00,9128.72,0.12,0
69770,6935,-1000.00,11000.00,12000.00,9432.65,2021.48,0.08,0
69771,6935,-1000.00,10000.00,11000.00,7187.59,4812.41,0.16,0
69772,6935,-1000.00,9000.00,10000.00,0.00,11000.00,0.27,0
69773,6935,-1000.00,8000.00,9000.00,5008.75,4991.25,0.13,0
69774,6935,-1000.00,7000.00,8000.00,731.89,7023.94,0.41,0
69775,6935,-1000.00,6000.00,7000.00,0.00,8000.00,0.27,0
69776,6935,-1000.00,5000.00,6000.00,0.00,2745.51,0.26,0
69777,6935,-1000.00,4000.00,5000.00,1396.75,4289.11,0.37,0
69778,6935,-483.33,3516.67,4516.67,0.00,483.33,0.05,0
69779,6935,-1000.00,2516.67,3516.67,2594.13,1922.53,0.12,0
69780,6935,-1000.00,1516.67,2516.67,0.00,3516.67,0.32,0
69781,6935,-1000.00,516.67,1516.67,540.15,1151.36,0.28,0
69782,6935,-1000.00,-483.33,516.67,0.00,1516.67,0.25,0
69783,6935,-516.67,-1000.00,0.00,148.07,368.60,0.35,0
69784,6936,-1000.00,-1000.00,0.00,0.00,1000.00,0.18,0
69785,6937,1000.00,1000.00,2000.00,0.00,339.55,0.04,1
69786,6937,1000.00,2000.00,3000.00,0.00,1078.98,0.23,1
69787,6937,-744.55,1255.45,2255.45,744.55,0.00,0.09,0
69788,6937,-768.23,487.22,1487.22,768.23,0.00,0.03,0
69789,6937,1000.00,1487.22,2487.22,743.61,743.61,0.04,1
69790,6937,1000.00,2487.22,3487.22,0.00,2487.22,0.10,1
69791,6937,1000.00,3487.22,4487.22,443.44,2560.69,0.39,1
69792,6937,1000.00,4487.22,5487.22,0.00,4487.22,0.23,1
69793,6937,1000.00,5487.22,6487.22,2625.63,2861.59,0.14,1
69794,6937,1000.00,6487.22,7487.22,0.00,6487.22,0.20,1
69795,6937,1000.00,7487.22,8487.22,3147.45,4339.77,0.27,1
69796,6937,1000.00,8487.22,9487.22,0.00,8487.22,0.23,1
69797,6937,1000.00,9487.22,10487.22,0.00,5215.79,0.21,1
69798,6937,1000.00,10487.22,11487.22,528.44,9412.86,0.43,1
69799,6937,1000.00,11487.22,12487.22,0.00,11487.22,0.11,1
69800,6937,1000.00,12487.22,13487.22,0.00,6474.86,0.25,1
69801,6937,1000.00,13487.22,14487.22,0.00,13487.22,0.34,1
69802,6937,1000.00,14487.22,15487.22,0.00,2265.28,0.16,1
69803,6937,1000.00,15487.22,16487.22,0.00,15487.22,0.21,1
69804,6937,1000.00,16487.22,17487.22,346.75,15528.55,0.44,1
69805,6937,1000.00,17487.22,18487.22,3756.43,6189.75,0.23,1
69806,6937,1000.00,18487.22,19487.22,2864.10,10192.34,0.32,1
69807,6937,1000.00,19487.22,20487.22,0.00,19487.22,0.18,1
69808,6937,-1000.00,18487.22,19487.22,11414.45,1887.78,0.09,0
69809,6937,1000.00,19487.22,20487.22,5606.96,13880.26,0.32,1
69810,6937,1000.00,20487.22,21487.22,1478.52,19008.70,0.41,1
69811,6937,-1000.00,19487.22,20487.22,5117.07,2286.50,0.13,0
69812,6937,1000.00,20487.22,21487.22,0.00,10791.60,0.28,1
69813,6937,1000.00,21487.22,22487.22,0.00,19140.19,0.43,1
69814,6937,1000.00,22487.22,23487.22,0.00,5086.30,0.19,1
69815,6937,-391.06,22096.16,23096.16,391.06,0.00,0.09,0
69816,6937,-1000.00,21096.16,22096.16,8258.65,0.00,0.08,0
69817,6937,1000.00,22096.16,23096.16,0.00,18732.97,0.07,1
69818,6937,1000.00,23096.16,24096.16,3621.33,11359.05,0.30,1
69819,6937,1000.00,24096.16,25096.16,4491.04,14431.13,0.34,1
69820,6937,1000.00,25096.16,26096.16,10040.14,15056.02,0.20,1
69821,6937,1000.00,26096.16,27096.16,0.00,26096.16,0.38,1
69822,6937,1000.00,27096.16,28096.16,0.00,27096.16,0.18,1
69823,6937,1000.00,28096.16,29096.16,0.00,28096.16,0.32,1
69824,6937,1000.00,29096.16,30096.16,0.00,29096.16,0.13,1
69825,6937,1000.00,30096.16,31096.16,6220.53,11234.72,0.24,1
69826,6937,1000.00,31096.16,32096.16,0.00,31096.16,0.30,1
69827,6937,1000.00,32096.16,33096.16,0.00,30064.67,0.11,1
69828,6937,1000.00,33096.16,34096.16,0.00,33096.16,0.44,1
69829,6937,1000.00,34096.16,35096.16,16189.52,17906.65,0.05,1
69830,6937,-1000.00,33096.16,34096.16,18290.80,16805.36,0.13,0
69831,6937,1000.00,34096.16,35096.16,0.00,34096.16,0.01,1
69832,6937,-1000.00,33096.16,34096.16,6136.04,28960.12,0.36,0
69833,6937,-1000.00,32096.16,33096.16,8111.63,25984.54,0.38,0
69834,6937,-1000.00,31096.16,32096.16,20685.38,12410.79,0.14,0
69835,6937,-1000.00,30096.16,31096.16,0.00,32096.16,0.35,0
69836,6937,-1000.00,29096.16,30096.16,479.51,30616.66,0.37,0
69837,6937,-1000.00,28096.16,29096.16,0.00,1712.41,0.12,0
69838,6937,-1000.00,27096.16,28096.16,7113.20,21982.96,0.35,0
69839,6937,-1000.00,26096.16,27096.16,0.00,28096.16,0.37,0
69840,6937,-1000.00,25096.16,26096.16,9483.90,15738.51,0.29,0
69841,6937,-1000.00,24096.16,25096.16,0.00,26096.16,0.05,0
69842,6937,-1000.00,23096.16,24096.16,10643.67,6379.18,0.16,0
69843,6937,-1000.00,22096.16,23096.16,0.00,24096.16,0.19,0
69844,6937,-1000.00,21096.16,22096.16,0.00,23096.16,0.31,0
69845,6937,-1000.00,20096.16,21096.16,0.00,22096.16,0.34,0
69846,6937,-1000.00,19096.16,20096.16,0.00,21096.16,0.34,0
69847,6937,-1000.00,18096.16,19096.16,0.00,14504.83,0.37,0
69848,6937,-1000.00,17096.16,18096.16,0.00,15340.59,0.39,0
69849,6937,-1000.00,16096.16,17096.16,7794.49,10301.67,0.19,0
69850,6937,-1000.00,15096.16,16096.16,0.00,12450.25,0.30,0
69851,6937,-1000.00,14096.16,15096.16,7965.98,8130.18,0.00,0
69852,6937,-1000.00,13096.16,14096.16,7256.68,7839.49,0.12,0
69853,6938,-1000.00,-1000.00,0.00,539.69,460.31,0.19,0
69854,6939,1000.00,1000.00,2000.00,455.46,544.54,0.17,1
69855,6939,0.00,1000.00,2000.00,0.00,0.00,0.03,0
69856,6939,1000.00,2000.00,3000.00,338.52,1661.48,0.42,1
69857,6939,1000.00,3000.00,4000.00,522.40,1322.27,0.27,1
69858,6939,1000.00,4000.00,5000.00,733.05,3266.95,0.40,1
69859,6939,1000.00,5000.00,6000.00,0.00,1646.44,0.22,1
69860,6939,1000.00,6000.00,7000.00,0.00,5454.64,0.33,1
69861,6939,-75.27,5924.73,6924.73,75.27,0.00,0.02,0
69862,6939,1000.00,6924.73,7924.73,0.00,6924.73,0.34,1
69863,6939,1000.00,7924.73,8924.73,0.00,2969.27,0.22,1
69864,6939,1000.00,8924.73,9924.73,0.00,6366.81,0.25,1
69865,6939,1000.00,9924.73,10924.73,0.00,9924.73,0.22,1
69866,6939,1000.00,10924.73,11924.73,3228.96,7695.77,0.08,1
69867,6939,1000.00,11924.73,12924.73,0.00,11924.73,0.24,1
69868,6939,-1000.00,10924.73,11924.73,6791.86,6132.87,0.15,0
69869,6939,0.00,10924.73,11924.73,0.00,0.00,0.09,0
69870,6939,-1000.00,9924.73,10924.73,5082.78,3375.23,0.17,0
69871,6939,1000.00,10924.73,11924.73,2380.45,8544.28,0.25,1
69872,6939,-1000.00,9924.73,10924.73,6657.06,5267.66,0.14,0
69873,6939,1000.00,10924.73,11924.73,638.47,9271.22,0.43,1
69874,6939,1000.00,11924.73,12924.73,4488.12,7436.60,0.03,1
69875,6939,1000.00,12924.73,13924.73,0.00,12924.73,0.28,1
69876,6939,-1000.00,11924.73,12924.73,0.00,13924.73,0.08,0
69877,6939,-1000.00,10924.73,11924.73,3421.33,0.00,0.06,0
69878,6939,-1000.00,9924.73,10924.73,1505.88,10184.15,0.42,0
69879,6939,-1000.00,8924.73,9924.73,4353.34,6571.39,0.22,0
69880,6939,-1000.00,7924.73,8924.73,5783.80,4140.92,0.14,0
69881,6939,-1000.00,6924.73,7924.73,0.00,4186.91,0.23,0
69882,6939,-1000.00,5924.73,6924.73,6762.74,629.49,0.05,0
69883,6939,-1000.00,4924.73,5924.73,0.00,6924.73,0.31,0
69884,6939,-1000.00,3924.73,4924.73,0.00,5924.73,0.03,0
69885,6939,-1000.00,2924.73,3924.73,1914.76,3009.97,0.22,0
69886,6939,-1000.00,1924.73,2924.73,0.00,3628.55,0.37,0
69887,6939,-1000.00,924.73,1924.73,0.00,2464.22,0.18,0
69888,6939,-1000.00,-75.27,924.73,0.00,1924.73,0.24,0
69889,6939,-1000.00,-1075.27,-75.27,464.19,460.54,0.01,0
69890,6940,-1000.00,-1000.00,0.00,0.00,1000.00,0.10,0
69891,6941,0.00,0.00,1000.00,0.00,0.00,0.17,0
69892,6941,-1000.00,-1000.00,0.00,0.00,177.23,0.30,0
69893,6942,1000.00,1000.00,2000.00,0.00,1000.00,0.37,1
69894,6942,1000.00,2000.00,3000.00,878.11,1121.89,0.21,1
69895,6942,1000.00,3000.00,4000.00,0.00,3000.00,0.43,1
69896,6942,1000.00,4000.00,5000.00,0.00,2454.43,0.09,1
69897,6942,1000.00,5000.00,6000.00,0.00,5000.00,0.10,1
69898,6942,1000.00,6000.00,7000.00,0.00,4513.63,0.40,1
69899,6942,1000.00,7000.00,8000.00,0.00,7000.00,0.03,1
69900,6942,1000.00,8000.00,9000.00,0.00,8000.00,0.36,1
69901,6942,1000.00,9000.00,10000.00,2921.05,6078.95,0.34,1
69902,6942,1000.00,10000.00,11000.00,0.00,10000.00,0.23,1
69903,6942,1000.00,11000.00,12000.00,0.00,11000.00,0.43,1
69904,6942,1000.00,12000.00,13000.00,4495.23,7504.77,0.26,1
69905,6942,1000.00,13000.00,14000.00,2962.02,10037.98,0.38,1
69906,6942,1000.00,14000.00,15000.00,4794.22,9205.78,0.32,1
69907,6942,-1000.00,13000.00,14000.00,14652.95,0.00,0.01,0
69908,6942,0.00,13000.00,14000.00,0.00,0.00,0.06,0
69909,6942,1000.00,14000.00,15000.00,0.00,14000.00,0.24,1
69910,6942,1000.00,15000.00,16000.00,7500.00,7500.00,0.05,1
69911,6942,1000.00,16000.00,17000.00,3544.72,12455.28,0.39,1
69912,6942,-1000.00,15000.00,16000.00,0.00,8011.92,0.08,0
69913,6942,-1000.00,14000.00,15000.00,0.00,11900.44,0.21,0
69914,6942,0.00,14000.00,15000.00,0.00,0.00,0.05,0
69915,6942,-1000.00,13000.00,14000.00,0.00,15000.00,0.33,0
69916,6942,-1000.00,12000.00,13000.00,0.00,11764.86,0.07,0
69917,6942,-1000.00,11000.00,12000.00,0.00,4831.24,0.19,0
69918,6942,-1000.00,10000.00,11000.00,0.00,12000.00,0.37,0
69919,6942,-1000.00,9000.00,10000.00,0.00,10559.44,0.32,0
69920,6942,-1000.00,8000.00,9000.00,0.00,9649.41,0.35,0
69921,6942,-1000.00,7000.00,8000.00,0.00,8412.62,0.31,0
69922,6942,-1000.00,6000.00,7000.00,0.00,5349.84,0.33,0
69923,6942,-1000.00,5000.00,6000.00,1552.13,5447.87,0.18,0
69924,6942,-1000.00,4000.00,5000.00,2203.56,3796.44,0.31,0
69925,6942,-1000.00,3000.00,4000.00,1783.16,3216.84,0.28,0
69926,6942,0.00,3000.00,4000.00,0.00,0.00,0.01,0
69927,6942,0.00,3000.00,4000.00,0.00,0.00,0.06,0
69928,6942,-1000.00,2000.00,3000.00,0.00,2033.69,0.20,0
69929,6942,-1000.00,1000.00,2000.00,1101.06,1898.94,0.21,0
69930,6942,-1000.00,0.00,1000.00,0.00,1273.10,0.36,0
69931,6942,-1000.00,-1000.00,0.00,500.00,500.00,0.10,0
69932,6943,-536.98,-536.98,463.02,536.98,0.00,0.07,0
69933,6943,0.00,-536.98,463.02,0.00,0.00,0.31,0
69934,6943,-1000.00,-1536.98,-536.98,198.61,264.41,0.18,0
69935,6944,-603.64,-603.64,396.36,0.00,603.64,0.07,0
69936,6944,-396.36,-1000.00,0.00,0.00,396.36,0.29,0
69937,6945,-627.78,-627.78,372.22,0.00,627.78,0.34,0
69938,6945,-1000.00,-1627.78,-627.78,258.56,113.66,0.10,0
69939,6946,1000.00,1000.00,2000.00,451.21,548.79,0.13,1
69940,6946,1000.00,2000.00,3000.00,0.00,2000.00,0.12,1
69941,6946,1000.00,3000.00,4000.00,0.00,1313.88,0.12,1
69942,6946,1000.00,4000.00,5000.00,0.00,1371.69,0.10,1
69943,6946,1000.00,5000.00,6000.00,1169.32,3830.68,0.03,1
69944,6946,1000.00,6000.00,7000.00,0.00,6000.00,0.03,1
69945,6946,1000.00,7000.00,8000.00,0.00,7000.00,0.37,1
69946,6946,1000.00,8000.00,9000.00,3355.32,4644.68,0.11,1
69947,6946,1000.00,9000.00,10000.00,0.00,9000.00,0.39,1
69948,6946,1000.00,10000.00,11000.00,0.00,10000.00,0.29,1
69949,6946,1000.00,11000.00,12000.00,3186.97,4808.77,0.25,1
69950,6946,1000.00,12000.00,13000.00,4574.00,7426.00,0.23,1
69951,6946,1000.00,13000.00,14000.00,0.00,13000.00,0.32,1
69952,6946,1000.00,14000.00,15000.00,0.00,14000.00,0.40,1
69953,6946,1000.00,15000.00,16000.00,0.00,15000.00,0.40,1
69954,6946,1000.00,16000.00,17000.00,2602.44,13397.56,0.41,1
69955,6946,1000.00,17000.00,18000.00,0.00,9111.81,0.04,1
69956,6946,1000.00,18000.00,19000.00,4542.38,13457.62,0.38,1
69957,6946,1000.00,19000.00,20000.00,0.00,19000.00,0.18,1
69958,6946,1000.00,20000.00,21000.00,0.00,7396.35,0.23,1
69959,6946,1000.00,21000.00,22000.00,0.00,21000.00,0.15,1
69960,6946,1000.00,22000.00,23000.00,0.00,4168.75,0.15,1
69961,6946,-1000.00,21000.00,22000.00,1515.44,13463.24,0.35,0
69962,6946,-1000.00,20000.00,21000.00,7850.92,14149.08,0.29,0
69963,6946,-1000.00,19000.00,20000.00,0.00,21000.00,0.34,0
69964,6946,-1000.00,18000.00,19000.00,0.00,20000.00,0.16,0
69965,6946,-1000.00,17000.00,18000.00,7438.34,11561.66,0.15,0
69966,6946,-1000.00,16000.00,17000.00,9917.74,6548.67,0.17,0
69967,6946,-1000.00,15000.00,16000.00,5080.39,11778.89,0.34,0
69968,6946,-1000.00,14000.00,15000.00,0.00,16000.00,0.33,0
69969,6946,-1000.00,13000.00,14000.00,3834.43,11165.57,0.11,0
69970,6946,0.00,13000.00,14000.00,0.00,0.00,0.08,0
69971,6946,-1000.00,12000.00,13000.00,7686.37,6313.63,0.09,0
69972,6946,-1000.00,11000.00,12000.00,2359.10,10640.90,0.41,0
69973,6946,-1000.00,10000.00,11000.00,0.00,12000.00,0.11,0
69974,6946,-1000.00,9000.00,10000.00,0.00,8016.47,0.40,0
69975,6946,-1000.00,8000.00,9000.00,3372.58,6627.42,0.33,0
69976,6946,-1000.00,7000.00,8000.00,0.00,9000.00,0.28,0
69977,6946,-1000.00,6000.00,7000.00,1151.70,5359.96,0.37,0
69978,6946,-1000.00,5000.00,6000.00,0.00,5124.41,0.18,0
69979,6946,-305.71,4694.29,5694.29,0.00,305.71,0.01,0
69980,6946,-1000.00,3694.29,4694.29,0.00,2167.98,0.06,0
69981,6946,-1000.00,2694.29,3694.29,0.00,4694.29,0.17,0
69982,6946,-1000.00,1694.29,2694.29,29.10,3665.19,0.36,0
69983,6946,-1000.00,694.29,1694.29,1584.56,1082.55,0.17,0
69984,6946,1000.00,1694.29,2694.29,843.66,850.63,0.10,1
69985,6946,-1000.00,694.29,1694.29,1502.20,1192.09,0.15,0
69986,6946,1000.00,1694.29,2694.29,109.81,1170.23,0.38,1
69987,6946,1000.00,2694.29,3694.29,0.00,2045.10,0.32,1
69988,6946,1000.00,3694.29,4694.29,1175.21,2519.08,0.34,1
69989,6946,1000.00,4694.29,5694.29,1418.84,3275.45,0.15,1
69990,6946,-1000.00,3694.29,4694.29,4135.00,1559.29,0.07,0
69991,6946,1000.00,4694.29,5694.29,802.76,821.51,0.16,1
69992,6946,1000.00,5694.29,6694.29,0.00,4907.52,0.23,1
69993,6946,1000.00,6694.29,7694.29,0.00,5727.37,0.39,1
69994,6946,-1000.00,5694.29,6694.29,5299.73,2394.56,0.10,0
69995,6946,-1000.00,4694.29,5694.29,4215.52,2478.77,0.04,0
69996,6946,1000.00,5694.29,6694.29,1369.38,4324.91,0.37,1
69997,6946,1000.00,6694.29,7694.29,0.00,6694.29,0.04,1
69998,6946,1000.00,7694.29,8694.29,0.00,3909.02,0.10,1
69999,6946,-1000.00,6694.29,7694.29,4506.93,4187.36,0.20,0
70000,6946,1000.00,7694.29,8694.29,0.00,7694.29,0.03,1
70001,6946,1000.00,8694.29,9694.29,0.00,8549.32,0.44,1
70002,6946,1000.00,9694.29,10694.29,3178.97,6515.32,0.29,1
70003,6946,-1000.00,8694.29,9694.29,6593.42,4100.87,0.08,0
70004,6946,1000.00,9694.29,10694.29,0.00,9694.29,0.02,1
70005,6946,1000.00,10694.29,11694.29,2685.62,8008.67,0.35,1
70006,6946,1000.00,11694.29,12694.29,1987.02,9707.27,0.41,1
70007,6946,1000.00,12694.29,13694.29,0.00,7666.83,0.33,1
70008,6947,-837.51,-837.51,162.49,0.00,837.51,0.36,0
70009,6947,-145.89,-983.39,16.61,0.00,145.89,0.15,0
70010,6947,-3.06,-986.45,13.55,0.00,3.06,0.06,0
70011,6947,-11.04,-997.49,2.51,0.00,11.04,0.42,0
70012,6947,-2.51,-1000.00,0.00,1.08,1.43,0.26,0
70013,6948,-1000.00,-1000.00,0.00,161.32,838.68,0.35,0
70014,6949,-603.80,-603.80,396.20,0.00,603.80,0.35,0
70015,6949,-325.58,-929.38,70.62,28.13,297.45,0.40,0
70016,6949,-70.62,-1000.00,0.00,0.00,70.62,0.32,0
70017,6950,-929.95,-929.95,70.05,0.00,929.95,0.34,0
70018,6950,-70.05,-1000.00,0.00,16.58,53.48,0.39,0
70019,6951,-701.01,-701.01,298.99,0.00,701.01,0.37,0
70020,6951,-298.99,-1000.00,0.00,105.58,193.41,0.27,0
70021,6952,-557.71,-557.71,442.29,557.71,0.00,0.02,0
70022,6952,1000.00,442.29,1442.29,123.57,318.72,0.14,1
70023,6952,1000.00,1442.29,2442.29,0.00,532.82,0.08,1
70024,6952,1000.00,2442.29,3442.29,0.00,1910.93,0.26,1
70025,6952,1000.00,3442.29,4442.29,0.00,3168.34,0.34,1
70026,6952,1000.00,4442.29,5442.29,1576.67,2865.62,0.14,1
70027,6952,1000.00,5442.29,6442.29,2270.04,3172.25,0.27,1
70028,6952,0.00,5442.29,6442.29,0.00,0.00,0.03,0
70029,6952,1000.00,6442.29,7442.29,0.00,6442.29,0.23,1
70030,6952,1000.00,7442.29,8442.29,0.00,7442.29,0.25,1
70031,6952,-1000.00,6442.29,7442.29,6672.19,454.51,0.05,0
70032,6952,-1000.00,5442.29,6442.29,4342.62,3099.67,0.09,0
70033,6952,1000.00,6442.29,7442.29,0.00,6442.29,0.35,1
70034,6952,1000.00,7442.29,8442.29,1487.57,4953.46,0.36,1
70035,6952,-1000.00,6442.29,7442.29,5588.24,2854.05,0.06,0
70036,6952,1000.00,7442.29,8442.29,0.00,7442.29,0.09,1
70037,6952,1000.00,8442.29,9442.29,0.00,8442.29,0.32,1
70038,6952,1000.00,9442.29,10442.29,2281.45,7160.84,0.15,1
70039,6952,1000.00,10442.29,11442.29,0.00,10442.29,0.29,1
70040,6952,1000.00,11442.29,12442.29,0.00,10124.55,0.43,1
70041,6952,1000.00,12442.29,13442.29,6221.15,6221.15,0.01,1
70042,6952,1000.00,13442.29,14442.29,0.00,12548.57,0.37,1
70043,6952,1000.00,14442.29,15442.29,2021.13,12339.95,0.42,1
70044,6952,-1000.00,13442.29,14442.29,4513.00,3817.08,0.18,0
70045,6952,1000.00,14442.29,15442.29,0.00,14442.29,0.27,1
70046,6952,1000.00,15442.29,16442.29,0.00,15442.29,0.13,1
70047,6952,1000.00,16442.29,17442.29,0.00,11402.79,0.10,1
70048,6952,1000.00,17442.29,18442.29,1904.71,11607.06,0.37,1
70049,6952,1000.00,18442.29,19442.29,77.63,14265.67,0.41,1
70050,6952,1000.00,19442.29,20442.29,0.00,19442.29,0.12,1
70051,6952,1000.00,20442.29,21442.29,0.00,20442.29,0.12,1
70052,6952,1000.00,21442.29,22442.29,7142.56,14299.73,0.25,1
70053,6952,1000.00,22442.29,23442.29,5268.64,17173.65,0.39,1
70054,6952,1000.00,23442.29,24442.29,1724.55,21717.74,0.44,1
70055,6952,-1000.00,22442.29,23442.29,12830.29,7014.06,0.15,0
70056,6952,1000.00,23442.29,24442.29,0.00,23442.29,0.26,1
70057,6952,1000.00,24442.29,25442.29,0.00,18939.40,0.39,1
70058,6952,1000.00,25442.29,26442.29,0.00,3276.17,0.04,1
70059,6952,1000.00,26442.29,27442.29,9723.99,16718.30,0.28,1
70060,6952,1000.00,27442.29,28442.29,0.00,27442.29,0.01,1
70061,6952,1000.00,28442.29,29442.29,4604.98,23837.31,0.33,1
70062,6953,-1000.00,-1000.00,0.00,0.00,355.97,0.23,0
70063,6954,-1000.00,-1000.00,0.00,73.97,250.16,0.20,0
70064,6955,-672.14,-672.14,327.86,475.85,196.29,0.13,0
70065,6955,1000.00,327.86,1327.86,0.00,327.86,0.23,1
70066,6955,1000.00,1327.86,2327.86,0.00,882.09,0.37,1
70067,6955,1000.00,2327.86,3327.86,0.00,2327.86,0.08,1
70068,6955,1000.00,3327.86,4327.86,0.00,2759.95,0.10,1
70069,6955,1000.00,4327.86,5327.86,901.92,3425.94,0.15,1
70070,6955,1000.00,5327.86,6327.86,0.00,5327.86,0.34,1
70071,6955,1000.00,6327.86,7327.86,2804.77,3067.84,0.23,1
70072,6955,1000.00,7327.86,8327.86,1300.01,5264.88,0.38,1
70073,6955,1000.00,8327.86,9327.86,2645.96,5681.90,0.34,1
70074,6955,1000.00,9327.86,10327.86,0.00,9327.86,0.05,1
70075,6955,1000.00,10327.86,11327.86,0.00,10327.86,0.37,1
70076,6955,1000.00,11327.86,12327.86,0.00,8956.03,0.42,1
70077,6955,1000.00,12327.86,13327.86,2768.18,9559.68,0.39,1
70078,6955,1000.00,13327.86,14327.86,0.00,13327.86,0.09,1
70079,6955,-1000.00,12327.86,13327.86,0.00,9520.58,0.19,0
70080,6955,0.00,12327.86,13327.86,0.00,0.00,0.03,0
70081,6955,0.00,12327.86,13327.86,0.00,0.00,0.01,0
70082,6955,-1000.00,11327.86,12327.86,3926.49,9401.37,0.34,0
70083,6955,-1000.00,10327.86,11327.86,0.00,5646.95,0.19,0
70084,6955,-1000.00,9327.86,10327.86,5480.42,5847.44,0.13,0
70085,6955,-1000.00,8327.86,9327.86,0.00,5662.58,0.32,0
70086,6955,-1000.00,7327.86,8327.86,209.92,9117.94,0.38,0
70087,6955,-1000.00,6327.86,7327.86,0.00,8327.86,0.27,0
70088,6955,-1000.00,5327.86,6327.86,0.00,7327.86,0.40,0
70089,6955,-1000.00,4327.86,5327.86,2405.75,3922.11,0.08,0
70090,6955,-1000.00,3327.86,4327.86,0.00,5327.86,0.07,0
70091,6955,-1000.00,2327.86,3327.86,0.00,3412.71,0.32,0
70092,6955,-1000.00,1327.86,2327.86,0.00,1970.95,0.06,0
70093,6955,-1000.00,327.86,1327.86,1426.62,389.56,0.10,0
70094,6955,-1000.00,-672.14,327.86,0.00,1304.02,0.44,0
70095,6955,-271.18,-943.32,56.68,70.78,200.40,0.34,0
70096,6955,-13.63,-956.95,43.05,0.00,13.63,0.15,0
70097,6955,-1000.00,-1956.95,-956.95,31.09,11.96,0.10,0
70098,6956,-1000.00,-1000.00,0.00,0.00,1000.00,0.09,0
70099,6957,1000.00,1000.00,2000.00,0.00,649.30,0.10,1
70100,6957,1000.00,2000.00,3000.00,0.00,1530.00,0.33,1
70101,6957,1000.00,3000.00,4000.00,0.00,3000.00,0.17,1
70102,6957,1000.00,4000.00,5000.00,784.51,3215.49,0.38,1
70103,6957,1000.00,5000.00,6000.00,2500.00,2500.00,0.01,1
70104,6957,1000.00,6000.00,7000.00,0.00,6000.00,0.14,1
70105,6957,1000.00,7000.00,8000.00,0.00,1269.71,0.16,1
70106,6957,1000.00,8000.00,9000.00,0.00,8000.00,0.42,1
70107,6957,1000.00,9000.00,10000.00,0.00,6697.18,0.40,1
70108,6957,1000.00,10000.00,11000.00,1362.01,8637.99,0.42,1
70109,6957,1000.00,11000.00,12000.00,72.77,10354.44,0.44,1
70110,6957,1000.00,12000.00,13000.00,1163.14,10836.86,0.20,1
70111,6957,1000.00,13000.00,14000.00,0.00,13000.00,0.42,1
70112,6957,1000.00,14000.00,15000.00,4124.21,9875.79,0.16,1
70113,6957,1000.00,15000.00,16000.00,2642.59,12136.62,0.40,1
70114,6957,1000.00,16000.00,17000.00,0.00,16000.00,0.14,1
70115,6957,1000.00,17000.00,18000.00,0.00,7523.18,0.24,1
70116,6957,-1000.00,16000.00,17000.00,11824.15,5636.76,0.13,0
70117,6957,-1000.00,15000.00,16000.00,9623.77,7376.23,0.17,0
70118,6957,0.00,15000.00,16000.00,0.00,0.00,0.01,0
70119,6957,1000.00,16000.00,17000.00,6059.09,9940.91,0.26,1
70120,6957,1000.00,17000.00,18000.00,5961.04,11038.96,0.19,1
70121,6957,1000.00,18000.00,19000.00,0.00,6280.19,0.24,1
70122,6957,1000.00,19000.00,20000.00,0.00,19000.00,0.10,1
70123,6957,1000.00,20000.00,21000.00,0.00,20000.00,0.15,1
70124,6957,1000.00,21000.00,22000.00,0.00,21000.00,0.22,1
70125,6957,1000.00,22000.00,23000.00,7794.81,14205.19,0.09,1
70126,6957,1000.00,23000.00,24000.00,3510.32,18113.00,0.40,1
70127,6957,1000.00,24000.00,25000.00,0.00,20954.30,0.28,1
70128,6957,1000.00,25000.00,26000.00,0.00,25000.00,0.09,1
70129,6957,-1000.00,24000.00,25000.00,15015.72,10984.28,0.04,0
70130,6957,1000.00,25000.00,26000.00,0.00,25000.00,0.01,1
70131,6957,0.00,25000.00,26000.00,0.00,0.00,0.02,0
70132,6957,1000.00,26000.00,27000.00,0.00,20440.43,0.29,1
70133,6957,-1000.00,25000.00,26000.00,12394.81,7502.50,0.16,0
70134,6957,1000.00,26000.00,27000.00,11031.74,14659.16,0.26,1
70135,6957,1000.00,27000.00,28000.00,0.00,11582.32,0.27,1
70136,6957,1000.00,28000.00,29000.00,0.00,28000.00,0.15,1
70137,6957,1000.00,29000.00,30000.00,2316.18,18061.75,0.36,1
70138,6957,1000.00,30000.00,31000.00,2453.26,24200.17,0.42,1
70139,6957,1000.00,31000.00,32000.00,0.00,19991.07,0.07,1
70140,6957,1000.00,32000.00,33000.00,0.00,26360.30,0.42,1
70141,6957,1000.00,33000.00,34000.00,4761.53,16565.93,0.30,1
70142,6957,1000.00,34000.00,35000.00,0.00,34000.00,0.08,1
70143,6957,-1000.00,33000.00,34000.00,17500.00,17500.00,0.05,0
70144,6957,0.00,33000.00,34000.00,0.00,0.00,0.10,0
70145,6957,-1000.00,32000.00,33000.00,6824.44,27175.56,0.35,0
70146,6957,-1000.00,31000.00,32000.00,0.00,7474.70,0.17,0
70147,6957,-1000.00,30000.00,31000.00,0.00,32000.00,0.13,0
70148,6957,-1000.00,29000.00,30000.00,15139.57,15860.43,0.12,0
70149,6957,-1000.00,28000.00,29000.00,8116.85,21883.15,0.37,0
70150,6957,-1000.00,27000.00,28000.00,5128.81,23871.19,0.40,0
70151,6957,-1000.00,26000.00,27000.00,13970.08,14029.92,0.05,0
70152,6957,-1000.00,25000.00,26000.00,0.00,27000.00,0.09,0
70153,6957,-1000.00,24000.00,25000.00,8593.90,17406.10,0.32,0
70154,6957,0.00,24000.00,25000.00,0.00,0.00,0.05,0
70155,6957,-1000.00,23000.00,24000.00,5193.40,3068.87,0.14,0
70156,6957,-1000.00,22000.00,23000.00,0.00,19344.93,0.42,0
70157,6957,-1000.00,21000.00,22000.00,0.00,23000.00,0.02,0
70158,6957,-1000.00,20000.00,21000.00,0.00,8496.36,0.14,0
70159,6957,-1000.00,19000.00,20000.00,0.00,21000.00,0.20,0
70160,6957,-1000.00,18000.00,19000.00,4652.15,13505.34,0.35,0
70161,6957,0.00,18000.00,19000.00,0.00,0.00,0.08,0
70162,6957,-1000.00,17000.00,18000.00,800.03,18199.97,0.02,0
70163,6957,-1000.00,16000.00,17000.00,4525.91,5941.67,0.22,0
70164,6957,-1000.00,15000.00,16000.00,5285.04,11714.96,0.34,0
70165,6957,-1000.00,14000.00,15000.00,2638.59,13361.41,0.41,0
70166,6957,-1000.00,13000.00,14000.00,0.00,15000.00,0.02,0
70167,6958,-797.27,-797.27,202.73,200.33,596.94,0.33,0
70168,6958,-1000.00,-1797.27,-797.27,49.25,26.57,0.14,0
70169,6959,1000.00,1000.00,2000.00,0.00,1000.00,0.44,1
70170,6959,1000.00,2000.00,3000.00,762.42,1237.58,0.22,1
70171,6959,1000.00,3000.00,4000.00,0.00,1540.57,0.07,1
70172,6959,1000.00,4000.00,5000.00,1488.12,2511.88,0.15,1
70173,6959,1000.00,5000.00,6000.00,0.00,3781.09,0.23,1
70174,6959,-1000.00,4000.00,5000.00,3996.04,0.00,0.03,0
70175,6959,-1000.00,3000.00,4000.00,2849.80,2150.20,0.12,0
70176,6959,1000.00,4000.00,5000.00,0.00,2937.46,0.32,1
70177,6959,1000.00,5000.00,6000.00,0.00,5000.00,0.42,1
70178,6959,1000.00,6000.00,7000.00,0.00,5668.36,0.21,1
70179,6959,1000.00,7000.00,8000.00,0.00,7000.00,0.32,1
70180,6959,1000.00,8000.00,9000.00,0.00,3865.51,0.30,1
70181,6959,1000.00,9000.00,10000.00,1277.30,7722.70,0.26,1
70182,6959,1000.00,10000.00,11000.00,0.00,9378.53,0.13,1
70183,6959,1000.00,11000.00,12000.00,3703.34,7296.66,0.33,1
70184,6959,1000.00,12000.00,13000.00,836.73,11163.27,0.40,1
70185,6959,1000.00,13000.00,14000.00,35.89,12964.11,0.21,1
70186,6959,1000.00,14000.00,15000.00,0.00,14000.00,0.02,1
70187,6959,-1000.00,13000.00,14000.00,14788.98,211.02,0.03,0
70188,6959,-1000.00,12000.00,13000.00,2192.70,11807.30,0.42,0
70189,6959,-1000.00,11000.00,12000.00,3167.85,9832.15,0.38,0
70190,6959,-1000.00,10000.00,11000.00,0.00,10449.91,0.37,0
70191,6959,-1000.00,9000.00,10000.00,2732.41,8267.59,0.34,0
70192,6959,-1000.00,8000.00,9000.00,4015.07,364.04,0.10,0
70193,6959,-1000.00,7000.00,8000.00,0.00,9000.00,0.30,0
70194,6959,-1000.00,6000.00,7000.00,0.00,8000.00,0.18,0
70195,6959,-1000.00,5000.00,6000.00,1807.80,0.00,0.05,0
70196,6959,-1000.00,4000.00,5000.00,0.00,6000.00,0.08,0
70197,6959,-1000.00,3000.00,4000.00,0.00,4492.92,0.42,0
70198,6959,-1000.00,2000.00,3000.00,0.00,1490.87,0.14,0
70199,6959,-1000.00,1000.00,2000.00,0.00,2388.03,0.03,0
70200,6959,-1000.00,0.00,1000.00,0.00,1967.63,0.09,0
70201,6959,-1000.00,-1000.00,0.00,0.00,1000.00,0.21,0
70202,6960,-1000.00,-1000.00,0.00,0.00,693.94,0.38,0
70203,6961,-911.33,-911.33,88.67,33.16,878.17,0.43,0
70204,6961,-87.35,-998.67,1.33,25.64,61.71,0.35,0
70205,6961,-1.20,-999.87,0.13,0.00,1.20,0.38,0
70206,6961,0.00,-999.87,0.13,0.00,0.00,0.04,0
70207,6961,-0.13,-1000.00,0.00,0.05,0.08,0.24,0
70208,6962,-676.05,-676.05,323.95,676.05,0.00,0.20,0
70209,6962,0.00,-676.05,323.95,0.00,0.00,0.10,0
70210,6962,-1000.00,-1676.05,-676.05,41.72,282.23,0.41,0
70211,6963,-1000.00,-1000.00,0.00,0.00,1000.00,0.09,0
70212,6964,-1000.00,-1000.00,0.00,0.00,1000.00,0.42,0
70213,6965,-1000.00,-1000.00,0.00,0.00,154.93,0.16,0
70214,6966,-1000.00,-1000.00,0.00,0.00,1000.00,0.43,0
70215,6967,-1000.00,-1000.00,0.00,233.98,766.02,0.38,0
70216,6968,1000.00,1000.00,2000.00,489.35,510.65,0.19,1
70217,6968,-1000.00,0.00,1000.00,1206.84,793.16,0.16,0
70218,6968,1000.00,1000.00,2000.00,39.26,960.74,0.42,1
70219,6968,1000.00,2000.00,3000.00,0.00,2000.00,0.31,1
70220,6968,1000.00,3000.00,4000.00,736.22,2263.78,0.17,1
70221,6968,1000.00,4000.00,5000.00,0.00,2503.86,0.33,1
70222,6968,-1000.00,3000.00,4000.00,2777.64,2222.36,0.14,0
70223,6968,-1000.00,2000.00,3000.00,2199.30,1800.70,0.14,0
70224,6968,1000.00,3000.00,4000.00,0.00,3000.00,0.41,1
70225,6968,1000.00,4000.00,5000.00,982.84,3017.16,0.39,1
70226,6968,1000.00,5000.00,6000.00,0.00,5000.00,0.36,1
70227,6968,1000.00,6000.00,7000.00,2084.41,3915.59,0.06,1
70228,6968,-1000.00,5000.00,6000.00,4879.76,2120.24,0.04,0
70229,6968,1000.00,6000.00,7000.00,0.00,6000.00,0.23,1
70230,6968,1000.00,7000.00,8000.00,0.00,5256.41,0.10,1
70231,6968,1000.00,8000.00,9000.00,1287.90,6712.10,0.40,1
70232,6968,1000.00,9000.00,10000.00,533.69,2143.39,0.20,1
70233,6968,1000.00,10000.00,11000.00,0.00,10000.00,0.32,1
70234,6968,1000.00,11000.00,12000.00,0.00,11000.00,0.31,1
70235,6968,1000.00,12000.00,13000.00,0.00,12000.00,0.01,1
70236,6968,-1000.00,11000.00,12000.00,2815.04,1908.64,0.15,0
70237,6968,1000.00,12000.00,13000.00,0.00,7984.33,0.14,1
70238,6968,-1000.00,11000.00,12000.00,1328.18,11671.82,0.43,0
70239,6968,-1000.00,10000.00,11000.00,0.00,3874.85,0.17,0
70240,6968,-1000.00,9000.00,10000.00,0.00,11000.00,0.03,0
70241,6968,-1000.00,8000.00,9000.00,0.00,10000.00,0.28,0
70242,6968,-1000.00,7000.00,8000.00,0.00,2249.90,0.07,0
70243,6968,-1000.00,6000.00,7000.00,0.00,7252.73,0.36,0
70244,6968,-1000.00,5000.00,6000.00,0.00,7000.00,0.41,0
70245,6968,-1000.00,4000.00,5000.00,3750.80,1652.13,0.12,0
70246,6968,-1000.00,3000.00,4000.00,1158.25,2036.50,0.25,0
70247,6968,-1000.00,2000.00,3000.00,1672.40,2327.60,0.20,0
70248,6968,-1000.00,1000.00,2000.00,0.00,3000.00,0.30,0
70249,6968,-1000.00,0.00,1000.00,11.15,1988.85,0.44,0
70250,6968,-1000.00,-1000.00,0.00,371.21,628.79,0.31,0
70251,6969,1000.00,1000.00,2000.00,0.00,499.67,0.30,1
70252,6969,1000.00,2000.00,3000.00,617.65,1382.35,0.17,1
70253,6969,1000.00,3000.00,4000.00,0.00,2603.94,0.35,1
70254,6969,1000.00,4000.00,5000.00,0.00,3988.24,0.13,1
70255,6969,-1000.00,3000.00,4000.00,3937.82,1062.18,0.05,0
70256,6969,1000.00,4000.00,5000.00,1723.80,2276.20,0.20,1
70257,6969,1000.00,5000.00,6000.00,0.00,5000.00,0.14,1
70258,6969,1000.00,6000.00,7000.00,0.00,6000.00,0.07,1
70259,6969,1000.00,7000.00,8000.00,2344.58,4655.42,0.24,1
70260,6969,-1000.00,6000.00,7000.00,4830.26,3169.74,0.08,0
70261,6969,1000.00,7000.00,8000.00,0.00,6212.30,0.30,1
70262,6969,1000.00,8000.00,9000.00,0.00,8000.00,0.09,1
70263,6969,1000.00,9000.00,10000.00,0.00,9000.00,0.16,1
70264,6969,1000.00,10000.00,11000.00,0.00,10000.00,0.42,1
70265,6969,1000.00,11000.00,12000.00,0.00,2726.53,0.19,1
70266,6969,1000.00,12000.00,13000.00,4415.08,7584.92,0.17,1
70267,6969,1000.00,13000.00,14000.00,6333.79,6666.21,0.21,1
70268,6969,0.00,13000.00,14000.00,0.00,0.00,0.05,0
70269,6969,1000.00,14000.00,15000.00,5752.83,8247.17,0.17,1
70270,6969,1000.00,15000.00,16000.00,0.00,5491.69,0.14,1
70271,6969,1000.00,16000.00,17000.00,0.00,16000.00,0.14,1
70272,6969,1000.00,17000.00,18000.00,0.00,17000.00,0.33,1
70273,6969,-1000.00,16000.00,17000.00,16537.03,1462.97,0.04,0
70274,6969,1000.00,17000.00,18000.00,3096.34,13903.66,0.18,1
70275,6969,-1000.00,16000.00,17000.00,0.00,15216.17,0.41,0
70276,6969,-1000.00,15000.00,16000.00,2478.95,14521.05,0.35,0
70277,6969,-1000.00,14000.00,15000.00,0.00,14358.87,0.37,0
70278,6969,-398.47,13601.53,14601.53,0.00,398.47,0.06,0
70279,6969,-1000.00,12601.53,13601.53,8093.49,6508.05,0.09,0
70280,6969,-1000.00,11601.53,12601.53,1982.99,11618.54,0.36,0
70281,6969,-1000.00,10601.53,11601.53,1882.41,10719.12,0.29,0
70282,6969,-975.86,9625.67,10625.67,0.00,975.86,0.14,0
70283,6969,-1000.00,8625.67,9625.67,0.00,6216.25,0.17,0
70284,6969,-1000.00,7625.67,8625.67,29.28,9596.39,0.24,0
70285,6969,-1000.00,6625.67,7625.67,0.00,1559.79,0.14,0
70286,6969,-1000.00,5625.67,6625.67,2244.75,5380.92,0.03,0
70287,6969,-1000.00,4625.67,5625.67,1433.86,4734.85,0.37,0
70288,6969,-1000.00,3625.67,4625.67,1795.51,3830.16,0.33,0
70289,6969,-1000.00,2625.67,3625.67,957.09,3148.47,0.36,0
70290,6969,-690.93,1934.74,2934.74,0.00,690.93,0.16,0
70291,6969,-1000.00,934.74,1934.74,753.24,2181.50,0.29,0
70292,6970,-1000.00,-1000.00,0.00,0.00,1000.00,0.01,0
70293,6971,-1000.00,-1000.00,0.00,339.74,660.26,0.00,0
70294,6972,-1000.00,-1000.00,0.00,619.80,380.20,0.10,0
70295,6973,1000.00,1000.00,2000.00,388.73,611.27,0.29,1
70296,6973,1000.00,2000.00,3000.00,858.51,1141.49,0.17,1
70297,6973,1000.00,3000.00,4000.00,0.00,3000.00,0.10,1
70298,6973,-224.06,2775.94,3775.94,224.06,0.00,0.08,0
70299,6973,1000.00,3775.94,4775.94,0.00,3775.94,0.40,1
70300,6973,1000.00,4775.94,5775.94,0.00,4775.94,0.27,1
70301,6973,1000.00,5775.94,6775.94,0.00,5775.94,0.41,1
70302,6973,1000.00,6775.94,7775.94,1110.17,5665.77,0.09,1
70303,6973,1000.00,7775.94,8775.94,3125.89,4650.06,0.25,1
70304,6973,-1000.00,6775.94,7775.94,6322.64,2453.30,0.05,0
70305,6973,-1000.00,5775.94,6775.94,2007.27,1782.47,0.18,0
70306,6973,1000.00,6775.94,7775.94,144.68,5056.38,0.40,1
70307,6973,1000.00,7775.94,8775.94,0.00,6940.34,0.29,1
70308,6973,1000.00,8775.94,9775.94,0.00,7035.92,0.40,1
70309,6973,1000.00,9775.94,10775.94,0.00,7049.29,0.20,1
70310,6973,1000.00,10775.94,11775.94,1912.84,8863.10,0.25,1
70311,6973,1000.00,11775.94,12775.94,0.00,11775.94,0.29,1
70312,6973,1000.00,12775.94,13775.94,4233.15,8542.80,0.26,1
70313,6973,1000.00,13775.94,14775.94,3289.48,10486.46,0.18,1
70314,6973,1000.00,14775.94,15775.94,0.00,14775.94,0.34,1
70315,6973,1000.00,15775.94,16775.94,0.00,14590.04,0.16,1
70316,6973,1000.00,16775.94,17775.94,0.00,364.55,0.02,1
70317,6973,1000.00,17775.94,18775.94,0.00,14016.51,0.28,1
70318,6973,-1000.00,16775.94,17775.94,31.52,4991.29,0.21,0
70319,6973,-1000.00,15775.94,16775.94,2793.71,14982.23,0.31,0
70320,6973,-1000.00,14775.94,15775.94,0.00,16775.94,0.34,0
70321,6973,-1000.00,13775.94,14775.94,0.00,2235.06,0.16,0
70322,6973,-1000.00,12775.94,13775.94,0.00,9018.83,0.25,0
70323,6973,-1000.00,11775.94,12775.94,2267.82,11508.13,0.42,0
70324,6973,-1000.00,10775.94,11775.94,7242.64,5533.30,0.14,0
70325,6973,-1000.00,9775.94,10775.94,4167.39,7608.55,0.25,0
70326,6973,-1000.00,8775.94,9775.94,4633.95,6141.99,0.20,0
70327,6973,-1000.00,7775.94,8775.94,1516.00,8259.94,0.41,0
70328,6973,-1000.00,6775.94,7775.94,0.00,7576.40,0.34,0
70329,6973,-1000.00,5775.94,6775.94,0.00,7775.94,0.30,0
70330,6973,-861.08,4914.86,5914.86,0.00,861.08,0.05,0
70331,6973,-1000.00,3914.86,4914.86,0.00,5914.86,0.28,0
70332,6973,-1000.00,2914.86,3914.86,312.92,2272.26,0.29,0
70333,6973,-1000.00,1914.86,2914.86,0.00,2393.10,0.36,0
70334,6973,-1000.00,914.86,1914.86,983.27,1124.95,0.22,0
70335,6973,-1000.00,-85.14,914.86,731.90,1182.96,0.29,0
70336,6973,-914.86,-1000.00,0.00,391.06,523.81,0.16,0
70337,6974,-345.72,-345.72,654.28,0.00,345.72,0.29,0
70338,6974,-654.28,-1000.00,0.00,125.16,529.12,0.17,0
70339,6975,1000.00,1000.00,2000.00,52.96,947.04,0.41,1
70340,6975,1000.00,2000.00,3000.00,0.00,2000.00,0.34,1
70341,6975,1000.00,3000.00,4000.00,0.00,2866.24,0.06,1
70342,6975,1000.00,4000.00,5000.00,0.00,3464.48,0.40,1
70343,6975,1000.00,5000.00,6000.00,0.00,2601.13,0.32,1
70344,6975,1000.00,6000.00,7000.00,0.00,6000.00,0.37,1
70345,6975,-1000.00,5000.00,6000.00,3727.89,3272.11,0.17,0
70346,6975,-1000.00,4000.00,5000.00,2538.28,3461.72,0.20,0
70347,6975,-1000.00,3000.00,4000.00,0.00,3795.08,0.38,0
70348,6975,-1000.00,2000.00,3000.00,26.79,527.23,0.16,0
70349,6975,-1000.00,1000.00,2000.00,0.00,2802.83,0.28,0
70350,6975,-1000.00,0.00,1000.00,253.48,1746.52,0.43,0
70351,6975,-1000.00,-1000.00,0.00,385.04,614.96,0.30,0
70352,6976,-1000.00,-1000.00,0.00,533.97,466.03,0.09,0
70353,6977,-413.98,-413.98,586.02,0.00,413.98,0.36,0
70354,6977,-427.96,-841.94,158.06,183.65,244.31,0.34,0
70355,6977,-120.39,-962.33,37.67,44.66,75.73,0.27,0
70356,6977,-37.67,-1000.00,0.00,0.00,37.67,0.05,0
70357,6978,-755.56,-755.56,244.44,0.00,755.56,0.25,0
70358,6978,-219.15,-974.71,25.29,0.00,219.15,0.23,0
70359,6978,-1000.00,-1974.71,-974.71,16.78,8.51,0.09,0
70360,6979,-1000.00,-1000.00,0.00,466.72,533.28,0.24,0
70361,6980,-1000.00,-1000.00,0.00,0.00,1000.00,0.43,0
70362,6981,-1000.00,-1000.00,0.00,394.28,257.31,0.17,0
70363,6982,1000.00,1000.00,2000.00,0.00,1000.00,0.07,1
70364,6982,1000.00,2000.00,3000.00,50.15,1148.32,0.34,1
70365,6982,1000.00,3000.00,4000.00,908.02,2091.98,0.35,1
70366,6982,1000.00,4000.00,5000.00,591.16,3408.84,0.31,1
70367,6982,1000.00,5000.00,6000.00,206.72,4793.28,0.31,1
70368,6982,1000.00,6000.00,7000.00,687.32,4625.07,0.40,1
70369,6982,1000.00,7000.00,8000.00,366.59,4707.51,0.38,1
70370,6982,0.00,7000.00,8000.00,0.00,0.00,0.07,0
70371,6982,1000.00,8000.00,9000.00,3659.18,4340.82,0.14,1
70372,6982,1000.00,9000.00,10000.00,0.00,9000.00,0.11,1
70373,6982,1000.00,10000.00,11000.00,0.00,10000.00,0.03,1
70374,6982,0.00,10000.00,11000.00,0.00,0.00,0.03,0
70375,6982,1000.00,11000.00,12000.00,0.00,6243.04,0.30,1
70376,6982,1000.00,12000.00,13000.00,0.00,12000.00,0.19,1
70377,6982,-1000.00,11000.00,12000.00,8012.74,4987.26,0.03,0
70378,6982,1000.00,12000.00,13000.00,6000.00,6000.00,0.05,1
70379,6982,1000.00,13000.00,14000.00,2127.52,10872.48,0.41,1
70380,6982,1000.00,14000.00,15000.00,6248.90,7751.10,0.06,1
70381,6982,1000.00,15000.00,16000.00,4956.03,10043.97,0.15,1
70382,6982,1000.00,16000.00,17000.00,2688.71,13311.29,0.42,1
70383,6982,1000.00,17000.00,18000.00,4659.85,12340.15,0.37,1
70384,6982,1000.00,18000.00,19000.00,0.00,18000.00,0.33,1
70385,6982,1000.00,19000.00,20000.00,581.64,14127.04,0.40,1
70386,6982,0.00,19000.00,20000.00,0.00,0.00,0.01,0
70387,6982,-1000.00,18000.00,19000.00,449.10,19550.90,0.34,0
70388,6982,-1000.00,17000.00,18000.00,9500.00,9500.00,0.08,0
70389,6982,-1000.00,16000.00,17000.00,5937.05,12062.95,0.28,0
70390,6982,-1000.00,15000.00,16000.00,4626.59,12373.41,0.35,0
70391,6982,-1000.00,14000.00,15000.00,0.00,16000.00,0.22,0
70392,6982,-1000.00,13000.00,14000.00,0.00,15000.00,0.03,0
70393,6982,-1000.00,12000.00,13000.00,7000.00,7000.00,0.00,0
70394,6982,-1000.00,11000.00,12000.00,11032.60,1967.40,0.02,0
70395,6982,-1000.00,10000.00,11000.00,480.37,6443.31,0.33,0
70396,6982,-1000.00,9000.00,10000.00,9475.19,1524.81,0.02,0
70397,6982,-1000.00,8000.00,9000.00,5102.05,4644.32,0.21,0
70398,6982,-1000.00,7000.00,8000.00,808.31,1174.62,0.15,0
70399,6982,-1000.00,6000.00,7000.00,2676.43,5323.57,0.08,0
70400,6982,-1000.00,5000.00,6000.00,2154.40,4845.60,0.02,0
70401,6982,-1000.00,4000.00,5000.00,2183.75,3816.25,0.31,0
70402,6982,-1000.00,3000.00,4000.00,0.00,4885.82,0.38,0
70403,6982,-1000.00,2000.00,3000.00,0.00,1718.98,0.28,0
70404,6982,-1000.00,1000.00,2000.00,2093.37,906.63,0.07,0
70405,6982,-1000.00,0.00,1000.00,0.00,1453.41,0.26,0
70406,6982,-1000.00,-1000.00,0.00,333.28,666.72,0.26,0
70407,6983,-1000.00,-1000.00,0.00,187.43,812.57,0.41,0
70408,6984,1000.00,1000.00,2000.00,251.37,748.63,0.38,1
70409,6984,1000.00,2000.00,3000.00,214.20,1785.80,0.43,1
70410,6984,1000.00,3000.00,4000.00,0.00,1290.09,0.15,1
70411,6984,1000.00,4000.00,5000.00,0.00,469.60,0.13,1
70412,6984,1000.00,5000.00,6000.00,0.00,4452.51,0.02,1
70413,6984,1000.00,6000.00,7000.00,0.00,4881.43,0.06,1
70414,6984,1000.00,7000.00,8000.00,0.00,4811.01,0.30,1
70415,6984,1000.00,8000.00,9000.00,24.12,5847.70,0.40,1
70416,6984,1000.00,9000.00,10000.00,0.00,9000.00,0.31,1
70417,6984,1000.00,10000.00,11000.00,0.00,7802.28,0.30,1
70418,6984,1000.00,11000.00,12000.00,1006.10,9993.90,0.17,1
70419,6984,-1000.00,10000.00,11000.00,7994.85,4005.15,0.01,0
70420,6984,1000.00,11000.00,12000.00,0.00,11000.00,0.41,1
70421,6984,1000.00,12000.00,13000.00,5813.17,6186.83,0.05,1
70422,6984,1000.00,13000.00,14000.00,1254.53,11745.47,0.43,1
70423,6984,1000.00,14000.00,15000.00,0.00,14000.00,0.21,1
70424,6984,-1000.00,13000.00,14000.00,7740.39,7259.61,0.21,0
70425,6984,1000.00,14000.00,15000.00,6909.88,7090.12,0.20,1
70426,6984,-1000.00,13000.00,14000.00,8890.78,6109.22,0.12,0
70427,6984,1000.00,14000.00,15000.00,0.00,3001.54,0.19,1
70428,6984,1000.00,15000.00,16000.00,0.00,15000.00,0.44,1
70429,6984,1000.00,16000.00,17000.00,0.00,16000.00,0.37,1
70430,6984,1000.00,17000.00,18000.00,0.00,4859.03,0.18,1
70431,6984,1000.00,18000.00,19000.00,0.00,18000.00,0.13,1
70432,6984,1000.00,19000.00,20000.00,0.00,19000.00,0.24,1
70433,6984,1000.00,20000.00,21000.00,2128.23,14011.48,0.38,1
70434,6984,1000.00,21000.00,22000.00,8546.93,12453.07,0.21,1
70435,6984,1000.00,22000.00,23000.00,11000.00,11000.00,0.03,1
70436,6984,1000.00,23000.00,24000.00,0.00,8770.87,0.11,1
70437,6984,1000.00,24000.00,25000.00,0.00,24000.00,0.42,1
70438,6984,1000.00,25000.00,26000.00,0.00,25000.00,0.35,1
70439,6984,1000.00,26000.00,27000.00,8820.80,17179.20,0.21,1
70440,6984,1000.00,27000.00,28000.00,5591.20,21408.80,0.40,1
70441,6984,1000.00,28000.00,29000.00,9178.20,18821.80,0.17,1
70442,6984,1000.00,29000.00,30000.00,1967.80,27032.20,0.44,1
70443,6984,1000.00,30000.00,31000.00,0.00,30000.00,0.42,1
70444,6984,1000.00,31000.00,32000.00,14314.48,16685.52,0.20,1
70445,6984,1000.00,32000.00,33000.00,8791.53,23208.47,0.36,1
70446,6984,1000.00,33000.00,34000.00,16321.20,16678.80,0.18,1
70447,6984,-1000.00,32000.00,33000.00,19947.52,14052.48,0.16,0
70448,6984,1000.00,33000.00,34000.00,6827.17,11525.29,0.23,1
70449,6984,1000.00,34000.00,35000.00,0.00,34000.00,0.01,1
70450,6984,0.00,34000.00,35000.00,0.00,0.00,0.07,0
70451,6984,1000.00,35000.00,36000.00,0.00,35000.00,0.05,1
70452,6985,-1000.00,-1000.00,0.00,381.87,618.13,0.19,0
70453,6986,1000.00,1000.00,2000.00,0.00,1000.00,0.20,1
70454,6986,1000.00,2000.00,3000.00,0.00,605.27,0.26,1
70455,6986,-1000.00,1000.00,2000.00,1973.62,1026.38,0.06,0
70456,6986,-1000.00,0.00,1000.00,1074.56,925.44,0.18,0
70457,6986,1000.00,1000.00,2000.00,0.00,1000.00,0.31,1
70458,6986,1000.00,2000.00,3000.00,0.00,2000.00,0.07,1
70459,6986,1000.00,3000.00,4000.00,1176.71,1823.29,0.20,1
70460,6986,1000.00,4000.00,5000.00,902.51,2762.83,0.36,1
70461,6986,1000.00,5000.00,6000.00,665.79,4334.21,0.35,1
70462,6986,1000.00,6000.00,7000.00,2362.57,3019.52,0.25,1
70463,6986,1000.00,7000.00,8000.00,3327.45,3672.55,0.06,1
70464,6986,1000.00,8000.00,9000.00,1567.25,6432.75,0.18,1
70465,6986,0.00,8000.00,9000.00,0.00,0.00,0.00,0
70466,6986,1000.00,9000.00,10000.00,0.00,9000.00,0.41,1
70467,6986,1000.00,10000.00,11000.00,1937.01,7314.59,0.38,1
70468,6986,1000.00,11000.00,12000.00,752.31,10247.69,0.38,1
70469,6986,1000.00,12000.00,13000.00,1699.11,10300.89,0.33,1
70470,6986,1000.00,13000.00,14000.00,5344.08,7655.92,0.28,1
70471,6986,-1000.00,12000.00,13000.00,9733.85,4266.15,0.04,0
70472,6986,1000.00,13000.00,14000.00,5333.32,7666.68,0.19,1
70473,6986,1000.00,14000.00,15000.00,0.00,14000.00,0.07,1
70474,6986,-1000.00,13000.00,14000.00,6960.07,2460.96,0.12,0
70475,6986,1000.00,14000.00,15000.00,6753.44,7246.56,0.21,1
70476,6986,1000.00,15000.00,16000.00,507.96,14492.04,0.29,1
70477,6986,1000.00,16000.00,17000.00,2828.00,13172.00,0.05,1
70478,6986,1000.00,17000.00,18000.00,3889.71,13110.29,0.36,1
70479,6986,1000.00,18000.00,19000.00,0.00,18000.00,0.34,1
70480,6986,1000.00,19000.00,20000.00,0.00,19000.00,0.01,1
70481,6986,1000.00,20000.00,21000.00,5855.78,14144.22,0.03,1
70482,6986,1000.00,21000.00,22000.00,0.00,21000.00,0.27,1
70483,6986,1000.00,22000.00,23000.00,10438.60,11561.40,0.12,1
70484,6986,1000.00,23000.00,24000.00,0.00,4757.60,0.18,1
70485,6986,1000.00,24000.00,25000.00,0.00,24000.00,0.42,1
70486,6986,1000.00,25000.00,26000.00,0.00,25000.00,0.03,1
70487,6986,-1000.00,24000.00,25000.00,22069.94,3930.06,0.00,0
70488,6986,-1000.00,23000.00,24000.00,18047.83,0.00,0.00,0
70489,6986,1000.00,24000.00,25000.00,0.00,18559.96,0.37,1
70490,6986,1000.00,25000.00,26000.00,5910.80,19089.20,0.28,1
70491,6986,1000.00,26000.00,27000.00,0.00,26000.00,0.22,1
70492,6986,1000.00,27000.00,28000.00,0.00,1818.92,0.11,1
70493,6986,1000.00,28000.00,29000.00,0.00,28000.00,0.14,1
70494,6986,1000.00,29000.00,30000.00,0.00,19866.44,0.35,1
70495,6986,1000.00,30000.00,31000.00,0.00,23472.66,0.03,1
70496,6987,1000.00,1000.00,2000.00,0.00,292.98,0.22,1
70497,6987,-1000.00,0.00,1000.00,1183.84,816.16,0.08,0
70498,6987,1000.00,1000.00,2000.00,379.66,620.34,0.21,1
70499,6987,1000.00,2000.00,3000.00,0.00,2000.00,0.30,1
70500,6987,1000.00,3000.00,4000.00,0.00,258.32,0.13,1
70501,6987,1000.00,4000.00,5000.00,1442.03,2557.97,0.31,1
70502,6987,1000.00,5000.00,6000.00,1273.34,3726.66,0.38,1
70503,6987,1000.00,6000.00,7000.00,0.00,2327.01,0.21,1
70504,6987,1000.00,7000.00,8000.00,0.00,7000.00,0.09,1
70505,6987,1000.00,8000.00,9000.00,0.00,7292.27,0.39,1
70506,6987,1000.00,9000.00,10000.00,0.00,9000.00,0.41,1
70507,6987,1000.00,10000.00,11000.00,2460.32,7539.68,0.36,1
70508,6987,1000.00,11000.00,12000.00,0.00,11000.00,0.07,1
70509,6987,1000.00,12000.00,13000.00,5620.82,6379.18,0.24,1
70510,6987,1000.00,13000.00,14000.00,0.00,13000.00,0.05,1
70511,6987,1000.00,14000.00,15000.00,4618.08,9381.92,0.33,1
70512,6987,1000.00,15000.00,16000.00,393.39,14606.61,0.31,1
70513,6987,1000.00,16000.00,17000.00,4591.06,11408.94,0.36,1
70514,6987,1000.00,17000.00,18000.00,0.00,9527.22,0.23,1
70515,6987,1000.00,18000.00,19000.00,0.00,636.40,0.01,1
70516,6987,1000.00,19000.00,20000.00,0.00,19000.00,0.05,1
70517,6987,1000.00,20000.00,21000.00,0.00,20000.00,0.05,1
70518,6987,1000.00,21000.00,22000.00,5308.23,15691.77,0.26,1
70519,6987,1000.00,22000.00,23000.00,0.00,22000.00,0.32,1
70520,6987,-1000.00,21000.00,22000.00,2957.11,0.00,0.11,0
70521,6987,1000.00,22000.00,23000.00,0.00,22000.00,0.15,1
70522,6987,1000.00,23000.00,24000.00,5412.63,15391.09,0.35,1
70523,6987,1000.00,24000.00,25000.00,5080.59,18919.41,0.23,1
70524,6987,1000.00,25000.00,26000.00,11945.22,13054.78,0.05,1
70525,6987,1000.00,26000.00,27000.00,2632.43,23367.57,0.33,1
70526,6987,1000.00,27000.00,28000.00,0.00,27000.00,0.11,1
70527,6987,-1000.00,26000.00,27000.00,10909.88,17090.12,0.21,0
70528,6987,-1000.00,25000.00,26000.00,6973.65,20026.35,0.25,0
70529,6987,-1000.00,24000.00,25000.00,13000.00,13000.00,0.05,0
70530,6987,-1000.00,23000.00,24000.00,12196.82,12803.18,0.11,0
70531,6987,-1000.00,22000.00,23000.00,5761.06,18238.94,0.38,0
70532,6987,-1000.00,21000.00,22000.00,0.00,16194.17,0.39,0
70533,6987,-1000.00,20000.00,21000.00,0.00,2724.42,0.01,0
70534,6987,-1000.00,19000.00,20000.00,12849.42,8150.58,0.15,0
70535,6987,-1000.00,18000.00,19000.00,11366.16,8633.84,0.12,0
70536,6987,-1000.00,17000.00,18000.00,0.00,19000.00,0.11,0
70537,6988,1000.00,1000.00,2000.00,0.00,352.61,0.24,1
70538,6988,1000.00,2000.00,3000.00,0.00,658.85,0.23,1
70539,6988,1000.00,3000.00,4000.00,0.00,3000.00,0.08,1
70540,6988,1000.00,4000.00,5000.00,0.00,4000.00,0.20,1
70541,6988,1000.00,5000.00,6000.00,0.00,5000.00,0.15,1
70542,6988,1000.00,6000.00,7000.00,0.00,6000.00,0.10,1
70543,6988,-1000.00,5000.00,6000.00,5347.79,843.63,0.07,0
70544,6988,1000.00,6000.00,7000.00,0.00,6000.00,0.33,1
70545,6988,1000.00,7000.00,8000.00,256.34,6743.66,0.28,1
70546,6988,1000.00,8000.00,9000.00,0.00,6712.72,0.03,1
70547,6988,1000.00,9000.00,10000.00,1785.36,7214.64,0.41,1
70548,6988,1000.00,10000.00,11000.00,3955.11,6044.89,0.26,1
70549,6988,1000.00,11000.00,12000.00,5500.00,5500.00,0.08,1
70550,6988,1000.00,12000.00,13000.00,4662.95,7337.05,0.30,1
70551,6988,1000.00,13000.00,14000.00,2881.52,10118.48,0.22,1
70552,6988,1000.00,14000.00,15000.00,0.00,10559.85,0.41,1
70553,6988,1000.00,15000.00,16000.00,0.00,5276.85,0.25,1
70554,6988,1000.00,16000.00,17000.00,0.00,16000.00,0.16,1
70555,6988,1000.00,17000.00,18000.00,0.00,17000.00,0.42,1
70556,6988,-1000.00,16000.00,17000.00,0.00,14888.15,0.08,0
70557,6988,-1000.00,15000.00,16000.00,0.00,9297.53,0.28,0
70558,6988,-1000.00,14000.00,15000.00,0.00,16000.00,0.43,0
70559,6988,-1000.00,13000.00,14000.00,10632.00,4368.00,0.06,0
70560,6988,-1000.00,12000.00,13000.00,0.00,14000.00,0.33,0
70561,6988,-1000.00,11000.00,12000.00,5888.81,7111.19,0.17,0
70562,6988,-14.40,10985.60,11985.60,0.00,14.40,0.09,0
70563,6988,-1000.00,9985.60,10985.60,0.00,9689.74,0.25,0
70564,6988,-1000.00,8985.60,9985.60,0.00,10985.60,0.20,0
70565,6988,-1000.00,7985.60,8985.60,0.00,9985.60,0.23,0
70566,6988,-1000.00,6985.60,7985.60,2571.10,6414.50,0.33,0
70567,6988,-1000.00,5985.60,6985.60,0.00,7985.60,0.09,0
70568,6988,-1000.00,4985.60,5985.60,357.27,6628.33,0.43,0
70569,6988,-1000.00,3985.60,4985.60,2169.36,3816.25,0.28,0
70570,6988,-1000.00,2985.60,3985.60,1566.48,3419.12,0.29,0
70571,6988,-1000.00,1985.60,2985.60,0.00,2765.26,0.28,0
70572,6988,-1000.00,985.60,1985.60,930.89,2054.71,0.34,0
70573,6988,-1000.00,-14.40,985.60,0.00,1985.60,0.21,0
70574,6988,-985.60,-1000.00,0.00,480.05,505.56,0.00,0
70575,6989,-1000.00,-1000.00,0.00,56.45,943.55,0.30,0
70576,6990,-1000.00,-1000.00,0.00,0.00,1000.00,0.40,0
70577,6991,-1000.00,-1000.00,0.00,0.00,1000.00,0.22,0
70578,6992,-1000.00,-1000.00,0.00,81.95,918.05,0.20,0
70579,6993,-1000.00,-1000.00,0.00,267.62,732.38,0.05,0
70580,6994,-1000.00,-1000.00,0.00,1000.00,0.00,0.01,0
70581,6995,-1000.00,-1000.00,0.00,221.43,778.57,0.23,0
70582,6996,-1000.00,-1000.00,0.00,0.00,1000.00,0.10,0
70583,6997,1000.00,1000.00,2000.00,748.80,0.00,0.19,1
70584,6997,0.00,1000.00,2000.00,0.00,0.00,0.31,0
70585,6997,1000.00,2000.00,3000.00,1400.28,599.72,0.10,1
70586,6997,-1000.00,1000.00,2000.00,0.00,3000.00,0.15,0
70587,6997,-1000.00,0.00,1000.00,0.00,2000.00,0.06,0
70588,6997,-1000.00,-1000.00,0.00,0.00,1000.00,0.37,0
70589,6998,-1000.00,-1000.00,0.00,0.00,1000.00,0.41,0
70590,6999,1000.00,1000.00,2000.00,0.00,979.59,0.42,1
70591,6999,1000.00,2000.00,3000.00,0.00,870.53,0.21,1
70592,6999,1000.00,3000.00,4000.00,0.00,3000.00,0.18,1
70593,6999,1000.00,4000.00,5000.00,0.00,1874.55,0.30,1
70594,6999,1000.00,5000.00,6000.00,0.00,2754.12,0.30,1
70595,6999,1000.00,6000.00,7000.00,877.03,5122.97,0.38,1
70596,6999,1000.00,7000.00,8000.00,1408.17,4087.22,0.33,1
70597,6999,1000.00,8000.00,9000.00,0.00,6134.63,0.31,1
70598,6999,1000.00,9000.00,10000.00,2650.83,6349.17,0.26,1
70599,6999,1000.00,10000.00,11000.00,5000.00,5000.00,0.02,1
70600,6999,1000.00,11000.00,12000.00,0.00,11000.00,0.01,1
70601,6999,1000.00,12000.00,13000.00,0.00,12000.00,0.16,1
70602,6999,1000.00,13000.00,14000.00,0.00,4754.33,0.20,1
70603,6999,1000.00,14000.00,15000.00,0.00,14000.00,0.01,1
70604,6999,1000.00,15000.00,16000.00,0.00,15000.00,0.10,1
70605,6999,1000.00,16000.00,17000.00,0.00,16000.00,0.42,1
70606,6999,1000.00,17000.00,18000.00,3354.19,13645.81,0.02,1
70607,6999,1000.00,18000.00,19000.00,0.00,18000.00,0.14,1
70608,6999,1000.00,19000.00,20000.00,5326.03,13673.97,0.32,1
70609,6999,0.00,19000.00,20000.00,0.00,0.00,0.02,0
70610,6999,1000.00,20000.00,21000.00,423.32,19576.68,0.37,1
70611,6999,1000.00,21000.00,22000.00,0.00,6535.55,0.19,1
70612,6999,1000.00,22000.00,23000.00,7564.30,14435.70,0.00,1
70613,6999,1000.00,23000.00,24000.00,0.00,4786.82,0.18,1
70614,6999,1000.00,24000.00,25000.00,0.00,24000.00,0.31,1
70615,6999,1000.00,25000.00,26000.00,0.00,25000.00,0.10,1
70616,6999,1000.00,26000.00,27000.00,352.97,22624.36,0.43,1
70617,6999,1000.00,27000.00,28000.00,9671.16,17328.84,0.32,1
70618,6999,1000.00,28000.00,29000.00,0.00,1138.40,0.05,1
70619,6999,-1000.00,27000.00,28000.00,16437.93,2618.76,0.09,0
70620,6999,1000.00,28000.00,29000.00,7990.40,20009.60,0.14,1
70621,6999,1000.00,29000.00,30000.00,0.00,8203.81,0.20,1
70622,6999,1000.00,30000.00,31000.00,0.00,30000.00,0.21,1
70623,6999,1000.00,31000.00,32000.00,8414.81,22585.19,0.26,1
70624,6999,1000.00,32000.00,33000.00,0.00,32000.00,0.39,1
70625,6999,1000.00,33000.00,34000.00,141.96,6486.50,0.18,1
70626,6999,1000.00,34000.00,35000.00,14685.58,19314.42,0.19,1
70627,6999,1000.00,35000.00,36000.00,0.00,35000.00,0.08,1
70628,6999,1000.00,36000.00,37000.00,2011.18,33988.82,0.35,1
70629,6999,-1000.00,35000.00,36000.00,18556.08,5387.55,0.11,0
70630,6999,1000.00,36000.00,37000.00,0.00,1824.91,0.12,1
70631,6999,1000.00,37000.00,38000.00,0.00,37000.00,0.05,1
70632,6999,1000.00,38000.00,39000.00,0.00,38000.00,0.03,1
70633,6999,-1000.00,37000.00,38000.00,14807.74,7215.69,0.14,0
70634,6999,-1000.00,36000.00,37000.00,26678.57,11321.43,0.09,0
70635,6999,1000.00,37000.00,38000.00,10549.14,26450.86,0.35,1
70636,7000,-550.53,-550.53,449.47,550.53,0.00,0.23,0
70637,7000,0.00,-550.53,449.47,0.00,0.00,0.04,0
70638,7000,-1000.00,-1550.53,-550.53,182.33,267.14,0.28,0
